id,meta_start,meta_end,meta_duration,meta_finished,meta_recorded,meta_captcha,meta_browser,meta_version,meta_operating system,meta_resolution_width,meta_resolution_height,meta_feedback,meta_resolution_ratio,meta_task_duration,meta_state_duration,meta_ace_duration,meta_temp_orient_duration,meta_psychopath_duration,meta_dems_duration,meta_task_duration_z,meta_state_duration_z,meta_ace_duration_z,meta_temp_orient_duration_z,meta_psychopath_duration_z,meta_dems_duration_z,stai_s01,stai_s02,stai_s03,stai_s04,stai_s05,stai_s06,stai_s07,stai_s08,stai_s09,stai_s10,stai_s11,stai_s12,stai_s13,stai_s14,stai_s15,stai_s16,stai_s17,stai_s18,stai_s19,stai_s20,sd_stai,sick,meal,hungry,sleep,rested,stai_s_mean,stai_s_missing,chaos01,chaos02,chaos03,chaos04,chaos05,chaos06,chaos07,chaos08,chaos09,chaos10,chaos11,chaos12,chaos13,chaos14,chaos15,unp01,unp02,unp03,unp04,unp05,unp06,unp07,unp08,unp_moving,unp_other_adults,unp_female_fig_num,unp_female_fig_rom,unp_male_fig_num,unp_male_fig_rom,quic01,quic02,quic03,quic04,quic05,quic06,quic07,quic08,quic09,quic10,quic11,quic12,quic13,quic14,quic15,quic16,quic17,quic18,quic19,quic20,quic21,quic22,quic23,quic24,quic25,quic26,quic27,quic28,quic29,quic30,quic31,quic32,quic33,quic34,quic35,quic36,quic37,change_env01,change_env02,change_env03,change_env04,sd_quic,sd_chaos,pcunp_mean,pcunp_missing,change_env_mean,change_env_missing,chaos_mean,chaos_missing,quic_monitoring_mean,quic_monitoring_missing,quic_par_predict_mean,quic_par_predict_missing,quic_par_env_mean,quic_par_env_missing,quic_phys_env_mean,quic_phys_env_missing,quic_safety_mean,quic_safety_missing,quic_total_mean,quic_total_missing,unp_moving_binned,unp_male_fig_rom_binned,unp_female_fig_rom_binned,unp_pcunp_quic_comp,unp_subj_comp,unp_obj_comp,unp_comp,violence01,violence02,violence03,violence04,violence05,violence06,violence07,aces_fighting1,aces_fighting2,sd_violence,nvs_mean,nvs_missing,fighting_mean,vio_comp,ses01,ses02,ses03,ses04,ses05,ses06,ses07,dems_edu_first,dems_edu_second,dems_income_past,dems_class_past,sd_ses,edu_caregivers,ses_subj_comp,ses_subj_missing,ses_obj_comp,ses_obj_missing,ses_comp,impuls01,impuls02,impuls03,impuls04,impuls05,fos01,fos02,fos03,fos04,fos05,fos06,fos07,fos08,fos09,fos10,fos11,fos12,fos13,fos14,fos15,sd_fos,impuls_mean,impuls_missing.x,fos_pa_mean,fos_pa_missing,fos_tp_mean,fos_tp_missing,fos_fc_mean,fos_fc_missing,fos_fo_mean,fos_fo_missing,depression01,depression02,depression03,depression04,depression05,depression06,depression07,depression08,depression09,depression10,depression11,depression12,depression13,depression14,depression15,depression16,depression17,depression18,depression19,depression20,sd_depression,depression_mean,impuls_missing.y,family_composition,fam_composition_multiple,dems_ethnicity,dems_ethnicity_mixed,dems_age,dems_sex,dems_gender,dems_gender_4_text,dems_born_us,dems_class_current,dems_edu,dems_occupation,dems_income,weight,height,activity,att_check01,att_check02,att_getup,att_interrupted,att_noise,attention_check_sum,attention_interrupt_sum,ex_narb_NA_selfreport_pass,ex_narb_attention_checks_pass,ex_narb_suspect_responses_pass,ex_narb_resolution_ratio,ex_narb_resolution_height,counterbalance,rt_flanker_congruent_deg,rt_flanker_congruent_enh,rt_flanker_congruent_std,rt_flanker_incongruent_deg,rt_flanker_incongruent_enh,rt_flanker_incongruent_std,acc_flanker_congruent_deg,acc_flanker_congruent_enh,acc_flanker_congruent_std,acc_flanker_incongruent_deg,acc_flanker_incongruent_enh,acc_flanker_incongruent_std,a_flanker_std,t0_flanker_std,p_flanker_std,rd_flanker_std,sda_flanker_std,g2_flanker_std,bbic_flanker_std,a_flanker_enh,t0_flanker_enh,p_flanker_enh,rd_flanker_enh,sda_flanker_enh,g2_flanker_enh,bbic_flanker_enh,a_flanker_deg,t0_flanker_deg,p_flanker_deg,rd_flanker_deg,sda_flanker_deg,g2_flanker_deg,bbic_flanker_deg,interference_flanker_std,interference_flanker_enh,interference_flanker_deg,ssp_refit,final_width_px,scale_factor,no_resize,fullscreenenter,fullscreenexit,blur_event,focus_event,event_during_flanker
2,2022-03-18T14:13:15Z,2022-03-18T14:35:34Z,1339,1,2022-03-18T14:35:36Z,0.8999999761581421,Chrome,99.0.4844.51,Macintosh,1280,800,n/a,1.6,565,90,350,88,64,76,-0.23205194267137688,-0.15402792182317124,-0.22282954412848152,-0.12478151042141572,0.06375055786272243,-0.25376763186643136,1,2,1,1,1,1,1,3,1,2,2,1,1,1,1,2,1,1,2,2,1.2096106376585989,0,1,1,4,4,1.4,0,2,2,1,1,2,1,1,2,2,2,1,1,1,1,2,1,2,1,1,1,2,1,1,1,2,0,0,0,0,1,1,1,1,1,1,1,1,1,1,1,1,1,2,2,1,2,1,2,3,2,1,1,1,1,1,1,1,3,3,1,1,1,2,1,1,1,1,1,2,2,1.7971448827876204,1.6676187756655838,1.25,0,1.5,0,1.4666666666666666,0,1,0,1.5833333333333333,0,1,0,1.7142857142857142,0,1,0,1.3243243243243243,0,1,0,0,-1.0637935853282892,-1.1332542727810155,-0.22730066264678367,-0.6802774677138996,1,2,4,1,2,2,1,1,1,1.3451854182690985,1.8571428571428572,0,1,-0.4603111395192921,3,4,5,2,2,2,4,4,3,2,2,1.2149857925879117,3.5,3.142857142857143,0,-0.788955151249163,0,-0.6443523350374132,2,2,3,2,2,4,4,4,4,4,4,4,4,3,4,4,4,4,4,2,1,2.2,0,4,0,4,0,3.4,0,3.8,0,2,1,1,2,1,1,1,2,1,1,1,1,2,2,1,2,1,2,1,1,0.9333020044867296,1.35,0,I lived with my mother and father an equal amount of time (joint custody),0,"Asian or Asian American (e.g., Chinese, Japanese, and others)",0,25,1,2,NA,1,2,6,student,7,130,66,2,5,2,0,0,0,0,0,TRUE,TRUE,TRUE,TRUE,TRUE,6,0.5931500000040978,0.5087437500059605,0.5271062499973923,0.6241387096778039,0.5755374999996274,0.594265625,1,1,1,0.96875,1,1,0.114,0.397,0.908,0.013,1.342,64.87877379183134,1849.2253660241956,0.091,0.391,0.806,0.02,1.661,67.06600462929075,1850.288611939237,0.049,0.496,0.534,0.016,1.133,94.96742687708208,1928.8807824221071,103.23076923076924,83.05,70.8125,FALSE,386,1.1437037037037037,0,1,0,0,3,FALSE
3,2022-03-18T14:47:17Z,2022-03-18T15:05:21Z,1083,1,2022-03-18T15:05:23Z,0.699999988079071,Chrome,99.0.4844.51,Windows NT 10.0,1280,720,NA,1.7777777777777777,485,47,217,192,21,61,-0.3965399244189453,-0.39146341640719184,-0.70605439786646,1.1578157403747824,-0.818001904157992,-0.42234097034706597,2,2,3,2,2,1,2,3,1,3,3,1,1,1,3,3,2,1,2,3,0.7591546545162482,0,0,2,4,4,2.05,0,5,2,3,2,3,3,3,3,3,3,4,4,3,4,3,3,5,1,1,2,4,3,3,1,1,0,0,2,0,3,3,3,3,2,2,2,2,2,2,2,3,2,4,2,3,3,3,4,3,4,3,1,1,1,2,1,1,2,2,2,2,3,2,2,4,2,2,1,2,2,1.0237421785039669,0.7988086367179802,2.75,0,1.75,0,3.2,0,2.4444444444444446,0,2.9166666666666665,0,1.5,0,2,0,2.6666666666666665,0,2.3783783783783785,0,1,0,0,0.5942727612842665,0.7386211581611001,-0.14114775846592847,0.2987366998475858,3,3,3,2,2,3,3,2,1,0.4879500364742666,2.7142857142857144,0,1.5,0.2306985064430642,4,3,4,4,2,2,3,6,8,4,3,0.8997354108424374,7,3.142857142857143,0,0.6141103876166872,0,0.21024017410123944,2,2,2,2,2,4,3,4,5,3,5,5,3,5,5,4,5,4,4,4,1.4638501094227998,2,0,4.6,0,3.4,0,4.6,0,4.2,0,2,2,2,2,2,2,2,2,1,1,2,2,1,1,1,2,2,2,1,2,0.7181848464596079,1.7,0,I lived with my mother and father an equal amount of time (joint custody),0,"White, Caucasian, Anglo, European American",0,22,3,3,NA,1,2,6,freelancer,1,160,68,3,5,2,0,0,1,0,0,TRUE,TRUE,TRUE,TRUE,TRUE,2,0.6485125000000408,0.6517281249999068,0.6326750000000465,0.6969093750001047,0.7547968749999417,0.7537258064517031,1,1,1,1,1,0.96875,0.107,0.392,0.475,0.007,1.341,99.216300561566,1925.4551202257956,0.109,0.387,0.399,0.024,1.642,127.02256250574698,1910.2527187004837,0.08,0.441,0.418,0.014,1.274,90.40062083917067,1874.172610454598,191.57142857142856,68.41666666666666,91,FALSE,304,0.9007407407407407,1,1,0,0,3,FALSE
4,2022-03-18T14:49:21Z,2022-03-18T15:07:49Z,1107,1,2022-03-18T15:07:50Z,0.8999999761581421,Chrome,99.0.4844.51,Windows NT 10.0,1440,900,"Thank you! I had a second screen connected, but I covered it as instructed.",1.6,511,76,290,60,31,70,-0.34308133035098554,-0.23133250145517795,-0.44082571874711846,-0.470096154866546,-0.6129431920601515,-0.32119696725868524,1,2,1,1,2,1,1,2,1,2,2,1,2,1,2,1,1,1,3,2,1.1192102478745307,0,1,1,4,3,1.5,0,3,2,1,2,1,2,2,3,1,2,2,3,2,3,4,2,5,5,1,3,4,3,4,4,2,0,0,0,0,2,4,2,4,4,2,2,2,4,1,1,4,1,3,1,1,2,2,4,4,4,5,1,3,2,3,2,1,4,2,1,2,1,2,1,1,3,2,2,2,2,1.322024110123468,1.0600988273786194,3.375,0,2,0,2.2,0,2.888888888888889,0,2.3333333333333335,0,2.6666666666666665,0,1.8571428571428572,0,1.6666666666666667,0,2.3783783783783785,0,2,0,0,1.0000165101246405,0.5748959746919562,0.16436794915095845,0.3696319619214573,1,1,2,2,1,1,2,3,1,1.6035674514745464,1.4285714285714286,0,2,-0.32231065268119236,5,5,5,4,2,2,5,6,6,4,3,1.7182493859684491,6,4,0,0.43348058270556905,0,0.5646365052056546,2,2,2,2,2,4,4,3,4,4,5,4,5,4,3,4,5,4,3,2,1.2227992865708155,2,0,4.4,0,4,0,3.2,0,3.8666666666666667,0,1,1,1,1,3,1,1,2,1,1,2,2,1,1,1,2,1,1,1,2,0.9880869341680844,1.35,0,I lived with my mother and father an equal amount of time (joint custody),0,"White, Caucasian, Anglo, European American",0,24,1,2,NA,1,3,6,Marketing Specialist,4,165,65,2,5,2,0,0,0,0,0,TRUE,TRUE,TRUE,TRUE,TRUE,3,0.481296875,0.42500312500447035,0.47699999999813736,0.5611500000022351,0.49853125000558796,0.5407687499988824,1,1,1,1,1,1,0.124,0.32,0.784,0.025,1.635,22.80645140136867,1809.3047992815261,0.073,0.344,0.883,0.03,1.966,112.48419378573527,1903.5159043613821,0.068,0.38,0.705,0.023,1.934,107.08239479974314,1892.0120683469665,65.39999999999999,65.53333333333333,84.08695652173913,FALSE,304,0.9007407407407407,1,1,0,0,3,FALSE
5,2022-03-18T15:09:17Z,2022-03-18T15:31:02Z,1304,1,2022-03-18T15:31:04Z,1,Safari,15.1,Macintosh,1440,900,N/A,1.6,526,150,330,79,52,86,-0.3122398337733165,0.17727741945685752,-0.29549493566802715,-0.23577550327877903,-0.18231989665468626,-0.14138540621267498,2,2,2,2,2,1,1,2,1,2,2,2,2,1,2,2,2,1,2,2,0.8506963092234007,0,1,3,3,2,1.75,0,4,2,3,1,2,2,3,2,1,1,4,3,3,3,3,3,3,1,1,3,3,2,1,2,1,0,0,1,0,2,4,3,2,3,3,2,2,2,3,2,2,2,2,3,1,4,2,2,3,3,2,1,1,1,4,2,1,2,2,1,2,3,1,1,2,1,2,2,2,2,1.2030991012578505,1.0997835284835873,2.125,0,2,0,2.466666666666667,0,2.5555555555555554,0,2.4166666666666665,0,1.8333333333333333,0,1.7142857142857142,0,1.3333333333333333,0,2.135135135135135,0,1,0,0,0.030617931814124925,0.039372041254744763,-0.05499485428507328,-0.007811406515164258,2,1,4,1,1,2,3,3,3,1.1547005383792515,2,0,3,0.3962319431973266,3,3,4,4,1,1,1,7,5,3,2,1.5275252316519468,6,2.4285714285714284,0,-0.12355533664153649,0,-0.6260776606158913,2,3,2,4,3,4,5,4,4,3,5,4,2,5,3,4,4,4,3,5,1.3020130933435712,2.8,0,4.2,0,3.4,0,4.2,0,3.933333333333333,0,2,1,2,1,3,2,4,1,1,1,3,2,2,1,1,2,1,2,1,2,1.0894228312566052,1.75,0,I lived with my mother and father an equal amount of time (joint custody),0,"White, Caucasian, Anglo, European American",0,28,1,2,NA,1,4,7,Board Certified Behavior Analyst,4,171,62,2,5,2,0,0,2,0,0,TRUE,TRUE,TRUE,TRUE,TRUE,2,0.6360624999999945,0.4947499999999982,0.5082499999999973,0.661709677419352,0.5878387096774175,0.5847333333333338,1,1,1,1,0.96875,0.9375,0.056,0.37,0.427,0.007,1.114,111.55544848076272,1979.0028101547368,0.091,0.348,0.628,0.008,1.202,106.93424346382655,1937.635301305813,0.211,0.24,0.562,0.024,1.486,281.46202807874215,2067.5506297452816,159.14285714285717,150.25,61.916666666666664,FALSE,436,1.2918518518518518,0,1,0,0,3,FALSE
6,2022-03-18T15:15:28Z,2022-03-18T15:36:53Z,1285,1,2022-03-18T15:36:54Z,0.8999999761581421,Chrome,99.0.4844.74,Windows NT 10.0,1920,1080,No,1.7777777777777777,518,76,331,126,41,79,-0.3286886319480733,-0.23133250145517795,-0.29186166609104985,0.34385979275411827,-0.40788447996231086,-0.22005296417030445,1,1,2,1,1,1,2,2,1,1,3,2,2,2,1,2,2,1,2,3,1.0990426455975697,1,1,2,3,4,1.65,0,4,3,5,3,5,5,4,4,5,3,5,5,2,4,4,3,5,2,3,4,3,4,3,4,1,4,0,4,0,3,5,4,4,4,4,4,3,4,4,4,4,1,4,3,2,4,5,5,4,4,4,3,1,1,4,3,4,4,1,1,4,3,3,4,5,5,3,2,3,4,1.2863338037440573,1.4375905768565218,3.375,0,3,0,4.066666666666666,0,3.888888888888889,0,3.6666666666666665,0,2.6666666666666665,0,2.857142857142857,0,4.666666666666667,0,3.4864864864864864,0,2,0,0,1.719389210771357,1.8736840967703057,0.5089795658743793,1.1913318313223424,3,3,3,2,1,3,2,3,3,0.7867957924694432,2.4285714285714284,0,3,0.6450357042146491,3,3,3,2,1,1,1,4,7,3,2,1.3972762620115438,5.5,2,0,-0.21387023909709557,0,-0.9132955465077466,2,3,2,3,2,4,5,4,5,3,5,4,3,4,5,5,5,4,4,5,1.5522640914238175,2.4,0,4.4,0,4,0,4.6,0,4.333333333333333,0,1,3,1,2,2,1,3,1,1,1,3,2,1,1,1,2,2,2,1,2,0.998683343734455,1.65,0,I lived with my mother and father an equal amount of time (joint custody),0,"White, Caucasian, Anglo, European American",0,29,1,2,NA,1,4,6,Human Resources Client Services,6,221,66,3,5,2,0,0,0,0,0,TRUE,TRUE,TRUE,TRUE,TRUE,2,0.5484749999940395,0.4858451612880153,0.4961451612864771,0.6250900000135103,0.5335444444373801,0.5646548387081393,1,1,0.96875,0.967741935483871,0.8709677419354839,0.96875,0.073,0.367,0.653,0.02,1.861,265.4918051425363,2134.6472010938955,0.052,0.359,0.48,0.018,1.87,114.82800000065232,2011.6265591861363,0.068,0.407,0.488,0.016,1.619,41.31526248229081,1870.8021754422361,93.05,103.8888888888889,101.1875,FALSE,376,1.114074074074074,0,1,0,0,3,FALSE
7,2022-03-18T15:18:14Z,2022-03-18T15:37:26Z,1151,1,2022-03-18T15:37:28Z,0.8999999761581421,Safari,15.2,Macintosh,1440,900,NA,1.6,492,90,333,74,54,66,-0.38214722601603307,-0.15402792182317124,-0.2845951269370953,-0.29743883264398085,-0.14130815423511814,-0.3661498575201878,3,2,1,1,1,1,2,2,1,1,2,1,2,2,2,2,1,2,2,1,1.0809352675491624,0,0,2,4,4,1.6,0,3,1,2,2,1,2,3,4,2,2,1,3,1,3,4,4,2,5,3,2,2,4,3,7,1,0,0,3,3,2,3,3,2,3,3,4,4,3,3,3,1,1,2,2,4,1,2,3,2,3,5,5,4,1,2,1,1,5,5,1,2,2,2,1,1,1,2,4,4,3,1.28224184307959,1.1872336794093274,3.125,0,3.25,0,2.2666666666666666,0,3,0,2.25,0,3,0,2.5714285714285716,0,1,0,2.5135135135135136,0,4,3,0,0.9254473887161394,0.5538526177776041,3.1319531112787513,1.8429028645281778,2,2,4,1,1,1,1,2,1,1.1126972805283737,1.7142857142857142,0,1.5,-0.3498436025973552,3,3,5,5,1,2,4,6,9,2,3,1.5275252316519468,7.5,3.2857142857142856,0,0.276774685412584,0,0.0821752099601632,3,4,4,5,4,3,5,3,3,2,2,4,3,4,3,5,4,3,4,3,0.9611501047232549,4,0,3.2,0,3.8,0,3.2,0,3.4,0,3,3,2,2,2,2,1,2,1,2,2,2,2,2,1,2,1,2,1,2,0.7591546545162482,1.85,0,"I lived with my mother, but not father, most of the time.",0,"White, Caucasian, Anglo, European American",0,23,1,2,NA,1,4,6,nanny and student,1,132,68,3,5,2,0,0,1,0,0,TRUE,TRUE,TRUE,TRUE,TRUE,3,0.5747187500000036,0.5874062500000014,0.5431562499999909,0.6297741935483908,0.6645937499999987,0.6674374999999946,1,1,1,1,1,1,0.207,0.287,0.828,0.013,1.727,80.07507550758066,1862.963606405311,0.086,0.436,0.573,0.024,1.868,37.68298264942327,1820.1346360895252,0.227,0.316,0.925,0.019,1.59,39.86837625844848,1823.9978437052725,132.84615384615387,77.83333333333334,83.6842105263158,TRUE,364,1.0785185185185184,0,1,0,0,3,FALSE
8,2022-03-18T15:18:18Z,2022-03-18T15:38:55Z,1236,1,2022-03-18T15:38:56Z,0.8999999761581421,Chrome,99.0.4844.51,Macintosh,1680,1050,NA,1.6,502,67,282,59,193,66,-0.361586228297587,-0.28102830264718226,-0.4698918753629367,-0.4824288207395864,2.7090079439248655,-0.3661498575201878,2,3,3,3,3,1,1,2,1,2,2,1,1,1,3,3,1,1,4,3,0.8750939799154206,0,1,1,3,2,2.05,0,2,2,3,2,2,2,2,3,2,1,1,2,4,2,1,2,1,1,1,1,1,3,1,1,1,2,0,1,0,1,2,3,2,3,1,2,1,3,2,3,2,1,2,2,2,2,1,1,1,1,2,1,1,1,3,2,1,2,2,1,2,3,2,1,1,1,2,1,1,2,1.365050681609794,1.245945806357946,1.375,0,1.5,0,2.066666666666667,0,2,0,1.6666666666666667,0,1.6666666666666667,0,1.8571428571428572,0,1,0,1.7297297297297298,0,1,0,0,-0.7194597011772692,-0.6397187197289838,-0.22730066264678367,-0.43350969118788374,3,3,3,3,2,4,3,2,1,0.5773502691896257,3,0,1.5,0.39656768045461255,4,4,4,4,2,2,3,6,6,NA,3,0.9511897312113419,6,3.2857142857142856,0,0.40966740893729353,1,0.1631187745316749,3,3,4,3,4,3,4,3,4,2,4,3,3,4,3,2,4,3,4,3,0.7432233529572065,3.4,0,3.4,0,3,0,3.4,0,3.2666666666666666,0,2,1,1,2,3,1,3,2,1,1,4,2,1,2,2,2,1,1,1,3,1.025978352085154,1.8,0,I lived with my mother and father an equal amount of time (joint custody),0,"White, Caucasian, Anglo, European American",0,27,1,2,NA,1,2,7,Executive Coordinator,3,190,70,2,5,2,0,0,0,0,0,TRUE,TRUE,TRUE,TRUE,TRUE,3,0.44164666666785873,0.42568437499925493,0.4837437500003725,0.5775045454475013,0.5394766666710377,0.5831062499955296,0.967741935483871,1,1,0.6875,0.9375,1,0.114,0.303,0.637,0.014,1.675,328.57616834377734,2118.332909825689,0.073,0.322,0.717,0.011,1.54,70.1135822395194,1913.4167353533276,0.052,0.324,0.496,0.009,1.803,170.1925355168348,2120.082091916696,119.64285714285714,140,200.33333333333334,FALSE,317,0.9392592592592592,0,1,0,3,6,FALSE
10,2022-03-18T15:41:04Z,2022-03-18T15:58:45Z,1061,1,2022-03-18T15:58:46Z,0.8999999761581421,Chrome,99.0.4844.74,Windows NT 10.0,1536,864,no,1.7777777777777777,491,61,258,73,32,61,-0.38420332578787764,-0.31415883677518514,-0.5570903452103915,-0.30977149851702124,-0.5924373208503674,-0.42234097034706597,1,2,1,1,1,1,1,2,1,1,2,1,1,1,1,1,1,1,2,1,1.3803127029389886,0,1,1,3,3,1.2,0,1,1,1,1,2,1,2,1,1,2,1,1,1,1,1,1,1,1,1,1,1,1,1,0,2,0,0,0,0,1,3,1,1,1,1,1,1,1,1,1,1,1,1,1,1,2,1,2,1,2,1,1,1,1,1,1,1,1,1,1,1,1,2,1,1,1,1,1,1,1,1.8639942259766993,1.9073791542572855,1,0,1,0,1.2,0,1.2222222222222223,0,1.25,0,1,0,1.1428571428571428,0,1,0,1.162162162162162,0,0,0,0,-1.331365138617617,-1.4296312715654,-0.6189692744445258,-1.0243002730049628,1,1,3,1,1,1,1,1,1,1.5735915849388864,1.2857142857142858,0,1,-0.7920494875423887,5,5,5,5,3,1,4,4,3,3,3,1.7043362064926932,3.5,4,0,-0.23191923190205752,0,0.15934845458074715,3,3,4,2,3,3,4,4,3,3,3,3,4,4,3,4,3,3,4,4,0.7037315505489968,3,0,3,0,3.8,0,3.6,0,3.466666666666667,0,1,1,1,1,1,1,1,1,1,1,1,1,1,1,1,1,1,1,1,2,1.2258187382102494,1.05,0,I lived with my mother and father an equal amount of time (joint custody),0,"White, Caucasian, Anglo, European American",0,30,1,2,NA,1,3,5,lab tech,4,160,66,3,5,2,0,0,1,0,0,TRUE,TRUE,TRUE,TRUE,TRUE,1,0.5668406250011175,0.45964516128263166,0.4683437499906868,0.6254571428554399,0.5182931034482758,0.5186933333317438,1,0.96875,1,0.9032258064516129,0.90625,0.9375,0.042,0.397,0.537,0.042,2.032,166.29725251574453,2021.0255605192262,0.046,0.373,0.535,0.012,1.298,174.86888685314483,2100.8823009809785,0.061,0.42,0.482,0.019,1.913,160.0985020305259,2014.8743673575993,48.38095238095238,108.16666666666667,100.6842105263158,FALSE,298,0.882962962962963,0,1,0,3,6,FALSE
12,2022-03-18T15:31:48Z,2022-03-18T16:00:40Z,1731,1,2022-03-18T16:00:42Z,1,Chrome,97.0.4692.71,Macintosh,1440,900,NA,1.6,575,112,622,98,97,154,-0.21149094495293083,-0.0325492966871607,0.7654197808093391,-0.0014548516910120387,0.7404443077855963,0.6228137282328685,3,1,2,1,2,1,1,3,1,2,2,1,1,2,3,3,1,1,2,3,0.9119095061289915,0,1,1,4,4,1.8,0,3,2,2,3,2,3,4,3,3,3,4,4,2,4,3,3,4,1,3,3,3,3,3,7,1,1,0,1,1,1,2,3,3,4,1,1,1,1,3,1,2,1,3,2,1,4,3,2,4,4,3,1,1,1,2,5,2,5,1,1,3,4,2,3,5,2,4,3,4,1,1.456063226690421,0.7037315505489968,2.875,0,3,0,3,0,1.8888888888888888,0,2.5,0,2.1666666666666665,0,2.5714285714285716,0,3.3333333333333335,0,2.3783783783783785,0,4,1,0,0.6754215110523414,0.7058761214672714,1.647070184196927,1.1764731528320993,2,2,4,2,2,3,2,4,1,0.7867957924694432,2.4285714285714284,0,2.5,0.4516335802869379,2,2,3,3,1,1,1,4,3,1,1,1.3972762620115438,3.5,1.8571428571428572,0,-1.3459910705962685,0,-1.6802611503776048,2,2,3,3,3,4,5,4,4,2,3,4,3,4,4,3,2,4,3,4,0.990430401872025,2.6,0,3.4,0,3.2,0,4,0,3.533333333333333,0,2,3,1,2,3,1,3,1,2,3,1,1,1,1,1,1,2,2,1,1,1.1367080817685316,1.65,0,"I lived with my mother, but not father, most of the time.",0,Black or African American & Middle Eastern,1,23,1,2,NA,1,4,6,unemployed currently,4,103,64,3,5,2,0,0,0,0,0,TRUE,TRUE,TRUE,TRUE,TRUE,3,0.5117937500011176,0.48012812500074503,0.49297741935522327,0.5902406250145287,0.541568750007078,0.5502874999959022,1,1,0.96875,1,1,1,0.059,0.382,0.524,0.02,1.475,112.65284146034622,1941.073989023762,0.069,0.374,0.618,0.036,1.943,22.166918616861274,1803.539998305473,0.192,0.296,0.93,0.015,1.479,67.53561793377496,1853.105480855174,73.75,53.97222222222223,98.60000000000001,FALSE,436,1.2918518518518518,0,1,0,3,6,FALSE
13,2022-03-18T15:36:57Z,2022-03-18T16:05:06Z,1688,1,2022-03-18T16:05:08Z,0.8999999761581421,Chrome,99.0.4844.51,Windows NT 6.1,1280,800,NA,1.6,905,118,380,78,72,79,0.46702197975578885,5.812374408421722e-4,-0.11383145681916307,-0.24810816915181938,0.2277975275409949,-0.22005296417030445,3,3,3,3,3,1,3,3,1,3,4,3,3,1,3,3,2,1,3,2,0.7591546545162482,0,1,1,1,1,2.55,0,4,3,3,4,3,4,4,5,4,3,5,4,3,4,4,5,5,3,2,4,5,5,5,0,1,1,0,0,0,3,4,2,3,3,2,2,3,3,3,3,4,3,3,3,2,4,5,5,5,5,5,3,4,1,3,1,2,1,2,1,4,4,4,1,1,5,1,4,2,2,1.301419876017611,1.0690449676496976,4.25,0,2.25,0,3.8,0,2.7777777777777777,0,3.75,0,2.8333333333333335,0,2.5714285714285716,0,2.3333333333333335,0,3.027027027027027,0,0,0,0,1.9891539735138766,1.9386825029403387,-0.1882047535402498,0.8752388747000445,1,1,1,1,1,2,2,8,1,1.8126539343499315,1.2857142857142858,0,4.5,0.56176537995158915,5,5,5,5,3,2,5,8,7,6,4,1.7043362064926932,7.5,4.285714285714286,0,1.475286511749183,0,1.3539949241463662,2,2,3,3,3,4,4,4,4,3,5,4,4,3,5,3,4,4,3,2,1.0997835284835873,2.6,0,4.2,0,3.4,0,3.6,0,3.7333333333333334,0,4,2,2,2,4,2,4,3,3,1,3,3,3,3,1,3,3,3,4,4,0.9665456669582609,2.85,0,I lived with my mother and father an equal amount of time (joint custody),0,"White, Caucasian, Anglo, European American",0,27,1,2,NA,1,2,4,Transcription,1,133,66,1,5,2,1,0,1,0,1,TRUE,TRUE,TRUE,TRUE,TRUE,1,0.5449999999850988,0.50209375,0.5567281250208617,0.6401781249940396,0.5971218749582767,0.6460516129309132,1,1,1,1,1,1,0.089,0.419,0.627,0.016,1.564,27.010810554140903,1810.1648696442273,0.115,0.323,0.647,0.019,1.85,14.40684935459952,1794.2500137768998,0.093,0.382,0.554,0.016,1.557,49.58704200415695,1836.6416164269908,97.75,97.36842105263159,97.3125,FALSE,390,1.1555555555555557,0,1,0,0,3,FALSE
15,2022-03-18T15:37:41Z,2022-03-18T16:07:03Z,1762,1,2022-03-18T16:07:04Z,0.8999999761581421,Chrome,98.0.4758.91,CrOS x86_64 14388.52.0,1920,1080,no,1.7777777777777777,790,63,337,114,56,76,0.23057050599365925,-0.3031153253991842,-0.2700620486291862,0.19586780227763384,-0.10029641181555002,-0.25376763186643136,1,1,1,1,1,1,1,1,1,1,1,3,2,1,1,2,1,1,1,2,1.394538218230416,0,0,3,3,3,1.25,0,5,4,4,5,4,4,4,4,3,4,4,4,3,4,4,4,4,5,2,3,3,3,3,6,2,0,0,0,0,1,5,3,4,5,4,4,4,4,4,4,2,1,3,3,3,5,4,2,3,3,3,1,4,1,5,5,1,5,4,1,3,3,3,4,5,3,3,3,3,2,1.3367074424820065,1.1464230084422218,3.375,0,2.75,0,4,0,3.7777777777777777,0,3.0833333333333335,0,3.1666666666666665,0,2.857142857142857,0,4,0,3.2972972972972974,0,3,0,0,1.5965694813926496,1.761977304925893,0.6421894651295558,1.2020833850277244,5,3,5,3,3,5,3,5,1,1.3801311186847085,3.857142857142857,0,3,1.474381574272391,2,2,2,1,1,1,1,7,6,2,2,1.4142135623730951,6.5,1.4285714285714286,0,-0.24706573651580854,0,-1.2431252769065957,4,4,4,5,4,2,5,3,3,2,3,3,2,2,5,1,3,4,3,2,1.0555973258234952,4.2,0,3,0,2.6,0,3,0,2.8666666666666667,0,3,3,3,4,3,3,3,4,2,3,4,3,4,3,1,3,1,3,3,2,0.9459053029269173,2.9,0,"I lived with my mother, but not father, most of the time.",0,"White, Caucasian, Anglo, European American",0,20,1,2,NA,1,2,4,retail associate,2,140,62,1,5,2,0,0,1,0,0,TRUE,TRUE,TRUE,TRUE,TRUE,4,0.6402000000000961,0.5146906249998138,0.5316612903225807,0.6926968749999068,0.577396774193933,0.6151580645177633,1,1,0.96875,1,0.96875,1,0.07,0.405,0.554,0.026,1.901,122.29309207975257,1949.0700997312167,0.123,0.331,0.681,0.015,1.418,152.13524048681438,1975.268000480274,0.099,0.483,0.617,0.04,1.964,35.560221385671134,1817.8402840049587,73.11538461538461,94.53333333333333,49.1,FALSE,466,1.3807407407407408,0,1,0,0,3,FALSE
16,2022-03-18T15:47:44Z,2022-03-18T16:07:34Z,1189,1,2022-03-18T16:07:35Z,1,Edge,99.0.1150.39,Windows NT 10.0,1280,720,n/a,1.7777777777777777,525,98,308,76,42,79,-0.3142959335451611,-0.10985387631916742,-0.37542686636152733,-0.27277350089790015,-0.38737860875252683,-0.22005296417030445,2,2,3,2,2,2,1,3,1,3,3,2,2,1,3,2,2,1,4,3,0.7254762501100116,0,1,3,2,2,2.2,0,1,1,2,2,2,2,1,2,2,2,2,4,2,3,2,1,1,1,1,1,1,1,1,1,2,0,0,0,0,2,2,3,2,2,1,1,1,1,2,1,1,1,1,1,1,2,1,1,1,1,1,1,1,1,1,1,1,2,2,1,2,2,1,1,1,1,2,1,2,2,1.6930346618915888,1.2798809468443688,1,0,1.75,0,2,0,1.6666666666666667,0,1.1666666666666667,0,1,0,1.5714285714285714,0,1,0,1.3243243243243243,0,1,0,0,-1.2260910848644389,-1.0095508008265515,-0.14114775846592847,-0.5753492796462399,1,1,2,1,1,1,1,1,1,1.7320508075688772,1.1428571428571428,0,1,-0.874984074548163,5,5,5,4,2,3,4,6,6,5,3,1.3801311186847085,6,4,0,0.6473058850354002,0,0.6948752549814432,2,1,2,3,2,4,4,4,5,3,5,3,3,4,3,5,3,3,3,3,0.9856107606091623,2,0,3.6,0,3.6,0,3.8,0,3.6666666666666665,0,1,1,1,2,1,1,1,2,1,1,1,2,1,2,1,1,1,1,2,1,0.9445132413883326,1.25,0,I lived with my mother and father an equal amount of time (joint custody),0,"White, Caucasian, Anglo, European American",0,29,1,2,NA,1,3,7,Recruitment Coordinator,5,230,68,2,5,2,0,1,1,0,1,TRUE,TRUE,TRUE,TRUE,TRUE,4,0.5512468750020489,0.5671406249981373,0.5194000000011536,0.6749290322613332,0.6196580645192054,0.8277566666712364,1,1,0.96875,1,1,0.9375,0.107,0.325,0.486,0.004,1.307,199.65131239327084,2130.2638343147046,0.098,0.337,0.478,0.023,2.063,109.36808580703726,1894.0993618156042,0.187,0.219,0.581,0.009,1.393,96.90534457283412,1880.2759763480294,326.75,89.69565217391305,154.7777777777778,TRUE,258,0.7644444444444445,0,1,1,6,9,FALSE
17,2022-03-18T15:40:54Z,2022-03-18T16:08:32Z,1658,1,2022-03-18T16:08:34Z,0.800000011920929,Firefox,98.0,Windows NT 10.0,1920,1080,I experienced a lot from the study.,1.7777777777777777,564,127,413,86,48,94,-0.23410804244322148,0.05027703863284649,0.0060664392210872395,-0.14944684216749646,-0.26434338149382247,-0.05147962568966986,2,1,1,2,4,1,1,1,1,2,2,1,2,1,2,1,2,1,3,1,1.1964860832322377,0,1,3,5,4,1.6,0,2,1,2,2,2,1,4,1,2,2,1,2,1,2,3,2,1,1,2,1,1,1,1,0,1,1,1,1,1,2,3,2,2,3,2,2,3,2,2,3,1,3,2,3,2,1,1,2,2,4,2,1,1,2,4,1,2,1,2,1,2,1,1,2,1,1,1,2,2,3,1.2609877438302444,1.3557637102737474,1.25,0,2,0,1.8666666666666667,0,2.3333333333333335,0,2.1666666666666665,0,1.8333333333333333,0,1.4285714285714286,0,1.3333333333333333,0,1.945945945945946,0,0,1,1,-0.6602430459411065,-0.687213772951564,1.3311408428585365,0.32196353495348623,2,2,2,1,1,1,1,3,2,1.4142135623730951,1.4285714285714286,0,2.5,-0.12890852875348124,4,5,4,4,5,4,4,7,7,5,5,1,7,4.285714285714286,0,1.514356923981067,0,1.3777923025990628,1,1,2,1,1,5,3,5,4,1,5,4,4,4,4,5,4,3,4,2,1.3522468075656264,1.2,0,4.2,0,3.4,0,3.8,0,3.8,0,1,2,1,3,2,1,1,2,1,1,1,2,1,1,1,2,1,1,1,1,0.7591546545162482,1.35,0,I lived with my mother and father an equal amount of time (joint custody),0,"White, Caucasian, Anglo, European American",0,29,1,2,NA,1,5,6,IT Expert,6,165,66,4,5,2,0,0,1,0,0,TRUE,TRUE,TRUE,TRUE,TRUE,2,0.58625,0.4976875,0.49634375,0.6283448275862069,0.550304347826087,0.5737931034482758,1,1,1,0.90625,0.7419354838709677,0.90625,0.055,0.373,0.449,0.011,1.321,31.456545984097882,1885.187166084475,0.044,0.379,0.356,0.011,1.443,84.40570113489225,2084.5597013346146,0.071,0.347,0.385,0.01,1.499,173.4949201504493,2034.0118462516027,120.0909090909091,131.1818181818182,149.9,FALSE,316,0.9362962962962963,0,1,1,6,9,FALSE
18,2022-03-18T15:49:21Z,2022-03-18T16:10:53Z,1291,1,2022-03-18T16:10:53Z,1,Chrome,96.0.4664.110,Macintosh,1920,1080,NA,1.7777777777777777,570,83,341,75,50,96,-0.22177144381215386,-0.1926802116391746,-0.2555289703212771,-0.2851061667709405,-0.22333163907425438,-0.029003180558918575,2,2,2,1,3,1,2,2,1,3,3,2,1,2,2,3,2,1,3,3,0.6863327411532597,0,0,4,2,1,2.05,0,1,1,2,2,1,1,3,1,1,1,1,2,3,3,2,1,2,3,1,1,1,1,1,2,2,0,0,0,0,2,5,4,3,3,3,4,3,3,1,2,2,1,3,1,3,1,1,1,1,3,4,4,5,1,3,1,1,3,1,1,2,1,1,1,1,1,2,2,1,1,1.2105641104317713,1.5491933384829668,1.375,0,1.5,0,1.6666666666666667,0,3.3333333333333335,0,1.6666666666666667,0,3,0,1.4285714285714286,0,1,0,2.189189189189189,0,1,0,0,-0.4211832155432646,-0.6137586906383807,-0.22730066264678367,-0.42052967664258223,1,1,3,1,1,1,1,1,1,1.5735915849388864,1.2857142857142858,0,1,-0.7920494875423887,5,4,5,4,1,1,4,6,10,2,3,1.7728105208558367,8,3.4285714285714284,0,0.3670895878681431,0,0.2145877453706641,2,1,2,2,1,5,5,5,5,3,5,5,5,4,4,4,5,4,4,5,1.6761634196950514,1.6,0,4.8,0,4.2,0,4.6,0,4.533333333333333,0,1,1,1,1,2,1,2,2,1,1,3,2,1,1,1,3,1,1,1,1,0.9403246919632545,1.4,0,"I lived with my mother, but not father, most of the time.",0,"White, Caucasian, Anglo, European American",0,25,1,2,NA,1,3,6,Senior Admissions Representative for a university,3,130,65,2,5,2,0,0,1,0,0,TRUE,TRUE,TRUE,TRUE,TRUE,2,0.7483593749701977,0.5732718749940395,0.6382375000044703,0.7970483870890833,0.6007064516236705,0.7054225806574668,1,1,1,0.96875,0.96875,0.96875,0.065,0.481,0.402,0.024,1.767,86.08242778946061,1911.6986090252494,0.055,0.457,0.494,0.026,1.384,121.45957789476589,1957.2669945065827,0.083,0.485,0.338,0.023,1.744,55.69694816461729,1884.4706906884185,73.625,53.230769230769226,75.82608695652173,FALSE,348,1.031111111111111,0,1,0,0,3,FALSE
19,2022-03-18T15:55:21Z,2022-03-18T16:13:39Z,1098,1,2022-03-18T16:13:41Z,1,Chrome,97.0.4692.91,CrOS x86_64 14324.72.0,1366,768,NA,1.7786458333333333,462,77,281,90,55,81,-0.4438302191713712,-0.22581074576717747,-0.473525144939914,-0.10011617867533498,-0.12080228302533408,-0.19757651903955317,2,1,2,1,2,1,1,3,1,2,3,2,2,1,2,2,2,1,2,2,0.9333020044867296,0,0,2,4,4,1.75,0,3,1,2,1,1,1,2,1,1,1,2,2,1,2,2,1,2,1,1,1,2,1,1,3,2,0,0,0,0,1,5,1,2,2,1,1,1,1,1,1,1,1,1,1,1,1,1,1,1,1,2,1,1,1,2,1,1,2,2,1,1,1,2,1,1,1,1,1,1,1,1.7879308422578029,1.5946338585572373,1.25,0,1,0,1.5333333333333334,0,1.6666666666666667,0,1,0,1.3333333333333333,0,1.4285714285714286,0,1,0,1.2972972972972974,0,2,0,0,-1.081339260953819,-1.1159475867206134,-0.18024366757246235,-0.6480956271465379,1,1,3,1,1,1,2,1,1,1.5275252316519468,1.4285714285714286,0,1,-0.7091149005366146,5,5,5,5,4,4,5,6,3,5,4,1.4638501094227998,4.5,4.714285714285714,0,0.7195717946859974,0,1.1259050390736665,2,2,2,2,2,5,4,5,5,4,5,4,5,5,3,5,5,4,4,4,1.5946338585572373,2,0,4.6,0,4.4,0,4.4,0,4.466666666666667,0,2,2,1,1,2,1,2,3,1,3,3,2,3,3,1,3,2,2,2,2,0.812727700887249,2.05,0,I lived with my mother and father an equal amount of time (joint custody),0,"White, Caucasian, Anglo, European American",0,27,1,2,NA,1,3,4,transcriber,6,123,67,2,5,2,0,0,1,0,0,TRUE,TRUE,TRUE,TRUE,TRUE,2,0.4061343750000087,0.38767812499999127,0.45252812500002254,0.484175,0.4627599999999977,0.5232777777777649,1,1,1,0.625,0.625,0.84375,0.057,0.331,0.518,0.019,2.003,76.76246192557933,1939.437208310804,0.038,0.312,0.566,0.014,1.768,78.75561038561035,1983.240369549915,0.047,0.318,0.64,0.011,1.596,119.37865755981615,2030.3002895654752,105.42105263157896,126.28571428571428,145.0909090909091,FALSE,360,1.0666666666666667,0,1,0,0,3,FALSE
20,2022-03-18T15:57:30Z,2022-03-18T16:15:51Z,1100,1,2022-03-18T16:15:53Z,1,Chrome,99.0.4844.74,Windows NT 10.0,1920,1080,NA,1.7777777777777777,512,59,310,65,50,66,-0.34102523057914097,-0.3252023481511861,-0.3681603272075728,-0.4084328255013442,-0.22333163907425438,-0.3661498575201878,2,3,1,1,3,1,1,4,1,3,4,1,1,1,2,3,1,1,3,3,0.6882472016116853,0,1,1,3,3,2,0,1,1,1,1,1,1,1,1,1,1,1,2,2,2,3,1,2,2,1,1,1,1,1,2,2,0,0,0,0,1,2,2,2,5,1,4,4,2,1,1,1,1,2,2,1,1,3,1,1,3,2,1,1,1,4,1,2,2,2,1,1,1,1,1,1,1,1,2,2,2,1.551904767828364,1.7994708216848747,1.25,0,1.75,0,1.3333333333333333,0,2.5555555555555554,0,1.5,0,1.6666666666666667,0,1.4285714285714286,0,1,0,1.7297297297297298,0,1,0,0,-0.8006084509453439,-1.014467473002802,-0.14114775846592847,-0.5778076157343652,1,1,2,1,1,1,1,3,1,1.7320508075688772,1.1428571428571428,0,2,-0.48817982669274074,5,5,5,5,1,1,5,4,3,4,4,2.138089935299395,3.5,3.857142857142857,0,0.32511668744504807,0,0.4212305175141676,2,2,2,3,3,4,2,4,4,2,1,4,2,4,2,2,3,3,2,4,1.0600988273786194,2.4,0,3,0,2,0,3.6,0,2.8666666666666667,0,1,2,2,3,2,2,1,3,3,3,3,3,2,3,2,3,1,3,1,2,0.6863327411532597,2.25,0,"I lived with my mother, but not father, most of the time. & I lived with my mother and father an equal amount of time (joint custody)",1,"White, Caucasian, Anglo, European American",0,23,1,2,NA,1,2,6,Customer Support Representative,2,92,61,1,5,2,0,0,1,0,0,TRUE,TRUE,TRUE,TRUE,TRUE,2,0.4811187500008382,0.4319437499996275,0.4510781249997672,0.5845259259265881,0.47264399999946355,0.5356777777779433,1,1,1,0.84375,0.78125,0.84375,0.056,0.351,0.526,0.022,2.067,56.98339581604526,1959.413656268431,0.038,0.355,0.487,0.013,1.364,109.12004006006123,2082.141159117017,0.057,0.369,0.564,0.009,1.452,128.0507299995129,2032.4519050565143,93.95454545454547,104.92307692307693,161.33333333333334,FALSE,222,0.6577777777777777,0,1,0,0,3,FALSE
21,2022-03-18T15:56:19Z,2022-03-18T16:15:55Z,1176,1,2022-03-18T16:15:57Z,0.8999999761581421,Chrome,99.0.4844.51,Windows NT 10.0,1920,1080,NA,1.7777777777777777,493,81,302,58,52,80,-0.38009112624418845,-0.20372372301517555,-0.39722648382339104,-0.49476148661262676,-0.18231989665468626,-0.20881474160492883,3,3,3,2,4,1,2,3,1,3,3,3,3,2,3,2,2,1,3,3,0.6488856845230502,0,0,2,3,4,2.5,0,2,3,2,3,2,1,2,2,3,1,3,3,1,3,3,2,4,1,1,2,3,2,3,2,2,0,0,0,0,1,2,2,2,2,1,3,2,1,3,1,3,1,3,3,5,4,5,3,5,5,3,1,1,1,2,1,1,2,2,1,3,3,2,1,1,2,2,1,2,1,1.475017178095115,0.990430401872025,2.25,0,1.5,0,2.2666666666666666,0,1.7777777777777777,0,3.4166666666666665,0,1.5,0,2,0,1.3333333333333333,0,2.27027027027027,0,1,0,0,0.19949505970984815,0.0656270706759223,-0.22730066264678367,-0.08083679598543068,2,2,3,1,1,2,1,1,1,1.1547005383792515,1.7142857142857142,0,1,-0.5432457265250663,3,3,3,2,1,1,4,3,9,4,2,0.8997354108424374,6,2.4285714285714284,0,0.09026996568829465,0,-0.49583891084010284,2,3,2,3,2,4,3,4,4,2,3,3,5,3,3,3,3,4,2,3,0.6399404734221844,2.4,0,3.4,0,3,0,3.4,0,3.2666666666666666,0,2,1,1,4,2,2,2,4,4,2,2,2,2,3,1,2,1,3,2,2,0.8583950752789521,2.2,0,I lived with my mother and father an equal amount of time (joint custody),0,"White, Caucasian, Anglo, European American",0,20,1,2,NA,1,2,3,NA,4,120,63,2,5,2,0,0,1,0,0,TRUE,TRUE,TRUE,TRUE,TRUE,2,0.45019032258756697,0.4394531250074506,0.4419437499716878,0.5448285714387894,0.5173838709746638,0.5293689655065537,0.96875,1,1,0.875,0.96875,0.90625,0.065,0.352,0.736,0.019,1.851,20.68208436789645,1875.6401259970003,0.057,0.359,0.778,0.018,1.757,192.58652984780827,2028.2090761493537,0.052,0.371,0.673,0.013,1.591,158.36622518436607,2066.556332845357,97.42105263157895,97.61111111111111,122.38461538461539,FALSE,294,0.8711111111111112,0,1,0,0,3,FALSE
22,2022-03-18T15:49:28Z,2022-03-18T16:16:52Z,1643,1,2022-03-18T16:16:53Z,0.8999999761581421,Safari,14.1.2,Macintosh,1440,900,no,1.6,836,139,309,96,53,74,0.32515109549851107,0.11653810688885224,-0.3717935967845501,-0.026120183437092773,-0.1618140254449022,-0.2762440769971827,2,2,2,1,2,1,1,2,1,2,3,2,1,1,2,2,2,1,2,2,0.9119095061289915,0,0,2,3,3,1.7,0,3,1,2,1,2,2,2,4,2,3,3,3,2,3,2,1,4,1,1,1,2,2,1,1,2,0,0,0,0,2,1,1,1,1,1,1,1,1,1,1,3,1,2,1,1,1,2,3,2,1,2,1,1,1,2,2,1,2,1,1,1,1,1,1,2,1,2,1,2,1,1.745865987997947,1.0600988273786194,1.625,0,1.5,0,2.3333333333333335,0,1.1111111111111112,0,1.5833333333333333,0,1.5,0,1.1428571428571428,0,1.3333333333333333,0,1.3513513513513513,0,1,0,0,-0.8028016603985353,-0.5793419854046268,-0.22730066264678367,-0.4033213240257052,1,2,1,1,1,1,1,1,1,1.889822365046136,1.1428571428571428,0,1,-0.874984074548163,5,5,5,5,3,2,4,7,7,6,4,1.4638501094227998,7,4.142857142857143,0,1.384971609293624,0,1.2215823887358657,2,2,2,2,2,4,4,3,4,3,4,4,3,3,4,3,4,5,4,3,0.9258200997725514,2,0,4.2,0,3.4,0,3.4,0,3.6666666666666665,0,2,1,2,4,1,3,1,3,2,1,2,3,2,3,1,3,1,3,2,1,0.7163503994113789,2.05,0,I lived with my mother and father an equal amount of time (joint custody),0,"White, Caucasian, Anglo, European American",0,23,1,2,NA,1,3,6,patient care tech,5,145,65,3,5,2,0,0,1,0,0,TRUE,TRUE,TRUE,TRUE,TRUE,6,0.5058125000000054,0.4622258064515904,0.47840625,0.5772258064516091,0.5019354838709827,0.5390312499999964,1,0.96875,1,0.96875,0.96875,1,0.104,0.308,0.636,0.013,1.266,71.59549885457737,1858.0619843880295,0.052,0.354,0.471,0.022,1.397,159.77663083090295,2025.5762195635084,0.08,0.364,0.581,0.019,1.724,119.88795950177912,1951.531302904209,97.38461538461539,63.50000000000001,90.73684210526316,FALSE,392,1.1614814814814816,0,1,0,3,6,FALSE
23,2022-03-18T15:58:42Z,2022-03-18T16:22:10Z,1408,1,2022-03-18T16:22:11Z,0.8999999761581421,Chrome,99.0.4844.74,Windows NT 10.0,1920,1080,NA,1.7777777777777777,427,47,563,181,77,65,-0.5157937111859324,-0.39146341640719184,0.5510568757676795,1.0221564157713385,0.3303268835899152,-0.3773880800855634,2,3,1,1,2,1,1,3,1,2,3,1,1,1,2,1,1,1,2,3,0.9880869341680844,0,0,5,5,5,1.65,0,3,1,2,3,1,1,1,2,2,1,1,1,3,2,2,2,4,5,1,2,3,3,2,12,1,0,0,2,2,1,2,5,1,2,1,2,2,2,1,1,3,1,5,1,3,3,4,5,4,4,5,2,2,4,1,1,1,4,4,4,3,3,2,1,1,1,2,2,4,4,1.5122125468289127,1.52127765851133,2.75,0,3,0,1.7333333333333334,0,2,0,2.9166666666666665,0,2.5,0,3,0,1,0,2.4864864864864864,0,6,2,0,0.6644554637863846,0.14547382681823176,2.785160802519475,1.4653173146688534,1,1,1,1,1,1,1,3,1,1.9518001458970664,1,0,2,-0.571114413698515,5,5,5,5,2,2,5,3,3,3,2,1.8126539343499315,3,4.142857142857143,0,-0.665444751374891,0,-0.027304718746708312,4,3,4,5,3,1,2,2,3,2,3,2,3,2,3,2,3,4,3,1,1.0327955589886444,3.8,0,2.6,0,2.4,0,2.2,0,2.4,0,3,2,3,3,3,2,3,3,4,2,2,3,2,2,1,3,2,3,3,3,0.6805570473787206,2.6,0,I lived with my mother and father an equal amount of time (joint custody),0,"White, Caucasian, Anglo, European American",0,27,1,2,NA,1,2,3,Entertainment Producer,3,115,65,1,5,2,0,0,1,0,0,TRUE,TRUE,TRUE,TRUE,TRUE,1,0.46869999999552964,0.4836937499977648,0.47240624999999997,0.5709821428571429,0.5520419354823328,0.5468800000111262,1,1,1,0.875,0.96875,0.9375,0.061,0.334,0.467,0.021,1.86,80.68816855839738,1927.4872478422876,0.081,0.318,0.499,0.014,1.463,70.30011352330726,1893.6950112972736,0.067,0.319,0.485,0.011,1.687,48.9512644043132,1907.2760228161267,88.57142857142857,104.5,153.36363636363637,FALSE,358,1.0607407407407408,0,1,0,6,9,FALSE
24,2022-03-18T16:05:05Z,2022-03-18T16:23:38Z,1113,1,2022-03-18T16:23:39Z,0.8999999761581421,Chrome,99.0.4844.74,Macintosh,1440,900,no,1.6,492,67,286,73,47,83,-0.38214722601603307,-0.28102830264718226,-0.4553587970550276,-0.30977149851702124,-0.28484925270360656,-0.1751000739088019,3,3,3,3,3,3,4,3,2,3,3,3,3,2,3,3,3,2,3,3,0.5982430416161189,0,0,2,4,4,2.9,0,3,3,3,3,2,2,2,2,2,2,2,2,2,2,2,3,2,3,1,1,1,1,1,1,1,0,0,1,1,2,3,1,1,1,1,1,1,1,2,1,1,2,2,2,2,2,2,2,1,3,3,2,3,1,3,2,1,2,1,1,3,2,1,2,4,2,3,4,4,2,1.4436357172375875,0.8618916073713346,1.625,0,3.25,0,2.2666666666666666,0,1.3333333333333333,0,1.8333333333333333,0,2.3333333333333335,0,1.5714285714285714,0,2.6666666666666665,0,1.8108108108108107,0,1,1,0,-0.5045251747645307,-0.4078484598970072,1.075134678069687,0.33364310908634,2,2,5,2,2,2,2,1,1,0.8997354108424374,2.4285714285714284,0,1,-0.1285727914961955,2,3,3,2,1,1,2,3,9,1,1,1.1126972805283737,6,2,0,-0.8944165583184731,0,-1.3278091742878089,3,3,3,4,4,2,4,4,3,3,5,3,3,4,3,4,4,4,4,4,0.9611501047232549,3.4,0,3.6,0,3.6,0,3.6,0,3.6,0,2,3,2,3,3,3,1,4,2,2,2,4,2,2,1,4,2,2,1,2,0.6708203932499369,2.35,0,"I lived with my mother, but not father, most of the time.",0,"Hispanic of Latino (e.g., Mexican American, Central American, and others)",0,20,1,2,NA,1,2,4,student,1,135,61,4,5,2,0,0,0,0,0,TRUE,TRUE,TRUE,TRUE,TRUE,3,0.5048354838707394,0.4213812500000349,0.45843225806458826,0.5926033333334451,0.5228766666665052,0.5464548387096053,0.96875,1,0.96875,0.967741935483871,0.9375,0.96875,0.064,0.31,0.443,0.014,1.607,166.3985362255837,2042.8361259625506,0.063,0.32,0.632,0.016,1.89,62.02130621395311,1909.7949192429812,0.063,0.359,0.454,0.021,2.002,89.50978984818381,1964.8579101949517,114.78571428571428,118.12499999999999,95.33333333333331,FALSE,432,1.28,0,1,0,0,3,FALSE
25,2022-03-18T15:58:17Z,2022-03-18T16:24:25Z,1567,1,2022-03-18T16:24:26Z,0.8999999761581421,Chrome,99.0.4844.74,Windows NT 10.0,1280,720,NA,1.7777777777777777,718,98,394,99,74,113,0.0825313224208477,-0.10985387631916742,-0.06296568274148112,0.01087781418202833,0.268809269960563,0.16204660305246732,3,3,3,2,4,1,2,3,1,3,4,2,2,2,3,3,2,1,4,4,0.5712405705774795,0,0,2,3,2,2.6,0,5,3,4,3,4,3,4,3,3,2,4,4,3,4,4,4,4,4,1,2,4,4,4,6,2,0,0,0,0,4,2,4,3,4,2,3,3,3,4,3,3,1,4,3,4,4,4,4,4,4,5,1,1,1,2,1,1,3,3,1,3,3,3,2,3,2,2,2,2,2,1.068242079840118,0.8837151016885368,3.375,0,2,0,3.533333333333333,0,3.111111111111111,0,3.5,0,1.8333333333333333,0,2.4285714285714284,0,2.3333333333333335,0,2.8378378378378377,0,3,0,0,1.2982929957586449,1.3576301851510464,0.3837307525869902,0.8706804688690183,4,5,5,5,5,4,4,4,2,1.6035674514745464,4.571428571428571,0,3,1.8890545093012616,3,3,3,4,1,1,2,1,5,2,2,1.2535663410560174,3,2.4285714285714284,0,-0.8792700537047221,0,-1.0863755714106227,2,3,3,3,3,4,4,4,4,2,5,4,4,3,4,5,4,5,4,3,1.1832159566199232,2.8,0,4.4,0,3.8,0,3.6,0,3.933333333333333,0,1,2,2,2,3,1,3,2,1,2,3,2,2,2,2,2,1,2,2,3,0.7677718959499145,2,0,I lived with my mother and father an equal amount of time (joint custody),0,"Hispanic of Latino (e.g., Mexican American, Central American, and others)",0,26,1,2,NA,1,2,7,social worker,3,165,68,2,5,2,0,0,1,0,0,TRUE,TRUE,TRUE,TRUE,TRUE,4,0.5096516129032318,0.5226516129032468,0.48408437499999124,0.5390375000000349,0.5389312500000087,0.5409999999999845,0.96875,0.96875,1,1,1,0.9375,0.076,0.307,0.451,0.014,1.606,80.91447919334884,1923.3886198142425,0.144,0.274,0.583,0.061,1.427,142.3119049264371,1969.3737596930987,0.082,0.328,0.453,0.057,1.981,231.64021289392755,2058.9892723792877,114.71428571428572,23.393442622950822,34.75438596491228,FALSE,382,1.1318518518518519,0,1,0,0,3,FALSE
26,2022-03-18T15:52:31Z,2022-03-18T16:25:17Z,1966,1,2022-03-18T16:25:18Z,0.800000011920929,Firefox,98.0,Windows NT 10.0,1600,900,Nothing to say. Thanks.,1.7777777777777777,725,174,447,89,93,229,0.09692402082375992,0.309799555968869,0.1295976048383148,-0.11244884454837535,0.6584208229464601,1.4656804206360416,2,1,3,2,3,1,1,1,2,1,2,1,2,1,2,2,1,1,4,1,1.1742858972247996,0,1,4,4,3,1.7,0,1,2,2,2,4,3,4,3,4,3,4,2,5,2,2,4,2,3,4,3,4,4,4,1,1,1,0,1,1,2,2,3,1,3,2,2,2,3,3,3,4,3,3,2,5,2,3,1,2,2,2,2,3,3,3,3,3,4,1,2,4,2,1,1,2,1,4,4,5,2,1.0766425401028696,0.8997354108424374,3.5,0,3.75,0,2.8666666666666667,0,2.2222222222222223,0,2.75,0,2.6666666666666665,0,2.4285714285714284,0,1.3333333333333333,0,2.4324324324324325,0,1,1,0,1.1162566111437744,0.944138055128374,1.2474404864313975,1.0957892707798857,1,2,3,5,4,4,4,2,2,1.0690449676496976,3.2857142857142856,0,2,0.7558389783938718,4,4,4,4,4,4,2,6,6,1,3,0,6,3.7142857142857144,0,-0.20799532428392437,0,0.01911490539693486,1,1,1,1,1,2,4,2,2,4,2,5,3,4,5,5,4,3,5,2,0.990430401872025,1,0,3.2,0,4.2,0,3,0,3.466666666666667,0,3,1,2,2,3,3,2,1,1,1,1,2,2,2,1,2,1,2,1,2,0.9445132413883326,1.75,0,I lived with my mother and father an equal amount of time (joint custody),0,"White, Caucasian, Anglo, European American",0,27,1,2,NA,1,3,6,Student,2,105,64,4,5,2,0,0,1,0,0,TRUE,TRUE,TRUE,TRUE,TRUE,6,0.71653125,0.62021875,0.63859375,0.788258064516129,0.69903125,0.74978125,1,1,1,1,1,1,0.204,0.323,0.66,0.013,1.626,19.878847320480528,1800.3097217638601,0.233,0.242,0.624,0.02,1.646,18.41124513679298,1799.6187342320447,0.218,0.277,0.502,0.017,1.459,33.42418258009004,1815.0336131129018,125.07692307692308,82.3,85.82352941176471,TRUE,340,1.0074074074074075,0,1,0,0,3,FALSE
27,2022-03-18T16:00:10Z,2022-03-18T16:26:38Z,1588,1,2022-03-18T16:26:39Z,0.8999999761581421,Chrome,99.0.4844.74,Windows NT 10.0,1366,768,No,1.7786458333333333,581,108,561,88,83,93,-0.1991543463218632,-0.05463631943916262,0.543790336613725,-0.12478151042141572,0.4533621108486195,-0.06271784825504549,2,2,2,1,2,1,2,2,1,3,3,2,2,2,3,3,2,1,3,3,0.6488856845230502,0,1,1,3,3,2.1,0,2,2,2,2,2,3,3,3,2,3,3,3,2,3,2,2,3,1,2,2,2,2,2,1,1,2,1,3,1,2,3,2,2,2,1,1,1,2,1,1,1,2,3,2,2,3,3,3,4,3,3,1,1,1,3,1,3,3,1,1,2,3,1,1,1,1,2,2,2,2,1.4072954488949647,0.7559289460184544,2,0,2,0,2.466666666666667,0,1.7777777777777777,0,2.3333333333333335,0,1.6666666666666667,0,2,0,1,0,1.9189189189189189,0,1,1,1,-0.1908962229581874,-0.10960312568564741,1.5505036462945683,0.7204502603044605,3,2,4,2,1,3,3,3,1,0.7559289460184544,2.5714285714285716,0,2,0.34116604336500117,4,4,4,4,3,3,4,2,1,3,3,0.7867957924694432,1.5,3.7142857142857144,0,-0.5931788417242938,0,-0.2154963365799022,2,2,2,3,3,4,4,4,4,3,4,4,2,4,4,3,3,3,3,3,0.7988086367179802,2.4,0,3.6,0,3,0,3.8,0,3.466666666666667,0,2,2,3,2,2,2,2,3,2,2,2,2,2,1,1,3,1,2,2,2,0.5619514869490163,2,0,I lived with my mother and father an equal amount of time (joint custody),0,"White, Caucasian, Anglo, European American",0,25,1,2,NA,1,3,4,Self employed,3,103,61,4,5,2,0,0,0,0,0,TRUE,TRUE,TRUE,TRUE,TRUE,5,0.5637124999999069,0.518234374998603,0.56959375,0.6449935483874814,0.55235624999972055,0.5931656249989755,1,1,1,0.96875,1,1,0.072,0.417,0.451,0.095,1.224,54.73763295862984,1835.6408915692655,0.065,0.375,0.488,0.042,1.939,90.53831585536706,1874.9266648081496,0.071,0.381,0.345,0.031,2.058,96.0656088398025,1921.8800096622315,12.884210526315789,46.166666666666664,66.38709677419354,FALSE,368,1.0903703703703704,0,1,0,0,3,FALSE
28,2022-03-18T15:53:32Z,2022-03-18T16:29:18Z,2145,1,2022-03-18T16:29:19Z,0.8999999761581421,Chrome,99.0.4844.51,Macintosh,1440,900,NA,1.6,666,248,818,134,104,118,-0.024385865715071772,0.7184094768809045,1.4775406178968864,0.4425211197384412,0.8839854062540847,0.2182377158793455,4,3,4,3,4,2,2,4,1,3,4,4,2,2,4,4,3,2,4,4,0.9880869341680844,0,0,5,3,3,3.15,0,4,2,3,3,5,3,4,3,2,2,3,3,3,3,3,4,4,5,1,2,3,4,4,5,1,2,0,2,0,1,2,3,3,4,1,3,1,4,3,3,3,3,3,3,1,3,4,4,5,5,5,3,4,3,5,5,2,4,3,2,1,2,2,3,3,3,5,3,3,2,1.1170262968022497,0.7988086367179802,3.375,0,3.25,0,3.066666666666667,0,2.4444444444444446,0,3.3333333333333335,0,4.166666666666667,0,2.2857142857142856,0,3,0,3.027027027027027,0,3,0,0,1.4211127251373528,1.2364833827282329,0.8144952734912662,1.0254893281097495,4,4,3,2,3,3,3,1,2,0.6900655593423543,3.142857142857143,0,1.5,0.4795022674603866,3,3,3,3,2,2,2,4,3,NA,2,0.6900655593423543,3.5,2.5714285714285716,0,-0.7825102850053112,1,-0.9500375355428525,2,2,2,2,2,4,4,5,4,3,5,4,4,4,4,3,5,5,3,3,1.2649110640673518,2,0,4.6,0,3.4,0,4,0,4,0,2,2,1,2,3,1,3,3,2,2,3,2,2,1,2,2,1,1,2,3,0.7880689256524124,2,0,"I lived with my mother, but not father, most of the time. & I lived with my extended family on mother's side (grandparents, aunts ,uncles, cousins)",1,Black or African American & Filipino,1,24,1,2,NA,1,2,7,Graduate Student,2,120,64,3,5,2,0,1,3,0,1,TRUE,TRUE,TRUE,TRUE,TRUE,3,0.5208468750002794,0.48423750000074506,0.5291812500013039,0.6165258064524781,0.5484366666689515,0.6082548387108311,1,1,1,1,0.9375,0.96875,0.082,0.387,0.646,0.016,1.8,109.13449568231933,1932.6572494053132,0.057,0.388,0.556,0.033,2.048,63.16480797240539,1931.2262494237427,0.141,0.368,0.919,0.009,1.151,67.861433469774,1855.9235944355703,112.5,62.06060606060606,127.8888888888889,FALSE,374,1.108148148148148,0,1,0,3,6,FALSE
30,2022-03-18T15:48:45Z,2022-03-18T16:31:42Z,2577,1,2022-03-18T16:31:43Z,0.8999999761581421,Chrome,99.0.4844.51,Windows NT 10.0,1920,1080,NA,1.7777777777777777,469,79,452,67,41,71,-0.429437520768459,-0.2147672343911765,0.14776395272320123,-0.3837674937552634,-0.40788447996231086,-0.3099587446933096,3,3,2,2,3,1,2,4,1,3,3,2,3,1,3,3,3,1,3,4,0.6155870112510925,0,0,3,2,2,2.5,0,3,3,2,3,3,3,3,3,3,2,2,3,1,3,2,3,3,1,1,2,2,3,2,4,1,2,0,1,0,2,3,4,3,3,2,3,2,3,2,2,1,1,4,1,1,4,2,2,2,2,2,1,3,2,1,1,1,3,3,1,4,4,3,1,3,3,2,2,2,2,1.1455620071878747,0.7037315505489968,2.125,0,2,0,2.6,0,2.7777777777777777,0,2,0,1.6666666666666667,0,2.7142857142857144,0,2.3333333333333335,0,2.2972972972972974,0,2,0,0,0.13589198556730314,0.1683855191595593,0.16436794915095845,0.1663767341552589,2,2,3,1,1,2,3,8,5,1.1126972805283737,2,0,6.5,1.7500468106913045,2,3,3,2,1,1,2,4,9,NA,6,1.1126972805283737,6.5,2,0,2.089587539198367,1,0.4897164354127068,2,1,2,1,2,5,5,5,5,4,4,5,5,4,5,5,5,4,4,3,1.709915063331955,1.6,0,4.6,0,4.6,0,4.4,0,4.533333333333333,0,2,1,2,2,1,3,1,4,2,2,2,4,2,2,1,4,1,3,1,2,0.7326950970650465,2.1,0,"I lived with my mother, but not father, most of the time.",0,"White, Caucasian, Anglo, European American",0,29,0,1,NA,1,6,6,Self-employed,7,135,69,3,5,2,0,0,0,0,0,TRUE,TRUE,TRUE,TRUE,TRUE,1,0.5180156249962747,0.4501903225760306,0.4826781249977648,0.5479714285816465,0.48802903226498634,0.5110344827462887,1,1,1,0.9032258064516129,0.96875,0.9354838709677419,0.042,0.42,0.71,0.056,2.006,51.13123685011743,1895.150939244188,0.054,0.391,0.967,0.053,2.157,179.77174321798435,2017.3843523017458,0.039,0.456,0.646,0.02,1.227,90.57124640951747,2007.7254086912274,35.82142857142857,40.69811320754717,61.35,FALSE,168,0.49777777777777776,0,1,0,3,6,FALSE
31,2022-03-18T16:13:19Z,2022-03-18T16:31:53Z,1114,1,2022-03-18T16:31:54Z,0.8999999761581421,Chrome,99.0.4844.74,Windows NT 10.0,1920,1080,NA,1.7777777777777777,498,73,275,65,31,67,-0.3698106273849654,-0.24789776851917938,-0.49532476240177764,-0.4084328255013442,-0.6129431920601515,-0.35491163495481215,2,2,1,1,2,1,1,2,1,2,2,1,1,1,2,2,1,1,2,2,1.025978352085154,0,1,2,4,4,1.5,0,3,1,2,2,1,2,3,3,3,2,3,3,3,3,3,2,3,1,1,2,2,1,2,1,2,0,0,0,0,2,3,2,3,3,2,2,2,2,2,2,3,1,2,2,3,3,4,3,3,3,3,1,1,1,3,1,1,2,2,1,2,1,2,1,1,3,1,2,2,2,1.1657010160666665,0.9154754164341269,1.75,0,1.75,0,2.466666666666667,0,2.3333333333333335,0,2.5833333333333335,0,1.6666666666666667,0,1.5714285714285714,0,1.6666666666666667,0,2.108108108108108,0,1,0,0,-0.23037399311562928,-0.13615315543740092,-0.14114775846592847,-0.1386504569516647,1,2,2,2,1,2,2,2,3,1.3972762620115438,1.7142857142857142,0,2.5,0.036960645258067054,5,5,5,5,5,5,5,1,3,6,4,1.5118578920369088,2,5,0,0.481822584738033,0,1.13589983848169,2,3,3,2,2,4,4,3,4,3,5,4,3,4,4,4,4,4,3,3,0.9611501047232549,2.4,0,4.2,0,3.4,0,3.6,0,3.7333333333333334,0,2,1,1,4,1,1,1,1,1,1,1,1,1,1,1,1,1,1,1,1,1.1002392084403616,1.2,0,I lived with my mother and father an equal amount of time (joint custody),0,"White, Caucasian, Anglo, European American",0,25,0,1,NA,1,3,6,Analyst,5,160,69,3,5,2,0,0,1,0,0,TRUE,TRUE,TRUE,TRUE,TRUE,2,0.7082838709700492,0.5922517241362868,0.5357633333484332,0.7748451612880153,0.6267733333468437,0.638209999994437,1,1,1,0.96875,0.9375,0.9375,0.062,0.375,0.314,0.016,1.253,132.93068633260717,2001.869000013048,0.068,0.363,0.32,0.014,1.208,48.69032952874677,1914.064810343716,0.086,0.332,0.258,0.019,1.967,81.44568220800656,1908.3373576583297,78.31249999999999,86.28571428571428,103.52631578947368,FALSE,362,1.0725925925925925,0,1,0,3,6,FALSE
32,2022-03-18T16:09:59Z,2022-03-18T16:32:17Z,1338,1,2022-03-18T16:32:19Z,0.8999999761581421,Chrome,99.0.4844.51,Macintosh,1440,900,NA,1.6,528,86,398,103,80,86,-0.30812763422962725,-0.17611494457517315,-0.04843260443357199,0.0602084776741898,0.39184449721926734,-0.14138540621267498,2,3,1,1,3,1,1,3,1,3,3,1,1,1,3,3,1,1,2,2,0.7451598203705946,0,0,1,3,3,1.85,0,4,3,1,3,1,1,3,1,1,1,3,4,2,3,3,1,5,1,1,2,3,2,3,3,2,0,0,0,0,2,2,2,2,3,1,1,2,3,2,3,5,1,5,1,4,2,3,5,4,2,4,1,1,2,2,2,1,3,2,3,3,1,1,1,2,3,2,3,1,1,1.319750636196756,0.9258200997725514,2.25,0,1.75,0,2.2666666666666666,0,2,0,3.0833333333333335,0,2,0,2,0,2,0,2.3513513513513513,0,2,0,0,0.252132086586437,0.1010271103449266,0.07821504497010326,0.08962107765751492,3,2,4,1,1,1,1,2,1,0.7867957924694432,1.8571428571428572,0,1.5,-0.2669090155915809,3,3,4,4,1,1,2,9,9,NA,1,1.3451854182690985,9,2.5714285714285716,0,0.1928696799855022,1,-0.35594382533822333,3,3,2,3,2,5,3,2,4,2,4,2,2,3,3,2,3,4,3,2,0.9411239481143202,2.6,0,3.6,0,2.4,0,2.8,0,2.933333333333333,0,2,1,1,3,1,1,2,3,1,1,1,2,1,1,1,2,1,2,1,2,0.6882472016116853,1.5,0,I lived with my mother and father an equal amount of time (joint custody),0,"Asian or Asian American (e.g., Chinese, Japanese, and others)",0,25,1,2,NA,1,2,6,Educator,2,160,62,2,5,2,0,0,1,0,0,TRUE,TRUE,TRUE,TRUE,TRUE,2,0.5832250000000495,0.5178999999999796,0.4494812500000262,0.6122031249999854,0.5608133333333457,0.5411937500000058,1,1,1,1,0.967741935483871,1,0.092,0.328,0.735,0.024,2.043,65.67567006907292,1849.920267810942,0.057,0.388,0.465,0.027,1.664,89.2479815389652,1913.6918642080225,0.155,0.347,0.648,0.038,1.288,33.68846986447193,1816.3316062174529,85.125,61.629629629629626,33.89473684210527,FALSE,438,1.2977777777777777,0,1,0,3,6,FALSE
33,2022-03-18T16:04:36Z,2022-03-18T16:34:36Z,1799,1,2022-03-18T16:34:38Z,0.8999999761581421,Chrome,99.0.4844.74,Windows NT 10.0,1536,864,none,1.7777777777777777,546,250,393,91,34,363,-0.2711178383364244,0.7294529882569054,-0.0665989523184584,-0.08778351280229461,-0.5514255784307993,2.971602244396377,3,3,2,2,3,2,3,3,2,4,4,3,1,2,3,3,3,1,4,4,0.6708203932499369,0,1,1,3,1,2.75,0,5,3,5,4,4,5,5,5,5,5,5,5,1,5,5,5,5,5,4,5,5,5,5,6,1,4,0,NA,NA,5,5,5,5,5,5,5,5,5,4,4,5,4,5,4,3,5,5,5,5,5,5,1,1,1,1,1,4,1,1,1,3,1,2,2,1,5,1,4,1,2,1.6608004871923232,1.889822365046136,4.875,0,2,0,4.466666666666667,0,5,0,4.5,0,1.6666666666666667,0,1.8571428571428572,0,2.6666666666666665,0,3.5135135135135136,0,3,NA,0,2.7107198836137854,2.7150250395703024,0.5896307986656166,1.6523279191179596,1,1,1,3,1,1,1,8,6,1.9023794624226837,1.2857142857142858,0,7,1.5287759995901447,5,5,5,5,4,3,4,3,1,5,4,1.2149857925879117,2,4.428571428571429,0,0.2679972824082019,0,0.6960503877431934,4,4,4,2,3,3,2,2,3,2,5,3,5,2,2,2,4,5,2,3,1.0600988273786194,3.4,0,4,0,2.6,0,2.4,0,3,0,2,2,2,3,2,3,2,4,1,2,1,3,2,1,1,4,2,3,4,3,0.8255779474818965,2.35,0,"I lived with my father, but not mother, most of the time.",0,"White, Caucasian, Anglo, European American",0,24,0,2,NA,1,1,4,none,1,130,68,1,5,2,0,0,0,0,0,TRUE,TRUE,TRUE,TRUE,TRUE,3,0.6284366666475931,0.8065031250417233,0.8537343750298023,0.7555037037001716,1.0356031250059605,1.3286551723809077,0.9375,1,1,0.84375,1,0.90625,0.093,0.491,0.147,0.254,1.304,447.64040238168104,2355.9855475930094,0.141,0.353,0.304,0.003,0.942,42.783984338082234,1826.9926412222928,0.056,0.477,0.249,0.016,1.876,204.28496306707655,2234.880385914391,5.133858267716535,314,117.24999999999999,TRUE,304,0.9007407407407407,1,1,0,0,3,FALSE
34,2022-03-18T16:19:49Z,2022-03-18T16:35:16Z,927,1,2022-03-18T16:35:17Z,0.8999999761581421,Chrome,99.0.4844.74,Windows NT 10.0,1920,1080,"No, everything was fine.",1.7777777777777777,475,52,198,57,38,58,-0.41710092213739136,-0.3638546379671895,-0.7750865198290283,-0.5070941524856671,-0.46940209359166307,-0.4560556380431929,1,2,2,2,1,1,1,2,1,1,2,2,3,1,1,2,1,3,1,2,1.142481141154959,0,1,2,4,4,1.6,0,1,1,2,1,1,1,1,1,1,1,1,1,2,1,2,1,2,1,1,1,1,1,1,1,2,0,0,0,0,1,3,1,2,1,2,1,1,2,2,2,1,2,1,2,1,1,1,2,3,2,1,1,1,1,3,2,1,1,1,1,1,1,1,1,1,1,1,1,1,1,1.6725122711948326,1.9073791542572855,1.125,0,1,0,1.2,0,1.5555555555555556,0,1.6666666666666667,0,1.5,0,1,0,1,0,1.4324324324324325,0,1,0,0,-1.0747596325942455,-1.257056078179005,-0.39960647100849406,-0.8283312745937496,1,1,2,1,1,1,1,3,1,1.7320508075688772,1.1428571428571428,0,2,-0.48817982669274074,5,5,5,5,4,4,4,7,6,5,4,1.1126972805283737,6.5,4.571428571428571,0,1.0808314045082337,0,1.2685418045122843,4,3,3,2,2,4,4,2,4,4,1,4,5,4,4,4,5,4,4,3,1.2344267996967353,2.8,0,3.6,0,4.2,0,3.4,0,3.7333333333333334,0,1,1,1,1,2,1,1,1,1,1,1,2,2,2,1,1,1,1,1,2,1.118033988749895,1.25,0,I lived with my mother and father an equal amount of time (joint custody),0,"White, Caucasian, Anglo, European American",0,21,0,1,NA,1,4,4,Software Engineer,5,150,70,1,5,2,0,0,1,0,0,TRUE,TRUE,TRUE,TRUE,TRUE,3,0.4041093749997672,0.39789687500009313,0.3858774193544542,0.5227466666661202,0.4398741935479545,0.4879233333339294,1,1,1,0.9375,1,0.9375,0.072,0.261,0.608,0.012,1.684,70.37362142620259,1914.577952216318,0.075,0.278,0.682,0.032,1.825,70.31019331579509,1854.8447609546715,0.078,0.286,0.728,0.011,1.607,121.9219989352809,1976.635294360268,140.33333333333331,57.03125,146.0909090909091,FALSE,434,1.285925925925926,0,1,0,0,3,FALSE
35,2022-03-18T16:18:48Z,2022-03-18T16:37:21Z,1113,1,2022-03-18T16:37:22Z,0.8999999761581421,Chrome,99.0.4844.74,Windows NT 10.0,3440,1440,NA,2.388888888888889,511,54,319,67,50,57,-0.34308133035098554,-0.3528111265911885,-0.33546090101477727,-0.3837674937552634,-0.22333163907425438,-0.46729386060856853,2,2,1,1,3,1,1,3,1,3,3,1,1,1,2,2,1,1,2,3,0.8506963092234007,0,0,1,2,1,1.75,0,5,5,4,5,5,5,5,5,5,5,3,5,2,5,5,3,5,5,2,3,5,5,5,1,1,2,1,0,0,5,5,5,5,5,5,5,5,5,5,5,5,3,5,1,4,5,5,5,5,5,5,4,5,3,5,4,3,1,1,1,5,5,5,1,4,5,1,1,1,3,1.8355842038352175,1.869555587629877,4.125,0,1.5,0,4.6,0,5,0,4.416666666666667,0,4.333333333333333,0,3,0,3.3333333333333335,0,4.1891891891891895,0,1,0,1,2.6624692756435784,2.740788401773856,0.6788328264823734,1.7098106141281149,2,1,1,1,1,1,1,4,3,1.7320508075688772,1.1428571428571428,0,3.5,0.0920265450903926,1,2,4,2,1,1,1,6,2,1,1,1.6035674514745464,4,1.7142857142857142,0,-1.2556761681407096,0,-1.7026539654484583,5,5,5,5,5,2,1,3,3,5,1,1,4,1,1,1,4,4,1,5,1.6388149028228556,5,0,2.4,0,2.4,0,2.6,0,2.466666666666667,0,4,4,1,4,4,4,4,4,4,4,4,4,3,3,4,4,4,4,4,4,1.3088765773505315,3.75,0,"I lived with my mother, but not father, most of the time.",0,"White, Caucasian, Anglo, European American",0,28,0,1,NA,1,1,4,unemployed,2,380,70,1,5,2,0,0,1,0,0,TRUE,TRUE,TRUE,TRUE,TRUE,5,0.5655034482807949,0.5675250000022352,0.5994781250059604,0.5825655172405572,0.5952482758637132,0.6641724137807714,0.90625,1,1,0.9354838709677419,0.9354838709677419,0.90625,0.057,0.448,0.383,0.017,1.635,64.82912295918958,1954.008007425507,0.06,0.376,0.354,0.026,1.933,101.53000122482244,1946.702546905205,0.05,0.395,0.31,0.02,1.62,179.9627250408632,2150.630276528859,96.17647058823529,74.34615384615385,81,FALSE,382,1.1318518518518519,0,1,0,3,6,FALSE
36,2022-03-18T16:15:05Z,2022-03-18T16:38:51Z,1425,1,2022-03-18T16:38:52Z,0.8999999761581421,Chrome,99.0.4844.51,Windows NT 10.0,1600,900,NA,1.7777777777777777,597,88,314,186,66,78,-0.16625674997234952,-0.1650714331991722,-0.3536272488996637,1.0838197451365403,0.10476230028229055,-0.2312911867356801,1,1,1,1,1,1,1,1,1,1,1,1,2,1,1,1,1,1,1,1,1.5035046776746235,0,1,1,4,3,1.05,0,4,2,1,3,2,1,3,3,1,1,1,3,1,4,1,4,4,5,1,3,4,5,3,0,1,2,2,2,2,1,2,1,3,4,1,1,1,2,1,1,1,1,1,2,3,1,1,3,4,4,5,5,1,1,1,1,2,1,1,1,1,1,3,1,1,1,1,2,1,1,1.7071656083738376,1.2649110640673518,3.625,0,1.25,0,2.066666666666667,0,1.7777777777777777,0,1.9166666666666667,0,2.3333333333333335,0,1.4285714285714286,0,1,0,1.7837837837837838,0,0,2,2,0.776309145899137,0.3662324075318823,2.6781806308956124,1.5222065192137473,1,1,1,1,1,1,2,1,3,1.889822365046136,1.1428571428571428,0,2,-0.48817982669274074,5,5,5,5,5,5,5,6,6,6,4,1.5118578920369088,6,5,0,1.2043418043825058,0,1.5759787198402806,2,4,3,2,4,4,3,3,4,4,3,2,2,5,4,3,4,4,5,1,1.121223821162776,3,0,3.4,0,3.4,0,3.4,0,3.4,0,2,1,2,1,2,2,3,1,2,1,3,1,1,1,1,1,1,1,1,2,1.1652874052533586,1.5,0,I lived with my mother and father an equal amount of time (joint custody),0,"Asian or Asian American (e.g., Chinese, Japanese, and others)",0,23,0,1,NA,1,4,6,Researcher,6,190,69,5,5,2,0,0,2,0,0,TRUE,TRUE,TRUE,TRUE,TRUE,5,0.5453531250022352,0.5642937500048428,0.6520312500000001,0.5845064516144414,0.5262032258010679,0.7032483871021579,1,1,1,0.96875,1,1,0.062,0.484,0.401,0.037,1.808,120.41067535555301,1903.6063627008386,0.063,0.362,0.371,0.196,1.331,123.61854571310667,1905.1257533121695,0.074,0.372,0.474,0.028,2.005,82.6455509048921,1908.7467608811862,48.86486486486487,6.790816326530612,71.60714285714285,FALSE,432,1.28,0,1,0,0,3,FALSE
37,2022-03-18T16:17:21Z,2022-03-18T16:39:03Z,1301,1,2022-03-18T16:39:04Z,0.8999999761581421,Chrome,99.0.4844.74,Macintosh,1440,900,NA,1.6,787,50,238,86,39,57,0.22440220667812544,-0.37489814934319043,-0.6297557367499371,-0.14944684216749646,-0.448896222381879,-0.46729386060856853,2,1,1,1,2,1,1,2,1,2,2,1,1,1,2,2,1,1,2,2,1.0990426455975697,0,1,1,3,3,1.45,0,2,2,2,1,2,2,2,2,2,1,1,1,3,1,2,1,1,1,1,1,1,1,1,1,2,0,0,0,0,1,1,1,1,1,1,1,1,1,1,1,1,1,2,1,1,1,1,1,1,1,1,1,1,1,1,1,1,2,1,1,1,1,1,1,1,1,1,1,1,1,1.923850618213691,1.4375905768565218,1,0,1,0,1.7333333333333334,0,1,0,1.0833333333333333,0,1,0,1.1428571428571428,0,1,0,1.054054054054054,0,1,0,0,-1.401547841119736,-1.2439777301901782,-0.39960647100849406,-0.8217921005993362,1,1,2,1,1,1,2,1,1,1.6761634196950514,1.2857142857142858,0,1,-0.7920494875423887,5,5,5,5,4,4,5,6,6,5,4,1.4638501094227998,6,4.714285714285714,0,0.9905165020526746,0,1.290934619583138,2,2,2,2,2,4,4,4,5,4,5,5,4,5,4,5,5,4,3,4,1.505545305418162,2,0,4.6,0,4,0,4.4,0,4.333333333333333,0,1,1,2,1,1,2,2,2,1,1,2,2,1,1,1,1,2,2,1,2,0.9880869341680844,1.45,0,I lived with my mother and father an equal amount of time (joint custody),0,"White, Caucasian, Anglo, European American",0,29,1,2,NA,1,4,7,Faculty Coordinator,5,145,65,3,5,2,0,0,1,0,0,TRUE,TRUE,TRUE,TRUE,TRUE,2,0.5189218750074506,0.4748406250178814,0.5004750000014901,0.6186781249865889,0.5832586206649912,0.5807374999895691,1,1,1,1,0.9354838709677419,1,0.137,0.34,0.895,0.019,1.783,36.555700101145355,1823.479620768119,0.066,0.354,0.534,0.019,1.87,73.5649245875846,1920.188018919643,0.089,0.358,0.543,0.017,1.645,80.72530303601148,1863.9784202375001,93.84210526315789,98.42105263157896,96.76470588235294,FALSE,416,1.2325925925925925,0,1,0,0,3,FALSE
38,2022-03-18T15:48:50Z,2022-03-18T16:39:18Z,3027,1,2022-03-18T16:39:18Z,1,Chrome,99.0.4844.51,Windows NT 10.0,1536,864,No,1.7777777777777777,950,379,820,157,77,174,0.559546469488796,1.4417594720089673,1.484807157050841,0.7261724348183697,0.3303268835899152,0.8475781795403814,1,1,1,1,1,1,1,1,1,2,1,1,1,1,2,2,1,1,1,2,1.3803127029389886,0,0,2,4,4,1.2,0,5,1,2,2,2,1,2,2,1,1,1,1,3,1,1,1,1,1,1,1,1,1,1,0,2,0,0,0,0,1,1,1,1,1,1,1,1,1,1,2,1,1,2,1,1,1,1,1,1,1,1,1,1,1,2,1,2,1,1,1,1,1,1,1,1,1,1,1,1,1,1.8800357801208292,1.6987390281365427,1,0,1,0,1.7333333333333334,0,1,0,1.1666666666666667,0,1.1666666666666667,0,1.1428571428571428,0,1,0,1.1081081081081081,0,0,0,0,-1.3664564898686766,-1.2203777037441756,-0.6189692744445258,-0.9196734890943508,1,1,2,1,1,1,1,4,1,1.7320508075688772,1.1428571428571428,0,2.5,-0.2947777027650296,5,5,5,5,4,4,5,6,6,4,3,1.4638501094227998,6,4.714285714285714,0,0.43348058270556905,0,0.9516498814090404,1,1,1,1,1,4,2,4,4,3,5,4,4,4,4,4,5,4,2,2,1.162919151265879,1,0,4.4,0,3,0,3.6,0,3.6666666666666665,0,1,1,1,1,1,1,1,1,1,1,2,1,1,1,1,1,1,1,1,1,1.2258187382102494,1.05,0,I lived with my mother and father an equal amount of time (joint custody),0,"Asian or Asian American (e.g., Chinese, Japanese, and others)",0,27,1,2,NA,1,3,7,Engineering,5,176,68,4,5,2,0,0,1,0,0,TRUE,TRUE,TRUE,TRUE,TRUE,3,1.00078125,0.8720483870986969,0.8988870967703481,1.045300000000745,0.9342096774155094,0.9707343750037253,1,1,1,1,0.96875,1,0.064,0.775,0.483,0.021,1.427,40.102934991256575,1821.7499041301928,0.064,0.748,0.476,0.036,1.976,138.46310483511692,1969.4602461898507,0.494,0.376,0.788,0.039,1.891,53.9629841944551,1839.098908174802,67.95238095238095,54.88888888888889,48.48717948717949,TRUE,304,0.9007407407407407,1,1,0,3,6,FALSE
39,2022-03-18T16:22:29Z,2022-03-18T16:40:37Z,1087,1,2022-03-18T16:40:38Z,0.8999999761581421,Chrome,99.0.4844.74,Windows NT 10.0,1920,1080,N/A,1.7777777777777777,485,74,269,81,47,59,-0.3965399244189453,-0.2423760128311789,-0.5171243798636413,-0.2111101715326983,-0.28484925270360656,-0.4448174154778173,1,1,1,1,1,1,2,1,1,1,2,1,1,1,1,2,1,1,2,1,1.3917047478769187,0,1,3,3,4,1.2,0,2,1,2,2,2,2,2,2,2,2,2,2,3,2,2,2,2,1,1,2,2,2,2,2,2,0,0,0,0,1,2,2,2,2,1,1,2,2,2,4,3,1,2,3,1,2,3,3,3,3,2,1,3,1,3,3,1,3,1,1,2,2,2,1,1,1,2,1,2,1,1.3439889531935545,1.0997835284835873,1.75,0,1.5,0,2,0,1.6666666666666667,0,2.5,0,2.1666666666666665,0,1.7142857142857142,0,1,0,1.972972972972973,0,1,0,0,-0.3181023712432777,-0.39890011653623103,-0.22730066264678367,-0.3131003895915073,1,1,3,1,1,1,1,1,1,1.5735915849388864,1.2857142857142858,0,1,-0.7920494875423887,5,5,5,4,3,3,4,1,1,3,2,1.2149857925879117,1,4.142857142857143,0,-1.0267043611971274,0,-0.24734415942600346,2,2,3,2,2,4,3,3,4,2,4,4,4,3,4,4,4,3,4,3,0.8338093878327919,2.2,0,3.8,0,3.4,0,3.4,0,3.533333333333333,0,1,1,1,1,2,1,1,1,1,1,1,2,1,2,1,2,1,2,1,1,1.0399898784932577,1.25,0,I lived with my mother and father an equal amount of time (joint custody),0,"Hispanic of Latino (e.g., Mexican American, Central American, and others)",0,20,0,1,NA,1,3,3,Student,4,135,67,3,5,2,0,0,1,0,0,TRUE,TRUE,TRUE,TRUE,TRUE,6,0.5693612903225641,0.5043437499999928,0.5339935483870757,0.5920999999999806,0.51095806451612,0.5686838709677329,0.96875,1,1,0.967741935483871,0.96875,0.96875,0.07,0.348,0.39,0.028,1.824,94.42188940266787,1920.1532971280183,0.069,0.305,0.37,0.034,1.718,106.10156755212456,1926.6198737476136,0.065,0.372,0.345,0.019,1.363,165.22043672301393,2037.7721172339213,65.14285714285714,50.52941176470588,71.73684210526316,FALSE,304,0.9007407407407407,1,1,0,0,3,FALSE
40,2022-03-18T16:19:29Z,2022-03-18T16:40:50Z,1281,1,2022-03-18T16:40:51Z,0.8999999761581421,Chrome,99.0.4844.51,Macintosh,1792,1120,Thank you!,1.6,646,62,347,57,37,78,-0.06550786115196387,-0.3086370810871847,-0.23372935285941338,-0.5070941524856671,-0.4899079648014471,-0.2312911867356801,2,2,1,1,2,1,1,2,1,2,2,1,2,1,2,2,1,1,2,2,0.998683343734455,1,1,2,3,3,1.55,0,3,3,3,4,3,3,3,3,3,2,2,3,2,3,4,3,3,3,1,2,3,3,3,3,2,0,0,0,0,3,3,3,3,3,3,3,3,3,2,3,2,1,3,2,3,3,3,3,3,3,4,1,1,2,3,3,1,3,2,1,3,2,3,3,4,3,2,2,2,2,0.7652356405615107,0.4879500364742666,2.625,0,2,0,2.933333333333333,0,3,0,2.5833333333333335,0,2.3333333333333335,0,2.142857142857143,0,3.3333333333333335,0,2.6216216216216215,0,2,0,0,0.6710350921459582,0.6738194188781177,0.16436794915095845,0.41909368401453806,3,3,4,2,2,3,3,1,1,0.5345224838248488,2.857142857142857,0,1,0.12023096952112716,2,2,2,2,1,1,2,7,1,2,2,1,4,1.7142857142857142,0,-0.698640248793604,0,-1.3633692272743607,3,3,3,3,3,3,4,2,3,3,5,2,3,3,4,4,4,4,4,3,0.9258200997725514,3,0,3.6,0,3.6,0,3,0,3.4,0,2,2,4,3,4,4,4,3,4,3,4,3,3,4,3,3,4,4,4,4,0.910465468000326,3.45,0,I lived with my mother and father an equal amount of time (joint custody),0,Black or African American,0,24,1,2,NA,1,2,4,Data Analyst,2,150,65,1,5,2,0,0,1,0,0,TRUE,TRUE,TRUE,TRUE,TRUE,1,0.7777709677426085,0.6299156250003726,0.7652437499989755,0.7912468749997206,0.6580125000011176,0.8894781250013039,1,1,1,1,1,1,0.128,0.321,0.29,0.015,1.873,59.007131277694384,1841.0041802880069,0.204,0.332,0.686,0.061,1.293,73.66926638795044,1861.0729829666643,0.102,0.501,0.405,0.033,1.53,120.76734218967052,1904.7533909736842,124.86666666666667,21.196721311475407,46.36363636363636,TRUE,460,1.3629629629629632,0,1,0,0,3,FALSE
42,2022-03-18T16:17:13Z,2022-03-18T16:44:11Z,1618,1,2022-03-18T16:44:12Z,0.8999999761581421,Chrome,99.0.4844.51,Macintosh,1440,900,NA,1.6,745,68,247,124,48,96,0.13804601626065202,-0.2755065469591818,-0.5970563105571416,0.3191944610080375,-0.26434338149382247,-0.029003180558918575,2,3,2,1,2,1,1,2,1,2,3,1,1,1,3,3,1,1,2,3,0.8335087534664907,0,0,4,2,1,1.8,0,4,3,3,3,4,3,4,3,2,4,4,4,2,3,4,2,4,1,1,3,3,3,2,1,2,0,0,0,0,2,4,1,2,3,1,1,1,3,1,1,3,1,2,3,1,2,4,3,4,4,3,1,1,1,1,1,1,1,1,1,2,3,2,1,4,2,1,1,1,1,1.5117160068231352,0.7745966692414834,2.375,0,1,0,3.3333333333333335,0,2,0,2.4166666666666665,0,1.3333333333333333,0,1.5714285714285714,0,2.3333333333333335,0,1.972972972972973,0,1,0,0,0.08764137759709634,0.45610917491374237,-0.39960647100849406,0.028251351952624154,1,1,3,2,1,1,3,3,3,1.4960264830861913,1.7142857142857142,0,3,0.23036276918577817,2,2,2,3,1,1,1,3,3,NA,3,1.3801311186847085,3,1.7142857142857142,0,-0.4031667131627382,1,-1.1833993946441876,4,4,3,3,4,3,3,2,2,1,5,4,3,3,4,4,5,5,3,4,1.245945806357946,3.6,0,4.4,0,2.8,0,3,0,3.4,0,2,1,2,4,1,3,3,4,4,1,3,4,2,3,3,4,3,3,1,2,0.998683343734455,2.65,0,I lived with my mother and father an equal amount of time (joint custody),0,"White, Caucasian, Anglo, European American",0,30,0,1,NA,0,3,5,Student/Security Officer,2,250,73,2,5,2,0,0,1,0,0,TRUE,TRUE,TRUE,TRUE,TRUE,5,0.5473812499921769,0.4657218749988824,0.5327968750037253,0.5997700000027816,0.5739129032300364,0.6080843749940396,1,1,1,0.9375,0.96875,1,0.245,0.229,0.813,0.018,1.625,53.68516965487087,1839.4974057279717,0.06,0.375,0.621,0.014,1.566,136.4821298041559,1971.3064985881429,0.054,0.418,0.407,0.03,1.88,58.84859285943032,1903.9622447880586,90.27777777777779,111.85714285714286,62.666666666666664,FALSE,438,1.2977777777777777,0,1,0,3,6,FALSE
43,2022-03-18T16:27:40Z,2022-03-18T16:44:30Z,1010,1,2022-03-18T16:44:31Z,0.8999999761581421,Chrome,99.0.4844.74,Windows NT 10.0,1280,720,NA,1.7777777777777777,449,53,202,53,32,66,-0.4705595162053511,-0.35833288227918897,-0.7605534415211193,-0.5564248159778286,-0.5924373208503674,-0.3661498575201878,1,2,1,1,2,1,1,2,1,1,2,1,1,1,1,1,1,1,1,2,1.332784974957958,0,1,1,4,3,1.25,0,1,1,2,1,2,1,2,2,1,1,1,1,1,1,2,1,1,1,1,1,1,1,1,1,2,0,0,0,0,1,1,1,1,1,1,1,1,1,2,1,1,1,1,2,1,3,1,1,1,1,1,1,2,1,1,1,1,2,2,1,1,1,1,1,1,1,1,1,1,1,1.8688211504829702,1.791514389985135,1,0,1,0,1.3333333333333333,0,1,0,1.3333333333333333,0,1.1666666666666667,0,1.2857142857142858,0,1,0,1.1891891891891893,0,1,0,0,-1.3138194629920872,-1.3596178597755917,-0.39960647100849406,-0.8796121653920429,3,2,3,2,1,3,3,1,1,0.7867957924694432,2.4285714285714284,0,1,-0.1285727914961955,5,5,5,5,5,5,5,6,7,NA,3,1.5118578920369088,6.5,5,0,0.5451397626206321,1,1.1744656676745362,2,2,2,2,2,4,4,4,5,3,3,5,4,3,5,4,4,4,3,4,1.1872336794093274,2,0,4,0,3.6,0,4.2,0,3.933333333333333,0,2,1,2,3,2,2,2,3,4,2,1,3,2,3,1,3,1,3,2,3,0.7591546545162482,2.25,0,I lived with my mother and father an equal amount of time (joint custody),0,"Asian or Asian American (e.g., Chinese, Japanese, and others) & Filipino",1,28,1,2,NA,0,1,6,unemployed,5,100,60,2,5,2,0,0,1,0,0,TRUE,TRUE,TRUE,TRUE,TRUE,4,0.46940645161223027,0.38555161290543694,0.4652687500002794,0.5346612903221,0.4292586206886275,0.524010000000894,0.96875,1,1,0.96875,0.90625,0.9375,0.055,0.362,0.585,0.021,1.669,21.24721153744618,1864.674843237072,0.044,0.309,0.601,0.022,1.464,56.85588498463746,1945.5218532929944,0.07,0.315,0.458,0.009,1.179,243.565082549341,2117.9642312486676,79.47619047619047,66.54545454545455,131.00000000000003,FALSE,364,1.0785185185185184,0,1,0,0,3,FALSE
45,2022-03-18T16:28:32Z,2022-03-18T16:45:27Z,1014,1,2022-03-18T16:45:27Z,0.8999999761581421,Chrome,99.0.4844.51,Macintosh,1440,900,n/a,1.6,526,85,212,43,45,62,-0.3122398337733165,-0.18163670026317363,-0.7242207457513464,-0.6797514747082323,-0.3258609951231747,-0.41110274778169037,3,3,3,3,3,2,2,3,1,3,3,3,3,2,3,3,1,1,3,3,0.6048053188292994,0,0,3,4,4,2.55,0,2,2,4,2,4,3,2,3,2,2,3,2,3,2,3,2,3,1,1,1,2,2,2,1,2,0,0,0,0,2,2,2,2,3,1,2,3,2,2,2,3,2,2,3,1,3,3,3,4,4,2,1,1,1,3,1,2,1,1,1,2,4,3,1,1,1,2,1,1,1,1.3231593822177095,0.7367883976130072,1.75,0,1.25,0,2.6,0,2.111111111111111,0,2.6666666666666665,0,1.5,0,2,0,1,0,2.081081081081081,0,1,0,0,-0.2479196687411588,-0.08973977009359509,-0.31345356682763886,-0.20159666846061697,1,2,1,1,1,2,2,3,1,1.7182493859684491,1.4285714285714286,0,2,-0.32231065268119236,5,4,4,4,2,2,3,8,7,5,3,1.1338934190276817,7.5,3.4285714285714284,0,0.9182505924020775,0,0.550294134528206,3,3,3,3,3,3,4,3,3,2,5,3,3,2,3,3,3,4,3,3,0.7037315505489968,3,0,3.6,0,3,0,2.8,0,3.1333333333333333,0,3,3,4,2,3,4,4,2,1,3,2,2,3,3,1,2,2,2,2,3,0.8506963092234007,2.55,0,I lived with my mother and father an equal amount of time (joint custody),0,"White, Caucasian, Anglo, European American",0,23,1,2,NA,1,3,6,Legal assistant,1,125,67,2,5,2,0,0,1,0,0,TRUE,TRUE,TRUE,TRUE,TRUE,3,0.5353999999997905,0.5069968749997206,0.5043312500005123,0.629989655172645,0.627171875,0.692066666666915,1,1,1,0.9354838709677419,1,0.9375,0.077,0.368,0.56,0.012,1.975,88.12831083151293,1934.8586960108996,0.216,0.26,0.914,0.018,2.215,72.76190741065113,1855.820352988076,0.066,0.411,0.546,0.012,1.517,64.56580598388162,1913.0710945309443,164.58333333333334,123.05555555555556,126.41666666666666,FALSE,416,1.2325925925925925,0,1,0,0,3,FALSE
46,2022-03-18T16:26:00Z,2022-03-18T16:45:34Z,1173,1,2022-03-18T16:45:34Z,0.8999999761581421,Chrome,99.0.4844.74,Windows NT 6.2,1366,768,Nothing,1.7786458333333333,573,67,259,76,27,98,-0.21560314449662005,-0.28102830264718226,-0.5534570756334142,-0.27277350089790015,-0.6949666768992877,-0.0065267354281672955,3,1,2,1,3,1,1,1,1,1,1,1,1,1,2,2,1,1,1,1,1.332784974957958,0,0,3,5,5,1.35,0,1,2,1,1,1,1,1,1,1,1,1,1,1,1,2,1,1,1,1,1,1,1,1,2,2,0,0,0,0,1,1,1,1,1,2,2,2,2,1,1,1,1,1,1,1,1,1,1,1,1,1,1,1,1,2,1,1,2,2,1,1,1,1,1,1,1,2,1,2,2,1.8046486518867757,1.9444671200491874,1,0,1.75,0,1.1333333333333333,0,1.4444444444444444,0,1,0,1.1666666666666667,0,1.2857142857142858,0,1,0,1.1891891891891893,0,1,0,0,-1.3138194629920872,-1.4469379576258017,-0.14114775846592847,-0.794042858045865,2,1,2,1,1,1,1,1,1,1.4638501094227998,1.2857142857142858,0,1,-0.7920494875423887,5,5,5,5,3,3,5,8,6,3,3,1.5735915849388864,7,4.428571428571429,0,0.4002850852868561,0,0.7766255014915452,1,1,1,2,1,4,4,3,4,3,5,4,5,4,4,3,4,1,3,5,1.2798809468443688,1.2,0,3.6,0,3.6,0,4,0,3.7333333333333334,0,1,1,1,1,1,1,1,1,1,1,1,1,1,1,1,1,1,1,1,1,1.231174022502185,1,0,I lived with my mother and father an equal amount of time (joint custody),0,Black or African American,0,22,1,2,NA,1,3,6,Customer Service Representative,5,145,62,2,5,2,0,0,1,0,0,TRUE,TRUE,TRUE,TRUE,TRUE,3,0.6880937499701977,0.47356562495976684,0.4993290322519118,0.7439968750327826,0.5911903225760307,0.5985310344860472,1,1,0.96875,1,0.96875,0.9354838709677419,0.055,0.416,0.595,0.017,1.789,101.6985238398854,1990.4769242156422,0.056,0.389,0.579,0.014,1.587,198.84953267745345,2037.445062714228,0.215,0.338,0.641,0.018,1.496,45.73321700205876,1830.487291689092,105.23529411764704,113.35714285714285,83.11111111111111,FALSE,340,1.0074074074074075,0,1,0,0,3,FALSE
47,2022-03-18T16:17:27Z,2022-03-18T16:47:30Z,1803,1,2022-03-18T16:47:33Z,0.4000000059604645,Chrome,99.0.4844.74,Windows NT 10.0,1366,768,57d0badf28d5250001bdd9d2,1.7786458333333333,738,100,508,202,60,94,0.1236533178577398,-0.09881036494316646,0.35122704903392904,1.2811423991051862,-0.018272926976413795,-0.05147962568966986,1,2,1,2,1,1,2,3,2,3,3,2,1,1,2,3,2,1,3,3,0.8870412083230169,0,1,1,5,5,1.95,0,3,1,4,1,1,2,3,3,1,1,1,3,1,3,1,3,2,1,1,3,4,3,5,5,2,0,0,0,0,1,5,1,1,1,1,1,1,1,1,1,5,1,1,1,1,3,5,5,5,2,2,1,1,1,1,1,1,3,1,1,2,1,1,1,1,1,1,1,2,1,1.9058153457594291,1.533747356112131,2.75,0,1.25,0,1.9333333333333333,0,1.4444444444444444,0,2.5833333333333335,0,1.1666666666666667,0,1.4285714285714286,0,1,0,1.7297297297297298,0,3,0,0,0.17317654627155374,-0.0976064455755961,0.12527204004442455,0.013832797234414225,1,1,1,1,1,1,1,1,1,1.9518001458970664,1,0,1,-0.9579186615539372,5,5,5,5,5,4,5,5,5,4,4,1.4960264830861913,5,4.857142857142857,0,0.5960613948117253,0,1.1280788247083786,1,2,1,1,1,5,3,5,5,3,5,4,5,3,5,5,5,5,3,5,1.533747356112131,1.2,0,4.8,0,3.8,0,4.6,0,4.4,0,1,1,1,1,1,1,1,1,1,1,1,1,1,1,1,1,1,1,1,1,1.231174022502185,1,0,I lived with my mother and father an equal amount of time (joint custody),0,"Hispanic of Latino (e.g., Mexican American, Central American, and others) & White, Caucasian, Anglo, European American",1,29,1,2,NA,1,2,3,server,2,132,63,1,5,2,0,0,1,0,0,TRUE,TRUE,TRUE,TRUE,TRUE,3,0.5251129032258666,0.46609062500006987,0.507680645161038,0.610375,0.5389034482759006,0.5958129032257824,0.96875,1,1,1,0.90625,0.96875,0.061,0.403,0.591,0.019,1.813,106.30050871222501,1937.240493124913,0.056,0.377,0.678,0.006,0.971,66.71810795154822,1960.5905387085127,0.121,0.342,0.686,0.01,1.257,139.52173423772524,1965.8562491817481,95.42105263157895,161.83333333333331,125.69999999999999,FALSE,344,1.0192592592592593,0,1,0,0,3,FALSE
48,2022-03-18T16:26:01Z,2022-03-18T16:47:50Z,1308,1,2022-03-18T16:47:53Z,0.800000011920929,Firefox,98.0,Windows NT 10.0,1600,900,No comments. Thanks.,1.7777777777777777,488,103,274,49,46,203,-0.39037162510341145,-0.08224509787916502,-0.49895803197875493,-0.6057554794699901,-0.3053551239133906,1.1734866339362748,3,3,2,2,2,1,2,2,1,2,3,1,2,3,2,1,1,1,4,2,0.9119095061289915,0,0,3,5,3,2,0,3,4,3,2,3,4,3,3,4,2,4,2,3,5,3,2,3,3,3,2,3,1,2,2,2,0,0,0,0,3,2,2,5,3,3,2,2,3,3,2,3,4,4,5,3,4,3,3,4,3,4,3,3,1,2,3,4,3,4,3,3,3,2,3,3,2,2,3,3,4,0.8621155625803557,0.8837151016885368,2.375,0,3,0,3.2,0,2.7777777777777777,0,3.4166666666666665,0,2.6666666666666665,0,3.142857142857143,0,2.6666666666666665,0,3.027027027027027,0,1,0,0,0.7719227269927544,0.8580962920439889,0.28961676243834755,0.5738565272411682,3,3,3,3,4,4,2,1,1,0.6900655593423543,3.142857142857143,0,1,0.28610014353267543,3,3,3,3,3,2,3,6,6,2,4,0.3779644730092272,6,2.857142857142857,0,0.34904059506318114,0,-0.10601640787303052,1,1,1,1,1,3,4,2,3,1,3,3,2,3,4,3,3,1,4,2,0.9102589898327995,1,0,2.6,0,2.8,0,2.8,0,2.7333333333333334,0,2,3,4,2,2,2,3,3,2,2,3,1,1,1,1,2,1,1,1,1,1.0208355710680808,1.9,0,"I lived with my mother, but not father, most of the time.",0,"White, Caucasian, Anglo, European American",0,30,1,2,NA,1,3,6,Student,3,109,65,3,5,2,0,0,1,0,0,TRUE,TRUE,TRUE,TRUE,TRUE,5,0.6233225806451613,0.55603125,0.62909375,0.7048387096774194,0.6199032258064516,0.6895666666666667,1,1,1,1,1,1,0.194,0.342,0.672,0.037,1.601,44.06708405324172,1826.2814582706587,0.091,0.396,0.591,0.025,1.866,25.91744849895192,1807.9404218580544,0.085,0.44,0.472,0.015,1.465,32.8965825117567,1813.9118606585507,43.270270270270274,74.64,97.66666666666667,FALSE,328,0.9718518518518519,0,1,0,0,3,FALSE
50,2022-03-18T16:24:10Z,2022-03-18T16:48:14Z,1444,1,2022-03-18T16:48:15Z,1,Safari,15.3,Macintosh,1440,900,NA,1.6,767,147,279,71,34,76,0.18328021124123334,0.16071215239285608,-0.4807916840938685,-0.33443683026310195,-0.5514255784307993,-0.25376763186643136,3,3,1,1,3,1,2,3,1,3,3,1,1,2,3,3,2,1,4,3,0.5026246899500346,0,1,3,3,2,2.2,0,3,2,5,3,4,2,2,2,3,1,2,3,3,3,3,2,1,1,1,2,2,2,1,3,2,0,0,0,0,2,3,2,3,4,1,3,3,1,2,2,2,1,2,2,3,2,2,2,1,3,2,1,3,1,4,3,1,2,1,1,2,3,2,2,3,1,2,1,1,1,1.1892915598853018,1,1.5,0,1.25,0,2.7333333333333334,0,2.4444444444444446,0,2,0,2.3333333333333335,0,1.7142857142857142,0,2,0,2.108108108108108,0,2,0,0,-0.3926714926517789,-0.1288764806165501,-0.09409076339160714,-0.11148362200407863,2,1,4,2,1,1,2,2,1,1.0690449676496976,1.8571428571428572,0,1.5,-0.2669090155915809,3,3,3,3,2,2,3,6,7,2,2,0.4879500364742666,6.5,2.7142857142857144,0,-0.24706573651580854,0,-0.5465011997405017,2,2,2,2,1,4,5,4,3,3,4,4,3,4,3,4,4,4,4,4,1,1.8,0,4,0,3.8,0,3.6,0,3.8,0,2,1,2,2,3,1,1,2,1,2,3,3,2,3,1,3,1,2,1,2,0.7880689256524124,1.9,0,"I lived with my mother, but not father, most of the time.",0,"White, Caucasian, Anglo, European American",0,25,1,1,NA,1,4,8,law associate,6,130,65,2,5,2,0,0,0,0,0,TRUE,TRUE,TRUE,TRUE,TRUE,1,0.5367500000000036,0.47984375,0.5463437500000009,0.616031249999989,0.5723870967741916,0.6695937499999982,1,1,1,1,0.96875,1,0.12,0.316,0.499,0.014,1.599,64.40332468759053,1848.6681624534947,0.073,0.336,0.564,0.011,1.494,142.4693596890736,1976.463452782192,0.117,0.368,0.693,0.012,1.166,52.46055418107974,1833.7855326278723,114.21428571428571,135.8181818181818,97.16666666666666,FALSE,420,1.2444444444444445,0,1,0,0,3,FALSE
51,2022-03-18T16:26:37Z,2022-03-18T16:50:45Z,1447,1,2022-03-18T16:50:47Z,0.8999999761581421,Firefox,98.0,Windows NT 10.0,2133,1200,I sneezed a few times during the game and couldn't see well,1.7775,708,51,332,98,47,75,0.061970324702401644,-0.3693763936551899,-0.2882283965140726,-0.0014548516910120387,-0.28484925270360656,-0.265005854431807,2,2,1,2,3,1,1,3,1,1,2,1,1,1,2,2,1,1,2,2,1.025978352085154,0,0,4,4,4,1.6,0,2,2,2,1,4,3,1,2,2,2,2,1,2,2,2,2,2,5,1,1,1,1,2,0,1,0,0,1,0,1,1,1,1,2,2,2,1,1,3,2,1,1,1,3,1,2,1,1,1,1,4,1,1,1,2,1,1,1,1,1,1,2,2,1,1,1,1,1,1,1,1.7093630164251017,1.2344267996967353,1.875,0,1,0,2,0,1.3333333333333333,0,1.5,0,1.6666666666666667,0,1.2857142857142858,0,1,0,1.4054054054054055,0,0,0,0,-0.6054128096113264,-0.5921253330628783,-0.6189692744445258,-0.605547303753702,2,4,3,2,2,2,3,8,1,0.8997354108424374,2.5714285714285716,0,4.5,1.308176663003557,5,5,5,4,2,2,4,3,9,2,2,1.5118578920369088,6,3.857142857142857,0,-0.33738063897136766,0,0.0177103420150915,3,3,4,3,4,2,3,3,4,2,1,3,4,3,4,2,3,3,2,2,0.9154754164341269,3.4,0,2.4,0,2.6,0,3.2,0,2.7333333333333334,0,1,1,1,1,3,1,1,1,1,1,2,1,1,1,1,1,1,1,1,2,1.2396943596157715,1.2,0,"I lived with my mother, but not father, most of the time.",0,"Hispanic of Latino (e.g., Mexican American, Central American, and others)",0,27,0,1,NA,1,3,6,Data Analyst,5,173,69,2,5,2,0,0,0,0,0,TRUE,TRUE,TRUE,TRUE,TRUE,3,0.37078125,0.36346875,0.40228125,0.48974074074074075,0.43143478260869567,0.5100416666666666,1,1,1,0.84375,0.71875,0.7741935483870968,0.056,0.291,0.557,0.015,1.984,80.493993465503,1929.6129398054297,0.046,0.266,0.54,0.011,1.566,122.78475643102826,2045.3319635345194,0.06,0.272,0.639,0.015,2.01,85.71783341017517,1997.3724083073873,132.26666666666668,142.36363636363637,134,FALSE,325,0.9629629629629629,0,1,0,9,12,FALSE
52,2022-03-18T16:29:37Z,2022-03-18T16:51:22Z,1304,1,2022-03-18T16:51:22Z,0.8999999761581421,Chrome,99.0.4844.74,Windows NT 10.0,1280,720,NA,1.7777777777777777,637,83,351,57,39,85,-0.08401275909856531,-0.1926802116391746,-0.21919627455150423,-0.5070941524856671,-0.448896222381879,-0.1526236287780506,2,2,1,1,2,1,1,2,1,2,4,1,1,1,1,2,1,1,2,3,1.0711528467275955,0,0,2,4,3,1.6,0,3,2,4,1,4,4,2,4,3,3,4,4,1,3,2,1,4,2,1,1,2,3,2,0,1,1,0,1,0,1,2,4,1,4,1,3,3,2,2,1,2,1,4,3,1,4,2,2,2,2,4,2,1,1,3,2,1,1,1,1,2,2,3,1,1,3,1,1,1,1,1.34566370643293,0.990430401872025,2,0,1,0,2.933333333333333,0,2.3333333333333335,0,2.1666666666666665,0,2.1666666666666665,0,1.5714285714285714,0,1.6666666666666667,0,2.054054054054054,0,0,0,0,-0.1031678448305387,0.15314383541318272,-0.6189692744445258,-0.23291271951567152,5,4,5,3,3,2,3,4,3,1.1338934190276817,3.5714285714285716,0,3.5,1.5019145241885536,1,5,5,5,5,5,4,1,1,2,2,1.7320508075688772,1,4.285714285714286,0,-1.2405296635269585,0,-0.3001802339611151,2,3,3,4,3,3,3,3,3,3,3,3,3,5,5,2,3,3,3,3,0.7237468644557459,3,0,3,0,2.8,0,3.8,0,3.2,0,2,1,4,4,1,4,3,4,4,1,2,4,1,2,1,3,1,4,2,3,1.190974832912761,2.55,0,I lived with my mother and father an equal amount of time (joint custody),0,"Hispanic of Latino (e.g., Mexican American, Central American, and others)",0,28,0,1,NA,1,2,6,educator,3,180,65,2,5,2,0,0,1,0,0,TRUE,TRUE,TRUE,TRUE,TRUE,4,0.5358499999940395,0.527921875,0.5470312500223518,0.6036935483947877,0.5487124999985099,0.6203838709785092,1,1,1,0.96875,1,1,0.126,0.339,0.627,0.019,1.704,11.673501110544224,1793.5603968384291,0.102,0.348,0.612,0.05,1.984,126.98299230768646,1911.2445904606184,0.068,0.381,0.455,0.019,1.768,59.294507099954835,1886.827180055221,89.6842105263158,39.68,93.05263157894737,FALSE,356,1.0548148148148149,0,1,0,0,3,FALSE
53,2022-03-18T16:33:04Z,2022-03-18T16:51:38Z,1113,1,2022-03-18T16:51:39Z,0.8999999761581421,Chrome,99.0.4844.51,Windows NT 10.0,1280,720,NA,1.7777777777777777,536,61,319,43,24,61,-0.29167883605487044,-0.31415883677518514,-0.33546090101477727,-0.6797514747082323,-0.7564842905286399,-0.42234097034706597,1,1,1,1,1,1,1,1,1,1,1,1,1,1,1,1,1,1,1,1,1.538967528127731,0,1,1,5,4,1,0,5,3,2,3,1,3,3,3,2,1,3,5,2,5,2,5,5,5,1,5,5,5,5,2,2,0,0,0,0,1,3,1,1,1,3,3,3,5,2,3,5,1,4,1,5,2,5,5,5,5,5,1,1,2,1,1,1,3,1,1,1,1,3,1,1,5,1,2,2,1,1.7005563477556078,1.01418510567422,4.5,0,1.5,0,2.8666666666666667,0,2.3333333333333335,0,3.5833333333333335,0,1.8333333333333333,0,1.5714285714285714,0,2.3333333333333335,0,2.5135135135135136,0,1,0,0,1.8180836361649624,1.4161385840484282,-0.22730066264678367,0.5944189607008222,1,1,2,1,1,1,1,1,1,1.7320508075688772,1.1428571428571428,0,1,-0.874984074548163,5,5,5,5,5,5,5,8,7,6,4,1.5118578920369088,7.5,5,0,1.475286511749183,0,1.7410083003497518,1,1,1,1,1,5,5,5,5,5,5,5,5,5,5,5,5,5,5,5,2.065591117977289,1,0,5,0,5,0,5,0,5,0,1,1,1,1,1,1,1,1,1,1,1,1,1,1,1,1,1,1,1,1,1.231174022502185,1,0,I lived with my mother and father an equal amount of time (joint custody),0,"White, Caucasian, Anglo, European American",0,29,1,2,NA,1,2,3,customer service representative,2,155,69,2,5,2,0,0,1,0,0,TRUE,TRUE,TRUE,TRUE,TRUE,5,0.438754838689681,0.41692187498509886,0.4017687500119209,0.49001724138753167,0.46270645160828866,0.4871551724096824,0.96875,1,1,0.90625,0.96875,0.90625,0.058,0.315,0.728,0.015,1.668,60.882945411000875,1919.008845836485,0.055,0.335,0.754,0.025,1.663,79.07203633563894,1901.6833890915323,0.051,0.329,0.514,0.019,1.677,141.93673415719965,2038.6133377565134,111.2,66.52,88.26315789473685,FALSE,392,1.1614814814814816,0,1,0,0,3,FALSE
54,2022-03-18T16:34:06Z,2022-03-18T16:53:07Z,1140,1,2022-03-18T16:53:07Z,0.8999999761581421,Firefox,98.0,Windows NT 10.0,1280,720,NA,1.7777777777777777,482,83,302,72,39,84,-0.4027082237344791,-0.1926802116391746,-0.39722648382339104,-0.3221041643900616,-0.448896222381879,-0.16386185134342626,1,2,1,1,1,1,1,3,1,1,3,1,1,1,1,1,1,1,2,1,1.3611140947574412,0,1,1,4,4,1.3,0,2,1,1,1,1,1,2,1,1,1,1,1,3,2,1,1,1,1,1,1,2,1,1,2,2,0,0,0,0,1,4,1,2,1,1,4,3,1,1,1,1,1,3,1,1,2,2,2,2,2,2,1,1,1,1,1,1,2,2,1,1,1,1,1,1,1,2,2,2,2,1.6047040459458795,1.820517979665599,1.125,0,2,0,1.3333333333333333,0,2,0,1.5833333333333333,0,1.1666666666666667,0,1.2857142857142858,0,1,0,1.5135135135135136,0,1,0,0,-1.0221226057176562,-1.1634426399431943,-0.05499485428507328,-0.6092187471141338,1,1,3,1,1,3,2,1,1,1.4960264830861913,1.7142857142857142,0,1,-0.5432457265250663,5,5,5,5,2,2,3,4,4,2,2,1.4638501094227998,4,3.857142857142857,0,-0.698640248793604,0,-0.20232909866420362,2,2,2,3,2,4,5,3,4,3,5,4,5,4,4,5,4,5,4,4,1.3870146083619754,2.2,0,4.4,0,4.4,0,3.8,0,4.2,0,1,1,1,1,2,1,1,1,1,1,3,1,1,1,1,1,2,1,1,2,1.2258187382102494,1.25,0,"I lived with my mother, but not father, most of the time. & I lived with my extended family on mother's side (grandparents, aunts ,uncles, cousins)",1,"White, Caucasian, Anglo, European American",0,30,1,2,NA,1,4,6,Cytotechnologist,6,160,65,3,5,2,0,0,1,0,0,TRUE,TRUE,TRUE,TRUE,TRUE,1,0.599875,0.54271875,0.5488125,0.7033548387096774,0.6355806451612903,0.6475625,1,1,1,1,1,1,0.121,0.38,0.724,0.011,1.383,88.93005156105896,1873.402605783466,0.137,0.365,0.798,0.019,1.93,76.15205846836517,1861.3565136361667,0.075,0.467,0.557,0.011,1.295,147.61828552418498,1933.1954755093745,125.72727272727273,101.57894736842105,117.72727272727273,FALSE,470,1.3925925925925926,0,1,0,0,3,FALSE
56,2022-03-18T16:32:41Z,2022-03-18T16:55:25Z,1363,1,2022-03-18T16:55:25Z,0.8999999761581421,Chrome,99.0.4844.51,Windows NT 10.0,1536,864,NA,1.7777777777777777,469,66,255,68,30,63,-0.429437520768459,-0.28655005833518277,-0.5679901539413234,-0.37143482788222304,-0.6334490632699356,-0.3998645252163147,2,2,2,1,2,1,1,2,1,1,3,1,1,1,2,2,1,1,2,2,1.050062654772261,0,1,1,3,3,1.55,0,3,2,2,2,2,3,3,3,2,2,2,4,2,3,2,2,5,1,1,4,5,4,4,1,2,0,0,0,0,1,5,4,4,5,2,3,1,3,2,1,3,1,4,2,2,2,5,5,5,3,4,1,1,1,2,1,1,2,2,1,3,4,2,1,1,3,2,2,2,2,1.4263711068773564,0.7988086367179802,3.25,0,2,0,2.466666666666667,0,3.111111111111111,0,2.9166666666666665,0,1.6666666666666667,0,2.142857142857143,0,1.6666666666666667,0,2.5135135135135136,0,1,0,0,1.0065961384842141,0.6957477767841955,-0.05499485428507328,0.3203764612495611,1,1,2,1,1,1,1,2,1,1.7320508075688772,1.1428571428571428,0,1.5,-0.6815819506204519,5,5,5,5,5,5,5,4,6,6,4,1.5118578920369088,5,5,0,1.0237119994713875,0,1.465958999500633,3,2,3,3,3,3,2,5,4,2,3,3,2,4,4,3,4,3,3,3,0.8837151016885368,2.8,0,3.2,0,2.4,0,4,0,3.2,0,1,1,1,2,2,1,1,2,1,1,2,2,1,1,1,2,1,1,1,1,0.8271701918685112,1.3,0,I lived with my mother and father an equal amount of time (joint custody),0,"White, Caucasian, Anglo, European American",0,22,1,2,NA,1,4,4,Pharmacy Intern,6,160,60,3,5,2,0,0,0,0,0,TRUE,TRUE,TRUE,TRUE,TRUE,1,0.5271258064546893,0.44159375000186263,0.4787249999959022,0.6188633333305518,0.4843766666710377,0.5484531250037253,0.96875,1,1,0.967741935483871,0.967741935483871,1,0.132,0.289,0.716,0.025,1.84,28.827116253437623,1812.9428314814252,0.06,0.33,0.608,0.029,1.807,63.0773412426545,1890.297663626901,0.063,0.337,0.266,0.038,1.939,117.11998282686781,1986.2719020320783,73.6,62.3103448275862,51.026315789473685,FALSE,388,1.1496296296296296,0,1,0,3,6,FALSE
57,2022-03-18T16:35:47Z,2022-03-18T16:56:46Z,1259,1,2022-03-18T16:56:47Z,0.4000000059604645,Chrome,99.0.4844.51,Windows NT 10.0,1366,768,N/A,1.7786458333333333,615,73,280,57,32,88,-0.12924695407914663,-0.24789776851917938,-0.4771584145168912,-0.5070941524856671,-0.5924373208503674,-0.1189089610819237,3,3,2,1,3,1,1,3,1,3,4,1,1,2,3,3,1,1,3,3,0.5104177855340404,0,0,1,3,3,2.15,0,4,2,3,3,3,4,3,3,3,4,3,4,3,4,3,4,4,2,1,3,3,3,3,1,2,0,0,0,0,2,3,4,4,4,3,4,4,5,3,3,4,2,3,3,3,4,4,4,4,4,4,3,2,1,3,3,2,2,1,1,4,4,2,1,3,4,1,1,1,1,1.005988077470112,0.6546536707079771,2.875,0,1,0,3.2666666666666666,0,3.6666666666666665,0,3.4166666666666665,0,2.6666666666666665,0,2.2857142857142856,0,2.6666666666666665,0,3.081081081081081,0,1,0,0,1.1316090773161127,1.1291032623989201,-0.39960647100849406,0.364748395695213,3,3,5,2,2,3,3,3,2,0.7867957924694432,3,0,2.5,0.7833719283100348,4,4,5,5,1,1,3,5,2,3,2,1.7043362064926932,3.5,3.2857142857142856,0,-0.5751298489193319,0,-0.4367109100209476,2,2,3,2,2,4,3,4,5,3,4,3,4,3,4,4,3,3,3,3,0.7367883976130072,2.2,0,3.4,0,3.4,0,3.8,0,3.533333333333333,0,2,1,2,2,2,3,3,3,1,3,2,3,2,2,1,3,2,3,1,3,0.7181848464596079,2.2,0,I lived with my mother and father an equal amount of time (joint custody),0,"White, Caucasian, Anglo, European American",0,28,1,2,NA,1,3,6,Educational services,4,215,69,2,5,2,0,0,1,0,0,TRUE,TRUE,TRUE,TRUE,TRUE,5,0.48913548386866046,0.4435096774216621,0.4946031249994412,0.5206612903216192,0.48580322580664387,0.5713533333301545,1,1,1,1,1,0.967741935483871,0.072,0.348,0.513,0.023,2.067,150.22181488607313,1980.4404661382132,0.08,0.332,0.786,0.008,0.891,55.1345440866733,1838.3111992314248,0.097,0.333,0.615,0.048,1.716,46.71407009190331,1830.9958116432124,89.86956521739131,111.375,35.75,FALSE,244,0.7229629629629629,0,1,0,0,3,FALSE
58,2022-03-18T16:36:09Z,2022-03-18T16:56:49Z,1240,1,2022-03-18T16:56:50Z,0.8999999761581421,Chrome,99.0.4844.74,Macintosh,1280,800,NA,1.6,574,111,306,73,44,75,-0.21354704472477543,-0.03807105237516118,-0.3826934055154819,-0.30977149851702124,-0.3463668663329587,-0.265005854431807,2,2,1,1,3,1,1,1,1,2,2,1,2,1,1,1,1,1,2,2,1.1821033884786185,0,0,4,3,3,1.45,0,3,2,2,2,2,2,2,1,2,1,1,1,2,1,1,1,2,1,1,1,2,2,1,0,2,0,0,0,0,1,2,1,1,1,1,1,1,2,1,1,1,1,1,1,1,1,1,1,2,2,1,1,1,1,2,1,1,1,1,1,1,1,1,1,2,1,1,1,1,1,1.849031886939465,1.505545305418162,1.375,0,1,0,1.6666666666666667,0,1.2222222222222223,0,1.1666666666666667,0,1.1666666666666667,0,1,0,1.3333333333333333,0,1.162162162162162,0,0,0,0,-1.0879188893133926,-1.0621591931124323,-0.6189692744445258,-0.8405642337784791,2,1,3,1,1,2,1,1,1,1.2149857925879117,1.5714285714285714,0,1,-0.6261803135308405,5,4,4,5,2,3,3,3,3,3,2,1.1126972805283737,3,3.7142857142857144,0,-0.665444751374891,0,-0.25951274446873984,2,2,3,3,2,4,3,3,4,2,5,4,4,3,3,5,4,4,3,3,0.9154754164341269,2.4,0,4.2,0,3.4,0,3.2,0,3.6,0,2,2,1,1,2,1,1,2,1,1,2,1,2,1,1,2,1,1,1,1,1.019545822516343,1.35,0,I lived with my mother and father an equal amount of time (joint custody) & Prefer not to say.,1,"White, Caucasian, Anglo, European American",0,29,0,1,NA,1,2,6,Teacher,4,165,68,2,5,2,0,0,3,0,0,TRUE,TRUE,TRUE,TRUE,TRUE,6,0.7225593750006519,0.5936968750017695,0.6570125000006519,0.7617843749998138,0.7966750000012107,0.7519838709667805,1,1,1,1,1,1,0.084,0.466,0.436,0.018,1.787,37.10328242712246,1821.9904531019006,0.077,0.428,0.415,0.009,1.336,220.95118562427373,2008.0948502187784,0.208,0.352,0.578,0.028,1.321,33.89997758107681,1815.5354455715574,99.27777777777779,148.44444444444446,47.17857142857142,FALSE,316,0.9362962962962963,0,1,0,0,3,FALSE
60,2022-03-18T16:42:53Z,2022-03-18T16:58:46Z,953,1,2022-03-18T16:58:47Z,1,Chrome,99.0.4844.51,Macintosh,1440,900,NA,1.6,495,53,209,44,38,71,-0.37597892670049926,-0.35833288227918897,-0.7351205544822783,-0.6674188088351919,-0.46940209359166307,-0.3099587446933096,1,1,1,1,1,1,1,1,1,1,1,1,1,1,1,1,1,1,1,1,1.538967528127731,0,1,1,5,5,1,0,3,2,3,2,3,3,2,4,3,2,3,2,3,3,3,2,3,1,1,1,2,3,3,4,2,0,0,0,0,2,2,2,2,2,1,1,1,2,1,2,4,1,2,1,2,1,4,4,4,2,3,1,4,1,3,2,1,3,4,3,2,1,2,1,1,1,1,2,2,2,1.4410331628996524,0.5936168397046637,2,0,1.75,0,2.7333333333333334,0,1.6666666666666667,0,2.3333333333333335,0,2.3333333333333335,0,2.2857142857142856,0,1,0,2.054054054054054,0,2,0,0,-0.1031678448305387,0.06582373756297237,0.07821504497010326,0.07201939126653781,1,1,1,1,1,1,1,1,1,1.9518001458970664,1,0,1,-0.9579186615539372,5,5,5,5,2,2,5,6,7,6,4,1.8126539343499315,6.5,4.142857142857143,0,1.2946567068380648,0,1.1665725285660418,4,4,4,3,3,3,5,3,3,4,4,5,3,4,4,4,4,4,3,3,0.9759000729485332,3.6,0,4,0,3.8,0,3.4,0,3.7333333333333334,0,2,2,1,2,3,2,2,2,1,2,2,2,1,2,2,2,2,2,2,1,0.6863327411532597,1.85,0,I lived with my mother and father an equal amount of time (joint custody),0,"Asian or Asian American (e.g., Chinese, Japanese, and others)",0,21,1,2,NA,1,3,4,Student,6,154,72,4,5,2,0,0,1,0,0,TRUE,TRUE,TRUE,TRUE,TRUE,4,0.4765156250074506,0.4315156249850988,0.48867500000447034,0.5484899999936421,0.4867846154341331,0.5219666666543042,1,1,1,0.9375,0.8125,0.84375,0.05,0.342,0.362,0.029,2.062,103.21016345532982,2008.3160730232896,0.045,0.325,0.424,0.015,1.5,47.940389794357955,1988.2962683103644,0.066,0.335,0.523,0.022,2.118,55.393844560971104,1903.530552977482,71.10344827586206,100,96.27272727272727,FALSE,438,1.2977777777777777,0,1,0,3,6,FALSE
62,2022-03-18T16:39:49Z,2022-03-18T17:00:13Z,1224,1,2022-03-18T17:00:14Z,0.8999999761581421,Chrome,99.0.4844.51,Macintosh,1440,900,na,1.6,487,64,235,28,14,48,-0.39242772487525607,-0.2975935697111837,-0.6406555454808689,-0.8647414628038378,-0.9615430026264804,-0.5684378636969493,2,4,1,3,2,2,2,3,3,2,3,2,2,2,3,2,2,2,2,2,0.6569466853317864,0,1,2,5,4,2.3,0,2,2,2,2,2,1,1,2,2,2,1,2,2,2,2,2,2,3,2,2,2,2,2,1,1,1,0,0,0,2,2,1,2,2,2,3,2,2,2,2,1,1,2,4,2,4,2,2,3,4,3,3,3,2,3,3,1,2,2,1,1,1,1,2,2,1,2,2,2,2,1.2508255532105843,1.3020130933435712,2.125,0,2,0,1.8,0,2,0,2.4166666666666665,0,2.8333333333333335,0,1.2857142857142858,0,1.6666666666666667,0,2.108108108108108,0,1,0,0,0.013072256188595128,-0.2634949648022902,-0.05499485428507328,-0.15924490954368173,2,1,3,1,1,1,1,1,1,1.2535663410560174,1.4285714285714286,0,1,-0.7091149005366146,4,4,4,4,3,3,4,6,6,3,3,0.7867957924694432,6,3.7142857142857144,0,0.2196552803757379,0,0.2795924049485119,3,3,3,3,3,4,3,3,3,4,3,3,4,3,3,3,3,3,2,3,0.5163977794943222,3,0,3.2,0,3.2,0,3,0,3.1333333333333333,0,2,3,2,3,2,3,3,2,2,2,2,2,3,2,2,3,2,2,2,2,0.47016234598162726,2.3,0,"I lived with my mother, but not father, most of the time.",0,Black or African American,0,21,1,2,NA,1,3,6,retail,2,125,69,3,5,3,0,0,0,1,0,TRUE,TRUE,TRUE,TRUE,TRUE,1,0.620903225806692,0.6089928571430168,0.5805258064512764,0.7734319999995828,0.7162374999995033,0.6654280000001193,0.96875,0.875,0.96875,0.8333333333333334,0.7741935483870968,0.8064516129032258,0.062,0.308,0.235,0.01,1.524,160.14090576774723,2105.575411134309,0.061,0.292,0.148,0.018,2.106,127.2687781869429,2254.552209630224,0.062,0.32,0.255,0.019,2.067,221.7869858237358,2171.560681586156,152.4,117,108.78947368421053,FALSE,354,1.0488888888888888,0,1,0,0,3,FALSE
63,2022-03-18T16:43:26Z,2022-03-18T17:00:25Z,1019,1,2022-03-18T17:00:26Z,1,Chrome,98.0.4758.109,Macintosh,1440,900,n/a,1.6,477,49,311,48,33,52,-0.4129887225937021,-0.3804199050311909,-0.3645270576305955,-0.6180881453430304,-0.5719314496405833,-0.5234849734354468,3,3,3,3,3,1,3,3,1,3,3,3,4,2,4,3,2,1,3,3,0.7880689256524124,0,0,3,1,1,2.7,0,4,3,3,4,4,3,4,3,2,3,2,3,3,4,4,2,2,1,1,1,1,1,1,0,2,0,0,0,0,3,3,3,3,4,2,2,2,2,2,2,1,1,2,3,1,3,1,1,1,1,2,1,1,1,3,2,2,1,3,1,5,2,3,2,3,1,2,1,3,2,1.23268792462631,0.6324555320336759,1.25,0,2,0,3.2666666666666666,0,2.6666666666666665,0,1.5833333333333333,0,1.6666666666666667,0,2.4285714285714284,0,2,0,2.054054054054054,0,0,0,0,-0.5900603434389878,-0.028773035108088194,-0.274357657721105,-0.1515653464145966,3,3,4,4,3,3,4,6,3,0.6900655593423543,3.4285714285714284,0,4.5,1.8057841850382017,3,3,5,4,3,2,3,6,6,3,2,0.9511897312113419,6,3.2857142857142856,0,-0.12355533664153649,0,-0.1616616091718286,2,1,2,2,2,4,4,4,3,3,4,2,3,3,3,3,4,4,4,3,0.7432233529572065,1.8,0,3.6,0,3.4,0,3.2,0,3.4,0,3,1,2,3,3,2,2,3,1,1,3,2,2,2,1,2,1,1,1,2,0.7880689256524124,1.9,0,I lived with my mother and father an equal amount of time (joint custody),0,"White, Caucasian, Anglo, European American",0,29,0,1,NA,1,3,6,Sports Reporter,3,175,70,3,5,2,0,0,1,0,0,TRUE,TRUE,TRUE,TRUE,TRUE,6,0.47419999999552964,0.44308125000819565,0.5306387096758811,0.5533107143087046,0.5337999999893123,0.6440709677357828,1,1,1,0.9032258064516129,0.90625,0.96875,0.073,0.371,0.49,0.013,1.564,50.96834464155519,1878.7162527049827,0.05,0.353,0.544,0.007,1.191,99.14924255637015,1987.7460838145164,0.058,0.364,0.564,0.018,1.816,20.00897985015203,1875.8584837469932,120.30769230769232,170.14285714285714,100.8888888888889,FALSE,358,1.0607407407407408,0,1,1,0,3,FALSE
64,2022-03-18T16:08:51Z,2022-03-18T17:00:52Z,3120,1,2022-03-18T17:00:53Z,1,Firefox,98.0,Windows NT 10.0,1920,1080,NA,1.7777777777777777,735,600,572,106,100,93,0.11748501854220597,2.662067479057073,0.583756301960475,0.0972064752933109,0.8019619214149485,-0.06271784825504549,2,2,1,1,2,1,1,2,1,2,3,1,1,2,1,2,1,1,3,2,1.025978352085154,0,0,1,4,4,1.6,0,2,2,1,2,1,1,1,1,1,1,1,2,1,1,2,1,1,5,1,1,1,1,1,2,2,0,0,0,0,2,1,1,1,2,2,3,3,3,1,2,1,1,1,1,1,1,2,2,2,1,5,1,1,1,2,1,1,2,1,1,1,1,1,1,1,1,1,1,1,1,1.5749541201192117,1.7265434778633235,1.5,0,1,0,1.3333333333333333,0,2,0,1.3333333333333333,0,1.8333333333333333,0,1.1428571428571428,0,1,0,1.5135135135135136,0,1,0,0,-0.7786763564134319,-0.9997174564740503,-0.39960647100849406,-0.6996619637412722,1,1,3,1,1,1,1,1,1,1.5735915849388864,1.2857142857142858,0,1,-0.7920494875423887,5,4,4,3,3,3,5,4,10,2,3,1.2535663410560174,7,3.857142857142857,0,0.18645978295702492,0,0.33677605075304806,3,2,3,3,2,4,2,3,3,3,5,2,5,3,3,3,2,5,3,1,1.0600988273786194,2.6,0,3.6,0,3.2,0,2.6,0,3.1333333333333333,0,1,1,2,3,2,2,2,3,1,2,2,3,2,2,1,3,2,2,1,2,0.4442616583193193,1.95,0,"I lived with my father, but not mother, most of the time.",0,"Asian or Asian American (e.g., Chinese, Japanese, and others)",0,27,1,2,NA,1,4,2,piano accompanist,3,105,60,1,5,2,0,0,1,0,0,TRUE,TRUE,TRUE,TRUE,TRUE,1,0.4587741935483871,0.39126666666666665,0.44593548387096776,0.5558461538461539,0.4573333333333333,0.54964,1,0.967741935483871,0.96875,0.8125,0.84375,0.78125,0.051,0.319,0.412,0.013,1.737,100.38104518807579,1997.9994498632338,0.042,0.319,0.548,0.013,1.337,92.90906150740571,2042.4563514631484,0.052,0.343,0.467,0.013,1.756,96.55538361404348,2016.5843651974133,133.61538461538464,102.84615384615385,135.0769230769231,FALSE,298,0.882962962962963,0,1,0,6,9,FALSE
65,2022-03-18T16:44:18Z,2022-03-18T17:01:40Z,1041,1,2022-03-18T17:01:40Z,0.8999999761581421,Chrome,99.0.4844.51,Macintosh,1280,800,NA,1.6,515,72,236,58,37,74,-0.33485693126360716,-0.2534195242071799,-0.6370222759038917,-0.49476148661262676,-0.4899079648014471,-0.2762440769971827,2,3,1,1,3,3,2,4,1,3,4,1,1,2,3,4,2,2,4,4,0.6805570473787206,0,1,1,3,3,2.5,0,2,2,2,2,2,2,3,2,2,3,2,3,3,2,3,2,1,1,1,1,1,1,2,0,2,0,0,0,0,2,3,2,2,2,3,4,2,1,1,2,3,1,2,3,3,1,2,1,2,1,1,2,1,1,1,1,2,1,1,1,1,1,2,1,1,1,1,1,1,1,1.415274886021441,0.8338093878327919,1.25,0,1,0,2.3333333333333335,0,2.3333333333333335,0,1.8333333333333333,0,1.1666666666666667,0,1.2857142857142858,0,1,0,1.6756756756756757,0,0,0,0,-0.8356998021964036,-0.6014670101977543,-0.6189692744445258,-0.61021814232114,1,1,3,1,1,1,1,1,1,1.5735915849388864,1.2857142857142858,0,1,-0.7920494875423887,5,5,5,5,2,3,5,7,7,6,4,1.7043362064926932,7,4.285714285714286,0,1.384971609293624,0,1.2989850639765426,4,4,3,3,4,2,3,3,2,2,4,2,3,3,3,1,3,3,3,3,0.7988086367179802,3.6,0,2.8,0,2.4,0,2.8,0,2.6666666666666665,0,1,3,4,4,3,4,2,4,4,1,2,4,2,4,1,4,1,4,4,3,1.3088765773505315,2.95,0,I lived with my mother and father an equal amount of time (joint custody),0,Black or African American,0,25,0,1,NA,1,4,4,Warehouse worker,6,195,71,1,5,2,0,0,0,0,0,TRUE,TRUE,TRUE,TRUE,TRUE,3,0.4658935483847895,0.4624533333301544,0.4771968750031665,0.5395806451564835,0.5069466666648785,0.53515,1,1,1,0.96875,0.9375,1,0.089,0.321,0.561,0.017,1.345,43.00615861750992,1825.5300032292057,0.055,0.345,0.553,0.021,1.625,136.14420920941015,1986.3757000099906,0.065,0.362,0.646,0.016,1.637,46.05243658312589,1873.4651717701888,79.11764705882352,77.38095238095238,102.3125,FALSE,380,1.125925925925926,0,1,0,0,3,FALSE
66,2022-03-18T16:42:50Z,2022-03-18T17:02:13Z,1163,1,2022-03-18T17:02:14Z,1,Opera,84.0.4316.31,Macintosh,1440,900,N/A,1.6,546,66,291,55,46,95,-0.2711178383364244,-0.28655005833518277,-0.43719244917014116,-0.5317594842317478,-0.3053551239133906,-0.040241403124294216,2,2,3,3,2,2,2,3,2,2,2,3,3,3,2,3,3,2,3,2,0.4893604849295929,0,1,1,4,3,2.45,0,3,2,3,2,3,3,2,2,2,2,2,3,2,2,2,2,3,1,1,1,2,1,1,1,1,3,0,2,0,2,2,1,2,2,1,1,1,1,2,2,2,2,2,2,2,3,2,3,4,4,2,1,1,1,3,2,1,1,1,1,1,2,2,1,1,1,2,2,2,2,1.5002502293786697,0.8451542547285166,1.5,0,2,0,2.3333333333333335,0,1.4444444444444444,0,2.5,0,1.6666666666666667,0,1.2857142857142858,0,1,0,1.7567567567567568,0,1,0,0,-0.6207652757836646,-0.4569168482159875,-0.05499485428507328,-0.2559558512505304,2,2,2,4,2,2,2,2,2,1.0690449676496976,2.2857142857142856,0,2,0.17529686935345262,5,5,5,5,3,3,4,7,8,6,4,1.2909944487358056,7.5,4.285714285714286,0,1.475286511749183,0,1.3539949241463662,3,3,3,2,2,3,4,4,4,3,4,3,4,2,4,4,3,4,3,3,0.7237468644557459,2.6,0,3.4,0,3.6,0,3.4,0,3.466666666666667,0,3,1,1,3,3,1,3,3,1,2,1,2,2,2,1,2,1,2,2,2,0.7880689256524124,1.9,0,I lived with my mother and father an equal amount of time (joint custody),0,"Asian or Asian American (e.g., Chinese, Japanese, and others)",0,22,1,2,NA,1,3,6,Research Assistant,2,117,65,3,5,2,0,0,2,0,0,TRUE,TRUE,TRUE,TRUE,TRUE,6,0.674754838689681,0.5193258064254638,0.5191000000046145,0.6442035714217594,0.5996933333396911,0.5849793103645587,1,1,1,0.875,0.9375,0.90625,0.059,0.349,0.356,0.012,1.437,110.78023405723444,1994.7662465354178,0.065,0.334,0.36,0.01,1.196,38.680797662861515,1882.2230488718328,0.067,0.351,0.221,0.023,2.003,158.0356069185571,2062.2872660316903,119.75,119.6,87.08695652173914,FALSE,432,1.28,0,1,0,3,6,FALSE
67,2022-03-18T16:37:09Z,2022-03-18T17:02:44Z,1534,1,2022-03-18T17:02:48Z,1,Edge,99.0.1150.39,Windows NT 10.0,1366,768,n/a,1.7786458333333333,549,125,529,97,67,83,-0.2649495390208906,0.03923352725684553,0.42752571015045193,-0.013787517564052406,0.12526817149207461,-0.1751000739088019,1,2,1,1,1,1,2,3,1,3,2,1,1,1,2,2,2,1,2,2,1.0711528467275955,1,1,1,3,3,1.6,0,3,3,2,2,1,1,3,3,2,1,2,3,2,3,3,4,4,3,1,2,3,3,2,5,2,0,0,0,0,2,3,3,2,2,1,3,2,2,2,2,2,2,3,2,4,3,3,2,3,3,3,2,4,1,4,4,2,5,3,1,2,2,2,3,3,2,2,2,3,2,1.0134234194190634,0.9102589898327995,2.75,0,2.25,0,2.2666666666666666,0,2.2222222222222223,0,2.5833333333333335,0,3,0,2.4285714285714284,0,2.6666666666666665,0,2.5405405405405403,0,3,0,0,0.6995468150374442,0.4019274475314614,0.4698836567678454,0.43590555214965343,2,1,4,2,1,1,1,1,1,1.1126972805283737,1.7142857142857142,0,1,-0.5432457265250663,3,3,3,3,2,2,2,3,3,2,2,0.6900655593423543,3,2.5714285714285716,0,-0.8792700537047221,0,-1.0089728961699453,2,2,2,1,1,4,4,4,4,3,4,3,4,4,4,4,3,4,3,3,0.7988086367179802,1.6,0,3.6,0,3.6,0,3.8,0,3.6666666666666665,0,1,2,2,3,3,2,3,3,3,1,2,2,3,3,1,2,1,2,1,1,0.8255779474818965,2.05,0,"I lived with my mother, but not father, most of the time.",0,"White, Caucasian, Anglo, European American",0,29,0,1,NA,1,1,6,disabled,1,145,72,3,5,2,0,0,1,0,0,TRUE,TRUE,TRUE,TRUE,TRUE,4,0.625438709666652,0.6262125000040978,0.748028124999255,0.715453125,0.6122687499970197,0.8122733333329359,1,1,1,1,1,0.967741935483871,0.084,0.399,0.258,0.012,1.375,76.2670527399362,1900.2495964013376,0.084,0.382,0.372,0.154,1.477,65.95829286454523,1851.167943721275,0.225,0.266,0.629,0.014,1.431,33.90021292650282,1817.3838257616333,114.58333333333333,9.590909090909092,102.21428571428572,FALSE,304,0.9007407407407407,1,1,0,0,3,FALSE
68,2022-03-18T16:47:20Z,2022-03-18T17:03:30Z,969,1,2022-03-18T17:03:32Z,0.8999999761581421,Chrome,99.0.4844.51,Macintosh,1440,900,NA,1.6,469,42,232,49,30,106,-0.429437520768459,-0.41907219484719427,-0.6515553542118008,-0.6057554794699901,-0.6334490632699356,0.08337904509483783,2,2,1,1,2,1,1,2,1,2,2,1,1,1,2,2,3,1,2,2,1.0208355710680808,0,1,1,4,4,1.6,0,4,2,3,2,3,2,2,2,1,1,2,2,2,2,2,2,3,1,1,1,2,2,1,2,2,0,0,0,0,1,1,1,1,1,1,1,1,1,1,1,1,1,1,1,1,2,1,3,2,2,2,1,1,1,3,3,1,3,1,1,1,1,1,1,1,1,1,1,2,1,1.8125355955912383,1.1464230084422218,1.625,0,1.25,0,2.1333333333333333,0,1,0,1.4166666666666667,0,1.8333333333333333,0,1.2857142857142858,0,1,0,1.3243243243243243,0,1,0,0,-0.8203473360240647,-0.6784620964778383,-0.31345356682763886,-0.49595783165273855,2,1,3,1,1,2,1,3,3,1.2149857925879117,1.5714285714285714,0,3,0.14742818218000403,5,5,5,5,2,2,3,6,6,5,3,1.4638501094227998,6,3.857142857142857,0,0.6473058850354002,0,0.6174725797407661,2,2,2,2,2,4,4,4,4,3,5,4,5,4,4,5,3,5,4,3,1.2421180068162376,2,0,4.2,0,4.2,0,3.8,0,4.066666666666666,0,1,2,1,1,1,1,2,2,1,1,1,2,1,1,1,2,1,2,1,1,0.9403246919632545,1.3,0,I lived with my mother and father an equal amount of time (joint custody),0,"White, Caucasian, Anglo, European American",0,21,1,3,NA,1,3,4,University student,1,130,66,2,5,2,0,0,1,0,0,TRUE,TRUE,TRUE,TRUE,TRUE,3,0.526421875,0.5147906250040978,0.5360406250078231,0.6102806451628285,0.5645124999992549,0.6163312500026077,1,1,1,0.96875,1,1,0.201,0.285,0.811,0.018,1.562,18.306645152549216,1801.6325263299811,0.086,0.397,0.72,0.028,1.541,24.6554756918241,1810.567708300113,0.123,0.349,0.799,0.016,1.755,147.8085979563334,1972.6771035738855,86.77777777777779,55.035714285714285,109.68749999999999,FALSE,453,1.3422222222222222,0,1,0,0,3,FALSE
69,2022-03-18T16:43:12Z,2022-03-18T17:05:07Z,1314,1,2022-03-18T17:05:08Z,0.8999999761581421,Chrome,99.0.4844.74,Windows NT 10.0,1536,864,NA,1.7777777777777777,580,81,290,43,64,92,-0.2012104460937078,-0.20372372301517555,-0.44082571874711846,-0.6797514747082323,0.06375055786272243,-0.07395607082042113,2,2,2,2,2,1,2,2,1,2,3,1,2,2,2,2,2,1,2,3,0.7677718959499145,0,0,3,3,2,1.9,0,2,2,2,2,2,1,2,2,2,2,2,2,3,2,3,2,2,1,1,1,1,1,2,2,2,0,0,0,0,2,3,3,4,4,3,4,3,3,2,3,1,1,3,2,4,3,2,3,1,2,3,3,1,2,2,2,2,1,1,2,2,2,2,2,2,2,2,2,2,2,0.7960110763259728,1.0600988273786194,1.375,0,2,0,2.066666666666667,0,3.2222222222222223,0,2.25,0,2.1666666666666665,0,1.7142857142857142,0,2,0,2.3513513513513513,0,1,0,0,-0.31590916179008643,-0.36831841559995226,-0.05499485428507328,-0.21165663494251277,2,2,4,2,1,2,2,3,1,0.8997354108424374,2.142857142857143,0,2,0.09236228234767849,3,4,4,3,3,2,3,5,3,2,2,0.6900655593423543,4,3.142857142857143,0,-0.698640248793604,0,-0.5893424748675894,2,2,2,2,2,4,3,4,3,2,2,2,3,2,3,4,2,2,3,3,0.7237468644557459,2,0,2.4,0,3,0,3,0,2.8,0,2,2,2,2,2,2,2,3,3,2,2,3,3,2,2,3,1,2,2,3,0.4893604849295929,2.25,0,I lived with my mother and father an equal amount of time (joint custody),0,"White, Caucasian, Anglo, European American",0,28,0,1,NA,1,2,6,IT Associate,2,149,65,1,5,2,0,0,0,0,0,TRUE,TRUE,TRUE,TRUE,TRUE,5,0.5463516129032379,0.587981250000128,0.6313419354837988,0.6030700000002359,0.6269937499998487,0.690983870967802,1,1,0.96875,0.967741935483871,1,0.96875,0.067,0.364,0.244,0.042,1.699,199.08391770287162,2066.781878741251,0.148,0.318,0.566,0.021,1.247,5.9973052763409695,1787.0146793307724,0.059,0.385,0.413,0.02,1.654,141.82426622221342,1972.3465434046373,40.45238095238095,59.38095238095238,82.69999999999999,FALSE,541,1.6029629629629631,0,1,0,3,6,FALSE
70,2022-03-18T16:45:34Z,2022-03-18T17:05:50Z,1216,1,2022-03-18T17:05:52Z,0.8999999761581421,Chrome,99.0.4844.74,Windows NT 10.0,1536,864,NA,1.7777777777777777,693,69,242,56,30,73,0.031128828124732565,-0.2699847912711813,-0.615222658442028,-0.5194268183587075,-0.6334490632699356,-0.2874822995625583,2,2,1,1,1,1,1,3,1,2,1,1,1,1,1,2,1,1,1,1,1.3218806379747876,0,1,3,4,4,1.3,0,2,2,2,1,4,3,1,2,1,1,1,2,2,1,1,2,3,5,1,1,2,1,1,0,2,0,0,0,0,1,1,1,1,1,1,1,1,1,3,1,1,1,1,1,1,1,1,2,2,2,4,1,5,5,2,3,1,1,1,1,1,1,1,1,1,1,2,1,1,1,1.8583469679942586,1.5675276256394517,2,0,1.25,0,1.7333333333333334,0,1,0,1.4166666666666667,0,3.3333333333333335,0,1,0,1,0,1.5135135135135136,0,0,0,0,-0.45408135734113264,-0.606777016148105,-0.5328163702636706,-0.5697966932058878,5,5,5,3,5,5,3,4,1,1.7994708216848747,4.428571428571429,0,2.5,1.6127177983677767,4,4,4,4,1,3,3,6,7,2,3,1.1126972805283737,6.5,3.2857142857142856,0,0.09614488050146584,0,-0.027844510379484363,2,2,2,2,2,4,4,4,5,1,5,3,3,5,3,5,4,4,5,3,1.3972762620115438,2,0,4,0,3.6,0,4,0,3.8666666666666667,0,2,1,1,1,1,1,1,1,1,1,1,1,1,1,1,1,1,1,1,1,1.2258187382102494,1.05,0,"I lived with my mother, but not father, most of the time.",0,"White, Caucasian, Anglo, European American",0,18,1,2,NA,1,3,4,Student --- part time job at campus gym front desk,3,130,66,4,5,2,0,1,0,0,1,TRUE,TRUE,TRUE,TRUE,TRUE,6,0.5177593749761581,0.49789062498509884,0.4808218750357628,0.5965724138227002,0.5481884615237896,0.5881071428741728,1,1,1,0.9354838709677419,0.8387096774193549,0.875,0.058,0.354,0.478,0.006,1.189,65.43733367405785,1963.2355629248034,0.056,0.34,0.474,0.012,1.572,81.40962573341727,1950.5356995845648,0.061,0.375,0.398,0.025,1.959,77.97154554637486,1946.17909201749,198.16666666666669,131,78.36,FALSE,376,1.114074074074074,0,1,0,0,3,FALSE
71,2022-03-18T16:30:29Z,2022-03-18T17:05:53Z,2124,1,2022-03-18T17:05:54Z,0.8999999761581421,Chrome,99.0.4844.51,Windows NT 6.3,1366,768,Fun study!,1.7786458333333333,807,163,510,128,104,143,0.26552420211501754,0.24906024340086375,0.35849358818788357,0.368525124500199,0.8839854062540847,0.49919328001373653,1,1,1,1,1,1,1,1,1,1,1,1,1,1,1,1,1,1,1,1,1.538967528127731,0,0,2,3,2,1,0,3,1,1,1,1,1,3,2,1,1,2,1,3,2,2,1,3,1,1,2,3,2,2,0,2,0,0,0,0,1,1,3,2,3,1,1,1,1,2,1,2,1,2,3,3,3,2,2,3,2,3,2,1,1,4,1,1,1,4,2,5,2,2,1,1,1,1,2,1,4,1.4694077579620841,1.5796322658258457,1.875,0,2,0,1.6666666666666667,0,1.5555555555555556,0,2.1666666666666665,0,2,0,2.4285714285714284,0,1,0,1.945945945945946,0,0,0,0,-0.2544992971007324,-0.5016585650198677,-0.274357657721105,-0.38800811137048635,1,1,2,1,1,1,1,2,1,1.7320508075688772,1.1428571428571428,0,1.5,-0.6815819506204519,5,5,5,4,3,2,4,4,7,4,4,1.3801311186847085,5.5,4,0,0.6863762972672843,0,0.7186726334341398,2,2,2,3,2,4,4,4,5,3,5,4,3,4,4,5,5,5,4,3,1.3732131246511903,2.2,0,4.6,0,3.8,0,4,0,4.133333333333334,0,1,1,1,1,2,1,4,2,2,2,4,3,1,1,1,3,1,1,1,2,1.0894228312566052,1.75,0,I lived with my mother and father an equal amount of time (joint custody),0,Black or African American,0,24,1,2,NA,1,2,4,Preschool Teacher,1,180,65,3,5,2,0,0,1,0,0,TRUE,TRUE,TRUE,TRUE,TRUE,5,0.6805874999761582,0.5735781249403954,0.6803562499284744,0.7489290320488714,0.6531156249642373,0.792200000166893,1,1,1,0.96875,1,1,0.124,0.415,0.463,0.008,1.201,78.05135740699745,1860.9715326343974,0.189,0.284,0.643,0.015,1.417,71.410777246156,1855.0285591688282,0.072,0.478,0.359,0.015,1.483,67.61117617039122,1894.6444995698996,150.125,94.46666666666667,98.86666666666667,FALSE,344,1.0192592592592593,0,1,0,0,3,FALSE
72,2022-03-18T16:51:35Z,2022-03-18T17:07:14Z,938,1,2022-03-18T17:07:15Z,0.8999999761581421,Chrome,99.0.4844.51,Macintosh,1440,900,NA,1.6,434,63,199,48,40,58,-0.5014010127830202,-0.3031153253991842,-0.7714532502520511,-0.6180881453430304,-0.42839035117209495,-0.4560556380431929,2,1,1,1,2,1,3,3,1,1,3,1,1,1,2,2,2,1,3,2,1.0711528467275955,0,1,1,4,5,1.7,0,3,1,4,1,4,2,3,3,1,3,5,3,2,4,2,2,4,1,1,3,4,2,5,4,2,0,0,0,0,2,1,1,1,1,2,5,1,4,4,2,4,1,2,1,1,1,5,5,5,5,1,1,1,1,3,1,1,3,4,1,2,3,1,1,1,3,2,1,2,2,1.7058458048457692,1.2227992865708155,2.75,0,1.75,0,2.7333333333333334,0,2,0,3,0,1.3333333333333333,0,2.142857142857143,0,1.6666666666666667,0,2.2162162162162162,0,2,0,0,0.48899870753108776,0.46407418383926874,0.07821504497010326,0.271144614404686,2,2,3,1,1,2,1,1,1,1.1547005383792515,1.7142857142857142,0,1,-0.5432457265250663,5,5,5,5,5,5,5,6,8,6,4,1.5118578920369088,7,5,0,1.384971609293624,0,1.6859984401799282,3,4,3,3,3,2,5,4,4,5,5,5,5,5,5,5,5,5,5,5,1.8973665961010275,3.2,0,4.4,0,5,0,4.6,0,4.666666666666667,0,3,3,3,3,4,3,3,3,3,4,3,1,2,1,1,1,2,3,2,3,0.910465468000326,2.55,0,I lived with my mother and father an equal amount of time (joint custody),0,"White, Caucasian, Anglo, European American",0,24,1,2,NA,1,3,6,Writer/Director,5,145,68,5,5,2,0,0,1,0,0,TRUE,TRUE,TRUE,TRUE,TRUE,5,0.44041875000018627,0.43377812499925494,0.4494374999953434,0.5404037037006131,0.5231354838696218,0.5365483870967742,1,1,1,0.84375,1,0.96875,0.075,0.343,0.724,0.022,2.005,74.20275687405555,1900.1126209585016,0.066,0.341,0.726,0.014,1.455,148.69457356834602,1937.5291668728903,0.055,0.356,0.658,0.021,2.182,42.46644293038855,1905.7724337070895,91.13636363636364,103.92857142857143,103.9047619047619,FALSE,394,1.1674074074074074,0,1,0,0,3,FALSE
76,2022-03-18T16:53:16Z,2022-03-18T17:09:24Z,967,1,2022-03-18T17:09:25Z,0.8999999761581421,Chrome,99.0.4844.74,Windows NT 10.0,1920,1080,NA,1.7777777777777777,486,64,226,63,29,55,-0.3944838246471007,-0.2975935697111837,-0.6733549716736644,-0.4330981572474249,-0.6539549344797195,-0.48977030573931984,2,2,3,2,3,2,3,3,2,2,2,2,2,3,3,3,2,1,1,2,0.6863327411532597,0,1,1,5,4,2.25,0,1,1,1,1,1,5,1,1,1,1,3,1,2,1,4,1,1,1,1,1,1,1,1,0,2,0,0,0,0,1,3,2,1,1,1,1,1,1,1,1,1,1,1,1,1,2,1,1,2,1,2,1,1,1,1,1,1,1,1,1,1,1,1,1,1,1,1,1,1,1,1.834766024965136,1.88477610139267,1,0,1,0,1.6666666666666667,0,1.3333333333333333,0,1.1666666666666667,0,1.1666666666666667,0,1,0,1,0,1.162162162162162,0,0,0,0,-1.331365138617617,-1.2258843765815763,-0.6189692744445258,-0.922426825513051,2,1,4,1,1,1,1,2,1,1.1338934190276817,1.5714285714285714,0,1.5,-0.4327781896031293,4,4,4,4,3,3,5,3,3,3,3,1.1126972805283737,3,3.857142857142857,0,-0.3222341343576166,0,0.026935919170246264,1,3,2,1,1,5,1,5,3,3,5,5,5,5,5,5,5,1,5,1,1.9223002094465098,1.6,0,4.2,0,3.8,0,3.8,0,3.933333333333333,0,1,1,1,4,1,2,1,1,2,1,1,2,2,2,1,3,1,2,1,1,0.8255779474818965,1.55,0,I lived with my mother and father an equal amount of time (joint custody),0,"White, Caucasian, Anglo, European American",0,20,0,1,NA,1,3,4,"Student, also a part time nurse aide",4,155,72,3,5,2,0,0,1,0,0,TRUE,TRUE,TRUE,TRUE,TRUE,5,0.5975999999995033,0.5145161290332194,0.5506000000005588,0.64732413793124,0.5782733333334327,0.6200633333330353,0.9375,0.96875,1,0.90625,0.9375,0.9375,0.059,0.421,0.446,0.021,1.747,124.9862433918468,1969.0474277493372,0.052,0.414,0.479,0.015,1.348,121.21317385772177,2015.0377696702924,0.047,0.47,0.369,0.023,1.746,144.2436739412969,2089.295921497155,83.19047619047619,89.86666666666667,75.91304347826087,FALSE,304,0.9007407407407407,1,1,0,0,3,FALSE
78,2022-03-18T16:25:53Z,2022-03-18T17:10:06Z,2652,1,2022-03-18T17:10:07Z,0.8999999761581421,Firefox,98.0,Macintosh,1440,900,NA,1.6,1882,57,368,72,43,68,2.4758314568479682,-0.33624585952718705,-0.15743069174289046,-0.3221041643900616,-0.36687273754274274,-0.3436734123894365,3,4,1,2,3,1,1,3,1,3,4,1,1,2,3,3,1,1,3,3,0.512989176042577,0,1,1,2,1,2.2,0,2,2,2,2,2,1,1,2,2,1,2,2,2,2,2,1,1,1,1,1,1,1,1,0,1,1,0,0,0,1,2,2,2,3,1,1,1,1,2,1,1,1,3,1,2,2,1,1,1,1,1,1,1,1,2,1,1,1,1,1,1,1,1,1,1,1,1,1,1,1,1.7054056433612528,1.3020130933435712,1,0,1,0,1.8,0,1.5555555555555556,0,1.4166666666666667,0,1.1666666666666667,0,1,0,1,0,1.2972972972972974,0,0,0,0,-1.2436367604899685,-1.1086709118997626,-0.6189692744445258,-0.8638200931721443,3,3,3,2,3,3,2,1,1,0.4879500364742666,2.7142857142857144,0,1,0.037296382515353055,5,5,5,5,3,3,5,6,7,5,3,1.5735915849388864,6.5,4.428571428571429,0,0.7376207874909593,0,0.9820931408732985,2,2,2,2,2,4,5,4,4,4,4,5,4,3,4,2,4,4,3,2,1.1464230084422218,2,0,4.2,0,3.6,0,3.4,0,3.7333333333333334,0,2,1,1,3,4,2,2,3,3,1,2,3,1,2,1,2,1,2,2,2,0.7880689256524124,2,0,I lived with my mother and father an equal amount of time (joint custody),0,Black or African American,0,30,1,2,NA,1,3,6,consultant,4,145,65,4,5,2,0,0,1,0,0,TRUE,TRUE,TRUE,TRUE,TRUE,6,0.5929375,0.49665625,0.5120333333333333,0.6497,0.5590625,0.5707741935483871,1,1,1,0.967741935483871,1,0.96875,0.056,0.398,0.496,0.024,1.667,173.5878660034323,2005.3841677881014,0.175,0.258,0.767,0.011,1.197,62.731366625436735,1844.3720115663377,0.068,0.44,0.436,0.018,1.485,89.50835214644171,1915.0426077107275,69.45833333333333,108.81818181818183,82.50000000000001,FALSE,490,1.451851851851852,0,1,0,3,6,FALSE
80,2022-03-18T16:51:58Z,2022-03-18T17:10:49Z,1131,1,2022-03-18T17:10:51Z,0.8999999761581421,Chrome,99.0.4844.51,Macintosh,1440,900,NA,1.6,553,82,252,51,32,54,-0.25672513993351215,-0.19820196732717507,-0.5788899626722551,-0.5810901477239093,-0.5924373208503674,-0.5010085283046954,3,3,1,1,3,1,3,3,1,3,4,2,1,4,3,3,2,1,2,3,0.812727700887249,0,1,4,3,3,2.35,0,4,1,4,1,5,2,2,2,2,1,1,3,2,3,2,2,4,1,2,1,2,2,3,0,1,1,0,2,0,1,2,1,3,2,1,4,3,2,2,2,4,1,1,2,2,5,4,4,5,5,4,1,1,1,1,1,2,1,3,1,1,3,3,1,1,1,1,1,1,2,1.5701800742161598,1.4142135623730951,2.125,0,1.25,0,2.3333333333333335,0,2.111111111111111,0,3.0833333333333335,0,1.5,0,2,0,1,0,2.2162162162162162,0,0,0,0,0.08325495869071374,0.01655868235694198,-0.5328163702636706,-0.2581288439533643,1,1,1,1,1,1,1,1,1,1.9518001458970664,1,0,1,-0.9579186615539372,5,5,5,5,3,1,5,6,7,6,5,1.9023794624226837,6.5,4.142857142857143,0,1.6378673238553392,0,1.3756185169643507,4,4,3,2,4,2,4,4,4,3,5,5,4,3,4,1,5,5,3,2,1.3732131246511903,3.4,0,4.4,0,3,0,3.4,0,3.6,0,2,3,3,4,4,2,3,3,4,2,3,2,2,4,1,3,1,3,4,3,0.99472291830968,2.8,0,I lived with my mother and father an equal amount of time (joint custody),0,"White, Caucasian, Anglo, European American",0,24,1,2,NA,1,3,4,Dog Walker,4,135,63,2,5,2,0,0,1,0,0,TRUE,TRUE,TRUE,TRUE,TRUE,5,0.5270624999925494,0.4617125000022352,0.5015000000074505,0.5934899999976158,0.5380586206871888,0.5812125000022351,1,1,1,0.967741935483871,0.9354838709677419,1,0.126,0.3,0.648,0.01,1.232,88.6815591308823,1873.7801656507838,0.065,0.317,0.465,0.018,1.874,77.92480196011309,1921.5278583811114,0.071,0.373,0.48,0.014,1.453,67.40703547501437,1891.2846374084365,123.2,104.11111111111113,103.78571428571429,FALSE,434,1.285925925925926,0,1,0,0,3,FALSE
81,2022-03-18T16:52:07Z,2022-03-18T17:12:07Z,1199,1,2022-03-18T17:12:08Z,0.8999999761581421,Chrome,99.0.4844.51,Macintosh,1440,900,no,1.6,689,73,232,23,36,85,0.022904429037354145,-0.24789776851917938,-0.6515553542118008,-0.9264047921690396,-0.5104138360112311,-0.1526236287780506,2,3,2,2,3,2,3,3,1,3,3,1,1,2,3,3,1,2,3,3,0.5525062514530825,0,1,1,4,4,2.3,0,2,3,3,2,3,1,4,2,2,2,2,2,2,3,2,2,2,1,1,1,1,1,1,0,1,1,0,0,0,2,2,2,2,2,2,3,3,1,3,4,3,3,2,4,3,2,2,3,3,2,2,1,1,1,1,1,2,1,1,1,2,2,2,1,1,1,1,2,2,2,1.2603922360077393,0.9611501047232549,1.25,0,1.75,0,2.3333333333333335,0,2.111111111111111,0,2.8333333333333335,0,1.1666666666666667,0,1.5714285714285714,0,1,0,2,0,0,0,0,-0.6251516946900472,-0.45986685152173795,-0.3605105619019602,-0.41018870671184904,2,2,3,1,1,2,1,1,1,1.1547005383792515,1.7142857142857142,0,1,-0.5432457265250663,5,5,5,5,3,3,5,8,7,4,3,1.5735915849388864,7.5,4.428571428571429,0,0.7044252900722463,0,0.9618741114371575,4,4,4,2,2,2,3,3,2,2,4,3,2,5,3,4,2,4,1,3,1.0600988273786194,3.2,0,3,0,2.4,0,3.2,0,2.8666666666666667,0,4,2,4,3,4,4,3,2,3,3,3,3,2,4,3,3,3,4,3,3,0.7591546545162482,3.15,0,I lived with my mother and father an equal amount of time (joint custody),0,Black or African American,0,19,1,2,NA,1,3,4,Student,3,140,66,3,5,4,0,0,2,1,0,TRUE,TRUE,TRUE,TRUE,TRUE,3,0.5938548387116002,0.4948124999990687,0.5750343750016764,0.6146593749998137,0.5368966666688522,0.6037548387117924,1,1,1,1,0.967741935483871,0.96875,0.063,0.393,0.354,0.066,1.923,44.758932494292225,1868.9199556264678,0.053,0.388,0.491,0.039,1.84,45.82127648288013,1871.775208506884,0.112,0.372,0.512,0.04,1.587,76.56999466016399,1858.43588229249,29.136363636363637,47.17948717948718,39.675,FALSE,442,1.3096296296296297,0,1,0,0,3,FALSE
83,2022-03-18T16:33:39Z,2022-03-18T17:13:29Z,2390,1,2022-03-18T17:13:30Z,1,Chrome,99.0.4844.57,CrOS x86_64 14469.41.0,1536,864,No,1.7777777777777777,558,133,566,703,75,127,-0.24644464107428912,0.08340757276084937,0.5619566844986114,7.459808001498411,0.28931514117034707,0.31938171896772627,2,2,2,1,2,1,2,2,1,2,3,2,1,2,2,2,2,1,2,2,0.8335087534664907,1,1,1,4,4,1.8,0,2,2,2,1,1,2,2,1,1,1,1,2,2,2,2,1,1,1,1,2,1,2,1,0,2,0,0,0,0,1,1,1,1,1,1,1,1,1,1,1,1,1,1,1,1,1,1,2,1,3,1,1,1,1,1,1,1,1,1,1,1,1,2,1,1,1,1,1,1,1,1.9199443185119163,1.4960264830861913,1.25,0,1,0,1.6,0,1,0,1.25,0,1,0,1.1428571428571428,0,1,0,1.1081081081081081,0,0,0,0,-1.204158990332527,-1.16944097999822,-0.6189692744445258,-0.8942051272213729,1,1,2,1,1,2,1,1,1,1.6761634196950514,1.2857142857142858,0,1,-0.7920494875423887,5,5,5,5,3,2,5,6,7,6,4,1.7043362064926932,6.5,4.285714285714286,0,1.2946567068380648,0,1.2439752038067187,1,3,2,3,2,5,5,4,4,1,5,5,2,5,5,4,5,4,5,5,1.791514389985135,2.2,0,4.8,0,3.4,0,4.6,0,4.266666666666667,0,2,1,1,2,2,1,3,1,1,3,2,2,1,2,2,2,1,1,2,2,0.9176629354822471,1.7,0,I lived with my mother and father an equal amount of time (joint custody),0,"White, Caucasian, Anglo, European American",0,23,1,2,NA,1,3,7,Music Teacher,6,230,64,1,5,2,0,1,3,0,1,TRUE,TRUE,TRUE,TRUE,TRUE,1,0.5353812500000932,0.4559999999999418,0.45418437499998254,0.5898777777777502,0.5382774193548868,0.5295032258065597,1,1,1,0.8709677419354839,0.96875,0.96875,0.064,0.335,0.506,0.03,2.024,105.49277789258089,1928.8784521024393,0.077,0.288,0.502,0.014,1.652,86.37450143071842,1911.3649968002078,0.062,0.346,0.425,0.017,1.859,95.63489482617835,1958.2796030001866,67.46666666666667,117.99999999999999,109.35294117647058,FALSE,788,2.334814814814815,0,1,0,0,3,FALSE
84,2022-03-18T16:52:32Z,2022-03-18T17:14:42Z,1330,1,2022-03-18T17:14:44Z,0.8999999761581421,Chrome,99.0.4844.51,Macintosh,1280,800,NA,1.6,514,98,284,55,37,95,-0.3369130310354517,-0.10985387631916742,-0.4626253362089821,-0.5317594842317478,-0.4899079648014471,-0.040241403124294216,2,2,2,1,2,1,1,2,1,2,3,1,1,1,2,2,1,1,2,2,0.9733285267845752,0,1,1,4,3,1.6,0,1,1,1,3,1,1,1,1,1,1,1,1,3,1,1,1,2,1,1,1,1,1,1,0,2,0,0,0,0,1,1,1,1,1,1,2,1,1,1,1,1,1,1,1,1,1,1,1,1,3,1,1,1,1,1,1,1,1,1,1,1,1,1,1,1,1,1,1,1,1,1.9234603452371197,1.9223002094465098,1.125,0,1,0,1.2666666666666666,0,1.1111111111111112,0,1.1666666666666667,0,1,0,1,0,1,0,1.0810810810810811,0,0,0,0,-1.3028534157261313,-1.3813495507946194,-0.6189692744445258,-1.0001594126195725,5,5,5,3,4,5,3,5,1,1.6761634196950514,4.285714285714286,0,3,1.7231853352897135,5,5,5,5,1,1,1,1,3,1,1,1.9518001458970664,2,3.2857142857142856,0,-1.6169357779629459,0,-1.0712639784803049,2,2,2,3,2,5,5,5,5,1,5,5,4,5,5,5,4,5,5,5,1.9198214202665531,2.2,0,4.8,0,4,0,5,0,4.6,0,1,1,1,2,1,1,2,1,1,1,1,1,1,2,1,2,1,1,1,2,1.0399898784932577,1.25,0,I lived with my mother and father an equal amount of time (joint custody),0,"White, Caucasian, Anglo, European American",0,27,1,2,NA,1,3,3,Daycare Director,2,135,64,2,5,2,0,0,1,0,0,TRUE,TRUE,TRUE,TRUE,TRUE,1,0.601245161293495,0.47063124999869616,0.5162718750010244,0.687875,0.5403562500006519,0.5939687499990687,1,1,1,1,1,1,0.118,0.322,0.627,0.018,1.789,53.82601074417437,1840.1852256807822,0.088,0.333,0.646,0.012,1.199,48.171023862604684,1830.8579417216406,0.091,0.347,0.41,0.008,1.253,170.85678787633157,1957.1379186654358,99.38888888888889,99.91666666666667,156.62499999999997,FALSE,386,1.1437037037037037,0,1,0,0,3,FALSE
85,2022-03-18T16:54:34Z,2022-03-18T17:14:50Z,1215,1,2022-03-18T17:14:50Z,0.8999999761581421,Chrome,99.0.4844.51,Windows NT 10.0,1280,720,NA,1.7777777777777777,569,79,312,66,50,90,-0.22382754358399845,-0.2147672343911765,-0.3608937880536182,-0.3961001596283038,-0.22333163907425438,-0.09643251595117242,3,1,3,2,3,1,1,3,1,3,2,2,3,1,3,3,1,1,3,3,0.8255779474818965,0,1,1,4,4,2.15,0,2,2,2,3,2,2,3,2,2,2,1,2,2,2,2,2,3,3,1,1,2,2,1,1,2,0,0,0,0,2,2,2,2,2,1,1,1,1,1,1,1,1,2,2,3,4,3,1,1,2,2,1,3,2,3,1,1,2,2,2,3,4,3,1,1,1,2,2,2,2,1.4606962838433024,1.0327955589886444,1.875,0,2,0,2.066666666666667,0,1.5555555555555556,0,1.8333333333333333,0,2,0,2.4285714285714284,0,1,0,1.837837837837838,0,1,0,0,-0.3246819996028513,-0.3742184222114529,-0.05499485428507328,-0.2146066382482631,2,2,3,2,2,2,2,2,1,0.7867957924694432,2.142857142857143,0,1.5,-0.10103984158003264,4,4,4,4,2,2,3,3,4,3,2,0.9511897312113419,3.5,3.2857142857142856,0,-0.5751298489193319,0,-0.4367109100209476,2,2,3,2,2,3,4,3,4,3,2,3,4,3,3,3,3,3,3,3,0.5345224838248488,2.2,0,2.8,0,3.4,0,3.2,0,3.1333333333333333,0,3,1,3,2,3,2,2,3,2,3,2,2,2,2,1,3,3,3,2,2,0.6569466853317864,2.3,0,I lived with my mother and father an equal amount of time (joint custody),0,"White, Caucasian, Anglo, European American",0,23,1,2,NA,1,3,6,Receptionist,4,170,67,2,5,2,0,0,0,0,0,TRUE,TRUE,TRUE,TRUE,TRUE,4,0.5725406250134111,0.5094781249836087,0.5232593749761582,0.6274999999769272,0.5664124999791383,0.5817250000238419,1,1,1,1,1,1,0.097,0.377,0.692,0.024,1.679,17.393600429661088,1800.9991663549458,0.101,0.307,0.51,0.02,1.66,110.092629782875,1894.43835349021,0.196,0.301,0.707,0.025,1.421,54.31533267872756,1837.853150629852,69.95833333333333,83,56.839999999999996,FALSE,372,1.1022222222222222,0,1,0,0,3,FALSE
86,2022-03-18T16:53:01Z,2022-03-18T17:14:52Z,1310,1,2022-03-18T17:14:52Z,0.8999999761581421,Chrome,99.0.4844.74,Windows NT 10.0,1536,864,none,1.7777777777777777,617,87,328,104,56,67,-0.12513475453545742,-0.17059318888717268,-0.30276147482198174,0.07254114354723017,-0.10029641181555002,-0.35491163495481215,2,2,2,2,3,1,3,3,3,3,3,3,1,1,3,3,3,2,3,3,0.6708203932499369,0,1,2,3,2,2.45,0,4,3,2,3,3,3,3,3,2,4,4,3,2,3,3,2,4,1,1,1,2,2,3,0,2,0,0,0,0,2,2,2,2,2,1,1,1,1,2,2,3,3,3,2,2,3,3,5,5,3,4,1,2,1,1,1,1,1,1,1,1,2,2,1,3,3,2,2,1,1,1.460182225659569,0.6399404734221844,2,0,1.5,0,3,0,1.5555555555555556,0,3,0,1.6666666666666667,0,1.2857142857142858,0,2.3333333333333335,0,2.054054054054054,0,0,0,0,-0.1031678448305387,0.18225053469658598,-0.4466634660828154,-0.1322064656931147,1,1,3,2,1,1,1,3,2,1.5275252316519468,1.4285714285714286,0,2.5,-0.12890852875348124,3,3,3,4,2,2,3,3,3,4,3,0.6900655593423543,3,2.857142857142857,0,-0.10840883202778547,0,-0.38464405773870514,2,3,2,2,2,4,4,3,4,2,4,3,2,3,4,3,3,3,4,4,0.7988086367179802,2.2,0,3.4,0,3,0,3.6,0,3.3333333333333335,0,1,1,3,4,2,4,3,4,4,4,3,4,2,4,2,3,1,4,4,4,1.2763022245616642,3.05,0,I lived with my mother and father an equal amount of time (joint custody),0,"White, Caucasian, Anglo, European American",0,25,0,1,NA,1,2,6,unemployed,3,156,67,3,5,2,0,0,1,0,0,TRUE,TRUE,TRUE,TRUE,TRUE,3,0.5193906249999418,0.49326874999995923,0.5555500000000902,0.6237933333333271,0.5825689655172414,0.6714166666665735,1,1,1,0.9375,0.9354838709677419,0.9375,0.066,0.403,0.407,0.016,1.802,88.35724199069006,1938.3331292150053,0.066,0.364,0.511,0.021,1.891,89.60784481747056,1940.1513082077547,0.073,0.361,0.474,0.014,1.681,37.188909869078365,1884.4567080685797,112.625,90.04761904761904,120.07142857142857,FALSE,376,1.114074074074074,0,1,0,3,6,FALSE
88,2022-03-18T16:57:37Z,2022-03-18T17:15:41Z,1084,1,2022-03-18T17:15:42Z,1,Chrome,99.0.4844.74,Windows NT 10.0,1920,1080,NA,1.7777777777777777,494,83,287,63,43,56,-0.3780350264723438,-0.1926802116391746,-0.4517255274780503,-0.4330981572474249,-0.36687273754274274,-0.4785320831739442,2,2,1,1,2,1,2,3,1,2,2,1,1,1,2,2,1,2,2,2,0.9445132413883326,0,1,2,3,2,1.65,0,3,2,3,3,4,4,3,3,3,3,2,3,2,3,4,3,3,3,2,2,2,4,2,1,1,1,0,0,0,2,4,4,2,3,2,3,2,2,2,2,2,2,3,3,2,4,3,2,2,3,3,2,1,2,3,1,1,2,1,1,3,3,4,1,1,1,2,2,2,2,1.0953080387268688,0.6546536707079771,2.625,0,2,0,3,0,2.6666666666666665,0,2.5,0,2,0,2.142857142857143,0,1,0,2.27027027027027,0,1,0,0,0.4429413090140726,0.5495259462625031,-0.05499485428507328,0.2472655459887149,2,2,3,2,1,2,2,2,1,0.9511897312113419,2,0,1.5,-0.1839744285858068,4,4,4,4,2,2,4,6,6,4,3,1.0690449676496976,6,3.4285714285714284,0,0.43348058270556905,0,0.255025804242946,3,3,3,3,3,3,3,2,3,4,4,3,3,3,4,4,4,4,3,3,0.7037315505489968,3,0,3.6,0,3.4,0,3,0,3.3333333333333335,0,1,1,1,2,2,1,2,2,1,1,1,2,2,2,2,2,1,2,2,2,0.7677718959499145,1.6,0,Prefer not to say.,0,"White, Caucasian, Anglo, European American",0,21,0,1,NA,1,3,4,Student,4,140,71,2,5,2,0,0,1,0,0,TRUE,TRUE,TRUE,TRUE,TRUE,5,0.5368483870933133,0.5086125000026077,0.5473062500059604,0.6005468749962747,0.5531774193471478,0.6264032258045289,0.96875,1,1,1,0.96875,1,0.071,0.435,0.603,0.017,1.251,38.06410608998551,1819.8230070279305,0.062,0.364,0.399,0.024,1.582,122.37857352273653,1950.2902724714138,0.084,0.393,0.587,0.034,1.923,184.25628818769502,2028.3690551958214,73.58823529411764,65.91666666666667,56.55882352941176,FALSE,276,0.8177777777777777,0,1,0,0,3,FALSE
89,2022-03-18T16:52:39Z,2022-03-18T17:16:00Z,1401,1,2022-03-18T17:16:01Z,0.8999999761581421,Chrome,99.0.4844.74,Macintosh,1440,900,Thank you!,1.6,669,83,350,96,56,87,-0.018217566399537956,-0.1926802116391746,-0.22282954412848152,-0.026120183437092773,-0.10029641181555002,-0.13014718364729932,2,2,2,2,2,2,3,2,2,2,3,2,1,2,2,2,2,2,2,2,0.6048053188292994,0,1,4,4,4,2.05,0,3,3,2,3,2,2,3,3,2,2,4,3,1,3,2,2,2,2,1,1,2,2,3,4,2,0,0,0,0,2,2,2,1,1,3,2,2,3,2,2,3,2,2,2,1,3,3,2,3,3,2,1,1,1,3,2,1,3,3,1,2,2,2,1,3,3,1,2,2,2,1.196842693269434,0.816496580927726,1.875,0,1.75,0,2.533333333333333,0,2,0,2.3333333333333335,0,1.6666666666666667,0,2,0,2.3333333333333335,0,2.081081081081081,0,2,0,0,-0.166770918973084,-0.06427140822061723,0.07821504497010326,0.006971818374743012,2,2,3,1,1,2,1,1,1,1.1547005383792515,1.7142857142857142,0,1,-0.5432457265250663,3,3,3,3,3,3,4,5,5,3,3,0.3779644730092272,5,3.142857142857143,0,0.03902547546461973,0,-0.1400380163538443,2,3,3,3,3,4,3,4,4,3,4,3,3,2,4,3,3,5,3,2,0.816496580927726,2.8,0,3.8,0,3,0,3.2,0,3.3333333333333335,0,1,1,1,3,2,1,2,2,2,2,1,2,2,1,2,2,1,1,3,1,0.7863975156570492,1.65,0,NA,NA,"Black or African American & White, Caucasian, Anglo, European American",1,30,1,3,NA,1,3,6,Internet Safety Evaluator,3,120,62,3,5,2,0,0,0,0,0,TRUE,TRUE,TRUE,TRUE,TRUE,3,0.6816774193548312,0.7870062499999876,0.5743718749999971,0.7573468749999883,0.8498687499999978,0.6374566666666573,1,1,1,1,1,1,0.16,0.348,0.729,0.009,0.992,42.925082969790665,1825.8501447777803,0.245,0.292,0.493,0.014,1.177,52.413847966351156,1836.1213064196609,0.089,0.367,0.344,0.023,1.971,60.708238235764185,1844.5702387543697,110.22222222222223,84.07142857142857,85.69565217391305,TRUE,431,1.2770370370370372,0,1,0,0,3,FALSE
90,2022-03-18T16:55:20Z,2022-03-18T17:16:28Z,1268,1,2022-03-18T17:16:29Z,1,Firefox,98.0,Windows NT 10.0,2560,1440,N/A - No technical issues or otherwise!,1.7777777777777777,585,69,400,60,41,50,-0.19092994723448478,-0.2699847912711813,-0.04116606527961743,-0.470096154866546,-0.40788447996231086,-0.5459614185661981,1,2,1,1,2,1,2,2,1,1,3,1,1,1,2,1,1,1,4,2,1.190974832912761,0,0,2,3,3,1.55,0,3,2,2,3,2,2,3,3,3,2,2,2,3,3,4,2,2,2,1,2,2,3,2,3,1,1,0,2,0,1,2,3,2,3,3,1,2,1,1,2,1,1,3,3,2,2,2,1,1,1,2,1,1,1,3,1,1,3,3,3,2,2,1,2,4,1,2,2,2,2,1.3852504895934594,0.7037315505489968,2,0,2,0,2.6,0,2,0,1.6666666666666667,0,1.5,0,2.142857142857143,0,2.3333333333333335,0,1.864864864864865,0,2,0,0,-0.2259875742092467,-0.07498975356484339,0.16436794915095845,0.04468909779305753,4,4,5,4,2,4,5,3,3,1.4638501094227998,4,0,3,1.5573161612781652,2,3,4,4,1,1,2,6,6,2,1,1.3801311186847085,6,2.4285714285714284,0,-0.680591255988642,0,-0.9653623987899889,2,2,3,3,3,4,5,3,5,4,4,4,4,3,5,3,4,4,4,3,1.1872336794093274,2.6,0,4,0,4,0,3.8,0,3.933333333333333,0,2,1,1,2,2,4,2,3,2,1,4,3,1,4,1,3,1,4,2,2,1.0894228312566052,2.25,0,"I lived with my mother, but not father, most of the time.",0,"White, Caucasian, Anglo, European American",0,28,0,1,NA,1,2,4,"Unemployed, free-lance web developer",2,145,68,2,5,2,0,0,1,0,0,TRUE,TRUE,TRUE,TRUE,TRUE,3,0.626875,0.576375,0.5336875,0.6825517241379311,0.7073666666666667,0.7047741935483871,1,1,1,0.90625,0.967741935483871,0.96875,0.086,0.369,0.531,0.011,1.836,47.61326491901404,1874.381562965032,0.077,0.339,0.307,0.013,1.797,68.57007933442169,1893.576734561261,0.062,0.377,0.263,0.017,1.859,72.40102053335946,1927.5901187556124,166.90909090909093,138.23076923076923,109.35294117647058,TRUE,226,0.6696296296296296,0,1,0,0,3,FALSE
91,2022-03-18T16:50:55Z,2022-03-18T17:16:36Z,1541,1,2022-03-18T17:16:37Z,1,Chrome,99.0.4844.51,Macintosh,1440,900,No feedback,1.6,569,120,386,116,86,139,-0.22382754358399845,0.01162474881684313,-0.09203183935729937,0.22053313402371458,0.5148797244779717,0.45424038975223396,2,2,1,1,3,1,2,2,1,2,4,1,1,1,2,2,1,1,3,3,0.8944271909999159,0,1,1,4,2,1.8,0,2,1,1,1,1,1,5,1,1,1,1,1,1,5,1,1,1,1,1,1,1,1,1,1,2,0,0,0,0,1,1,2,1,1,1,1,1,1,2,1,1,1,1,1,1,1,1,1,2,2,1,1,1,1,2,2,1,2,2,1,1,1,1,1,1,1,2,1,1,1,1.8265640794498113,1.869555587629877,1,0,1.25,0,1.6,0,1.1111111111111112,0,1.25,0,1.3333333333333333,0,1.2857142857142858,0,1,0,1.2162162162162162,0,1,0,0,-1.2962737873665577,-1.2313910494189768,-0.31345356682763886,-0.7724223081233078,1,1,1,1,1,1,1,3,1,1.9518001458970664,1,0,2,-0.571114413698515,5,5,5,5,3,3,4,1,4,3,2,1.2909944487358056,2.5,4.285714285714286,0,-0.7557596538304501,0,-0.004911903675855145,2,3,2,1,2,4,4,4,5,1,2,4,4,4,4,3,2,5,2,1,1.3345232785352157,2,0,3.4,0,2.8,0,3.6,0,3.2666666666666666,0,1,1,1,1,2,1,1,2,2,2,2,2,2,2,1,2,2,2,2,1,0.8522416262267903,1.6,0,I lived with my mother and father an equal amount of time (joint custody),0,"Hispanic of Latino (e.g., Mexican American, Central American, and others)",0,23,1,2,NA,1,4,4,Restaurant employee,4,122,61,3,5,2,0,0,1,0,0,TRUE,TRUE,TRUE,TRUE,TRUE,2,0.5551968749995576,0.4955531249997439,0.5627437500002561,0.6007500000001165,0.5775548387095332,0.6536406249998836,1,1,1,1,0.96875,1,0.238,0.24,0.743,0.014,1.505,15.663765050630445,1798.0737503702173,0.055,0.399,0.577,0.012,1.391,80.92186098595268,1908.3320159330337,0.164,0.304,0.687,0.022,1.571,108.9126320532328,1893.978455636339,107.49999999999999,115.91666666666667,71.4090909090909,FALSE,444,1.3155555555555554,0,1,0,0,3,FALSE
92,2022-03-18T16:54:29Z,2022-03-18T17:16:43Z,1334,1,2022-03-18T17:16:44Z,1,Chrome,98.0.4758.107,CrOS x86_64 14388.61.0,1366,768,NA,1.7786458333333333,486,80,231,57,42,80,-0.3944838246471007,-0.20924547870317603,-0.6551886237887781,-0.5070941524856671,-0.38737860875252683,-0.20881474160492883,3,3,3,3,4,2,1,3,1,3,3,2,2,2,3,3,2,1,4,3,0.5871429486123998,0,1,4,3,2,2.55,0,2,2,1,1,1,1,2,1,1,1,1,2,1,2,2,1,1,1,1,1,1,1,1,0,2,0,0,0,0,1,1,1,1,1,1,1,1,1,1,1,1,1,1,1,1,1,1,1,1,1,1,1,1,1,1,1,1,1,1,1,1,1,1,1,1,1,1,1,1,1,1.9666895707934864,1.6417180315870614,1,0,1,0,1.4,0,1,0,1,0,1,0,1,0,1,0,1,0,0,0,0,-1.4366391923707953,-1.413111253053198,-0.6189692744445258,-1.016040263748862,1,1,2,1,1,1,1,1,2,1.7320508075688772,1.1428571428571428,0,1.5,-0.6815819506204519,5,5,5,5,5,5,5,7,8,6,4,1.5118578920369088,7.5,5,0,1.475286511749183,0,1.7410083003497518,2,3,2,2,2,4,4,4,4,2,4,4,4,4,4,4,4,4,4,4,1.01418510567422,2.2,0,4,0,3.6,0,4,0,3.8666666666666667,0,2,1,1,2,2,2,2,2,1,1,2,2,1,1,1,2,1,1,2,2,0.7863975156570492,1.55,0,I lived with my mother and father an equal amount of time (joint custody),0,"White, Caucasian, Anglo, European American",0,29,1,2,NA,1,3,7,Homemaker,5,120,69,3,5,2,0,0,1,0,0,TRUE,TRUE,TRUE,TRUE,TRUE,4,0.5560125000015832,0.45362187499925494,0.4688187499991618,0.6622533333331346,0.5542580645156483,0.5569178571429636,1,1,1,0.967741935483871,0.96875,0.875,0.056,0.367,0.525,0.012,1.485,135.162975544424,2070.253029657963,0.087,0.333,0.724,0.02,2.01,81.61906225016722,1914.049886052211,0.079,0.382,0.482,0.009,1.351,82.4117238030742,1913.2243454411953,123.75,100.49999999999999,150.11111111111111,FALSE,346,1.0251851851851852,0,1,0,0,3,FALSE
93,2022-03-18T16:44:45Z,2022-03-18T17:16:45Z,1920,1,2022-03-18T17:16:46Z,1,Firefox,98.0,Windows NT 10.0,1366,768,i left just to brush my teeth lol,1.7786458333333333,770,137,560,120,72,134,0.18944851055676715,0.10549459551285129,0.5401570670367477,0.269863797515876,0.2277975275409949,0.39804927692535574,2,2,1,1,2,1,1,3,1,2,2,1,1,2,2,1,1,1,3,2,1.025978352085154,0,0,2,5,4,1.6,0,3,4,3,1,1,2,4,3,3,1,1,1,4,3,3,1,1,1,1,1,1,1,1,1,2,0,0,0,0,2,2,3,1,2,1,2,3,4,1,1,2,1,4,3,3,5,5,4,5,4,3,5,1,1,2,1,1,1,2,1,5,3,4,1,1,1,2,2,1,2,1.548029843509613,1.2798809468443688,1,0,1.75,0,2.466666666666667,0,2.2222222222222223,0,3.1666666666666665,0,2.1666666666666665,0,2.4285714285714284,0,1,0,2.4594594594594597,0,1,0,0,-0.4891727085921919,-0.3102033504766705,-0.14114775846592847,-0.2256755544712995,2,2,3,1,1,5,3,3,2,1.4960264830861913,2.4285714285714284,0,2.5,0.4516335802869379,4,5,5,5,5,5,3,1,3,1,2,0.7867957924694432,2,4.571428571428571,0,-1.2737251609456715,0,-0.16559391291590186,4,4,3,2,3,4,5,4,2,1,4,5,2,3,5,4,5,4,4,1,1.4540583599999397,3.2,0,4.4,0,3.2,0,3,0,3.533333333333333,0,1,2,1,1,3,2,3,1,1,1,1,1,1,2,1,1,1,1,1,1,1.234376040972246,1.35,0,I lived with my mother and father an equal amount of time (joint custody),0,"Hispanic of Latino (e.g., Mexican American, Central American, and others)",0,21,1,2,NA,1,2,1,freelance digital artist but planning to do delivery n shit after i get a bike,1,120,62,3,5,2,1,0,2,0,1,TRUE,TRUE,TRUE,TRUE,TRUE,6,0.598,0.54646875,0.5670322580645162,0.6860344827586207,0.5861333333333333,0.6082,0.9375,1,1,0.9354838709677419,0.9375,0.9375,0.066,0.351,0.317,0.036,2.116,96.79156069577822,1943.078995227823,0.059,0.397,0.392,0.03,1.674,52.62732874956328,1897.501213972802,0.059,0.43,0.276,0.01,1.149,118.5051056653919,2068.2799413238563,58.777777777777786,55.8,114.9,FALSE,348,1.031111111111111,0,1,0,3,6,FALSE
94,2022-03-18T17:01:09Z,2022-03-18T17:16:51Z,942,1,2022-03-18T17:16:52Z,0.8999999761581421,Chrome,98.0.4758.102,Macintosh,1440,900,"I accidentally put 2 women in the household that were romantically invovled. It should only be 2 men, both romantically involved nothing more! Sorry!!",1.6,434,40,274,52,24,63,-0.5014010127830202,-0.4301157062231952,-0.49895803197875493,-0.5687574818508689,-0.7564842905286399,-0.3998645252163147,2,2,2,1,2,1,2,2,1,2,2,2,1,1,3,2,2,1,2,2,0.8750939799154206,0,1,2,3,3,1.75,0,1,1,3,2,3,1,4,1,1,1,1,3,1,3,3,1,1,5,3,1,1,1,1,1,1,2,0,2,2,2,1,1,2,2,2,4,2,2,2,2,1,1,2,4,1,2,1,1,1,1,4,3,1,1,2,1,1,1,1,1,1,2,2,1,1,1,3,1,1,1,1.517663764904237,1.4573295865416045,1.75,0,1.5,0,1.9333333333333333,0,2,0,1.5833333333333333,0,2,0,1.2857142857142858,0,1,0,1.6486486486486487,0,1,2,0,-0.5286504787496339,-0.5696069744956507,2.9836963385124995,1.2070446820084244,1,1,1,1,1,1,1,1,1,1.9518001458970664,1,0,1,-0.9579186615539372,5,5,5,5,2,2,5,8,8,3,3,1.8126539343499315,8,4.142857142857143,0,0.5809148901979743,0,0.7318398713498386,3,3,3,3,2,5,3,5,5,4,5,4,5,4,1,5,4,3,4,1,1.5522640914238175,2.8,0,4.2,0,4.2,0,3.2,0,3.8666666666666667,0,1,1,1,4,1,1,1,1,1,1,1,1,1,1,1,1,1,1,2,1,1.1002392084403616,1.2,0,"I lived with my mother, but not father, most of the time.",0,"White, Caucasian, Anglo, European American",0,25,1,2,NA,1,4,6,Medical Student/researcher,5,130,68,2,5,2,0,0,1,0,0,TRUE,TRUE,TRUE,TRUE,TRUE,2,0.4552241379330898,0.48573225806413156,0.5227366666694482,0.5508360000014305,0.464007999997139,0.6326479999923706,1,1,1,0.78125,0.78125,0.78125,0.055,0.343,0.354,0.015,1.992,89.6527050268787,1987.5428380494236,0.045,0.314,0.293,0.039,2.095,196.47537556676997,2160.531497351922,0.057,0.353,0.625,0.015,1.943,57.47199499585069,1913.783049393975,132.8,53.71794871794872,129.53333333333333,FALSE,372,1.1022222222222222,0,1,0,0,3,FALSE
95,2022-03-18T16:57:27Z,2022-03-18T17:17:24Z,1196,1,2022-03-18T17:17:25Z,1,Chrome,99.0.4844.74,Windows NT 10.0,1366,768,NA,1.7786458333333333,599,72,284,51,37,67,-0.1621445504286603,-0.2534195242071799,-0.4626253362089821,-0.5810901477239093,-0.4899079648014471,-0.35491163495481215,1,4,1,1,1,1,1,1,1,1,1,1,1,1,1,1,1,1,1,1,1.5312533566021211,0,1,1,3,3,1.15,0,3,3,4,2,4,2,4,3,2,1,1,5,1,3,3,3,5,5,5,3,5,4,4,3,1,2,2,3,2,4,2,2,3,3,1,1,2,2,3,3,2,3,4,3,4,5,5,5,5,5,3,4,2,3,5,5,3,1,1,1,3,4,4,2,5,2,3,4,4,4,1.2985323200391226,1.1254628677422756,4.25,0,3.75,0,2.7333333333333334,0,2.2222222222222223,0,3.9166666666666665,0,3.6666666666666665,0,2.4285714285714284,0,3,0,3.108108108108108,0,2,2,2,2.0417910003904653,1.5083753540748885,3.978435279576228,2.7434053168255583,3,2,5,1,1,4,2,1,1,1.1547005383792515,2.5714285714285716,0,1,-0.04563820449042111,2,3,2,4,1,1,1,6,6,1,1,1.5118578920369088,6,2,0,-0.8944165583184731,0,-1.3278091742878089,1,1,2,2,4,2,2,4,3,4,2,3,2,2,3,2,1,4,3,4,0.990430401872025,2,0,2.4,0,2.6,0,3.2,0,2.7333333333333334,0,2,1,1,3,2,1,2,3,1,2,2,3,2,2,2,3,3,3,4,4,0.8522416262267903,2.3,0,I lived with my mother and father an equal amount of time (joint custody),0,"White, Caucasian, Anglo, European American",0,23,1,2,NA,1,2,6,receptionist,3,97,60,1,5,2,0,0,1,0,0,TRUE,TRUE,TRUE,TRUE,TRUE,5,0.6688812500024215,0.7324193548358255,0.677719354841017,0.6710645161290323,0.7283766666700443,0.6503903225823756,1,0.96875,1,0.96875,0.967741935483871,0.96875,0.08,0.359,0.264,0.108,1.184,119.52701491327217,1945.0895493319551,0.084,0.401,0.26,0.139,1.455,134.0624618887775,2001.4549055423215,0.085,0.36,0.292,0.019,1.589,91.30832100740353,1919.3944109852532,10.962962962962962,10.467625899280575,83.63157894736842,FALSE,304,0.9007407407407407,1,1,0,0,3,FALSE
96,2022-03-18T16:50:16Z,2022-03-18T17:17:25Z,1629,1,2022-03-18T17:17:26Z,0.8999999761581421,Safari,14.0.3,Macintosh,1440,900,After I finished the game the survey did give me some issues. It stayed in full screen and wouldn't allow me to scroll to see the rest of the questions. I exited full screen and it was even worse. I had to refresh almost every screen during the questions because the words were cut off. Once I finished the questions and moved on to the demographics I did not have the issue anymore.,1.6,641,300,279,84,79,76,-0.0757883600111869,1.0055407726569294,-0.4807916840938685,-0.1741121739135772,0.3713386260094833,-0.25376763186643136,3,3,1,1,4,1,2,4,1,3,3,2,1,1,2,3,2,1,4,3,0.6048053188292994,0,0,4,3,2,2.25,0,4,5,5,5,5,5,5,4,5,3,2,5,3,4,5,5,3,1,1,3,2,5,3,2,1,1,0,1,0,5,4,4,4,5,2,3,3,4,2,2,2,1,5,5,2,5,5,3,1,2,2,5,1,1,1,2,1,1,1,1,5,5,5,5,5,3,1,2,2,2,1.5872994422979931,1.6676187756655838,2.875,0,1.75,0,4.333333333333333,0,3.7777777777777777,0,2.9166666666666665,0,2,0,2.7142857142857144,0,4.333333333333333,0,3.054054054054054,0,1,0,0,1.1140634016905835,1.5830104377103722,-0.14114775846592847,0.7209313396222219,4,3,5,4,2,4,3,4,1,1.1126972805283737,3.5714285714285716,0,2.5,1.1151102763331315,1,1,1,1,1,1,1,3,4,1,1,1.5118578920369088,3.5,1,0,-1.3459910705962685,0,-2.1446772018216675,3,4,3,5,3,4,5,3,3,4,3,3,2,3,2,2,4,4,3,4,0.9154754164341269,3.6,0,3.6,0,3.2,0,3,0,3.2666666666666666,0,1,3,1,1,1,1,3,2,1,2,1,3,2,1,1,4,1,1,1,2,0.9333020044867296,1.65,0,"I lived with my mother, but not father, most of the time. & I lived with my extended family on mother's side (grandparents, aunts ,uncles, cousins)",1,Black or African American,0,28,1,2,NA,1,1,6,call center rep,1,90,61,1,5,2,0,0,0,0,0,TRUE,TRUE,TRUE,TRUE,TRUE,5,0.5739000000000014,0.4765937499999927,0.5282187500000036,0.6312812500000013,0.5353437500000037,0.5878709677419317,0.967741935483871,1,1,1,1,0.96875,0.071,0.409,0.659,0.03,2.178,65.17447901304783,1891.9917083086302,0.18,0.279,0.887,0.027,1.457,116.27277356930188,1902.664412409528,0.065,0.426,0.418,0.031,1.723,161.74870222741478,1992.5135715651877,72.6,53.96296296296297,55.58064516129033,FALSE,434,1.285925925925926,0,1,0,0,3,FALSE
97,2022-03-18T17:00:28Z,2022-03-18T17:18:17Z,1068,1,2022-03-18T17:18:17Z,0.8999999761581421,Safari,14.1.2,Macintosh,1440,900,NA,1.6,620,109,169,37,21,58,-0.1189664552199236,-0.04911456375116214,-0.8804513375613695,-0.7537474699464745,-0.818001904157992,-0.4560556380431929,2,2,1,1,2,1,2,3,1,2,2,1,4,3,2,2,1,1,3,2,1.0052493799000692,0,1,2,3,3,1.9,0,3,2,3,2,4,1,2,1,1,1,3,1,1,3,2,1,1,1,1,1,3,1,1,1,2,0,0,0,0,2,2,1,1,1,1,1,1,1,3,2,1,1,2,5,1,4,1,1,2,1,1,1,1,1,1,1,1,1,1,1,3,3,1,1,1,1,1,1,1,1,1.7803566130608974,1.424279266355945,1.25,0,1,0,2,0,1.2222222222222223,0,2,0,1,0,1.5714285714285714,0,1,0,1.4864864864864864,0,1,0,0,-0.9585195315751113,-0.8296005991757807,-0.39960647100849406,-0.6146035350921374,1,1,2,1,1,1,1,1,1,1.7320508075688772,1.1428571428571428,0,1,-0.874984074548163,5,5,5,5,5,5,5,6,6,6,4,1.5118578920369088,6,5,0,1.2043418043825058,0,1.5759787198402806,5,2,4,3,3,3,5,2,4,2,4,4,2,3,3,5,4,3,4,4,1.0997835284835873,3.4,0,3.6,0,3.6,0,3.2,0,3.466666666666667,0,1,1,1,4,1,1,1,1,1,1,1,1,1,2,2,1,1,1,1,1,1.0990426455975697,1.25,0,I lived with my mother and father an equal amount of time (joint custody),0,"White, Caucasian, Anglo, European American",0,21,1,2,NA,1,4,4,student,6,140,69,3,5,2,0,0,1,0,0,TRUE,TRUE,TRUE,TRUE,TRUE,1,0.47216129032258064,0.46356249999999727,0.4838064516129051,0.5698260869565294,0.5507499999999987,0.6736399999999977,0.96875,1,1,0.71875,0.75,0.78125,0.06,0.343,0.41,0.011,1.753,143.14741634245735,1998.099048088226,0.052,0.352,0.505,0.012,1.692,42.32180075374145,1933.6315265939932,0.05,0.352,0.435,0.01,1.68,149.47251747766504,2123.3760765589345,159.36363636363637,141,168,FALSE,364,1.0785185185185184,0,1,0,0,3,FALSE
98,2022-03-18T17:00:44Z,2022-03-18T17:19:52Z,1147,1,2022-03-18T17:20:02Z,0.8999999761581421,Chrome,99.0.4844.51,Macintosh,1440,900,NA,1.6,572,52,320,74,29,60,-0.21765924426846464,-0.3638546379671895,-0.3318276314378,-0.29743883264398085,-0.6539549344797195,-0.4335791929124416,2,1,1,2,2,1,1,2,1,2,1,1,2,1,2,2,1,1,2,2,1.105012502906165,0,1,2,4,5,1.5,0,4,1,2,2,1,2,3,3,2,3,3,4,3,3,5,2,4,5,1,3,3,4,3,1,1,1,0,0,0,2,5,4,2,2,1,3,2,1,2,5,3,1,4,2,4,4,4,4,3,5,4,2,1,1,3,2,1,1,1,1,2,2,2,1,1,2,1,3,1,1,1.346221494521727,1.0555973258234952,3.125,0,1.5,0,2.7333333333333334,0,2.4444444444444446,0,3.4166666666666665,0,2.1666666666666665,0,1.4285714285714286,0,1.3333333333333333,0,2.4324324324324325,0,1,0,0,0.87281036183955,0.722199473092423,-0.22730066264678367,0.2474494052228197,1,1,1,2,1,1,2,3,1,1.8126539343499315,1.2857142857142858,0,2,-0.40524523968696646,5,5,5,5,4,3,5,6,3,6,5,1.5275252316519468,4.5,4.571428571428571,0,1.2766077140331027,0,1.3877871020070867,3,4,3,4,2,3,3,2,3,2,4,3,3,4,3,2,4,4,3,3,0.7037315505489968,3.2,0,3.6,0,2.6,0,3,0,3.066666666666667,0,1,2,1,1,2,1,1,1,1,1,2,2,1,1,1,2,1,1,1,2,1.0310954828418375,1.3,0,I lived with my mother and father an equal amount of time (joint custody),0,"White, Caucasian, Anglo, European American",0,28,1,2,NA,1,5,6,paid search specialist,6,120,61,3,5,2,0,0,1,0,0,TRUE,TRUE,TRUE,TRUE,TRUE,4,0.5495645161328777,0.5161218750011176,0.48279687500186264,0.5989193548367869,0.5450354838698142,0.553106249999255,0.96875,1,1,0.96875,0.96875,1,0.094,0.372,0.913,0.016,1.4,19.21447924530021,1803.1725969549718,0.062,0.386,0.5,0.024,1.437,52.398949970945814,1878.3969371882856,0.058,0.416,0.464,0.016,1.518,165.76841790504017,2032.9431297249841,87.49999999999999,59.875,94.875,FALSE,433,1.282962962962963,0,1,0,0,3,FALSE
100,2022-03-18T16:57:44Z,2022-03-18T17:21:09Z,1404,1,2022-03-18T17:21:11Z,0.8999999761581421,Chrome,99.0.4844.74,Macintosh,1440,900,NA,1.6,523,94,375,102,82,87,-0.3184081330888503,-0.13194089907116932,-0.13199780470404948,0.04787581180114943,0.43285623963883546,-0.13014718364729932,4,4,3,4,4,1,2,4,1,4,4,2,2,2,4,4,2,1,4,4,0.8271701918685112,0,1,4,2,2,3,0,5,2,4,4,4,5,5,4,4,5,3,5,1,5,5,2,5,1,3,4,5,5,2,0,2,0,0,0,0,3,4,2,2,3,4,4,4,5,4,2,4,1,5,1,3,4,5,5,5,5,4,1,3,1,5,5,2,1,1,1,3,5,4,1,5,5,2,3,1,1,1.572091432287407,1.624221425205085,3.375,0,1.75,0,4.066666666666666,0,3.4444444444444446,0,3.6666666666666665,0,3.1666666666666665,0,2.4285714285714284,0,3.6666666666666665,0,3.2972972972972974,0,0,0,0,1.5965694813926496,1.7910840042092964,-0.3605105619019602,0.7152867211536681,2,3,4,3,2,3,2,3,6,0.7559289460184544,2.7142857142857144,0,4.5,1.391111250009331,1,1,3,3,1,1,2,3,3,2,1,1.2909944487358056,3,1.7142857142857142,0,-1.2224806707219966,0,-1.6824349360123172,2,3,2,2,2,4,2,4,4,3,5,4,5,4,4,5,5,4,4,4,1.2983506020002016,2.2,0,4.4,0,3.8,0,4,0,4.066666666666666,0,1,2,1,2,2,1,2,1,1,1,2,3,2,1,1,2,1,1,1,2,0.8645047258706176,1.5,0,I lived with my mother and father an equal amount of time (joint custody),0,"White, Caucasian, Anglo, European American",0,29,1,2,NA,1,3,6,administrative assistant and homemaker,5,122,63,4,5,2,0,0,1,0,0,TRUE,TRUE,TRUE,TRUE,TRUE,3,0.6693483870967982,0.6295218750000349,0.5549968749999534,0.7022709677418875,0.6165741935484712,0.7027483870968102,0.96875,1,1,0.96875,1,0.96875,0.081,0.412,0.575,0.007,1.384,25.605388680297683,1849.4996303224405,0.092,0.367,0.412,0.027,1.548,204.9049725667689,1996.3147437330979,0.068,0.462,0.348,0.018,1.605,219.26603570255702,2087.669953213356,197.7142857142857,57.333333333333336,89.16666666666667,FALSE,442,1.3096296296296297,0,1,0,0,3,FALSE
101,2022-03-18T16:57:08Z,2022-03-18T17:21:17Z,1448,1,2022-03-18T17:21:18Z,1,Chrome,87.0.4280.88,Macintosh,1280,800,interesting study,1.6,798,83,305,67,59,68,0.2470193041684161,-0.1926802116391746,-0.3863266750924592,-0.3837674937552634,-0.03877879818619785,-0.3436734123894365,4,4,4,4,4,3,4,4,2,4,4,4,3,2,4,4,4,3,4,4,1.3088765773505315,0,0,2,4,3,3.65,0,4,3,5,3,3,3,4,4,3,4,4,5,1,4,4,2,3,1,1,2,4,4,3,0,2,0,0,0,0,3,4,3,4,4,2,2,2,4,3,2,4,1,5,1,5,5,4,4,5,5,3,3,1,1,2,5,2,1,1,1,5,5,4,1,3,2,1,1,1,1,1.4503805030417376,1.1464230084422218,2.5,0,1,0,3.6,0,3.111111111111111,0,3.6666666666666665,0,2.5,0,2.7142857142857144,0,2,0,3.027027027027027,0,0,0,0,0.8530714767608292,1.0873115489007907,-0.6189692744445258,0.2341711372281325,2,2,3,1,1,3,2,2,1,1.1126972805283737,2,0,1.5,-0.1839744285858068,2,3,4,4,1,1,2,7,7,3,3,1.3801311186847085,7,2.4285714285714284,0,0.4002850852868561,0,-0.30701195187793484,1,2,1,1,1,5,5,5,5,3,5,5,4,4,5,5,5,5,5,5,1.869555587629877,1.2,0,5,0,4.4,0,4.8,0,4.733333333333333,0,4,4,4,4,4,4,4,1,3,4,2,4,3,4,4,4,4,4,4,4,1.1367080817685316,3.65,0,I lived with my mother and father an equal amount of time (joint custody),0,Middle Eastern,0,25,1,2,NA,1,3,6,piano teacher,4,240,64,1,5,2,0,0,1,0,0,TRUE,TRUE,TRUE,TRUE,TRUE,5,0.7668056451615074,0.6913479999995713,0.711545166666959,0.7891898333337546,0.6946745161293449,0.801214354839636,1,0.967741935483871,1,0.9375,0.96875,0.96875,0.081,0.452,0.306,0.009,1.183,76.5281679695288,1902.1167655582665,0.071,0.381,0.287,0.02,1.907,198.04454559152236,2066.3788282598143,0.072,0.508,0.29,0.026,1.543,104.6671922755516,1970.828126101243,131.44444444444446,95.35,59.34615384615385,FALSE,272,0.8059259259259259,0,1,0,6,9,FALSE
102,2022-03-18T16:39:23Z,2022-03-18T17:21:30Z,2527,1,2022-03-18T17:21:31Z,0.8999999761581421,Edge,99.0.1150.39,Windows NT 10.0,1920,1080,no,1.7777777777777777,935,154,415,96,58,74,0.528704972911127,0.19936444220885943,0.013332978375041804,-0.026120183437092773,-0.05928466939598191,-0.2762440769971827,2,2,1,1,3,1,2,3,1,2,2,1,1,1,2,2,2,1,2,2,0.9176629354822471,0,1,1,4,3,1.7,0,5,2,3,2,4,1,2,1,2,1,1,2,2,2,2,1,3,5,1,2,1,3,1,0,2,0,0,0,0,1,2,2,1,1,1,1,1,1,2,2,1,1,3,1,2,2,3,1,1,1,2,1,1,1,2,1,1,1,1,1,3,5,1,1,1,1,1,1,1,1,1.6934780387911346,1.3972762620115438,2.125,0,1,0,2.1333333333333333,0,1.2222222222222223,0,1.6666666666666667,0,1.3333333333333333,0,1.8571428571428572,0,1,0,1.4864864864864864,0,0,0,0,-0.39047828319858763,-0.38936177251430504,-0.6189692744445258,-0.5041655234794153,1,2,2,1,1,2,1,1,1,1.6035674514745464,1.4285714285714286,0,1,-0.7091149005366146,5,5,5,5,2,2,3,3,4,2,3,1.4638501094227998,3.5,3.857142857142857,0,-0.44574453423188864,0,-0.04829297043571845,2,2,2,1,2,5,3,4,5,3,5,4,2,2,4,5,4,5,4,1,1.4474937289114918,1.8,0,4.6,0,3.4,0,3.2,0,3.7333333333333334,0,1,3,3,1,3,2,3,4,2,1,3,3,1,3,1,3,2,2,1,3,0.9333020044867296,2.25,0,I lived with my mother and father an equal amount of time (joint custody),0,"White, Caucasian, Anglo, European American",0,29,1,2,NA,1,3,3,Administrative Assistant,3,150,68,1,5,2,0,0,1,0,0,TRUE,TRUE,TRUE,TRUE,TRUE,4,0.5875593749992549,0.5433343749828636,0.5074000000039737,0.6267709677488573,0.6210357142771993,0.591556666680177,1,1,1,0.96875,0.9333333333333333,0.9375,0.074,0.36,0.557,0.019,1.978,79.01089438404617,1924.0159595387388,0.067,0.391,0.467,0.015,1.637,121.15538733696333,1971.6679508203165,0.073,0.375,0.362,0.014,1.474,94.91626984756473,1919.4589121386068,104.10526315789474,109.13333333333334,105.28571428571428,FALSE,280,0.8296296296296296,0,1,0,3,6,FALSE
103,2022-03-18T16:47:48Z,2022-03-18T17:21:30Z,2021,1,2022-03-18T17:21:32Z,1,Safari,15.3,Macintosh,1440,900,NA,1.6,961,252,435,85,69,131,0.5821635669790867,0.7404964996329064,0.08599836991458744,-0.1617795080405368,0.1662799139116427,0.36433460922922883,3,2,1,2,3,2,1,2,2,3,3,3,1,3,3,2,2,2,3,3,0.6407232755171874,0,1,4,3,3,2.3,0,2,2,1,2,1,1,3,3,1,2,1,2,2,3,1,3,1,1,1,3,3,3,1,0,1,1,0,0,0,1,1,1,1,1,1,1,1,1,1,1,1,1,1,2,1,1,1,1,1,3,2,2,1,1,3,1,3,1,1,1,1,1,1,1,1,3,2,3,1,1,1.8318995212226723,1.4040757000349275,2,0,1.75,0,1.8,0,1,0,1.25,0,1.6666666666666667,0,1.2857142857142858,0,1.6666666666666667,0,1.2972972972972974,0,0,0,0,-0.5944467623453702,-0.6720704226487125,-0.3605105619019602,-0.5162904922753364,3,3,4,2,2,2,2,1,1,0.4879500364742666,2.5714285714285716,0,1,-0.04563820449042111,3,3,4,3,2,2,3,5,3,3,2,0.6900655593423543,4,2.857142857142857,0,-0.4848149464637728,0,-0.6139090755731551,2,3,2,3,2,4,3,4,4,3,3,4,4,5,4,3,4,4,3,3,0.9258200997725514,2.4,0,3.8,0,3.2,0,4,0,3.6666666666666665,0,1,2,3,3,3,3,3,2,1,3,4,2,2,3,1,2,3,3,3,3,0.8207826816681233,2.5,0,NA,NA,"White, Caucasian, Anglo, European American",0,30,1,2,NA,1,3,3,"no full or part time job, just side work in the creative field to help supplement husband's income",3,160,67,1,5,2,0,0,0,0,0,TRUE,TRUE,TRUE,TRUE,TRUE,2,0.49396875000001456,0.46015625000000365,0.47065625000001093,0.573064516129021,0.5200624999999782,0.5602812499999945,1,1,1,0.96875,1,1,0.08,0.368,0.79,0.018,1.686,43.245460019586034,1826.9870826902986,0.136,0.304,0.864,0.017,1.244,78.65102227620156,1872.5574246523602,0.067,0.394,0.67,0.014,1.416,45.05914768308831,1869.184809782292,93.66666666666667,73.17647058823529,101.14285714285714,FALSE,436,1.2918518518518518,0,1,0,0,3,FALSE
104,2022-03-18T16:51:31Z,2022-03-18T17:21:47Z,1816,1,2022-03-18T17:21:48Z,0.8999999761581421,Chrome,99.0.4844.74,Windows NT 10.0,1920,1080,NA,1.7777777777777777,679,132,656,162,49,61,0.002343431318908094,0.07788581707284889,0.8889509464265667,0.7878357641835715,-0.2438375102840384,-0.42234097034706597,3,2,1,2,3,1,1,3,1,3,3,1,1,1,3,2,1,1,3,3,0.6708203932499369,0,0,1,3,1,1.95,0,2,3,2,3,2,1,2,2,2,2,2,2,3,2,2,1,1,1,2,1,1,1,1,3,1,2,0,2,0,2,3,3,2,4,3,4,4,4,3,4,2,1,4,2,4,1,1,1,1,1,2,1,2,1,4,3,1,3,3,1,1,1,2,1,2,1,2,1,2,2,1.109608593708264,1.01418510567422,1.125,0,1.75,0,2.1333333333333333,0,3.2222222222222223,0,2.0833333333333335,0,2.1666666666666665,0,1.7142857142857142,0,1.3333333333333333,0,2.2432432432432434,0,2,0,0,-0.5483893638283547,-0.4955618915213171,0.07821504497010326,-0.2086734232756069,2,2,4,2,2,2,2,1,1,0.7559289460184544,2.2857142857142856,0,1,-0.21150737850196963,2,2,4,1,1,1,1,3,3,2,2,1.6035674514745464,3,1.7142857142857142,0,-0.8792700537047221,0,-1.4733889476140083,3,3,4,2,3,2,2,3,3,2,1,2,4,3,3,2,2,2,2,3,0.9611501047232549,3,0,1.8,0,2.4,0,3,0,2.4,0,1,1,1,2,2,1,2,3,2,1,1,3,1,2,2,3,1,2,2,1,0.5982430416161189,1.7,0,"I lived with my mother, but not father, most of the time. & I lived with my mother and father an equal amount of time (joint custody) & I lived with my extended family on mother's side (grandparents, aunts ,uncles, cousins)",1,"Asian or Asian American (e.g., Chinese, Japanese, and others)",0,25,0,1,NA,1,2,6,Receptionist,2,190,70,3,5,2,0,0,1,0,0,TRUE,TRUE,TRUE,TRUE,TRUE,3,0.4882968750000073,0.439441935483877,0.41841249999999125,0.5322374999999956,0.49089374999999563,0.47422333333333955,1,0.96875,1,1,1,0.9375,0.053,0.33,0.652,0.026,1.91,120.25059838734816,1964.2355337712204,0.067,0.297,0.465,0.033,1.92,202.41789742083873,2028.1153677689742,0.104,0.308,0.571,0.007,0.829,35.34095113587905,1819.930392571424,73.46153846153847,58.18181818181818,118.42857142857142,FALSE,328,0.9718518518518519,0,1,0,3,6,FALSE
105,2022-03-18T16:59:18Z,2022-03-18T17:22:29Z,1390,1,2022-03-18T17:22:29Z,0.8999999761581421,Chrome,99.0.4844.51,Windows NT 6.1,1920,1080,"On the first scale from 1-5/6 scales during the family questions (I think) there was a 6th option that read something like ""Click to write text"" so I think that 6th column was not meant to be there and didn't get caught when reviewing the study before posting it.",1.7777777777777777,559,99,387,79,63,73,-0.2443885413024445,-0.10433212063116694,-0.0883985697803221,-0.23577550327877903,0.043244686652938374,-0.2874822995625583,3,2,2,1,2,1,1,3,1,2,3,1,2,1,2,2,1,1,2,3,0.8522416262267903,0,0,2,3,3,1.8,0,4,2,2,3,2,2,3,3,2,2,3,3,2,3,3,2,3,1,2,2,3,1,3,8,1,1,0,0,0,2,2,4,4,4,2,4,3,3,3,3,2,3,4,4,2,4,4,3,2,3,4,1,2,2,4,2,2,3,3,3,2,1,2,1,3,2,3,3,2,2,0.9388191419977446,0.6324555320336759,2.125,0,2.5,0,2.6,0,3.111111111111111,0,3.0833333333333335,0,2.5,0,2.2857142857142856,0,2,0,2.7567567567567566,0,4,0,0,0.43416847120130736,0.3689857439505827,0.7753993643847322,0.5721925541676575,2,2,3,1,1,2,1,6,1,1.1547005383792515,1.7142857142857142,0,3.5,0.4237648931134893,3,3,4,4,2,2,3,4,4,3,2,0.816496580927726,4,3,0,-0.4848149464637728,0,-0.536506400332478,1,2,1,2,1,5,5,4,5,4,5,5,5,4,5,4,5,5,3,4,1.6987390281365427,1.4,0,5,0,4.2,0,4.4,0,4.533333333333333,0,1,2,1,2,1,1,2,3,2,1,4,3,2,1,3,4,1,1,3,1,0.910465468000326,1.95,0,I lived with my mother and father an equal amount of time (joint custody),0,"White, Caucasian, Anglo, European American",0,23,1,1,NA,1,4,6,Unemployed,5,148,62,1,5,2,0,0,1,0,0,TRUE,TRUE,TRUE,TRUE,TRUE,5,0.4692258064525743,0.4145062500024214,0.4398968750024214,0.5409580645109376,0.4829500000009934,0.5446516129057254,0.96875,1,1,0.96875,0.9375,0.96875,0.07,0.324,0.64,0.012,1.619,73.10712371362798,1899.3413752463632,0.058,0.327,0.708,0.016,1.564,58.92365759176166,1904.8262978785215,0.062,0.357,0.583,0.015,1.48,264.8417481247828,2133.0893205511143,134.91666666666666,97.75,98.66666666666667,FALSE,320,0.9481481481481481,0,1,0,0,3,FALSE
106,2022-03-18T17:05:49Z,2022-03-18T17:22:47Z,1017,1,2022-03-18T17:22:48Z,0.8999999761581421,Chrome,99.0.4844.51,Windows NT 10.0,1366,768,NA,1.7786458333333333,497,66,235,53,41,65,-0.37186672715681,-0.28655005833518277,-0.6406555454808689,-0.5564248159778286,-0.40788447996231086,-0.3773880800855634,2,2,2,2,2,1,3,3,1,3,3,2,2,1,3,3,1,1,3,3,0.6863327411532597,0,1,1,2,2,2.15,0,1,1,3,2,3,3,4,2,1,3,2,3,1,3,3,1,2,1,1,1,1,1,2,1,2,0,0,0,0,2,2,5,2,3,2,3,2,4,1,2,3,1,2,2,2,3,2,2,2,3,1,1,1,1,4,3,1,2,1,1,2,2,2,2,2,1,2,3,1,1,1.238763308519644,1.1872336794093274,1.25,0,1.75,0,2.3333333333333335,0,2.7777777777777777,0,2.0833333333333335,0,1.8333333333333333,0,1.5714285714285714,0,1.6666666666666667,0,2.081081081081081,0,1,0,0,-0.5725146678134581,-0.42446681185273394,-0.14114775846592847,-0.2828072851593312,2,2,3,3,1,3,2,3,1,0.9759000729485332,2.2857142857142856,0,2,0.17529686935345262,4,4,4,4,3,4,4,6,3,4,3,0.7867957924694432,4.5,3.857142857142857,0,0.1625358753388918,0,0.3222042494555062,2,3,3,2,3,4,4,4,4,3,3,4,5,4,4,3,4,4,4,3,1,2.6,0,3.8,0,3.8,0,3.8,0,3.8,0,2,1,4,3,4,4,3,3,3,1,3,4,3,4,1,3,2,4,2,3,1.0990426455975697,2.85,0,I lived with my mother and father an equal amount of time (joint custody),0,"White, Caucasian, Anglo, European American",0,22,0,1,NA,1,3,6,Unemployed,1,200,69,2,5,2,0,0,1,0,0,TRUE,TRUE,TRUE,TRUE,TRUE,2,0.43823125000670554,0.48160624999180435,0.4135343750007451,0.49495862069212154,0.49586250000819565,0.4975071428673608,1,1,1,0.90625,1,0.9032258064516129,0.057,0.33,0.696,0.021,1.848,53.15370796025803,1911.9800100254583,0.137,0.276,0.652,0.219,1.786,73.4046534750205,1854.8406672306514,0.06,0.345,0.681,0.014,1.45,193.0986819464116,2086.981245978103,88,8.155251141552512,103.57142857142857,FALSE,430,1.2740740740740741,0,1,0,0,3,FALSE
108,2022-03-18T17:06:16Z,2022-03-18T17:22:51Z,995,1,2022-03-18T17:22:52Z,0.8999999761581421,Chrome,99.0.4844.51,Windows NT 10.0,1280,720,NA,1.7777777777777777,493,78,217,51,33,69,-0.38009112624418845,-0.220288990079177,-0.70605439786646,-0.5810901477239093,-0.5719314496405833,-0.33243518982406084,2,2,1,1,1,1,1,3,1,1,3,1,1,1,1,1,1,1,2,2,1.2523661815266247,0,1,2,3,3,1.4,0,2,1,2,1,2,1,1,1,1,1,1,1,2,1,1,1,1,1,1,1,2,2,1,0,2,0,0,0,0,1,1,1,1,2,1,1,1,1,1,1,1,1,2,1,1,2,2,1,1,1,3,1,1,1,1,1,1,1,1,1,1,1,1,1,1,1,1,1,1,1,1.834766024965136,1.8516401995451028,1.25,0,1,0,1.2666666666666666,0,1.1111111111111112,0,1.25,0,1.3333333333333333,0,1,0,1,0,1.162162162162162,0,0,0,0,-1.1690676390814674,-1.291374449969234,-0.6189692744445258,-0.9551718622068799,1,1,3,1,1,1,1,1,1,1.5735915849388864,1.2857142857142858,0,1,-0.7920494875423887,5,5,5,5,3,3,5,6,4,4,4,1.5735915849388864,5,4.428571428571429,0,0.5960613948117253,0,0.8958707989863475,2,2,2,3,2,4,3,5,5,3,5,4,4,2,3,3,4,5,3,4,1.0465362369445672,2.2,0,4.4,0,3.2,0,3.8,0,3.8,0,1,1,1,3,1,1,3,3,1,1,2,3,1,3,1,3,1,1,1,3,0.7591546545162482,1.75,0,I lived with my mother and father an equal amount of time (joint custody),0,"White, Caucasian, Anglo, European American",0,29,1,2,NA,1,4,6,healthcare worker,5,110,61,3,5,2,0,0,1,0,0,TRUE,TRUE,TRUE,TRUE,TRUE,2,0.5542906250022351,0.48684375,0.5756437500007451,0.6133375000003726,0.5436687500057742,0.6194343750001863,1,1,1,1,1,1,0.094,0.387,0.492,0.055,1.977,38.16556457232511,1823.1606659064446,0.076,0.359,0.568,0.037,1.86,25.1895603434756,1808.213273511678,0.123,0.334,0.565,0.015,1.272,50.182339185916575,1832.8119711483744,35.945454545454545,50.270270270270274,84.80000000000001,FALSE,292,0.8651851851851852,0,1,0,0,3,FALSE
109,2022-03-18T16:57:44Z,2022-03-18T17:24:24Z,1600,1,2022-03-18T17:24:25Z,1,Chrome,97.0.4692.99,Macintosh,1440,900,N/A,1.6,578,133,464,129,114,113,-0.20532264563739702,0.08340757276084937,0.1913631876469286,0.38085779037323936,1.0890441183519253,0.16204660305246732,2,1,1,1,1,1,2,2,1,1,2,1,1,1,2,1,1,1,2,1,1.3018205875255096,0,1,1,4,5,1.3,0,4,2,3,3,5,4,3,4,3,4,4,3,2,3,4,2,3,1,1,2,3,3,2,2,2,0,0,0,0,2,4,1,2,2,2,2,2,1,3,1,3,2,3,2,1,4,3,3,4,2,2,1,1,1,3,1,2,2,2,1,3,3,2,2,4,2,2,1,2,2,1.2460146678721533,0.8837151016885368,2.125,0,1.75,0,3.4,0,2,0,2.5833333333333335,0,1.5,0,2.142857142857143,0,2.6666666666666665,0,2.189189189189189,0,1,0,0,0.06570928306518452,0.47046585766839394,-0.14114775846592847,0.16465904960123273,2,2,3,1,1,2,1,2,1,1.1547005383792515,1.7142857142857142,0,1.5,-0.3498436025973552,3,3,3,2,1,1,2,6,6,3,2,1.1338934190276817,6,2.142857142857143,0,-0.12355533664153649,0,-0.7808830110972456,3,2,3,3,4,3,5,3,4,1,5,4,3,4,3,5,3,4,4,4,1.2227992865708155,3,0,3.8,0,3.6,0,3.6,0,3.6666666666666665,0,2,2,1,2,3,1,2,1,1,1,2,1,1,2,1,1,1,1,1,3,1.1239029738980326,1.5,0,I lived with my mother and father an equal amount of time (joint custody),0,"White, Caucasian, Anglo, European American",0,22,1,2,NA,1,3,6,Editor,4,150,66,3,5,2,0,0,1,0,0,TRUE,TRUE,TRUE,TRUE,TRUE,1,0.6563187499998894,0.5772187500000291,0.5949343749998952,0.6826387096773232,0.610649999999965,0.6193838709676638,1,1,1,1,1,1,0.068,0.46,0.521,0.04,1.63,81.59340069960018,1864.742128629588,0.125,0.38,0.654,0.027,1.395,60.010719991942544,1844.1353198359686,0.085,0.467,0.466,0.047,1.786,58.63856013946855,1838.426681220196,40.75,51.66666666666667,38,FALSE,432,1.28,0,1,0,0,3,FALSE
110,2022-03-18T17:05:36Z,2022-03-18T17:24:48Z,1151,1,2022-03-18T17:24:50Z,1,Chrome,97.0.4692.71,Windows NT 10.0,1920,1080,"Thanks for the survey, I hope you have a wonderful day.",1.7777777777777777,520,81,298,62,35,100,-0.3245764324043841,-0.20372372301517555,-0.41175956213130016,-0.4454308231204653,-0.5309197072210152,0.015949709702583987,2,2,2,3,3,1,1,3,1,3,3,1,2,2,3,3,1,1,3,3,0.6708203932499369,0,0,2,4,4,2.15,0,3,2,2,2,2,1,2,2,1,1,2,2,2,2,3,5,4,4,2,3,4,3,4,3,2,0,0,0,0,1,2,1,2,3,1,1,1,2,5,2,5,3,1,2,2,2,3,5,4,3,3,2,2,1,4,3,1,2,1,1,2,2,2,1,2,2,1,2,1,1,1.4110248016923697,1.1832159566199232,3.625,0,1.25,0,1.9333333333333333,0,1.5555555555555556,0,3.0833333333333335,0,2.5,0,1.5714285714285714,0,1.6666666666666667,0,2.2162162162162162,0,2,0,0,1.0570399559076114,0.4968192205330974,-0.09409076339160714,0.20136422857074512,2,2,3,1,1,1,1,4,4,1.2149857925879117,1.5714285714285714,0,4,0.5342324300354263,5,5,5,5,3,2,3,6,6,5,4,1.2909944487358056,6,4,0,0.9905165020526746,0,0.9039212433797521,2,2,3,2,2,4,4,2,4,3,3,3,4,4,3,2,3,4,3,3,0.7559289460184544,2.2,0,3.4,0,3.2,0,3.2,0,3.2666666666666666,0,1,3,3,3,3,2,3,2,2,2,1,3,1,1,1,3,1,2,2,2,0.7591546545162482,2.05,0,"I lived with my mother, but not father, most of the time. & I lived with my mother and father an equal amount of time (joint custody)",1,"Hispanic of Latino (e.g., Mexican American, Central American, and others) & White, Caucasian, Anglo, European American",1,23,0,1,NA,1,1,5,self-employed,2,145,71,2,5,2,0,0,1,0,0,TRUE,TRUE,TRUE,TRUE,TRUE,3,0.45244193548252504,0.40443125000130387,0.450984374997206,0.5776833333363136,0.49233448275409897,0.5399906250014901,0.96875,1,1,0.9375,0.90625,1,0.11,0.291,0.702,0.022,2.061,21.522796492413804,1804.5197906545454,0.05,0.333,0.684,0.022,1.942,57.828640968115046,1921.4173125412378,0.059,0.351,0.552,0.015,1.951,164.09654807082146,2052.2890177878553,93.68181818181819,88.27272727272728,130.06666666666666,FALSE,284,0.8414814814814815,0,1,0,3,6,FALSE
111,2022-03-18T17:08:42Z,2022-03-18T17:25:44Z,1022,1,2022-03-18T17:25:45Z,0.8999999761581421,Firefox,98.0,Windows NT 10.0,1366,768,I had a great time completing the survey.,1.7786458333333333,486,59,248,55,31,67,-0.3944838246471007,-0.3252023481511861,-0.5934230409801643,-0.5317594842317478,-0.6129431920601515,-0.35491163495481215,1,1,1,1,1,1,1,1,1,1,1,1,1,1,1,1,1,1,1,1,1.538967528127731,0,1,1,5,5,1,0,1,1,1,1,1,1,1,1,1,1,1,1,1,1,1,1,1,1,1,1,1,1,1,0,2,0,0,0,0,1,1,1,1,1,1,1,1,1,1,1,1,1,1,1,1,1,1,1,1,1,1,1,1,1,1,1,1,1,1,1,1,1,1,1,1,1,1,1,1,1,1.9666895707934864,2.065591117977289,1,0,1,0,1,0,1,0,1,0,1,0,1,0,1,0,1,0,0,0,0,-1.4366391923707953,-1.587751448753618,-0.6189692744445258,-1.103360361599072,1,1,5,1,1,1,1,1,1,1.5118578920369088,1.5714285714285714,0,1,-0.6261803135308405,5,5,5,5,1,1,5,4,3,3,3,2.138089935299395,3.5,3.857142857142857,0,-0.23191923190205752,0,0.08194577934007008,1,1,1,1,1,5,5,5,5,5,5,5,5,5,5,5,5,5,5,5,2.065591117977289,1,0,5,0,5,0,5,0,5,0,1,1,1,1,1,1,1,1,1,1,1,1,1,1,1,1,1,1,1,1,1.231174022502185,1,0,I lived with my mother and father an equal amount of time (joint custody),0,Black or African American,0,29,0,1,NA,1,3,3,Trnasportation,3,170,66,4,5,2,0,0,1,0,0,TRUE,TRUE,TRUE,TRUE,TRUE,5,0.53703125,0.4908125,0.5074375,0.6039687499999999,0.53575,0.58315625,1,1,1,1,1,1,0.144,0.334,0.844,0.019,1.671,7.449277192256529,1788.4583924948388,0.082,0.355,0.548,0.07,1.984,115.90944972077598,1906.066665339455,0.092,0.421,0.844,0.014,1.369,80.65545171456607,1862.5793467094409,87.94736842105263,28.34285714285714,97.78571428571428,FALSE,334,0.9896296296296296,0,1,0,0,3,FALSE
112,2022-03-18T17:10:01Z,2022-03-18T17:26:06Z,965,1,2022-03-18T17:26:07Z,1,Chrome,98.0.4758.109,Macintosh,1440,900,NA,1.6,497,60,204,53,32,75,-0.37186672715681,-0.31968059246318564,-0.7532869023671647,-0.5564248159778286,-0.5924373208503674,-0.265005854431807,1,2,1,1,2,1,1,1,1,2,2,1,1,1,1,1,1,1,3,2,1.268027892769755,0,0,2,3,2,1.35,0,4,1,1,2,1,1,2,2,1,1,1,2,3,2,2,1,1,1,1,1,1,1,1,1,2,0,0,0,0,1,1,1,1,1,1,1,1,1,1,1,1,1,1,1,1,1,1,1,1,1,1,1,1,1,1,1,1,2,1,1,1,1,1,1,1,1,1,1,1,1,1.9521298140264163,1.505545305418162,1,0,1,0,1.7333333333333334,0,1,0,1,0,1,0,1.1428571428571428,0,1,0,1.027027027027027,0,1,0,0,-1.4190935167452654,-1.2557777434131798,-0.39960647100849406,-0.827692107210837,1,1,3,1,1,1,1,1,1,1.5735915849388864,1.2857142857142858,0,1,-0.7920494875423887,5,5,5,4,2,2,5,3,2,4,3,1.7182493859684491,2.5,4,0,-0.19872373448334457,0,0.17956748401688805,1,1,1,1,1,5,4,5,5,2,5,3,5,3,4,5,4,5,3,3,1.2649110640673518,1,0,4.4,0,3.8,0,4,0,4.066666666666666,0,1,2,1,1,1,1,1,1,1,1,2,2,1,1,1,1,2,1,1,1,1.1285761872936695,1.2,0,I lived with my mother and father an equal amount of time (joint custody),0,"White, Caucasian, Anglo, European American",0,22,1,2,NA,1,3,6,student,5,88,59,2,5,2,0,0,0,0,0,TRUE,TRUE,TRUE,TRUE,TRUE,1,0.5780468749962747,0.5045843749977649,0.5134875000044703,0.7153064516109805,0.5982466666638852,0.6454107142899718,1,1,1,0.96875,0.967741935483871,0.875,0.082,0.274,0.337,0.01,1.836,117.67529449166051,2021.3176729618183,0.075,0.333,0.451,0.006,1.088,75.41941143776582,1900.396925657523,0.104,0.295,0.395,0.008,1.573,35.8642566833505,1858.3307790941337,183.6,181.33333333333334,196.625,FALSE,431,1.2770370370370372,0,0,0,0,3,FALSE
113,2022-03-18T17:05:44Z,2022-03-18T17:26:27Z,1242,1,2022-03-18T17:26:28Z,0.8999999761581421,Chrome,99.0.4844.74,Windows NT 10.0,1440,900,NA,1.6,501,65,365,103,38,76,-0.3636423280694316,-0.2920718140231832,-0.16833050047382228,0.0602084776741898,-0.46940209359166307,-0.25376763186643136,1,1,1,1,1,1,1,1,1,1,1,1,1,1,1,1,1,1,1,1,1.538967528127731,1,0,1,4,5,1,0,3,1,1,1,1,2,1,3,1,1,1,2,2,2,3,3,3,3,1,3,3,3,2,2,2,0,0,0,0,3,1,4,1,1,1,1,1,1,1,5,1,1,2,1,1,3,3,3,3,3,3,1,3,2,2,1,1,2,2,2,1,1,1,1,1,1,1,2,2,2,1.5849328099361222,1.5796322658258457,2.625,0,1.75,0,1.6666666666666667,0,1.5555555555555556,0,2.25,0,2,0,1.4285714285714286,0,1,0,1.7837837837837838,0,1,0,0,0.12711914775453853,-0.2450082774195883,-0.14114775846592847,-0.1930780179427584,1,2,2,1,1,1,1,1,1,1.6761634196950514,1.2857142857142858,0,1,-0.7920494875423887,5,5,5,5,4,4,5,6,5,4,4,1.4638501094227998,5.5,4.714285714285714,0,0.6863762972672843,0,1.1056860096375256,3,1,3,3,3,3,4,2,5,2,3,4,3,5,5,2,4,4,4,1,1.1872336794093274,2.6,0,3.6,0,3,0,3.6,0,3.4,0,1,1,1,1,2,1,1,1,1,1,1,1,1,1,1,1,3,2,1,1,1.2396943596157715,1.2,0,I lived with my mother and father an equal amount of time (joint custody),0,"White, Caucasian, Anglo, European American",0,26,1,2,NA,1,2,5,Housekeeper,1,160,69,3,5,2,0,0,1,0,0,TRUE,TRUE,TRUE,TRUE,TRUE,6,0.6774281250024214,0.513422580644969,0.5617812499990686,0.7403258064504593,0.6074580645186286,0.646971875000745,1,1,1,0.96875,0.96875,1,0.198,0.213,0.601,0.012,1.468,24.493261951245636,1806.823418950857,0.085,0.365,0.625,0.012,1.627,34.486643152007126,1858.9489481587898,0.079,0.448,0.361,0.018,1.751,41.4249644334029,1865.2630464799472,122.33333333333333,135.58333333333334,97.27777777777779,FALSE,294,0.8711111111111112,0,1,0,0,3,FALSE
115,2022-03-18T17:05:56Z,2022-03-18T17:28:25Z,1348,1,2022-03-18T17:28:26Z,0.8999999761581421,Chrome,99.0.4844.74,Windows NT 10.0,1920,1080,NA,1.7777777777777777,593,86,331,60,51,62,-0.17448114905972795,-0.17611494457517315,-0.29186166609104985,-0.470096154866546,-0.20282576786447032,-0.41110274778169037,3,3,3,3,3,2,4,3,1,3,4,3,1,1,3,3,4,2,3,4,0.9119095061289915,0,0,2,3,2,2.8,0,4,2,5,3,5,3,4,4,4,5,4,3,1,3,4,2,4,1,1,3,4,4,3,3,1,3,0,0,0,3,1,1,2,3,1,2,1,5,4,1,3,1,4,3,1,5,5,5,5,5,4,1,1,1,5,5,1,1,1,1,2,2,3,1,3,2,4,4,1,1,1.6585387395990336,1.2344267996967353,2.75,0,2.5,0,3.6,0,2.111111111111111,0,3.5,0,2.8333333333333335,0,1.5714285714285714,0,2,0,2.5675675675675675,0,2,0,0,0.717092490662974,0.99586144642253,0.33667375751266887,0.6662676019675995,1,1,4,1,1,1,1,1,1,1.4960264830861913,1.4285714285714286,0,1,-0.7091149005366146,3,3,4,4,1,2,1,3,5,NA,3,1.3451854182690985,4,2.5714285714285716,0,-0.13222200579606097,1,-0.5539537626906533,1,2,1,3,1,5,5,4,5,4,5,5,4,4,5,5,5,5,4,3,1.709915063331955,1.6,0,5,0,4.4,0,4.2,0,4.533333333333333,0,1,3,3,4,2,4,4,2,4,4,3,3,4,2,1,3,3,4,4,4,1.1192102478745307,3.1,0,NA,NA,"White, Caucasian, Anglo, European American",0,21,1,2,NA,1,3,3,unemployed,3,162,68,3,5,2,1,0,1,0,1,TRUE,TRUE,TRUE,TRUE,TRUE,4,0.5866187499985098,0.4239031249899417,0.5067218750044703,0.6599258064531511,0.4906321428545884,0.796181249992922,1,1,1,1,0.875,1,0.121,0.263,0.427,0.012,2.113,260.8835921002525,2051.6899799633447,0.055,0.312,0.579,0.019,2.019,140.27214807144637,2006.7612581910269,0.087,0.365,0.387,0.037,2.01,44.82699739600726,1825.1492065232947,176.08333333333334,106.26315789473685,54.32432432432432,FALSE,254,0.7525925925925925,0,1,0,0,3,FALSE
117,2022-03-18T17:04:36Z,2022-03-18T17:29:10Z,1473,1,2022-03-18T17:29:11Z,1,Chrome,99.0.4844.74,Windows NT 6.1,2560,1080,NA,2.3703703703703702,824,69,360,60,49,69,0.30047789823637583,-0.2699847912711813,-0.1864968483587087,-0.470096154866546,-0.2438375102840384,-0.33243518982406084,1,2,2,2,2,1,2,2,1,2,2,2,2,2,2,2,2,1,2,3,0.812727700887249,0,0,2,3,3,1.85,0,2,3,3,3,2,2,2,2,2,3,3,3,2,3,3,2,4,3,3,3,4,3,2,5,2,0,0,0,0,2,3,3,3,3,2,3,2,2,3,1,2,1,2,3,2,3,3,4,2,4,3,2,1,1,2,2,2,3,2,1,2,2,2,4,5,2,1,2,2,1,1.100095545945992,0.6761234037828132,3,0,1.5,0,2.533333333333333,0,2.5555555555555554,0,2.5,0,1.8333333333333333,0,2,0,3.6666666666666665,0,2.4054054054054053,0,3,0,0,0.7741159364459455,0.5685043008628304,0.21142494422527977,0.3899646225440551,2,2,5,2,2,2,2,3,2,0.8997354108424374,2.4285714285714284,0,2.5,0.4516335802869379,3,3,3,3,1,1,2,7,4,2,2,1.1338934190276817,5.5,2.2857142857142856,0,-0.42769554142692673,0,-0.8887289458021808,2,3,3,2,2,4,4,2,3,4,4,4,3,4,3,4,4,4,4,3,0.8618916073713346,2.4,0,4,0,3.8,0,3,0,3.6,0,2,3,2,2,2,2,2,2,1,1,2,2,3,2,2,2,1,1,1,2,0.7591546545162482,1.85,0,"I lived with my mother, but not father, most of the time.",0,"White, Caucasian, Anglo, European American",0,27,0,1,NA,1,2,7,Legal Intern/Student,1,230,74,1,5,2,0,0,0,0,0,TRUE,TRUE,TRUE,TRUE,TRUE,1,0.4895843750005588,0.5381312499996275,0.5009281249998603,0.5539678571429104,0.5553903225809336,0.6217888888898823,1,1,1,0.9032258064516129,1,0.9,0.069,0.331,0.461,0.017,2.009,138.33967971934504,2027.336690809086,0.093,0.307,0.514,0.016,1.381,101.78882681539996,1886.5795958432234,0.054,0.379,0.477,0.025,1.907,37.75828313861087,1893.5888747806423,118.17647058823528,86.3125,76.28,FALSE,326,0.965925925925926,0,1,1,3,6,FALSE
118,2022-03-18T16:59:34Z,2022-03-18T17:29:29Z,1794,1,2022-03-18T17:29:30Z,0.8999999761581421,Chrome,99.0.4844.74,Windows NT 10.0,1920,1080,NA,1.7777777777777777,556,272,421,119,75,111,-0.25055684061797834,0.850931613392916,0.03513259583690549,0.2575311316428357,0.28931514117034707,0.13957015792171604,1,2,1,1,2,1,3,2,1,2,2,1,1,1,2,2,2,1,2,1,1.118033988749895,0,1,1,2,3,1.55,0,4,4,4,4,5,4,4,4,2,4,2,5,1,4,5,4,4,1,1,4,3,4,3,2,2,0,0,0,0,3,5,5,4,4,3,2,2,4,2,2,4,1,4,3,3,4,4,3,3,2,1,1,1,2,3,1,1,3,3,1,3,4,2,1,1,1,1,1,2,3,1.1911838308669735,1.3020130933435712,3,0,1.75,0,3.7333333333333334,0,3.5555555555555554,0,2.9166666666666665,0,1.5,0,2.4285714285714284,0,1,0,2.5945945945945947,0,1,0,0,0.8969356658246534,1.1750249805251005,-0.14114775846592847,0.516938611029586,1,1,2,1,1,1,1,3,1,1.7320508075688772,1.1428571428571428,0,2,-0.48817982669274074,3,5,5,5,4,3,4,3,3,4,3,1.2149857925879117,3,4.142857142857143,0,-0.10840883202778547,0,0.31198001942738923,3,1,3,4,4,4,5,2,3,3,1,3,5,4,3,5,3,5,4,3,1.3093073414159542,3,0,3.2,0,4.4,0,3,0,3.533333333333333,0,1,2,2,4,3,1,2,2,2,1,2,1,1,1,1,2,2,2,1,1,0.8944271909999159,1.7,0,"I lived with my father, but not mother, most of the time.",0,"White, Caucasian, Anglo, European American",0,24,1,2,NA,1,3,6,Logistics coordinator,3,215,64,3,5,2,0,0,1,0,0,TRUE,TRUE,TRUE,TRUE,TRUE,1,0.8339129032266717,0.5479031249997206,0.5797875000005588,0.8877677419363491,0.6838906249990687,0.681425000000745,1,1,1,1,1,1,0.246,0.22,0.685,0.004,0.836,82.28879075254112,1863.4850670819424,0.121,0.325,0.561,0.008,1.427,84.91664981179821,1873.501151667386,0.118,0.377,0.275,0.036,1.787,42.23654738056492,1821.8858863171938,209,178.375,49.63888888888889,FALSE,390,1.1555555555555557,0,1,0,6,9,FALSE
119,2022-03-18T17:01:02Z,2022-03-18T17:29:46Z,1723,1,2022-03-18T17:29:48Z,0.8999999761581421,Chrome,99.0.4844.74,Windows NT 10.0,1366,768,no,1.7786458333333333,561,180,506,115,123,71,-0.2402763417587553,0.34293009009687186,0.34396050987997445,0.2082004681506742,1.2735969592399818,-0.3099587446933096,2,1,4,4,2,3,4,2,3,2,1,3,3,4,4,4,1,3,4,4,1.1516578439248717,0,1,1,3,3,2.9,0,4,3,2,3,2,1,4,2,2,2,3,4,2,4,4,2,3,1,1,1,3,3,2,2,2,0,0,0,0,3,3,3,4,4,3,4,4,3,3,4,2,2,4,2,1,3,3,3,2,2,3,3,1,1,1,1,1,5,5,1,2,1,1,1,1,1,1,1,1,1,1.1753218203459772,0.5163977794943222,2,0,1,0,2.8,0,3.4444444444444446,0,2.5833333333333335,0,1.6666666666666667,0,2.2857142857142856,0,1,0,2.4594594594594597,0,1,0,0,0.16001728955240654,0.27193063519139654,-0.39960647100849406,-0.06383791790854876,3,3,4,3,3,3,3,3,2,0.3779644730092272,3.142857142857143,0,2.5,0.8663065153158088,4,4,4,3,3,3,4,4,4,1,2,0.7559289460184544,4,3.5714285714285716,0,-0.9124655511234351,0,-0.48737319892134634,1,1,1,1,1,5,5,5,5,1,5,5,5,1,4,5,5,5,5,4,1.8387366263150307,1,0,5,0,4.2,0,3.8,0,4.333333333333333,0,2,1,1,4,1,1,1,4,2,1,2,3,1,3,2,2,2,3,3,2,0.7863975156570492,2.05,0,I lived with my mother and father an equal amount of time (joint custody),0,"Hispanic of Latino (e.g., Mexican American, Central American, and others)",0,22,1,2,NA,1,2,4,self employed,1,132,64,2,5,2,0,0,1,0,0,TRUE,TRUE,TRUE,TRUE,TRUE,2,0.7261937500000931,0.6798437500000583,0.7022281250003143,0.6822687500001048,0.6714758620692481,0.8104774193545623,1,1,1,1,0.9666666666666667,1,0.175,0.32,0.469,0.019,1.723,116.0385436363417,1903.5979066410525,0.075,0.404,0.343,0.013,1.405,140.98688617498823,1971.5186870843595,0.099,0.442,0.376,0.169,0.817,97.71878053563515,1885.8850667462007,90.6842105263158,108.07692307692308,4.834319526627218,FALSE,304,0.9007407407407407,1,1,0,0,3,FALSE
120,2022-03-18T17:13:36Z,2022-03-18T17:29:56Z,980,1,2022-03-18T17:29:57Z,0.8999999761581421,Chrome,99.0.4844.51,Macintosh,1440,900,No,1.6,482,79,219,55,40,60,-0.4027082237344791,-0.2147672343911765,-0.6987878587125055,-0.5317594842317478,-0.42839035117209495,-0.4335791929124416,3,3,3,2,3,1,1,4,1,3,4,1,1,1,3,3,1,1,3,4,0.6069769786668839,0,0,4,2,2,2.3,0,3,2,4,3,4,4,3,2,3,2,3,3,2,4,3,2,2,1,1,2,3,3,3,0,2,0,0,0,0,2,2,1,2,1,1,2,1,1,2,2,2,1,2,2,1,3,3,3,3,5,3,1,1,1,1,1,1,1,1,1,3,3,2,1,1,1,1,1,1,1,1.5572170448993052,0.7559289460184544,2.125,0,1,0,3,0,1.4444444444444444,0,2.4166666666666665,0,1.3333333333333333,0,1.7142857142857142,0,1,0,1.7567567567567568,0,0,0,0,-0.21502152694329052,0.10702545039995226,-0.6189692744445258,-0.25597191202228675,1,2,3,1,1,2,2,1,1,1.3801311186847085,1.7142857142857142,0,1,-0.5432457265250663,5,4,4,4,2,3,4,7,7,4,4,1.1338934190276817,7,3.7142857142857144,0,0.9573210046339616,0,0.728896863462257,2,2,2,4,3,4,5,4,5,1,5,4,3,4,5,5,4,4,5,4,1.5675276256394517,2.6,0,4.2,0,3.8,0,4.4,0,4.133333333333334,0,2,3,1,3,3,2,4,3,2,3,3,2,1,2,1,2,2,2,2,3,0.8013147091860318,2.3,0,I lived with my mother and father an equal amount of time (joint custody),0,"White, Caucasian, Anglo, European American",0,25,1,2,NA,1,3,7,Speech Therapist,2,155,68,1,5,2,0,0,0,0,0,TRUE,TRUE,TRUE,TRUE,TRUE,1,0.5606062499997206,0.4886031250001397,0.5222156249994878,0.6312999999996635,0.5672387096766502,0.584490625000326,1,1,1,0.96875,0.96875,1,0.104,0.328,0.579,0.02,1.765,103.89186905568293,1888.1153111050503,0.063,0.38,0.569,0.019,1.901,122.09899765275142,1954.384242205808,0.065,0.419,0.512,0.022,1.929,50.301277564128675,1875.8928913567943,88.25,100.05263157894737,87.68181818181819,FALSE,428,1.268148148148148,0,1,0,0,3,FALSE
121,2022-03-18T17:08:46Z,2022-03-18T17:30:04Z,1278,1,2022-03-18T17:30:05Z,0.800000011920929,Chrome,99.0.4844.51,Windows NT 10.0,1536,864,no,1.7777777777777777,761,216,113,20,18,84,0.17094361261016572,0.5417132948648892,-1.0839144338720974,-0.9634027897881607,-0.8795195177873442,-0.16386185134342626,2,2,2,2,2,1,2,3,2,3,2,1,1,2,2,2,2,2,3,2,0.6958523739384593,0,1,3,4,4,2,0,4,4,1,4,2,3,3,2,2,2,2,2,4,2,3,2,3,4,4,4,4,1,3,1,2,0,0,0,0,3,2,2,3,4,3,4,3,4,3,2,2,2,2,2,3,3,2,3,2,3,2,3,3,4,3,3,3,2,2,2,4,2,2,1,1,1,2,2,2,2,0.861244298524955,0.9154754164341269,3.125,0,2,0,2.6666666666666665,0,3.111111111111111,0,2.4166666666666665,0,3,0,2.4285714285714284,0,1,0,2.5675675675675675,0,1,0,0,0.9605387399671984,0.7520928399240266,-0.05499485428507328,0.3485489928194767,2,4,2,3,2,2,4,2,2,0.9511897312113419,2.7142857142857144,0,2,0.42410063037077533,3,4,3,3,3,3,2,6,6,2,4,0.4879500364742666,6,3,0,0.34904059506318114,0,-0.028613732632353395,3,3,2,3,3,3,3,2,3,4,2,3,2,4,3,2,3,4,2,3,0.7037315505489968,2.8,0,3,0,2.6,0,3,0,2.8666666666666667,0,3,2,3,3,3,2,3,2,2,2,2,1,3,1,1,2,2,2,1,2,0.8013147091860318,2.1,0,"I lived with my mother, but not father, most of the time. & I lived with my father, but not mother, most of the time.",1,"Asian or Asian American (e.g., Chinese, Japanese, and others)",0,22,0,1,NA,1,4,6,sales consultant,3,198,77,4,5,2,0,0,1,0,0,TRUE,TRUE,TRUE,TRUE,TRUE,4,0.46813437500596045,0.4408500000014901,0.4581096774224312,0.5688549999833107,0.5428576923425381,0.5667040000247955,1,1,0.96875,0.625,0.8387096774193549,0.78125,0.057,0.343,0.636,0.007,1.356,156.31155964046246,2075.658634580295,0.057,0.316,0.472,0.017,2.002,28.457916356136785,1889.930248011089,0.051,0.332,0.401,0.011,1.895,76.84262482602057,2016.7383269572038,193.71428571428572,117.76470588235291,172.27272727272728,FALSE,390,1.1555555555555557,0,1,0,15,18,FALSE
122,2022-03-18T17:12:41Z,2022-03-18T17:30:29Z,1067,1,2022-03-18T17:30:30Z,0.8999999761581421,Chrome,99.0.4844.74,Windows NT 10.0,1920,1080,Great!,1.7777777777777777,551,72,219,60,31,73,-0.26083733947720134,-0.2534195242071799,-0.6987878587125055,-0.470096154866546,-0.6129431920601515,-0.2874822995625583,1,1,1,1,1,1,1,1,1,1,1,1,1,1,1,1,1,1,1,1,1.538967528127731,0,0,2,3,4,1,0,1,1,1,1,1,1,1,1,1,1,1,1,1,1,1,1,1,1,1,1,1,1,1,0,2,0,0,0,0,1,1,1,1,1,1,1,1,1,1,1,1,1,1,1,1,1,1,1,1,1,1,1,1,1,1,1,1,1,1,1,1,1,1,1,1,1,1,1,1,1,1.9666895707934864,2.065591117977289,1,0,1,0,1,0,1,0,1,0,1,0,1,0,1,0,1,0,0,0,0,-1.4366391923707953,-1.587751448753618,-0.6189692744445258,-1.103360361599072,2,2,2,2,2,1,2,1,1,1.1338934190276817,1.8571428571428572,0,1,-0.4603111395192921,5,5,5,5,3,3,5,5,3,3,3,1.5735915849388864,4,4.428571428571429,0,-0.14160432944649845,0,0.44656634047260246,1,1,2,2,2,5,4,4,5,2,5,5,5,4,5,5,4,4,4,1,1.65615734242165,1.6,0,4.6,0,4,0,3.8,0,4.133333333333334,0,1,1,1,1,1,1,1,1,1,1,1,1,1,1,1,1,1,1,1,1,1.231174022502185,1,0,I lived with my mother and father an equal amount of time (joint custody),0,"White, Caucasian, Anglo, European American",0,29,1,2,NA,1,3,6,Manager,2,132,68,3,5,2,0,0,1,0,0,TRUE,TRUE,TRUE,TRUE,TRUE,5,0.4985750000011176,0.4674968749987893,0.5020968750002794,0.5545156249990687,0.5592838709662038,0.5624225806468918,1,1,1,1,0.96875,0.96875,0.066,0.383,0.555,0.014,1.236,21.355038400523693,1845.8375261440056,0.072,0.34,0.561,0.019,1.837,25.17414855384096,1847.697186169079,0.081,0.333,0.496,0.028,1.842,118.13290146544425,1905.0387768194114,88.28571428571428,96.6842105263158,65.78571428571429,FALSE,328,0.9718518518518519,0,1,0,0,3,FALSE
123,2022-03-18T17:05:10Z,2022-03-18T17:30:30Z,1519,1,2022-03-18T17:30:30Z,0.4000000059604645,Chrome,99.0.4844.74,Windows NT 10.0,1280,720,no,1.7777777777777777,570,91,441,89,115,126,-0.22177144381215386,-0.14850616613517076,0.10779798737645113,-0.11244884454837535,1.1095499895617094,0.3081434964023506,1,1,1,1,1,1,1,1,1,1,1,1,1,1,1,1,1,1,1,1,1.538967528127731,0,1,1,5,5,1,0,2,5,1,5,1,1,2,1,1,1,1,2,1,2,2,1,1,5,1,1,1,1,1,2,2,0,0,0,0,1,2,2,1,1,1,2,2,2,1,1,1,1,2,1,2,1,1,1,1,1,1,1,1,1,1,1,1,2,1,1,5,1,1,1,1,1,1,1,2,1,1.6899277664609975,1.4638501094227998,1.5,0,1.25,0,1.8666666666666667,0,1.5555555555555556,0,1.1666666666666667,0,1,0,1.7142857142857142,0,1,0,1.3243243243243243,0,1,0,0,-0.9014960857921396,-0.849463954767833,-0.31345356682763886,-0.581458760797736,3,3,5,3,3,3,3,3,1,0.7559289460184544,3.2857142857142856,0,2,0.7558389783938718,4,4,4,4,1,1,4,3,10,2,2,1.4638501094227998,6.5,3.142857142857143,0,-0.24706573651580854,0,-0.31429317401847046,1,1,1,1,1,5,5,5,5,5,5,5,5,5,3,5,5,5,3,1,1.9223002094465098,1,0,5,0,4.6,0,3.8,0,4.466666666666667,0,1,1,1,1,1,1,1,1,1,1,1,1,1,1,1,1,1,1,1,1,1.231174022502185,1,0,"I lived with my mother, but not father, most of the time.",0,Black or African American,0,28,0,1,NA,1,3,6,computer programmer,3,130,67,3,5,2,0,0,1,0,0,TRUE,TRUE,TRUE,TRUE,TRUE,1,0.5889187500000116,0.46575312500004656,0.5304843750000582,0.6902999999999884,0.5362448275863225,0.6037687500002212,1,1,1,1,0.9354838709677419,1,0.093,0.363,0.555,0.023,1.701,71.80454513843043,1861.4239598347024,0.061,0.37,0.688,0.018,1.711,50.127788693579305,1897.5829417921984,0.192,0.26,0.593,0.014,1.573,16.797720426960577,1798.3644363838437,73.95652173913044,95.05555555555557,112.35714285714285,FALSE,352,1.0429629629629629,0,1,0,3,6,FALSE
125,2022-03-18T17:13:49Z,2022-03-18T17:32:47Z,1137,1,2022-03-18T17:32:47Z,0.8999999761581421,Chrome,99.0.4844.51,Windows NT 10.0,1280,720,n/a,1.7777777777777777,448,79,360,67,25,61,-0.4726156159771957,-0.2147672343911765,-0.1864968483587087,-0.3837674937552634,-0.7359784193188558,-0.42234097034706597,3,4,1,1,3,1,1,4,1,4,4,1,1,1,3,4,1,1,3,4,0.41039134083406165,0,1,1,3,2,2.3,0,4,4,2,4,3,1,4,1,2,NA,1,4,1,3,5,1,3,1,1,1,2,1,3,0,2,0,0,0,0,1,1,1,3,3,3,3,3,3,1,2,2,1,4,1,4,2,2,2,2,3,4,1,4,1,4,5,2,1,1,1,5,5,4,1,3,3,1,1,1,1,1.3633997428703215,0.6992932067530679,1.625,0,1,0,2.7857142857142856,1,2.3333333333333335,0,2.1666666666666665,0,3.1666666666666665,0,2.7142857142857144,0,2.3333333333333335,0,2.4864864864864864,0,0,0,0,-0.06588328412628867,0.11376831509881036,-0.6189692744445258,-0.2526004796728577,4,3,5,1,1,2,2,1,1,0.7559289460184544,2.5714285714285716,0,1,-0.04563820449042111,5,2,2,5,1,1,3,3,3,1,2,1.7043362064926932,3,2.7142857142857144,0,-1.0930953560345533,0,-1.0618089707050569,3,3,4,5,2,2,3,2,3,3,2,4,2,4,3,3,4,2,4,2,0.4879500364742666,3.4,0,2.8,0,3,0,2.8,0,2.8666666666666667,0,1,1,1,4,1,1,4,4,1,1,1,4,1,2,1,4,1,1,1,1,0.6958523739384593,1.8,0,I lived with my mother and father an equal amount of time (joint custody),0,"Asian or Asian American (e.g., Chinese, Japanese, and others)",0,22,1,2,NA,1,2,3,Financial Assistant,1,114,64,2,5,2,0,0,1,0,0,TRUE,TRUE,TRUE,TRUE,TRUE,2,0.47923437508940697,0.42599062505364416,0.4281281251013279,0.5412933334032695,0.5243708333969116,0.49176538471075204,1,1,1,0.9375,0.75,0.8125,0.046,0.344,0.566,0.02,1.751,42.57144361291845,1940.00135539978,0.048,0.336,0.553,0.01,1.496,56.8052519391667,1950.8775470876974,0.07,0.327,0.494,0.016,1.71,72.67396797838974,1916.8982613787869,87.55,149.6,106.875,FALSE,304,0.9007407407407407,1,1,0,0,3,FALSE
126,2022-03-18T16:54:52Z,2022-03-18T17:33:08Z,2295,1,2022-03-18T17:33:08Z,1,Chrome,97.0.4692.71,Windows NT 10.0,1600,900,N/A,1.7777777777777777,594,218,807,164,115,250,-0.17242504928788333,0.5527568062408901,1.4375746525501363,0.8125010959296523,1.1095499895617094,1.70168309450893,2,3,1,2,1,2,1,2,1,1,2,2,2,1,1,2,3,1,3,2,1.0399898784932577,0,1,2,4,4,1.75,0,5,2,3,3,2,4,4,5,2,3,4,4,1,5,3,3,5,1,1,3,4,4,3,1,2,0,0,0,0,1,4,2,1,2,3,2,2,1,2,2,5,1,2,1,1,4,5,4,5,5,3,4,1,1,2,3,1,1,3,2,4,5,4,1,3,2,2,3,1,2,1.4745081126172803,1.2344267996967353,3,0,2,0,3.3333333333333335,0,2,0,3.0833333333333335,0,2.3333333333333335,0,2.857142857142857,0,2,0,2.5675675675675675,0,1,0,0,0.8793899901991236,0.9885847716016792,-0.05499485428507328,0.466794958658303,1,1,2,2,1,2,1,3,1,1.6035674514745464,1.4285714285714286,0,2,-0.32231065268119236,5,4,5,3,2,2,5,8,7,NA,4,1.5735915849388864,7.5,3.7142857142857144,0,1.330900395513221,1,0.9564401536153769,3,2,4,5,4,2,3,1,3,1,3,2,2,3,4,3,3,2,2,4,1.0327955589886444,3.6,0,2.4,0,2.2,0,3,0,2.533333333333333,0,2,4,3,3,4,4,3,3,3,3,1,3,4,4,2,3,1,3,4,3,1.0052493799000692,3,0,I lived with my mother and father an equal amount of time (joint custody),0,"Asian or Asian American (e.g., Chinese, Japanese, and others)",0,22,0,1,NA,1,3,6,Software Engineer,4,120,63,2,5,2,0,0,1,0,0,TRUE,TRUE,TRUE,TRUE,TRUE,6,0.5308935483732531,0.4727062499858439,0.5056968750059605,0.5800187499970197,0.558780000003179,0.7133999999894036,0.96875,1,1,1,0.9375,0.84375,0.069,0.353,0.37,0.007,1.638,198.51660887063053,2136.98838026513,0.058,0.379,0.646,0.017,1.697,39.44150006537313,1884.3569288414135,0.059,0.406,0.47,0.025,1.583,122.39152586296326,1951.339152196431,233.99999999999997,99.8235294117647,63.31999999999999,FALSE,322,0.9540740740740741,0,1,0,0,3,FALSE
128,2022-03-18T17:07:43Z,2022-03-18T17:34:01Z,1577,1,2022-03-18T17:34:01Z,1,Chrome,99.0.4844.74,Windows NT 10.0,2560,1440,None,1.7777777777777777,516,116,394,65,377,56,-0.33280083149176254,-0.010462273935158787,-0.06296568274148112,-0.4084328255013442,6.482088246525133,-0.4785320831739442,2,2,2,2,2,2,3,3,2,3,3,3,3,3,3,3,3,2,3,3,0.5026246899500346,0,1,1,2,2,2.6,0,2,2,3,2,3,1,2,2,3,4,2,2,3,3,2,1,1,1,1,1,1,1,1,2,1,2,1,1,1,2,3,3,3,3,2,2,2,2,2,2,4,4,2,3,2,2,2,2,2,2,2,1,1,1,3,1,2,3,2,1,3,2,3,1,1,1,3,3,3,3,1.138989594902999,0.9411239481143202,1,0,3,0,2.4,0,2.4444444444444446,0,2.4166666666666665,0,1.5,0,2.2857142857142856,0,1,0,2.135135135135135,0,1,1,1,-0.6997208160985483,-0.4809102084360904,1.895115263017989,0.7071025272909494,2,2,2,2,2,2,4,1,1,1.0690449676496976,2.2857142857142856,0,1,-0.21150737850196963,4,4,4,4,3,3,5,6,6,5,3,1.1126972805283737,6,3.857142857142857,0,0.6473058850354002,0,0.6174725797407661,3,3,3,3,3,3,3,3,4,3,4,3,3,3,3,4,4,4,3,3,0.560611910581388,3,0,3.6,0,3.2,0,3.2,0,3.3333333333333335,0,3,2,3,3,2,3,3,3,3,2,3,3,2,3,3,3,1,3,3,3,0.6069769786668839,2.7,0,"I lived with my mother and father an equal amount of time (joint custody) & I lived with my extended family on father's side (grandparents, aunts ,uncles, cousins)",1,"Asian or Asian American (e.g., Chinese, Japanese, and others)",0,28,0,1,NA,1,4,8,Pharmacist,6,170,66,3,5,2,0,0,0,0,0,TRUE,TRUE,TRUE,TRUE,TRUE,4,0.5848937500000029,0.9469093749999739,0.5377806451613264,0.6794566666666418,0.8127645161290984,0.6470000000000621,1,1,1,1,0.96875,0.967741935483871,0.068,0.38,0.444,0.017,1.862,149.28917503648705,1974.924416484638,0.11,0.255,0.186,0.171,2.033,176.26171999953272,2001.5184400863968,0.185,0.238,0.57,0.008,1.272,99.61920432855125,1882.105844885766,109.52941176470588,11.888888888888888,159,FALSE,328,0.9718518518518519,0,1,1,3,6,FALSE
129,2022-03-18T16:25:33Z,2022-03-18T17:34:13Z,4120,1,2022-03-18T17:34:14Z,0.8999999761581421,Chrome,99.0.4844.74,Windows NT 10.0,1920,1080,NA,1.7777777777777777,2406,53,438,235,29,56,3.553227737294541,-0.35833288227918897,0.09689817864551929,1.6881203729155183,-0.6539549344797195,-0.4785320831739442,1,1,1,1,1,1,1,1,1,1,1,1,1,1,1,1,1,1,1,1,1.538967528127731,0,1,1,5,5,1,0,1,1,2,1,1,1,1,1,1,1,1,1,1,1,3,1,1,1,1,1,1,1,1,5,2,0,0,0,0,2,1,1,1,1,1,1,1,1,1,1,1,1,1,1,1,1,1,1,1,1,1,1,1,1,3,1,1,4,4,2,1,1,1,1,1,1,2,1,3,3,1.895149490565742,1.9346465162548798,1,0,2.25,0,1.2,0,1.1111111111111112,0,1,0,1.3333333333333333,0,2,0,1,0,1.2702702702702702,0,3,0,0,-1.2611824361154984,-1.3824312186733945,0.4698836567678454,-0.45627378095277454,1,1,2,1,1,1,2,1,1,1.6761634196950514,1.2857142857142858,0,1,-0.7920494875423887,5,5,5,5,3,3,5,8,6,3,3,1.5735915849388864,7,4.428571428571429,0,0.4002850852868561,0,0.7766255014915452,2,2,2,2,2,4,5,4,4,1,5,3,3,4,3,4,3,3,2,2,1.1126972805283737,2,0,3.6,0,3,0,3.4,0,3.3333333333333335,0,1,1,1,1,1,1,1,1,1,1,1,1,1,1,1,1,1,1,1,1,1.231174022502185,1,0,I lived with my mother and father an equal amount of time (joint custody),0,"White, Caucasian, Anglo, European American",0,22,0,1,NA,1,2,3,Unemployed,1,220,70,3,5,2,0,0,1,0,0,TRUE,TRUE,TRUE,TRUE,TRUE,5,0.6859838709687033,0.6435999999998603,0.6086656249999068,0.6100482758625314,0.6576166666664183,0.6845518518520726,1,1,1,0.90625,0.9375,0.8709677419354839,0.067,0.372,0.303,0.013,1.666,138.30915274750558,2070.764242133799,0.072,0.359,0.274,0.035,1.769,53.66767701135669,1918.73097391602,0.064,0.354,0.229,0.183,1.64,168.8472404127088,2053.7683481977147,128.15384615384616,50.54285714285714,8.96174863387978,FALSE,472,1.3985185185185185,0,1,1,24,27,FALSE
130,2022-03-18T16:57:54Z,2022-03-18T17:34:34Z,2199,1,2022-03-18T17:34:35Z,0.8999999761581421,Chrome,99.0.4844.51,Macintosh,1280,800,n/a,1.6,835,215,678,109,97,140,0.3230949957266665,0.5361915391768887,0.9688828771200669,0.134204472912432,0.7404443077855963,0.4654786123176096,3,3,1,2,4,1,2,3,1,3,4,2,2,1,3,3,2,1,4,3,0.5026246899500346,0,1,1,3,3,2.4,0,2,2,1,2,2,1,3,1,1,2,3,3,2,3,2,1,3,1,1,1,2,1,2,0,2,0,0,0,0,1,1,1,1,1,1,3,1,1,2,2,1,1,2,1,1,2,1,1,1,1,2,1,1,1,3,1,1,1,1,1,1,1,1,1,1,1,2,1,1,1,1.7891900964406218,1.1872336794093274,1.5,0,1.25,0,2,0,1.2222222222222223,0,1.3333333333333333,0,1.5,0,1,0,1,0,1.2432432432432432,0,0,0,0,-0.954133112668729,-0.8266505958700302,-0.5328163702636706,-0.6797334830668504,1,1,2,1,1,1,1,1,1,1.7320508075688772,1.1428571428571428,0,1,-0.874984074548163,4,4,5,3,1,1,4,7,3,NA,3,1.5735915849388864,5,3.142857142857143,0,0.13872270157061628,1,-0.07931348121847359,2,4,2,3,2,5,3,4,4,3,5,4,4,3,3,3,4,4,3,3,0.9102589898327995,2.6,0,4.4,0,3.2,0,3.4,0,3.6666666666666665,0,2,2,3,4,2,3,3,4,2,2,1,3,1,2,1,3,2,3,2,1,0.7181848464596079,2.3,0,NA,NA,"White, Caucasian, Anglo, European American",0,30,1,2,NA,1,3,8,unemployed,3,111,63,2,5,2,1,1,0,0,2,TRUE,TRUE,TRUE,TRUE,TRUE,5,0.5813419355730857,0.5158312499970198,0.5789875000268221,0.6271218750625849,0.5749937500357628,0.6352156251370906,1,1,1,1,1,1,0.115,0.419,0.729,0.029,1.731,65.25076369874425,1847.519737558033,0.081,0.403,0.754,0.022,1.661,27.506808782545885,1813.5075151212116,0.086,0.46,0.702,0.031,1.646,78.59857310718064,1864.8775468953277,59.689655172413794,75.5,53.096774193548384,FALSE,388,1.1496296296296296,0,1,0,0,3,FALSE
131,2022-03-18T17:08:40Z,2022-03-18T17:35:19Z,1598,1,2022-03-18T17:35:20Z,0.8999999761581421,Chrome,99.0.4844.51,Windows NT 6.1,1920,1080,NA,1.7777777777777777,532,99,539,216,22,100,-0.29990323514224887,-0.10433212063116694,0.46385840592022476,1.4537997213277514,-0.7974960329482079,0.015949709702583987,3,3,2,2,3,2,2,3,2,3,3,2,2,3,3,3,2,2,3,3,0.22360679774997896,0,1,1,3,2,2.55,0,4,4,3,3,2,1,3,4,2,3,3,4,3,4,3,2,1,1,1,2,1,1,1,2,2,0,0,0,0,3,3,2,2,3,3,2,3,4,4,3,2,4,3,3,2,2,3,2,3,3,1,1,1,1,3,1,1,3,3,1,2,2,3,1,2,1,2,2,3,4,1.1109609508143095,0.7432233529572065,1.25,0,2.75,0,3.066666666666667,0,2.7777777777777777,0,2.8333333333333335,0,1.3333333333333333,0,2.142857142857143,0,1.3333333333333333,0,2.324324324324324,0,1,0,0,-0.414603587183691,0.0019069992717150306,0.20346385825749233,0.10268542876460368,2,2,2,2,2,2,2,1,1,0.9759000729485332,2,0,1,-0.3773765525135179,4,3,3,3,3,2,4,6,6,4,3,0.6900655593423543,6,3.142857142857143,0,0.43348058270556905,0,0.1002204537615918,3,4,2,3,3,3,2,4,3,3,4,3,4,3,3,3,3,3,4,3,0.560611910581388,3,0,3.2,0,3.2,0,3.2,0,3.2,0,2,3,3,3,2,2,2,3,3,3,2,3,2,2,2,2,2,3,2,2,0.47016234598162726,2.4,0,I lived with my mother and father an equal amount of time (joint custody),0,"White, Caucasian, Anglo, European American",0,23,0,1,NA,1,2,6,Student,2,150,71,2,5,2,0,0,0,0,0,TRUE,TRUE,TRUE,TRUE,TRUE,2,0.6041806451612858,0.5383187499999876,0.6395937499999982,0.6673062500000014,0.5884468750000015,0.6995531249999949,1,1,1,1,1,1,0.092,0.404,0.368,0.041,1.314,8.383415261267775,1788.8385852507413,0.07,0.406,0.493,0.037,1.682,29.33250264795917,1813.6660113819046,0.087,0.398,0.394,0.025,1.494,66.06937402387423,1850.0528857140387,32.048780487804876,45.45945945945946,59.76,FALSE,304,0.9007407407407407,1,1,0,0,3,FALSE
132,2022-03-18T16:54:40Z,2022-03-18T17:36:09Z,2489,1,2022-03-18T17:36:10Z,0.8999999761581421,Chrome,99.0.4844.74,Windows NT 10.0,1366,768,No,1.7786458333333333,1031,96,1039,57,93,99,0.7260905510082091,-0.12089738769516838,2.2804931944088658,-0.5070941524856671,0.6584208229464601,0.004711487137208345,1,2,1,1,3,1,2,2,1,2,2,3,1,1,2,2,2,1,2,2,1.0052493799000692,0,0,3,3,3,1.7,0,3,3,3,3,2,2,4,3,2,3,3,3,3,4,3,2,3,3,1,2,2,3,2,1,2,0,0,0,0,3,4,3,3,5,3,3,3,3,4,3,3,3,3,2,3,3,1,2,3,2,3,2,3,4,3,2,2,2,1,1,3,3,4,3,3,2,4,3,3,3,0.7941225539113158,0.4879500364742666,2.25,0,3.25,0,2.933333333333333,0,3.3333333333333335,0,2.6666666666666665,0,2.8333333333333335,0,2.2857142857142856,0,2.6666666666666665,0,2.7837837837837838,0,1,0,0,0.5328628965949126,0.5808943147469818,0.37576966661920275,0.4783319906830923,3,2,5,2,1,3,2,3,2,0.816496580927726,2.5714285714285716,0,2.5,0.5345681672927123,4,4,5,4,3,3,4,3,3,2,2,0.9759000729485332,3,3.857142857142857,0,-0.8792700537047221,0,-0.31234881900385125,3,3,3,3,3,3,3,4,4,3,3,3,4,3,3,3,3,3,3,3,0.4140393356054125,3,0,3,0,3.2,0,3.4,0,3.2,0,3,2,2,2,2,2,2,3,3,1,2,2,2,2,1,3,1,1,1,2,0.6863327411532597,1.95,0,"I lived with my mother, but not father, most of the time.",0,"Hispanic of Latino (e.g., Mexican American, Central American, and others)",0,30,1,2,NA,1,2,3,stocker,2,165,64,3,5,2,0,0,0,0,0,TRUE,TRUE,TRUE,TRUE,TRUE,3,0.56353125,0.4767903225921815,0.4975093749947846,0.5723937500007451,0.5029516129186077,0.5517499999957425,1,0.96875,1,1,0.96875,0.875,0.051,0.384,0.505,0.015,1.553,78.809318371654,1937.228220139729,0.049,0.37,0.506,0.025,1.48,109.6383127627037,1978.8688943399009,0.125,0.343,0.577,0.1,1.944,42.669347118217424,1825.1668109217771,103.53333333333333,59.199999999999996,19.439999999999998,FALSE,522,1.5466666666666666,0,1,0,0,3,FALSE
133,2022-03-18T17:18:17Z,2022-03-18T17:37:12Z,1134,1,2022-03-18T17:37:14Z,0.8999999761581421,Chrome,99.0.4844.51,Macintosh,1440,900,No,1.6,505,79,280,106,42,68,-0.3554179289820532,-0.2147672343911765,-0.4771584145168912,0.0972064752933109,-0.38737860875252683,-0.3436734123894365,1,1,1,1,1,1,2,1,1,1,2,1,1,1,1,1,1,1,1,3,1.4290224851827542,0,1,1,3,3,1.2,0,1,1,2,1,1,1,2,1,1,1,1,2,2,1,1,5,2,1,1,1,1,1,1,1,2,0,0,0,0,1,1,1,1,1,1,1,1,1,1,1,1,1,1,1,1,1,1,1,1,2,1,1,1,1,1,1,1,1,1,1,1,1,1,1,1,1,1,1,1,1,1.9521298140264163,1.8464895909600492,1.625,0,1,0,1.2666666666666666,0,1,0,1.0833333333333333,0,1,0,1,0,1,0,1.027027027027027,0,1,0,0,-1.0133497679048913,-1.1866493326150969,-0.39960647100849406,-0.7931279018117955,1,1,2,1,1,5,2,1,1,1.889822365046136,1.8571428571428572,0,1,-0.4603111395192921,5,5,5,5,2,3,5,6,6,4,3,1.7043362064926932,6,4.285714285714286,0,0.43348058270556905,0,0.7194418556870088,2,2,3,3,2,5,3,3,4,2,5,2,3,4,5,3,3,4,5,2,1.245945806357946,2.4,0,3.8,0,3.2,0,3.6,0,3.533333333333333,0,1,1,1,1,1,1,1,1,1,1,1,1,1,1,1,1,1,1,1,1,1.231174022502185,1,0,I lived with my mother and father an equal amount of time (joint custody),0,"White, Caucasian, Anglo, European American",0,30,1,2,NA,1,3,7,Social Worker,3,143,66,3,5,2,0,0,1,0,0,TRUE,TRUE,TRUE,TRUE,TRUE,2,0.5140250000022352,0.4583375000031665,0.5102531249988824,0.5722741935464644,0.5352933333347241,0.5870774193531082,1,1,1,0.96875,0.9375,0.96875,0.069,0.363,0.466,0.02,1.796,37.75362469812185,1859.3577757100447,0.072,0.331,0.608,0.017,1.834,106.00314262747254,1947.9267408167054,0.095,0.301,0.491,0.01,1.343,125.75166390303716,1952.7230778784815,89.8,107.88235294117646,134.29999999999998,FALSE,416,1.2325925925925925,0,1,0,0,3,FALSE
134,2022-03-18T17:20:15Z,2022-03-18T17:38:52Z,1117,1,2022-03-18T17:38:53Z,1,Firefox,98.0,Windows NT 10.0,1536,864,NA,1.7777777777777777,553,59,289,73,32,60,-0.25672513993351215,-0.3252023481511861,-0.4444589883240957,-0.30977149851702124,-0.5924373208503674,-0.4335791929124416,1,1,1,1,1,1,1,2,1,1,3,1,1,1,1,1,1,1,1,1,1.460893742308382,0,1,1,4,4,1.15,0,3,1,2,2,1,1,5,3,2,1,1,3,3,2,2,2,3,1,1,3,2,3,2,3,2,0,0,0,0,1,3,5,1,1,3,4,4,2,3,4,1,4,4,4,4,5,5,4,4,2,3,1,1,1,5,5,1,3,3,1,1,1,1,3,3,2,4,2,2,2,1.4866775743954068,1.3557637102737474,2.125,0,2.5,0,2.1333333333333333,0,2.6666666666666665,0,3.6666666666666665,0,2.6666666666666665,0,1.5714285714285714,0,2.6666666666666665,0,2.7837837837837838,0,2,0,0,0.45171414682683775,0.1770388621897606,0.33667375751266887,0.2568563098512147,2,2,5,2,1,2,2,2,1,1,2.2857142857142856,0,1.5,-0.01810525457425849,4,4,4,4,1,1,1,5,3,4,2,1.6035674514745464,4,2.7142857142857144,0,-0.27098964413394167,0,-0.5610730010380436,2,3,2,3,3,3,5,3,4,5,5,2,5,4,4,4,5,5,4,5,1.5522640914238175,2.6,0,4,0,4.6,0,4,0,4.2,0,1,1,1,4,1,1,1,2,1,1,1,2,1,2,1,2,1,1,1,1,0.7451598203705946,1.35,0,I lived with my mother and father an equal amount of time (joint custody),0,"White, Caucasian, Anglo, European American",0,28,1,2,NA,1,3,7,Museum Technician,2,195,67,2,5,2,0,0,1,0,0,TRUE,TRUE,TRUE,TRUE,TRUE,2,0.57003125,0.54678125,0.5622258064516129,0.67046875,0.6150645161290322,0.6289677419354839,1,1,1,1,1,0.96875,0.071,0.394,0.44,0.018,1.632,68.42877709809554,1893.8146847198252,0.073,0.383,0.442,0.025,1.712,82.32698968477875,1866.2606111526477,0.197,0.25,0.621,0.019,1.742,48.60262009738282,1831.1081477042712,90.66666666666667,68.47999999999999,91.6842105263158,FALSE,360,1.0666666666666667,0,1,0,0,3,FALSE
135,2022-03-18T17:22:55Z,2022-03-18T17:38:58Z,962,1,2022-03-18T17:39:00Z,0.8999999761581421,Chrome,99.0.4844.51,Windows NT 10.0,1280,720,NA,1.7777777777777777,440,76,244,47,43,69,-0.4890644141519525,-0.23133250145517795,-0.6079561192880734,-0.6304208112160707,-0.36687273754274274,-0.33243518982406084,2,2,2,1,3,1,1,2,1,2,3,1,2,2,2,3,1,1,2,3,0.8255779474818965,0,1,1,3,3,1.85,0,4,4,4,3,4,4,2,4,2,2,3,3,1,3,3,3,3,1,1,4,3,4,2,1,2,0,0,0,0,1,1,1,1,2,1,1,1,1,1,1,2,1,1,1,1,4,1,1,2,3,2,1,1,1,1,1,1,1,1,1,3,3,2,1,2,2,2,2,1,1,1.7424224619867699,0.9611501047232549,2.625,0,1.5,0,3.066666666666667,0,1.1111111111111112,0,1.5833333333333333,0,1.1666666666666667,0,1.7142857142857142,0,1.6666666666666667,0,1.4324324324324325,0,1,0,0,-0.10097463537734769,0.21283223563286444,-0.22730066264678367,-0.007234213506959616,2,2,3,3,1,2,2,1,6,0.9759000729485332,2.142857142857143,0,3.5,0.6725686541308118,4,4,5,4,3,3,3,6,4,2,3,0.7559289460184544,5,3.7142857142857144,0,-0.17479982686521142,0,0.03933393483307579,1,2,1,1,2,4,3,4,5,4,5,5,5,5,5,1,5,5,3,4,1.6903085094570331,1.4,0,4.8,0,3.2,0,4.6,0,4.2,0,3,1,2,3,4,2,3,4,2,1,1,2,2,2,1,2,2,2,1,3,0.8870412083230169,2.15,0,I lived with my mother and father an equal amount of time (joint custody),0,"White, Caucasian, Anglo, European American",0,27,1,1,NA,1,4,6,Junior Researcher,3,115,63,1,5,2,0,0,1,0,0,TRUE,TRUE,TRUE,TRUE,TRUE,5,0.4700062500005588,0.39989687499962745,0.4389499999973923,0.5343793103427722,0.4784733333339294,0.5376321428567171,1,1,1,0.90625,0.9375,0.875,0.059,0.328,0.63,0.01,1.614,131.39975812670724,2000.9559557573116,0.059,0.308,0.612,0.025,1.975,81.56031452945408,1935.4927678472307,0.058,0.358,0.533,0.024,1.938,77.05774046883027,1935.0825325020396,161.4,79,80.75,FALSE,318,0.9422222222222223,0,1,0,0,3,FALSE
136,2022-03-18T17:03:56Z,2022-03-18T17:39:45Z,2148,1,2022-03-18T17:39:46Z,1,Chrome,99.0.4844.74,Windows NT 10.0,1536,864,Thank you for the opportunity to participate and good luck. I enjoyed the Flanker game.,1.7777777777777777,917,105,863,44,28,51,0.4916951770179241,-0.07120158650316406,1.641037748860864,-0.6674188088351919,-0.6744608056895036,-0.5347231960008224,2,2,2,1,2,1,2,3,1,2,4,2,2,1,3,2,2,1,2,3,0.7947194142390263,0,0,4,3,3,2,0,3,2,2,2,4,1,4,3,2,3,4,3,3,3,2,3,4,2,1,3,3,3,3,2,2,0,0,0,0,2,3,1,2,2,1,2,2,3,2,3,3,2,2,3,2,4,4,3,5,4,3,1,2,1,3,3,1,2,2,1,2,3,3,2,2,2,3,2,2,2,1.1422805280686548,0.9258200997725514,2.75,0,2.25,0,2.7333333333333334,0,2,0,3.0833333333333335,0,2.1666666666666665,0,2,0,2,0,2.3783783783783785,0,1,0,0,0.5942727612842665,0.5348742631772767,0.031158049895781924,0.28301615653652934,2,2,4,3,2,3,2,3,3,0.7867957924694432,2.5714285714285716,0,3,0.7279702912204233,4,4,5,4,1,1,3,6,4,3,2,1.5735915849388864,5,3.142857142857143,0,-0.30418514155265464,0,-0.3490840047521533,2,2,2,2,2,4,4,4,4,4,5,4,1,3,4,5,4,4,4,2,1.2798809468443688,2,0,4.2,0,3.6,0,3.4,0,3.7333333333333334,0,3,2,2,4,2,3,1,3,2,1,3,3,3,3,2,4,1,3,3,1,0.8255779474818965,2.45,0,I lived with my mother and father an equal amount of time (joint custody),0,"White, Caucasian, Anglo, European American",0,30,0,1,NA,1,2,6,Data Analyst,2,170,73,3,5,2,0,0,0,0,0,TRUE,TRUE,TRUE,TRUE,TRUE,1,0.592441935479641,0.43120999999841053,0.42648387096966467,0.585890322583337,0.5124967742004702,0.5159799999992053,1,0.9375,0.96875,0.96875,0.96875,0.967741935483871,0.064,0.314,0.626,0.009,1.261,150.70215488266317,2032.0365230574587,0.05,0.339,0.457,0.021,1.665,204.8185996887259,2101.04632234507,0.065,0.375,0.335,0.039,1.821,128.46180395061327,1953.4260254731657,140.11111111111111,79.28571428571428,46.69230769230769,FALSE,400,1.1851851851851851,0,1,0,3,6,FALSE
137,2022-03-18T17:07:17Z,2022-03-18T17:39:46Z,1948,1,2022-03-18T17:39:46Z,0.8999999761581421,Chrome,99.0.4844.74,Windows NT 10.0,1504,1003,NA,1.4995014955134596,724,122,921,20,19,48,0.09486792105191533,0.02266826019284409,1.8517673843255464,-0.9634027897881607,-0.8590136465775602,-0.5684378636969493,2,2,1,1,2,1,1,2,1,1,3,2,1,2,1,1,1,1,2,2,1.1516578439248717,0,1,1,3,3,1.5,0,3,4,3,3,3,4,3,3,4,3,3,4,2,4,3,2,1,1,1,1,1,3,1,2,2,0,0,0,0,3,2,3,2,3,2,3,3,3,4,3,4,2,3,3,3,2,3,2,2,4,2,1,2,1,1,2,3,2,1,1,3,2,3,2,2,2,2,1,1,1,0.9531046156684,0.6399404734221844,1.375,0,1.25,0,3.2666666666666666,0,2.6666666666666665,0,2.9166666666666665,0,1.5,0,2.142857142857143,0,2,0,2.4054054054054053,0,1,0,0,-0.2808178105390271,0.17920219794731077,-0.31345356682763886,-0.06712568444016405,3,3,4,3,2,3,3,3,1,0.4879500364742666,3,0,2,0.5899698043823236,3,2,4,4,2,2,4,1,1,2,2,0.9511897312113419,1,3,0,-1.2405296635269585,0,-0.9968043111272092,3,2,3,4,3,3,2,3,3,3,3,4,3,3,3,2,2,3,2,3,0.5936168397046637,3,0,3,0,2.4,0,3,0,2.8,0,2,1,1,3,2,1,1,2,2,1,1,2,2,1,1,2,2,1,1,2,0.7451598203705946,1.55,0,I lived with my mother and father an equal amount of time (joint custody),0,"Asian or Asian American (e.g., Chinese, Japanese, and others)",0,26,1,2,NA,1,3,7,auditor,3,120,64,2,5,2,0,0,0,0,0,TRUE,TRUE,TRUE,TRUE,TRUE,2,0.4636218750000116,0.40673749999993014,0.43298387096774194,0.5178555555556107,0.4704399999999131,0.5040160000001639,1,1,0.96875,0.9,0.9375,0.78125,0.046,0.348,0.592,0.01,1.38,164.33422819557313,2151.5650388012264,0.052,0.326,0.598,0.013,1.226,180.20320444452994,2053.9250948988533,0.051,0.363,0.551,0.022,1.774,100.71990032901178,1997.723118399389,138,94.3076923076923,80.63636363636364,FALSE,428,1.268148148148148,0,1,0,0,3,FALSE
138,2022-03-18T17:21:18Z,2022-03-18T17:40:45Z,1166,1,2022-03-18T17:40:45Z,0.8999999761581421,Chrome,99.0.4844.51,Windows NT 10.0,1536,864,NA,1.7777777777777777,498,86,291,69,48,89,-0.3698106273849654,-0.17611494457517315,-0.43719244917014116,-0.3591021620091827,-0.26434338149382247,-0.10767073851654806,1,1,1,1,1,1,1,2,1,1,1,1,1,1,1,1,1,1,1,1,1.5035046776746235,0,1,1,3,3,1.05,0,3,1,3,2,4,3,1,3,1,1,1,1,3,2,1,1,4,1,1,1,1,3,1,0,2,0,0,0,0,1,1,1,1,1,1,1,1,1,1,1,1,1,2,1,4,5,3,2,3,4,3,1,1,1,5,5,1,1,2,1,2,5,2,1,1,1,2,1,1,2,1.7870908465138793,1.4474937289114918,1.625,0,1.5,0,2,0,1,0,2.3333333333333335,0,2.6666666666666665,0,2,0,1,0,1.8918918918918919,0,0,0,0,-0.45188814788794135,-0.48887521736161643,-0.4466634660828154,-0.4677693417222159,1,1,3,1,1,1,1,1,1,1.5735915849388864,1.2857142857142858,0,1,-0.7920494875423887,5,5,5,5,1,1,2,7,7,2,2,1.889822365046136,7,3.4285714285714284,0,-0.15675083406024948,0,-0.10447796336729244,1,2,1,1,1,5,4,5,5,4,5,4,3,4,3,4,3,5,3,3,1.245945806357946,1.2,0,4.4,0,3.6,0,4,0,4,0,1,1,1,1,2,1,2,1,1,1,3,1,1,1,1,1,1,1,1,2,1.2258187382102494,1.25,0,I lived with my mother and father an equal amount of time (joint custody),0,"White, Caucasian, Anglo, European American",0,25,1,2,NA,1,2,6,"Full-time master's student, part-time university teaching assistant",3,125,68,2,5,2,0,0,1,0,0,TRUE,TRUE,TRUE,TRUE,TRUE,3,0.47141562500223516,0.4302843749895692,0.4242750000208616,0.5654999999884636,0.49868387096543465,0.5144812500067055,1,1,1,0.96875,1,1,0.104,0.29,0.737,0.027,2.066,86.67086261608631,1873.6480693198318,0.082,0.32,0.823,0.017,1.588,49.098425569391786,1833.613758369476,0.07,0.342,0.561,0.013,1.552,51.27717161704209,1875.712908771227,76.51851851851852,93.41176470588235,119.38461538461539,FALSE,384,1.1377777777777778,0,1,0,0,3,FALSE
139,2022-03-18T17:26:39Z,2022-03-18T17:41:47Z,908,1,2022-03-18T17:41:49Z,0.8999999761581421,Chrome,99.0.4844.51,Windows NT 10.0,1536,864,I do not,1.7777777777777777,453,53,197,42,28,89,-0.46233511711797265,-0.35833288227918897,-0.7787197894060056,-0.6920841405812727,-0.6744608056895036,-0.10767073851654806,3,3,2,1,3,1,1,3,1,3,4,1,1,1,3,3,1,1,3,3,0.512989176042577,0,1,1,3,2,2.1,0,5,2,1,2,1,3,3,3,3,1,3,4,1,4,4,1,3,1,1,1,2,2,1,1,2,0,0,0,0,2,2,3,3,3,2,3,2,3,1,2,1,2,4,2,3,3,1,1,1,1,3,2,1,1,1,1,1,2,2,2,3,3,2,1,1,1,1,1,2,2,1.0932498320124249,1.0997835284835873,1.5,0,1.5,0,2.6666666666666665,0,2.5555555555555554,0,1.8333333333333333,0,1.5,0,2.142857142857143,0,1,0,1.945945945945946,0,1,0,0,-0.4979455464049568,-0.2287832592379614,-0.22730066264678367,-0.22804196094237253,3,1,3,1,1,1,1,1,1,0.9759000729485332,1.5714285714285714,0,1,-0.6261803135308405,4,4,4,4,1,1,4,3,2,3,3,1.4638501094227998,2.5,3.142857142857143,0,-0.41254903681317573,0,-0.4150873172029633,1,1,1,1,1,5,4,5,5,1,5,4,5,3,3,5,4,5,4,4,1.3557637102737474,1,0,4.6,0,3.8,0,4,0,4.133333333333334,0,1,1,1,3,1,1,1,3,2,1,2,3,1,2,1,3,1,1,1,2,0.5026246899500346,1.6,0,I lived with my mother and father an equal amount of time (joint custody),0,"White, Caucasian, Anglo, European American",0,23,2,2,NA,1,3,6,Food Inspector,2,140,67,4,5,2,0,0,1,0,0,TRUE,TRUE,TRUE,TRUE,TRUE,2,0.509728125013411,0.4292709677411664,0.46788750000298024,0.6181965517298929,0.5208225806374703,0.6305344827462886,1,1,1,0.9354838709677419,0.96875,0.90625,0.074,0.323,0.498,0.011,1.791,63.22254546807301,1918.8765734083586,0.075,0.317,0.685,0.02,1.893,30.156690736642744,1852.249222303386,0.064,0.352,0.438,0.009,1.434,104.31399419212569,1945.7363528418678,162.8181818181818,94.65,159.33333333333334,FALSE,422,1.2503703703703704,0,1,0,0,3,FALSE
142,2022-03-18T17:24:43Z,2022-03-18T17:42:20Z,1057,1,2022-03-18T17:42:21Z,1,Chrome,98.0.4758.107,CrOS x86_64 14388.61.0,1536,864,NA,1.7777777777777777,493,93,242,68,40,71,-0.38009112624418845,-0.1374626547591698,-0.615222658442028,-0.37143482788222304,-0.42839035117209495,-0.3099587446933096,2,3,1,2,2,1,1,2,1,1,3,1,1,1,2,2,1,1,3,2,0.998683343734455,0,0,2,3,3,1.65,0,5,3,3,5,1,5,5,4,4,4,3,5,2,5,5,5,5,1,1,5,5,5,1,0,2,0,0,0,0,2,5,5,4,5,2,3,3,3,4,2,5,1,4,1,2,5,5,5,5,5,4,1,1,1,2,1,1,1,1,1,5,5,4,1,4,5,1,1,1,1,1.6644128905623958,1.4474937289114918,3.5,0,1,0,3.933333333333333,0,3.5555555555555554,0,3.6666666666666665,0,1.6666666666666667,0,2.5714285714285716,0,3.3333333333333335,0,3.081081081081081,0,0,0,0,1.5373528261564866,1.6930455610148598,-0.6189692744445258,0.537038143285167,1,2,3,1,1,2,1,1,1,1.4638501094227998,1.5714285714285714,0,1,-0.6261803135308405,5,3,5,2,1,2,3,4,3,2,2,1.5275252316519468,3.5,3,0,-0.788955151249163,0,-0.7217550102780903,1,3,1,4,1,5,4,5,5,3,5,5,4,2,5,1,5,5,4,3,1.6846647257229665,2,0,5,0,3.2,0,4,0,4.066666666666666,0,3,1,2,4,2,3,2,4,3,4,2,3,2,4,1,4,1,3,3,3,1.0052493799000692,2.7,0,NA,NA,"White, Caucasian, Anglo, European American",0,29,1,4,Genderqueer,1,1,5,Phone Interviewer,1,280,68,1,4,2,0,0,1,1,0,TRUE,TRUE,TRUE,TRUE,TRUE,4,0.5629516129003417,0.5026774193558001,0.5301374999983236,0.6677781250020489,0.5903933333347241,0.638374999997206,1,1,1,1,0.9375,1,0.163,0.268,0.609,0.016,1.758,55.7799832353791,1839.9132376364391,0.058,0.389,0.511,0.014,1.463,17.047984604060833,1861.9966902179315,0.145,0.32,0.609,0.013,1.625,87.11282323041186,1870.0251785648427,109.875,104.5,125,FALSE,304,0.9007407407407407,1,0,0,0,3,FALSE
143,2022-03-18T17:22:41Z,2022-03-18T17:42:33Z,1191,1,2022-03-18T17:42:34Z,0.8999999761581421,Chrome,99.0.4844.51,Macintosh,1280,800,NA,1.6,626,72,186,62,26,80,-0.10662985658885597,-0.2534195242071799,-0.8186857547527557,-0.4454308231204653,-0.7154725481090718,-0.20881474160492883,2,1,2,3,1,1,1,2,1,2,2,1,1,2,2,2,1,1,2,2,1.0809352675491624,0,1,1,3,2,1.6,0,1,1,2,1,2,1,1,1,1,1,1,1,1,1,2,1,1,1,1,1,1,1,1,1,2,0,0,0,0,1,1,1,1,1,1,1,1,1,1,1,1,1,1,1,1,1,1,1,1,1,1,1,1,1,2,1,1,1,1,1,1,1,1,1,1,1,1,1,1,1,1.9521298140264163,1.9073791542572855,1,0,1,0,1.2,0,1,0,1,0,1.1666666666666667,0,1,0,1,0,1.027027027027027,0,1,0,0,-1.4190935167452654,-1.4886313376804068,-0.39960647100849406,-0.9441189043444504,1,1,1,1,1,1,2,1,1,1.889822365046136,1.1428571428571428,0,1,-0.874984074548163,5,5,5,5,4,3,5,5,6,5,4,1.5275252316519468,5.5,4.571428571428571,0,0.9002015995971155,0,1.158522084172637,1,2,2,3,2,4,3,3,5,1,5,4,4,3,4,5,4,5,4,3,1.245945806357946,2,0,4.4,0,3.4,0,3.6,0,3.8,0,1,1,1,4,1,1,1,1,1,1,1,1,1,1,1,1,1,1,1,1,1.0990426455975697,1.15,0,I lived with my mother and father an equal amount of time (joint custody),0,"Asian or Asian American (e.g., Chinese, Japanese, and others)",0,22,1,2,NA,1,4,6,Consultant,3,140,66,3,5,2,0,0,1,0,0,TRUE,TRUE,TRUE,TRUE,TRUE,6,0.6643500000014901,0.48912812500074504,0.5473531249994412,0.660531249997206,0.577406250002794,0.6821586206894497,1,1,1,1,1,0.90625,0.08,0.415,0.662,0.012,1.875,17.003292732922684,1872.1908611486783,0.113,0.36,0.855,0.013,1.37,38.25317854055454,1819.936754829577,0.232,0.28,0.624,0.169,1.24,303.92918248043185,2091.054309674945,156.25,105.3846153846154,7.337278106508875,FALSE,388,1.1496296296296296,0,1,0,0,3,FALSE
144,2022-03-18T17:17:52Z,2022-03-18T17:42:43Z,1490,1,2022-03-18T17:42:44Z,0.8999999761581421,Chrome,99.0.4844.74,Macintosh,1440,900,No,1.6,623,292,286,133,31,64,-0.11279815590438978,0.9613667271529256,-0.4553587970550276,0.43018845386540083,-0.6129431920601515,-0.38862630265093906,3,3,1,1,3,1,1,3,1,3,3,1,1,1,3,3,1,1,3,3,0.512989176042577,0,0,3,3,3,2,0,1,1,1,1,1,1,1,1,1,1,1,1,2,1,1,1,2,1,1,1,1,1,1,1,2,0,0,0,0,1,1,1,1,1,1,1,1,1,1,1,1,1,1,1,1,1,1,1,1,1,1,1,1,1,2,1,1,1,1,1,1,1,1,1,1,1,1,1,1,1,1.9521298140264163,2.016597794967223,1.125,0,1,0,1.0666666666666667,0,1,0,1,0,1.1666666666666667,0,1,0,1,0,1.027027027027027,0,1,0,0,-1.3379447669771907,-1.4922696750908322,-0.39960647100849406,-0.9459380730496632,1,1,2,1,1,1,1,1,1,1.7320508075688772,1.1428571428571428,0,1,-0.874984074548163,5,5,5,5,3,3,5,8,6,6,4,1.5735915849388864,7,4.428571428571429,0,1.384971609293624,0,1.3763877392172197,1,1,1,2,2,5,4,5,5,1,5,3,5,4,5,5,5,5,5,3,1.7265434778633235,1.4,0,4.6,0,4,0,4.4,0,4.333333333333333,0,1,1,1,1,1,1,1,1,1,1,1,1,1,1,1,1,1,1,1,1,1.231174022502185,1,0,I lived with my mother and father an equal amount of time (joint custody),0,"Asian or Asian American (e.g., Chinese, Japanese, and others)",0,26,1,2,NA,1,4,6,social media and marketing manager,6,140,63,2,5,2,0,0,1,0,0,TRUE,TRUE,TRUE,TRUE,TRUE,3,0.613815625000163,0.5221437500003958,0.5538124999996508,0.7462999999996973,0.5947967741937648,0.6714903225806211,1,1,1,1,1,0.96875,0.104,0.335,0.503,0.015,1.949,43.41438990100045,1865.9846179855992,0.12,0.341,0.665,0.009,1.078,19.91218578251396,1801.9179395431916,0.122,0.361,0.495,0.013,1.73,71.95895036947302,1854.531102511561,129.93333333333334,119.7777777777778,133.0769230769231,FALSE,436,1.2918518518518518,0,1,0,0,3,FALSE
145,2022-03-18T17:25:45Z,2022-03-18T17:43:50Z,1085,1,2022-03-18T17:43:51Z,0.8999999761581421,Chrome,99.0.4844.51,Windows NT 10.0,1920,1080,"My parents were very toxic and controlling. They sometimes smashed things like game consoles and they didn't buy me things that other kids at school had; I didn't have cable, internet, the same clothes that other kids wore, the same toys that other kids wore. They grew up in poverty in a communist country and didn't understand what a 'normal' upbringing in the Western world was like. So, although I had more money than other kids at school on paper, nobody wanted to come to my house as a kid and I felt poor.",1.7777777777777777,559,94,215,41,26,45,-0.2443885413024445,-0.13194089907116932,-0.7133209370204145,-0.704416806454313,-0.7154725481090718,-0.6021525313930762,2,3,2,3,3,3,3,2,2,2,2,3,2,2,2,3,3,2,2,2,0.5026246899500346,0,0,3,4,4,2.4,0,3,3,2,2,2,3,4,3,2,2,5,5,1,4,4,3,2,1,1,4,4,3,5,5,1,1,0,1,0,2,2,4,2,2,2,1,1,1,3,3,5,3,3,3,2,2,3,5,5,5,2,1,1,1,3,1,1,3,3,3,3,3,3,1,1,5,2,1,2,2,1.3710871160797478,1.0600988273786194,2.875,0,1.75,0,3,0,1.8888888888888888,0,3.5,0,1.5,0,2.7142857142857144,0,2.3333333333333335,0,2.5405405405405403,0,3,0,0,0.780695564805519,0.7766762008052794,0.297577848406135,0.5371270246057072,2,2,2,3,1,1,3,4,5,1.2724180205607036,2,0,4.5,0.9764383149804601,5,5,5,5,2,2,4,8,8,5,4,1.6035674514745464,8,4,0,1.351776111874911,0,1.1239606840590473,2,2,2,1,3,3,5,4,4,3,4,4,4,4,4,5,4,5,4,3,1.2227992865708155,2,0,4,0,4.2,0,3.8,0,4,0,4,4,4,2,4,4,4,2,3,2,4,2,3,3,3,2,1,4,3,4,0.8013147091860318,3.1,0,NA,NA,"Asian or Asian American (e.g., Chinese, Japanese, and others)",0,27,0,1,NA,1,4,4,Gig Worker,6,130,65,3,5,2,0,0,1,0,0,TRUE,TRUE,TRUE,TRUE,TRUE,3,0.4898937499932945,0.4533437499962747,0.5061593749858438,0.5930093749985099,0.5326066666762034,0.5726437500268221,1,1,1,1,0.9375,1,0.074,0.387,0.673,0.017,1.53,74.36761665022404,1855.094440834441,0.053,0.38,0.748,0.019,1.704,61.08723187664557,1910.8274489311696,0.102,0.366,0.837,0.016,1.771,32.7110220475876,1812.5110458413253,90,89.6842105263158,110.68749999999999,FALSE,322,0.9540740740740741,0,1,0,0,3,FALSE
146,2022-03-18T17:28:09Z,2022-03-18T17:44:37Z,988,1,2022-03-18T17:44:38Z,0.8999999761581421,Chrome,99.0.4844.74,Macintosh,1440,900,NA,1.6,452,62,232,69,46,80,-0.46439121688981727,-0.3086370810871847,-0.6515553542118008,-0.3591021620091827,-0.3053551239133906,-0.20881474160492883,3,1,1,2,2,1,1,3,1,1,3,2,1,1,2,2,3,1,3,3,0.998683343734455,0,0,1,3,2,1.85,0,1,1,1,1,1,1,1,1,1,1,1,1,1,1,1,1,1,1,1,1,1,1,1,0,2,0,0,0,0,1,1,1,1,1,1,1,1,1,1,1,1,1,1,1,1,1,1,1,1,2,1,1,1,1,3,1,1,1,1,1,1,2,1,1,1,1,1,1,1,1,1.9199443185119163,2.065591117977289,1,0,1,0,1,0,1,0,1.0833333333333333,0,1.3333333333333333,0,1.1428571428571428,0,1,0,1.1081081081081081,0,0,0,0,-1.3664564898686766,-1.5405513958616124,-0.6189692744445258,-1.0797603351530691,1,1,1,1,1,1,1,1,1,1.9518001458970664,1,0,1,-0.9579186615539372,5,5,5,5,4,3,5,6,8,5,4,1.5275252316519468,7,4.571428571428571,0,1.1711463069637928,0,1.3235516646821082,1,2,1,1,1,5,5,4,4,2,5,5,4,5,4,4,5,5,4,5,1.65615734242165,1.2,0,5,0,3.8,0,4.4,0,4.4,0,2,1,3,3,1,4,2,4,2,3,4,3,1,2,1,2,1,2,1,3,0.998683343734455,2.25,0,I lived with my mother and father an equal amount of time (joint custody),0,"White, Caucasian, Anglo, European American",0,28,1,2,NA,1,4,6,Unemployed,5,140,63,3,5,2,0,0,0,0,0,TRUE,TRUE,TRUE,TRUE,TRUE,4,0.478858064516117,0.4338781250000029,0.46277187500000583,0.5670799999999969,0.5363333333333411,0.5801499999999875,0.96875,1,1,0.9375,0.9375,0.8387096774193549,0.058,0.365,0.605,0.011,1.515,99.18851593457583,1962.2066122731765,0.063,0.36,0.848,0.02,2.024,88.84101542745776,1943.2275632815201,0.074,0.363,0.748,0.015,1.848,207.6552698634449,2107.453928997632,137.72727272727272,101.2,123.20000000000002,FALSE,436,1.2918518518518518,0,1,0,3,6,FALSE
147,2022-03-18T17:18:31Z,2022-03-18T17:44:59Z,1587,1,2022-03-18T17:45:00Z,1,Firefox,98.0,Windows NT 10.0,1536,864,N/A,1.7777777777777777,602,86,544,160,47,80,-0.1559762511131265,-0.17611494457517315,0.4820247538051112,0.7631704324374907,-0.28484925270360656,-0.20881474160492883,1,1,1,1,1,1,1,1,1,1,1,1,1,1,1,1,1,1,1,1,1.538967528127731,0,1,1,5,5,1,0,1,1,1,1,1,1,1,1,2,1,1,1,1,1,2,1,1,5,1,1,1,1,1,2,2,0,0,0,0,1,4,1,1,1,4,2,2,3,2,1,2,1,3,2,1,1,1,1,2,2,3,1,1,3,1,1,2,2,2,1,1,1,2,1,1,1,2,2,2,2,1.5007505629691607,1.9591057240729093,1.5,0,2,0,1.1333333333333333,0,2.111111111111111,0,1.5833333333333333,0,1.6666666666666667,0,1.5714285714285714,0,1,0,1.6756756756756757,0,1,0,0,-0.6734023026602539,-1.0162374749862522,-0.05499485428507328,-0.5356161646356628,1,1,2,2,1,1,1,2,2,1.6761634196950514,1.2857142857142858,0,2,-0.40524523968696646,5,5,5,5,2,2,5,5,5,3,3,1.8126539343499315,5,4.142857142857143,0,0.03902547546461973,0,0.40178071033089585,3,1,3,2,3,3,3,2,4,1,5,3,3,5,5,4,5,4,3,1,1.4074631010979937,2.4,0,4,0,2.8,0,3.4,0,3.4,0,1,1,1,1,1,1,1,1,1,1,1,1,1,1,1,1,1,1,1,1,1.231174022502185,1,0,I lived with my mother and father an equal amount of time (joint custody),0,"White, Caucasian, Anglo, European American",0,27,0,1,NA,1,2,4,Retail Associate,1,180,75,2,5,2,0,0,1,0,0,TRUE,TRUE,TRUE,TRUE,TRUE,6,0.6797096774193548,0.541,0.6417419354838709,0.7123125,0.6019375,0.768625,1,1,1,1,1,1,0.115,0.29,0.339,0.018,1.817,43.95690246001431,1826.2279139651125,0.146,0.279,0.578,0.022,1.88,38.90216460754887,1822.4455592188058,0.192,0.282,0.506,0.029,1.369,118.4166101427298,1898.896153077147,100.94444444444444,85.45454545454545,47.206896551724135,FALSE,393,1.1644444444444444,0,1,0,0,3,FALSE
148,2022-03-18T17:13:12Z,2022-03-18T17:46:54Z,2021,1,2022-03-18T17:46:56Z,1,Firefox,98.0,Windows NT 10.0,2144,1206,NA,1.7777777777777777,888,131,625,128,53,120,0.43206828363443056,0.0723640613848484,0.776319589540271,0.368525124500199,-0.1618140254449022,0.2407141610100968,2,2,1,1,2,1,1,3,1,2,4,1,1,2,2,2,1,1,2,2,0.9679060415469871,0,1,2,3,3,1.7,0,5,5,5,4,3,4,5,4,3,3,4,5,3,5,3,3,3,1,2,2,3,3,2,2,2,0,0,0,0,3,5,3,5,5,4,3,4,4,3,3,3,1,3,3,3,5,3,2,2,3,3,2,2,1,3,2,2,3,2,1,4,2,2,2,3,2,3,3,4,4,0.8516015648325367,1.3522468075656264,2.375,0,3.5,0,4.066666666666666,0,4,0,2.8333333333333335,0,2.1666666666666665,0,2.2857142857142856,0,2.3333333333333335,0,2.864864864864865,0,1,0,0,0.6666486732395762,1.1656833033902243,0.46192257080005794,0.8138029370951412,3,3,5,3,2,3,2,1,2,0.7867957924694432,3,0,1.5,0.39656768045461255,2,3,2,1,1,1,2,3,1,1,2,1.1547005383792515,2,1.7142857142857142,0,-1.2737251609456715,0,-1.7136474177294443,3,2,3,3,3,4,1,4,5,1,4,2,3,3,3,5,3,5,4,4,0.9611501047232549,2.8,0,3.6,0,2.8,0,3.8,0,3.4,0,2,1,1,1,2,1,1,2,1,1,2,2,1,1,1,1,1,1,1,1,1.0399898784932577,1.25,0,I lived with my mother and father an equal amount of time (joint custody),0,Prefer not to say,0,29,0,1,NA,1,2,3,customer service worker,2,280,67,1,5,2,0,0,3,0,0,TRUE,TRUE,TRUE,TRUE,TRUE,3,0.6332258064516129,0.4738125,0.541125,0.62103125,0.5006333333333334,0.6092333333333333,1,1,1,1,0.9375,0.9375,0.076,0.317,0.36,0.009,1.286,118.01520136504394,1981.5113971883168,0.043,0.389,0.494,0.056,1.756,69.83448618597885,1920.656511564814,0.099,0.356,0.414,0.048,1.551,12.160300571333687,1792.131226026309,142.88888888888891,31.357142857142858,32.3125,FALSE,546,1.6177777777777778,0,1,0,0,3,FALSE
149,2022-03-18T17:27:54Z,2022-03-18T17:47:09Z,1154,1,2022-03-18T17:47:10Z,0.8999999761581421,Chrome,99.0.4844.51,Windows NT 10.0,1920,1080,NA,1.7777777777777777,489,70,309,62,45,72,-0.3883155253315669,-0.26446303558318085,-0.3717935967845501,-0.4454308231204653,-0.3258609951231747,-0.29872052212793393,3,2,1,2,2,1,1,3,1,2,2,1,1,2,2,3,1,1,3,3,0.812727700887249,0,0,5,2,2,1.85,0,4,2,3,2,3,2,3,3,3,4,3,4,3,4,2,2,2,1,1,1,3,3,2,0,2,0,0,0,0,3,2,2,2,2,1,2,2,2,1,4,4,1,5,2,3,1,1,2,5,5,4,1,1,1,1,1,1,1,3,1,2,1,2,1,1,1,1,1,1,2,1.4760347823404023,0.7559289460184544,1.875,0,1.25,0,3,0,2,0,2.8333333333333335,0,1.5,0,1.5714285714285714,0,1,0,2.027027027027027,0,0,0,0,-0.2018622702241433,0.11587546031720362,-0.5328163702636706,-0.20847045497323347,3,2,3,3,2,4,3,4,4,0.6900655593423543,2.857142857142857,0,4,1.280643713087394,4,5,5,4,3,3,5,8,7,5,4,1.3972762620115438,7.5,4.142857142857143,0,1.2614612094193518,0,1.146353499129901,4,4,4,3,4,2,2,3,2,3,2,2,4,1,2,4,1,3,4,3,1.0465362369445672,3.8,0,2,0,3.4,0,2.2,0,2.533333333333333,0,2,1,2,3,2,3,4,3,2,1,3,4,2,3,1,4,1,1,1,3,0.9119095061289915,2.3,0,I lived with my mother and father an equal amount of time (joint custody),0,Filipino & Middle Eastern,1,30,0,1,NA,0,4,6,Software Engineer,3,145,68,4,5,2,0,0,1,0,0,TRUE,TRUE,TRUE,TRUE,TRUE,2,0.5941812500059604,0.5362437499947846,0.5492937499955296,0.6790031250044704,0.6329781249985099,0.6626838709731255,1,1,1,1,1,0.96875,0.067,0.438,0.609,0.004,0.968,88.38557410459751,1916.06129343131,0.141,0.374,0.853,0.008,1.141,60.48018439975117,1842.7978958230153,0.233,0.291,0.772,0.015,1.532,40.89883791294369,1824.033097924173,242,142.625,102.13333333333334,TRUE,440,1.3037037037037038,0,1,0,3,6,FALSE
150,2022-03-18T17:28:46Z,2022-03-18T17:47:22Z,1115,1,2022-03-18T17:47:23Z,0.8999999761581421,Chrome,99.0.4844.74,Macintosh,1440,900,No,1.6,587,47,221,30,74,56,-0.18681774769079557,-0.39146341640719184,-0.6915213195585509,-0.840076131057757,0.268809269960563,-0.4785320831739442,2,3,3,2,3,2,2,2,2,2,3,2,3,3,3,3,3,4,3,3,0.6048053188292994,0,1,1,3,3,2.65,0,4,3,3,2,3,4,2,3,3,4,5,2,3,3,2,1,2,2,1,1,1,1,1,1,2,0,0,0,0,2,3,2,2,3,3,2,3,3,4,3,3,4,2,3,3,2,4,3,3,3,2,4,4,3,3,3,3,4,2,3,4,3,2,2,2,2,3,3,3,3,0.7134486730024866,0.7432233529572065,1.25,0,3,0,3.066666666666667,0,2.5555555555555554,0,3.0833333333333335,0,3.1666666666666665,0,3,0,2,0,2.864864864864865,0,1,0,0,-0.06369007467309709,0.23790726373174273,0.28961676243834755,0.26376201308504515,2,2,2,4,4,4,4,8,4,0.7559289460184544,3.142857142857143,0,6,2.2201213828097868,3,3,3,4,3,3,3,6,4,4,4,0.3779644730092272,5,3.142857142857143,0,0.5960613948117253,0,0.1992467218202532,3,3,3,3,3,2,3,3,3,3,3,4,3,2,3,2,3,2,3,2,0.5936168397046637,3,0,2.8,0,2.8,0,2.6,0,2.7333333333333334,0,3,4,3,3,3,3,3,3,2,3,3,3,2,2,3,2,2,2,2,2,0.6048053188292994,2.65,0,I lived with my mother and father an equal amount of time (joint custody),0,"White, Caucasian, Anglo, European American",0,29,0,1,NA,1,3,6,Marketing,3,210,75,3,5,2,0,0,2,0,0,TRUE,TRUE,TRUE,TRUE,TRUE,4,0.7700645161280709,0.8369749999996274,0.8194620689672643,0.8549482758605275,0.7947379310346883,0.98972857142772,1,1,1,0.90625,0.9666666666666667,0.9655172413793104,0.093,0.326,0.185,0.139,1.329,320.1540002473963,2158.7933892100705,0.08,0.299,0.193,0.095,1.023,588.062272198809,2419.1017738479677,0.07,0.373,0.213,0.013,1.68,243.56127238045877,2132.5184770051524,9.561151079136689,10.768421052631577,129.23076923076923,FALSE,304,0.9007407407407407,1,1,0,0,3,FALSE
151,2022-03-18T17:24:40Z,2022-03-18T17:48:03Z,1403,1,2022-03-18T17:48:04Z,0.8999999761581421,Chrome,99.0.4844.74,Windows NT 10.0,1600,900,NA,1.7777777777777777,773,95,247,55,40,123,0.19561680987230096,-0.12641914338316884,-0.5970563105571416,-0.5317594842317478,-0.42839035117209495,0.2744288287062237,3,3,2,2,3,1,3,4,1,3,3,2,2,3,3,3,2,1,4,3,0.5871429486123998,0,1,2,3,3,2.55,0,4,3,3,4,3,2,4,3,3,2,3,5,1,4,3,3,3,1,1,3,3,2,3,0,2,0,0,0,0,3,5,4,4,4,4,4,4,4,1,3,3,1,4,3,4,3,3,3,3,3,4,1,1,1,3,2,1,1,2,1,4,3,3,1,3,2,2,2,1,2,0.79506737584442,0.7237468644557459,2.375,0,1.75,0,3.1333333333333333,0,4,0,2.8333333333333335,0,2,0,2.142857142857143,0,2,0,2.7837837837837838,0,0,0,0,0.6140116463629873,0.7227894737535733,-0.3605105619019602,0.18113945592580655,2,1,4,1,1,1,1,1,1,1.1338934190276817,1.5714285714285714,0,1,-0.6261803135308405,3,3,3,3,1,1,3,3,5,2,2,0.9759000729485332,4,2.4285714285714284,0,-0.698640248793604,0,-0.9763558510709751,2,2,2,2,2,4,4,4,4,3,4,4,4,4,4,4,4,4,4,3,0.9611501047232549,2,0,4,0,3.8,0,3.8,0,3.8666666666666667,0,2,2,2,3,3,2,3,3,2,1,2,3,3,3,1,3,1,2,2,3,0.6407232755171874,2.3,0,I lived with my mother and father an equal amount of time (joint custody),0,"White, Caucasian, Anglo, European American",0,27,1,2,NA,1,3,8,Psychologist,3,103,60,3,5,2,0,0,1,0,0,TRUE,TRUE,TRUE,TRUE,TRUE,4,0.5177374999994645,0.4862593750002561,0.4846593749995809,0.5535843749997439,0.5234354838713283,0.551510000000149,1,1,1,1,0.96875,0.967741935483871,0.068,0.341,0.526,0.024,2.088,46.948698829607196,1873.7981625987,0.063,0.352,0.505,0.012,1.154,35.88254786149561,1860.9952841421225,0.107,0.353,0.686,0.04,1.831,25.648999701674185,1807.7080378914518,87,96.16666666666666,45.775,FALSE,323,0.9570370370370371,0,1,0,9,12,FALSE
152,2022-03-18T17:22:01Z,2022-03-18T17:48:09Z,1567,1,2022-03-18T17:48:10Z,0.8999999761581421,Chrome,99.0.4844.74,Windows NT 10.0,2560,1440,Thanks for the survey,1.7777777777777777,433,102,179,50,24,718,-0.5034571125548648,-0.0877668535671655,-0.8441186417915967,-0.5934228135969497,-0.7564842905286399,6.96117125510473,1,1,1,1,1,1,1,1,1,1,1,1,1,1,1,1,1,4,1,1,1.5312533566021211,0,0,2,5,5,1.15,0,1,1,1,1,1,1,1,1,1,1,1,1,1,1,5,1,1,1,1,1,1,1,1,1,2,0,0,0,0,2,3,1,1,1,1,1,1,1,1,1,1,1,1,1,1,1,1,1,1,1,1,1,1,1,1,2,1,3,2,1,1,1,1,1,1,1,2,1,1,1,1.849843756083719,2.02837021134844,1,0,1.25,0,1.2666666666666666,0,1.3333333333333333,0,1,0,1.1666666666666667,0,1.4285714285714286,0,1,0,1.1891891891891893,0,1,0,0,-1.3138194629920872,-1.3887245590589952,-0.31345356682763886,-0.851089062943317,1,1,3,1,1,1,1,1,1,1.5735915849388864,1.2857142857142858,0,1,-0.7920494875423887,4,5,5,5,1,1,4,3,3,3,3,1.889822365046136,3,3.5714285714285716,0,-0.3222341343576166,0,-0.12786943131110795,1,1,1,1,1,5,3,5,5,2,5,1,5,3,3,3,5,4,2,4,1.162919151265879,1,0,4,0,3,0,4,0,3.6666666666666665,0,1,1,1,1,1,1,1,1,1,1,1,1,1,1,1,1,1,1,1,1,1.231174022502185,1,0,I lived with my mother and father an equal amount of time (joint custody),0,"White, Caucasian, Anglo, European American",0,29,0,1,NA,1,3,5,Unemployed,3,170,71,2,5,2,0,0,1,0,0,TRUE,TRUE,TRUE,TRUE,TRUE,1,0.5175354838709652,0.440593548387105,0.48853750000000035,0.6418741935483901,0.4964343750000062,0.5650374999999994,0.96875,0.96875,1,0.96875,1,1,0.086,0.316,0.509,0.028,1.917,32.98622885680016,1814.9598525399979,0.05,0.352,0.59,0.026,1.708,153.24297424554067,1993.2247143230525,0.099,0.32,0.519,0.014,1.932,185.18033428147982,2046.85957508513,68.46428571428571,65.6923076923077,138,FALSE,304,0.9007407407407407,1,1,0,0,3,FALSE
153,2022-03-18T17:28:58Z,2022-03-18T17:49:09Z,1210,1,2022-03-18T17:49:10Z,1,Chrome,96.0.4664.110,Macintosh,1440,900,N/A,1.6,508,150,280,82,46,90,-0.34924962966651935,0.17727741945685752,-0.4771584145168912,-0.1987775056596579,-0.3053551239133906,-0.09643251595117242,4,2,2,2,4,1,2,4,1,4,4,2,1,2,4,3,2,1,4,4,0.6048053188292994,0,0,2,2,2,2.65,0,1,1,2,1,2,1,1,1,1,1,1,2,1,2,1,1,1,1,1,1,1,1,1,2,2,0,0,0,0,1,1,1,1,3,1,1,1,1,2,1,1,1,1,1,1,2,1,1,1,1,1,1,1,1,2,1,1,2,2,1,1,1,1,1,1,1,1,1,2,2,1.8478134143940006,1.8464895909600492,1,0,1.5,0,1.2666666666666666,0,1.2222222222222223,0,1.1666666666666667,0,1.1666666666666667,0,1.2857142857142858,0,1,0,1.1891891891891893,0,1,0,0,-1.3138194629920872,-1.3887245590589952,-0.22730066264678367,-0.8080126108528894,2,2,3,1,1,2,1,1,1,1.1547005383792515,1.7142857142857142,0,1,-0.5432457265250663,5,5,5,5,2,2,4,8,7,6,4,1.6035674514745464,7.5,4,0,1.475286511749183,0,1.199189573665012,2,3,2,4,2,4,4,4,4,3,5,4,4,4,4,4,4,4,3,3,1.01418510567422,2.6,0,4.2,0,3.6,0,3.8,0,3.8666666666666667,0,1,1,1,1,2,1,2,2,1,1,3,2,1,1,1,2,1,1,1,2,0.9787209698591858,1.4,0,I lived with my mother and father an equal amount of time (joint custody),0,"White, Caucasian, Anglo, European American",0,26,1,2,NA,1,4,6,Business Manager,6,130,66,3,5,2,0,0,1,0,0,TRUE,TRUE,TRUE,TRUE,TRUE,4,0.6068187500163913,0.5599612903210425,0.5722468750104308,0.8312366666555404,0.6034928571156093,0.6699499999920527,1,0.96875,1,0.9375,0.9333333333333333,0.967741935483871,0.076,0.395,0.472,0.016,1.848,54.577482521537846,1879.6265801005686,0.052,0.433,0.447,0.027,1.979,149.77423430581075,2049.5390864411975,0.092,0.38,0.406,0.009,1.82,155.5012259490936,2026.790354564145,115.5,73.2962962962963,202.22222222222226,TRUE,438,1.2977777777777777,0,1,0,0,3,FALSE
154,2022-03-18T17:20:34Z,2022-03-18T17:49:19Z,1724,1,2022-03-18T17:49:20Z,0.8999999761581421,Chrome,99.0.4844.51,Windows NT 10.0,1536,864,"I find it funny that 13 is your cutoff point for questions because 13 was the start of The Terrible Era of my life with a decent amount of trauma, abuse, uncertainty, and insecurity. My life before 13 feels like an entirely different person than I am now.
Also - I was homeschooled K-12, so that somewhat affected how I responded to questions about school.",1.7777777777777777,869,89,321,72,41,67,0.3930023879693831,-0.15954967751117172,-0.3281943618608227,-0.3221041643900616,-0.40788447996231086,-0.35491163495481215,2,2,2,1,2,2,2,2,1,2,3,1,1,1,2,2,2,1,3,2,0.8522416262267903,0,1,1,2,1,1.8,0,4,2,2,2,2,1,3,1,2,1,1,1,1,2,4,2,1,2,1,1,2,2,1,2,2,0,0,0,0,4,3,1,2,2,1,1,1,1,1,1,2,1,2,3,2,4,2,2,2,3,2,1,1,1,1,1,1,2,1,1,2,3,2,1,1,2,2,2,2,1,1.513205138039714,1.3451854182690985,1.5,0,1.75,0,1.9333333333333333,0,1.7777777777777777,0,2.0833333333333335,0,1.1666666666666667,0,1.7142857142857142,0,1.3333333333333333,0,1.7297297297297298,0,1,0,0,-0.6383109514091944,-0.6433570571394092,-0.14114775846592847,-0.3922524078026688,1,2,3,1,1,1,1,1,1,1.5275252316519468,1.4285714285714286,0,1,-0.7091149005366146,5,5,5,5,3,2,5,6,4,3,3,1.7043362064926932,5,4.285714285714286,0,0.03902547546461973,0,0.47918338557157275,2,3,2,1,2,4,5,5,5,3,5,5,5,3,5,4,5,5,4,3,1.65615734242165,2,0,4.8,0,4.2,0,4.2,0,4.4,0,3,4,2,3,2,2,4,3,2,2,4,2,3,2,1,2,2,2,1,2,0.8825799501580878,2.4,0,I lived with my mother and father an equal amount of time (joint custody),0,"White, Caucasian, Anglo, European American",0,28,1,3,NA,1,2,6,operations coordinator,2,165,64,1,5,2,1,0,1,0,1,TRUE,TRUE,TRUE,TRUE,TRUE,6,0.5445624999925495,0.4924593749940395,0.4994937499910593,0.588790000017484,0.5455062500014901,0.5642499999920527,1,1,1,0.9375,1,0.9375,0.067,0.367,0.528,0.015,1.537,65.951653654513,1910.4763774252851,0.069,0.372,0.575,0.041,1.812,81.92619934288982,1876.6626004542716,0.07,0.344,0.392,0.019,1.84,98.64427957923488,1942.3614526884612,102.46666666666667,44.19512195121951,96.8421052631579,FALSE,220,0.6518518518518519,0,1,0,3,6,FALSE
155,2022-03-18T17:24:24Z,2022-03-18T17:50:04Z,1540,1,2022-03-18T17:50:05Z,0.8999999761581421,Chrome,99.0.4844.51,Macintosh,1512,982,"There were instructions during the flanker game that displayed examples of the arrows, however, since pushing any key moved on to the next section, I missed the first set of changed instructions since I saw the arrow display and clicked the right arrow thinking it was still apart of the test. I reacted too fast to the direction of the arrow before realizing there were written instructions on the page. It may be good to have to push the spacebar or something specific instead of any key so reactions to the arrows don't cause direction bypass.",1.539714867617108,654,75,334,69,54,91,-0.04905906297720703,-0.23685425714317843,-0.28096185736011803,-0.3591021620091827,-0.14130815423511814,-0.08519429338579677,3,3,2,2,4,1,1,3,1,4,4,1,3,1,4,3,1,1,3,3,0.6069769786668839,0,1,1,3,3,2.4,0,1,1,3,2,2,2,1,2,2,1,1,3,2,2,2,2,1,1,1,1,2,1,1,1,2,0,0,0,0,2,1,1,1,1,1,1,1,1,1,2,1,1,3,1,1,1,1,1,1,2,1,1,1,1,2,1,1,2,2,1,1,1,1,1,1,1,2,2,2,2,1.8046486518867757,1.4142135623730951,1.25,0,2,0,1.8,0,1.1111111111111112,0,1.3333333333333333,0,1.1666666666666667,0,1.2857142857142858,0,1,0,1.2162162162162162,0,1,0,0,-1.133976287830408,-1.0349208292560044,-0.05499485428507328,-0.5449578417705389,1,1,1,1,1,1,2,1,1,1.889822365046136,1.1428571428571428,0,1,-0.874984074548163,4,5,5,4,2,2,5,7,6,4,3,1.6035674514745464,6.5,3.857142857142857,0,0.5237954851611282,0,0.5422436901348013,1,1,1,1,1,5,4,5,5,3,5,5,5,3,5,5,5,5,2,5,1.6761634196950514,1,0,5,0,3.8,0,4.6,0,4.466666666666667,0,1,2,2,4,1,2,3,4,2,1,3,2,1,3,1,4,1,2,2,2,0.7863975156570492,2.15,0,I lived with my mother and father an equal amount of time (joint custody),0,"Asian or Asian American (e.g., Chinese, Japanese, and others) & White, Caucasian, Anglo, European American",1,19,1,2,NA,1,4,4,Sales Associate,6,158,66,3,5,2,0,0,1,0,0,TRUE,TRUE,TRUE,TRUE,TRUE,3,0.5367374999970198,0.5312499999990686,0.5357750000013038,0.6118870967741935,0.6016343750003725,0.669045161285708,1,1,1,0.96875,1,0.96875,0.079,0.358,0.463,0.01,1.522,68.14977605858495,1891.5505631490344,0.105,0.323,0.521,0.025,1.868,42.00205023666617,1826.548470233463,0.082,0.337,0.427,0.019,1.916,26.686507127454576,1849.1778783012037,152.2,74.72,100.84210526315789,FALSE,436,1.2918518518518518,0,1,0,0,3,FALSE
156,2022-03-18T17:32:46Z,2022-03-18T17:50:06Z,1040,1,2022-03-18T17:50:09Z,0.8999999761581421,Safari,13.1.2,Macintosh,1440,900,None,1.6,441,163,234,47,36,64,-0.4870083143801079,0.24906024340086375,-0.6442888150578462,-0.6304208112160707,-0.5104138360112311,-0.38862630265093906,2,2,2,4,2,2,2,3,1,3,3,1,1,2,2,2,2,1,2,2,0.8506963092234007,0,1,2,3,3,2.05,0,3,3,4,3,3,3,3,3,3,3,3,3,4,3,3,2,1,1,1,1,1,2,1,0,2,0,0,0,0,3,3,3,3,4,2,3,3,3,4,2,1,1,2,1,2,2,1,1,1,2,2,1,1,1,1,1,1,1,1,1,2,1,2,2,3,1,1,1,2,2,1.20559257357262,0.3518657752744984,1.25,0,1.5,0,3.1333333333333333,0,3,0,1.6666666666666667,0,1.1666666666666667,0,1.2857142857142858,0,2,0,1.864864864864865,0,0,0,0,-0.7128800728176956,-0.16958652623590453,-0.4466634660828154,-0.30812499615935995,2,2,4,3,2,3,3,3,2,0.7559289460184544,2.7142857142857144,0,2.5,0.6175027542984864,3,3,3,3,2,2,3,4,4,3,3,0.4879500364742666,4,2.7142857142857144,0,-0.14160432944649845,0,-0.48226576241552316,2,3,3,2,2,4,3,3,4,3,4,3,3,3,3,3,3,3,3,3,0.4140393356054125,2.4,0,3.4,0,3,0,3.2,0,3.2,0,2,1,2,3,2,1,2,2,2,1,1,2,3,1,1,2,1,2,1,3,0.812727700887249,1.75,0,"I lived with my mother, but not father, most of the time.",0,"White, Caucasian, Anglo, European American",0,30,0,1,NA,1,3,6,operations manager,5,185,74,4,5,2,0,0,1,0,0,TRUE,TRUE,TRUE,TRUE,TRUE,5,0.6422903225806454,0.4211612903225769,0.46550000000000363,0.6453000000000018,0.5329677419354858,0.5595555555555501,1,1,1,0.9375,0.96875,0.84375,0.05,0.389,0.73,0.009,1.314,49.948157068464425,1925.0115979910743,0.061,0.357,0.876,0.012,1.465,121.30089553006752,1957.4138778699319,0.068,0.354,0.244,0.026,1.834,160.82929362099682,2023.3519727562546,146.00000000000003,122.08333333333334,70.53846153846155,FALSE,304,0.9007407407407407,1,1,0,0,3,FALSE
157,2022-03-18T17:15:16Z,2022-03-18T17:50:09Z,2093,1,2022-03-18T17:50:10Z,1,Chrome,98.0.4758.102,Windows NT 10.0,1920,1080,Nope! All good.,1.7777777777777777,634,606,383,163,181,72,-0.09018105841409914,2.695198013185076,-0.10293164808823121,0.8001684300566119,2.462937489407457,-0.29872052212793393,2,2,1,1,2,1,1,2,1,2,3,1,1,1,2,2,1,1,2,2,0.998683343734455,0,0,1,3,3,1.55,0,1,2,4,1,5,4,1,3,2,1,1,1,2,3,1,1,2,1,1,1,1,3,1,1,2,0,0,0,0,1,1,1,1,1,1,1,1,1,2,1,1,1,1,2,1,3,1,1,2,3,1,1,1,1,2,1,1,2,1,1,2,3,3,1,1,1,1,1,1,1,1.7719028301912156,1.5023790657297036,1.375,0,1,0,2.1333333333333333,0,1,0,1.5833333333333333,0,1.1666666666666667,0,1.8571428571428572,0,1,0,1.3783783783783783,0,1,0,0,-0.9475534843091554,-0.764012192344598,-0.39960647100849406,-0.581809331676546,1,1,1,1,1,1,1,1,1,1.9518001458970664,1,0,1,-0.9579186615539372,5,5,5,5,4,5,5,8,6,6,4,1.4960264830861913,7,4.857142857142857,0,1.384971609293624,0,1.6085957649392508,2,2,3,4,3,4,4,4,4,3,5,4,4,4,4,3,5,4,4,4,1.162919151265879,2.8,0,4.4,0,3.6,0,4,0,4,0,1,2,1,3,3,1,2,2,2,1,2,2,2,3,1,2,2,2,2,3,0.7591546545162482,1.95,0,I lived with my mother and father an equal amount of time (joint custody),0,"White, Caucasian, Anglo, European American",0,28,1,2,NA,1,3,7,Archivist,3,150,62,3,5,2,0,0,1,0,0,TRUE,TRUE,TRUE,TRUE,TRUE,1,0.6332874999344349,0.5187750000208616,0.5839781249761581,0.66891612908148,0.5865406250208616,0.6865624999701977,1,1,1,0.96875,1,1,0.146,0.36,0.648,0.01,1.313,13.645321705772025,1796.2418285236165,0.09,0.329,0.539,0.019,1.946,105.37117112442152,1889.448827212887,0.065,0.433,0.337,0.027,1.79,127.7944393228552,1951.3903339113997,131.29999999999998,102.42105263157895,66.2962962962963,FALSE,302,0.8948148148148148,0,1,0,0,3,FALSE
158,2022-03-18T17:31:36Z,2022-03-18T17:51:41Z,1205,1,2022-03-18T17:51:42Z,1,Chrome,98.0.4758.109,Macintosh,1440,900,no comments,1.6,530,91,347,63,37,78,-0.30401543468593806,-0.14850616613517076,-0.23372935285941338,-0.4330981572474249,-0.4899079648014471,-0.2312911867356801,3,3,3,1,3,1,1,3,1,3,3,2,1,1,3,3,1,1,3,4,0.5982430416161189,0,1,4,3,3,2.2,0,2,2,2,2,2,2,2,3,2,2,2,2,2,2,2,2,4,1,1,1,1,2,2,1,2,0,0,0,0,2,2,2,2,2,2,3,2,1,2,2,2,1,2,2,2,1,3,3,3,3,4,1,1,1,1,1,1,1,1,1,1,1,1,1,3,1,1,2,1,1,1.4062281029326207,1,1.75,0,1.25,0,2.066666666666667,0,2,0,2.1666666666666665,0,1.5,0,1,0,1.6666666666666667,0,1.7567567567567568,0,1,0,0,-0.45846777624751495,-0.4641935230368383,-0.31345356682763886,-0.3888235449322386,1,1,2,1,1,2,2,2,1,1.6035674514745464,1.4285714285714286,0,1.5,-0.5157127766089035,5,4,5,4,2,2,4,6,3,4,4,1.3972762620115438,4.5,3.7142857142857144,0,0.5057464923561662,0,0.453847562613138,2,2,2,3,2,4,4,4,4,5,4,4,4,4,4,4,5,4,4,3,1.1872336794093274,2.2,0,4.2,0,4.2,0,3.8,0,4.066666666666666,0,2,1,1,1,1,1,2,2,1,1,2,2,1,1,1,2,1,1,1,2,0.9333020044867296,1.35,0,I lived with my mother and father an equal amount of time (joint custody),0,"Asian or Asian American (e.g., Chinese, Japanese, and others) & White, Caucasian, Anglo, European American",1,28,1,2,NA,1,3,6,medical assistant supervisor,4,150,63,2,5,2,0,0,1,0,0,TRUE,TRUE,TRUE,TRUE,TRUE,5,0.6413656249949709,0.5587625000001862,0.5938781250026077,0.7347838709652423,0.6619500000009935,0.721323333332936,1,1,1,0.96875,0.9375,0.9375,0.08,0.406,0.462,0.007,1.454,51.45871475213074,1894.5299998194823,0.075,0.417,0.565,0.011,1.538,31.163761759453948,1877.611526114039,0.099,0.38,0.411,0.013,1.672,59.64842379482416,1884.3663330678428,207.7142857142857,139.81818181818184,128.6153846153846,FALSE,424,1.2562962962962962,0,1,0,0,3,FALSE
159,2022-03-18T17:36:37Z,2022-03-18T17:52:40Z,962,1,2022-03-18T17:52:40Z,1,Chrome,99.0.4844.51,Windows NT 10.0,1504,1003,NA,1.4995014955134596,497,62,224,43,35,56,-0.37186672715681,-0.3086370810871847,-0.680621510827619,-0.6797514747082323,-0.5309197072210152,-0.4785320831739442,2,2,2,2,2,1,2,2,1,2,3,2,2,2,2,2,2,2,2,2,0.6708203932499369,0,1,3,3,3,1.95,0,4,2,4,3,2,3,4,4,2,3,3,5,2,4,2,2,4,1,1,2,4,4,3,2,2,0,0,0,0,2,2,2,2,4,2,2,2,2,3,2,5,2,2,4,3,4,4,5,5,5,4,1,3,1,1,1,2,3,3,1,2,1,2,2,3,4,2,2,2,2,1.2944789205219511,0.9611501047232549,2.625,0,2,0,3.1333333333333333,0,2.2222222222222223,0,3.6666666666666665,0,1.8333333333333333,0,2,0,3,0,2.6486486486486487,0,1,0,0,0.6885807677714886,0.7729395299513293,-0.05499485428507328,0.358972337833128,2,2,3,1,1,2,2,8,8,1.0690449676496976,1.8571428571428572,0,8,2.2473185954686636,4,4,4,4,2,2,3,8,6,5,3,0.9511897312113419,7,3.2857142857142856,0,0.8279356899465183,0,0.417881599117705,2,2,3,2,3,4,4,4,5,4,5,5,4,4,5,4,4,2,4,1,1.4375905768565218,2.4,0,4,0,4,0,3.8,0,3.933333333333333,0,1,1,4,4,2,4,2,3,1,1,3,4,1,4,2,4,1,4,3,2,1.190974832912761,2.55,0,I lived with my mother and father an equal amount of time (joint custody),0,"Asian or Asian American (e.g., Chinese, Japanese, and others)",0,20,1,2,NA,1,4,4,Student,6,140,67,3,5,2,0,0,1,0,0,TRUE,TRUE,TRUE,TRUE,TRUE,1,0.565654838710062,0.5084593749986962,0.5783903225809336,0.6890310344824503,0.5805464285723865,0.6306000000010245,0.96875,1,1,0.9354838709677419,0.9032258064516129,1,0.228,0.235,0.677,0.013,1.219,40.69257823588633,1822.220493551956,0.058,0.371,0.465,0.015,1.72,121.60971673083061,1977.456651025362,0.066,0.43,0.509,0.014,1.852,124.50918244729927,2020.940450362141,93.76923076923077,114.66666666666667,132.28571428571428,FALSE,476,1.4103703703703703,0,1,0,0,3,FALSE
160,2022-03-18T17:30:13Z,2022-03-18T17:52:57Z,1363,1,2022-03-18T17:52:59Z,1,Chrome,98.0.4758.102,Windows NT 10.0,1920,1080,NA,1.7777777777777777,508,86,324,105,56,161,-0.34924962966651935,-0.17611494457517315,-0.31729455312989086,0.08487380942027054,-0.10029641181555002,0.701481286190498,1,2,2,1,2,1,3,2,1,1,4,2,1,1,2,1,2,1,3,2,1.118033988749895,0,1,1,4,4,1.75,0,2,2,2,2,2,2,2,1,2,1,1,2,4,2,2,1,1,1,1,2,2,2,3,0,2,0,0,0,0,1,3,4,2,2,1,1,1,2,1,1,1,1,3,4,1,1,1,1,1,2,1,1,1,1,3,2,2,1,1,1,1,1,1,3,4,1,2,1,1,1,1.65763317647414,1.3020130933435712,1.625,0,1.25,0,1.9333333333333333,0,1.8888888888888888,0,1.5,0,1.5,0,1.1428571428571428,0,2.6666666666666665,0,1.6216216216216217,0,0,0,0,-0.6273449041432382,-0.6359820488750333,-0.5328163702636706,-0.584399209569352,1,1,4,1,1,1,1,1,1,1.4960264830861913,1.4285714285714286,0,1,-0.7091149005366146,4,4,3,3,1,1,3,3,3,1,2,1.2535663410560174,3,2.7142857142857144,0,-1.0930953560345533,0,-1.0618089707050569,1,3,1,3,1,5,4,5,5,3,5,4,3,2,5,1,5,5,3,4,1.5796322658258457,1.8,0,4.8,0,2.8,0,4.2,0,3.933333333333333,0,1,1,3,2,2,1,2,4,3,3,3,2,2,2,2,2,1,2,2,3,0.812727700887249,2.15,0,I lived with my mother and father an equal amount of time (joint custody),0,"White, Caucasian, Anglo, European American",0,26,1,2,NA,1,2,4,Disabled,1,147,61,2,5,2,0,0,1,0,0,TRUE,TRUE,TRUE,TRUE,TRUE,6,0.5644968749955297,0.47886562503129243,0.4926531250104308,0.6495548387342883,0.5863562499880791,0.5875516129232222,1,1,1,0.96875,1,1,0.191,0.249,0.805,0.019,1.995,161.90365583449847,1945.299125649582,0.087,0.327,0.606,0.013,1.674,106.15118063960304,1889.1774928811194,0.088,0.371,0.458,0.007,1.077,91.96231985099475,1919.5931321926876,105.00000000000001,128.76923076923077,153.85714285714286,FALSE,422,1.2503703703703704,0,1,0,0,3,FALSE
161,2022-03-18T17:33:37Z,2022-03-18T17:53:35Z,1197,1,2022-03-18T17:53:35Z,1,Chrome,98.0.4758.109,Macintosh,1366,768,"No, thank you!",1.7786458333333333,496,103,299,78,61,105,-0.37392282692865464,-0.08224509787916502,-0.4081262925543229,-0.24810816915181938,0.0022329442333702625,0.07214082252946219,4,4,2,2,4,2,4,4,2,4,3,3,3,2,4,4,3,2,4,4,0.8944271909999159,0,0,1,3,3,3.2,0,2,1,2,1,2,2,1,2,2,1,1,1,2,1,2,1,1,1,1,1,1,2,1,0,2,0,0,0,0,1,1,2,1,1,1,1,1,1,1,1,1,1,1,1,1,1,1,1,1,3,1,1,1,1,2,1,1,1,1,1,2,1,2,1,1,1,1,1,1,1,1.8639942259766993,1.5976172734359604,1.125,0,1,0,1.5333333333333334,0,1.1111111111111112,0,1.1666666666666667,0,1.1666666666666667,0,1.2857142857142858,0,1,0,1.162162162162162,0,0,0,0,-1.2502163888495421,-1.2295227139920017,-0.6189692744445258,-0.9242459942182637,1,1,3,1,1,2,2,1,1,1.4638501094227998,1.5714285714285714,0,1,-0.6261803135308405,5,4,4,5,3,3,4,4,3,3,3,1.1126972805283737,3.5,4,0,-0.23191923190205752,0,0.15934845458074715,2,2,2,2,2,4,5,4,5,3,5,3,4,3,4,2,4,3,4,3,1.162919151265879,2,0,3.8,0,3.6,0,3.8,0,3.7333333333333334,0,3,3,1,3,2,1,1,1,1,2,2,2,3,1,2,1,2,2,2,2,0.9333020044867296,1.85,0,I lived with my mother and father an equal amount of time (joint custody),0,"White, Caucasian, Anglo, European American",0,28,1,2,NA,1,3,6,Strength Coach,4,144,66,4,5,2,0,0,2,0,0,TRUE,TRUE,TRUE,TRUE,TRUE,4,0.5211812500022351,0.4593500000014901,0.45197812499850987,0.5798866666674614,0.5623733333329359,0.5830666666686535,1,1,1,0.9375,0.9375,0.9375,0.08,0.32,0.632,0.015,2.075,112.6873225121467,1957.5230179213577,0.069,0.33,0.585,0.015,1.808,20.49828823329181,1864.0732759743535,0.056,0.391,0.503,0.012,1.43,113.47077245394951,1959.9763908004077,138.33333333333334,120.53333333333335,119.16666666666666,FALSE,390,1.1555555555555557,0,1,0,0,3,FALSE
162,2022-03-18T17:36:29Z,2022-03-18T17:53:55Z,1046,1,2022-03-18T17:53:56Z,1,Firefox,95.0,Macintosh,1280,800,NA,1.6,488,68,292,42,43,66,-0.39037162510341145,-0.2755065469591818,-0.43355917959316387,-0.6920841405812727,-0.36687273754274274,-0.3661498575201878,3,3,2,1,3,1,1,3,1,3,3,1,1,1,3,3,1,1,3,3,0.5104177855340404,0,0,4,4,4,2.05,0,2,2,2,2,2,2,3,2,2,2,2,3,2,3,3,2,2,1,1,1,2,1,1,1,2,0,0,0,0,3,3,3,3,3,3,3,3,3,2,3,3,2,4,2,3,2,3,4,4,4,3,1,1,1,3,2,1,3,3,1,2,2,2,1,2,2,2,2,2,2,0.9012837024557319,0.816496580927726,1.375,0,2,0,2.2666666666666666,0,3,0,3,0,1.8333333333333333,0,2,0,1.6666666666666667,0,2.5135135135135136,0,1,0,0,-0.21063510803690821,-0.2101982384117342,-0.05499485428507328,-0.13259654634840373,2,2,3,2,2,2,2,1,1,0.7867957924694432,2.142857142857143,0,1,-0.29444196550774376,4,4,4,2,1,1,3,6,6,3,3,1.3801311186847085,6,2.7142857142857144,0,0.2196552803757379,0,-0.262226321736228,4,4,4,4,4,2,4,2,2,4,4,3,4,3,3,3,3,3,3,3,0.6761234037828132,4,0,3,0,3.6,0,2.6,0,3.066666666666667,0,2,1,2,3,2,2,2,3,2,2,2,3,2,2,1,3,1,2,2,2,0.36634754853252327,2.05,0,I lived with my mother and father an equal amount of time (joint custody),0,"White, Caucasian, Anglo, European American",0,28,0,1,NA,1,2,6,dog walker,1,150,68,2,5,2,0,0,1,0,0,TRUE,TRUE,TRUE,TRUE,TRUE,6,0.4990322580645161,0.491,0.5640000000000001,0.5579642857142857,0.5514,0.6276774193548387,0.96875,1,1,0.875,0.967741935483871,0.96875,0.082,0.357,0.441,0.014,1.588,94.70906906416567,1918.2665045445742,0.066,0.355,0.528,0.027,1.945,60.348821648785375,1887.146057701193,0.05,0.375,0.435,0.016,1.769,89.87397908952533,1996.8923874559955,113.42857142857143,72.03703703703704,110.56249999999999,FALSE,387,1.1466666666666667,0,1,0,3,6,FALSE
164,2022-03-18T17:37:22Z,2022-03-18T17:56:18Z,1136,1,2022-03-18T17:56:19Z,0.8999999761581421,Chrome,100.0.4896.30,Macintosh,1536,960,NA,1.6,530,96,273,68,45,68,-0.30401543468593806,-0.12089738769516838,-0.5025913015557322,-0.37143482788222304,-0.3258609951231747,-0.3436734123894365,3,3,3,2,3,1,2,3,1,3,3,2,2,1,3,3,1,1,3,3,0.5231483637805969,0,1,1,2,2,2.3,0,2,2,2,2,2,2,2,1,2,2,4,3,3,3,2,2,3,1,1,2,3,3,1,0,2,0,0,0,0,2,2,1,1,2,1,1,1,2,2,4,1,1,1,1,3,2,1,1,2,4,2,1,1,1,2,1,1,1,3,1,2,2,2,1,1,1,2,1,1,2,1.5744773669313188,1.0327955589886444,2,0,1.5,0,2.2666666666666666,0,1.4444444444444444,0,1.9166666666666667,0,1.3333333333333333,0,1.7142857142857142,0,1,0,1.5945945945945945,0,0,0,0,-0.40144433046454353,-0.33852338221187406,-0.4466634660828154,-0.3925934241473447,1,1,3,1,1,2,1,1,1,1.5275252316519468,1.4285714285714286,0,1,-0.7091149005366146,5,5,5,5,3,3,4,7,7,6,4,1.2909944487358056,7,4.285714285714286,0,1.384971609293624,0,1.2989850639765426,1,2,2,3,1,5,5,5,5,2,5,5,3,4,5,5,5,4,5,4,1.7674302033770737,1.8,0,4.8,0,4,0,4.6,0,4.466666666666667,0,1,1,2,3,3,4,4,3,1,1,4,3,1,2,1,3,3,3,3,2,1.0563093645728086,2.4,0,I lived with my mother and father an equal amount of time (joint custody),0,"White, Caucasian, Anglo, European American",0,23,1,2,NA,1,3,6,Researcher,2,160,64,1,5,2,0,0,1,0,0,TRUE,TRUE,TRUE,TRUE,TRUE,3,0.5615031249988824,0.5062531249991152,0.514625,0.6522281250006053,0.5560250000006054,0.5880000000004967,1,1,1,1,1,0.9375,0.067,0.407,0.677,0.022,2.015,99.87009141876153,1948.1782146352648,0.154,0.292,0.724,0.026,1.555,45.499696218591886,1827.861640285447,0.101,0.417,0.735,0.014,1.6,46.545263811451605,1831.6215938332455,91.59090909090911,59.80769230769231,114.28571428571429,FALSE,384,1.1377777777777778,0,1,0,0,3,FALSE
165,2022-03-18T17:34:34Z,2022-03-18T17:57:03Z,1348,1,2022-03-18T17:57:04Z,0.8999999761581421,Chrome,98.0.4758.80,Macintosh,1440,900,NA,1.6,496,80,465,87,62,82,-0.37392282692865464,-0.20924547870317603,0.1949964572239059,-0.13711417629445607,0.02273881544315432,-0.18633829647417754,3,2,2,2,3,2,3,3,1,2,2,2,2,2,3,2,2,1,3,3,0.5871429486123998,0,1,2,1,1,2.25,0,4,1,3,3,3,3,2,3,3,2,4,2,2,2,3,4,3,5,4,3,3,4,3,8,1,1,0,1,0,1,2,1,1,1,1,2,1,1,3,1,2,1,2,2,1,2,2,3,3,3,4,2,2,5,3,2,3,5,1,1,2,3,2,2,2,1,2,3,4,2,1.4305755997312923,0.8618916073713346,3.625,0,2.75,0,2.6666666666666665,0,1.2222222222222223,0,2.0833333333333335,0,3,0,2.4285714285714284,0,1.6666666666666667,0,2.054054054054054,0,4,0,0,0.9517659021544338,0.7461928333125257,0.8615522685655875,0.8038725509390566,2,2,2,2,2,2,4,4,1,1.0690449676496976,2.2857142857142856,0,2.5,0.36869899328116373,4,5,5,5,4,4,4,6,7,3,3,1.0690449676496976,6.5,4.428571428571429,0,0.309970182831297,0,0.7216156413217214,2,3,3,3,3,4,4,4,3,3,4,4,3,4,4,4,3,3,4,3,0.7988086367179802,2.8,0,3.6,0,3.6,0,3.6,0,3.6,0,2,2,2,1,2,1,2,2,1,1,3,2,2,2,1,1,1,2,1,3,0.9679060415469871,1.7,0,I lived with my mother and father an equal amount of time (joint custody),0,"White, Caucasian, Anglo, European American",0,21,1,2,NA,1,3,4,Student,4,118,61,1,5,2,0,0,1,0,0,TRUE,TRUE,TRUE,TRUE,TRUE,3,0.544212499992922,0.44487500000558794,0.4761562500093132,0.6008827586132904,0.5233187500033527,0.5506625000014901,1,1,1,0.9354838709677419,1,1,0.109,0.328,0.751,0.015,1.392,26.241006291566812,1807.8623458576803,0.068,0.355,0.738,0.019,1.581,120.61081309123966,1910.8886229304264,0.065,0.37,0.41,0.017,1.982,118.73319168369369,1968.0111208233402,92.8,83.21052631578948,116.58823529411764,FALSE,430,1.2740740740740741,0,1,0,0,3,FALSE
166,2022-03-18T17:25:45Z,2022-03-18T17:58:27Z,1961,1,2022-03-18T17:58:29Z,0.8999999761581421,Chrome,99.0.4844.51,Macintosh,1440,900,na,1.6,734,151,481,149,139,148,0.11542891877036138,0.182799175144858,0.2531287704555424,0.6275111078340467,1.6016908985965266,0.5553843928406147,2,2,2,2,2,1,2,2,1,3,3,2,2,2,2,2,2,2,3,2,0.6386663736585051,0,1,1,3,2,2.05,0,2,2,1,2,2,1,2,2,1,1,1,2,2,1,1,1,2,1,1,1,2,1,1,1,2,0,0,0,0,1,1,1,1,1,1,1,1,1,1,1,1,1,1,1,2,1,1,1,1,1,2,3,1,1,1,1,1,1,1,1,1,1,2,1,1,1,1,1,1,1,1.879636409796595,1.5796322658258457,1.25,0,1,0,1.5333333333333334,0,1,0,1.0833333333333333,0,1.5,0,1.1428571428571428,0,1,0,1.135135135135135,0,1,0,0,-1.1866133147069973,-1.1867476660586218,-0.39960647100849406,-0.793177068533558,1,1,2,1,1,1,1,1,1,1.7320508075688772,1.1428571428571428,0,1,-0.874984074548163,5,5,5,5,3,4,4,6,7,6,4,1.2149857925879117,6.5,4.428571428571429,0,1.2946567068380648,0,1.3213778790473958,2,2,2,2,2,4,4,4,5,2,3,2,4,4,4,3,3,4,3,2,0.9611501047232549,2,0,3.2,0,3.2,0,3.8,0,3.4,0,1,2,1,2,1,1,2,2,1,2,4,4,2,2,1,1,2,2,1,3,0.998683343734455,1.85,0,I lived with my mother and father an equal amount of time (joint custody),0,"White, Caucasian, Anglo, European American",0,29,1,2,NA,1,3,6,cottage baker,3,230,69,2,5,2,0,0,1,0,0,TRUE,TRUE,TRUE,TRUE,TRUE,3,0.7481709677480882,0.643974193530698,0.5853968749940396,0.8139281249903142,0.7013749999888241,0.6873709677342446,1,1,1,1,1,1,0.088,0.436,0.534,0.02,1.688,69.49166710459677,1855.5116694725348,0.16,0.331,0.516,0.028,1.531,69.3401301952072,1855.7274140395014,0.118,0.367,0.308,0.083,1.592,80.06281598080116,1862.2125033946022,84.39999999999999,54.67857142857142,19.180722891566266,FALSE,380,1.125925925925926,0,1,0,0,3,FALSE
167,2022-03-18T17:37:10Z,2022-03-18T17:58:48Z,1297,1,2022-03-18T17:58:49Z,0.8999999761581421,Chrome,99.0.4844.74,Windows NT 10.0,1805,1204,n/a,1.4991694352159468,525,83,380,86,55,116,-0.3142959335451611,-0.1926802116391746,-0.11383145681916307,-0.14944684216749646,-0.12080228302533408,0.19576127074859423,2,2,1,1,2,1,1,2,1,2,2,1,1,1,2,4,1,1,3,2,0.9880869341680844,0,1,1,2,1,1.65,0,2,2,2,1,2,1,2,3,3,2,3,3,2,3,2,2,2,1,1,1,3,2,3,0,2,0,0,0,0,1,2,1,1,1,1,4,1,2,3,1,3,1,2,4,4,2,3,4,4,4,1,1,1,1,1,1,1,1,3,1,1,1,2,1,1,3,2,2,2,4,1.622384705343382,1.0690449676496976,1.875,0,2.5,0,2.2,0,1.5555555555555556,0,2.9166666666666665,0,1,0,1.4285714285714286,0,1.6666666666666667,0,1.8918918918918919,0,0,0,0,-0.2895906483517917,-0.2924049971986436,-0.10205184935939461,-0.1972284232790191,3,3,3,2,2,5,4,6,1,1.0690449676496976,3.142857142857143,0,3.5,1.253110763171231,5,5,5,5,3,3,5,6,7,6,4,1.5735915849388864,6.5,4.428571428571429,0,1.2946567068380648,0,1.3213778790473958,3,3,3,3,3,2,4,2,3,4,1,2,4,3,3,4,2,3,4,3,0.9411239481143202,3,0,2,0,4,0,2.8,0,2.933333333333333,0,1,1,3,3,3,4,4,3,3,3,2,4,2,4,2,3,2,4,3,2,1,2.8,0,I lived with my mother and father an equal amount of time (joint custody),0,"Hispanic of Latino (e.g., Mexican American, Central American, and others) & White, Caucasian, Anglo, European American",1,23,1,2,NA,1,3,6,real estate agent,3,125,65,2,4,2,0,0,0,1,0,TRUE,TRUE,TRUE,TRUE,TRUE,5,0.6915093749947846,0.5344999999962747,0.6089499999992549,0.7591218750011176,0.6294874999914318,0.682590624993667,1,1,1,1,1,1,0.193,0.313,0.656,0.015,1.406,25.34200239786975,1807.2167939073881,0.097,0.384,0.638,0.015,1.589,44.344873084195555,1826.8042165626305,0.204,0.368,0.645,0.018,1.595,44.82675372163593,1826.3030313232412,93.73333333333333,105.93333333333334,88.61111111111111,FALSE,450,1.3333333333333335,0,1,0,0,3,FALSE
168,2022-03-18T17:28:44Z,2022-03-18T17:59:02Z,1817,1,2022-03-18T17:59:03Z,1,Chrome,99.0.4844.51,Windows NT 10.0,1600,900,n/a,1.7777777777777777,992,94,395,99,53,97,0.6459026599062695,-0.13194089907116932,-0.059332413164503835,0.01087781418202833,-0.1618140254449022,-0.017764957993542937,2,1,2,2,2,1,2,1,1,2,1,2,1,1,2,1,2,1,2,2,1.0990426455975697,0,1,1,5,5,1.55,0,4,1,3,3,2,2,4,3,1,2,2,3,2,3,3,1,3,3,1,1,2,3,1,1,1,0,0,1,0,2,1,1,1,1,1,2,1,3,1,1,1,1,2,1,1,3,1,2,3,3,3,1,1,2,5,1,1,2,1,1,2,3,2,1,1,1,2,2,1,1,1.643989873053573,0.9154754164341269,1.875,0,1.5,0,2.533333333333333,0,1.4444444444444444,0,1.6666666666666667,0,2.1666666666666665,0,1.7142857142857142,0,1,0,1.6486486486486487,0,1,0,0,-0.44750172898155904,-0.2530716197886394,-0.22730066264678367,-0.24018614121771154,1,1,2,1,1,1,3,1,1,1.7043362064926932,1.4285714285714286,0,1,-0.7091149005366146,5,5,5,5,4,3,5,5,3,4,3,1.5275252316519468,4,4.571428571428571,0,0.072220972883332707,0,0.6542077654890679,1,2,2,2,2,4,5,4,4,5,5,5,4,5,5,5,5,5,5,3,1.7511900715418263,1.8,0,4.8,0,4.8,0,4.2,0,4.6,0,1,1,1,1,1,1,1,1,1,1,2,1,1,1,1,1,1,2,1,2,1.2085223687584246,1.15,0,I lived with my mother and father an equal amount of time (joint custody),0,"White, Caucasian, Anglo, European American",0,27,1,2,NA,1,4,6,nurse care manager,6,122,63,3,5,2,0,0,1,0,0,TRUE,TRUE,TRUE,TRUE,TRUE,5,0.4941812500022352,0.4844781249947846,0.4677375000026077,0.5705875000078231,0.5707562499959021,0.6079343750085682,1,1,1,1,1,1,0.115,0.287,0.645,0.009,1.521,82.52459633890152,1865.5480275745244,0.084,0.314,0.539,0.011,1.424,85.5567310780801,1869.191177992567,0.092,0.351,0.694,0.019,1.797,170.83562254437777,1966.390706443377,169,129.45454545454547,94.57894736842105,FALSE,364,1.0785185185185184,0,1,0,0,3,FALSE
169,2022-03-18T17:35:31Z,2022-03-18T17:59:31Z,1439,1,2022-03-18T17:59:32Z,NA,Chrome,99.0.4844.74,Windows NT 10.0,1366,768,NA,1.7786458333333333,816,67,308,69,41,83,0.28402910006161897,-0.28102830264718226,-0.37542686636152733,-0.3591021620091827,-0.40788447996231086,-0.1751000739088019,2,3,3,2,2,1,2,3,1,2,4,3,1,2,3,2,1,1,3,3,0.7947194142390263,0,0,1,3,2,2.2,0,2,1,1,2,1,2,2,1,1,1,1,1,1,3,1,2,1,1,4,2,2,2,1,3,1,1,0,3,0,1,2,1,1,1,1,1,1,1,2,1,1,1,2,1,3,1,1,1,1,1,1,1,1,1,1,1,3,3,2,2,1,1,1,1,1,1,1,2,2,2,1.7866707005467437,1.7237832147426693,1.875,0,1.75,0,1.4,0,1.1111111111111112,0,1.3333333333333333,0,1,0,1.8571428571428572,0,1,0,1.2972972972972974,0,2,0,0,-0.6755955121134449,-0.901285679505514,0.07821504497010326,-0.41153531726770537,1,1,3,1,1,2,2,1,1,1.4638501094227998,1.5714285714285714,0,1,-0.6261803135308405,5,5,5,5,2,2,5,3,3,3,4,1.8126539343499315,3,4.142857142857143,0,0.020976482659657802,0,0.39078725804990966,3,3,3,4,2,4,5,5,4,2,5,2,5,5,5,1,5,5,3,4,1.6987390281365427,3,0,4.2,0,3.2,0,4.6,0,4,0,2,1,1,4,2,2,3,3,3,2,4,3,1,1,1,2,2,2,2,3,0.8583950752789521,2.2,0,I lived with my mother and father an equal amount of time (joint custody),0,"Hispanic of Latino (e.g., Mexican American, Central American, and others)",0,25,1,2,NA,1,2,3,unemployed,2,125,62,3,5,2,0,0,1,0,0,TRUE,TRUE,TRUE,TRUE,TRUE,1,0.4751374999992549,0.4811187499985099,0.5204375000037252,0.5843433333317439,0.5772900000055631,0.5849758620755425,1,1,1,0.967741935483871,0.967741935483871,0.90625,0.062,0.365,0.423,0.025,2.039,59.24154373423173,1916.6154778231169,0.075,0.371,0.723,0.02,1.989,27.939890227588,1852.8775719078224,0.071,0.335,0.503,0.013,1.538,12.782926178586143,1836.533337266691,81.56,99.45,118.30769230769232,FALSE,328,0.9718518518518519,0,1,0,3,6,FALSE
170,2022-03-18T17:26:08Z,2022-03-18T17:59:33Z,2005,1,2022-03-18T17:59:34Z,1,Chrome,98.0.4758.81,Windows NT 10.0,1536,864,NA,1.7777777777777777,1169,102,491,81,40,80,1.0098323195227645,-0.0877668535671655,0.2894614662253152,-0.2111101715326983,-0.42839035117209495,-0.20881474160492883,3,2,2,1,3,1,2,3,1,2,3,2,1,1,3,3,2,1,4,3,0.6386663736585051,0,0,3,4,3,2.15,0,4,1,2,2,1,1,1,1,2,1,2,2,1,2,1,1,3,1,1,1,3,2,1,0,1,2,0,2,0,1,1,1,1,1,1,1,1,1,2,1,3,1,3,2,4,2,2,3,3,3,3,1,1,1,4,1,1,1,1,1,1,1,1,1,2,2,1,1,1,1,1.652189374657073,1.632993161855452,1.625,0,1,0,1.6,0,1,0,2.4166666666666665,0,1.8333333333333333,0,1,0,1.6666666666666667,0,1.6486486486486487,0,0,0,0,-0.6097992285177086,-0.7697155320690485,-0.6189692744445258,-0.6943424032567871,1,1,3,1,1,1,1,1,1,1.5735915849388864,1.2857142857142858,0,1,-0.7920494875423887,5,5,5,5,2,2,5,6,7,3,3,1.8126539343499315,6.5,4.142857142857143,0,0.309970182831297,0,0.5668102908403673,2,3,2,2,1,4,4,5,5,3,4,4,3,3,4,3,3,4,3,3,0.9611501047232549,2,0,3.8,0,3.2,0,4,0,3.6666666666666665,0,3,2,3,2,3,2,2,3,1,1,3,2,1,2,1,3,1,1,1,1,0.8522416262267903,1.9,0,I lived with my mother and father an equal amount of time (joint custody),0,"Asian or Asian American (e.g., Chinese, Japanese, and others)",0,22,1,2,NA,1,3,3,full time student,4,185,67,2,5,2,0,0,1,0,0,TRUE,TRUE,TRUE,TRUE,TRUE,1,0.5061468750238418,0.4648937500119209,0.5160999999940395,0.5675250000442777,0.561564516144414,0.5853148148324755,1,1,1,0.875,0.96875,0.84375,0.053,0.392,0.502,0.015,1.785,95.45348721546469,1959.9798676156538,0.068,0.338,0.55,0.014,1.546,110.49491980158538,1938.8173351607688,0.058,0.364,0.473,0.02,2.046,69.73957584369857,1932.510486171796,119,110.42857142857143,102.29999999999998,FALSE,356,1.0548148148148149,0,1,0,0,3,FALSE
171,2022-03-18T16:42:40Z,2022-03-18T18:00:43Z,4683,1,2022-03-18T18:00:44Z,0.8999999761581421,Chrome,99.0.4844.51,Macintosh,1440,900,Only breaks I took were during the questions after the game!,1.6,705,71,3457,112,53,63,0.05580202538686783,-0.25894127989518034,11.065739031539932,0.1712024705315531,-0.1618140254449022,-0.3998645252163147,4,3,4,3,4,2,4,4,2,4,4,4,4,3,4,4,4,2,4,4,1.268027892769755,0,1,2,2,1,3.55,0,2,1,1,1,1,1,2,2,2,2,2,2,3,2,1,1,3,2,2,2,3,2,2,0,2,0,0,0,0,1,1,3,1,1,1,2,1,3,1,1,3,1,4,1,5,1,3,3,3,3,4,1,3,1,1,1,1,1,3,1,1,1,1,1,1,1,1,2,1,2,1.6093756833288149,1.5118578920369088,2.125,0,1.5,0,1.6666666666666667,0,1.5555555555555556,0,2.4166666666666665,0,1.8333333333333333,0,1.2857142857142858,0,1,0,1.7837837837837838,0,0,0,0,-0.197475851317761,-0.4633085220451133,-0.4466634660828154,-0.45498599406396434,1,1,1,1,1,1,3,1,2,1.9023794624226837,1.2857142857142858,0,1.5,-0.5986473636146776,5,5,5,5,3,3,5,6,7,5,4,1.5735915849388864,6.5,4.428571428571429,0,1.0808314045082337,0,1.1911391292716074,3,2,4,3,3,3,5,3,4,3,4,3,3,5,3,5,3,3,4,3,1.0327955589886444,3,0,3.2,0,4,0,3.6,0,3.6,0,1,2,4,3,3,4,4,3,4,2,2,3,1,4,1,3,4,4,2,3,1.1367080817685316,2.85,0,"I lived with my mother, but not father, most of the time.",0,"White, Caucasian, Anglo, European American",0,27,1,2,NA,1,4,8,Editor (currently),4,120,65,2,5,2,1,0,1,0,1,TRUE,TRUE,TRUE,TRUE,TRUE,4,0.4925031250002794,0.455568749998929,0.4798343749998603,0.5601580645158406,0.5164387096784288,0.5830290322575358,1,1,1,0.96875,0.96875,0.96875,0.068,0.365,0.657,0.018,2.035,107.14878895032449,1938.4006970757216,0.088,0.332,0.797,0.025,1.907,223.61115008400563,2048.883350577297,0.066,0.366,0.591,0.014,1.593,167.61384364606576,1991.9852668877945,113.05555555555557,76.28,113.78571428571428,FALSE,404,1.1970370370370371,0,1,0,0,3,FALSE
172,2022-03-18T17:31:12Z,2022-03-18T18:01:22Z,1810,1,2022-03-18T18:01:23Z,1,Edge,99.0.1150.39,Windows NT 10.0,1366,768,NA,1.7786458333333333,781,90,489,132,76,116,0.21206560804705782,-0.15402792182317124,0.2821949270713607,0.41785578799236045,0.3098210123801311,0.19576127074859423,3,2,2,2,3,1,1,4,1,3,2,2,2,2,3,3,2,1,3,4,0.6155870112510925,0,0,4,3,3,2.3,0,5,2,5,3,4,5,1,5,5,5,5,5,1,5,5,5,5,1,2,5,5,5,5,1,1,2,0,2,0,3,5,3,4,5,4,5,4,4,1,2,5,1,4,3,3,4,5,4,5,5,5,1,1,3,2,1,2,3,3,3,2,1,1,1,1,5,1,5,1,2,1.4263711068773564,1.8439088914585775,4.125,0,2.25,0,4.066666666666666,0,4.111111111111111,0,3.5,0,2.1666666666666665,0,2.142857142857143,0,2.3333333333333335,0,3.081081081081081,0,1,0,0,1.9430965749968607,2.024134265363573,0.031158049895781924,1.0276461576296774,2,2,5,2,2,2,2,8,5,0.8997354108424374,2.4285714285714284,0,6.5,1.998850571708627,4,4,5,4,1,1,4,3,2,2,2,1.632993161855452,2.5,3.2857142857142856,0,-0.9695849561602813,0,-0.6769693801363836,2,3,3,1,3,3,3,2,4,3,3,3,3,3,4,3,5,5,3,2,0.9154754164341269,2.4,0,3.8,0,3,0,3,0,3.2666666666666666,0,1,4,1,1,3,1,2,1,2,2,3,3,1,2,2,2,1,2,1,2,1.0399898784932577,1.85,0,"I lived with my extended family on father's side (grandparents, aunts ,uncles, cousins)",0,"White, Caucasian, Anglo, European American",0,25,0,1,NA,1,3,4,fractured spine rn so I do not work.,4,155,69,1,5,2,0,0,1,0,0,TRUE,TRUE,TRUE,TRUE,TRUE,4,0.7122133333305518,0.6882290322559496,0.8320656249960885,0.8774468750040978,0.7995406250003725,1.2237343750037253,0.9375,1,1,1,1,1,0.182,0.159,0.234,0.004,1.288,85.9335766356198,1869.0223114683408,0.217,0.132,0.389,0.014,1.625,143.41760270438002,1928.8766949181925,0.097,0.399,0.299,0.012,1.801,151.7803696919658,2024.1557742691011,322,116.07142857142857,150.08333333333331,TRUE,362,1.0725925925925925,0,1,0,0,3,FALSE
173,2022-03-18T17:27:30Z,2022-03-18T18:01:29Z,2038,1,2022-03-18T18:01:30Z,1,Safari,15.3,Macintosh,1440,900,NA,1.6,569,241,652,133,119,109,-0.22382754358399845,0.6797571870649012,0.8744178681186576,0.43018845386540083,1.1915734744008455,0.11709371279096474,2,2,2,1,2,1,1,3,1,1,2,2,1,2,2,1,1,3,1,1,1.142481141154959,1,1,1,3,4,1.6,0,3,2,1,5,3,5,5,4,4,3,1,4,1,4,5,5,3,5,1,3,5,5,5,2,1,1,0,1,0,5,5,5,1,5,5,5,5,5,1,1,5,1,4,3,4,5,5,5,5,5,4,3,2,1,2,1,1,2,1,1,5,5,5,1,1,4,2,3,2,1,1.724666482098633,1.4040757000349275,4,0,2,0,3.3333333333333335,0,4.555555555555555,0,3.6666666666666665,0,2.1666666666666665,0,2.857142857142857,0,2,0,3.3513513513513513,0,1,0,0,2.0374045814840827,1.7673856443197686,-0.05499485428507328,0.8561953950173476,5,5,3,3,1,5,1,2,1,1.7994708216848747,3.2857142857142856,0,1.5,0.5624368544661608,5,5,5,3,1,1,2,4,3,NA,2,1.8126539343499315,3.5,3.142857142857143,0,-0.7825102850053112,1,-0.640426834580144,2,4,2,1,1,5,5,5,5,2,5,5,4,5,5,1,5,5,3,1,1.88477610139267,2,0,5,0,3,0,4.2,0,4.066666666666666,0,4,2,3,1,4,2,4,1,1,4,3,2,3,1,1,2,3,3,1,3,1.105012502906165,2.4,0,"I lived with my father, but not mother, most of the time. & I lived with my mother and father an equal amount of time (joint custody)",1,"White, Caucasian, Anglo, European American",0,22,0,2,NA,1,2,1,Unemployed,2,109,70,2,5,2,0,0,0,0,0,TRUE,TRUE,TRUE,TRUE,TRUE,3,0.4927187499999964,0.44381249999999817,0.4396562499999982,0.5573333333333256,0.5186451612903207,0.5099000000000078,1,1,1,0.9375,0.96875,0.9375,0.056,0.358,0.696,0.024,1.886,89.57540870169143,1936.993958197959,0.067,0.351,0.781,0.021,1.753,49.21423805454744,1875.7919000292036,0.057,0.378,0.525,0.021,1.811,37.88131016549701,1882.487248945086,78.58333333333333,83.47619047619047,86.23809523809523,FALSE,360,1.0666666666666667,0,1,0,0,3,FALSE
174,2022-03-18T17:21:20Z,2022-03-18T18:01:46Z,2426,1,2022-03-18T18:01:47Z,1,Chrome,97.0.4692.71,Windows NT 10.0,1920,1200,NA,1.6,639,125,270,168,43,79,-0.07990055955487611,0.03923352725684553,-0.513491110286664,0.8618317594218137,-0.36687273754274274,-0.22005296417030445,3,2,1,1,3,1,1,3,1,3,3,1,1,1,3,3,1,1,3,3,0.6048053188292994,0,1,1,3,3,1.95,0,1,2,2,2,2,1,3,2,2,1,2,2,2,2,2,1,1,1,1,1,1,1,1,1,1,2,0,0,0,1,1,1,1,1,1,1,1,1,1,1,1,1,2,1,2,2,1,1,1,1,1,1,1,1,2,1,1,1,1,1,1,1,1,1,2,1,2,1,1,1,1.8647995810481826,1.2649110640673518,1,0,1.25,0,1.8666666666666667,0,1,0,1.25,0,1.1666666666666667,0,1,0,1.3333333333333333,0,1.135135135135135,0,1,0,0,-1.3489108142431467,-1.1503642919543675,-0.31345356682763886,-0.7319089293910032,2,1,3,2,1,2,3,1,1,1.1126972805283737,2,0,1,-0.3773765525135179,4,4,4,4,2,2,3,4,6,3,2,0.9511897312113419,5,3.2857142857142856,0,-0.30418514155265464,0,-0.27168132951147617,3,3,3,3,3,3,4,4,4,3,5,4,3,3,3,5,4,5,4,3,1.0997835284835873,3,0,4.2,0,3.8,0,3.4,0,3.8,0,1,2,2,1,3,2,2,2,2,1,3,2,2,2,1,2,1,2,1,2,0.8522416262267903,1.8,0,NA,NA,"White, Caucasian, Anglo, European American",0,23,1,2,NA,1,2,5,clerical supervisor,4,125,70,2,5,2,0,0,1,0,0,TRUE,TRUE,TRUE,TRUE,TRUE,3,0.4885437499973923,0.510999999997206,0.4635218750019558,0.5596300000006954,0.5375562499989756,0.5616718750009313,1,1,1,0.967741935483871,1,1,0.085,0.324,0.595,0.017,1.636,23.165596473206772,1802.7941920017377,0.141,0.295,0.678,0.043,1.663,55.59666905274923,1841.0099664484464,0.072,0.354,0.57,0.021,1.812,23.034388585794645,1849.881075903391,96.23529411764704,38.674418604651166,86.28571428571428,FALSE,323,0.9570370370370371,0,1,0,6,9,FALSE
175,2022-03-18T17:14:09Z,2022-03-18T18:01:59Z,2869,1,2022-03-18T18:01:59Z,1,Safari,13.1.2,Macintosh,1440,900,NA,1.6,462,102,2143,55,26,50,-0.4438302191713712,-0.0877668535671655,6.291622807391785,-0.5317594842317478,-0.7154725481090718,-0.5459614185661981,3,4,3,2,3,1,2,4,1,3,4,4,1,2,3,4,3,1,4,4,0.8645047258706176,0,1,1,4,3,2.8,0,2,2,3,2,3,1,1,2,2,1,1,2,1,2,2,1,1,1,1,1,1,1,3,1,2,0,0,0,0,1,2,1,3,3,1,3,3,2,2,1,3,1,2,1,2,1,3,3,4,1,1,1,1,1,1,1,1,1,1,1,1,1,1,1,1,1,1,1,1,1,1.5915505122467941,1.4074631010979937,1.25,0,1,0,1.8,0,2.111111111111111,0,2,0,1,0,1,0,1,0,1.5945945945945945,0,1,0,0,-0.8883368290729924,-0.8697206441339852,-0.39960647100849406,-0.6346635575712396,1,1,2,1,1,2,2,1,1,1.6035674514745464,1.4285714285714286,0,1,-0.7091149005366146,5,5,5,5,3,3,5,8,8,5,4,1.5735915849388864,8,4.428571428571429,0,1.351776111874911,0,1.3561687097810788,2,2,2,2,2,4,3,3,4,3,5,4,5,3,4,3,3,5,3,5,1.0600988273786194,2,0,4.2,0,3.4,0,3.8,0,3.8,0,2,1,3,4,3,4,4,4,4,1,1,3,1,3,2,4,1,3,4,4,1.260743306232687,2.8,0,I lived with my mother and father an equal amount of time (joint custody),0,"Asian or Asian American (e.g., Chinese, Japanese, and others)",0,20,1,2,NA,1,4,4,student,6,115,65,3,5,2,0,0,1,0,0,TRUE,TRUE,TRUE,TRUE,TRUE,2,0.4814999999999964,0.9029687499999963,0.4890000000000019,0.5750967741935474,0.9097586206896572,0.5388387096774184,1,1,1,0.96875,0.90625,1,0.242,0.194,0.841,0.006,0.787,34.90740090876157,1819.2043028905782,0.099,0.26,0.15,0.218,1.344,232.2452665223227,2113.0629553925437,0.072,0.336,0.571,0.015,1.744,76.66951798522837,1903.2263788703856,131.16666666666666,6.165137614678899,116.26666666666667,FALSE,416,1.2325925925925925,0,1,0,0,3,FALSE
177,2022-03-18T17:42:25Z,2022-03-18T18:02:44Z,1218,1,2022-03-18T18:02:45Z,0.800000011920929,Chrome,99.0.4844.74,Windows NT 10.0,1536,864,No,1.7777777777777777,565,67,351,65,43,66,-0.23205194267137688,-0.28102830264718226,-0.21919627455150423,-0.4084328255013442,-0.36687273754274274,-0.3661498575201878,1,1,1,1,1,1,1,1,1,1,1,1,1,1,1,1,1,1,1,1,1.538967528127731,0,0,3,4,4,1,0,1,1,1,1,2,1,1,1,1,1,1,1,1,1,1,1,1,4,1,1,1,1,1,5,2,0,0,0,0,2,1,1,1,2,1,1,1,1,2,1,1,1,1,1,1,1,1,1,1,1,1,1,1,1,2,1,1,3,2,2,1,1,1,1,1,1,1,1,1,1,1.8310796959315705,2.016597794967223,1.375,0,1,0,1.0666666666666667,0,1.2222222222222223,0,1.0833333333333333,0,1.1666666666666667,0,1.5714285714285714,0,1,0,1.2162162162162162,0,3,0,0,-1.0528275380623333,-1.3005194602170598,0.03911913586356937,-0.6307001621767452,1,1,2,1,1,1,1,1,1,1.7320508075688772,1.1428571428571428,0,1,-0.874984074548163,5,5,5,5,1,1,5,7,7,4,3,2.138089935299395,7,3.857142857142857,0,0.6141103876166872,0,0.5972535503046252,3,3,2,2,2,3,4,2,3,3,5,3,4,5,4,4,4,5,2,1,1.2798809468443688,2.4,0,4,0,3.4,0,3,0,3.466666666666667,0,1,2,2,1,2,3,3,2,1,1,2,1,2,2,1,2,1,2,1,3,0.9880869341680844,1.75,0,"I lived with my father, but not mother, most of the time.",0,"White, Caucasian, Anglo, European American",0,30,0,1,NA,1,2,6,Umemployed,1,170,68,1,5,2,0,0,1,0,0,TRUE,TRUE,TRUE,TRUE,TRUE,6,0.5852812499981374,0.5471593749988825,0.5870468750037253,0.6923250000048429,0.5970633333365123,0.655319354841786,1,1,1,1,1,1,0.097,0.375,0.495,0.019,1.771,35.3913776676267,1817.1601111343036,0.095,0.383,0.598,0.017,1.294,32.75037076743974,1814.1165337061875,0.166,0.329,0.673,0.012,1.527,30.267359159183286,1812.3182558515032,93.21052631578947,76.11764705882352,127.24999999999999,FALSE,388,1.1496296296296296,0,1,0,0,3,FALSE
178,2022-03-18T17:45:53Z,2022-03-18T18:04:20Z,1106,1,2022-03-18T18:04:21Z,0.800000011920929,Chrome,99.0.4844.74,Windows NT 10.0,1920,1080,NA,1.7777777777777777,438,57,397,66,59,50,-0.49317661369564175,-0.33624585952718705,-0.05206587401054927,-0.3961001596283038,-0.03877879818619785,-0.5459614185661981,3,3,1,2,3,1,1,3,1,3,4,3,3,1,4,3,1,1,4,3,0.6805570473787206,0,1,2,3,3,2.4,0,4,2,3,3,2,3,2,3,3,1,4,4,3,3,3,3,5,5,3,3,4,4,4,5,1,0,0,1,1,1,2,1,2,4,1,2,1,1,2,2,3,3,3,2,1,5,5,5,4,4,4,4,5,5,5,5,3,5,1,1,2,2,4,1,1,1,3,3,3,1,1.4617238578598342,0.8338093878327919,3.875,0,2.5,0,2.8666666666666667,0,1.6666666666666667,0,3.25,0,4.666666666666667,0,2.5714285714285716,0,1,0,2.7837837837837838,0,3,1,0,1.5877966435798851,1.2612634104965352,1.255401572399185,1.25833249144786,2,1,5,1,1,1,1,1,1,1.1338934190276817,1.7142857142857142,0,1,-0.5432457265250663,5,4,5,3,1,1,4,4,2,2,2,1.7320508075688772,3,3.2857142857142856,0,-0.8792700537047221,0,-0.62195951996656,3,3,3,3,3,4,5,4,4,2,3,3,4,3,5,5,3,5,3,3,1.1751393027860062,3,0,3.6,0,3.8,0,3.8,0,3.7333333333333334,0,2,2,1,3,3,2,2,4,4,1,1,3,3,4,1,4,1,3,3,3,1.0208355710680808,2.5,0,"I lived with my mother, but not father, most of the time.",0,"White, Caucasian, Anglo, European American",0,22,0,1,NA,1,2,4,unemployed,1,135,76,1,5,2,0,0,1,0,0,TRUE,TRUE,TRUE,TRUE,TRUE,4,0.41057499999995345,0.3671843749997206,0.3868000000003958,0.47911666666666664,0.42699032258074127,0.43744285714346914,1,1,1,0.967741935483871,0.96875,0.9032258064516129,0.045,0.318,0.687,0.023,1.542,75.97475188344342,1960.4476899369486,0.051,0.305,0.811,0.016,1.356,136.20918621372843,1971.8892675371712,0.063,0.318,0.758,0.021,1.836,110.19760996860069,1935.8005175725862,67.04347826086956,84.75,87.42857142857143,FALSE,304,0.9007407407407407,1,1,0,3,6,FALSE
179,2022-03-18T17:42:48Z,2022-03-18T18:04:26Z,1297,1,2022-03-18T18:04:26Z,1,Chrome,98.0.4758.102,Windows NT 10.0,1280,720,NA,1.7777777777777777,661,96,222,58,50,68,-0.0346663645742948,-0.12089738769516838,-0.6878880499815736,-0.49476148661262676,-0.22333163907425438,-0.3436734123894365,1,2,1,1,1,1,1,2,1,2,2,1,1,1,1,1,1,1,2,2,1.2814465510343749,0,1,1,2,2,1.3,0,1,1,1,2,1,1,1,1,1,1,1,1,1,1,1,1,3,4,1,1,1,1,1,1,2,0,0,0,0,1,2,2,1,1,1,1,1,1,2,2,1,1,2,3,2,4,4,1,3,3,5,5,1,1,2,1,1,2,1,1,1,1,1,1,3,1,1,1,1,1,1.675203362671621,2.007130147392398,1.625,0,1,0,1.0666666666666667,0,1.2222222222222223,0,2.3333333333333335,0,2.5,0,1.1428571428571428,0,1.6666666666666667,0,1.8108108108108107,0,1,0,0,-0.5045251747645307,-0.9317690469982675,-0.39960647100849406,-0.6656877590033807,1,1,2,2,1,1,3,1,1,1.618347187425374,1.5714285714285714,0,1,-0.6261803135308405,4,3,4,4,2,2,2,7,3,NA,3,0.9511897312113419,5,3,0,0.13872270157061628,1,-0.15671615645915069,1,1,1,3,2,5,3,4,4,1,5,5,3,4,5,3,5,3,1,2,1.505545305418162,1.6,0,4.6,0,2.2,0,3.8,0,3.533333333333333,0,2,1,1,1,1,2,2,4,1,1,2,2,1,2,1,1,1,1,1,1,0.9880869341680844,1.45,0,"I lived with my mother, but not father, most of the time.",0,"White, Caucasian, Anglo, European American",0,30,1,2,NA,1,4,7,Teacher,4,137,63,4,5,2,0,0,1,0,0,TRUE,TRUE,TRUE,TRUE,TRUE,5,0.5062064516082887,0.4311312500014901,0.5516937499716877,0.5651241379524099,0.4917689655402611,0.5905033332904179,1,1,1,0.90625,0.9354838709677419,0.967741935483871,0.086,0.319,0.423,0.02,1.953,134.59837732721277,1956.9159797799427,0.058,0.31,0.418,0.031,1.672,162.65603356864253,2006.7190205377235,0.06,0.376,0.564,0.021,2.011,107.09971172662652,1967.2671885253285,97.65,53.93548387096774,95.76190476190476,FALSE,364,1.0785185185185184,0,1,0,0,3,FALSE
180,2022-03-18T17:17:16Z,2022-03-18T18:04:28Z,2831,1,2022-03-18T18:04:29Z,0.8999999761581421,Chrome,99.0.4844.74,Windows NT 10.0,1366,768,NA,1.7786458333333333,583,73,320,105,55,1374,-0.195042146778174,-0.24789776851917938,-0.3318276314378,0.08487380942027054,-0.12080228302533408,14.33344525799115,2,2,1,1,2,1,1,2,1,1,2,1,1,1,2,2,1,1,2,2,1.0990426455975697,0,0,1,5,5,1.45,0,5,3,3,4,3,2,2,5,3,4,5,5,1,4,3,4,4,1,1,3,3,3,4,2,2,0,0,0,0,2,5,5,5,5,3,3,1,5,3,1,1,1,4,2,5,5,3,4,4,4,4,1,1,1,1,2,1,2,2,1,4,5,4,1,1,3,2,4,1,1,1.4311002927985332,1.3201731488169053,2.875,0,2,0,3.466666666666667,0,3.7777777777777777,0,3.0833333333333335,0,1.6666666666666667,0,2.7142857142857144,0,1.6666666666666667,0,2.8378378378378377,0,1,0,0,0.9736979966863456,1.1102232412421182,-0.05499485428507328,0.5276141934785225,2,2,4,3,2,2,1,8,4,0.9511897312113419,2.2857142857142856,0,6,1.7225138607751418,2,5,5,5,3,2,5,7,4,4,3,1.7043362064926932,5.5,3.857142857142857,0,0.34316568025000993,0,0.43222396979515376,1,3,2,2,2,4,5,4,4,4,5,4,5,4,4,5,5,5,5,2,1.6035674514745464,2,0,4.6,0,4.8,0,3.6,0,4.333333333333333,0,1,3,3,1,3,3,3,1,1,1,2,2,1,2,2,2,2,2,1,2,0.9787209698591858,1.9,0,I lived with my mother and father an equal amount of time (joint custody),0,"Asian or Asian American (e.g., Chinese, Japanese, and others)",0,28,1,2,NA,1,4,6,medical student,1,147,64,3,5,2,0,0,1,0,0,TRUE,TRUE,TRUE,TRUE,TRUE,3,0.5695562499995577,0.5281718750003492,0.549950000000419,0.6938516129030575,0.6257354838708716,0.6190906249999535,1,1,1,1,1,1,0.136,0.372,0.782,0.011,1.177,49.24605428300168,1833.979326703734,0.092,0.362,0.534,0.027,2.035,97.06046925848831,1875.3896947800592,0.105,0.362,0.525,0.013,1.736,34.243069291349926,1816.1126717473253,107.00000000000001,75.37037037037038,133.53846153846155,FALSE,398,1.1792592592592592,0,1,0,0,3,FALSE
181,2022-03-18T17:42:38Z,2022-03-18T18:04:36Z,1317,1,2022-03-18T18:04:39Z,0.8999999761581421,Chrome,99.0.4844.74,Macintosh,1600,900,No,1.7777777777777777,571,61,297,44,32,63,-0.21971534404030926,-0.31415883677518514,-0.41539283170827745,-0.6674188088351919,-0.5924373208503674,-0.3998645252163147,1,2,1,1,2,1,1,3,1,3,3,1,1,1,2,2,1,1,2,3,0.9880869341680844,0,1,1,5,5,1.65,0,1,1,1,1,5,1,1,1,1,1,1,1,1,1,1,1,1,1,1,1,1,1,1,0,2,0,0,0,0,1,1,1,1,1,1,1,1,1,1,1,1,1,1,1,1,1,1,1,1,1,1,1,1,1,3,3,1,1,2,1,1,5,1,1,1,1,1,1,1,1,1.9351342963072988,2.065591117977289,1,0,1,0,1.2666666666666666,0,1,0,1,0,1.6666666666666667,0,1.7142857142857142,0,1,0,1.2432432432432432,0,0,0,0,-1.2787281117410283,-1.3651245326129924,-0.6189692744445258,-0.9920469035287591,1,1,1,1,1,1,1,1,1,1.9518001458970664,1,0,1,-0.9579186615539372,5,5,5,5,3,3,5,4,6,3,3,1.5735915849388864,5,4.428571428571429,0,0.03902547546461973,0,0.55658606081225,2,3,2,3,2,5,3,3,4,2,5,1,5,3,3,3,3,5,3,3,0.9411239481143202,2.4,0,3.8,0,3.2,0,3.2,0,3.4,0,3,4,2,3,2,2,2,3,2,1,1,3,2,2,2,3,1,2,2,2,0.6488856845230502,2.2,0,Prefer not to say.,0,"White, Caucasian, Anglo, European American",0,29,1,2,NA,1,1,4,admin,1,120,69,1,5,2,0,0,1,0,0,TRUE,TRUE,TRUE,TRUE,TRUE,4,0.6922774193594533,0.6763218749910593,0.6842406250014901,0.7084379310443484,0.77673793102955,0.7767500000085149,0.96875,1,1,0.9354838709677419,0.90625,0.9032258064516129,0.066,0.413,0.255,0.02,1.737,73.84365754905184,1959.161955016221,0.061,0.418,0.222,0.026,1.888,226.41076637704543,2114.9275210929504,0.076,0.36,0.212,0.027,1.76,319.4010399606595,2212.2259923806077,86.85000000000001,72.61538461538461,65.18518518518519,FALSE,400,1.1851851851851851,0,1,0,6,9,FALSE
182,2022-03-18T17:07:47Z,2022-03-18T18:05:50Z,3483,1,2022-03-18T18:05:51Z,0.8999999761581421,Edge,99.0.1150.39,Windows NT 10.0,1366,768,None,1.7786458333333333,830,90,1770,494,150,67,0.31281449686744345,-0.15402792182317124,4.936413255179259,4.882280834032974,1.827255481904151,-0.35491163495481215,3,3,3,2,3,3,2,4,1,3,3,1,1,2,2,3,3,2,3,3,0.6488856845230502,0,1,1,2,4,2.5,0,1,1,4,1,2,1,2,2,3,1,3,2,1,2,2,2,3,1,1,2,2,2,3,0,2,0,0,0,0,2,3,2,2,3,2,3,3,3,3,2,3,2,3,4,2,3,2,4,5,5,2,4,5,1,1,1,1,1,1,1,1,1,2,2,2,2,1,2,3,2,1.3288211940534986,1.4735767952260144,2,0,2,0,1.8666666666666667,0,2.5555555555555554,0,3.1666666666666665,0,2.3333333333333335,0,1.1428571428571428,0,2,0,2.4054054054054053,0,0,0,0,0.12492593830134693,-0.1591631812222532,-0.274357657721105,-0.2167604194716791,1,2,3,1,1,2,1,5,2,1.4638501094227998,1.5714285714285714,0,3.5,0.34083030610771514,5,4,5,5,2,2,1,5,6,5,3,1.4142135623730951,5.5,3.4285714285714284,0,0.5569909825798411,0,0.33025469384891076,3,4,4,3,4,3,5,4,3,4,5,4,4,3,3,3,3,3,3,3,0.9258200997725514,3.6,0,3.6,0,3.8,0,3.2,0,3.533333333333333,0,4,2,4,3,4,4,3,1,3,4,4,4,2,1,1,4,4,4,3,4,1.234376040972246,3.15,0,"I lived with my mother, but not father, most of the time. & I lived with my mother and father an equal amount of time (joint custody)",1,"Asian or Asian American (e.g., Chinese, Japanese, and others) & Black or African American",1,23,1,2,NA,1,3,6,Unemployed,6,140,66,4,5,2,0,0,1,0,0,TRUE,TRUE,TRUE,TRUE,TRUE,2,0.5221451612888806,0.44805312499823047,0.4835718749994412,0.6131437499998137,0.4849903225797799,0.5471166666636864,0.96875,1,1,1,0.96875,0.9375,0.063,0.336,0.477,0.012,1.429,86.5801055658078,1932.7404539689476,0.044,0.364,0.562,0.039,1.921,105.44946966652552,1929.598368445869,0.068,0.342,0.339,0.02,1.781,115.07408335349008,1941.0435444034604,119.08333333333333,49.256410256410255,89.05,FALSE,374,1.108148148148148,0,1,0,0,3,FALSE
183,2022-03-18T17:47:41Z,2022-03-18T18:06:15Z,1114,1,2022-03-18T18:06:16Z,0.8999999761581421,Chrome,99.0.4844.51,Windows NT 10.0,1920,1080,NA,1.7777777777777777,583,59,205,45,46,83,-0.195042146778174,-0.3252023481511861,-0.7496536327901874,-0.6550861429621515,-0.3053551239133906,-0.1751000739088019,3,3,2,1,3,1,1,3,1,3,3,1,2,1,3,3,1,1,3,3,0.5026246899500346,0,1,2,4,4,2.1,0,3,2,2,3,2,3,4,4,4,4,4,4,2,3,3,3,4,1,1,2,3,3,2,2,2,0,0,0,0,2,2,2,2,2,2,2,2,2,2,2,2,2,2,2,2,3,3,3,3,3,3,1,1,1,3,3,1,3,3,1,3,1,1,1,1,1,2,2,2,2,1.2030991012578505,0.8451542547285166,2.375,0,2,0,3.1333333333333333,0,2,0,2.4166666666666665,0,2,0,1.8571428571428572,0,1,0,2.027027027027027,0,1,0,0,0.12273272884815593,0.3923891035095351,-0.05499485428507328,0.1686971246122309,2,2,2,2,1,2,1,2,3,1.2535663410560174,1.7142857142857142,0,2.5,0.036960645258067054,4,4,4,4,2,2,4,6,6,3,3,1.0690449676496976,6,3.4285714285714284,0,0.2196552803757379,0,0.12478705446715747,2,2,2,2,2,4,4,4,4,3,4,4,4,4,4,5,5,4,3,2,1.162919151265879,2,0,4.2,0,3.8,0,3.6,0,3.8666666666666667,0,1,1,1,1,1,1,1,1,1,1,2,1,1,1,1,1,1,2,1,1,1.2182817926554552,1.1,0,I lived with my mother and father an equal amount of time (joint custody),0,"White, Caucasian, Anglo, European American",0,29,0,1,NA,1,4,7,Ops Manager,6,175,73,4,5,2,0,0,1,0,0,TRUE,TRUE,TRUE,TRUE,TRUE,2,0.4723843750003725,0.4509343750048429,0.47243437500484287,0.5333774193544542,0.4784031250067055,0.5119766666710377,1,1,1,1,1,0.967741935483871,0.056,0.369,0.492,0.063,1.92,98.37933572405944,1926.5903622212172,0.066,0.351,0.731,0.018,1.116,52.04737268628307,1839.5133493261765,0.129,0.313,0.835,0.028,1.772,23.597957260173832,1805.1241726392575,30.476190476190474,62.00000000000001,63.285714285714285,FALSE,352,1.0429629629629629,0,1,0,0,3,FALSE
184,2022-03-18T17:47:23Z,2022-03-18T18:07:25Z,1202,1,2022-03-18T18:07:26Z,1,Firefox,98.0,Windows NT 10.0,1451,907,NA,1.5997794928335172,510,132,269,50,34,91,-0.34513743012283016,0.07788581707284889,-0.5171243798636413,-0.5934228135969497,-0.5514255784307993,-0.08519429338579677,2,2,1,1,2,1,1,2,1,2,2,1,1,1,2,2,1,1,2,2,1.025978352085154,0,1,1,3,4,1.5,0,5,2,2,2,2,1,3,2,1,2,3,2,1,3,3,2,3,1,1,2,2,2,3,0,1,1,0,1,0,2,1,4,2,3,2,4,4,4,1,1,1,1,4,1,2,1,1,2,1,1,4,1,1,1,1,1,1,1,1,1,1,1,1,1,1,1,1,2,1,1,1.3495633817354862,1.121223821162776,2,0,1.25,0,2.2666666666666666,0,2.888888888888889,0,1.4166666666666667,0,1.5,0,1,0,1,0,1.6756756756756757,0,0,0,0,-0.3488073035879547,-0.30312334254287004,-0.5328163702636706,-0.41796985640327033,2,1,2,1,1,1,1,1,1,1.4638501094227998,1.2857142857142858,0,1,-0.7920494875423887,4,4,4,4,3,3,5,1,1,4,3,1.1126972805283737,1,3.857142857142857,0,-0.4696684418500219,0,-0.06286477173326038,2,2,2,3,2,4,5,4,4,3,5,4,3,3,4,5,4,4,3,5,1.2344267996967353,2.2,0,4.2,0,3.8,0,4,0,4,0,1,1,1,2,1,1,2,2,1,1,1,2,1,1,1,2,1,1,1,1,0.8255779474818965,1.25,0,I lived with my mother and father an equal amount of time (joint custody),0,"Asian or Asian American (e.g., Chinese, Japanese, and others)",0,27,1,2,NA,1,3,6,IT Support,4,130,63,3,5,2,0,0,1,0,0,TRUE,TRUE,TRUE,TRUE,TRUE,4,0.5164193548387097,0.414875,0.48046875,0.5784838709677419,0.4924,0.5650999999999999,0.96875,1,1,0.96875,0.9375,0.9375,0.066,0.378,0.71,0.009,1.264,26.255080568647656,1872.9397892506272,0.064,0.33,0.77,0.015,1.529,74.81559325848778,1925.5282898095231,0.06,0.378,0.481,0.018,1.661,86.62498206442942,1950.3601091947894,140.44444444444446,101.93333333333334,92.27777777777779,FALSE,423,1.2533333333333332,0,1,0,0,3,FALSE
185,2022-03-18T17:46:06Z,2022-03-18T18:07:33Z,1286,1,2022-03-18T18:07:34Z,1,Firefox,98.0,Linux x86_64,1920,1080,N/A,1.7777777777777777,502,96,358,79,72,120,-0.361586228297587,-0.12089738769516838,-0.19376338751266325,-0.23577550327877903,0.2277975275409949,0.2407141610100968,2,2,1,1,2,1,1,2,1,1,2,1,1,1,2,2,1,1,3,2,1.0760551736979407,0,1,1,5,4,1.5,0,3,3,2,3,2,1,2,2,1,1,2,2,1,3,3,2,3,1,1,1,1,1,1,0,2,0,0,0,0,2,2,2,2,5,1,1,1,3,2,2,1,4,3,3,3,2,2,1,1,1,3,1,1,1,1,1,1,1,1,1,2,4,3,1,1,1,1,1,1,1,1.4596679864375428,1.0465362369445672,1.375,0,1,0,2.066666666666667,0,2.111111111111111,0,2.0833333333333335,0,1.3333333333333333,0,1.8571428571428572,0,1,0,1.837837837837838,0,0,0,0,-0.6492769986751505,-0.5925186668369782,-0.6189692744445258,-0.6057439706407519,1,1,3,1,1,2,1,1,1,1.5275252316519468,1.4285714285714286,0,1,-0.7091149005366146,4,4,4,3,3,3,4,2,4,1,2,0.7559289460184544,3,3.5714285714285716,0,-1.0930953560345533,0,-0.597392919260994,1,1,1,2,2,4,5,5,5,2,5,4,4,3,4,4,4,5,4,4,1.3557637102737474,1.4,0,4.4,0,3.8,0,4.2,0,4.133333333333334,0,1,1,1,3,1,2,1,2,2,2,1,2,1,2,1,1,1,2,2,3,0.8944271909999159,1.6,0,I lived with my mother and father an equal amount of time (joint custody),0,"Hispanic of Latino (e.g., Mexican American, Central American, and others)",0,24,1,2,NA,1,2,6,homemaker,2,117,64,3,5,2,0,0,1,0,0,TRUE,TRUE,TRUE,TRUE,TRUE,4,0.482625,0.4211875,0.46884375,0.5298666666666667,0.4595666666666667,0.5182413793103449,1,1,1,0.9375,0.9375,0.90625,0.058,0.326,0.472,0.016,1.767,165.26540301790112,2024.762386339959,0.047,0.332,0.544,0.032,1.71,96.30642161057304,1969.8907815264233,0.058,0.359,0.514,0.031,2.02,76.72295437893044,1923.9391639700543,110.43749999999999,53.4375,65.16129032258064,FALSE,478,1.4162962962962962,0,1,0,0,3,FALSE
186,2022-03-18T17:42:01Z,2022-03-18T18:07:35Z,1533,1,2022-03-18T18:07:36Z,0.8999999761581421,Chrome,99.0.4844.74,Windows NT 10.0,1920,1080,NA,1.7777777777777777,633,177,286,93,94,74,-0.09223715818594373,0.32636482303287045,-0.4553587970550276,-0.06311818105621388,0.6789266941562442,-0.2762440769971827,1,1,1,1,1,1,1,2,1,1,2,1,1,1,1,1,1,1,2,2,1.3803127029389886,0,1,1,4,5,1.2,0,1,1,2,1,1,1,1,1,1,1,1,1,2,1,2,1,1,1,1,1,1,1,1,0,2,0,0,0,0,1,1,1,1,1,1,1,1,1,1,1,1,1,1,1,2,1,1,1,1,1,1,1,1,1,3,1,1,1,1,1,1,1,1,1,1,1,1,2,2,1,1.9234603452371197,1.9073791542572855,1,0,1.5,0,1.2,0,1,0,1.0833333333333333,0,1.3333333333333333,0,1,0,1,0,1.0810810810810811,0,0,0,0,-1.384002165494206,-1.465031311234404,-0.4466634660828154,-0.9558473886586096,3,2,4,2,2,2,2,3,2,0.3779644730092272,2.4285714285714284,0,2.5,0.4516335802869379,2,2,2,4,1,2,3,1,1,1,1,0.9511897312113419,1,2.2857142857142856,0,-1.797565582874064,0,-1.7231024255046925,2,1,1,1,1,3,2,3,4,2,3,3,5,3,4,1,4,4,1,1,1.245945806357946,1.2,0,3.4,0,2.2,0,3,0,2.8666666666666667,0,1,1,1,2,1,1,1,2,1,1,1,1,1,1,1,1,1,1,1,1,1.0513149660756937,1.1,0,NA,NA,"Hispanic of Latino (e.g., Mexican American, Central American, and others)",0,21,0,1,NA,1,2,4,College Student,2,170,68,3,5,2,0,0,1,0,0,TRUE,TRUE,TRUE,TRUE,TRUE,2,0.49159687499993016,0.4398741935483751,0.453918749999837,0.5649379310343928,0.5109966666669274,0.534932142857196,1,1,1,0.90625,0.9375,0.875,0.057,0.337,0.514,0.02,2.066,110.11475844258422,1971.2527111708785,0.061,0.33,0.649,0.015,1.653,95.79522120796166,1942.4836038307915,0.063,0.351,0.49,0.014,1.675,91.7259624138517,1948.467070408754,103.29999999999998,110.2,119.64285714285714,FALSE,324,0.96,0,1,0,6,9,FALSE
187,2022-03-18T17:49:18Z,2022-03-18T18:07:56Z,1117,1,2022-03-18T18:07:57Z,0.8999999761581421,Chrome,99.0.4844.51,Windows NT 10.0,1600,900,NA,1.7777777777777777,590,60,261,56,43,54,-0.18064944837526176,-0.31968059246318564,-0.5461905364794596,-0.5194268183587075,-0.36687273754274274,-0.5010085283046954,2,4,1,1,3,1,2,4,1,4,4,1,1,1,3,4,1,1,4,4,0.5501196042201808,0,0,2,3,3,2.35,0,3,2,1,1,1,1,1,1,1,1,3,2,1,2,2,3,2,1,1,2,3,2,5,1,2,0,0,0,0,1,4,2,3,5,3,3,4,5,2,2,5,1,4,1,1,1,1,3,5,5,1,1,1,1,2,1,1,2,1,1,2,2,1,1,1,1,1,3,1,1,1.5250658431116428,1.6388149028228556,2.375,0,1.5,0,1.5333333333333334,0,3.3333333333333335,0,2.5833333333333335,0,1.1666666666666667,0,1.4285714285714286,0,1,0,2.189189189189189,0,1,0,0,0.22800678260133414,-0.23537159995413726,-0.22730066264678367,-0.23133613130046046,1,1,3,1,1,1,1,3,1,1.5735915849388864,1.2857142857142858,0,2,-0.40524523968696646,3,2,3,2,1,1,4,3,3,2,2,0.816496580927726,3,2.2857142857142856,0,-0.8792700537047221,0,-1.1637782466512998,1,1,1,1,1,5,5,5,5,3,5,4,5,5,5,5,5,5,2,3,1.7647338933351153,1,0,4.8,0,4,0,4.6,0,4.466666666666667,0,1,1,2,4,2,2,1,4,4,1,2,3,1,4,1,3,1,1,1,1,0.9403246919632545,2,0,"I lived with my father, but not mother, most of the time. & I lived with my mother and father an equal amount of time (joint custody)",1,"Asian or Asian American (e.g., Chinese, Japanese, and others)",0,21,0,1,NA,1,2,4,Student,2,230,76,2,5,2,0,0,1,0,0,TRUE,TRUE,TRUE,TRUE,TRUE,2,0.5382812500093133,0.538371874999255,0.5027593750059605,0.5823419354923309,0.5931968750059604,0.5919862069035399,1,1,1,1,1,0.90625,0.062,0.368,0.45,0.018,1.976,43.38192521104981,1898.336222620228,0.084,0.383,0.55,0.018,1.359,64.90749288054941,1847.5471891591797,0.071,0.395,0.517,0.028,1.776,78.83438641194995,1860.430312451325,109.77777777777779,75.5,63.42857142857143,FALSE,324,0.96,0,1,0,3,6,FALSE
188,2022-03-18T17:49:20Z,2022-03-18T18:08:37Z,1157,1,2022-03-18T18:08:39Z,1,Chrome,99.0.4844.51,Windows NT 10.0,1280,720,NA,1.7777777777777777,510,159,226,60,41,116,-0.34513743012283016,0.22697322064886183,-0.6733549716736644,-0.470096154866546,-0.40788447996231086,0.19576127074859423,2,2,4,3,3,2,3,3,2,2,2,4,4,3,4,2,3,2,3,3,0.8013147091860318,0,1,3,4,4,2.8,0,2,1,2,1,3,2,1,2,2,1,1,1,3,1,1,2,2,1,1,2,4,3,3,0,2,0,0,0,0,1,1,1,1,1,1,1,1,1,1,1,1,1,1,2,1,2,1,1,1,3,1,1,1,1,1,1,2,1,2,1,1,2,2,1,1,1,1,2,1,2,1.850655269066858,1.5886502207249789,2.25,0,1.5,0,1.6,0,1,0,1.3333333333333333,0,1,0,1.5714285714285714,0,1,0,1.2162162162162162,0,0,0,0,-0.4847862896858096,-0.685640437855164,-0.4466634660828154,-0.5661519519689897,1,1,1,1,1,2,1,2,1,1.889822365046136,1.1428571428571428,0,1.5,-0.6815819506204519,5,5,5,5,4,2,5,6,8,6,3,1.6761634196950514,7,4.428571428571429,0,1.0417609922763496,0,1.1673417508189108,3,4,3,2,2,1,5,3,4,4,5,5,3,4,5,3,5,4,4,2,1.2909944487358056,2.8,0,4,0,3.8,0,3.6,0,3.8,0,3,2,3,3,4,3,3,1,3,3,2,2,1,2,1,1,3,3,3,3,0.8506963092234007,2.45,0,NA,NA,"White, Caucasian, Anglo, European American",0,26,1,2,NA,1,3,4,"Artist + various ""side gigs"" [I'm disabled and can't work, for the most part]",1,190,64,1,5,2,0,1,1,0,1,TRUE,TRUE,TRUE,TRUE,TRUE,3,0.6573875000029802,0.5926499999966472,0.6057843750007451,0.7290031250026077,0.6581468749959022,0.7228354838759669,1,1,1,1,1,1,0.131,0.396,0.609,0.01,1.367,27.4683070693028,1811.388243238814,0.129,0.371,0.575,0.024,1.545,83.51403026563915,1870.819901463976,0.126,0.38,0.491,0.014,1.535,49.00174764472846,1832.1402235608969,136.7,64.375,109.64285714285714,FALSE,358,1.0607407407407408,0,1,0,0,3,FALSE
190,2022-03-18T17:50:46Z,2022-03-18T18:10:03Z,1157,1,2022-03-18T18:10:04Z,0.8999999761581421,Chrome,99.0.4844.51,Macintosh,1440,900,n/a,1.6,486,186,243,52,32,106,-0.3944838246471007,0.37606062422487474,-0.6115893888650507,-0.5687574818508689,-0.5924373208503674,0.08337904509483783,3,3,3,1,3,1,2,3,1,3,2,2,1,2,3,3,1,1,3,2,0.6708203932499369,0,1,1,5,5,2.15,0,4,1,1,1,1,2,1,2,1,1,2,3,3,2,3,1,1,1,1,1,2,1,1,0,2,0,0,0,0,2,2,1,1,1,1,1,1,1,1,1,1,1,2,1,1,1,1,1,1,2,1,1,1,1,1,1,1,1,1,1,1,1,1,1,1,1,1,1,1,1,1.8647995810481826,1.4960264830861913,1.125,0,1,0,1.8666666666666667,0,1.2222222222222223,0,1.1666666666666667,0,1,0,1,0,1,0,1.1081081081081081,0,0,0,0,-1.285307740100602,-1.1075892440209876,-0.6189692744445258,-0.8632792592327567,1,1,1,2,1,1,1,1,1,1.889822365046136,1.1428571428571428,0,1,-0.874984074548163,5,5,5,5,4,4,5,8,7,6,4,1.4638501094227998,7.5,4.714285714285714,0,1.475286511749183,0,1.5862029498683978,2,3,3,2,3,4,3,4,5,3,4,2,3,3,3,3,3,4,2,4,0.6324555320336759,2.6,0,3.4,0,2.8,0,3.8,0,3.3333333333333335,0,1,1,2,2,2,1,2,2,1,2,2,3,1,2,1,3,1,2,3,2,0.6958523739384593,1.8,0,I lived with my mother and father an equal amount of time (joint custody),0,"White, Caucasian, Anglo, European American",0,30,0,1,NA,1,3,6,Personal Trainer,3,195,70,4,5,2,0,0,1,0,0,TRUE,TRUE,TRUE,TRUE,TRUE,4,0.6609531249998836,0.6364531249996508,0.6071375000001863,0.7704466666668653,0.6298781249996973,0.7117656249997671,1,1,1,0.9375,1,1,0.13,0.275,0.413,0.02,1.843,74.09062406541318,1857.5313221180813,0.187,0.231,0.475,0.152,1.884,79.98624414550298,1863.0203360665018,0.107,0.267,0.297,0.009,1.919,170.38894761747855,2019.821949754513,92.14999999999999,12.394736842105262,213.22222222222223,FALSE,325,0.9629629629629629,0,1,0,3,6,FALSE
192,2022-03-18T17:47:46Z,2022-03-18T18:12:42Z,1495,1,2022-03-18T18:12:43Z,1,Firefox,98.0,Windows NT 10.0,1366,768,NA,1.7786458333333333,799,57,273,55,32,66,0.2490754039402607,-0.33624585952718705,-0.5025913015557322,-0.5317594842317478,-0.5924373208503674,-0.3661498575201878,1,1,2,2,1,1,1,3,1,2,3,1,2,2,2,3,1,1,2,3,1.0399898784932577,0,0,2,3,2,1.75,0,2,2,4,2,3,3,1,2,3,2,1,2,3,2,2,1,3,1,2,2,2,2,2,6,1,1,0,0,0,1,2,5,2,3,1,3,4,3,2,2,2,1,3,3,3,3,2,1,4,3,2,3,5,1,1,1,1,5,5,5,2,3,2,2,2,2,1,4,4,4,1.3495633817354862,1.0465362369445672,1.875,0,3.25,0,2.2666666666666666,0,2.6666666666666665,0,2.4166666666666665,0,2.1666666666666665,0,3.2857142857142856,0,2,0,2.5675675675675675,0,3,0,0,0.14905124228645034,0.031702032659793815,0.8144952734912662,0.42309865307552996,2,2,3,2,2,2,3,4,3,0.7867957924694432,2.2857142857142856,0,3.5,0.755503241136586,4,4,4,3,1,1,3,3,9,NA,3,1.3451854182690985,6,2.857142857142857,0,0.40966740893729353,1,-0.06908925119035642,3,3,3,4,3,1,3,2,3,3,3,3,2,4,5,4,3,3,4,1,0.9102589898327995,3.2,0,2.6,0,3.2,0,3,0,2.933333333333333,0,1,4,4,3,4,4,4,3,3,1,2,3,3,4,1,3,1,4,2,4,1.2182817926554552,2.9,0,"I lived with my mother, but not father, most of the time.",0,"Black or African American & White, Caucasian, Anglo, European American",1,25,0,1,NA,1,2,3,n/a,2,145,72,2,5,2,0,0,1,0,0,TRUE,TRUE,TRUE,TRUE,TRUE,1,0.5108125,0.4778125,0.4888064516129032,0.5875555555555556,0.5435714285714286,0.5771785714285714,1,1,0.96875,0.84375,0.875,0.875,0.05,0.403,0.613,0.006,1.115,104.3491035910486,2051.823637795181,0.057,0.365,0.564,0.02,1.809,50.923004486053635,1916.5046108518982,0.055,0.393,0.535,0.013,1.602,102.17666993543676,1963.651787050173,185.83333333333331,90.44999999999999,123.23076923076924,FALSE,282,0.8355555555555556,0,1,0,0,3,FALSE
193,2022-03-18T17:57:24Z,2022-03-18T18:12:46Z,921,1,2022-03-18T18:12:47Z,0.8999999761581421,Chrome,99.0.4844.74,Windows NT 10.0,1920,1080,NA,1.7777777777777777,569,52,152,28,20,59,-0.22382754358399845,-0.3638546379671895,-0.9422169203699833,-0.8647414628038378,-0.8385077753677761,-0.4448174154778173,1,1,2,1,2,2,3,1,1,2,2,3,2,2,1,2,3,2,2,2,0.910465468000326,0,1,1,4,3,1.85,0,5,3,4,2,5,1,5,4,5,4,2,2,2,4,3,5,4,1,1,5,5,5,5,1,2,0,0,0,0,2,3,3,2,2,3,2,2,3,4,3,3,5,3,5,3,3,4,5,3,5,2,1,1,1,1,1,1,3,1,1,1,1,1,1,1,4,1,5,3,4,1.456063226690421,1.4142135623730951,3.875,0,3.25,0,3.4,0,2.4444444444444446,0,3.8333333333333335,0,1.1666666666666667,0,1.2857142857142858,0,2,0,2.4324324324324325,0,1,0,0,1.3597028604479988,1.3407168328647445,0.37576966661920275,0.8582432497419736,1,1,2,1,1,1,1,3,2,1.7320508075688772,1.1428571428571428,0,2.5,-0.2947777027650296,5,5,5,5,5,5,5,6,6,5,5,1.5118578920369088,6,5,0,1.333727119069949,0,1.654785958462801,3,2,4,5,5,3,4,1,3,4,3,2,2,3,5,1,3,2,2,4,1.0600988273786194,3.8,0,2.6,0,2.6,0,3.2,0,2.8,0,3,2,3,3,3,1,3,4,2,2,2,2,1,2,3,2,2,2,3,2,0.7163503994113789,2.35,0,I lived with my mother and father an equal amount of time (joint custody),0,"White, Caucasian, Anglo, European American",0,25,1,2,NA,1,3,5,Teacher,3,112,65,3,5,2,0,0,1,0,0,TRUE,TRUE,TRUE,TRUE,TRUE,6,0.471762499999988,0.41039354838711406,0.4614312500000051,0.5078483870967607,0.49318076923078086,0.5640107142857056,1,1,1,0.96875,0.8125,0.9032258064516129,0.063,0.341,0.51,0.012,1.534,34.07526608873931,1890.834981548631,0.048,0.288,0.37,0.014,1.656,69.62871997063569,1988.7458811226843,0.076,0.3,0.55,0.025,1.957,65.77201675134614,1889.306750444817,127.83333333333333,118.28571428571428,78.28,FALSE,305,0.9037037037037037,0,1,0,6,9,FALSE
194,2022-03-18T17:33:19Z,2022-03-18T18:12:47Z,2368,1,2022-03-18T18:12:48Z,0.8999999761581421,Chrome,99.0.4844.51,Windows NT 10.0,1280,720,no,1.7777777777777777,878,114,728,162,91,244,0.4115072859159845,-0.021505785311159747,1.150546355968931,0.7878357641835715,0.617409080526892,1.6342537591166761,4,4,4,4,4,1,2,4,1,4,4,1,2,1,3,3,2,1,4,4,0.9445132413883326,0,1,1,3,3,2.85,0,2,2,4,2,3,3,3,4,3,3,5,3,2,3,4,2,2,1,1,2,1,1,1,5,2,0,0,0,0,3,5,5,2,3,4,3,3,4,5,3,3,2,3,3,3,4,3,3,3,3,1,1,1,1,5,2,2,3,3,1,1,1,1,1,5,1,2,2,2,3,1.3169032744413063,0.816496580927726,1.375,0,2.25,0,3.066666666666667,0,3.5555555555555554,0,3.1666666666666665,0,1.8333333333333333,0,1.7142857142857142,0,2.3333333333333335,0,2.7027027027027026,0,3,0,0,-0.08781537865820048,0.22168224555011581,0.4698836567678454,0.3457829511589806,1,1,2,1,1,1,1,4,3,1.7320508075688772,1.1428571428571428,0,3.5,0.0920265450903926,5,5,5,5,2,3,4,3,3,3,3,1.4638501094227998,3,4.142857142857143,0,-0.3222341343576166,0,0.18174126965160067,2,2,2,3,3,3,2,4,5,3,5,3,4,5,5,2,4,4,3,2,1.2798809468443688,2.4,0,3.8,0,2.8,0,4.2,0,3.6,0,2,3,4,2,4,4,4,2,1,1,1,3,2,1,2,3,1,2,2,4,1.142481141154959,2.4,0,I lived with my mother and father an equal amount of time (joint custody),0,"White, Caucasian, Anglo, European American",0,26,1,1,NA,1,2,6,graphic designer,2,170,69,2,5,2,0,0,1,0,0,TRUE,TRUE,TRUE,TRUE,TRUE,6,0.5778593750093133,0.5368599999984105,0.686024999992922,0.6544548387046784,0.5803034482762731,0.7041033333341281,1,1,1,1,0.90625,0.967741935483871,0.089,0.375,0.274,0.029,1.839,138.09003189122086,1963.1848636072075,0.067,0.348,0.494,0.01,1.497,97.97197969962404,1951.2168634844268,0.176,0.317,0.755,0.017,1.516,75.00593862153448,1863.7428589502613,63.41379310344827,149.70000000000002,89.17647058823529,FALSE,382,1.1318518518518519,0,1,0,0,3,FALSE
195,2022-03-18T17:29:07Z,2022-03-18T18:13:06Z,2639,1,2022-03-18T18:13:07Z,0.8999999761581421,Chrome,99.0.4844.74,Windows NT 10.0,1536,864,"i lived in a well off home with a mentally unstable parent that made my life hell. I was verbally and physically abused constantly and never felt that my home was a safe or stable place to be in. However, it was a well taken care of home and i was clothed and mostly fed, although the taking away of food was a constant punishment. Nothing in my room was actually mine and my things were gone through constantly.",1.7777777777777777,1407,57,217,35,31,74,1.4991840652217805,-0.33624585952718705,-0.70605439786646,-0.7784128016925552,-0.6129431920601515,-0.2762440769971827,3,3,3,3,4,1,1,3,1,3,3,2,1,2,4,4,1,1,4,4,0.6863327411532597,1,1,1,5,5,2.55,0,5,2,3,3,1,1,5,5,1,2,5,5,1,3,3,3,5,1,1,5,5,5,5,1,2,0,0,0,0,3,3,2,3,3,3,1,1,3,1,2,5,1,2,1,1,5,5,5,5,5,4,1,2,1,1,1,1,1,3,1,1,1,1,2,1,5,1,5,1,3,1.6796789339993883,1.4960264830861913,3.75,0,2.5,0,3,0,2.4444444444444446,0,3.1666666666666665,0,1.6666666666666667,0,1.2857142857142858,0,2.6666666666666665,0,2.3513513513513513,0,1,0,0,1.2259170838033346,1.076101536338939,0.11731095407663712,0.596706245207788,1,1,1,1,1,1,1,1,3,1.9518001458970664,1,0,2,-0.571114413698515,5,5,5,5,4,3,4,7,8,4,4,1.2149857925879117,7.5,4.428571428571429,0,1.0476359070895207,0,1.1709200998354665,2,2,2,2,2,4,5,5,5,5,3,5,5,5,5,5,5,5,5,5,1.9444671200491874,2,0,4.4,0,5,0,5,0,4.8,0,2,4,4,4,4,4,4,3,3,2,1,3,3,4,1,4,2,4,3,1,1.231174022502185,3,0,I lived with my mother and father an equal amount of time (joint custody),0,"White, Caucasian, Anglo, European American",0,20,1,2,NA,1,3,4,student,7,110,67,2,5,2,0,0,1,0,0,TRUE,TRUE,TRUE,TRUE,TRUE,4,0.5312193548393346,0.459996666666617,0.5026666666664183,0.6204807692301961,0.4833892857144986,0.5339137931029344,0.96875,0.9375,0.967741935483871,0.8125,0.9032258064516129,0.90625,0.046,0.393,0.36,0.074,1.728,168.1074536878107,2102.021687220908,0.036,0.369,0.417,0.027,1.553,184.93833848942703,2131.8138575985186,0.057,0.361,0.279,0.011,1.533,165.6776358265255,2173.6824779193576,23.35135135135135,57.51851851851852,139.36363636363637,FALSE,386,1.1437037037037037,0,1,0,0,3,FALSE
196,2022-03-18T17:59:32Z,2022-03-18T18:13:21Z,828,1,2022-03-18T18:13:21Z,0.8999999761581421,Chrome,99.0.4844.51,Macintosh,1280,800,NA,1.6,439,41,193,43,30,53,-0.49112051392379713,-0.4245939505351947,-0.7932528677139148,-0.6797514747082323,-0.6334490632699356,-0.5122467508700711,3,2,3,2,2,1,3,2,1,2,2,1,3,1,2,2,2,1,2,2,0.8750939799154206,0,1,1,5,5,1.95,0,3,1,2,1,3,3,2,4,4,2,3,3,4,2,2,3,3,2,2,2,2,3,1,5,1,2,0,0,0,2,2,2,2,2,1,1,1,1,2,2,4,2,2,3,2,2,4,2,4,4,3,1,1,1,1,1,1,4,4,4,1,1,1,1,1,1,2,2,2,2,1.518158359593888,0.9154754164341269,2.25,0,2,0,2.6,0,1.5555555555555556,0,2.75,0,1.3333333333333333,0,2.2857142857142856,0,1,0,2,0,3,0,0,0.024038303454551324,0.09316043486292559,0.3837307525869902,0.23844559372495788,1,2,2,2,2,2,2,1,1,1.2535663410560174,1.8571428571428572,0,1,-0.4603111395192921,5,5,5,5,3,3,4,8,7,3,3,1.2909944487358056,7.5,4.285714285714286,0,0.49059998774241514,0,0.7542326864206916,2,2,2,2,2,4,4,4,4,4,4,2,4,4,4,5,4,4,4,2,1.1254628677422756,2,0,3.6,0,4.2,0,3.6,0,3.8,0,2,1,1,3,2,2,1,2,1,1,1,1,2,1,2,1,2,1,1,1,0.9665456669582609,1.45,0,I lived with my mother and father an equal amount of time (joint custody),0,"Asian or Asian American (e.g., Chinese, Japanese, and others)",0,22,1,2,NA,1,3,8,Assistant manager,3,112,66,2,5,2,0,0,1,0,0,TRUE,TRUE,TRUE,TRUE,TRUE,3,0.4996451612903226,0.3927064516111728,0.41350312500074504,0.5792555555579839,0.4794799999988079,0.4793391304353009,1,1,1,0.84375,0.78125,0.7419354838709677,0.047,0.311,0.481,0.01,1.404,112.19654700910354,2088.8023400271168,0.057,0.295,0.623,0.013,1.7,92.76870066621893,1998.2359924008904,0.057,0.351,0.44,0.012,1.622,67.44044353661474,1929.024729815317,140.39999999999998,130.76923076923077,135.16666666666669,FALSE,390,1.1555555555555557,0,1,0,3,6,FALSE
197,2022-03-18T17:00:24Z,2022-03-18T18:13:29Z,4385,1,2022-03-18T18:13:31Z,0.8999999761581421,Chrome,99.0.4844.74,Windows NT 10.0,1920,1080,No,1.7777777777777777,474,73,421,116,56,71,-0.4191570219092359,-0.24789776851917938,0.03513259583690549,0.22053313402371458,-0.10029641181555002,-0.3099587446933096,3,3,2,1,4,1,1,4,1,3,4,2,1,1,3,4,2,2,4,4,0.5026246899500346,0,0,3,3,2,2.5,0,4,3,5,2,5,3,5,4,4,4,2,4,1,5,5,4,4,3,1,3,4,4,4,4,2,0,0,0,0,4,3,2,4,2,2,2,2,4,1,2,4,2,4,3,2,4,5,5,5,5,5,4,4,2,3,3,1,3,1,1,3,4,2,1,1,3,3,3,2,1,1.322591867980916,1.4735767952260144,3.375,0,2.25,0,3.7333333333333334,0,2.7777777777777777,0,3.5,0,3.5,0,2.142857142857143,0,1.6666666666666667,0,2.918918918918919,0,2,0,0,1.3509300226352343,1.4803503226702603,0.2505208533318137,0.865435588001037,4,2,4,2,1,4,4,1,1,1.1338934190276817,3,0,1,0.20316555652690138,2,3,5,3,1,3,3,3,3,2,2,1.2149857925879117,3,2.857142857142857,0,-0.8792700537047221,0,-0.8541675456885912,1,2,1,2,1,5,3,5,5,3,5,4,5,3,4,2,4,3,3,2,1.2909944487358056,1.4,0,4.2,0,3.2,0,3.8,0,3.7333333333333334,0,3,2,3,4,4,3,4,3,3,1,4,4,2,1,2,3,2,2,2,3,0.9880869341680844,2.75,0,I lived with my mother and father an equal amount of time (joint custody),0,"Hispanic of Latino (e.g., Mexican American, Central American, and others) & White, Caucasian, Anglo, European American",1,30,1,2,NA,1,2,2,none,1,126,67,1,5,2,1,0,1,0,1,TRUE,TRUE,TRUE,TRUE,TRUE,6,0.5806354838667377,0.5534968749973923,0.5037874999959022,0.5778124999888241,0.5602741935387734,0.5568781249970197,1,1,1,1,1,1,0.19,0.219,0.688,0.014,1.248,102.13252583673223,1884.2814681229586,0.119,0.332,0.559,0.091,1.736,98.09239848924064,1886.6282845187407,0.154,0.275,0.51,0.228,1.825,190.92989738974984,1972.3065696427673,89.14285714285714,19.076923076923077,8.00438596491228,FALSE,304,0.9007407407407407,1,1,0,3,6,FALSE
198,2022-03-18T17:38:20Z,2022-03-18T18:13:31Z,2110,1,2022-03-18T18:13:32Z,0.8999999761581421,Chrome,99.0.4844.74,Windows NT 10.0,1920,1080,None,1.7777777777777777,524,119,513,116,72,98,-0.3163520333170057,0.006102993128842652,0.36939339691881545,0.22053313402371458,0.2277975275409949,-0.0065267354281672955,3,2,3,2,3,1,2,4,1,3,3,1,2,2,4,4,1,1,4,3,0.6708203932499369,0,1,1,3,1,2.45,0,3,1,1,3,4,3,3,2,2,3,1,3,2,3,5,2,3,5,1,2,2,2,2,2,1,0,0,1,1,3,3,1,1,2,1,2,2,1,2,2,1,1,2,2,4,3,1,1,1,4,4,2,1,2,4,3,2,2,1,1,1,1,1,1,2,1,1,2,1,1,1.4632638658632766,1.121223821162776,2.375,0,1.25,0,2.6,0,1.7777777777777777,0,2,0,2.6666666666666665,0,1.2857142857142858,0,1.3333333333333333,0,1.864864864864865,0,1,1,0,0.017458675094977723,0.08873542990430049,0.3859114446228456,0.23732343726357305,1,2,3,1,1,2,2,1,1,1.3801311186847085,1.7142857142857142,0,1,-0.5432457265250663,5,4,4,4,2,2,3,3,3,2,2,1.1338934190276817,3,3.4285714285714284,0,-0.8792700537047221,0,-0.5445568447258828,3,3,3,2,2,4,4,4,4,3,4,4,4,3,3,4,3,4,3,3,0.7237468644557459,2.6,0,3.8,0,3.6,0,3.4,0,3.6,0,2,2,3,3,4,3,3,3,2,1,2,3,1,2,1,3,2,3,2,3,0.7677718959499145,2.4,0,"I lived with my mother, but not father, most of the time.",0,"White, Caucasian, Anglo, European American",0,27,1,2,NA,1,2,6,unemployed,1,120,62,1,5,2,0,0,1,0,0,TRUE,TRUE,TRUE,TRUE,TRUE,5,0.6310100000063579,0.5084483871075415,0.5679718750007451,0.6625312500037253,0.5503281250111759,0.6201312499940396,0.967741935483871,1,1,1,1,1,0.103,0.402,0.654,0.033,2.004,22.589466232469707,1804.387852473959,0.079,0.396,0.743,0.039,1.858,22.45273215528336,1805.9895232287054,0.207,0.321,0.69,0.028,1.395,154.89599622345833,1980.438806674525,60.72727272727273,47.64102564102564,49.82142857142857,FALSE,342,1.0133333333333332,0,0,0,0,3,FALSE
199,2022-03-18T17:57:01Z,2022-03-18T18:13:55Z,1014,1,2022-03-18T18:13:56Z,0.8999999761581421,Chrome,99.0.4844.74,Windows NT 10.0,1366,768,no,1.7786458333333333,474,55,276,55,31,79,-0.4191570219092359,-0.347289370903188,-0.4916914928248004,-0.5317594842317478,-0.6129431920601515,-0.22005296417030445,3,3,2,2,3,1,1,3,1,3,3,1,1,1,3,3,1,1,4,4,0.512989176042577,0,0,1,3,2,2.2,0,3,2,4,2,2,1,5,1,1,1,1,5,1,4,1,2,1,5,1,1,3,1,3,4,2,0,0,0,0,1,2,4,1,1,1,1,1,1,2,5,4,1,4,2,2,1,3,5,4,2,5,1,1,2,1,1,1,1,2,1,1,1,1,1,2,2,2,2,1,1,1.65763317647414,1.4573295865416045,2.125,0,1.5,0,2.2666666666666666,0,1.4444444444444444,0,2.9166666666666665,0,1.8333333333333333,0,1.1428571428571428,0,1.6666666666666667,0,1.945945945945946,0,2,0,0,-0.09220179756458308,-0.13054814915647484,-0.007937859210751935,-0.06924300418361339,3,3,3,2,1,2,1,1,1,0.8997354108424374,2.142857142857143,0,1,-0.29444196550774376,2,5,5,5,1,1,2,3,3,3,2,1.889822365046136,3,3,0,-0.665444751374891,0,-0.6465261206721256,2,2,2,2,2,4,2,4,4,2,4,4,4,5,4,4,4,4,3,4,1.0465362369445672,2,0,4,0,3,0,4.2,0,3.7333333333333334,0,2,2,1,2,3,1,1,2,1,1,2,2,2,1,1,2,1,1,1,1,0.8645047258706176,1.5,0,"I lived with my mother, but not father, most of the time.",0,"White, Caucasian, Anglo, European American",0,27,1,2,NA,1,2,5,GIS Tech,1,145,66,4,5,2,0,0,2,0,0,TRUE,TRUE,TRUE,TRUE,TRUE,5,0.5177064516044432,0.4761562500037253,0.50196875,0.5942799999992053,0.5667906249761582,0.5707566666642825,1,1,1,0.9375,1,0.9375,0.058,0.362,0.381,0.021,1.601,220.94356518198646,2089.769049519468,0.117,0.337,0.889,0.015,1.618,48.26368911974838,1836.4735176895874,0.064,0.37,0.403,0.026,1.953,66.68586312917924,1910.135896116187,76.23809523809523,107.86666666666667,75.11538461538463,FALSE,412,1.2207407407407407,0,0,0,0,3,FALSE
200,2022-03-18T17:57:14Z,2022-03-18T18:14:31Z,1036,1,2022-03-18T18:14:32Z,1,Chrome,98.0.4758.109,Macintosh,1440,900,NA,1.6,452,53,263,126,35,60,-0.46439121688981727,-0.35833288227918897,-0.538923997325505,0.34385979275411827,-0.5309197072210152,-0.4335791929124416,2,2,2,2,2,1,2,2,1,2,3,1,2,2,2,2,1,1,2,2,0.8335087534664907,0,0,2,4,3,1.8,0,2,3,4,2,3,3,3,3,4,3,3,3,2,4,3,2,4,1,1,2,3,3,3,7,2,0,0,0,0,3,4,4,2,3,2,4,3,3,2,2,4,1,3,4,4,4,3,4,4,4,3,1,1,1,1,2,1,4,3,3,3,4,3,1,2,2,3,2,3,3,1.1021409686218524,0.6399404734221844,2.375,0,2.75,0,3,0,3.111111111111111,0,3.25,0,1.5,0,3,0,1.6666666666666667,0,2.7567567567567566,0,4,0,0,0.596465970737457,0.6527760619637649,0.8615522685655875,0.7571641652646762,1,1,3,1,1,2,1,4,1,1.5275252316519468,1.4285714285714286,0,2.5,-0.12890852875348124,4,3,5,4,2,1,3,6,3,4,3,1.3451854182690985,4.5,3.142857142857143,0,0.1625358753388918,0,-0.06480912674787956,2,2,2,3,2,4,4,4,4,3,4,4,3,3,5,2,3,4,3,4,0.9611501047232549,2.2,0,3.8,0,3,0,4,0,3.6,0,2,3,4,3,4,4,4,3,2,3,3,3,2,4,2,2,2,2,4,4,0.9119095061289915,3,0,I lived with my mother and father an equal amount of time (joint custody),0,"White, Caucasian, Anglo, European American",0,24,1,2,NA,1,2,6,unemployed,1,170,67,2,5,2,0,0,1,0,0,TRUE,TRUE,TRUE,TRUE,TRUE,3,0.48695806451382173,0.4061906249914318,0.4454187500011176,0.5676571428711925,0.509751851843463,0.5541434782665708,0.96875,1,1,0.875,0.84375,0.71875,0.053,0.349,0.538,0.013,1.947,126.64510405309835,2057.625578167522,0.055,0.307,0.59,0.01,1.441,112.96330496939011,1987.6396299859018,0.058,0.347,0.468,0.014,1.939,108.26321400024061,2015.8361339383266,149.76923076923077,144.1,138.5,FALSE,412,1.2207407407407407,0,1,0,3,6,FALSE
201,2022-03-18T17:52:05Z,2022-03-18T18:15:31Z,1405,1,2022-03-18T18:15:31Z,0.8999999761581421,Chrome,99.0.4844.51,Macintosh,1440,900,no,1.6,546,400,222,52,35,60,-0.2711178383364244,1.5577163414569772,-0.6878880499815736,-0.5687574818508689,-0.5309197072210152,-0.4335791929124416,2,2,2,2,2,1,1,2,2,2,2,2,2,2,2,2,2,2,2,2,0.6805570473787206,0,1,2,4,4,1.9,0,2,2,3,2,3,2,3,2,2,2,2,2,3,3,3,1,1,1,1,1,1,1,1,1,2,0,0,0,0,2,2,2,2,2,1,1,1,1,2,2,2,1,2,2,1,2,2,2,2,2,2,1,1,1,1,1,2,2,2,1,2,2,2,1,1,1,2,2,2,2,1.4596679864375428,0.7988086367179802,1,0,2,0,2.4,0,1.5555555555555556,0,1.8333333333333333,0,1.1666666666666667,0,1.8571428571428572,0,1,0,1.5945945945945945,0,1,0,0,-1.050634328609142,-0.7169104728961178,-0.05499485428507328,-0.38595266359059555,1,2,2,2,2,1,1,1,1,1.5118578920369088,1.5714285714285714,0,1,-0.6261803135308405,4,4,4,4,4,3,4,4,4,6,4,0.7867957924694432,4,3.857142857142857,0,0.8430821945602693,0,0.7367178772355684,2,3,3,3,3,3,3,3,3,3,4,3,4,3,3,4,3,4,3,3,0.45773770821706344,2.8,0,3.4,0,3.4,0,3,0,3.2666666666666666,0,1,1,1,2,2,1,1,2,1,1,1,2,1,1,1,2,1,1,1,1,0.8255779474818965,1.25,0,I lived with my mother and father an equal amount of time (joint custody),0,"White, Caucasian, Anglo, European American",0,25,1,2,NA,1,4,6,Marketing Project Manager,4,110,64,5,5,2,0,0,1,0,0,TRUE,TRUE,TRUE,TRUE,TRUE,6,0.5807129032265755,0.4897937500048429,0.648390625005588,0.612983870967742,0.5688193548379405,0.7722633333305517,0.96875,1,1,0.96875,1,0.9375,0.07,0.41,0.289,0.024,2.072,102.14937985814046,1945.9947891596357,0.091,0.325,0.578,0.021,1.855,77.95467832029351,1866.7079861501245,0.058,0.38,0.303,0.019,1.53,85.24946548422798,1949.516353643192,86.33333333333333,88.33333333333333,80.52631578947368,FALSE,424,1.2562962962962962,0,1,0,3,6,FALSE
202,2022-03-18T17:55:05Z,2022-03-18T18:15:38Z,1232,1,2022-03-18T18:15:39Z,0.8999999761581421,Chrome,99.0.4844.51,Macintosh,1440,900,NA,1.6,546,70,267,78,106,120,-0.2711178383364244,-0.26446303558318085,-0.5243909190175959,-0.24810816915181938,0.9249971486736528,0.2407141610100968,1,1,1,2,2,1,1,2,1,1,2,1,1,1,1,1,1,1,2,2,1.3018205875255096,0,1,2,2,1,1.3,0,2,1,2,1,2,1,1,1,1,1,1,1,1,1,1,1,1,1,1,1,1,1,1,0,2,0,0,0,0,1,1,1,1,1,1,1,1,1,1,1,2,1,1,1,1,1,1,1,1,3,1,1,1,1,1,1,1,1,1,1,1,1,1,1,1,1,2,1,1,1,1.935910056729844,1.9073791542572855,1,0,1.25,0,1.2,0,1,0,1.25,0,1,0,1,0,1,0,1.0810810810810811,0,0,0,0,-1.384002165494206,-1.465031311234404,-0.5328163702636706,-0.9989238407490373,1,1,3,1,1,1,1,2,1,1.5735915849388864,1.2857142857142858,0,1.5,-0.5986473636146776,5,5,5,5,3,2,5,3,3,6,3,1.7043362064926932,3,4.285714285714286,0,0.3192417726318768,0,0.6498601942196431,1,2,2,2,2,4,3,3,4,4,4,2,5,4,4,4,4,2,4,2,1.0690449676496976,1.8,0,3.2,0,4,0,3.4,0,3.533333333333333,0,1,1,1,1,2,1,1,1,1,1,2,1,1,1,1,1,1,1,1,1,1.2182817926554552,1.1,0,I lived with my mother and father an equal amount of time (joint custody),0,"White, Caucasian, Anglo, European American",0,20,0,1,NA,1,4,3,Student/ Part-time employee at Walmart,6,165,70,4,5,2,0,0,1,0,0,TRUE,TRUE,TRUE,TRUE,TRUE,3,0.5488937500016764,0.567890625005588,0.5285906249983237,0.705625806448921,0.7097656249990687,0.644628125003539,1,1,1,0.96875,1,1,0.102,0.304,0.47,0.017,2.01,35.55460344680299,1820.278200123844,0.107,0.31,0.404,0.012,1.745,41.96204445753849,1824.456212405289,0.087,0.384,0.555,0.007,1.398,34.01998413461976,1862.884346304036,118.23529411764704,145.41666666666669,199.7142857142857,FALSE,436,1.2918518518518518,0,1,0,0,3,FALSE
203,2022-03-18T17:52:39Z,2022-03-18T18:16:23Z,1423,1,2022-03-18T18:16:23Z,1,Firefox,98.0,Windows NT 10.0,1920,1080,Everything was easy to understand and answer thank you!,1.7777777777777777,531,133,331,139,62,61,-0.30195933491409344,0.08340757276084937,-0.29186166609104985,0.504184449103643,0.02273881544315432,-0.42234097034706597,1,2,1,1,2,1,2,2,1,2,2,1,1,1,2,2,1,1,2,3,1.050062654772261,0,1,1,3,3,1.55,0,3,1,2,2,1,2,1,3,2,1,2,2,1,2,2,2,2,1,1,1,1,2,2,0,2,0,0,0,0,1,1,2,1,1,1,1,1,1,1,1,2,1,1,2,1,1,2,1,3,3,1,1,1,1,1,1,1,1,1,1,1,1,1,1,1,1,1,1,1,1,1.8567303109087887,1.4074631010979937,1.5,0,1,0,1.8,0,1.1111111111111112,0,1.5833333333333333,0,1,0,1,0,1,0,1.2162162162162162,0,0,0,0,-0.9716787882942585,-0.9257707069432418,-0.6189692744445258,-0.7723699906938838,1,1,3,1,1,1,1,1,1,1.5735915849388864,1.2857142857142858,0,1,-0.7920494875423887,5,5,5,5,3,3,5,5,9,3,3,1.5735915849388864,7,4.428571428571429,0,0.4002850852868561,0,0.7766255014915452,2,3,3,1,2,4,5,5,4,3,5,3,5,3,3,5,4,4,5,4,1.3557637102737474,2.2,0,4,0,4.6,0,3.8,0,4.133333333333334,0,2,1,2,4,1,2,1,4,4,2,1,3,1,4,1,3,1,4,4,1,1.1652874052533586,2.3,0,I lived with my mother and father an equal amount of time (joint custody),0,"Hispanic of Latino (e.g., Mexican American, Central American, and others) & White, Caucasian, Anglo, European American",1,25,0,1,NA,1,3,3,Freelancer,4,185,67,4,5,2,0,0,1,0,0,TRUE,TRUE,TRUE,TRUE,TRUE,1,0.64540625,0.5456875,0.5535,0.6669677419354839,0.6049,0.6010322580645161,1,1,1,1,0.967741935483871,1,0.081,0.417,0.66,0.023,1.63,51.60105627531341,1833.2692427163083,0.069,0.377,0.422,0.028,2.065,91.80295215285119,1920.0252908232508,0.086,0.4,0.392,0.047,2.044,136.4780289604191,1921.4792595099502,70.8695652173913,73.75,43.48936170212766,FALSE,398,1.1792592592592592,0,1,0,0,3,FALSE
205,2022-03-18T18:01:15Z,2022-03-18T18:16:39Z,924,1,2022-03-18T18:16:40Z,0.8999999761581421,Chrome,99.0.4844.74,Macintosh,1440,900,nope,1.6,465,65,173,66,40,66,-0.4376619198558374,-0.2920718140231832,-0.8659182592534604,-0.3961001596283038,-0.42839035117209495,-0.3661498575201878,3,3,4,3,3,1,2,3,1,3,3,2,3,2,3,3,1,1,3,3,0.7254762501100116,0,1,1,3,3,2.5,0,1,1,1,1,1,1,1,1,1,1,1,1,1,1,1,1,1,1,1,1,1,1,1,0,2,0,0,0,0,1,1,1,1,1,1,1,1,1,1,1,1,1,1,1,1,1,1,1,1,1,1,1,1,1,1,1,1,1,1,1,1,1,1,1,1,1,1,1,1,1,1.9666895707934864,2.065591117977289,1,0,1,0,1,0,1,0,1,0,1,0,1,0,1,0,1,0,0,0,0,-1.4366391923707953,-1.587751448753618,-0.6189692744445258,-1.103360361599072,1,1,1,1,1,1,1,1,1,1.9518001458970664,1,0,1,-0.9579186615539372,5,5,5,5,3,3,5,6,6,6,4,1.5735915849388864,6,4.428571428571429,0,1.2043418043825058,0,1.2663680188775723,2,2,3,3,2,4,4,4,4,4,5,4,3,5,4,5,4,5,4,3,1.3345232785352157,2.4,0,4.4,0,4,0,4,0,4.133333333333334,0,1,1,1,1,2,1,1,2,1,1,1,1,2,1,1,1,1,1,1,1,1.1367080817685316,1.15,0,I lived with my mother and father an equal amount of time (joint custody),0,"White, Caucasian, Anglo, European American",0,19,1,2,NA,1,4,4,Student,6,115,67,2,5,2,0,0,1,0,0,TRUE,TRUE,TRUE,TRUE,TRUE,6,0.531528124999255,0.4479580645164655,0.5222000000000961,0.6125785714276135,0.5228193548386616,0.5684032258062113,1,0.96875,1,0.875,0.96875,0.96875,0.064,0.375,0.425,0.051,2.071,101.1013332884216,1929.3802498192026,0.068,0.3,0.479,0.02,1.714,217.35195072945444,2087.1460781593114,0.062,0.349,0.367,0.013,1.681,50.230660179452606,1910.0970212716716,40.60784313725491,85.7,129.30769230769232,FALSE,438,1.2977777777777777,0,1,0,0,3,FALSE
206,2022-03-18T18:00:38Z,2022-03-18T18:16:45Z,966,1,2022-03-18T18:16:46Z,0.8999999761581421,Chrome,99.0.4844.74,Windows NT 10.0,1920,1080,NA,1.7777777777777777,492,72,221,47,25,57,-0.38214722601603307,-0.2534195242071799,-0.6915213195585509,-0.6304208112160707,-0.7359784193188558,-0.46729386060856853,1,1,1,1,1,1,1,3,1,1,2,1,1,1,1,1,1,1,1,2,1.4179302929937965,0,1,1,2,1,1.2,0,5,2,3,4,3,3,3,4,2,1,4,3,1,3,5,4,5,1,1,4,4,4,5,0,2,0,0,0,0,3,2,3,1,1,1,1,1,1,1,1,3,1,2,2,1,5,5,4,4,5,5,1,1,1,5,4,2,1,1,1,2,2,2,1,3,1,2,1,1,1,1.6796789339993883,1.1254628677422756,3.5,0,1.25,0,3.066666666666667,0,1.5555555555555556,0,2.8333333333333335,0,2.8333333333333335,0,1.5714285714285714,0,1.6666666666666667,0,2.189189189189189,0,0,0,0,0.9583455305140074,0.9252580339715715,-0.5328163702636706,0.19622083185395045,1,1,3,1,1,1,1,2,1,1.5735915849388864,1.2857142857142858,0,1.5,-0.5986473636146776,2,2,5,2,1,1,1,4,2,1,1,1.7182493859684491,3,2,0,-1.4363059730518277,0,-1.6578683353067516,2,2,2,3,2,4,3,3,5,3,5,4,2,5,5,4,3,3,3,2,1.2227992865708155,2.2,0,3.8,0,3,0,4,0,3.6,0,1,1,1,1,1,1,1,1,1,1,3,1,1,2,1,1,1,1,1,1,1.2513150976809202,1.15,0,I lived with my mother and father an equal amount of time (joint custody),0,"Hispanic of Latino (e.g., Mexican American, Central American, and others)",0,26,0,1,NA,1,3,6,Manager,4,175,72,3,5,2,0,0,1,0,0,TRUE,TRUE,TRUE,TRUE,TRUE,5,0.51721875,0.4770343750044703,0.5274218750037253,0.5932419354896392,0.5188699999948343,0.6053031250014901,1,1,1,0.96875,0.967741935483871,1,0.164,0.253,0.624,0.025,2.037,17.212180306901093,1799.8020668544045,0.062,0.33,0.481,0.03,1.841,310.5425787688696,2142.3754564903375,0.081,0.338,0.464,0.011,1.321,80.52187439100639,1906.306746666217,81.47999999999999,61.36666666666667,120.0909090909091,FALSE,298,0.882962962962963,0,1,0,0,3,FALSE
207,2022-03-18T17:59:12Z,2022-03-18T18:18:07Z,1135,1,2022-03-18T18:18:08Z,0.8999999761581421,Chrome,99.0.4844.74,Windows NT 10.0,1536,864,no feedback,1.7777777777777777,473,103,300,64,46,70,-0.42121312168108055,-0.08224509787916502,-0.40449302297734563,-0.4207654913743845,-0.3053551239133906,-0.32119696725868524,3,4,3,3,4,2,2,4,1,4,3,2,1,2,4,4,2,1,3,3,0.6708203932499369,0,0,1,3,2,2.75,0,4,2,3,3,2,1,2,3,3,1,3,3,1,3,4,1,3,1,1,2,5,4,3,0,2,0,0,0,0,2,2,3,3,3,1,1,2,4,3,3,4,2,3,3,3,4,4,4,4,4,3,1,1,1,1,1,1,1,3,1,3,4,3,1,1,3,1,2,1,2,1.272249432547965,0.990430401872025,2.5,0,1.5,0,2.533333333333333,0,2.3333333333333335,0,3.4166666666666665,0,1.3333333333333333,0,2.2857142857142856,0,1.6666666666666667,0,2.4594594594594597,0,0,0,0,0.4846122886247058,0.37380408268330795,-0.4466634660828154,-0.036429691699753713,2,2,3,1,1,2,2,1,1,1.0690449676496976,1.8571428571428572,0,1,-0.4603111395192921,5,3,5,5,3,3,3,5,5,NA,3,1.0690449676496976,5,3.857142857142857,0,0.13872270157061628,1,0.3076998949849121,2,2,2,3,2,3,5,4,4,3,2,3,3,5,5,5,3,3,5,5,1.3732131246511903,2.2,0,2.8,0,4.2,0,4.6,0,3.8666666666666667,0,1,1,4,3,4,4,4,4,4,3,4,4,2,4,2,3,1,4,3,4,1.292692009559488,3.15,0,I lived with my mother and father an equal amount of time (joint custody),0,"White, Caucasian, Anglo, European American",0,27,1,2,NA,1,2,4,food delivery,1,125,65,2,5,2,0,0,1,0,0,TRUE,TRUE,TRUE,TRUE,TRUE,2,0.6234468750022352,0.4529843750018626,0.48370000000111757,0.6954064516155951,0.5379812500048429,0.5568437500037253,1,1,1,0.96875,1,1,0.073,0.375,0.684,0.015,1.366,96.6029050363674,1878.5349707307278,0.065,0.359,0.67,0.009,1.055,44.53612409069618,1827.7503021483446,0.085,0.403,0.446,0.012,1.536,98.49706336280747,1931.9480628152066,91.06666666666668,117.22222222222223,128,FALSE,384,1.1377777777777778,0,1,0,0,3,FALSE
208,2022-03-18T17:56:55Z,2022-03-18T18:18:17Z,1282,1,2022-03-18T18:18:18Z,1,Safari,13.1.2,Macintosh,1440,900,NA,1.6,603,102,314,60,39,76,-0.1539201513412819,-0.0877668535671655,-0.3536272488996637,-0.470096154866546,-0.448896222381879,-0.25376763186643136,3,3,1,1,3,1,1,3,1,2,4,1,1,1,2,2,1,1,3,3,0.7539370349250519,0,1,2,2,1,1.9,0,4,3,4,4,3,4,4,3,3,3,4,4,2,4,4,2,3,1,1,2,3,4,3,6,2,0,0,0,0,2,2,3,4,3,2,3,3,4,1,2,3,1,3,3,4,2,3,4,3,3,4,1,1,1,2,1,1,3,1,1,4,3,3,2,2,2,2,2,3,1,1.0097125925329047,0.7988086367179802,2.375,0,2,0,3.533333333333333,0,2.888888888888889,0,2.6666666666666665,0,1.6666666666666667,0,2.2857142857142856,0,2,0,2.4324324324324325,0,3,0,0,0.38591786323110117,0.7440294975549755,0.3837307525869902,0.5638801250709828,3,2,3,2,1,2,1,1,1,0.816496580927726,2,0,1,-0.3773765525135179,4,3,3,4,2,3,4,7,2,3,3,0.816496580927726,4.5,3.2857142857142856,0,-0.05128942699093936,0,-0.117645201282991,2,3,2,3,3,4,4,4,4,3,5,4,3,3,3,1,4,5,2,3,1.1464230084422218,2.6,0,4.4,0,2.6,0,3.4,0,3.466666666666667,0,1,2,2,3,2,2,2,2,1,1,2,3,2,3,1,3,2,2,2,2,0.5525062514530825,2,0,I lived with my mother and father an equal amount of time (joint custody),0,"White, Caucasian, Anglo, European American",0,22,1,2,NA,1,3,6,N/A,2,118,66,1,5,2,0,0,0,0,0,TRUE,TRUE,TRUE,TRUE,TRUE,2,0.5145161290322562,0.4465937500000109,0.4933225806451622,0.6332666666666686,0.5612999999999922,0.5892000000000029,0.96875,1,0.96875,0.9375,0.9375,0.9375,0.077,0.341,0.587,0.013,1.856,285.58672372758116,2175.689567172471,0.072,0.337,0.711,0.008,1.249,82.83629692468878,1968.411416303458,0.069,0.354,0.471,0.012,1.803,181.4579732762626,2077.417786069916,142.76923076923077,156.125,150.25,FALSE,432,1.28,0,1,0,0,3,FALSE
210,2022-03-18T18:04:39Z,2022-03-18T18:19:27Z,887,1,2022-03-18T18:19:28Z,0.8999999761581421,Chrome,99.0.4844.74,Macintosh,1440,900,N/A,1.6,510,47,180,23,31,59,-0.34513743012283016,-0.39146341640719184,-0.8404853722146195,-0.9264047921690396,-0.6129431920601515,-0.4448174154778173,3,3,1,2,3,1,1,3,1,3,3,1,2,1,3,3,1,1,4,3,0.5104177855340404,0,0,2,3,3,2.15,0,5,5,4,5,3,5,5,5,3,5,5,5,1,5,5,5,5,5,5,5,5,5,5,5,2,0,0,0,0,3,4,4,4,4,4,4,4,4,4,3,3,3,5,1,4,1,5,5,5,5,5,5,5,5,5,3,5,5,5,3,3,3,3,4,4,5,3,3,3,3,1.4268973460049732,1.8073922282301278,5,0,3,0,4.4,0,3.888888888888889,0,3.6666666666666665,0,4.666666666666667,0,3.857142857142857,0,4.333333333333333,0,3.972972972972973,0,3,0,0,3.0901451190158635,2.941093626234304,0.728342369310411,1.8347179977723576,3,3,4,3,2,3,3,4,1,0.4879500364742666,3,0,2.5,0.7833719283100348,3,2,2,2,1,1,2,2,6,2,3,1.0690449676496976,4,1.8571428571428572,0,-0.3554296317763296,0,-1.0769205636353747,2,2,2,2,2,4,2,4,4,2,4,2,4,2,2,4,2,4,2,4,0,2,0,3.2,0,2.8,0,3.2,0,3.066666666666667,0,1,1,1,3,1,1,1,2,1,1,1,4,1,1,2,2,1,2,2,2,0.6863327411532597,1.55,0,I lived with my mother and father an equal amount of time (joint custody),0,"Hispanic of Latino (e.g., Mexican American, Central American, and others)",0,22,1,2,NA,1,3,4,Technical Support Advisor,2,132,62,1,5,2,0,0,0,0,0,TRUE,TRUE,TRUE,TRUE,TRUE,1,0.48540625,0.4638281250001164,0.5045281249997207,0.591090322580489,0.5314225806452695,0.604174193548279,1,1,1,0.96875,1,0.96875,0.081,0.391,0.752,0.017,1.867,40.07426729645231,1870.9366438375393,0.074,0.341,0.62,0.029,2.024,108.66349640768422,1899.5380682241541,0.077,0.362,0.682,0.016,1.962,47.75152924189,1868.3402729586783,109.8235294117647,69.79310344827586,122.625,FALSE,424,1.2562962962962962,0,1,0,3,6,FALSE
212,2022-03-18T17:40:38Z,2022-03-18T18:19:41Z,2342,1,2022-03-18T18:19:42Z,0.800000011920929,Chrome,99.0.4844.74,Windows NT 10.0,1280,1024,Great!,1.25,751,184,629,328,48,152,0.15038261489171967,0.3650171128488738,0.7908526678481801,2.8350582991082725,-0.26434338149382247,0.6003372831021173,1,1,1,1,1,1,1,2,1,1,1,1,1,1,1,1,1,1,1,1,1.5035046776746235,0,1,1,5,5,1.05,0,1,1,1,2,1,1,1,1,1,1,1,1,1,1,2,1,1,1,1,1,1,1,1,0,2,0,0,0,0,2,2,1,1,1,1,1,1,1,1,1,1,1,1,1,1,1,1,1,1,1,1,1,1,1,1,1,1,1,1,1,1,1,1,1,1,1,1,1,1,1,1.9089641547562237,1.9444671200491874,1,0,1,0,1.1333333333333333,0,1.2222222222222223,0,1,0,1,0,1,0,1,0,1.054054054054054,0,0,0,0,-1.401547841119736,-1.5059380237408087,-0.6189692744445258,-1.0624536490926673,1,1,3,1,1,1,1,1,1,1.5735915849388864,1.2857142857142858,0,1,-0.7920494875423887,5,5,5,5,3,3,5,6,6,5,3,1.5735915849388864,6,4.428571428571429,0,0.6473058850354002,0,0.9270832807034747,1,1,1,1,1,5,4,5,5,5,5,4,4,4,5,4,5,5,4,4,1.65615734242165,1,0,4.8,0,4.2,0,4.6,0,4.533333333333333,0,1,1,1,1,1,1,1,1,1,1,1,1,1,1,1,1,1,1,1,1,1.231174022502185,1,0,I lived with my mother and father an equal amount of time (joint custody),0,"White, Caucasian, Anglo, European American",0,24,0,1,NA,1,3,6,Business Analyst,2,200,72,3,5,2,0,0,1,0,0,TRUE,TRUE,TRUE,TRUE,TRUE,3,0.7039419354892547,0.5964290322680628,0.621877419340995,0.7098781250044703,0.6155906249955296,0.6585843749903142,1,1,1,1,1,1,0.087,0.513,0.862,0.031,1.483,95.99245345782977,1883.3641547152224,0.069,0.46,0.557,0.059,1.872,37.819932940086396,1819.9443919139003,0.066,0.591,0.664,0.056,1.259,43.44721423032387,1825.61576101836,47.83870967741936,31.728813559322038,22.482142857142854,TRUE,276,0.8177777777777777,0,1,0,0,3,FALSE
213,2022-03-18T18:04:01Z,2022-03-18T18:20:37Z,995,1,2022-03-18T18:20:38Z,0.8999999761581421,Chrome,99.0.4844.51,Windows NT 10.0,1280,720,Thank you!,1.7777777777777777,491,77,203,60,34,76,-0.38420332578787764,-0.22581074576717747,-0.756920171944142,-0.470096154866546,-0.5514255784307993,-0.25376763186643136,3,3,2,1,3,1,1,2,1,2,3,1,1,1,2,2,1,1,3,2,0.8335087534664907,0,1,1,4,4,1.8,0,1,1,2,1,1,1,1,1,1,1,1,1,1,1,1,1,1,1,1,1,1,1,1,2,2,0,0,0,0,1,1,2,1,1,1,1,1,1,1,1,1,1,2,1,1,1,1,1,1,1,1,1,1,1,1,1,1,2,2,2,5,1,1,1,1,1,1,1,1,2,1.833947481081005,2.016597794967223,1,0,1.25,0,1.0666666666666667,0,1.1111111111111112,0,1.0833333333333333,0,1,0,2,0,1,0,1.2432432432432432,0,1,0,0,-1.2787281117410283,-1.4524446304632024,-0.31345356682763886,-0.8829490986454206,1,1,1,1,1,1,1,2,1,1.9518001458970664,1,0,1.5,-0.7645165376262261,5,5,5,5,5,5,5,7,6,6,5,1.5118578920369088,6.5,5,0,1.6378673238553392,0,1.8400345684084134,2,1,2,1,2,4,4,3,5,4,4,4,5,4,5,5,5,5,4,2,1.5118578920369088,1.6,0,4.4,0,4.4,0,3.8,0,4.2,0,2,1,1,1,3,1,1,2,1,1,1,2,1,1,1,2,1,1,1,2,0.9880869341680844,1.35,0,I lived with my mother and father an equal amount of time (joint custody),0,"White, Caucasian, Anglo, European American",0,25,0,1,NA,1,4,6,Resident,3,175,72,4,5,2,0,0,0,0,0,TRUE,TRUE,TRUE,TRUE,TRUE,3,0.4363281250037253,0.39055312500149014,0.4335187500044703,0.49840333333611486,0.46787999999920526,0.529419999998808,1,1,1,0.9375,0.9375,0.9375,0.073,0.323,0.725,0.016,1.953,68.83837799738966,1919.5394696151072,0.061,0.255,0.49,0.014,1.645,101.80528433876775,1946.4817536898997,0.077,0.317,0.716,0.022,1.949,113.21124283617488,1968.139087425588,122.0625,117.5,88.5909090909091,FALSE,358,1.0607407407407408,0,1,0,0,3,FALSE
214,2022-03-18T17:58:38Z,2022-03-18T18:20:43Z,1324,1,2022-03-18T18:20:44Z,1,Chrome,97.0.4692.71,Windows NT 10.0,1920,1080,NA,1.7777777777777777,431,61,269,123,330,55,-0.5075693120985539,-0.31415883677518514,-0.5171243798636413,0.3068617951349972,5.518312299665282,-0.48977030573931984,2,1,1,1,1,1,2,2,1,1,2,1,1,1,1,1,1,1,2,1,1.348488432516786,0,1,1,4,3,1.25,0,1,1,3,1,3,2,1,2,2,1,1,1,2,1,1,1,1,1,1,1,1,1,1,0,2,0,0,0,0,1,2,1,1,2,2,2,2,2,2,1,2,1,2,2,1,2,1,1,1,2,1,5,1,1,2,1,2,1,1,1,1,2,2,1,1,1,1,2,1,1,1.633912381270694,1.6388149028228556,1,0,1.25,0,1.5333333333333334,0,1.6666666666666667,0,1.5,0,1.8333333333333333,0,1.4285714285714286,0,1,0,1.5405405405405406,0,0,0,0,-1.0857256798602015,-1.118897590026364,-0.5328163702636706,-0.8258569801450173,1,1,1,1,1,1,1,1,1,1.9518001458970664,1,0,1,-0.9579186615539372,5,5,5,5,2,2,4,4,8,3,3,1.6035674514745464,6,4,0,0.2196552803757379,0,0.4343977554298661,2,2,2,2,2,4,5,3,4,2,5,4,4,3,4,3,4,4,4,3,1.0997835284835873,2,0,4.2,0,3.6,0,3.4,0,3.7333333333333334,0,3,2,3,3,3,3,3,3,3,2,2,3,3,4,2,2,2,3,3,3,0.5871429486123998,2.75,0,I lived with my mother and father an equal amount of time (joint custody),0,"White, Caucasian, Anglo, European American",0,27,0,1,NA,1,3,6,process engineer,4,125,68,2,5,2,0,0,1,0,0,TRUE,TRUE,TRUE,TRUE,TRUE,5,0.46573225806124746,0.4098718750001863,0.4327812499990687,0.5027838709681265,0.47284062500018625,0.4845290322553727,0.96875,1,1,0.96875,1,0.96875,0.062,0.339,0.723,0.02,1.534,152.17910177521395,1999.3133120538473,0.11,0.28,0.865,0.035,2.074,25.24045443522762,1812.6195303208385,0.045,0.372,0.491,0.033,1.695,151.4983823943426,2027.9915393750607,76.7,59.257142857142846,51.36363636363636,FALSE,304,0.9007407407407407,1,1,0,3,6,FALSE
215,2022-03-18T17:54:39Z,2022-03-18T18:22:27Z,1668,1,2022-03-18T18:22:28Z,0.8999999761581421,Chrome,99.0.4844.74,Windows NT 10.0,1920,1080,NA,1.7777777777777777,559,108,671,103,62,105,-0.2443885413024445,-0.05463631943916262,0.943449990081226,0.0602084776741898,0.02273881544315432,0.07214082252946219,1,2,2,2,3,1,1,2,1,2,3,1,1,1,2,3,1,1,2,3,0.9445132413883326,1,1,1,4,4,1.75,0,3,3,3,3,3,2,3,2,2,2,3,4,3,3,3,2,1,1,1,2,1,1,3,1,1,4,0,4,0,1,1,1,1,1,3,1,1,1,2,2,4,2,5,1,1,1,3,3,3,3,2,1,5,3,1,1,2,2,1,1,1,1,3,1,1,1,3,3,3,4,1.6562739034481113,0.4879500364742666,1.5,0,3.25,0,2.8,0,1.2222222222222223,0,2.5,0,2.1666666666666665,0,1.5714285714285714,0,1,0,1.837837837837838,0,1,0,0,-0.5681282489070757,-0.21776991356315983,0.37576966661920275,0.07899987652802146,3,2,4,3,1,3,2,4,3,0.7559289460184544,2.5714285714285716,0,3.5,0.9213724151481345,4,4,4,4,3,3,4,1,1,2,2,0.7867957924694432,1,3.7142857142857144,0,-1.2405296635269585,0,-0.6097909349238235,2,2,2,1,1,5,5,5,5,3,2,2,5,1,4,2,3,4,1,5,1.4375905768565218,1.6,0,3.2,0,3.2,0,4,0,3.466666666666667,0,4,1,3,4,1,4,1,4,4,3,3,4,3,1,1,4,4,4,4,4,1.394538218230416,3.05,0,"I lived with my mother, but not father, most of the time.",0,"Asian or Asian American (e.g., Chinese, Japanese, and others)",0,24,1,2,NA,0,1,6,Freelancer,2,105,63,4,5,2,0,0,1,0,0,TRUE,TRUE,TRUE,TRUE,TRUE,3,0.5026322580644891,0.40191249999996215,0.4557874999999767,0.5935718749999651,0.4599482758621011,0.5094699999999721,1,1,1,1,0.90625,0.967741935483871,0.077,0.345,0.606,0.062,1.92,613.9847503531968,2849.9867484394863,0.047,0.342,0.606,0.041,1.991,455.6475605760464,2397.5692500265914,0.077,0.326,0.432,0.018,1.698,340.1024936136002,2126.9965893295966,30.96774193548387,48.5609756097561,94.33333333333334,FALSE,328,0.9718518518518519,0,1,0,0,3,FALSE
216,2022-03-18T17:57:49Z,2022-03-18T18:23:01Z,1511,1,2022-03-18T18:23:03Z,0.8999999761581421,Chrome,99.0.4844.74,Windows NT 10.0,1920,1080,NA,1.7777777777777777,532,117,468,121,57,64,-0.29990323514224887,-0.004940518247158307,0.20589626595483773,0.2821964633889164,-0.07979054060576597,-0.38862630265093906,2,2,1,1,2,1,2,2,1,2,2,1,1,1,2,2,1,1,2,3,0.9733285267845752,0,1,1,3,4,1.6,0,2,1,2,2,2,1,2,2,1,1,1,1,2,3,2,2,1,1,2,1,1,1,1,0,2,0,0,0,0,1,1,1,1,2,1,2,2,1,1,2,1,1,1,1,1,1,1,1,3,3,1,1,1,1,2,1,1,1,2,1,2,1,2,1,1,1,2,1,1,1,1.7406981444322935,1.486446705914413,1.25,0,1.25,0,1.6666666666666667,0,1.3333333333333333,0,1.4166666666666667,0,1.1666666666666667,0,1.4285714285714286,0,1,0,1.3243243243243243,0,0,0,0,-1.0637935853282892,-1.0459341749308055,-0.5328163702636706,-0.789375272597238,1,2,2,2,1,2,2,1,1,1.3972762620115438,1.7142857142857142,0,1,-0.5432457265250663,4,5,4,5,2,2,4,8,7,NA,3,1.3972762620115438,7.5,3.7142857142857144,0,0.8160844699873094,1,0.6428711710179135,2,3,2,4,2,4,5,2,4,2,5,4,3,4,4,4,5,1,5,3,1.3522468075656264,2.6,0,3.8,0,3.8,0,3.4,0,3.6666666666666665,0,1,1,1,1,1,1,3,2,1,1,1,2,2,1,1,1,1,1,1,1,1.0894228312566052,1.25,0,I lived with my mother and father an equal amount of time (joint custody),0,"White, Caucasian, Anglo, European American",0,23,0,1,NA,1,4,6,Graduate Student,7,171,68,3,5,2,0,0,0,0,0,TRUE,TRUE,TRUE,TRUE,TRUE,5,0.5580812499999883,0.49208749999993595,0.5629483870966661,0.6174624999999941,0.5688124999999563,0.6055516129031687,1,1,1,1,1,1,0.133,0.343,0.643,0.02,1.47,62.434096512800764,1846.4128458997716,0.115,0.349,0.851,0.01,1.204,58.373598215211494,1840.7448437671844,0.116,0.356,0.606,0.026,1.846,47.905568097512024,1830.8974850674736,73.5,120.39999999999999,71,FALSE,304,0.9007407407407407,1,1,0,3,6,FALSE
217,2022-03-18T17:55:43Z,2022-03-18T18:23:27Z,1663,1,2022-03-18T18:23:27Z,0.8999999761581421,Chrome,95.0.4638.69,Windows NT 10.0,1920,1080,"I had a 2nd monitor connected, but it was not used and simply ignored. I briefly moved my mouse over to it at the very beginning of the experiment to test if it would go over to the other monitor still while in full screen mode on my main monitor.

Bringing back childhood memories for this experiment was very emotionally difficult. That is not your fault, though. I thank you for the study.",1.7777777777777777,651,123,527,91,49,58,-0.05522736229274085,0.02819001588084457,0.4202591709964974,-0.08778351280229461,-0.2438375102840384,-0.4560556380431929,3,4,4,4,4,2,2,4,2,4,4,4,2,3,4,4,4,2,4,4,1.1697953037312037,0,0,5,3,2,3.4,0,4,3,3,5,3,4,4,5,5,4,5,5,1,5,5,5,5,4,3,5,5,5,5,3,1,1,0,1,0,3,5,5,4,5,3,4,5,4,5,4,5,2,5,5,5,5,5,5,5,5,5,2,4,3,4,4,5,2,1,1,5,3,3,5,5,5,2,2,1,1,1.6499158227686108,1.5796322658258457,4.625,0,1.5,0,4.066666666666666,0,4.222222222222222,0,4.666666666666667,0,3.6666666666666665,0,2.857142857142857,0,5,0,4.081081081081081,0,2,0,0,2.9168815722137587,2.6790349992401485,-0.007937859210751935,1.3355485700146983,5,5,5,5,4,5,4,8,1,1.8126539343499315,4.714285714285714,0,4.5,2.5521954680901695,1,2,2,1,1,1,1,4,1,1,1,1.4638501094227998,2.5,1.2857142857142858,0,-1.5266208755073867,0,-2.0998915716799607,1,1,1,2,2,5,4,4,5,4,5,5,4,5,5,5,5,4,4,5,1.7265434778633235,1.4,0,4.8,0,4.2,0,4.8,0,4.6,0,2,2,2,4,3,4,4,4,4,2,2,4,1,2,3,4,1,4,2,4,1.1742858972247996,2.9,0,"I lived with my mother, but not father, most of the time.",0,"White, Caucasian, Anglo, European American",0,26,0,1,NA,1,1,1,Physically disabled,1,142,70,1,5,2,0,0,0,0,0,TRUE,TRUE,TRUE,TRUE,TRUE,2,0.46929062500968577,0.4113843750096858,0.48893437499925496,0.5994700000007948,0.523858620676501,0.5773206896535281,1,1,1,0.9375,0.90625,0.90625,0.074,0.314,0.455,0.012,1.74,112.93782404929397,1970.5484470433175,0.06,0.322,0.619,0.017,1.799,82.5229021063693,1938.8851382022951,0.082,0.333,0.662,0.013,1.949,66.27631950245454,1913.0645300338044,145,105.8235294117647,149.92307692307693,FALSE,272,0.8059259259259259,0,1,0,3,6,FALSE
218,2022-03-18T18:08:08Z,2022-03-18T18:26:16Z,1088,1,2022-03-18T18:26:17Z,1,Chrome,99.0.4844.57,CrOS x86_64 14469.41.0,1366,768,None.,1.7786458333333333,528,62,267,78,39,70,-0.30812763422962725,-0.3086370810871847,-0.5243909190175959,-0.24810816915181938,-0.448896222381879,-0.32119696725868524,3,3,3,2,4,1,2,4,1,4,4,2,1,2,4,4,2,1,4,4,0.6048053188292994,0,1,2,2,2,2.75,0,3,2,3,3,2,2,3,3,2,2,2,3,2,3,3,2,2,1,1,3,2,2,2,0,2,0,0,0,0,2,3,3,2,2,1,2,2,3,1,2,2,1,3,1,1,2,2,2,3,3,2,1,1,1,3,1,1,1,1,1,2,2,2,3,3,2,2,2,1,3,1.28224184307959,0.6172133998483676,1.875,0,2,0,2.533333333333333,0,2.2222222222222223,0,1.9166666666666667,0,1.5,0,1.4285714285714286,0,2.6666666666666665,0,1.8918918918918919,0,0,0,0,-0.2895906483517917,-0.14687150078162708,-0.274357657721105,-0.21061457925136604,2,2,3,2,1,2,2,2,2,0.9511897312113419,2,0,2,0.009427695341904336,4,3,2,3,2,2,3,1,1,1,2,0.7559289460184544,1,2.7142857142857144,0,-1.4543549658567896,0,-1.281848411384352,2,3,2,1,2,5,4,4,4,3,4,3,3,3,3,3,3,4,3,4,0.7367883976130072,2,0,3.8,0,3.2,0,3.6,0,3.533333333333333,0,2,1,2,4,2,3,3,4,2,1,2,3,1,2,2,4,3,3,2,3,0.7591546545162482,2.45,0,I lived with my mother and father an equal amount of time (joint custody),0,"White, Caucasian, Anglo, European American",0,27,1,2,NA,1,1,5,Self-employed,1,195,63,2,5,2,0,0,0,0,0,TRUE,TRUE,TRUE,TRUE,TRUE,3,0.6321906250000138,0.5846562499999995,0.6132812499999982,0.7076064516129141,0.6484250000000047,0.7630483870967761,1,1,1,1,1,0.96875,0.083,0.365,0.347,0.012,1.55,48.29665848569649,1871.6335628789018,0.089,0.393,0.472,0.023,1.738,36.823991967231244,1821.2294612780674,0.117,0.285,0.331,0.06,1.733,73.2220124547706,1858.188473124135,129.16666666666666,75.56521739130434,28.883333333333336,FALSE,334,0.9896296296296296,0,1,0,0,3,FALSE
219,2022-03-18T18:07:05Z,2022-03-18T18:26:20Z,1155,1,2022-03-18T18:26:21Z,0.8999999761581421,Chrome,99.0.4844.74,Windows NT 10.0,1920,1080,NA,1.7777777777777777,549,58,271,61,36,118,-0.2649495390208906,-0.3307241038391866,-0.5098578407096868,-0.4577634889935056,-0.5104138360112311,0.2182377158793455,2,2,1,1,2,1,1,2,1,2,2,1,1,1,2,2,1,1,2,2,1.025978352085154,0,1,2,3,4,1.5,0,3,2,1,2,1,1,2,1,1,1,1,2,1,2,3,2,2,1,1,1,2,1,1,1,2,0,0,0,0,2,3,3,2,4,3,2,2,2,2,4,1,1,3,1,4,1,1,1,2,2,2,1,1,1,2,2,1,2,2,1,1,1,1,1,1,1,2,2,2,2,1.2105641104317713,1.4375905768565218,1.375,0,2,0,1.6,0,2.5555555555555554,0,1.9166666666666667,0,1.5,0,1.2857142857142858,0,1,0,1.8108108108108107,0,1,0,0,-0.6668226743006803,-0.808065575043803,-0.05499485428507328,-0.4315302146644382,2,2,3,1,1,1,1,2,1,1.2149857925879117,1.5714285714285714,0,1.5,-0.4327781896031293,4,4,4,4,3,3,5,6,6,4,4,1.1126972805283737,6,3.857142857142857,0,0.7766911997228434,0,0.6962798183632866,1,2,2,2,2,5,1,5,5,1,5,4,5,1,3,3,3,3,3,3,1.1338934190276817,1.8,0,4,0,2.6,0,3.4,0,3.3333333333333335,0,1,2,1,1,1,1,2,1,1,1,1,1,3,1,1,1,1,1,1,1,1.2396943596157715,1.2,0,I lived with my mother and father an equal amount of time (joint custody),0,"Asian or Asian American (e.g., Chinese, Japanese, and others) & Filipino",1,22,0,1,NA,1,4,6,Lab Technician,4,120,66,2,5,2,0,0,1,0,0,TRUE,TRUE,TRUE,TRUE,TRUE,2,0.4708687500283122,0.4580531250163913,0.4383718750178814,0.549496774173552,0.5305677419324075,0.5194499999920527,1,1,1,0.96875,1,0.967741935483871,0.063,0.34,0.685,0.023,1.881,51.61580845020024,1881.0811041339484,0.185,0.201,0.736,0.022,1.767,22.649381357931926,1802.7422191248486,0.073,0.331,0.531,0.022,1.957,57.26091042010121,1880.9820784736505,81.78260869565217,80.31818181818181,88.95454545454547,FALSE,472,1.3985185185185185,0,1,0,0,3,FALSE
220,2022-03-18T17:51:26Z,2022-03-18T18:26:40Z,2113,1,2022-03-18T18:26:42Z,0.800000011920929,Chrome,99.0.4844.74,Windows NT 10.0,1366,768,The study was very engaging and thoughtful. I had no issues with the study.,1.7786458333333333,617,193,626,160,81,180,-0.12513475453545742,0.4147129140408781,0.7799528591172483,0.7631704324374907,0.41235036842905143,0.9150075149326352,2,2,1,1,2,1,1,2,1,2,2,1,1,1,2,2,1,1,2,2,1.025978352085154,0,1,3,5,5,1.5,0,5,3,2,2,1,1,5,1,1,1,1,3,2,3,2,2,1,1,2,1,1,1,1,0,2,0,0,0,0,3,3,3,3,3,3,3,3,3,2,3,1,2,3,1,3,1,1,1,1,1,2,4,1,1,1,1,1,1,1,1,2,1,1,1,2,1,3,2,2,1,1.092562901481509,1.162919151265879,1.25,0,2,0,2.2,0,3,0,1.6666666666666667,0,1.6666666666666667,0,1.1428571428571428,0,1.3333333333333333,0,1.864864864864865,0,0,0,0,-0.7128800728176956,-0.5770803162035515,-0.274357657721105,-0.42571898696232824,2,4,3,3,3,3,3,1,1,0.4879500364742666,3,0,1,0.20316555652690138,3,3,3,3,2,3,3,6,6,2,4,0.3779644730092272,6,2.857142857142857,0,0.34904059506318114,0,-0.10601640787303052,1,1,1,1,1,5,2,5,5,1,5,4,4,4,4,4,4,4,2,2,1.2909944487358056,1,0,4.4,0,2.6,0,4,0,3.6666666666666665,0,1,1,1,3,1,1,1,2,1,1,1,2,2,1,1,2,1,1,1,1,0.7539370349250519,1.3,0,I lived with my mother and father an equal amount of time (joint custody),0,Black or African American,0,27,1,2,NA,1,3,7,Information technology,3,196.7,67,2,3,2,0,0,1,1,0,TRUE,TRUE,TRUE,TRUE,TRUE,3,0.5718967741843193,0.48523124999552963,0.5723968750201166,0.6472548387281356,0.5318266666769982,0.6325266666611036,1,1,1,0.96875,0.9375,0.9375,0.055,0.468,0.531,0.028,1.954,53.50867425701129,1923.8539542498881,0.052,0.383,0.543,0.027,1.654,117.45089906984401,1969.0971721981796,0.065,0.438,0.523,0.011,1.404,109.16434723093381,1933.176706061946,69.78571428571428,61.25925925925926,127.63636363636364,FALSE,342,1.0133333333333332,0,0,0,0,3,FALSE
221,2022-03-18T17:49:52Z,2022-03-18T18:27:11Z,2239,1,2022-03-18T18:27:12Z,1,Edge,99.0.1150.30,Windows NT 10.0,1280,720,NA,1.7777777777777777,1761,61,209,54,34,70,2.227043384454771,-0.31415883677518514,-0.7351205544822783,-0.5440921501047882,-0.5514255784307993,-0.32119696725868524,2,2,2,1,3,2,2,3,1,3,3,2,3,3,3,3,2,1,3,3,0.6048053188292994,0,1,3,2,2,2.35,0,4,3,4,3,5,4,4,3,2,2,4,3,2,3,3,2,3,1,1,2,2,3,3,0,2,0,0,0,0,1,2,2,2,2,1,2,2,2,4,1,4,2,2,3,1,5,4,4,5,5,2,1,1,1,1,1,1,1,1,1,4,4,4,1,3,2,1,3,3,2,1.5368350145223337,0.9258200997725514,2.125,0,2.25,0,3.2666666666666666,0,1.7777777777777777,0,3.3333333333333335,0,1.1666666666666667,0,2.2857142857142856,0,2,0,2.2972972972972974,0,0,0,0,0.13589198556730314,0.459452511993593,-0.1882047535402498,0.1356238792266716,1,2,2,2,1,4,4,4,1,1.4638501094227998,2.2857142857142856,0,2.5,0.36869899328116373,4,4,4,5,3,3,4,6,7,5,3,0.9759000729485332,6.5,3.857142857142857,0,0.7376207874909593,0,0.6724824399105899,2,2,3,3,2,4,5,4,4,4,4,4,3,5,5,4,5,3,5,2,1.3020130933435712,2.4,0,4,0,4.2,0,4,0,4.066666666666666,0,3,4,3,2,4,2,3,2,1,1,3,2,2,3,1,2,3,3,4,3,0.910465468000326,2.55,0,I lived with my mother and father an equal amount of time (joint custody),0,"White, Caucasian, Anglo, European American",0,21,1,2,NA,1,4,4,front end associate at company/student,1,125,64,3,5,2,0,0,1,0,0,TRUE,TRUE,TRUE,TRUE,TRUE,3,0.5036156250014902,0.47796774192010205,0.5007677419262547,0.5752218750119209,0.5708906249962747,0.5575566666563352,1,0.96875,0.96875,1,1,0.967741935483871,0.05,0.394,0.443,0.026,1.607,120.8548705382473,1991.1335671306883,0.068,0.337,0.453,0.031,2.102,128.77307228366695,1951.667650251401,0.146,0.277,0.679,0.007,0.98,25.65631686529951,1809.6462113272353,61.80769230769231,67.80645161290322,140,FALSE,339,1.0044444444444445,0,1,0,6,9,FALSE
223,2022-03-18T17:46:30Z,2022-03-18T18:27:25Z,2454,1,2022-03-18T18:27:26Z,1,Opera,84.0.4316.36,Windows NT 10.0,1768,992,N/A,1.782258064516129,993,286,655,142,63,240,0.6479587596781141,0.9282361930249227,0.8853176768495895,0.5411824467227642,0.043244686652938374,1.5893008688551735,3,2,1,1,2,1,1,3,1,3,3,1,2,1,2,3,1,1,3,3,0.7326950970650465,0,0,2,3,2,1.9,0,4,5,3,4,3,5,5,4,3,2,2,4,1,5,5,5,5,5,3,4,4,5,5,4,1,2,0,2,1,2,3,3,3,5,3,5,4,4,2,3,3,1,4,1,3,5,4,4,4,3,5,3,5,3,4,4,3,4,1,1,3,3,3,2,1,3,1,3,3,1,1.1702005680093346,1.2071217242444348,4.5,0,2,0,3.6666666666666665,0,3.5555555555555554,0,3.0833333333333335,0,4,0,2.5714285714285716,0,2,0,3.1621621621621623,0,2,1,0,2.2391798511776746,2.048619292801301,0.8637329606014429,1.456176126701372,5,4,5,3,5,5,5,3,3,1.8126539343499315,4.571428571428571,0,3,1.8890545093012616,2,3,3,4,1,1,1,1,4,1,1,1.4960264830861913,2.5,2.142857142857143,0,-1.5266208755073867,0,-1.6354755202358982,3,4,3,2,3,4,5,3,3,3,5,3,4,4,3,5,4,2,5,4,1.2535663410560174,3,0,3.6,0,4.4,0,3.4,0,3.8,0,1,1,1,1,3,1,2,1,1,1,2,2,1,2,2,1,1,1,1,1,1.1367080817685316,1.35,0,"I lived with my father, but not mother, most of the time. & I lived with my extended family on father's side (grandparents, aunts ,uncles, cousins)",1,"White, Caucasian, Anglo, European American",0,18,0,1,NA,1,1,3,blogger,1,122,72,1,5,2,0,0,1,0,0,TRUE,TRUE,TRUE,TRUE,TRUE,4,0.6468406250000044,0.6076124999999738,0.5357749999999942,0.7693150000000489,0.7240709677419339,0.7744772727273045,1,1,1,0.625,0.96875,0.6875,0.066,0.375,0.344,0.007,1.985,145.09474179780142,2102.3050659071596,0.083,0.383,0.356,0.015,1.783,43.84066328599004,1867.4913980735448,0.058,0.414,0.191,0.008,1.814,159.51547977924994,2198.255391922915,283.57142857142856,118.86666666666666,226.75,FALSE,304,0.9007407407407407,1,1,0,0,3,FALSE
224,2022-03-18T18:01:59Z,2022-03-18T18:28:11Z,1571,1,2022-03-18T18:28:12Z,1,Chrome,98.0.4758.102,Macintosh,1440,900,no,1.6,519,82,300,58,63,94,-0.32663253217622873,-0.19820196732717507,-0.40449302297734563,-0.49476148661262676,0.043244686652938374,-0.05147962568966986,1,1,1,1,1,1,1,1,1,1,1,1,1,1,1,1,1,1,1,1,1.538967528127731,0,1,1,2,2,1,0,3,3,1,3,1,1,2,2,1,1,2,3,1,3,3,4,1,1,1,3,1,1,3,1,2,0,0,0,0,1,3,2,2,2,1,1,1,1,3,2,3,1,4,1,5,1,1,2,2,2,4,4,3,3,3,3,1,3,1,1,3,3,1,1,3,1,3,3,1,3,1.3955097446623035,1.0600988273786194,1.875,0,2.5,0,2,0,1.5555555555555556,0,2.25,0,3.3333333333333335,0,1.8571428571428572,0,1.6666666666666667,0,2.135135135135135,0,1,0,0,-0.1316795677220247,-0.27352497604184134,0.11731095407663712,-0.07810701098260212,2,3,4,1,1,1,2,3,1,1.1547005383792515,2,0,2,0.009427695341904336,3,2,3,5,1,1,3,6,3,2,1,1.3972762620115438,4.5,2.5714285714285716,0,-0.9515359633553193,0,-1.052989304058783,1,1,1,1,1,5,5,5,5,3,5,5,4,5,3,4,5,5,4,5,1.7182493859684491,1,0,5,0,4,0,4.6,0,4.533333333333333,0,2,1,1,1,2,2,2,2,1,1,3,2,2,2,2,1,1,1,1,2,0.9733285267845752,1.6,0,"I lived with my mother, but not father, most of the time. & I lived with my extended family on mother's side (grandparents, aunts ,uncles, cousins)",1,Black or African American,0,28,1,2,NA,1,3,7,Government,2,168,66,2,5,2,0,0,1,0,0,TRUE,TRUE,TRUE,TRUE,TRUE,6,0.5193093750067055,0.49386129032027337,0.5139718749932944,0.5972156250104308,0.5393193548398634,0.5739874999932945,1,1,1,1,0.96875,1,0.088,0.382,0.645,0.032,1.94,93.013396283364,1894.4451194079613,0.122,0.309,0.759,0.016,1.328,168.19718907980615,1996.7847760173067,0.139,0.33,0.765,0.019,1.821,21.797877664046464,1803.623441441724,60.625,83,95.84210526315789,FALSE,438,1.2977777777777777,0,1,0,0,3,FALSE
225,2022-03-18T17:40:33Z,2022-03-18T18:28:40Z,2887,1,2022-03-18T18:28:42Z,1,Chrome,99.0.4844.57,CrOS x86_64 14469.41.0,1366,768,no,1.7786458333333333,514,138,1186,304,341,297,-0.3369130310354517,0.11101635120085177,2.814583822224526,2.5390743181553037,5.7438768829729066,2.229879555081585,1,3,2,2,2,1,4,3,2,1,2,3,1,2,1,2,3,3,3,2,0.9333020044867296,0,1,2,2,3,2.15,0,2,1,1,3,1,2,4,3,2,1,2,3,3,3,3,3,4,3,2,2,3,4,2,2,2,0,0,0,0,2,3,2,3,4,3,1,1,1,1,3,2,2,2,2,1,5,5,3,1,1,4,1,1,1,3,3,1,2,2,1,2,2,2,1,1,1,2,2,2,2,1.4425952589278397,1.1254628677422756,2.875,0,2,0,2.2666666666666666,0,2.2222222222222223,0,2.3333333333333335,0,2.1666666666666665,0,1.7142857142857142,0,1,0,2.054054054054054,0,1,0,0,0.46487340354598494,0.24410227067381787,-0.05499485428507328,0.0945537081943723,1,2,2,1,1,2,2,1,1,1.5118578920369088,1.5714285714285714,0,1,-0.6261803135308405,2,1,1,1,2,1,4,4,6,2,3,0.5345224838248488,5,1.7142857142857142,0,-0.17479982686521142,0,-1.0443035185364042,3,3,4,3,3,3,4,3,3,2,4,2,3,3,3,4,4,4,2,4,0.7237468644557459,3.2,0,3.4,0,3,0,3.2,0,3.2,0,2,3,2,3,2,3,2,3,2,3,3,1,2,2,2,1,2,3,3,3,0.6863327411532597,2.35,0,"I lived with my father, but not mother, most of the time. & I lived with my mother and father an equal amount of time (joint custody) & I lived with my extended family on father's side (grandparents, aunts ,uncles, cousins)",1,"White, Caucasian, Anglo, European American",0,24,0,1,NA,1,2,2,dishwasher,1,140,68,2,5,2,0,0,0,0,0,TRUE,TRUE,TRUE,TRUE,TRUE,6,0.5859968750000698,0.7918419354842795,0.4879312500002561,0.6284548387094852,0.963596666666617,0.5450482758620175,1,1,1,0.96875,1,0.90625,0.055,0.35,0.429,0.023,1.937,73.87599958615219,1933.338969028734,0.123,0.169,0.181,0.263,1.849,347.04439783802934,2134.4120071584275,0.061,0.408,0.372,0.03,1.892,110.36967188839348,1934.6838151332352,84.21739130434783,7.03041825095057,63.06666666666666,FALSE,402,1.1911111111111112,0,1,0,0,3,FALSE
226,2022-03-18T17:48:40Z,2022-03-18T18:29:44Z,2464,1,2022-03-18T18:29:45Z,0.800000011920929,Chrome,99.0.4844.51,Macintosh,1280,800,NA,1.6,776,168,1002,111,81,164,0.2017851091878348,0.2766690218408661,2.1460622200607062,0.15886980465851275,0.41235036842905143,0.735195953886625,2,3,2,1,3,1,2,3,2,3,4,2,1,1,2,3,2,1,3,3,0.6155870112510925,0,1,4,3,2,2.2,0,2,3,2,3,3,2,2,2,2,1,1,3,2,2,2,2,2,3,2,2,2,2,2,2,2,0,0,0,0,2,2,3,2,3,1,1,1,3,2,3,1,3,3,2,3,3,2,1,1,1,3,3,5,1,3,1,2,3,3,3,3,3,3,2,3,3,2,2,2,2,1.1429375776070652,1.0465362369445672,2.125,0,2,0,2.1333333333333333,0,2,0,2.0833333333333335,0,2.6666666666666665,0,2.857142857142857,0,2.6666666666666665,0,2.3513513513513513,0,1,0,0,0.17098333681836214,-0.011761349378261576,-0.05499485428507328,-0.03337810183166743,4,4,5,3,3,4,3,4,1,1.0690449676496976,3.7142857142857144,0,2.5,1.1980448633389056,1,3,3,4,1,1,3,6,6,NA,2,1.2535663410560174,6,2.2857142857142856,0,-0.10514851658861807,1,-0.6922689347505284,2,2,2,3,2,4,2,5,5,3,2,3,4,3,3,1,3,3,2,5,1.1254628677422756,2.2,0,3,0,2.4,0,4.2,0,3.2,0,2,1,4,4,2,4,4,4,3,2,1,4,2,3,2,4,1,4,1,3,1.1821033884786185,2.75,0,"I lived with my mother, but not father, most of the time.",0,Black or African American,0,28,1,2,NA,1,2,6,unemployed and unpaid caregiver,7,245,67,1,5,2,0,0,1,0,0,TRUE,TRUE,TRUE,TRUE,TRUE,3,0.7886156249921769,0.6448437499906867,0.6869937500003725,0.8731593750044704,0.6925709677396282,0.7437580645180518,1,1,1,1,1,1,0.11,0.417,0.435,0.01,1.264,176.16954212103266,1965.7256257470683,0.104,0.455,0.567,0.024,1.522,47.05665463807074,1830.987560250839,0.224,0.393,0.583,0.018,1.524,76.59142673502875,1860.5586655351728,126.4,63.416666666666664,84.66666666666667,FALSE,253,0.7496296296296296,0,1,0,0,3,FALSE
227,2022-03-18T18:15:19Z,2022-03-18T18:30:54Z,934,1,2022-03-18T18:30:54Z,0.8999999761581421,Chrome,96.0.4664.45,Windows NT 10.0,1536,864,NA,1.7777777777777777,448,63,240,48,34,55,-0.4726156159771957,-0.3031153253991842,-0.6224891975959825,-0.6180881453430304,-0.5514255784307993,-0.48977030573931984,4,4,3,2,4,1,1,4,1,4,4,3,3,3,4,4,2,2,4,4,0.8255779474818965,0,1,1,2,2,3.05,0,5,1,2,2,2,2,4,4,3,3,5,5,3,4,4,2,4,4,1,1,5,3,3,6,2,0,0,0,0,1,1,4,3,3,1,2,2,5,1,2,4,1,5,5,5,3,5,5,5,5,5,3,4,3,2,1,1,2,1,1,1,1,1,1,4,1,2,2,2,2,1.6639617690225845,1.2798809468443688,2.875,0,2,0,3.2666666666666666,0,2.4444444444444446,0,3.8333333333333335,0,3,0,1.1428571428571428,0,2,0,2.7027027027027026,0,3,0,0,0.8859696185586973,0.963903077276901,0.3837307525869902,0.6738169149319456,1,1,3,1,1,1,1,2,1,1.5735915849388864,1.2857142857142858,0,1.5,-0.5986473636146776,5,5,5,5,3,3,5,7,7,2,3,1.5735915849388864,7,4.428571428571429,0,0.18645978295702492,0,0.6463867517157567,2,3,2,1,2,4,5,5,5,5,5,4,5,5,5,5,5,5,4,3,1.8309508328682538,2,0,4.6,0,4.8,0,4.6,0,4.666666666666667,0,2,2,4,4,3,2,2,4,4,1,4,3,2,4,4,3,2,3,4,2,1.0990426455975697,2.95,0,"I lived with my mother, but not father, most of the time.",0,"Asian or Asian American (e.g., Chinese, Japanese, and others)",0,22,1,2,NA,1,3,5,case manager,2,140,62,1,5,2,0,0,1,0,0,TRUE,TRUE,TRUE,TRUE,TRUE,4,0.4384437500005588,0.40048333333333336,0.44068387096543465,0.5384692307733573,0.4583384615377738,0.4610740740740741,1,0.9375,0.96875,0.8125,0.8125,0.84375,0.038,0.343,0.399,0.04,1.875,70.47692303949962,2016.9917317894085,0.041,0.316,0.456,0.009,1.205,165.03148688469614,2170.6976725204786,0.052,0.343,0.533,0.013,1.756,45.20247849539644,1948.9289725463746,46.875,133.88888888888891,135.0769230769231,FALSE,432,1.28,0,1,0,0,3,FALSE
228,2022-03-18T18:14:12Z,2022-03-18T18:31:40Z,1048,1,2022-03-18T18:31:41Z,0.8999999761581421,Chrome,99.0.4844.51,Macintosh,1440,900,N/A,1.6,495,69,259,58,43,72,-0.37597892670049926,-0.2699847912711813,-0.5534570756334142,-0.49476148661262676,-0.36687273754274274,-0.29872052212793393,1,1,2,2,2,1,3,2,1,2,1,2,1,2,2,2,2,1,2,1,1.050062654772261,0,1,1,2,3,1.65,0,4,3,3,2,3,3,4,3,2,3,3,3,2,4,3,2,3,1,1,2,2,3,2,1,2,0,0,0,0,1,4,1,2,2,2,2,1,2,3,2,3,1,2,2,1,4,2,3,3,4,3,1,1,1,2,1,2,1,1,1,4,4,4,1,3,1,2,2,1,1,1.4110248016923697,0.5936168397046637,2,0,1.5,0,3,0,1.8888888888888888,0,2.5,0,1.5,0,2.4285714285714284,0,1.6666666666666667,0,2.108108108108108,0,1,0,0,-0.06807649357947967,0.20585056114258846,-0.22730066264678367,-0.010725050752097606,2,3,1,1,1,1,1,3,1,1.7043362064926932,1.4285714285714286,0,2,-0.32231065268119236,4,4,5,5,2,1,2,7,7,4,3,1.5118578920369088,7,3.2857142857142856,0,0.6141103876166872,0,0.28764284934191653,4,3,4,4,4,2,5,1,2,2,4,3,3,2,3,3,4,4,3,2,1.0327955589886444,3.8,0,3.4,0,3.2,0,2,0,2.8666666666666667,0,1,3,3,3,4,3,4,3,1,1,3,3,2,3,1,3,2,3,2,4,0.99472291830968,2.6,0,I lived with my mother and father an equal amount of time (joint custody),0,"White, Caucasian, Anglo, European American",0,21,1,2,NA,1,4,4,student,5,105,64,1,5,2,0,0,0,0,0,TRUE,TRUE,TRUE,TRUE,TRUE,6,0.5122718750000932,0.4889593749996275,0.5428156249995809,0.6120366666649779,0.5727806451613865,0.6299903225800203,1,1,1,0.9375,0.96875,0.96875,0.072,0.398,0.524,0.015,1.747,63.45075926720345,1886.2592161594898,0.08,0.347,0.614,0.02,2.039,87.24062635355745,1914.8341188520506,0.08,0.334,0.515,0.014,1.918,71.41249453647843,1914.8523535031572,116.46666666666668,101.95,137,FALSE,438,1.2977777777777777,0,1,0,0,3,FALSE
229,2022-03-18T18:13:06Z,2022-03-18T18:31:43Z,1117,1,2022-03-18T18:31:44Z,0.8999999761581421,Chrome,99.0.4844.74,Windows NT 10.0,1920,1080,NA,1.7777777777777777,517,121,247,60,42,79,-0.3307447317199179,0.01714650450484361,-0.5970563105571416,-0.470096154866546,-0.38737860875252683,-0.22005296417030445,2,2,1,1,2,1,2,3,1,2,3,2,1,2,3,2,2,1,2,3,0.7947194142390263,0,1,3,3,2,1.9,0,3,2,3,3,4,4,4,3,2,3,2,3,2,3,3,2,2,1,1,2,2,2,2,0,2,0,0,0,0,1,2,1,2,2,2,1,1,3,2,2,3,1,1,2,1,2,3,3,4,3,3,1,1,1,1,1,1,1,1,1,1,2,2,1,1,2,1,1,1,1,1.539275598900135,0.7037315505489968,1.75,0,1,0,2.933333333333333,0,1.6666666666666667,0,2.25,0,1.3333333333333333,0,1.2857142857142858,0,1.3333333333333333,0,1.7027027027027026,0,0,0,0,-0.4935591274985745,-0.10940645879859792,-0.6189692744445258,-0.36418786662156183,1,1,1,1,1,1,1,1,1,1.9518001458970664,1,0,1,-0.9579186615539372,5,5,5,5,2,2,5,6,6,6,4,1.8126539343499315,6,4.142857142857143,0,1.2043418043825058,0,1.111562668396218,2,3,2,2,2,4,5,4,5,3,5,5,4,3,5,5,5,5,4,5,1.6676187756655838,2.2,0,4.8,0,4.2,0,4.4,0,4.466666666666667,0,1,1,2,2,2,1,2,3,3,1,1,2,1,2,1,3,1,1,2,2,0.7326950970650465,1.7,0,NA,NA,"White, Caucasian, Anglo, European American & Middle Eastern",1,25,1,3,NA,1,2,7,Graduate Student,4,175,66,3,5,2,0,0,1,0,0,TRUE,TRUE,TRUE,TRUE,TRUE,5,0.5300193548387577,0.48188749999878927,0.5136468750007916,0.59721666666617,0.5413062499994412,0.6086718750002328,0.96875,1,1,0.967741935483871,1,1,0.132,0.305,0.65,0.019,1.905,70.0512247042601,1855.559632572621,0.126,0.305,0.774,0.007,0.974,69.30139073352257,1849.7561224968572,0.065,0.397,0.546,0.013,1.518,222.75848635637172,2091.270277339417,100.26315789473685,139.14285714285714,116.76923076923077,FALSE,316,0.9362962962962963,0,1,0,0,3,FALSE
230,2022-03-18T18:01:39Z,2022-03-18T18:32:20Z,1840,1,2022-03-18T18:32:22Z,0.8999999761581421,Chrome,99.0.4844.74,Macintosh,1440,900,NA,1.6,601,184,622,146,65,136,-0.1580323508849711,0.3650171128488738,0.7654197808093391,0.5905131102149256,0.0842564290725065,0.42052572205610705,2,1,1,1,2,1,2,2,1,2,2,1,2,1,1,1,1,1,2,2,1.164157703189193,0,1,1,3,2,1.45,0,3,2,3,3,5,3,2,3,1,2,2,2,1,3,3,3,2,1,2,1,1,2,1,5,1,1,0,1,0,3,4,2,2,3,2,3,4,1,4,2,2,1,2,1,2,4,4,3,2,1,1,1,1,1,2,1,2,4,4,2,3,3,2,2,3,1,2,2,3,3,1.2615829705538957,1.0997835284835873,1.625,0,2.5,0,2.533333333333333,0,2.6666666666666665,0,2.3333333333333335,0,1.1666666666666667,0,2.857142857142857,0,2,0,2.2972972972972974,0,3,0,0,-0.1887030135049961,-0.07902142474936893,0.5560365609487006,0.23850756809966583,2,1,3,1,1,1,1,1,1,1.2535663410560174,1.4285714285714286,0,1,-0.7091149005366146,5,4,4,4,2,2,3,6,4,NA,2,1.1338934190276817,5,3.4285714285714284,0,-0.3760932239552953,1,-0.23807711333458287,2,3,2,2,2,4,4,4,4,2,4,4,4,4,4,3,4,4,3,1,1.0690449676496976,2.2,0,4,0,3.2,0,3.4,0,3.533333333333333,0,1,1,1,1,2,1,1,2,1,1,1,2,1,1,1,1,1,1,1,1,1.050062654772261,1.15,0,NA,NA,"White, Caucasian, Anglo, European American",0,19,1,2,NA,1,3,4,Student,4,195,65,2,5,2,0,0,0,0,0,TRUE,TRUE,TRUE,TRUE,TRUE,4,0.6040406250002561,0.5845129032258786,0.5562806451615067,0.6710531250004423,0.6069838709682226,0.6614966666664929,1,1,1,1,1,0.9375,0.074,0.378,0.447,0.01,1.525,56.06149796192951,1900.9247185661443,0.091,0.39,0.487,0.02,1.301,59.00802493959249,1838.7366324257468,0.077,0.407,0.402,0.02,1.626,171.91390475925002,1956.210266407307,152.5,65.05,81.3,FALSE,420,1.2444444444444445,0,1,0,0,3,FALSE
231,2022-03-18T18:10:36Z,2022-03-18T18:32:32Z,1315,1,2022-03-18T18:32:33Z,0.8999999761581421,Chrome,99.0.4844.74,Windows NT 10.0,1536,864,NA,1.7777777777777777,645,63,306,109,56,68,-0.06756396092380848,-0.3031153253991842,-0.3826934055154819,0.134204472912432,-0.10029641181555002,-0.3436734123894365,2,2,1,1,2,1,1,3,1,2,2,1,1,1,2,2,1,1,2,2,0.998683343734455,0,1,1,4,4,1.55,0,2,2,2,2,1,1,3,2,4,1,3,3,2,3,5,2,3,1,1,1,3,2,1,2,2,0,0,0,0,5,3,5,3,5,1,2,2,5,1,2,2,1,5,3,2,3,1,2,3,4,3,2,3,1,3,1,1,2,1,1,3,2,2,2,3,1,2,1,1,1,1.18802837146737,1.1872336794093274,1.75,0,1.25,0,2.4,0,3.4444444444444446,0,2.4166666666666665,0,2.1666666666666665,0,1.7142857142857142,0,2,0,2.4594594594594597,0,1,0,0,-0.0022802099837430836,-0.01185968282178632,-0.31345356682763886,-0.1626566248247126,1,1,3,1,1,1,1,1,1,1.5735915849388864,1.2857142857142858,0,1,-0.7920494875423887,4,3,3,2,1,1,2,2,1,2,2,1.2724180205607036,1.5,2.2857142857142856,0,-1.1502147610713993,0,-1.328807827160771,1,1,1,1,1,5,4,5,5,3,5,5,5,4,4,5,5,4,4,4,1.5946338585572373,1,0,4.8,0,4.2,0,4.4,0,4.466666666666667,0,1,1,1,1,2,1,1,1,1,2,1,2,2,1,1,2,1,1,1,2,1.0310954828418375,1.3,0,I lived with my mother and father an equal amount of time (joint custody),0,"White, Caucasian, Anglo, European American",0,23,1,2,NA,1,3,3,Cashier,4,180,65,2,5,2,0,0,0,0,0,TRUE,TRUE,TRUE,TRUE,TRUE,5,0.6139750000005588,0.5069250000016764,0.6019937499994412,0.6804161290372571,0.6010937499981374,0.7247562500005588,1,1,1,1,1,1,0.094,0.408,0.501,0.012,1.606,63.500882620261244,1846.2429280720182,0.106,0.348,0.694,0.016,1.796,50.973101160733925,1835.3850834438872,0.125,0.345,0.478,0.017,1.478,23.0818027769376,1804.3781763041734,133.83333333333334,112.25,86.94117647058823,FALSE,360,1.0666666666666667,0,1,0,3,6,FALSE
232,2022-03-18T17:59:28Z,2022-03-18T18:32:39Z,1990,1,2022-03-18T18:32:39Z,1,Chrome,99.0.4844.51,Macintosh,1680,1050,N/A,1.6,962,108,632,69,40,82,0.5842196667509313,-0.05463631943916262,0.801752476579112,-0.3591021620091827,-0.42839035117209495,-0.18633829647417754,3,3,1,1,3,1,1,3,1,3,3,2,1,1,3,3,1,1,3,2,0.5982430416161189,0,0,2,3,2,2,0,4,2,3,2,3,2,3,3,1,3,3,4,1,4,3,1,3,2,1,3,4,4,3,1,2,0,0,0,0,1,4,4,2,4,1,2,1,2,5,3,2,1,4,3,1,3,5,5,5,5,5,5,1,1,1,1,1,1,1,1,2,1,1,1,1,1,1,1,1,1,1.7137493798501977,0.9102589898327995,2.625,0,1,0,2.7333333333333334,0,2.3333333333333335,0,3.5,0,2.3333333333333335,0,1.1428571428571428,0,1,0,2.3783783783783785,0,1,0,0,0.5131240115161918,0.48029920202089565,-0.39960647100849406,0.0403463655062008,2,1,2,1,1,2,1,3,1,1.4142135623730951,1.4285714285714286,0,2,-0.32231065268119236,5,5,5,5,3,3,5,7,4,3,3,1.5735915849388864,5.5,4.428571428571429,0,0.1293403779201788,0,0.6115959209820738,1,1,1,2,2,5,4,5,5,2,5,5,3,3,4,3,5,5,3,2,1.486446705914413,1.4,0,5,0,3,0,3.8,0,3.933333333333333,0,1,1,1,1,1,1,1,3,1,1,1,2,1,1,1,3,1,1,1,1,0.812727700887249,1.25,0,I lived with my mother and father an equal amount of time (joint custody),0,Black or African American,0,21,1,2,NA,1,3,4,Student,4,157,65,1,5,2,1,1,1,0,2,TRUE,TRUE,TRUE,TRUE,TRUE,3,0.521599999997885,0.4346968750022352,0.46584062499925494,0.6274600000003974,0.4883645161294168,0.5412000000005768,0.96875,1,1,0.967741935483871,0.96875,0.96875,0.068,0.362,0.672,0.019,1.723,63.64365129884743,1892.0989311526855,0.058,0.344,0.659,0.025,1.671,27.535106757256287,1856.2073063576806,0.065,0.387,0.461,0.008,1.265,104.81860593161558,1976.1115324184566,90.6842105263158,66.84,158.12499999999997,FALSE,392,1.1614814814814816,0,1,0,0,3,FALSE
233,2022-03-18T17:41:47Z,2022-03-18T18:33:38Z,3109,1,2022-03-18T18:33:38Z,0.699999988079071,Chrome,99.0.4844.74,Windows NT 10.0,1024,768,No feedback thankyou,1.3333333333333333,1149,402,862,382,88,99,0.9687103240858724,1.5687598528329783,1.6374044792838869,3.501022256252453,0.5558914668975398,0.004711487137208345,2,2,2,2,3,2,2,3,1,2,2,2,2,2,2,2,2,2,2,2,0.5871429486123998,0,0,2,5,5,2.05,0,5,1,4,2,4,2,5,5,5,4,5,4,3,4,1,4,5,3,1,4,5,5,4,3,2,0,0,0,0,1,2,3,2,1,1,1,1,3,3,2,5,2,2,5,1,5,5,5,5,5,4,1,1,1,1,1,1,3,3,1,2,2,1,1,1,5,1,1,1,1,1.677442640990688,1.505545305418162,3.875,0,1,0,3.6,0,1.6666666666666667,0,3.75,0,1.5,0,1.8571428571428572,0,2.3333333333333335,0,2.4054054054054053,0,2,0,0,1.3421571848224692,1.4162369174919531,-0.18024366757246235,0.6179966249597454,2,2,3,2,1,1,1,1,1,1.1547005383792515,1.7142857142857142,0,1,-0.5432457265250663,5,5,5,5,4,4,5,6,3,1,3,1.4638501094227998,4.5,4.714285714285714,0,-0.4789400316506016,0,0.39590405157220343,3,3,3,2,3,4,4,4,4,2,5,4,3,5,4,4,4,4,4,2,1.1952286093343936,2.8,0,4.2,0,3.4,0,3.8,0,3.8,0,1,2,1,1,2,2,1,1,1,2,1,2,1,3,3,2,1,2,2,1,1.025978352085154,1.6,0,I lived with my mother and father an equal amount of time (joint custody),0,"White, Caucasian, Anglo, European American",0,21,0,1,NA,1,2,1,Doordash delivery driver,1,180,72,2,5,2,1,1,4,0,2,TRUE,TRUE,TRUE,TRUE,TRUE,4,0.7828451612889766,0.9047935483840204,0.9911562499981373,0.8053343750000932,0.7395906249987892,1.131796875001397,1,1,1,1,1,1,0.132,0.254,0.178,0.061,1.998,136.16003001064087,1918.4049683623061,0.112,0.346,0.251,0.259,1.267,162.91677968694822,1948.8735374810442,0.095,0.464,0.293,0.155,1.521,44.08565546685093,1826.7055040247535,32.75409836065574,4.891891891891891,9.812903225806451,FALSE,338,1.0014814814814814,0,1,0,6,9,FALSE
234,2022-03-18T18:05:24Z,2022-03-18T18:33:51Z,1706,1,2022-03-18T18:33:52Z,1,Chrome,98.0.4758.82,Windows NT 6.1,1920,1080,none,1.7777777777777777,590,135,489,92,61,262,-0.18064944837526176,0.09445108413685033,0.2821949270713607,-0.07545084692925424,0.0022329442333702625,1.8365417652934377,4,4,3,3,4,2,3,3,2,4,3,3,3,2,4,4,3,2,3,4,0.8255779474818965,0,1,2,3,3,3.15,0,1,2,3,2,3,2,1,2,1,2,1,1,2,2,2,2,1,2,1,1,1,1,1,0,2,0,0,0,0,1,1,1,1,1,1,1,1,1,1,2,1,1,1,2,1,2,1,1,1,1,2,1,1,1,2,1,1,1,1,1,1,1,2,1,1,1,1,1,1,1,1.849031886939465,1.4074631010979937,1.25,0,1,0,1.8,0,1,0,1.25,0,1.3333333333333333,0,1.1428571428571428,0,1,0,1.162162162162162,0,0,0,0,-1.1690676390814674,-1.058520855702007,-0.6189692744445258,-0.8387450650732664,1,1,3,2,1,1,1,2,2,1.5275252316519468,1.4285714285714286,0,2,-0.32231065268119236,5,5,5,5,3,4,5,6,10,3,3,1.5275252316519468,8,4.571428571428571,0,0.5809148901979743,0,0.9640478970718698,2,2,2,2,2,4,4,4,4,3,4,4,3,4,4,5,5,4,4,3,1.1338934190276817,2,0,4.2,0,3.8,0,3.8,0,3.933333333333333,0,1,1,3,2,2,3,3,3,1,2,3,3,3,1,1,3,1,2,1,4,0.9445132413883326,2.15,0,"I lived with my mother, but not father, most of the time.",0,"White, Caucasian, Anglo, European American",0,27,0,1,NA,1,2,6,College tutor/Gig worker,2,180,75,1,5,2,0,1,1,0,1,TRUE,TRUE,TRUE,TRUE,TRUE,4,0.8129451612964753,0.5690156250447035,0.6407781249880791,0.8954333333333333,0.6502466666698455,0.8051406249850989,0.96875,1,1,0.967741935483871,0.9375,1,0.131,0.389,0.499,0.013,1.831,51.85835946598483,1836.715440670561,0.06,0.431,0.422,0.01,1.365,120.15952732543224,1964.7236660369233,0.094,0.53,0.328,0.019,1.678,66.84846163602103,1849.2637208435474,140.84615384615384,136.5,88.3157894736842,TRUE,343,1.0162962962962963,0,1,0,0,3,FALSE
236,2022-03-18T18:09:48Z,2022-03-18T18:36:11Z,1583,1,2022-03-18T18:36:13Z,1,Chrome,99.0.4844.51,Macintosh,1440,900,NA,1.6,475,64,235,70,51,72,-0.41710092213739136,-0.2975935697111837,-0.6406555454808689,-0.34676949613614233,-0.20282576786447032,-0.29872052212793393,1,1,1,1,1,1,1,1,1,1,1,1,1,1,1,1,1,1,1,1,1.538967528127731,0,1,1,3,3,1,0,1,1,2,1,2,1,1,1,1,1,1,2,1,1,2,1,2,1,1,1,2,1,1,4,1,1,0,0,0,1,2,1,2,3,1,4,1,2,1,1,1,1,2,1,1,1,1,2,2,1,1,1,1,1,1,1,1,4,4,1,1,1,1,1,2,1,2,1,2,2,1.7098021591469066,1.8464895909600492,1.25,0,1.75,0,1.2666666666666666,0,1.8888888888888888,0,1.25,0,1,0,1.8571428571428572,0,1.3333333333333333,0,1.4864864864864864,0,2,0,0,-0.9585195315751113,-1.1497742912932176,0.07821504497010326,-0.5357796231615571,1,1,2,1,1,2,1,1,1,1.6761634196950514,1.2857142857142858,0,1,-0.7920494875423887,4,4,4,4,3,3,5,7,6,NA,3,1.1126972805283737,6.5,3.857142857142857,0,0.5451397626206321,1,0.5552442657491192,2,2,3,3,3,3,3,4,4,4,5,2,3,4,4,2,3,4,2,1,1.0997835284835873,2.6,0,3.4,0,2.8,0,3.4,0,3.2,0,2,1,2,2,3,1,2,2,1,1,2,2,1,2,1,2,2,2,1,2,0.7880689256524124,1.7,0,I lived with my mother and father an equal amount of time (joint custody),0,"Asian or Asian American (e.g., Chinese, Japanese, and others)",0,24,1,2,NA,1,3,6,Veterinary assistant,2,135,62,3,5,2,0,0,1,0,0,TRUE,TRUE,TRUE,TRUE,TRUE,5,0.500109677416663,0.45821562498807905,0.4688249999973923,0.5663999999995742,0.531364516135185,0.5532607142903975,0.96875,1,1,0.875,0.96875,0.9032258064516129,0.055,0.353,0.52,0.015,1.708,56.72173051086478,1914.8882817300805,0.072,0.308,0.503,0.016,1.605,49.47656235266607,1873.8563256983625,0.055,0.343,0.371,0.015,1.706,67.4869280841304,1970.985352095465,113.86666666666667,100.3125,113.73333333333333,FALSE,436,1.2918518518518518,0,1,0,3,6,FALSE
237,2022-03-18T17:45:56Z,2022-03-18T18:36:30Z,3034,1,2022-03-18T18:36:32Z,0.8999999761581421,Chrome,99.0.4844.74,Windows NT 10.0,1366,768,Very informative survey!,1.7786458333333333,718,103,639,147,69,201,0.0825313224208477,-0.08224509787916502,0.8271853636179529,0.602845776087966,0.1662799139116427,1.1510101888055237,2,2,1,1,2,1,1,2,1,2,2,1,1,1,2,2,1,1,2,2,1.025978352085154,0,1,1,4,3,1.5,0,4,2,3,3,4,3,2,3,4,3,4,3,4,3,3,3,3,1,2,3,3,3,3,5,1,1,0,0,0,3,3,3,3,3,2,2,2,2,3,3,3,3,4,3,4,4,4,3,5,5,3,1,1,1,4,2,3,4,4,2,3,3,3,2,3,2,3,1,2,3,0.9856325235459062,0.6172133998483676,2.625,0,2.25,0,3.2,0,2.5555555555555554,0,3.6666666666666665,0,2,0,3.142857142857143,0,2.3333333333333335,0,2.918918918918919,0,3,0,0,0.8640375240267854,0.920046361464746,0.4698836567678454,0.6949650091162958,2,2,3,2,1,2,2,4,1,0.9511897312113419,2,0,2.5,0.20282981926961546,4,4,4,4,3,3,4,4,8,5,4,0.7867957924694432,6,3.7142857142857144,0,0.9905165020526746,0,0.749115892898398,3,2,3,2,3,3,4,4,4,3,4,4,4,3,3,4,4,5,4,4,0.9611501047232549,2.6,0,4,0,3.8,0,3.6,0,3.8,0,3,2,3,3,2,3,4,3,3,3,2,3,3,4,3,3,3,4,3,4,0.7451598203705946,3.05,0,I lived with my mother and father an equal amount of time (joint custody),0,"White, Caucasian, Anglo, European American",0,21,0,1,NA,1,2,4,Stocking Associate (Retail),2,180,69,2,5,2,1,1,1,0,2,TRUE,TRUE,TRUE,TRUE,TRUE,5,0.47573750000447035,0.4177343749925494,0.4709406249932945,0.5258851851931324,0.49093000000317893,0.5675677419247166,1,1,1,0.84375,0.9375,0.96875,0.078,0.307,0.512,0.014,1.709,152.1571892961877,1991.6090714830973,0.061,0.311,0.601,0.023,1.915,61.904389346460256,1906.6213764134473,0.049,0.336,0.379,0.018,1.635,149.24622102972273,2053.9145922889657,122.07142857142857,83.26086956521739,90.83333333333334,FALSE,358,1.0607407407407408,0,1,0,0,3,FALSE
238,2022-03-18T18:17:21Z,2022-03-18T18:36:32Z,1151,1,2022-03-18T18:36:33Z,0.8999999761581421,Firefox,98.0,Windows NT 6.1,1920,1080,NA,1.7777777777777777,632,63,241,53,27,60,-0.09429325795778834,-0.3031153253991842,-0.6188559280190052,-0.5564248159778286,-0.6949666768992877,-0.4335791929124416,2,3,1,1,2,1,1,3,1,2,3,1,1,1,2,3,1,1,2,3,0.8506963092234007,0,1,1,3,3,1.75,0,2,2,1,1,1,1,2,2,1,1,1,2,1,2,2,1,1,1,1,1,1,1,1,1,2,0,0,0,0,2,3,2,2,2,1,2,1,3,2,2,1,1,3,1,3,1,1,1,1,1,2,1,1,1,1,1,1,2,2,2,1,1,2,1,1,1,1,2,2,2,1.4415540496554675,1.5976172734359604,1,0,1.75,0,1.4666666666666666,0,2,0,1.5,0,1.1666666666666667,0,1.5714285714285714,0,1,0,1.5405405405405406,0,1,0,0,-1.0857256798602015,-1.1480042893097673,-0.14114775846592847,-0.6445760238878478,2,2,3,1,2,3,2,1,1,0.9759000729485332,2.142857142857143,0,1,-0.29444196550774376,5,4,5,5,1,1,5,5,9,2,3,2.0354009783964297,7,3.7142857142857144,0,0.18645978295702492,0,0.25937337551237094,2,2,1,2,1,4,3,3,5,2,5,3,5,1,1,4,4,5,2,3,1,1.6,0,4.2,0,3.2,0,2.6,0,3.3333333333333335,0,1,1,1,2,1,1,1,4,1,1,2,1,1,1,1,2,1,1,1,1,0.8825799501580878,1.3,0,"I lived with my mother, but not father, most of the time. & I lived with my extended family on mother's side (grandparents, aunts ,uncles, cousins)",1,"Asian or Asian American (e.g., Chinese, Japanese, and others)",0,26,0,1,NA,1,3,6,Support Associate,3,133,67,2,5,2,0,0,1,0,0,TRUE,TRUE,TRUE,TRUE,TRUE,6,0.5616875,0.4625,0.5656875,0.5814516129032258,0.5767931034482758,0.5856774193548387,1,1,1,0.96875,0.9354838709677419,1,0.103,0.376,0.594,0.028,1.112,36.12358461493156,1819.0606417241886,0.06,0.349,0.459,0.014,1.451,123.56789164794132,1993.39505867906,0.061,0.413,0.454,0.033,1.675,162.42710383272257,1985.6714164129528,39.714285714285715,103.64285714285714,50.75757575757576,FALSE,355,1.0518518518518518,0,1,0,3,9,FALSE
239,2022-03-18T18:15:26Z,2022-03-18T18:40:40Z,1514,1,2022-03-18T18:40:42Z,0.8999999761581421,Edge,99.0.1150.39,Windows NT 10.0,1920,1080,No,1.7777777777777777,681,94,449,98,60,78,0.006455630862597304,-0.13194089907116932,0.1368641439922694,-0.0014548516910120387,-0.018272926976413795,-0.2312911867356801,3,3,2,1,3,1,3,3,2,3,3,3,1,2,3,3,3,1,3,4,0.6407232755171874,0,1,1,5,5,2.5,0,1,1,1,2,1,1,4,1,1,1,1,1,1,3,4,5,1,1,1,1,3,1,3,3,2,0,0,0,0,3,4,1,4,5,3,3,1,5,2,1,1,1,1,1,1,2,3,4,1,5,1,1,3,1,3,1,1,2,2,1,1,1,1,1,1,3,1,2,1,3,1.5744773669313188,1.6676187756655838,2,0,1.75,0,1.6,0,3.2222222222222223,0,1.9166666666666667,0,1.6666666666666667,0,1.2857142857142858,0,1.6666666666666667,0,2.054054054054054,0,2,0,0,-0.1031678448305387,-0.42899015025488435,0.07821504497010326,-0.17538755264239053,1,1,1,1,1,1,1,1,3,1.9518001458970664,1,0,2,-0.571114413698515,5,5,5,5,5,5,5,7,6,6,4,1.5118578920369088,6.5,5,0,1.2946567068380648,0,1.6309885800101043,2,1,2,2,2,4,5,3,3,3,4,3,4,5,5,3,4,5,3,1,1.2798809468443688,1.8,0,4,0,3.6,0,3.4,0,3.6666666666666665,0,3,1,3,3,4,3,4,3,2,4,1,3,2,1,2,3,1,2,1,4,1.0809352675491624,2.5,0,I lived with my mother and father an equal amount of time (joint custody),0,"White, Caucasian, Anglo, European American",0,26,1,3,NA,1,2,5,student,7,127,62,3,5,2,0,0,1,0,0,TRUE,TRUE,TRUE,TRUE,TRUE,4,0.591309374999255,0.52665625,0.5771687500011176,0.6447870967791927,0.5600593750011176,0.6344843749962747,1,1,1,1,1,1,0.214,0.328,0.859,0.024,1.57,59.48831633133919,1842.3649426794082,0.229,0.216,0.733,0.034,1.546,163.60987470474953,1954.2062960280866,0.261,0.29,0.873,0.012,1.005,19.947923173606682,1800.0112884752211,65.41666666666667,45.470588235294116,83.74999999999999,FALSE,530,1.5703703703703704,0,1,0,0,3,FALSE
240,2022-03-18T18:18:40Z,2022-03-18T18:42:07Z,1406,1,2022-03-18T18:42:09Z,0.800000011920929,Chrome,99.0.4844.51,Macintosh,1920,1080,N/A,1.7777777777777777,621,86,361,130,41,60,-0.116910355448079,-0.17611494457517315,-0.18286357878173143,0.39319045624627974,-0.40788447996231086,-0.4335791929124416,2,2,1,1,2,1,1,3,1,3,2,1,1,1,2,2,1,1,3,2,0.9333020044867296,0,0,4,5,5,1.65,0,1,1,2,2,1,1,3,1,2,1,1,1,1,2,1,1,2,1,1,1,1,1,1,3,2,0,0,0,0,1,1,1,1,1,1,1,1,1,2,1,1,1,1,1,1,1,1,1,1,2,1,1,1,1,3,2,1,3,2,1,1,2,2,1,2,1,2,1,2,2,1.8079736637376023,1.7511900715418263,1.125,0,1.75,0,1.4,0,1,0,1.1666666666666667,0,1.5,0,1.7142857142857142,0,1.3333333333333333,0,1.2972972972972974,0,2,0,0,-1.1624880107218938,-1.2287360464438017,0.07821504497010326,-0.5752605007368492,3,2,5,2,1,3,3,4,3,0.8997354108424374,2.7142857142857144,0,3.5,1.0043070021539087,3,3,5,2,1,1,2,6,4,2,1,1.4960264830861913,5,2.4285714285714284,0,-0.8612210608997602,0,-1.0753821191296364,2,2,2,3,3,2,3,2,3,4,3,2,4,5,4,5,3,3,3,1,1.0997835284835873,2.4,0,2.6,0,3.8,0,3,0,3.1333333333333333,0,1,1,3,3,2,4,3,3,4,1,1,3,1,3,1,3,1,3,3,3,1.0399898784932577,2.35,0,I lived with my mother and father an equal amount of time (joint custody),0,Black or African American,0,30,0,1,NA,1,3,4,Photographer/Business Owner,4,255,70,4,5,2,0,0,1,0,0,TRUE,TRUE,TRUE,TRUE,TRUE,5,0.5012806451628286,0.4382656249944121,0.4702312499955297,0.526643750006333,0.49264193548310187,0.526503125011921,1,1,1,1,1,1,0.1,0.344,0.824,0.029,1.949,28.210273579453315,1809.4279482072827,0.116,0.281,0.773,0.014,1.178,66.09276559117295,1852.44669973417,0.091,0.379,0.758,0.021,1.071,127.30543940244691,1919.7311527248114,67.20689655172414,84.14285714285714,50.99999999999999,FALSE,304,0.9007407407407407,1,1,0,0,3,FALSE
241,2022-03-18T18:15:59Z,2022-03-18T18:42:09Z,1570,1,2022-03-18T18:42:10Z,1,Firefox,98.0,Windows NT 10.0,1536,864,NA,1.7777777777777777,568,112,529,90,62,109,-0.22588364335584307,-0.0325492966871607,0.42752571015045193,-0.10011617867533498,0.02273881544315432,0.11709371279096474,3,1,1,1,2,1,1,3,1,3,3,1,1,1,2,2,1,1,2,3,0.9514531821875089,0,0,4,5,5,1.7,0,3,3,2,2,4,4,2,3,1,3,4,3,2,4,3,3,1,1,1,2,2,4,2,2,1,1,0,1,0,1,2,2,3,4,1,2,3,1,2,2,1,1,2,1,1,4,2,1,1,2,1,1,3,1,5,4,1,4,4,4,4,4,4,1,3,1,4,1,1,1,1.4997497288712036,0.9258200997725514,2,0,1.75,0,2.8666666666666667,0,2.111111111111111,0,1.6666666666666667,0,2.5,0,3.5714285714285716,0,1.6666666666666667,0,2.27027027027027,0,1,0,0,0.037197560173698525,0.21843724191378996,-0.14114775846592847,0.038644741723930745,2,2,2,1,1,2,1,1,1,1.3451854182690985,1.5714285714285714,0,1,-0.6261803135308405,4,3,5,3,1,1,1,4,4,2,2,1.6761634196950514,4,2.5714285714285716,0,-0.698640248793604,0,-0.8989531758302978,2,2,1,1,2,5,4,5,5,3,5,5,5,4,4,5,5,5,3,5,1.6388149028228556,1.6,0,5,0,4,0,4.6,0,4.533333333333333,0,2,3,1,2,2,1,4,2,1,1,2,2,2,2,1,2,2,1,1,2,0.9176629354822471,1.8,0,I lived with my mother and father an equal amount of time (joint custody),0,"White, Caucasian, Anglo, European American",0,22,1,2,NA,1,3,4,None currently,3,115,64,2,5,2,0,0,0,0,0,TRUE,TRUE,TRUE,TRUE,TRUE,2,0.4866875,0.42170967741935483,0.4893125,0.5468666666666666,0.50521875,0.5334193548387097,1,0.96875,1,0.9375,1,0.96875,0.061,0.368,0.483,0.04,1.87,79.08891964445708,1901.0847196400832,0.062,0.333,0.579,0.031,1.868,132.22979040311728,1972.5175829598252,0.056,0.374,0.57,0.012,1.323,117.93481184466184,1966.5900177692945,46.75,60.25806451612904,110.25,FALSE,391,1.1585185185185185,0,1,0,0,3,FALSE
242,2022-03-18T18:21:08Z,2022-03-18T18:42:39Z,1291,1,2022-03-18T18:42:40Z,0.8999999761581421,Firefox,98.0,Windows NT 10.0,1920,1080,NA,1.7777777777777777,596,61,352,72,52,91,-0.16831284974419414,-0.31415883677518514,-0.21556300497452696,-0.3221041643900616,-0.18231989665468626,-0.08519429338579677,1,2,1,1,2,1,1,2,1,1,2,1,1,2,2,2,1,1,2,2,1.1367080817685316,0,0,3,3,3,1.45,0,2,2,3,2,2,2,1,2,3,1,5,2,1,2,2,5,4,4,1,1,3,3,2,5,2,0,0,0,0,1,2,2,4,2,1,5,5,4,2,1,1,1,2,2,1,2,1,1,1,2,5,1,5,4,3,1,1,5,4,1,2,2,2,1,1,1,3,3,3,4,1.5744773669313188,1.3201731488169053,2.875,0,3.25,0,2.1333333333333333,0,2.888888888888889,0,1.4166666666666667,0,3.1666666666666665,0,2.4285714285714284,0,1,0,2.2162162162162162,0,3,0,0,0.5701474572991626,0.2566889514450194,0.8144952734912662,0.5355921124681428,2,1,3,1,1,2,1,3,1,1.2149857925879117,1.5714285714285714,0,2,-0.23937606567541822,2,4,2,2,1,1,2,4,2,2,1,1.2535663410560174,3,2,0,-1.2224806707219966,0,-1.527629585530963,2,1,1,3,2,5,5,4,5,3,5,4,2,3,4,2,5,4,2,5,1.4735767952260144,1.8,0,4.6,0,2.8,0,4.2,0,3.8666666666666667,0,1,1,3,4,3,2,2,4,2,2,1,2,3,2,1,2,1,2,1,3,0.8522416262267903,2.1,0,"I lived with my mother, but not father, most of the time.",0,"White, Caucasian, Anglo, European American",0,22,0,1,NA,1,3,5,Student,4,150,72,1,5,2,1,0,1,0,1,TRUE,TRUE,TRUE,TRUE,TRUE,3,0.616516129032258,0.58021875,0.63990625,0.71071875,0.6875333333333333,0.7731333333333333,0.96875,1,1,1,0.9375,0.9375,0.089,0.455,0.508,0.014,2.087,57.140195961208434,1902.9777097581778,0.074,0.432,0.547,0.012,1.802,109.57051751257049,1956.9836591032783,0.15,0.407,0.714,0.013,1.419,145.93096071661304,1971.3375329447483,149.07142857142858,150.16666666666666,109.15384615384616,FALSE,345,1.0222222222222224,0,1,0,3,6,FALSE
243,2022-03-18T18:28:26Z,2022-03-18T18:43:15Z,888,1,2022-03-18T18:43:16Z,0.8999999761581421,Chrome,99.0.4844.51,Windows NT 10.0,1280,720,NA,1.7777777777777777,547,54,135,21,24,62,-0.26906173856457977,-0.3528111265911885,-1.0039825031785972,-0.9510701239151204,-0.7564842905286399,-0.41110274778169037,2,1,4,3,2,2,3,2,2,3,3,2,1,3,2,3,3,3,1,2,0.7863975156570492,0,1,1,2,2,2.35,0,3,2,4,3,3,3,4,4,3,3,2,3,4,2,2,2,3,1,1,1,1,1,1,0,2,0,0,0,0,2,3,2,2,2,1,3,2,2,2,2,2,3,3,3,4,4,3,2,4,4,2,1,1,1,3,1,1,1,1,1,2,1,1,1,1,1,2,2,2,1,1.3445474360571321,0.7037315505489968,1.375,0,1.75,0,3,0,2.111111111111111,0,3,0,1.5,0,1.1428571428571428,0,1,0,2.027027027027027,0,0,0,0,-0.5264572692964425,-0.10242478430832193,-0.3605105619019602,-0.23146767310514105,3,4,3,3,4,3,4,1,1,0.5345224838248488,3.4285714285714284,0,1,0.45196931754422376,3,4,4,4,3,3,4,7,8,6,4,0.7559289460184544,7.5,3.5714285714285716,0,1.475286511749183,0,0.9669815479429806,3,2,2,2,2,3,2,2,3,3,3,4,3,2,3,3,4,3,4,2,0.6761234037828132,2.2,0,3.4,0,3,0,2.4,0,2.933333333333333,0,3,2,2,2,2,3,3,4,1,1,3,3,2,2,2,3,1,2,1,1,0.7591546545162482,2.15,0,I lived with my mother and father an equal amount of time (joint custody),0,"Asian or Asian American (e.g., Chinese, Japanese, and others)",0,22,0,1,NA,1,4,3,unemployed,6,160,68,4,5,2,0,0,1,0,0,TRUE,TRUE,TRUE,TRUE,TRUE,3,1.0674250000072643,0.5069032258054903,0.613674999997951,1.3250137931087922,0.5942333333273728,0.7985346153859909,1,1,1,0.90625,0.9375,0.8387096774193549,0.069,0.357,0.315,0.007,1.59,269.786223581951,2182.8080428453422,0.071,0.33,0.476,0.01,1.579,66.46799251377148,1910.0284902328638,0.122,0.247,0.121,0.007,1.353,120.18724075057008,2004.5133610326166,227.14285714285714,157.9,193.28571428571428,FALSE,356,1.0548148148148149,0,1,0,0,3,FALSE
244,2022-03-18T18:14:32Z,2022-03-18T18:44:00Z,1767,1,2022-03-18T18:44:01Z,0.8999999761581421,Chrome,99.0.4844.74,Windows NT 10.0,1536,864,n/a,1.7777777777777777,773,143,520,107,74,80,0.19561680987230096,0.13862512964085416,0.3948262839576564,0.10953914116635127,0.268809269960563,-0.20881474160492883,2,3,2,3,3,1,1,3,1,2,3,1,1,2,2,2,1,2,3,3,0.7591546545162482,0,1,2,5,4,2.05,0,3,2,2,2,1,1,3,2,2,1,2,3,4,3,2,2,4,1,1,2,3,2,2,3,2,0,0,0,0,1,2,1,1,2,2,3,3,2,2,2,1,1,2,2,1,2,2,1,1,3,3,1,1,1,2,2,1,3,3,2,1,1,2,1,1,1,1,2,2,2,1.4441556652887477,1.121223821162776,2.125,0,1.75,0,2.2,0,1.8888888888888888,0,1.6666666666666667,0,1.6666666666666667,0,1.8571428571428572,0,1,0,1.7027027027027026,0,2,0,0,-0.25011287819435013,-0.2658549674468904,0.07821504497010326,-0.09381996123839358,1,1,1,1,1,1,1,3,1,1.9518001458970664,1,0,2,-0.571114413698515,4,4,4,5,2,3,5,6,6,5,4,1.3801311186847085,6,3.857142857142857,0,0.9905165020526746,0,0.8265185681390751,2,3,2,4,2,4,4,4,4,3,4,3,3,4,4,3,3,5,4,2,0.9611501047232549,2.6,0,3.8,0,3.4,0,3.6,0,3.6,0,2,2,1,2,2,2,3,2,1,1,3,2,2,2,1,3,1,2,2,3,0.7591546545162482,1.95,0,I lived with my mother and father an equal amount of time (joint custody),0,"White, Caucasian, Anglo, European American",0,29,1,2,NA,1,3,6,Administrative,5,108,67,2,5,2,0,0,0,0,0,TRUE,TRUE,TRUE,TRUE,TRUE,5,0.515356249997858,0.4846500000008382,0.4533124999995343,0.593939285716308,0.5885161290312967,0.5949333333328918,1,1,1,0.9032258064516129,0.96875,0.8709677419354839,0.065,0.335,0.606,0.009,1.58,176.15386912524278,2041.8275466590912,0.066,0.348,0.536,0.011,1.412,149.0797995962609,1978.990700093757,0.064,0.356,0.462,0.018,2.004,165.1911995495747,2021.9968452784283,175.55555555555557,128.36363636363637,111.33333333333334,FALSE,430,1.2740740740740741,0,1,1,15,18,FALSE
245,2022-03-18T18:10:42Z,2022-03-18T18:44:16Z,2013,1,2022-03-18T18:44:18Z,1,Safari,15.1,Macintosh,1440,900,no comments,1.6,722,162,526,127,73,98,0.09075572150822611,0.24353848771286327,0.4166259014195201,0.3561924586271586,0.24830339875077895,-0.0065267354281672955,1,1,1,1,1,1,1,1,1,1,2,1,1,2,1,1,1,1,2,2,1.3917047478769187,0,1,1,5,4,1.2,0,2,2,2,3,1,2,2,2,1,2,1,2,2,1,1,3,2,1,1,2,1,2,1,4,1,2,0,2,0,1,1,1,1,2,1,1,1,1,2,2,1,2,1,2,1,3,3,2,2,3,1,1,1,1,3,2,1,3,3,2,1,1,2,1,1,1,2,2,2,2,1.6158932858054431,1.424279266355945,1.625,0,2,0,1.7333333333333334,0,1.1111111111111112,0,2,0,1.5,0,1.8571428571428572,0,1,0,1.5945945945945945,0,2,0,0,-0.644890579768768,-0.7351021599482448,0.16436794915095845,-0.2853671053986432,1,2,3,1,1,1,1,2,1,1.5275252316519468,1.4285714285714286,0,1.5,-0.5157127766089035,4,3,4,3,2,2,4,3,4,NA,2,0.8997354108424374,3.5,3.142857142857143,0,-0.7825102850053112,1,-0.640426834580144,3,3,4,2,3,3,4,4,4,3,5,3,1,5,4,4,2,5,3,1,1.3627702877384937,3,0,3.6,0,3,0,3.6,0,3.4,0,1,2,1,2,2,2,2,1,1,1,2,2,2,1,4,1,2,1,1,1,1.0760551736979407,1.6,0,I lived with my mother and father an equal amount of time (joint custody),0,"Hispanic of Latino (e.g., Mexican American, Central American, and others)",0,19,1,2,NA,1,2,3,I'm a full time student,7,125,62,2,5,2,0,1,1,0,1,TRUE,TRUE,TRUE,TRUE,TRUE,5,0.6652187499999991,0.5874193548387097,0.6415483870967742,0.7904516129032183,0.6513124999999891,0.7675333333333392,1,1,0.96875,0.96875,1,0.967741935483871,0.081,0.407,0.322,0.011,1.454,88.15392104344163,1952.910278432996,0.081,0.4,0.412,0.077,1.832,115.14133076679882,1900.1053865376011,0.179,0.266,0.436,0.007,1.135,159.09501028620525,1980.3638794979852,132.1818181818182,23.792207792207794,162.14285714285714,FALSE,436,1.2918518518518518,0,1,0,0,3,FALSE
246,2022-03-18T18:23:58Z,2022-03-18T18:44:40Z,1242,1,2022-03-18T18:44:41Z,0.8999999761581421,Safari,15.3,Macintosh,1440,900,:),1.6,541,164,273,60,39,71,-0.2813983371956474,0.2545819990888642,-0.5025913015557322,-0.470096154866546,-0.448896222381879,-0.3099587446933096,2,2,1,1,3,1,1,3,1,1,4,1,1,1,2,2,1,1,3,2,1.0052493799000692,0,0,2,4,2,1.7,0,4,2,3,3,4,3,3,4,2,3,4,4,1,4,3,1,3,1,1,1,2,3,2,0,2,0,0,0,0,2,2,1,2,1,1,3,4,3,1,1,3,1,3,3,1,2,2,3,5,5,2,1,1,1,1,1,1,1,2,1,3,3,2,1,1,2,2,1,1,1,1.5102254072756096,0.9154754164341269,1.75,0,1.25,0,3.1333333333333333,0,2.111111111111111,0,2.5,0,1.1666666666666667,0,1.8571428571428572,0,1.3333333333333333,0,1.972972972972973,0,0,0,0,-0.3181023712432777,0.09591377128162597,-0.5328163702636706,-0.2184512994910223,3,3,2,2,3,4,2,3,1,0.816496580927726,2.7142857142857144,0,2,0.42410063037077533,5,4,4,3,1,1,2,3,3,3,2,1.5735915849388864,3,2.857142857142857,0,-0.665444751374891,0,-0.7239287959128027,4,4,4,5,3,3,5,3,3,2,4,3,1,3,3,5,4,3,4,4,1.0997835284835873,4,0,3.4,0,3.4,0,3.2,0,3.3333333333333335,0,1,2,1,2,2,2,2,2,1,2,2,3,3,3,2,3,3,3,1,2,0.7181848464596079,2.1,0,I lived with my mother and father an equal amount of time (joint custody),0,"White, Caucasian, Anglo, European American",0,21,1,2,NA,1,3,4,student,5,180,68,2,5,2,0,0,0,0,0,TRUE,TRUE,TRUE,TRUE,TRUE,4,0.5932903225806508,0.47329032258064563,0.49840625000000366,0.6683124999999909,0.5016874999999995,0.5882000000000001,0.96875,1,1,1,1,0.9375,0.06,0.405,0.682,0.012,1.456,43.51346076747828,1887.9350317227295,0.201,0.187,0.712,0.027,1.311,88.60301430449331,1872.509433568022,0.084,0.38,0.394,0.016,1.557,114.06160005557611,1950.9644797210246,121.33333333333333,48.55555555555556,97.3125,TRUE,426,1.2622222222222224,0,1,0,0,3,FALSE
247,2022-03-18T18:17:01Z,2022-03-18T18:45:12Z,1690,1,2022-03-18T18:45:13Z,0.8999999761581421,Chrome,99.0.4844.74,Windows NT 10.0,1536,864,NA,1.7777777777777777,485,70,410,73,38,78,-0.3965399244189453,-0.26446303558318085,-0.004833369509844606,-0.30977149851702124,-0.46940209359166307,-0.2312911867356801,1,1,1,1,1,1,1,1,1,1,1,1,1,1,1,1,1,1,1,1,1.538967528127731,0,0,2,4,4,1,0,2,2,1,3,2,1,3,1,2,1,1,2,2,3,4,2,2,1,1,1,1,1,1,2,2,0,0,0,0,2,3,2,1,1,1,2,2,1,1,1,1,1,2,2,1,2,1,1,1,1,1,1,1,1,2,1,1,2,2,1,2,2,1,1,2,1,2,1,2,2,1.6265440804496034,1.162919151265879,1.25,0,1.75,0,2,0,1.6666666666666667,0,1.25,0,1.1666666666666667,0,1.5714285714285714,0,1.3333333333333333,0,1.4054054054054055,0,1,0,0,-1.0111565584517004,-0.8650006388447846,-0.14114775846592847,-0.5030741986553565,3,2,4,1,1,1,1,1,1,0.7867957924694432,1.8571428571428572,0,1,-0.4603111395192921,3,3,3,3,1,1,3,2,4,1,2,0.9759000729485332,3,2.4285714285714284,0,-1.0930953560345533,0,-1.216614321186411,2,1,3,1,2,4,1,4,5,1,2,3,5,4,5,1,3,3,1,1,1.5796322658258457,1.8,0,3,0,1.8,0,3.8,0,2.8666666666666667,0,1,1,1,1,1,1,2,1,1,1,1,1,1,1,1,1,1,1,1,1,1.2258187382102494,1.05,0,I lived with my mother and father an equal amount of time (joint custody),0,"White, Caucasian, Anglo, European American",0,29,0,1,NA,1,2,3,supervisor assistant,2,160,72,2,5,2,0,0,1,0,0,TRUE,TRUE,TRUE,TRUE,TRUE,1,0.6003187499996274,0.4828000000016764,0.5317999999998138,0.6314999999980773,0.5562066666657726,0.5707032258073168,1,1,1,1,0.9375,0.96875,0.069,0.382,0.543,0.025,2.041,92.79307962784033,1918.6889382367092,0.054,0.392,0.624,0.015,1.526,38.120956368300966,1882.245062486057,0.085,0.474,0.709,0.027,1.407,24.576191908489907,1806.5279826602703,81.63999999999999,101.73333333333333,52.111111111111114,FALSE,346,1.0251851851851852,0,1,0,0,3,FALSE
248,2022-03-18T18:20:39Z,2022-03-18T18:45:52Z,1512,1,2022-03-18T18:45:52Z,0.8999999761581421,Firefox,98.0,Windows NT 10.0,1920,1080,Survey was very very long,1.7777777777777777,648,93,459,95,63,65,-0.061395661608274664,-0.1374626547591698,0.1731968397620422,-0.03845284931013314,0.043244686652938374,-0.3773880800855634,3,1,4,4,3,1,1,2,1,3,2,4,2,1,3,3,3,1,2,3,1.0894228312566052,0,1,1,4,3,2.35,0,2,1,1,1,2,1,1,1,1,1,1,2,2,1,2,1,1,1,1,1,1,1,2,0,2,0,0,0,0,2,1,1,1,1,1,1,1,1,1,1,1,1,2,1,1,2,1,1,1,1,1,1,1,1,2,1,1,2,1,1,1,1,1,1,1,1,1,1,2,2,1.8647995810481826,1.780850519113991,1.125,0,1.5,0,1.3333333333333333,0,1.1111111111111112,0,1.1666666666666667,0,1.1666666666666667,0,1.1428571428571428,0,1,0,1.135135135135135,0,0,0,0,-1.267762064475072,-1.3286428250652134,-0.4466634660828154,-0.8876531455740144,2,3,4,2,1,2,3,1,2,0.9759000729485332,2.4285714285714284,0,1.5,0.06482933243151565,4,5,5,5,3,3,4,3,3,3,3,1.2149857925879117,3,4.142857142857143,0,-0.3222341343576166,0,0.18174126965160067,1,2,3,3,2,4,5,4,5,3,5,4,4,4,5,4,4,4,5,2,1.4375905768565218,2.2,0,4.2,0,4.2,0,4,0,4.133333333333334,0,1,1,1,3,2,1,2,1,1,2,2,1,2,1,1,2,1,1,1,2,0.9665456669582609,1.45,0,I lived with my mother and father an equal amount of time (joint custody),0,"White, Caucasian, Anglo, European American",0,29,0,1,NA,1,3,4,DISPATCHER,2,192,72,2,5,2,0,0,2,0,0,TRUE,TRUE,TRUE,TRUE,TRUE,6,0.503625,0.4788125,0.54259375,0.6315,0.5966,0.67425,1,1,1,1,0.9375,1,0.112,0.314,0.475,0.014,1.596,65.99300295074127,1851.3529698028847,0.063,0.357,0.482,0.014,1.613,69.23602283532492,1916.5842004548756,0.088,0.339,0.496,0.016,1.755,58.98477718135189,1839.927299588624,114,115.21428571428571,109.68749999999999,FALSE,400,1.1851851851851851,0,1,0,6,9,FALSE
249,2022-03-18T18:29:03Z,2022-03-18T18:47:01Z,1077,1,2022-03-18T18:47:02Z,0.8999999761581421,Firefox,98.0,Windows NT 10.0,3440,1440,NA,2.388888888888889,517,77,297,21,17,50,-0.3307447317199179,-0.22581074576717747,-0.41539283170827745,-0.9510701239151204,-0.9000253889971283,-0.5459614185661981,2,2,1,1,2,1,2,1,1,2,1,2,1,3,1,2,1,1,1,1,1.234376040972246,0,0,3,2,2,1.45,0,2,1,1,2,1,3,2,2,1,1,1,3,1,3,3,1,2,1,1,1,1,2,1,0,2,0,0,0,0,1,2,1,2,5,2,3,1,2,1,1,1,1,3,1,1,3,2,1,2,2,1,1,1,1,1,1,1,1,1,1,1,2,1,4,4,1,2,2,1,1,1.6435331457567874,1.4074631010979937,1.25,0,1.5,0,1.8,0,2.111111111111111,0,1.5833333333333333,0,1,0,1.1428571428571428,0,3,0,1.6486486486486487,0,0,0,0,-0.853245477821933,-0.8461206176879824,-0.4466634660828154,-0.6463920418853989,5,5,5,4,5,5,4,4,1,1.8126539343499315,4.714285714285714,0,2.5,1.7785869723793248,3,4,2,4,2,2,2,3,3,1,1,1,3,2.7142857142857144,0,-1.4363059730518277,0,-1.2708549591033658,3,2,2,2,3,3,2,2,4,3,2,4,4,2,4,3,4,3,2,2,0.8837151016885368,2.4,0,3.2,0,2.8,0,2.8,0,2.933333333333333,0,3,2,3,1,2,4,3,1,3,2,2,2,2,4,2,3,2,2,3,2,0.8013147091860318,2.4,0,I lived with my mother and father an equal amount of time (joint custody),0,"White, Caucasian, Anglo, European American",0,20,0,1,NA,1,1,3,sel employed,2,150,68,2,5,2,0,0,1,0,0,TRUE,TRUE,TRUE,TRUE,TRUE,2,0.57803125,0.49059375,0.507625,0.65,0.5418275862068965,0.584,1,1,1,1,0.90625,1,0.194,0.256,0.78,0.032,2.11,61.17005197578892,1849.145817948374,0.055,0.363,0.497,0.014,1.489,93.76725977203401,1946.201980797384,0.119,0.303,0.421,0.016,1.325,71.68743338770065,1855.6714604008012,65.9375,106.35714285714286,82.8125,FALSE,448,1.3274074074074074,0,1,0,0,3,FALSE
251,2022-03-18T18:16:20Z,2022-03-18T18:49:05Z,1965,1,2022-03-18T18:49:06Z,0.8999999761581421,Chrome,99.0.4844.51,Macintosh,1440,900,NA,1.6,625,127,830,167,52,87,-0.10868595636070058,0.05027703863284649,1.5211398528206137,0.8494990935487733,-0.18231989665468626,-0.13014718364729932,2,3,1,1,3,1,2,3,1,3,3,1,2,1,3,3,1,1,3,3,0.5871429486123998,0,1,3,4,1,2.05,0,1,1,1,1,2,1,1,1,1,1,1,2,1,1,3,3,1,1,1,1,1,1,1,0,1,1,0,0,0,2,2,4,2,5,2,5,4,2,3,2,1,1,3,2,2,3,1,1,1,1,1,1,1,1,1,1,1,1,1,1,2,2,2,1,1,1,1,1,1,1,1.3322067312451078,1.869555587629877,1.25,0,1,0,1.2666666666666666,0,3.111111111111111,0,1.75,0,1,0,1.4285714285714286,0,1,0,1.837837837837838,0,0,0,0,-0.7304257484432254,-0.9963741193941997,-0.6189692744445258,-0.8076716969193627,1,1,2,1,1,1,1,1,1,1.7320508075688772,1.1428571428571428,0,1,-0.874984074548163,5,5,5,5,3,2,5,1,1,3,2,1.7043362064926932,1,4.285714285714286,0,-1.0267043611971274,0,-0.16994148418532656,4,2,4,5,4,2,4,3,3,3,5,3,3,4,4,1,5,5,3,2,1.1751393027860062,3.8,0,4,0,2.8,0,3.2,0,3.3333333333333335,0,1,1,1,2,3,2,3,4,2,1,1,3,1,1,1,3,2,2,1,3,0.8013147091860318,1.9,0,NA,NA,"Hispanic of Latino (e.g., Mexican American, Central American, and others)",0,19,1,2,NA,1,2,3,office assistant,3,120,62,3,5,2,0,0,0,0,0,TRUE,TRUE,TRUE,TRUE,TRUE,4,1.1090354838710157,0.8791718750000582,1.0813781250001049,1.2043999999998318,0.8841387096776236,1.2771193548385655,0.96875,1,1,1,1,0.96875,0.096,0.737,0.228,0.017,1.463,119.59619564778471,1946.339648903331,0.183,0.237,0.301,0.034,1.679,41.784732162504596,1823.9099103456174,0.129,0.515,0.213,0.109,1.379,127.82037881845174,1959.0705054518824,86.05882352941177,49.38235294117647,12.65137614678899,TRUE,304,0.9007407407407407,1,1,0,0,3,FALSE
252,2022-03-18T18:27:24Z,2022-03-18T18:49:36Z,1331,1,2022-03-18T18:49:37Z,0.8999999761581421,Chrome,98.0.4758.109,Macintosh,1440,900,Nope! Thank you!,1.6,539,89,381,105,61,80,-0.28551053673933663,-0.15954967751117172,-0.11019818724218579,0.08487380942027054,0.0022329442333702625,-0.20881474160492883,2,3,2,2,2,2,2,3,2,2,3,3,1,2,2,3,3,2,3,2,0.5712405705774795,0,1,1,3,3,2.3,0,4,3,4,3,3,3,4,3,3,3,4,4,3,4,3,2,4,1,1,2,3,3,4,0,2,0,0,0,0,2,3,3,3,3,1,3,3,3,1,2,3,1,4,2,3,5,5,5,5,5,5,1,1,1,1,2,1,1,1,1,3,3,3,2,3,1,2,2,1,1,1.4210979978592326,0.6399404734221844,2.5,0,1.5,0,3.4,0,2.6666666666666665,0,3.4166666666666665,0,1.8333333333333333,0,1.8571428571428572,0,2,0,2.5675675675675675,0,0,0,0,0.5547949911268244,0.7993912262595569,-0.4466634660828154,0.17636388008837078,2,2,3,1,1,2,2,2,2,1.0690449676496976,1.8571428571428572,0,2,-0.07350689166386981,3,4,3,4,2,2,3,4,4,4,3,0.816496580927726,4,3,0,0.072220972883332707,0,-0.19722166215838044,2,2,3,2,2,4,2,3,4,2,5,4,4,4,4,3,3,4,3,2,0.9611501047232549,2.2,0,4,0,2.8,0,3.4,0,3.4,0,2,2,2,3,3,3,3,3,3,3,3,2,1,1,1,2,1,2,1,3,0.8335087534664907,2.2,0,I lived with my mother and father an equal amount of time (joint custody),0,"White, Caucasian, Anglo, European American",0,23,1,4,genderqueer,1,3,7,unemployed,1,155,63,1,5,2,0,0,1,0,0,TRUE,TRUE,TRUE,TRUE,TRUE,3,0.5818375000013039,0.4986906249998137,0.5461499999985099,0.6666781250005588,0.5471312500042841,0.5956156249977649,1,1,1,1,1,1,0.09,0.372,0.528,0.034,1.949,79.18523474822753,1865.763704697276,0.175,0.253,0.726,0.015,1.22,34.853754640686816,1817.0821127975835,0.134,0.332,0.542,0.014,1.471,84.04498860453327,1867.354674472002,57.3235294117647,81.33333333333333,105.07142857142857,FALSE,434,1.285925925925926,0,1,0,0,3,FALSE
253,2022-03-18T18:32:02Z,2022-03-18T18:49:55Z,1072,1,2022-03-18T18:49:55Z,0.8999999761581421,Chrome,99.0.4844.74,Windows NT 10.0,1920,1080,no,1.7777777777777777,455,52,306,74,52,62,-0.45822291757428346,-0.3638546379671895,-0.3826934055154819,-0.29743883264398085,-0.18231989665468626,-0.41110274778169037,4,3,2,3,4,1,1,4,1,4,4,1,2,2,4,4,1,1,4,4,0.5712405705774795,0,0,2,3,2,2.7,0,1,1,1,1,1,1,1,1,1,1,1,1,1,1,3,1,1,1,1,1,1,1,1,2,2,0,0,0,0,3,4,2,4,5,2,4,2,3,1,2,1,1,3,1,2,1,1,1,1,1,1,1,1,1,3,2,1,2,1,1,1,1,1,1,1,1,1,1,2,2,1.322591867980916,1.98086080374405,1,0,1.5,0,1.1333333333333333,0,3.2222222222222223,0,1.3333333333333333,0,1.5,0,1.1428571428571428,0,1,0,1.7567567567567568,0,1,0,0,-0.9453602748559637,-1.1991376799427733,-0.22730066264678367,-0.7132191712947785,1,1,2,1,1,1,1,3,2,1.7320508075688772,1.1428571428571428,0,2.5,-0.2947777027650296,5,5,5,5,4,3,5,7,6,5,4,1.5275252316519468,6.5,4.571428571428571,0,1.0808314045082337,0,1.2685418045122843,2,1,2,3,3,5,3,3,5,4,4,3,4,4,2,4,4,4,3,4,0.990430401872025,2.2,0,4,0,3.6,0,3.6,0,3.7333333333333334,0,2,2,3,3,3,3,3,4,2,1,3,3,2,3,2,3,1,3,3,3,0.7326950970650465,2.6,0,I lived with my mother and father an equal amount of time (joint custody),0,"White, Caucasian, Anglo, European American",0,26,0,1,NA,1,2,6,retail store manager,2,220,69,1,5,2,0,0,1,0,0,TRUE,TRUE,TRUE,TRUE,TRUE,3,0.53758064516105,0.5186000000002096,0.501203125,0.5991566666665797,0.5650838709678501,0.5679129032257103,0.96875,1,1,0.9375,0.96875,0.96875,0.065,0.366,0.5,0.015,1.396,151.25202922299567,1979.4092702935277,0.071,0.338,0.405,0.03,1.965,97.61230967307804,1927.4860195663725,0.054,0.411,0.414,0.016,1.555,81.26459234777577,1968.2781767934073,93.06666666666666,65.5,97.1875,FALSE,346,1.0251851851851852,0,1,0,0,3,FALSE
254,2022-03-18T18:35:43Z,2022-03-18T18:50:20Z,877,1,2022-03-18T18:50:21Z,0.8999999761581421,Firefox,98.0,Windows NT 10.0,1707,960,"I had no confusion during the survey, I was able to answer the questions to the best of my abilities.",1.778125,449,37,165,39,22,63,-0.4705595162053511,-0.44668097328719664,-0.8949844158692787,-0.7290821382003937,-0.7974960329482079,-0.3998645252163147,1,1,1,1,1,1,1,1,1,1,1,1,1,1,1,1,1,1,1,1,1.538967528127731,0,1,1,5,5,1,0,2,1,1,1,1,1,1,1,1,1,1,1,1,1,1,1,1,1,1,1,1,1,1,0,2,0,0,0,0,1,1,1,1,1,1,1,1,1,1,1,1,1,1,1,1,1,1,1,1,1,1,1,1,1,1,1,1,1,1,1,1,1,1,1,1,1,1,1,1,1,1.9666895707934864,2.007130147392398,1,0,1,0,1.0666666666666667,0,1,0,1,0,1,0,1,0,1,0,1,0,0,0,0,-1.4366391923707953,-1.5586447494702147,-0.6189692744445258,-1.0888070119573703,1,1,2,1,1,1,1,1,1,1.7320508075688772,1.1428571428571428,0,1,-0.874984074548163,5,5,5,5,3,2,5,3,3,3,3,1.7043362064926932,3,4.285714285714286,0,-0.3222341343576166,0,0.25914394489227754,1,1,1,1,1,5,5,5,5,5,5,5,5,5,5,5,5,5,5,5,2.065591117977289,1,0,5,0,5,0,5,0,5,0,1,1,1,1,1,1,1,1,1,1,1,1,1,1,1,1,1,1,1,1,1.231174022502185,1,0,I lived with my mother and father an equal amount of time (joint custody),0,"Hispanic of Latino (e.g., Mexican American, Central American, and others)",0,26,0,3,NA,1,3,6,Lab Technician,4,165,70,4,5,2,0,0,1,0,0,TRUE,TRUE,TRUE,TRUE,TRUE,3,0.45190625,0.37374999999999997,0.42546875,0.5147419354838709,0.4318214285714286,0.4973666666666667,1,1,1,0.96875,0.9032258064516129,0.9375,0.06,0.342,0.764,0.021,1.738,19.1509580514795,1864.619816865034,0.062,0.293,0.837,0.023,1.767,152.60920027448606,2019.8120560552895,0.061,0.33,0.558,0.018,1.68,100.8281667233606,1928.3711215196554,82.76190476190476,76.82608695652173,93.33333333333334,FALSE,247,0.7318518518518519,0,1,0,3,6,FALSE
255,2022-03-18T18:27:20Z,2022-03-18T18:51:10Z,1430,1,2022-03-18T18:51:11Z,0.8999999761581421,Chrome,99.0.4844.74,Windows NT 10.0,1536,864,NA,1.7777777777777777,641,102,392,81,52,75,-0.0757883600111869,-0.0877668535671655,-0.07023222189543568,-0.2111101715326983,-0.18231989665468626,-0.265005854431807,3,3,2,1,3,1,1,3,1,2,4,1,1,1,2,2,1,1,3,3,0.7451598203705946,0,1,1,4,3,1.95,0,2,2,2,3,2,2,2,2,2,1,1,2,2,2,3,2,2,1,2,2,2,2,2,1,2,0,0,0,0,1,3,3,2,2,3,3,3,3,2,3,2,1,3,3,3,3,2,3,3,4,3,3,1,2,3,1,2,3,3,1,2,2,2,1,1,1,2,2,2,2,1.0126823418651703,1.1126972805283737,1.875,0,2,0,2,0,2.5555555555555554,0,2.6666666666666665,0,2.1666666666666665,0,2.142857142857143,0,1,0,2.324324324324324,0,1,0,0,-0.008859838343316686,-0.19092488348083209,-0.05499485428507328,-0.12295986888295268,2,1,3,1,1,2,1,1,1,1.2149857925879117,1.5714285714285714,0,1,-0.6261803135308405,5,5,5,4,3,3,4,1,6,4,3,1.2149857925879117,3.5,4.142857142857143,0,-0.018093929572226358,0,0.366989879597213,3,2,2,3,2,4,3,3,4,2,4,3,3,3,3,2,3,4,2,4,0.6324555320336759,2.4,0,3.6,0,2.4,0,3.4,0,3.1333333333333333,0,1,1,1,2,2,1,2,3,2,1,1,2,2,1,2,3,1,1,1,2,0.6805570473787206,1.6,0,I lived with my mother and father an equal amount of time (joint custody),0,"White, Caucasian, Anglo, European American",0,22,1,2,NA,1,3,5,N/A,5,155,63,1,5,2,0,0,1,0,0,TRUE,TRUE,TRUE,TRUE,TRUE,2,0.457453125,0.4252612903204656,0.42237812499981375,0.5227935483897886,0.47961290322484507,0.5167310344813199,1,0.96875,1,1,0.96875,0.9354838709677419,0.072,0.302,0.622,0.017,1.892,56.93875867264653,1901.7345386193956,0.05,0.318,0.473,0.017,1.437,120.80138495045777,1987.1052907961503,0.091,0.331,0.768,0.014,1.337,70.20949970670648,1852.3426104401806,111.29411764705881,84.52941176470588,95.5,FALSE,382,1.1318518518518519,0,1,0,0,3,FALSE
256,2022-03-18T18:32:07Z,2022-03-18T18:52:45Z,1237,1,2022-03-18T18:52:47Z,0.800000011920929,Chrome,99.0.4844.74,Windows NT 10.0,1536,864,NA,1.7777777777777777,444,94,369,84,29,56,-0.4808400150645741,-0.13194089907116932,-0.15379742216591316,-0.1741121739135772,-0.6539549344797195,-0.4785320831739442,2,2,1,1,2,1,1,2,1,2,2,1,1,1,2,2,1,1,2,2,1.025978352085154,0,0,1,4,5,1.5,0,2,1,1,1,1,1,1,1,1,1,1,2,2,1,2,1,2,1,1,1,1,2,1,0,2,0,0,0,0,1,1,1,1,1,1,1,1,1,1,1,1,1,2,1,1,1,1,1,1,1,1,1,1,1,1,1,1,1,1,1,1,1,1,1,1,1,1,1,1,1,1.9382354750537296,1.8309508328682538,1.25,0,1,0,1.2666666666666666,0,1,0,1.0833333333333333,0,1,0,1,0,1,0,1.027027027027027,0,0,0,0,-1.2567960172091157,-1.3503745160842406,-0.6189692744445258,-0.9846718952643831,1,1,2,1,1,2,1,1,1,1.6761634196950514,1.2857142857142858,0,1,-0.7920494875423887,5,5,5,5,4,4,5,8,6,6,4,1.4638501094227998,7,4.714285714285714,0,1.384971609293624,0,1.531193089698574,2,2,2,1,2,5,3,4,5,3,5,4,5,4,3,5,5,5,3,4,1.3451854182690985,1.8,0,4.8,0,3.8,0,4,0,4.2,0,1,1,1,1,1,1,1,1,1,1,1,1,1,1,1,1,1,1,1,1,1.231174022502185,1,0,NA,NA,"White, Caucasian, Anglo, European American",0,30,0,1,NA,1,4,6,Case Manager,5,150,72,3,5,2,0,0,1,0,0,TRUE,TRUE,TRUE,TRUE,TRUE,6,0.4698419354884855,0.4259249999932945,0.44881874998658894,0.5426806451582139,0.49210333331823347,0.5389133333206176,0.96875,1,1,0.96875,0.9375,0.9375,0.064,0.363,0.743,0.015,1.634,23.850062402305547,1868.542256624449,0.055,0.348,0.702,0.028,1.989,62.153312908853295,1906.4417686924419,0.053,0.362,0.478,0.014,1.418,152.08341141595335,2020.0287573437006,108.93333333333334,71.03571428571429,101.28571428571428,FALSE,388,1.1496296296296296,0,1,0,0,3,FALSE
257,2022-03-18T17:29:23Z,2022-03-18T18:53:03Z,5020,1,2022-03-18T18:53:04Z,0.8999999761581421,Chrome,99.0.4844.74,Windows NT 10.0,1920,1080,No comments,1.7777777777777777,1598,343,585,293,33,75,1.8918991216441001,1.2429762672409501,0.6309888064611797,2.4034149935518596,-0.5719314496405833,-0.265005854431807,3,2,1,1,2,1,1,2,1,3,2,2,1,1,2,2,1,1,3,2,0.9119095061289915,0,1,1,3,4,1.7,0,1,2,2,1,2,2,1,2,1,1,2,2,1,2,2,1,1,1,1,1,1,1,1,0,2,0,0,0,0,2,3,3,2,1,1,2,1,1,3,1,1,1,2,2,1,3,1,1,1,1,1,1,1,1,3,1,1,1,1,1,2,2,2,1,1,1,2,1,1,2,1.6265440804496034,1.533747356112131,1,0,1.5,0,1.6,0,1.7777777777777777,0,1.5,0,1.3333333333333333,0,1.4285714285714286,0,1,0,1.4864864864864864,0,0,0,0,-1.1208170311112609,-1.1133909171889633,-0.4466634660828154,-0.7800271916358894,1,1,2,1,1,2,1,1,1,1.6761634196950514,1.2857142857142858,0,1,-0.7920494875423887,5,5,5,5,4,4,5,7,7,6,4,1.4638501094227998,7,4.714285714285714,0,1.384971609293624,0,1.531193089698574,2,2,2,2,2,5,5,4,5,3,4,2,4,4,4,4,5,4,4,3,1.3201731488169053,2,0,4,0,4,0,4,0,4,0,1,1,1,1,1,1,1,1,1,2,2,2,1,1,1,1,1,1,1,1,1.1367080817685316,1.15,0,I lived with my mother and father an equal amount of time (joint custody),0,"White, Caucasian, Anglo, European American",0,21,1,2,NA,1,3,6,Childcare worker,3,160,65,3,5,2,0,0,0,0,0,TRUE,TRUE,TRUE,TRUE,TRUE,6,0.5659531249995343,0.5213032258064035,0.5163096774201239,0.5976531249997206,0.5639000000001922,0.583153333333383,1,1,0.96875,1,0.96875,0.967741935483871,0.058,0.382,0.414,0.027,2.029,151.11330628145296,2022.0195131092805,0.065,0.373,0.439,0.03,1.771,36.9249007622703,1861.736080195414,0.071,0.402,0.437,0.038,1.679,82.60307353088476,1863.0014166960798,75.14814814814815,59.03333333333333,44.184210526315795,FALSE,447,1.3244444444444445,0,1,0,0,3,FALSE
258,2022-03-18T18:02:02Z,2022-03-18T18:53:07Z,3064,1,2022-03-18T18:53:07Z,0.800000011920929,Chrome,99.0.4844.74,Windows NT 10.0,1920,1080,It was a good study,1.7777777777777777,1032,109,1342,58,41,154,0.7281466507800537,-0.04911456375116214,3.381373876232982,-0.49476148661262676,-0.40788447996231086,0.6228137282328685,1,1,1,1,1,1,1,2,1,1,1,1,1,1,1,1,1,1,1,1,1.5035046776746235,0,1,1,5,5,1.05,0,2,2,1,1,1,1,1,1,1,1,2,2,2,1,2,2,2,1,1,1,1,2,1,1,2,0,0,0,0,1,1,1,1,2,1,1,1,1,2,1,2,2,1,2,2,1,1,3,2,3,1,5,1,1,2,1,2,2,2,2,1,2,2,1,1,1,4,2,2,2,1.6499158227686108,1.709915063331955,1.375,0,2.5,0,1.4,0,1.1111111111111112,0,1.8333333333333333,0,1.8333333333333333,0,1.8571428571428572,0,1,0,1.5945945945945945,0,1,0,0,-0.8071880793049175,-0.9897857786780242,0.11731095407663712,-0.4362374123006935,1,1,3,1,2,1,3,1,2,1.4960264830861913,1.7142857142857142,0,1.5,-0.3498436025973552,5,5,5,4,4,4,4,6,7,5,4,1.0690449676496976,6.5,4.428571428571429,0,1.0808314045082337,0,1.1911391292716074,1,1,2,2,2,5,5,5,4,5,5,5,5,4,5,4,5,5,4,4,1.791514389985135,1.6,0,5,0,4.6,0,4.4,0,4.666666666666667,0,1,1,1,1,1,1,2,2,1,1,2,1,1,1,1,2,1,1,2,2,1.0310954828418375,1.3,0,I lived with my mother and father an equal amount of time (joint custody),0,"White, Caucasian, Anglo, European American",0,26,0,1,NA,1,3,6,Data scientist,4,167,69,3,5,2,0,0,1,0,0,TRUE,TRUE,TRUE,TRUE,TRUE,5,0.5127374999932944,0.5088843750003725,0.5422437500059605,0.5994433333257834,0.5622096774155094,0.567153124999255,1,1,1,0.9375,1,1,0.176,0.3,0.735,0.037,1.52,156.85994518982042,1942.374503746549,0.133,0.321,0.724,0.025,1.613,55.40915582662867,1842.9935337362822,0.068,0.364,0.497,0.012,1.502,119.64548084383996,1989.1855962579866,41.08108108108108,64.52,125.16666666666666,FALSE,436,1.2918518518518518,0,1,0,0,3,FALSE
259,2022-03-18T18:07:18Z,2022-03-18T18:53:35Z,2777,1,2022-03-18T18:53:37Z,0.8999999761581421,Chrome,99.0.4844.51,Macintosh,1440,900,None!,1.6,1042,90,241,596,177,347,0.7487076484984997,-0.15402792182317124,-0.6188559280190052,6.140212753083091,2.3809140045683206,2.791790683350367,1,1,2,1,2,1,1,2,1,1,2,1,1,1,1,1,1,1,2,2,1.3018205875255096,0,1,1,3,2,1.3,0,2,1,1,1,1,1,1,1,3,1,1,2,1,2,1,1,1,1,1,1,2,2,3,0,2,0,0,0,0,1,1,1,1,1,1,1,1,1,1,1,1,1,1,3,3,1,1,1,1,1,1,1,1,1,2,1,1,1,1,1,1,1,1,1,1,1,1,1,1,1,1.894357038308404,1.820517979665599,1.5,0,1,0,1.3333333333333333,0,1,0,1.3333333333333333,0,1.1666666666666667,0,1,0,1,0,1.135135135135135,0,0,0,0,-1.0243158151708476,-1.1649176415960694,-0.6189692744445258,-0.8919434580202976,1,1,3,1,1,1,1,1,1,1.5735915849388864,1.2857142857142858,0,1,-0.7920494875423887,5,5,5,5,1,1,5,7,3,NA,3,2.138089935299395,5,3.857142857142857,0,0.13872270157061628,1,0.3076998949849121,1,1,1,3,1,5,5,5,5,2,5,5,2,4,5,5,5,5,5,3,1.8309508328682538,1.4,0,5,0,3.8,0,4.4,0,4.4,0,1,1,1,1,2,1,1,1,1,1,1,1,1,2,1,1,1,1,1,1,1.2182817926554552,1.1,0,I lived with my mother and father an equal amount of time (joint custody),0,"White, Caucasian, Anglo, European American",0,23,1,2,NA,1,3,6,Talent Acquisition Specialist,4,115,64,3,5,2,0,0,1,0,0,TRUE,TRUE,TRUE,TRUE,TRUE,4,0.5988225806466033,0.4737709677406857,0.5466451612912839,0.6547032258063554,0.5434785714282521,0.6354419354839671,0.96875,0.96875,1,0.96875,0.875,0.96875,0.075,0.379,0.477,0.02,2.076,274.47748086275044,2098.6626527218673,0.054,0.357,0.456,0.02,1.956,188.77500414043402,2098.3325958696714,0.061,0.401,0.375,0.022,1.995,176.10393730302715,2050.1984305339333,103.8,97.8,90.68181818181819,FALSE,434,1.285925925925926,0,1,0,0,3,FALSE
260,2022-03-18T18:30:48Z,2022-03-18T18:55:29Z,1480,1,2022-03-18T18:55:31Z,0.8999999761581421,Chrome,99.0.4844.74,Windows NT 10.0,1536,864,N/A,1.7777777777777777,970,53,270,48,27,61,0.6006684649256882,-0.35833288227918897,-0.513491110286664,-0.6180881453430304,-0.6949666768992877,-0.42234097034706597,2,2,1,1,2,1,1,2,1,2,2,1,2,1,2,2,1,1,2,2,0.998683343734455,0,0,2,3,3,1.55,0,4,2,2,2,2,2,4,3,2,1,2,4,1,3,4,2,2,1,1,1,1,2,2,2,2,0,0,0,0,2,3,4,3,4,1,2,2,2,1,3,1,2,2,4,3,2,2,3,1,2,1,1,1,1,3,1,1,2,2,1,2,1,2,1,1,1,1,1,1,2,1.2956383286545203,0.8837151016885368,1.5,0,1.25,0,2.533333333333333,0,2.5555555555555554,0,2.1666666666666665,0,1.3333333333333333,0,1.5714285714285714,0,1,0,1.9189189189189189,0,1,0,0,-0.5154912220304866,-0.2987966710277694,-0.31345356682763886,-0.3061251189277041,1,1,1,1,1,2,2,1,1,1.8126539343499315,1.2857142857142858,0,1,-0.7920494875423887,4,4,4,5,3,3,5,6,8,6,4,1.2724180205607036,7,4,0,1.384971609293624,0,1.1441797134951883,2,2,3,1,2,4,2,3,3,2,5,5,4,3,3,3,5,4,3,2,1.1254628677422756,2,0,4.6,0,2.8,0,2.8,0,3.4,0,1,1,1,1,3,1,1,3,1,1,3,1,1,1,1,1,1,1,1,2,1.164157703189193,1.35,0,I lived with my mother and father an equal amount of time (joint custody),0,Middle Eastern,0,28,0,1,NA,1,3,7,Real Estate Analyst,6,145,74,2,5,2,1,0,0,0,1,TRUE,TRUE,TRUE,TRUE,TRUE,2,0.5312033333381017,0.48760625000484287,0.55009375,0.5804249999932944,0.5760656250007451,0.5935031249970197,1,1,1,1,1,1,0.092,0.361,0.536,0.026,1.869,149.1107159559569,1935.1389769317434,0.134,0.282,0.643,0.009,1.057,97.55681711839686,1883.9913510847584,0.145,0.337,0.766,0.027,1.671,63.28509710668092,1845.0413812643471,71.88461538461539,117.44444444444444,61.88888888888889,FALSE,346,1.0251851851851852,0,1,1,12,15,FALSE
261,2022-03-18T18:33:47Z,2022-03-18T18:55:54Z,1326,1,2022-03-18T18:55:56Z,0.8999999761581421,Chrome,99.0.4844.74,Windows NT 10.0,1536,864,NA,1.7777777777777777,566,126,361,78,44,61,-0.2299958428995323,0.04475528294484601,-0.18286357878173143,-0.24810816915181938,-0.3463668663329587,-0.42234097034706597,2,2,1,1,1,1,1,4,1,1,3,1,1,1,1,2,1,1,2,2,1.2139539573337679,0,0,2,4,3,1.5,0,3,1,2,2,5,2,2,2,2,2,2,2,2,2,1,2,4,5,1,1,2,2,1,1,2,0,0,0,0,1,1,1,1,2,1,1,1,1,4,1,1,1,2,1,1,4,4,5,5,5,3,1,5,3,1,1,1,2,3,1,1,2,2,1,1,1,2,3,2,2,1.7424224619867699,1.2649110640673518,2.25,0,2.25,0,2.1333333333333333,0,1.1111111111111112,0,2.8333333333333335,0,2.3333333333333335,0,1.7142857142857142,0,1,0,1.972972972972973,0,1,0,0,0.006492627829021527,-0.122386473343899,0.031158049895781924,-0.04561421172405854,2,3,3,1,1,4,2,1,1,1.2724180205607036,2.2857142857142856,0,1,-0.21150737850196963,4,5,5,4,2,2,4,4,4,NA,3,1.3972762620115438,4,3.7142857142857144,0,-0.13222200579606097,1,0.06526763923476366,3,3,3,3,3,3,5,5,4,3,3,4,3,3,4,3,4,3,2,3,0.9611501047232549,3,0,3.4,0,3.2,0,3.8,0,3.466666666666667,0,3,2,3,3,3,3,2,2,2,1,3,3,2,3,1,2,2,3,3,2,0.6805570473787206,2.4,0,NA,NA,"White, Caucasian, Anglo, European American",0,30,1,2,NA,1,3,4,virtual assistant,3,180,65,3,5,2,0,0,0,0,0,TRUE,TRUE,TRUE,TRUE,TRUE,6,0.7283874999880791,0.5631437500044704,0.6148062500208616,0.8664774193609914,0.7056466666777929,0.7949499999920527,1,1,1,1,1,0.967741935483871,0.065,0.46,0.426,0.005,1.253,88.38439596718493,1912.6726211477662,0.084,0.378,0.423,0.024,1.89,117.61293898838593,1898.5297222710835,0.144,0.285,0.329,0.007,1.352,54.40316098968526,1836.8522461546775,250.59999999999997,78.75,193.14285714285714,FALSE,350,1.0370370370370372,0,1,0,0,3,FALSE
262,2022-03-18T18:36:17Z,2022-03-18T18:58:02Z,1305,1,2022-03-18T18:58:03Z,0.8999999761581421,Chrome,99.0.4844.74,Windows NT 10.0,1920,1080,N/a,1.7777777777777777,530,96,343,92,64,79,-0.30401543468593806,-0.12089738769516838,-0.2482624311673225,-0.07545084692925424,0.06375055786272243,-0.22005296417030445,3,2,2,1,3,1,1,2,1,3,2,1,1,1,3,2,1,1,2,2,0.8750939799154206,0,1,1,3,2,1.75,0,1,1,1,1,2,1,1,1,2,1,1,2,1,1,1,1,2,1,1,1,1,1,1,1,2,0,0,0,0,1,1,1,1,3,1,1,1,1,1,1,1,1,3,2,1,3,1,1,2,1,2,1,1,1,1,1,1,2,2,1,1,1,1,1,1,1,1,1,2,2,1.7731734670201176,1.9073791542572855,1.125,0,1.5,0,1.2,0,1.2222222222222223,0,1.5,0,1.1666666666666667,0,1.2857142857142858,0,1,0,1.2972972972972974,0,1,0,0,-1.1624880107218938,-1.3160561442940117,-0.22730066264678367,-0.7716784034703977,1,1,3,1,1,1,1,1,1,1.5735915849388864,1.2857142857142858,0,1,-0.7920494875423887,5,5,5,5,3,2,5,6,6,4,3,1.7043362064926932,6,4.285714285714286,0,0.43348058270556905,0,0.7194418556870088,1,1,2,2,2,5,4,4,5,4,5,5,5,3,4,4,5,5,3,4,1.5023790657297036,1.6,0,5,0,4,0,4,0,4.333333333333333,0,2,1,4,4,4,4,4,3,4,1,2,3,3,4,1,3,1,4,1,4,1.3168942730211068,2.85,0,I lived with my mother and father an equal amount of time (joint custody),0,"Asian or Asian American (e.g., Chinese, Japanese, and others)",0,26,0,1,NA,1,1,6,Unemployed,2,143,62,1,5,2,0,0,1,0,0,TRUE,TRUE,TRUE,TRUE,TRUE,4,0.553199999999255,0.45119374999403955,0.47482187499850986,0.6312749999836087,0.49880000001384367,0.5380718750022352,1,1,1,1,1,1,0.145,0.293,0.807,0.024,1.709,39.068917379222256,1823.1222944567967,0.091,0.323,0.706,0.01,0.93,73.74449033386632,1854.0155503749706,0.091,0.389,0.528,0.022,1.714,112.96387053728094,1901.6733846481195,71.20833333333333,93,77.9090909090909,FALSE,298,0.882962962962963,0,1,0,3,6,FALSE
263,2022-03-18T18:42:55Z,2022-03-18T18:58:12Z,916,1,2022-03-18T18:58:13Z,1,Chrome,99.0.4844.74,Windows NT 10.0,1280,720,NA,1.7777777777777777,444,68,195,51,32,66,-0.4808400150645741,-0.2755065469591818,-0.7859863285599602,-0.5810901477239093,-0.5924373208503674,-0.3661498575201878,2,2,1,1,2,1,1,1,1,1,2,1,1,1,1,1,1,1,1,1,1.3803127029389886,0,1,1,4,4,1.2,0,1,1,2,1,1,1,5,1,1,1,1,1,1,5,2,1,1,1,1,1,1,1,1,0,2,0,0,0,0,1,1,1,1,1,1,1,1,1,1,1,1,1,2,1,1,1,1,1,1,1,1,1,1,1,1,1,1,1,1,1,1,1,1,1,1,1,1,1,1,1,1.9382354750537296,1.8387366263150307,1,0,1,0,1.6666666666666667,0,1,0,1.0833333333333333,0,1,0,1,0,1,0,1.027027027027027,0,0,0,0,-1.4190935167452654,-1.284884442696583,-0.6189692744445258,-0.9519268585705545,1,1,1,1,1,2,1,1,1,1.889822365046136,1.1428571428571428,0,1,-0.874984074548163,5,5,5,5,5,5,5,6,6,6,4,1.5118578920369088,6,5,0,1.2043418043825058,0,1.5759787198402806,1,1,1,1,1,5,3,5,5,1,5,5,5,4,3,5,5,5,4,5,1.61245154965971,1,0,5,0,3.6,0,4.4,0,4.333333333333333,0,1,1,1,1,1,1,1,1,1,1,1,1,1,1,1,1,1,1,1,1,1.231174022502185,1,0,I lived with my mother and father an equal amount of time (joint custody),0,"White, Caucasian, Anglo, European American",0,25,1,2,NA,1,4,6,senior financial analyst,6,130,68,3,5,2,0,0,1,0,0,TRUE,TRUE,TRUE,TRUE,TRUE,6,0.4855806451535994,0.5540187499895692,0.5204354838594314,0.5339607142891203,0.5736896551724138,0.5948862069146387,1,1,1,0.9032258064516129,0.9354838709677419,0.90625,0.07,0.33,0.386,0.014,1.682,56.50348745497716,1939.9748232495685,0.067,0.309,0.317,0.026,1.969,217.5428823132222,2066.357746039568,0.058,0.337,0.43,0.022,1.921,56.16972224535566,1911.0676713408811,120.14285714285714,75.73076923076924,87.31818181818183,FALSE,304,0.9007407407407407,1,1,0,0,3,FALSE
264,2022-03-18T17:55:56Z,2022-03-18T18:58:27Z,3750,1,2022-03-18T18:58:28Z,0.8999999761581421,Chrome,99.0.4844.51,Windows NT 10.0,1366,768,NA,1.7786458333333333,3215,48,226,106,30,82,5.216612452716827,-0.3859416607191914,-0.6733549716736644,0.0972064752933109,-0.6334490632699356,-0.18633829647417754,2,3,1,2,2,1,1,2,1,2,2,1,1,1,2,2,1,1,3,3,0.9119095061289915,0,1,2,3,3,1.7,0,2,2,3,3,4,2,3,2,2,2,3,2,2,3,3,2,2,2,2,1,2,3,2,5,1,1,0,3,0,2,1,3,2,2,1,2,2,2,2,2,1,1,2,3,2,3,1,1,2,3,2,1,3,1,4,4,3,4,4,5,2,2,2,1,1,1,3,4,4,5,1.3639502778182058,0.7988086367179802,2,0,4,0,2.533333333333333,0,1.8888888888888888,0,1.9166666666666667,0,2.5,0,3.142857142857143,0,1,0,2.1621621621621623,0,3,0,0,-0.032985142328420085,0.02570369260476816,1.0729539860338317,0.5493288393193,2,1,3,1,1,1,1,5,4,1.2535663410560174,1.4285714285714286,0,4.5,0.6446999669573633,5,5,4,4,3,2,3,8,6,2,2,1.1126972805283737,7,3.7142857142857144,0,-0.15675083406024948,0,0.05032738711406198,2,3,3,3,3,3,5,4,4,5,4,4,4,4,5,5,5,5,3,4,1.486446705914413,2.8,0,4.2,0,4.4,0,4.2,0,4.266666666666667,0,2,3,3,3,3,4,3,3,3,2,3,4,2,4,2,3,1,4,4,3,0.9333020044867296,2.95,0,I lived with my mother and father an equal amount of time (joint custody),0,"Hispanic of Latino (e.g., Mexican American, Central American, and others)",0,19,0,1,NA,1,3,4,Location manager,3,160,66,3,5,2,0,0,0,0,0,TRUE,TRUE,TRUE,TRUE,TRUE,6,0.5340906250476837,0.4356900000413259,0.43142187501490115,0.6523999999523162,0.5176933333237966,0.5209074073897468,1,1,1,0.9375,0.967741935483871,0.8709677419354839,0.056,0.322,0.508,0.009,1.352,34.526341593849445,1930.7768868346816,0.071,0.306,0.568,0.022,1.998,41.35269565084051,1866.7045925470675,0.076,0.344,0.428,0.015,1.975,15.658389018482323,1859.3640414315546,150.22222222222226,90.81818181818183,131.66666666666669,FALSE,342,1.0133333333333332,0,1,1,30,33,FALSE
266,2022-03-18T18:37:22Z,2022-03-18T18:59:19Z,1317,1,2022-03-18T18:59:20Z,0.8999999761581421,Chrome,99.0.4844.51,Windows NT 10.0,1366,768,NA,1.7786458333333333,496,85,414,104,65,97,-0.37392282692865464,-0.18163670026317363,0.00969970879806452,0.07254114354723017,0.0842564290725065,-0.017764957993542937,3,3,3,3,3,1,1,2,1,3,3,1,2,1,3,3,1,1,3,3,0.6958523739384593,0,1,1,4,3,2.2,0,2,1,3,1,2,2,3,3,2,2,2,3,1,2,2,3,1,3,3,2,2,2,2,0,1,0,0,1,1,2,4,1,1,3,1,1,1,1,2,1,1,1,1,2,1,1,3,3,3,3,3,3,1,1,3,2,3,1,1,1,1,2,2,1,3,1,2,3,1,1,1.5485147393221343,1.1952286093343936,2.25,0,1.75,0,2.066666666666667,0,1.6666666666666667,0,1.8333333333333333,0,2.1666666666666665,0,1.5714285714285714,0,1.6666666666666667,0,1.7837837837837838,0,0,1,0,-0.1163271015496859,-0.23409326518831208,0.33885444954852423,0.05238059218010607,1,1,1,1,1,1,1,1,1,1.9518001458970664,1,0,1,-0.9579186615539372,5,5,5,5,2,2,3,6,6,NA,3,1.4638501094227998,6,3.857142857142857,0,0.40966740893729353,1,0.47272947549438354,4,2,3,4,3,3,5,4,3,2,4,3,2,3,5,4,4,3,4,5,1.162919151265879,3.2,0,3.4,0,3.4,0,4,0,3.6,0,3,2,3,2,1,2,2,2,1,1,2,2,1,3,1,3,1,2,2,3,0.8255779474818965,1.95,0,I lived with my mother and father an equal amount of time (joint custody),0,"White, Caucasian, Anglo, European American",0,23,1,2,NA,1,4,7,Restaurant Server,5,150,67,2,5,2,0,0,1,0,0,TRUE,TRUE,TRUE,TRUE,TRUE,5,0.5466312499940396,0.44835937495529654,0.43328749997913835,0.6326156249940396,0.5515517241461524,0.5434733333428701,1,1,1,1,0.90625,0.9375,0.072,0.302,0.606,0.007,1.344,162.92084980303255,2010.1485657987373,0.074,0.321,0.625,0.013,1.742,39.03174367037486,1895.2490647135846,0.169,0.234,0.561,0.015,1.619,13.934995378305803,1793.9588435042226,192,134,107.93333333333334,FALSE,382,1.1318518518518519,0,1,0,0,3,FALSE
267,2022-03-18T18:21:08Z,2022-03-18T18:59:30Z,2301,1,2022-03-18T18:59:31Z,0.8999999761581421,Firefox,98.0,Windows NT 10.0,1536,864,"I am living with my parents, so I reported their income for the household income since I am unemployed.",1.7777777777777777,589,149,859,178,133,205,-0.18270554814710635,0.17175566376885704,1.626504670552955,0.9851584181522174,1.4786556713378223,1.1959630790670261,3,2,2,2,3,1,1,3,1,3,2,2,1,1,3,3,2,1,2,3,0.6708203932499369,0,1,1,3,4,2.05,0,3,2,3,2,1,1,3,2,2,2,2,3,1,3,3,1,2,1,1,2,2,1,3,1,2,0,0,0,0,1,2,4,1,2,1,1,1,1,2,2,3,1,3,3,3,2,3,3,3,3,2,1,1,1,3,1,1,2,1,1,2,1,1,1,3,3,1,1,2,1,1.4415540496554675,0.990430401872025,1.625,0,1.25,0,2.2,0,1.5555555555555556,0,2.5833333333333335,0,1.5,0,1.2857142857142858,0,2.3333333333333335,0,1.8918918918918919,0,1,0,0,-0.45188814788794135,-0.4015551195114061,-0.31345356682763886,-0.3575043431695225,1,1,3,1,1,2,3,2,1,1.4960264830861913,1.7142857142857142,0,1.5,-0.3498436025973552,4,4,4,3,1,1,3,3,3,2,2,1.3451854182690985,3,2.857142857142857,0,-0.8792700537047221,0,-0.8541675456885912,3,2,3,2,3,3,3,3,3,3,4,3,3,3,4,3,4,4,3,3,0.5345224838248488,2.6,0,3.6,0,3,0,3.2,0,3.2666666666666666,0,1,1,1,1,1,1,1,3,1,2,1,2,1,1,2,3,1,1,2,1,0.8271701918685112,1.4,0,I lived with my mother and father an equal amount of time (joint custody),0,"Asian or Asian American (e.g., Chinese, Japanese, and others)",0,28,1,2,NA,1,2,7,currently unemployed,2,120,63,1,5,2,0,0,0,0,0,TRUE,TRUE,TRUE,TRUE,TRUE,1,0.531483870967742,0.46325,0.52696875,0.61809375,0.5195161290322581,0.5650937500000001,1,1,1,1,1,1,0.093,0.381,0.678,0.028,1.669,113.9151695074271,1901.3747495600796,0.192,0.271,0.994,0.036,1.905,10.808637054729934,1791.1306739757827,0.118,0.349,0.722,0.005,0.975,74.49094702036943,1860.8641627230422,59.607142857142854,52.91666666666667,195,FALSE,386,1.1437037037037037,0,1,0,0,3,FALSE
268,2022-03-18T18:34:16Z,2022-03-18T18:59:53Z,1536,1,2022-03-18T18:59:54Z,0.8999999761581421,Chrome,99.0.4844.74,Windows NT 10.0,1920,1080,"Nope, everything worked on my end.",1.7777777777777777,610,94,454,86,87,81,-0.13952745293836966,-0.13194089907116932,0.15503049187715578,-0.14944684216749646,0.5353855956877558,-0.19757651903955317,3,3,3,3,3,1,2,2,4,3,3,3,2,4,3,2,4,2,3,3,0.8271701918685112,0,0,3,2,2,2.8,0,5,3,4,4,2,1,4,3,3,2,5,3,1,3,3,3,5,4,2,3,4,4,2,1,2,0,0,0,0,3,5,3,3,5,5,3,2,5,2,2,3,3,3,4,2,3,2,4,5,3,4,3,1,1,3,4,1,1,1,1,2,2,3,1,1,2,2,1,4,4,1.2155153135512022,1.1254628677422756,3.375,0,2.75,0,3.066666666666667,0,3.7777777777777777,0,3,0,2.6666666666666665,0,1.5714285714285714,0,1.3333333333333333,0,2.72972972972973,0,1,0,0,1.2281102932565262,1.1066832372752176,0.20346385825749233,0.655073547766355,4,4,4,3,2,3,4,4,3,0.8997354108424374,3.4285714285714284,0,3.5,1.4189799371827794,5,4,4,3,1,1,3,1,1,3,1,1.5275252316519468,1,3,0,-1.3699149782144018,0,-1.0756115497497296,1,4,2,1,2,2,5,5,3,4,5,4,5,3,5,5,4,5,5,3,1.6035674514745464,2,0,4,0,4.8,0,3.8,0,4.2,0,1,3,4,4,2,4,3,3,3,4,4,3,3,4,1,2,4,3,4,4,1.0990426455975697,3.15,0,I lived with my mother and father an equal amount of time (joint custody),0,"Hispanic of Latino (e.g., Mexican American, Central American, and others)",0,22,0,1,NA,1,2,4,Self-employed,4,315,72,1,5,2,0,0,0,0,0,TRUE,TRUE,TRUE,TRUE,TRUE,2,0.5499451612897458,0.4854968749992549,0.5236187499985099,0.6435137931005708,0.5635258064500747,0.5844129032271523,1,1,1,0.9354838709677419,0.96875,0.96875,0.056,0.405,0.43,0.021,1.464,111.17496512602946,1935.8924603574196,0.07,0.356,0.55,0.017,1.53,54.89326349950027,1884.1917024747981,0.071,0.381,0.43,0.012,1.57,106.18733937907596,1955.9914340035189,69.71428571428571,90,130.83333333333334,FALSE,282,0.8355555555555556,0,0,0,3,6,FALSE
269,2022-03-18T18:44:06Z,2022-03-18T19:00:32Z,986,1,2022-03-18T19:00:33Z,0.8999999761581421,Chrome,99.0.4844.51,Windows NT 10.0,1920,1080,NA,1.7777777777777777,486,54,250,64,34,55,-0.3944838246471007,-0.3528111265911885,-0.5861565018262097,-0.4207654913743845,-0.5514255784307993,-0.48977030573931984,1,2,2,2,2,1,1,4,1,2,2,2,1,1,1,2,1,1,2,2,1.0894228312566052,0,0,2,3,3,1.65,0,2,2,2,4,1,1,1,1,1,1,1,2,2,1,2,2,1,1,1,1,1,1,2,1,2,0,0,0,0,2,1,2,1,2,2,1,1,1,1,3,1,1,2,1,1,1,1,1,1,1,1,1,1,1,1,1,1,2,2,1,1,1,1,1,1,1,1,1,1,1,1.7376764714754929,1.5976172734359604,1.25,0,1,0,1.6,0,1.4444444444444444,0,1.25,0,1,0,1.2857142857142858,0,1,0,1.2432432432432432,0,1,0,0,-1.1164306122048786,-1.110440913883213,-0.39960647100849406,-0.7550236924458535,2,2,3,1,1,2,3,1,1,1.1126972805283737,2,0,1,-0.3773765525135179,4,4,5,4,2,2,4,3,1,1,2,1.2535663410560174,2,3.5714285714285716,0,-1.2737251609456715,0,-0.7074126396006416,3,3,3,3,3,5,4,3,3,4,5,5,2,3,4,5,3,5,4,2,1.3627702877384937,3,0,4.6,0,3.8,0,3,0,3.8,0,1,2,2,1,2,2,2,2,1,1,2,3,1,2,1,2,2,2,2,2,0.7591546545162482,1.75,0,I lived with my mother and father an equal amount of time (joint custody),0,"Hispanic of Latino (e.g., Mexican American, Central American, and others) & White, Caucasian, Anglo, European American",1,29,0,1,NA,1,2,6,Mturker,1,185,69,1,5,2,0,0,1,0,0,TRUE,TRUE,TRUE,TRUE,TRUE,5,0.4839290322574877,0.46126562500279394,0.48352187500149013,0.5639590909115293,0.5815666666689018,0.5915481481474859,0.96875,1,1,0.6875,0.75,0.84375,0.058,0.351,0.426,0.012,1.686,56.352823408967836,1958.1939923355444,0.046,0.375,0.475,0.006,1.442,236.04546429367497,2233.513162094935,0.042,0.379,0.372,0.012,1.649,101.55718595702585,2104.370944120387,140.5,240.33333333333331,137.41666666666666,TRUE,278,0.8237037037037037,0,1,0,0,3,FALSE
270,2022-03-18T18:39:28Z,2022-03-18T19:01:40Z,1331,1,2022-03-18T19:01:40Z,0.8999999761581421,Chrome,99.0.4844.51,Macintosh,1440,900,no,1.6,562,96,373,86,67,84,-0.2382202419869107,-0.12089738769516838,-0.13926434385800404,-0.14944684216749646,0.12526817149207461,-0.16386185134342626,2,3,4,4,3,1,3,4,2,4,2,4,4,2,4,3,4,1,4,3,1.1821033884786185,0,1,1,4,2,3.05,0,4,3,3,3,3,3,4,4,3,2,4,4,3,5,3,2,4,1,1,3,3,2,3,1,2,0,0,0,0,3,4,3,3,3,2,2,2,3,3,2,3,2,3,3,2,4,4,4,5,5,3,1,2,1,5,5,3,2,1,1,4,5,4,3,3,3,2,2,1,1,1.166988372633533,0.7988086367179802,2.375,0,1.5,0,3.4,0,2.7777777777777777,0,3.3333333333333335,0,2.8333333333333335,0,2.857142857142857,0,3,0,3,0,1,0,0,0.7543770513672245,0.9336163766711973,-0.22730066264678367,0.3531578570122068,1,1,4,2,1,1,2,3,1,1.4142135623730951,1.7142857142857142,0,2,-0.15644147866964409,3,3,3,2,1,1,2,4,4,4,2,1.1338934190276817,4,2.142857142857143,0,-0.27098964413394167,0,-0.8706837020007523,2,3,3,4,3,3,5,4,4,3,4,5,3,5,5,5,4,4,5,5,1.52127765851133,3,0,4,0,4.2,0,4.6,0,4.266666666666667,0,3,3,4,3,4,4,3,4,3,4,2,3,2,3,2,3,3,3,3,3,0.8335087534664907,3.1,0,I lived with my mother and father an equal amount of time (joint custody),0,"White, Caucasian, Anglo, European American",0,25,1,2,NA,1,2,6,Grader,4,240,68,3,5,2,1,0,1,0,1,TRUE,TRUE,TRUE,TRUE,TRUE,2,0.5827531250002794,0.47529677419316385,0.6261031249994412,0.6975645161280709,0.5386843749983237,0.657483870967742,1,0.96875,1,1,1,1,0.09,0.409,0.418,0.07,1.937,79.00051216717864,1864.3544361939084,0.082,0.335,0.583,0.033,2.07,208.3037858152447,2038.2371376933454,0.131,0.347,0.581,0.009,1.432,66.51983361952736,1853.30107262139,27.67142857142857,62.72727272727272,159.11111111111111,TRUE,444,1.3155555555555554,0,1,0,0,3,FALSE
271,2022-03-18T18:42:46Z,2022-03-18T19:01:44Z,1137,1,2022-03-18T19:01:44Z,1,Edge,99.0.1150.39,Windows NT 10.0,1920,1080,NA,1.7777777777777777,541,61,276,57,78,59,-0.2813983371956474,-0.31415883677518514,-0.4916914928248004,-0.5070941524856671,0.3508327547996992,-0.4448174154778173,2,2,1,1,3,1,1,2,1,3,4,1,1,1,2,2,1,1,2,3,0.910465468000326,0,0,1,5,2,1.75,0,1,1,1,1,1,1,2,1,1,1,1,2,1,2,1,2,4,5,1,1,3,1,1,2,2,0,0,0,0,1,4,3,1,1,4,5,2,4,2,3,2,1,2,2,1,1,2,2,1,1,3,1,1,1,3,1,2,3,1,1,1,1,1,1,2,1,2,4,2,1,1.40248599528372,1.8771812708978117,2.25,0,2.25,0,1.2,0,2.7777777777777777,0,1.6666666666666667,0,1.6666666666666667,0,1.4285714285714286,0,1.3333333333333333,0,1.864864864864865,0,1,0,0,-0.06369007467309709,-0.5770803162035515,0.031158049895781924,-0.27296113315388476,3,3,5,4,2,1,2,3,2,1.1126972805283737,2.857142857142857,0,2.5,0.7004373413042606,5,5,5,5,1,1,3,9,9,NA,3,1.9023794624226837,9,3.5714285714285716,0,1.2225015310373253,1,0.8130128665414434,2,2,2,2,3,4,5,4,4,4,5,5,5,3,5,3,5,4,5,1,1.5886502207249789,2.2,0,4.6,0,4.4,0,3.4,0,4.133333333333334,0,2,2,4,1,1,4,4,4,1,2,3,3,2,2,1,3,1,4,2,2,1.1285761872936695,2.4,0,I lived with my mother and father an equal amount of time (joint custody),0,Prefer not to say,0,23,3,5,NA,1,4,6,manager,7,164,74,1,5,2,0,0,1,0,0,TRUE,TRUE,TRUE,TRUE,TRUE,1,0.6593064516109804,0.5663999999975786,0.5925187499998137,0.7243700000007948,0.653151851851631,0.6809814814803777,0.96875,1,1,0.9375,0.84375,0.9,0.074,0.401,0.425,0.012,1.921,141.76484409213808,2038.5721112690728,0.06,0.399,0.356,0.017,2.026,145.41149666982656,2094.2255843972425,0.062,0.446,0.285,0.024,2.207,197.10128893333854,2106.633821529689,160.08333333333334,119.17647058823528,91.95833333333333,FALSE,431,1.2770370370370372,0,1,1,21,24,FALSE
272,2022-03-18T18:27:07Z,2022-03-18T19:02:34Z,2126,1,2022-03-18T19:02:35Z,0.8999999761581421,Chrome,99.0.4844.51,Macintosh,1440,900,n/a,1.6,759,167,676,134,92,105,0.1668314130664765,0.27114726615286566,0.9616163379661123,0.4425211197384412,0.637914951736676,0.07214082252946219,3,1,1,1,1,1,1,2,1,1,3,1,1,2,1,1,1,1,2,2,1.2814465510343749,0,1,5,3,2,1.4,0,4,2,3,3,4,2,3,5,2,1,5,3,1,3,3,4,5,1,1,1,5,3,3,1,2,0,0,0,0,1,1,2,1,3,3,1,1,2,2,2,5,1,3,1,1,2,5,5,4,4,3,1,1,1,1,1,1,2,2,1,4,4,3,1,1,2,2,2,1,1,1.5948490660697467,1.2227992865708155,2.875,0,1.5,0,2.933333333333333,0,1.6666666666666667,0,2.9166666666666665,0,1.3333333333333333,0,2.4285714285714284,0,1.3333333333333333,0,2.135135135135135,0,1,0,0,0.5175104304225738,0.5705693031768558,-0.22730066264678367,0.17163432026503608,1,1,5,1,1,3,1,2,1,1.5735915849388864,1.8571428571428572,0,1.5,-0.2669090155915809,3,4,4,4,3,3,4,5,5,NA,2,0.7559289460184544,5,3.5714285714285716,0,-0.3760932239552953,1,-0.16067443809390553,2,3,2,5,2,4,3,3,4,2,4,5,3,3,3,3,4,5,2,3,0.9611501047232549,2.8,0,4.4,0,2.6,0,3.2,0,3.4,0,1,3,1,3,3,1,4,3,1,1,2,2,1,1,1,2,1,1,2,3,0.9880869341680844,1.85,0,I lived with my mother and father an equal amount of time (joint custody),0,"Asian or Asian American (e.g., Chinese, Japanese, and others)",0,22,1,2,NA,1,3,6,unemployed,3,93,60,1,5,2,0,0,3,0,0,TRUE,TRUE,TRUE,TRUE,TRUE,1,0.5794580645164655,0.4729548387097255,0.4869312499992084,0.5882187499997672,0.5181625000007917,0.5845250000001397,1,1,1,1,1,1,0.117,0.328,0.728,0.011,1.332,18.43346574459196,1799.5322628865429,0.111,0.318,0.732,0.019,1.313,21.7597980442544,1803.9538844227718,0.084,0.361,0.434,0.033,1.766,53.70048618228854,1835.549652690919,121.09090909090911,69.10526315789474,53.515151515151516,FALSE,424,1.2562962962962962,0,1,0,0,3,FALSE
273,2022-03-18T18:43:59Z,2022-03-18T19:03:32Z,1172,1,2022-03-18T19:03:33Z,1,Firefox,98.0,Macintosh,1280,800,NA,1.6,479,84,352,75,54,73,-0.40887652305001293,-0.1871584559511741,-0.21556300497452696,-0.2851061667709405,-0.14130815423511814,-0.2874822995625583,2,2,2,1,2,1,2,4,1,2,4,1,1,2,3,3,1,1,4,2,0.8506963092234007,0,1,4,1,1,2.05,0,4,2,5,2,3,3,3,5,5,2,4,4,2,4,4,1,3,1,1,4,5,5,4,4,1,2,0,1,0,1,3,1,3,4,2,2,2,4,4,2,5,1,3,3,1,3,3,5,5,4,3,1,1,1,3,3,1,3,3,3,3,4,3,1,4,4,2,1,2,2,1.2657417201396586,1.2071217242444348,3,0,1.75,0,3.466666666666667,0,2.4444444444444446,0,3.25,0,2,0,2.857142857142857,0,3,0,2.7567567567567566,0,2,0,0,1.002209719577831,1.129398262729495,0.07821504497010326,0.6038066538497991,3,4,5,3,2,3,3,3,4,0.9511897312113419,3.2857142857142856,0,3.5,1.336045350177005,4,3,3,2,1,1,2,6,4,3,2,1.2724180205607036,5,2.2857142857142856,0,-0.30418514155265464,0,-0.813500056196216,3,2,3,3,3,4,5,4,4,3,5,5,3,2,5,5,5,5,5,5,1.6846647257229665,2.8,0,4.8,0,4.2,0,4,0,4.333333333333333,0,2,1,3,2,4,3,4,2,3,3,4,2,1,1,1,2,1,3,2,3,1.050062654772261,2.35,0,I lived with my mother and father an equal amount of time (joint custody),0,"Asian or Asian American (e.g., Chinese, Japanese, and others)",0,29,1,2,NA,1,2,6,Tutor,5,95,62,3,5,2,0,0,1,0,0,TRUE,TRUE,TRUE,TRUE,TRUE,5,0.5011333333333333,0.44865625,0.47346875,0.585625,0.543125,0.5788125,1,1,1,1,1,1,0.116,0.305,0.719,0.01,1.482,133.84396318992992,1924.4318489698712,0.096,0.312,0.805,0.023,2.297,68.26538966223893,1851.9729859727715,0.115,0.325,0.677,0.013,1.466,60.45874506269841,1843.131579768002,148.2,99.86956521739131,112.76923076923077,FALSE,388,1.1496296296296296,0,1,0,0,3,FALSE
276,2022-03-18T18:43:42Z,2022-03-18T19:07:53Z,1451,1,2022-03-18T19:07:54Z,0.8999999761581421,Chrome,99.0.4844.51,Macintosh,1440,900,NA,1.6,866,102,240,70,35,64,0.3868340886538492,-0.0877668535671655,-0.6224891975959825,-0.34676949613614233,-0.5309197072210152,-0.38862630265093906,2,2,1,1,2,1,1,3,1,2,2,1,1,1,2,2,1,1,2,2,0.998683343734455,0,1,2,3,3,1.55,0,2,1,1,2,1,1,1,1,1,1,1,1,2,2,2,1,1,1,1,1,1,1,1,1,2,0,0,0,0,1,1,1,1,1,1,1,1,1,1,1,1,1,1,1,1,2,1,1,1,2,1,1,1,1,2,2,1,2,1,1,1,1,1,1,1,1,1,1,1,1,1.88880056320607,1.7593288763724921,1,0,1,0,1.3333333333333333,0,1,0,1.1666666666666667,0,1.3333333333333333,0,1.1428571428571428,0,1,0,1.135135135135135,0,1,0,0,-1.3489108142431467,-1.3832178862215945,-0.39960647100849406,-0.8914121786150443,1,1,2,1,1,2,1,1,1,1.6761634196950514,1.2857142857142858,0,1,-0.7920494875423887,5,5,5,5,3,3,5,7,4,6,4,1.5735915849388864,5.5,4.428571428571429,0,1.1140269019269466,0,1.2113581587077484,2,2,2,3,2,4,2,3,4,3,5,3,4,4,3,5,3,4,1,3,0.8997354108424374,2.2,0,3.8,0,3,0,3.4,0,3.4,0,1,1,1,1,1,1,1,4,1,1,2,1,1,2,1,2,1,1,1,1,1,1.3,0,NA,NA,"White, Caucasian, Anglo, European American",0,27,1,2,NA,1,3,6,student,3,152,64,3,5,2,0,0,1,0,0,TRUE,TRUE,TRUE,TRUE,TRUE,5,0.5445437500048429,0.5049625000022352,0.5330843749977648,0.5923250000011175,0.5679516128993803,0.5936437499988824,1,1,1,1,1,1,0.127,0.34,0.676,0.019,1.605,104.58792023175,1890.2579423082784,0.126,0.344,0.763,0.035,1.984,159.09277838572712,1946.508455142952,0.122,0.352,0.656,0.019,1.343,56.24011721208095,1839.2000630556377,84.47368421052632,56.68571428571428,70.6842105263158,FALSE,435,1.2888888888888888,0,1,0,3,6,FALSE
277,2022-03-18T18:48:39Z,2022-03-18T19:08:14Z,1175,1,2022-03-18T19:08:15Z,0.8999999761581421,Chrome,99.0.4844.74,Windows NT 10.0,1536,864,Thank you for letting me participate!,1.7777777777777777,527,67,320,62,51,83,-0.31018373400147187,-0.28102830264718226,-0.3318276314378,-0.4454308231204653,-0.20282576786447032,-0.1751000739088019,2,2,1,1,2,1,1,2,1,2,2,1,1,1,2,2,1,1,2,2,1.025978352085154,0,1,3,3,3,1.5,0,3,3,3,3,4,1,4,4,3,3,2,4,2,4,3,4,4,1,1,1,4,4,1,0,2,0,0,0,0,3,2,2,2,2,2,2,2,2,2,2,2,2,4,3,3,3,3,3,3,3,4,2,1,1,1,1,3,1,1,1,1,1,1,1,1,1,1,1,1,1,1.2609877438302444,0.816496580927726,2.5,0,1,0,3.066666666666667,0,2.111111111111111,0,2.75,0,1.6666666666666667,0,1.2857142857142858,0,1,0,2,0,0,0,0,0.18633580299070093,0.4060574521595117,-0.6189692744445258,-0.10645591114250702,2,2,3,1,1,1,1,1,1,1.2149857925879117,1.5714285714285714,0,1,-0.6261803135308405,3,3,3,3,2,2,3,7,1,3,3,0.4879500364742666,4,2.7142857142857144,0,-0.14160432944649845,0,-0.48226576241552316,3,3,3,3,3,3,3,4,3,3,5,3,4,3,3,5,3,4,3,3,0.7432233529572065,3,0,3.6,0,3.6,0,3.2,0,3.466666666666667,0,2,2,2,2,2,2,3,2,1,2,2,2,1,2,2,2,2,2,2,2,0.5871429486123998,1.95,0,I lived with my mother and father an equal amount of time (joint custody),0,Middle Eastern,0,24,1,2,NA,1,1,5,Student,1,218,61,2,5,2,0,0,1,0,0,TRUE,TRUE,TRUE,TRUE,TRUE,1,0.700271875000035,0.5045531249998894,0.5609093750000466,0.6978387096773893,0.5603451612903887,0.5925870967742597,1,1,1,0.96875,0.96875,0.96875,0.071,0.369,0.335,0.041,1.483,99.17176765960188,1926.3326091666515,0.082,0.336,0.507,0.022,1.784,101.0764880966508,1925.287725459286,0.285,0.201,0.594,0.281,1.453,218.70151768019053,2043.6246032011848,36.170731707317074,81.0909090909091,5.170818505338078,FALSE,382,1.1318518518518519,0,1,0,0,3,FALSE
278,2022-03-18T18:38:49Z,2022-03-18T19:08:57Z,1807,1,2022-03-18T19:08:59Z,0.8999999761581421,Chrome,99.0.4844.74,Windows NT 10.0,2560,1440,no,1.7777777777777777,731,150,517,202,85,62,0.10926061945482755,0.17727741945685752,0.3839264752267246,1.2811423991051862,0.4943738532681876,-0.41110274778169037,1,2,2,1,2,1,2,2,2,2,3,3,2,2,3,2,2,1,3,2,0.8013147091860318,0,0,3,4,4,2,0,3,2,3,2,3,2,2,2,2,1,1,2,4,2,4,3,3,1,1,3,2,2,4,1,2,0,0,0,0,1,2,1,1,1,1,3,2,2,3,2,4,1,4,2,1,5,4,4,5,5,2,1,1,1,2,1,2,2,1,1,1,1,2,2,3,3,1,1,2,1,1.5485147393221343,1.1254628677422756,2.375,0,1.25,0,2.3333333333333335,0,1.5555555555555556,0,3.3333333333333335,0,1.3333333333333333,0,1.4285714285714286,0,2.6666666666666665,0,2.1621621621621623,0,1,0,0,0.21046110697580434,0.1021087782237017,-0.31345356682763886,-0.10567239430196859,2,1,5,1,1,1,2,4,4,1.1338934190276817,1.8571428571428572,0,4,0.7001016040469747,3,3,3,4,1,1,2,4,5,1,2,1.2535663410560174,4.5,2.4285714285714284,0,-0.822150648667876,0,-1.0515847406769399,1,1,2,3,2,3,5,1,5,2,5,4,2,5,5,5,5,5,5,4,1.7511900715418263,1.8,0,4.4,0,3.8,0,4,0,4.066666666666666,0,2,2,1,1,2,1,2,1,4,2,2,2,1,1,1,2,1,2,1,2,1.050062654772261,1.65,0,I lived with my mother and father an equal amount of time (joint custody),0,"White, Caucasian, Anglo, European American",0,23,0,1,NA,1,2,6,self-employed,1,170,66,1,5,2,1,0,1,0,1,TRUE,TRUE,TRUE,TRUE,TRUE,3,0.6131161290320658,0.43330624999944123,0.5408031250000931,0.7571766666655739,0.4864999999994481,0.5594068965505937,0.96875,1,1,0.967741935483871,0.84375,0.9354838709677419,0.07,0.307,0.386,0.017,1.851,46.75300202583635,1891.233074864004,0.057,0.286,0.455,0.019,2.022,185.03667673693286,2087.961383030711,0.081,0.3,0.216,0.014,1.446,277.2350763712481,2150.958897395993,108.88235294117646,106.42105263157895,103.28571428571428,FALSE,304,0.9007407407407407,1,1,0,0,3,FALSE
279,2022-03-18T18:53:11Z,2022-03-18T19:10:02Z,1011,1,2022-03-18T19:10:03Z,0.8999999761581421,Chrome,99.0.4844.51,Macintosh,1440,900,no,1.6,446,52,290,53,35,63,-0.4767278155208849,-0.3638546379671895,-0.44082571874711846,-0.5564248159778286,-0.5309197072210152,-0.3998645252163147,2,2,2,1,2,1,2,2,1,2,3,1,1,3,2,2,2,1,1,2,0.9665456669582609,0,1,2,3,2,1.75,0,4,1,5,3,4,3,3,4,3,2,4,4,4,3,1,4,5,5,3,1,4,3,3,3,1,0,0,1,1,1,4,4,2,1,1,1,1,2,2,1,4,1,3,2,1,4,4,4,5,5,5,4,4,5,1,1,1,4,1,1,1,1,1,3,3,2,2,3,2,1,1.6009569210516137,1.0600988273786194,3.5,0,2,0,3.2,0,1.8888888888888888,0,3,0,3.3333333333333335,0,1.4285714285714286,0,2.6666666666666665,0,2.4594594594594597,0,2,1,0,1.1338022867693043,1.1014715647683921,0.8637329606014429,0.9826022626849176,1,1,2,1,1,1,1,3,1,1.7320508075688772,1.1428571428571428,0,2,-0.48817982669274074,3,3,3,3,2,1,3,6,4,5,3,0.7867957924694432,5,2.5714285714285716,0,0.466676080124282,0,-0.18917121776497564,1,1,1,1,1,5,5,5,5,3,4,5,4,4,4,5,5,5,4,5,1.6761634196950514,1,0,4.8,0,4.2,0,4.6,0,4.533333333333333,0,1,2,2,2,2,2,2,3,3,3,4,3,3,3,1,3,1,3,3,2,0.8013147091860318,2.4,0,"I lived with my mother, but not father, most of the time.",0,"Black or African American & White, Caucasian, Anglo, European American",1,22,1,2,NA,1,2,4,dancer,3,130,68,3,5,2,0,0,1,0,0,TRUE,TRUE,TRUE,TRUE,TRUE,3,0.4585312499983702,0.4213281250002328,0.4419838709670209,0.5713275862076673,0.49918928571497756,0.5522759999987483,1,1,0.96875,0.90625,0.875,0.8064516129032258,0.052,0.332,0.415,0.017,2.044,81.21381741459459,2027.5231871955216,0.058,0.323,0.635,0.015,1.605,149.6620978373203,2023.7713950566294,0.064,0.341,0.628,0.009,1.422,20.460835288064292,1877.027734275278,120.23529411764706,107,158,FALSE,412,1.2207407407407407,0,1,0,3,6,FALSE
280,2022-03-18T18:29:01Z,2022-03-18T19:10:31Z,2490,1,2022-03-18T19:10:32Z,0.800000011920929,Chrome,99.0.4844.74,Windows NT 10.0,1920,1080,NA,1.7777777777777777,550,77,381,883,40,188,-0.26289343924904596,-0.22581074576717747,-0.11019818724218579,9.679687858645677,-0.42839035117209495,1.0049132954556403,3,3,2,1,3,1,2,4,1,3,4,2,2,2,3,4,2,1,4,4,0.5104177855340404,0,1,1,4,3,2.55,0,4,2,2,2,1,3,3,3,3,2,3,3,2,3,3,3,3,5,1,3,3,3,2,1,2,0,0,0,0,2,2,2,1,3,1,1,1,1,1,1,1,2,2,3,2,3,2,3,2,2,3,1,4,3,2,4,1,2,2,2,2,2,2,1,1,3,2,2,2,2,1.3528970139409469,0.7988086367179802,2.875,0,2,0,2.6,0,1.5555555555555556,0,2,0,2.8333333333333335,0,1.8571428571428572,0,1.6666666666666667,0,1.972972972972973,0,1,0,0,0.41223637666939555,0.354235727421831,-0.05499485428507328,0.14962043656837887,1,1,2,1,1,1,1,4,1,1.7320508075688772,1.1428571428571428,0,2.5,-0.2947777027650296,5,5,5,5,2,2,4,4,3,3,3,1.6035674514745464,3.5,4,0,-0.23191923190205752,0,0.15934845458074715,2,2,2,2,2,4,5,4,4,3,5,4,5,3,4,5,4,4,4,4,1.2909944487358056,2,0,4.2,0,4.4,0,3.8,0,4.133333333333334,0,2,1,2,3,2,2,2,3,3,1,1,2,1,1,1,2,1,2,2,2,0.6958523739384593,1.8,0,"I lived with my mother, but not father, most of the time. & I lived with my mother and father an equal amount of time (joint custody) & I lived with my extended family on mother's side (grandparents, aunts ,uncles, cousins)",1,"White, Caucasian, Anglo, European American",0,28,1,2,NA,1,1,3,unemployed,1,293,66,1,5,2,0,0,1,0,0,TRUE,TRUE,TRUE,TRUE,TRUE,6,0.5445322580645161,0.44582580645622744,0.45606562500447034,0.5682906250059605,0.4778812500052154,0.5408677419231784,0.96875,1,1,1,1,0.96875,0.071,0.333,0.639,0.017,1.77,92.1480435945437,1914.3999295165922,0.056,0.36,0.721,0.048,2.017,103.29474528819105,1884.7594725057552,0.058,0.396,0.4,0.028,1.154,154.05990870730685,1981.9601786848064,104.11764705882352,42.02083333333333,41.21428571428571,FALSE,352,1.0429629629629629,0,1,0,0,3,FALSE
281,2022-03-18T18:44:26Z,2022-03-18T19:10:48Z,1582,1,2022-03-18T19:10:49Z,0.8999999761581421,Chrome,99.0.4844.74,Windows NT 10.0,1280,720,Thanks!! :),1.7777777777777777,729,62,403,150,119,68,0.10514841991113835,-0.3086370810871847,-0.03026625654868558,0.6398437737070871,1.1915734744008455,-0.3436734123894365,3,1,1,2,3,2,2,3,1,2,3,2,2,4,2,3,2,1,2,3,0.8335087534664907,0,0,4,2,3,2.2,0,4,2,4,3,3,5,4,4,4,3,2,5,2,5,5,4,3,2,4,2,1,3,2,4,2,0,0,0,0,4,4,3,5,5,4,5,5,5,1,3,1,1,4,3,3,4,1,1,1,1,4,1,1,2,3,3,1,3,3,3,4,4,3,2,2,1,2,2,2,2,0.9702790533869323,1.2798809468443688,2.625,0,2,0,3.6666666666666665,0,4.444444444444445,0,2,0,2.3333333333333335,0,3,0,1.6666666666666667,0,2.810810810810811,0,2,0,0,0.7938548215246662,1.076593203556564,0.16436794915095845,0.6204805763537612,3,1,5,3,1,3,1,2,2,1.0690449676496976,2.4285714285714284,0,2,0.2582314563592268,2,3,4,3,1,1,3,3,3,2,2,1.1338934190276817,3,2.4285714285714284,0,-0.8792700537047221,0,-1.0863755714106227,4,3,4,3,3,3,3,3,3,3,3,3,2,4,2,3,4,3,3,3,0.5163977794943222,3.4,0,3.2,0,2.8,0,3,0,3,0,3,2,3,3,2,4,3,4,4,2,4,3,3,3,1,3,1,3,3,3,0.9445132413883326,2.85,0,"I lived with my mother, but not father, most of the time.",0,"White, Caucasian, Anglo, European American",0,29,0,1,NA,1,2,6,Dispatcher,1,150,70,2,5,2,0,1,1,0,1,TRUE,TRUE,TRUE,TRUE,TRUE,4,0.5272566666655243,0.5026843750004191,0.7278593750004657,0.5306483870961013,0.5316967741928754,0.845306666666766,1,1,1,0.96875,0.96875,0.967741935483871,0.074,0.323,0.273,0.018,1.858,259.52453376800935,2087.26133592611,0.059,0.372,0.521,0.033,1.953,41.69198390058627,1865.9484695076824,0.059,0.363,0.421,0.029,1.619,82.58232191711491,1906.4917504505884,103.22222222222223,59.18181818181818,55.82758620689655,FALSE,304,0.9007407407407407,1,1,0,0,3,FALSE
282,2022-03-18T18:53:54Z,2022-03-18T19:11:25Z,1050,1,2022-03-18T19:11:26Z,0.8999999761581421,Chrome,99.0.4844.74,Windows NT 10.0,1536,864,NA,1.7777777777777777,508,49,224,58,37,75,-0.34924962966651935,-0.3804199050311909,-0.680621510827619,-0.49476148661262676,-0.4899079648014471,-0.265005854431807,2,1,1,1,2,1,1,2,1,2,1,1,2,1,3,2,1,1,2,2,1.1192102478745307,0,1,1,3,2,1.5,0,1,1,2,1,2,1,1,1,1,1,1,2,2,2,3,1,1,1,1,1,1,1,1,1,2,0,0,0,0,1,3,2,1,2,2,1,2,1,2,1,1,1,2,2,2,2,1,1,1,1,1,1,1,1,2,1,1,2,1,1,1,1,1,1,1,1,1,1,1,1,1.6589913357978252,1.6987390281365427,1,0,1,0,1.4666666666666666,0,1.6666666666666667,0,1.4166666666666667,0,1.1666666666666667,0,1.1428571428571428,0,1,0,1.3513513513513513,0,1,0,0,-1.2085454092389094,-1.2306043818707768,-0.39960647100849406,-0.8151054264396355,1,1,1,1,1,1,1,1,1,1.9518001458970664,1,0,1,-0.9579186615539372,5,5,5,5,4,4,5,4,3,6,4,1.4638501094227998,3.5,4.714285714285714,0,0.7527672921047103,0,1.1461240685098075,2,2,2,2,2,4,5,4,4,4,5,4,4,5,5,4,5,5,4,3,1.505545305418162,2,0,4.6,0,4.2,0,4.2,0,4.333333333333333,0,1,2,1,1,1,1,1,1,1,2,2,1,2,1,1,1,1,1,1,2,1.1821033884786185,1.25,0,I lived with my mother and father an equal amount of time (joint custody),0,"White, Caucasian, Anglo, European American",0,25,0,1,NA,1,3,6,Quality Assurance Specialist,5,150,70,2,5,2,0,0,0,0,0,TRUE,TRUE,TRUE,TRUE,TRUE,5,0.5057312500048429,0.4007687499951571,0.4681374999973923,0.5381709677403973,0.45139062500186267,0.5591187500003725,1,1,1,0.96875,1,1,0.137,0.243,0.613,0.017,1.818,23.08915903332022,1805.6219335248707,0.084,0.269,0.633,0.028,1.595,33.12242613253226,1817.9848372652853,0.075,0.333,0.459,0.017,1.407,135.31295543282354,1963.6336864937687,106.94117647058823,56.964285714285715,82.76470588235294,FALSE,414,1.2266666666666668,0,1,0,0,3,FALSE
283,2022-03-18T18:53:14Z,2022-03-18T19:12:06Z,1132,1,2022-03-18T19:12:07Z,1,Firefox,90.0,Windows NT 10.0,1920,1080,NA,1.7777777777777777,486,137,262,47,44,69,-0.3944838246471007,0.10549459551285129,-0.5425572669024823,-0.6304208112160707,-0.3463668663329587,-0.33243518982406084,2,3,2,2,2,1,3,2,1,2,4,2,1,4,2,2,3,1,3,2,0.9233805168766387,0,0,1,4,3,2.2,0,3,3,2,2,4,3,4,4,2,1,1,2,2,3,4,2,1,3,1,1,1,2,1,1,2,0,0,0,0,3,1,1,1,2,1,2,2,1,3,1,4,3,1,2,1,5,3,3,3,2,3,1,1,1,3,1,1,2,1,1,1,1,2,1,2,1,2,2,2,1,1.572091432287407,1.0465362369445672,1.5,0,1.75,0,2.6666666666666665,0,1.5555555555555556,0,2.5833333333333335,0,1.6666666666666667,0,1.2857142857142858,0,1.3333333333333333,0,1.837837837837838,0,1,0,0,-0.5681282489070757,-0.2759833121299669,-0.14114775846592847,-0.2085655352979477,1,1,3,2,1,1,1,3,1,1.5275252316519468,1.4285714285714286,0,2,-0.32231065268119236,3,4,4,4,2,2,3,4,4,NA,3,0.8997354108424374,4,3.142857142857143,0,-0.13222200579606097,1,-0.24434306172794495,2,2,2,2,2,4,5,4,4,3,5,4,4,3,5,3,4,4,3,5,1.2649110640673518,2,0,4.2,0,3.6,0,4.2,0,4,0,2,1,1,4,3,3,2,4,4,2,1,2,2,3,1,2,1,2,3,3,0.9679060415469871,2.3,0,I lived with my mother and father an equal amount of time (joint custody),0,"Asian or Asian American (e.g., Chinese, Japanese, and others)",0,27,1,2,NA,1,3,3,n/a,3,110,61,1,5,2,1,0,1,0,1,TRUE,TRUE,TRUE,TRUE,TRUE,6,0.5179677419354839,0.483875,0.47803125,0.5613333333333334,0.52134375,0.5471935483870968,1,1,1,0.9375,1,1,0.106,0.336,0.775,0.018,1.476,25.193591290341175,1809.110565991469,0.059,0.363,0.545,0.025,1.618,136.19881448823065,1920.6328776635614,0.059,0.37,0.415,0.022,1.715,50.317294311998985,1896.6222955314863,82,64.72,77.95454545454547,FALSE,348,1.031111111111111,0,1,0,3,6,FALSE
284,2022-03-18T18:54:04Z,2022-03-18T19:14:01Z,1197,1,2022-03-18T19:14:03Z,1,Edge,92.0.902.62,Macintosh,1440,900,"I enjoyed playing the Flanker game and I was fully attentive, missing only 1 question if I recall correctly. I felt encouraged not to take any breaks whatsoever. That said, thank you for giving me the opportunity to participate in this survey. I had a lot of fun taking part and I hope my input will contribute to your research.",1.6,514,77,290,56,24,84,-0.3369130310354517,-0.22581074576717747,-0.44082571874711846,-0.5194268183587075,-0.7564842905286399,-0.16386185134342626,1,1,1,1,2,1,1,1,1,1,2,1,1,1,1,1,1,1,1,1,1.465390194130093,0,0,2,4,4,1.1,0,3,2,4,1,3,1,2,3,1,1,2,2,1,2,4,1,3,1,1,1,1,1,1,0,2,0,0,0,0,2,4,3,2,2,2,3,5,3,3,1,1,1,4,3,1,3,1,1,2,1,1,1,1,1,1,1,1,1,1,1,2,2,2,1,1,1,1,2,2,1,1.3911992795553898,1.3732131246511903,1.25,0,1.5,0,2.1333333333333333,0,2.888888888888889,0,1.8333333333333333,0,1,0,1.4285714285714286,0,1,0,1.8108108108108107,0,0,0,0,-0.7479714240687552,-0.6297870419329575,-0.4466634660828154,-0.5382252540078865,1,1,2,1,1,1,3,4,1,1.7043362064926932,1.4285714285714286,0,2.5,-0.12890852875348124,5,4,4,5,2,2,5,9,9,3,3,1.6035674514745464,9,3.857142857142857,0,0.7615446951090925,0,0.6870542412081319,1,1,3,1,1,5,5,5,5,3,5,5,5,5,5,5,5,5,4,3,1.8593393604027366,1.4,0,5,0,4.4,0,4.6,0,4.666666666666667,0,1,1,1,4,1,1,1,1,1,1,1,1,3,1,1,1,1,1,1,1,1.145931016569864,1.25,0,I lived with my mother and father an equal amount of time (joint custody),0,"Asian or Asian American (e.g., Chinese, Japanese, and others)",0,19,0,1,NA,1,2,5,Student,3,150,69,3,5,2,0,0,1,0,0,TRUE,TRUE,TRUE,TRUE,TRUE,3,0.5637999999979811,0.5699687500009313,0.5929625000013039,0.6612935483864238,0.6230062500019558,0.6033937500012108,0.96875,1,1,1,1,1,0.183,0.317,0.69,0.063,1.373,95.58893079314208,1882.4960936060172,0.112,0.382,0.634,0.023,1.499,29.797134170140453,1813.4990189715693,0.085,0.409,0.554,0.019,1.896,132.82007233520156,1981.525746628101,21.793650793650794,65.17391304347827,99.78947368421052,FALSE,374,1.108148148148148,0,1,0,0,3,FALSE
285,2022-03-18T18:42:38Z,2022-03-18T19:15:06Z,1947,1,2022-03-18T19:15:08Z,0.8999999761581421,Chrome,99.0.4844.74,Windows NT 10.0,1920,1080,NA,1.7777777777777777,768,262,620,58,64,44,0.18533631101307793,0.7957140565129112,0.7581532416553846,-0.49476148661262676,0.06375055786272243,-0.6133907539584519,2,2,2,2,3,1,1,2,1,2,2,1,1,1,2,2,1,1,2,2,0.9445132413883326,0,0,4,3,3,1.65,0,2,1,2,2,2,2,2,3,4,3,2,2,4,3,2,2,1,1,1,1,1,2,1,2,2,0,0,0,0,2,2,2,3,2,1,2,1,2,3,2,4,4,3,2,3,2,2,2,2,2,5,1,1,1,3,2,2,3,3,1,2,2,2,1,1,1,2,1,2,2,1.248422427929969,0.9759000729485332,1.25,0,1.75,0,2.4,0,1.8888888888888888,0,2.5833333333333335,0,2.1666666666666665,0,2.142857142857143,0,1,0,2.135135135135135,0,1,0,0,-0.5374233165623987,-0.3717600861233279,-0.14114775846592847,-0.25645392229462816,2,2,2,2,1,2,2,1,1,1.1338934190276817,1.8571428571428572,0,1,-0.4603111395192921,3,4,4,4,3,3,3,6,6,4,3,0.5345224838248488,6,3.4285714285714284,0,0.43348058270556905,0,0.255025804242946,3,4,3,3,3,3,4,3,3,4,3,2,3,4,3,3,4,2,3,2,0.6172133998483676,3.2,0,2.8,0,3.4,0,3,0,3.066666666666667,0,2,3,2,1,2,1,2,2,1,1,1,1,2,1,2,1,1,1,1,1,1.0990426455975697,1.45,0,I lived with my mother and father an equal amount of time (joint custody),0,"White, Caucasian, Anglo, European American",0,22,0,1,NA,1,3,4,Student,1,150,72,2,5,2,0,0,0,0,0,TRUE,TRUE,TRUE,TRUE,TRUE,3,0.5793343750005588,0.505125,0.5180875000013039,0.5855187499998137,0.5387064516121342,0.5899187499983236,1,1,1,1,0.96875,1,0.068,0.335,0.353,0.019,1.281,112.21904649853644,1898.6020302105787,0.07,0.309,0.346,0.038,1.725,89.14066870501334,1911.4855868470997,0.126,0.276,0.422,0.108,1.819,47.2802323089672,1829.3371670518873,67.42105263157895,45.39473684210527,16.84259259259259,FALSE,257,0.7614814814814815,0,1,1,6,9,FALSE
286,2022-03-18T18:39:05Z,2022-03-18T19:15:09Z,2163,1,2022-03-18T19:15:11Z,0.8999999761581421,Chrome,99.0.4844.74,Windows NT 10.0,1536,864,no feedback,1.7777777777777777,678,218,846,120,94,129,2.8733154706348906e-4,0.5527568062408901,1.5792721660522504,0.269863797515876,0.6789266941562442,0.3418581640984775,4,4,4,3,4,2,2,4,2,4,4,2,1,2,4,4,3,3,4,4,0.9233805168766387,0,0,2,4,2,3.2,0,5,3,2,3,2,3,4,4,3,4,2,5,3,5,5,3,4,5,3,4,5,5,5,3,1,1,0,1,1,2,5,4,4,3,2,3,3,4,1,2,1,1,2,3,1,4,4,4,5,5,4,2,3,1,4,3,3,3,3,3,2,1,1,1,3,4,2,3,2,2,1.2728393929008168,1.0465362369445672,4.25,0,2.25,0,3.533333333333333,0,3.3333333333333335,0,2.75,0,2.8333333333333335,0,2.2857142857142856,0,2.6666666666666665,0,2.810810810810811,0,2,1,0,1.8487885685096388,1.727855600022714,0.9498858647822981,1.3388707324025062,2,2,4,2,1,2,2,4,1,0.8997354108424374,2.142857142857143,0,2.5,0.2857644062753896,3,4,5,5,2,1,3,4,5,3,3,1.4960264830861913,4.5,3.2857142857142856,0,-0.05128942699093936,0,-0.117645201282991,2,4,3,4,3,3,3,3,4,2,5,4,2,3,3,5,4,4,3,2,1.01418510567422,3.2,0,4,0,3,0,3,0,3.3333333333333335,0,3,2,4,2,4,4,3,4,1,2,2,3,4,3,2,3,1,4,3,4,1.0809352675491624,2.9,0,"I lived with my mother, but not father, most of the time. & I lived with my mother and father an equal amount of time (joint custody)",1,"White, Caucasian, Anglo, European American",0,25,1,2,NA,1,2,4,student,2,145,68,2,5,2,1,0,0,0,1,TRUE,TRUE,TRUE,TRUE,TRUE,6,0.7256032258072688,0.6663999999999068,0.5877312500008848,0.6815281250008848,0.6265562499996741,0.6568937500009779,1,1,1,1,1,1,0.12,0.389,0.627,0.01,1.211,95.58801706200879,1882.5463990430653,0.078,0.464,0.43,0.226,1.58,131.6250081773687,1910.7525085790348,0.168,0.41,0.574,0.277,1.367,138.5753345477002,1924.1263579300123,121.10000000000001,6.991150442477876,4.935018050541516,FALSE,393,1.1644444444444444,0,1,0,0,3,FALSE
287,2022-03-18T18:28:08Z,2022-03-18T19:15:14Z,2825,1,2022-03-18T19:15:14Z,1,Chrome,97.0.4692.71,Macintosh,1280,800,NA,1.6,2215,67,265,69,42,64,3.1605126808722215,-0.28102830264718226,-0.5316574581715505,-0.3591021620091827,-0.38737860875252683,-0.38862630265093906,2,2,1,1,1,1,2,2,1,2,4,1,1,1,2,2,2,1,2,2,1.050062654772261,0,1,2,4,3,1.65,0,3,2,3,3,3,2,3,2,2,2,3,3,2,4,4,2,1,1,1,1,2,2,1,0,2,0,0,0,0,2,2,2,2,2,2,2,2,2,3,2,3,1,3,2,2,3,3,3,3,3,2,3,3,1,4,3,2,1,3,2,3,3,3,2,3,2,2,2,2,3,0.9112246322012648,0.6324555320336759,1.375,0,2.25,0,2.7333333333333334,0,2,0,2.5833333333333335,0,2.6666666666666665,0,2.4285714285714284,0,2.3333333333333335,0,2.4054054054054053,0,0,0,0,-0.2808178105390271,-0.05365139631991641,-0.1882047535402498,-0.1209280749300831,4,3,4,2,3,4,2,3,2,0.7867957924694432,3.142857142857143,0,2.5,0.8663065153158088,4,4,4,4,4,5,4,3,3,2,3,0.8997354108424374,3,4.142857142857143,0,-0.5360594366874477,0,0.05150251987581217,2,3,3,3,3,3,4,3,4,2,5,3,4,4,3,5,4,4,3,4,0.9856107606091623,2.8,0,3.8,0,3.6,0,3.6,0,3.6666666666666665,0,2,2,3,3,2,3,3,2,2,2,2,2,2,3,2,2,2,2,2,2,0.4893604849295929,2.25,0,"I lived with my mother, but not father, most of the time.",0,"White, Caucasian, Anglo, European American",0,29,1,2,NA,1,4,4,front desk manager,4,115,62,3,5,2,0,0,1,0,0,TRUE,TRUE,TRUE,TRUE,TRUE,1,0.6105406249910593,0.5779937499798834,0.5977156249955297,0.6617935483801749,0.6331483870860068,0.6429677419277929,1,1,1,1,0.96875,1,0.145,0.346,0.641,0.015,1.298,52.511303934901775,1835.274783306133,0.067,0.42,0.466,0.015,1.451,88.78663779764507,1914.5527720697228,0.08,0.431,0.449,0.051,1.658,108.86468139857696,1894.0947954177345,86.53333333333335,96.73333333333335,32.509803921568626,FALSE,384,1.1377777777777778,0,1,0,0,3,FALSE
288,2022-03-18T17:11:00Z,2022-03-18T19:15:54Z,7494,1,2022-03-18T19:15:55Z,0.800000011920929,Chrome,99.0.4844.51,Windows NT 10.0,1368,912,NA,1.5,6768,86,357,62,53,78,12.521934942080708,-0.17611494457517315,-0.19739665708964055,-0.4454308231204653,-0.1618140254449022,-0.2312911867356801,3,2,4,3,3,3,4,3,1,3,2,2,3,1,3,3,4,1,3,3,0.9403246919632545,0,0,3,5,4,2.7,0,3,1,4,2,3,1,4,3,1,2,3,3,1,2,1,1,4,1,1,2,2,4,2,3,1,0,0,1,0,1,1,1,1,1,3,1,1,1,5,1,4,1,1,4,2,2,1,4,5,4,2,1,1,1,1,1,4,4,4,1,1,2,4,1,1,1,2,2,2,1,1.7005563477556078,1.3345232785352157,2.125,0,1.75,0,2.2666666666666666,0,1.2222222222222223,0,2.8333333333333335,0,1.1666666666666667,0,2.857142857142857,0,1,0,2.027027027027027,0,2,0,0,-0.03956477068799369,-0.09514810948747111,0.07821504497010326,-0.008466532258683927,2,3,1,1,1,2,1,3,2,1.618347187425374,1.5714285714285714,0,2.5,-0.04597394174770708,5,5,5,5,4,4,5,6,7,6,3,1.4638501094227998,6.5,4.714285714285714,0,0.9514460898207904,0,1.2671372411304413,3,4,4,2,3,2,3,3,3,4,2,3,2,3,4,3,3,3,4,3,0.50709255283711,3.2,0,2.6,0,3.2,0,3.2,0,3,0,3,2,2,2,2,3,2,1,3,2,2,2,3,4,3,2,2,3,4,3,0.6958523739384593,2.5,0,"I lived with my mother and father an equal amount of time (joint custody) & I lived with my extended family on mother's side (grandparents, aunts ,uncles, cousins)",1,"Asian or Asian American (e.g., Chinese, Japanese, and others)",0,21,1,2,NA,1,3,6,student,4,156,61,2,5,2,1,0,1,0,1,TRUE,TRUE,TRUE,TRUE,TRUE,4,0.5435593750001863,0.5360562499994412,0.5333281250009313,0.6420566666682561,0.5892062499979511,0.5715031250016763,1,1,1,0.9375,1,1,0.103,0.384,0.759,0.02,1.358,81.54479720859932,1871.1262228910791,0.161,0.307,0.734,0.017,1.419,40.57076526858554,1826.7854211958804,0.08,0.382,0.531,0.006,1.154,61.25607071895592,1904.0682584697327,67.9,83.47058823529412,192.33333333333331,FALSE,460,1.3629629629629632,0,1,1,6,9,FALSE
289,2022-03-18T18:54:41Z,2022-03-18T19:16:05Z,1283,1,2022-03-18T19:16:06Z,1,Firefox,98.0,Windows NT 10.0,1366,768,N/A,1.7786458333333333,651,71,288,75,38,78,-0.05522736229274085,-0.25894127989518034,-0.448092257901073,-0.2851061667709405,-0.46940209359166307,-0.2312911867356801,2,2,1,2,2,1,1,3,1,2,3,1,1,2,1,2,1,1,1,2,1.0711528467275955,0,0,4,3,2,1.6,0,3,1,2,2,1,1,2,3,1,1,2,2,2,3,2,2,2,1,1,2,2,1,2,3,2,0,0,0,0,1,1,1,2,3,1,2,1,1,2,2,2,1,3,2,4,3,2,4,3,2,2,1,1,1,4,2,1,3,2,1,2,3,2,1,2,1,1,2,2,2,1.4110248016923697,1.3451854182690985,1.625,0,1.75,0,1.8666666666666667,0,1.4444444444444444,0,2.5,0,1.8333333333333333,0,2,0,1.3333333333333333,0,1.945945945945946,0,2,0,0,-0.416796796636882,-0.5234885894824202,0.07821504497010326,-0.22263677225615847,2,2,3,1,1,3,2,1,2,1.1126972805283737,2,0,1.5,-0.1839744285858068,4,4,5,3,3,4,4,7,7,3,3,0.9759000729485332,7,3.857142857142857,0,0.4002850852868561,0,0.4670148005288366,2,2,2,3,1,5,2,5,5,2,2,3,4,3,2,1,2,4,3,2,1.1872336794093274,2,0,3.2,0,2.4,0,3.4,0,3,0,1,1,1,2,2,2,2,3,1,3,1,4,2,1,1,3,1,2,1,3,0.7451598203705946,1.85,0,I lived with my mother and father an equal amount of time (joint custody),0,"Asian or Asian American (e.g., Chinese, Japanese, and others)",0,24,0,1,NA,1,3,4,student,3,229,70,2,5,2,0,0,1,0,0,TRUE,TRUE,TRUE,TRUE,TRUE,1,0.48629032258064514,0.43146875,0.45659375,0.6414074074074074,0.5248461538461539,0.55068965517241375,0.96875,1,1,0.84375,0.8125,0.90625,0.059,0.353,0.618,0.013,1.613,63.39615708844861,1920.996720465909,0.048,0.345,0.491,0.014,1.508,158.9501528832421,2102.974269354234,0.055,0.36,0.365,0.007,1.406,159.9292742041559,2136.867397138841,124.07692307692308,107.71428571428571,200.85714285714283,FALSE,340,1.0074074074074075,0,1,0,0,3,FALSE
290,2022-03-18T18:59:16Z,2022-03-18T19:16:14Z,1018,1,2022-03-18T19:16:14Z,1,Firefox,98.0,Windows NT 10.0,1536,864,NA,1.7777777777777777,459,53,218,37,35,79,-0.44999851848690503,-0.35833288227918897,-0.7024211282894828,-0.7537474699464745,-0.5309197072210152,-0.22005296417030445,2,2,2,1,4,1,3,2,1,2,2,2,2,3,2,2,1,2,1,2,0.9333020044867296,0,1,2,4,4,1.95,0,2,2,2,2,1,2,3,3,2,3,2,2,4,3,2,2,2,2,2,2,2,1,2,1,2,0,0,0,0,2,4,4,2,2,2,2,2,2,4,3,3,4,2,3,2,2,2,3,4,3,4,2,2,3,4,1,1,2,1,1,2,1,3,1,1,1,2,3,3,3,1.1937021927285403,1,1.875,0,2.75,0,2.3333333333333335,0,2.4444444444444446,0,2.9166666666666665,0,2.6666666666666665,0,1.5714285714285714,0,1,0,2.3513513513513513,0,1,0,0,0.008685837282212535,-0.033591373840814016,0.20346385825749233,0.08493624220833916,2,1,3,3,1,2,3,2,1,1.1338934190276817,2.142857142857143,0,1.5,-0.10103984158003264,4,3,4,4,2,2,4,3,6,5,2,1,4.5,3.2857142857142856,0,0.03315056065144856,0,-0.06621369012972289,4,3,3,3,4,2,1,2,3,2,2,4,5,3,4,3,4,3,3,3,1.0327955589886444,3.4,0,3,0,2.8,0,3,0,2.933333333333333,0,1,2,1,3,3,1,1,2,2,3,2,2,2,2,1,3,1,1,1,2,0.7677718959499145,1.8,0,I lived with my mother and father an equal amount of time (joint custody),0,"White, Caucasian, Anglo, European American",0,24,0,1,NA,1,2,6,assistant manager,4,174,69,2,5,2,0,0,1,0,0,TRUE,TRUE,TRUE,TRUE,TRUE,5,0.5860666666666666,0.4855625,0.48746875,0.6417692307692308,0.5563333333333333,0.5983,0.9375,1,1,0.8387096774193549,0.967741935483871,0.967741935483871,0.079,0.339,0.505,0.019,2.03,29.913095386117853,1852.2238366992644,0.064,0.347,0.479,0.026,1.877,31.281364340506826,1856.63005852242,0.05,0.43,0.319,0.008,1.146,118.29696374369104,2084.898755593455,106.84210526315789,72.1923076923077,143.24999999999997,FALSE,357,1.0577777777777777,0,1,0,0,3,FALSE
292,2022-03-18T18:49:16Z,2022-03-18T19:18:28Z,1752,1,2022-03-18T19:18:29Z,NA,Chrome,98.0.4758.102,Windows NT 6.3,1366,768,Not that I can think of,1.7786458333333333,543,123,549,97,111,167,-0.2772861376519582,0.02819001588084457,0.5001911016899976,-0.013787517564052406,1.0275265047225732,0.7689106215827519,1,1,1,1,1,1,1,1,1,1,1,1,1,1,1,1,1,1,4,1,1.5312533566021211,0,0,2,5,5,1.15,0,5,3,5,3,1,5,1,3,2,1,5,5,1,5,3,1,5,5,1,5,5,5,5,6,1,2,1,1,1,1,3,1,1,5,1,5,3,3,3,3,5,1,5,3,3,1,3,5,5,5,4,3,1,5,3,2,3,3,2,2,1,1,3,1,3,5,1,5,5,5,1.489704406658992,1.6761634196950514,4,0,4,0,3.2,0,2.5555555555555554,0,3.5,0,3,0,2.142857142857143,0,3,0,2.891891891891892,0,3,1,1,1.7391280958500785,1.5085720209619393,2.678452486613473,2.093512253787706,3,2,3,3,1,1,5,2,3,1.3972762620115438,2.5714285714285716,0,2.5,0.5345681672927123,3,3,3,5,3,1,3,4,6,2,3,1.1547005383792515,5,3,0,-0.17479982686521142,0,-0.3476794413703099,3,3,5,1,2,3,5,3,3,3,3,3,4,3,3,3,5,3,3,3,0.7745966692414834,2.8,0,3.4,0,3.6,0,3,0,3.3333333333333335,0,2,1,1,4,2,2,4,3,2,4,1,4,1,2,3,4,4,4,1,2,1.145931016569864,2.55,0,"I lived with my father, but not mother, most of the time.",0,"White, Caucasian, Anglo, European American",0,21,0,1,NA,1,2,5,"Working at retail store stocking items, doing logistics, and do some cashier work",1,140,66,2,5,2,0,1,0,0,1,TRUE,TRUE,TRUE,TRUE,TRUE,3,0.5831968750357628,0.5014781250059605,0.5375903226175616,0.761862499922514,0.5933586207093864,0.6816692308279184,1,1,0.96875,1,0.9354838709677419,0.8666666666666667,0.071,0.327,0.342,0.013,2.159,87.87497261186503,1993.0332172667866,0.065,0.349,0.45,0.016,1.724,47.37091929210387,1891.5604610502164,0.147,0.284,0.486,0.007,1.399,36.44361427841146,1820.9686630515591,166.07692307692307,107.75,199.85714285714286,FALSE,304,0.9007407407407407,1,0,0,0,3,FALSE
293,2022-03-18T18:55:47Z,2022-03-18T19:18:43Z,1376,1,2022-03-18T19:18:44Z,0.8999999761581421,Chrome,99.0.4844.74,Windows NT 10.0,1920,1080,NA,1.7777777777777777,486,90,458,115,79,85,-0.3944838246471007,-0.15402792182317124,0.16956357018506493,0.2082004681506742,0.3713386260094833,-0.1526236287780506,2,3,2,2,3,1,1,3,1,3,2,1,2,2,2,2,1,1,2,3,0.7591546545162482,0,1,2,3,3,1.95,0,2,2,2,1,1,1,1,2,1,1,1,2,2,1,1,1,1,1,1,1,2,1,1,0,2,0,0,0,0,2,1,1,2,2,1,2,2,4,1,1,2,1,3,1,1,1,1,2,1,3,2,1,1,1,1,1,1,1,1,1,1,1,2,1,1,1,1,1,2,2,1.619605854250695,1.7265434778633235,1.125,0,1.5,0,1.4,0,1.8888888888888888,0,1.5,0,1.1666666666666667,0,1.1428571428571428,0,1,0,1.4324324324324325,0,0,0,0,-1.0747596325942455,-1.169735980328795,-0.4466634660828154,-0.8081997232058051,1,1,3,2,1,1,1,1,2,1.5275252316519468,1.4285714285714286,0,1.5,-0.5157127766089035,5,5,5,5,3,3,5,3,6,NA,3,1.5735915849388864,4.5,4.428571428571429,0,0.003250347887277641,1,0.5347958056928851,2,3,3,2,2,4,2,3,4,2,2,4,3,3,4,4,5,5,2,3,1.082325538564332,2.4,0,4,0,2.6,0,3.4,0,3.3333333333333335,0,1,1,1,2,3,1,2,4,2,1,1,2,1,2,1,3,1,2,1,2,0.7539370349250519,1.7,0,I lived with my mother and father an equal amount of time (joint custody),0,"White, Caucasian, Anglo, European American",0,27,0,1,NA,1,3,3,Unemployed,4,177,69,4,5,2,0,0,1,0,0,TRUE,TRUE,TRUE,TRUE,TRUE,6,0.4314218750046566,0.40602187499869613,0.4065124999983236,0.5112218749960884,0.48259354838440494,0.5136906249998138,1,1,1,1,0.96875,1,0.114,0.285,0.961,0.012,1.491,31.002999874357023,1816.0492740831164,0.061,0.328,0.894,0.018,1.767,215.98946748402824,2045.6296678904985,0.081,0.337,0.853,0.02,1.75,69.27989715956731,1860.1737453558076,124.25,98.16666666666667,87.5,FALSE,312,0.9244444444444444,0,1,0,0,3,FALSE
294,2022-03-18T18:47:27Z,2022-03-18T19:18:45Z,1878,1,2022-03-18T19:18:46Z,0.8999999761581421,Chrome,99.0.4844.51,Windows NT 10.0,1463,823,NA,1.7776427703523694,707,216,554,109,79,105,0.059914224930557036,0.5417132948648892,0.5183574495748839,0.134204472912432,0.3713386260094833,0.07214082252946219,4,4,3,3,4,2,4,4,2,4,4,4,4,3,4,4,4,2,4,4,1.234376040972246,1,1,2,4,3,3.55,0,5,4,5,4,5,4,4,5,5,5,5,5,1,5,3,3,5,1,1,3,5,5,4,0,2,0,0,0,0,1,4,5,3,3,1,2,2,5,1,1,3,1,3,2,1,5,5,5,5,5,4,1,1,1,2,1,1,1,1,1,4,5,4,2,3,4,1,1,1,1,1.641704965940956,1.7674302033770737,3.375,0,1,0,4.333333333333333,0,2.888888888888889,0,3.0833333333333335,0,1.6666666666666667,0,2.4285714285714284,0,3,0,2.675675675675676,0,0,0,0,1.1930189420054667,1.6361104972138785,-0.6189692744445258,0.5085706113846764,2,2,3,2,2,3,2,1,1,0.7867957924694432,2.2857142857142856,0,1,-0.21150737850196963,1,4,4,1,1,1,2,5,3,2,2,1.6035674514745464,4,2,0,-0.698640248793604,0,-1.2085638767930065,3,3,5,5,5,2,5,5,3,4,4,3,1,5,3,5,3,4,5,3,1.3870146083619754,4.2,0,3.2,0,4,0,3.8,0,3.6666666666666665,0,3,3,4,3,3,4,4,3,3,3,3,3,4,4,2,3,2,4,4,3,0.8255779474818965,3.25,0,NA,NA,"White, Caucasian, Anglo, European American",0,24,1,3,NA,1,2,6,Unemployed,1,230,67,1,5,2,0,0,3,0,0,TRUE,TRUE,TRUE,TRUE,TRUE,2,0.556421875,0.4654781250022352,0.5379593750033528,0.6739800000091394,0.5602483870944669,0.6156655172315137,1,1,1,0.967741935483871,0.96875,0.9354838709677419,0.058,0.388,0.462,0.014,1.622,75.15597574028963,1925.3502016814928,0.072,0.363,0.731,0.02,2.032,53.861824917893436,1876.1704661062556,0.069,0.374,0.425,0.012,1.688,110.77904033242444,1935.5839655384414,115.85714285714286,101.6,140.66666666666666,FALSE,368,1.0903703703703704,0,1,0,0,3,FALSE
295,2022-03-18T18:43:48Z,2022-03-18T19:19:52Z,2163,1,2022-03-18T19:19:53Z,1,Chrome,99.0.4844.51,Macintosh,1792,1120,NA,1.6,895,80,470,561,43,66,0.4464609820373428,-0.20924547870317603,0.21316280510879232,5.708569447526679,-0.36687273754274274,-0.3661498575201878,2,3,1,2,2,1,3,3,1,3,3,2,1,2,3,3,2,1,3,3,0.6407232755171874,0,0,2,3,3,2.2,0,2,1,2,1,2,1,3,1,1,1,2,2,3,2,3,1,1,1,1,1,1,1,1,0,2,0,0,0,0,1,1,1,1,1,3,2,1,2,2,3,2,3,3,2,3,3,2,3,3,2,1,1,1,1,1,1,1,1,1,1,2,1,2,1,1,1,1,1,1,1,1.517663764904237,1.4375905768565218,1,0,1,0,1.8,0,1.4444444444444444,0,2.5833333333333335,0,1,0,1.2857142857142858,0,1,0,1.6756756756756757,0,0,0,0,-0.9979973017325532,-0.9434707267777437,-0.6189692744445258,-0.7812200006111347,1,1,1,1,1,1,1,1,1,1.9518001458970664,1,0,1,-0.9579186615539372,5,5,5,5,4,4,5,7,7,6,5,1.4638501094227998,7,4.714285714285714,0,1.7281822263108981,0,1.740239078096883,2,2,2,2,2,4,4,3,4,4,5,2,5,4,4,4,4,4,3,3,1.0997835284835873,2,0,3.8,0,4,0,3.6,0,3.8,0,1,1,2,1,2,2,2,2,1,2,1,3,1,2,1,2,1,2,1,2,0.8335087534664907,1.6,0,I lived with my mother and father an equal amount of time (joint custody),0,"White, Caucasian, Anglo, European American",0,28,1,2,NA,1,3,6,Marketer,4,115,64,4,5,2,0,0,1,0,0,TRUE,TRUE,TRUE,TRUE,TRUE,1,0.45230937500298024,0.467484375,0.528470000076294,0.5619100000063578,0.5553874999880791,0.6128156250268221,1,1,1,0.9375,1,1,0.214,0.277,0.893,0.021,1.865,31.649426847477027,1812.113161126613,0.088,0.345,0.754,0.015,1.676,58.15978540776762,1842.4375913012814,0.055,0.364,0.595,0.013,1.682,175.2657287268363,2038.5250329582898,88.80952380952381,111.73333333333333,129.3846153846154,FALSE,400,1.1851851851851851,0,1,0,21,24,FALSE
296,2022-03-18T18:50:12Z,2022-03-18T19:20:12Z,1799,1,2022-03-18T19:20:12Z,0.8999999761581421,Firefox,98.0,Windows NT 10.0,1536,864,None,1.7777777777777777,777,98,356,121,35,66,0.2038412089596794,-0.10985387631916742,-0.20102992666661784,0.2821964633889164,-0.5309197072210152,-0.3661498575201878,3,2,2,1,4,1,2,3,1,3,3,1,1,1,4,3,1,1,4,3,0.6069769786668839,0,1,2,3,2,2.2,0,5,4,3,3,2,2,5,5,5,3,4,5,1,5,4,4,5,5,1,4,5,5,4,4,1,2,1,0,0,2,5,4,5,5,4,3,3,4,2,4,5,4,5,4,5,4,5,5,5,3,5,2,4,5,4,1,1,3,1,1,2,2,3,1,1,5,2,4,2,1,1.5102254072756096,1.4040757000349275,4.125,0,2.25,0,3.7333333333333334,0,3.888888888888889,0,4.25,0,3.5,0,1.8571428571428572,0,2.3333333333333335,0,3.4324324324324325,0,2,0,1,2.171190358128747,2.032000940845574,1.1566543424609708,1.5943276416532723,1,1,4,1,1,1,1,3,1,1.4960264830861913,1.4285714285714286,0,2,-0.32231065268119236,3,3,3,2,1,1,3,7,6,2,2,0.9511897312113419,6.5,2.2857142857142856,0,-0.24706573651580854,0,-0.7787092254625332,3,3,4,2,3,3,2,4,4,1,5,4,5,3,5,1,3,5,2,2,1.4040757000349275,3,0,4,0,2.2,0,3.6,0,3.2666666666666666,0,1,2,1,1,2,1,3,3,1,1,2,1,1,1,1,2,1,1,1,2,1.019545822516343,1.45,0,I lived with my mother and father an equal amount of time (joint custody),0,"White, Caucasian, Anglo, European American",0,24,1,1,NA,1,2,6,Rater,1,160,70,3,5,2,0,0,1,0,0,TRUE,TRUE,TRUE,TRUE,TRUE,6,0.4942666666666667,0.42071875,0.52859375,0.53753125,0.47433333333333333,0.5758214285714286,0.967741935483871,1,1,1,0.9375,0.875,0.064,0.287,0.364,0.006,1.168,148.08081640094818,2044.7900883261777,0.062,0.287,0.499,0.023,1.897,89.20544896704753,1936.4246434476088,0.072,0.328,0.393,0.053,2.008,122.6653331338681,1955.5465582066195,194.66666666666666,82.47826086956522,37.88679245283019,FALSE,386,1.1437037037037037,0,1,0,0,3,FALSE
297,2022-03-18T18:57:21Z,2022-03-18T19:20:25Z,1383,1,2022-03-18T19:20:25Z,0.8999999761581421,Chrome,98.0.4758.107,CrOS x86_64 14388.61.0,1200,750,no,1.6,509,77,514,82,53,66,-0.3471935298946748,-0.22581074576717747,0.3730266664957927,-0.1987775056596579,-0.1618140254449022,-0.3661498575201878,3,3,3,2,3,2,2,3,1,3,3,2,2,2,3,3,2,2,3,3,0.3244428422615251,1,0,2,3,2,2.5,0,3,2,2,3,2,2,3,3,2,2,3,3,2,3,4,3,4,1,1,4,4,4,3,1,2,0,0,0,0,2,4,4,3,3,2,3,3,3,2,2,2,2,3,2,3,2,3,4,4,3,3,1,1,1,1,1,1,2,3,1,2,1,1,1,1,2,1,3,1,1,1.0815126766107135,0.6324555320336759,3,0,1.5,0,2.6,0,3,0,2.6666666666666665,0,1.3333333333333333,0,1.5714285714285714,0,1.3333333333333333,0,2.2162162162162162,0,1,0,0,0.6512962070672375,0.5150109075852244,-0.22730066264678367,0.14385512246922036,1,1,3,1,1,2,1,1,1,1.5275252316519468,1.4285714285714286,0,1,-0.7091149005366146,5,5,5,5,3,3,5,6,3,6,4,1.5735915849388864,4.5,4.428571428571429,0,0.9333970970158285,0,1.1013384383681009,4,4,4,4,4,3,3,3,2,3,4,3,4,3,3,3,4,3,3,3,0.5345224838248488,4,0,3.4,0,3.2,0,2.8,0,3.1333333333333333,0,2,2,3,3,3,3,3,3,2,2,3,3,2,3,2,4,1,3,2,2,0.6386663736585051,2.55,0,I lived with my mother and father an equal amount of time (joint custody),0,"White, Caucasian, Anglo, European American",0,26,1,2,NA,1,3,6,retail,2,117,67,3,5,2,0,0,1,0,0,TRUE,TRUE,TRUE,TRUE,TRUE,4,0.47767499999987195,0.41910624999995344,0.4565374999999767,0.5482906249997904,0.5187535714286247,0.5477516129032498,1,1,1,1,0.875,0.96875,0.079,0.292,0.48,0.018,1.697,91.89089021281967,1917.1245516516358,0.054,0.308,0.434,0.015,1.632,96.8040056138982,1994.3656713365608,0.078,0.327,0.551,0.018,1.649,51.55534943422073,1836.7045289326763,94.27777777777779,108.8,91.61111111111111,TRUE,403,1.194074074074074,0,1,0,0,3,FALSE
298,2022-03-18T18:31:14Z,2022-03-18T19:20:32Z,2957,1,2022-03-18T19:20:32Z,0.8999999761581421,Chrome,99.0.4844.51,Macintosh,2560,1440,N/A,1.7777777777777777,848,196,845,604,272,66,0.34982429276064636,0.43127818110487953,1.575638896475273,6.238874080067414,4.328971769497806,-0.3661498575201878,4,4,3,3,4,2,2,4,1,4,4,3,3,4,4,4,2,1,4,4,0.9787209698591858,0,1,4,2,1,3.2,0,1,2,2,2,2,1,3,2,1,1,1,2,2,1,1,2,2,1,1,1,1,1,2,0,2,0,0,0,0,1,1,3,1,2,1,1,1,1,2,2,1,1,3,2,2,1,1,1,1,1,1,1,1,1,2,1,1,1,3,1,2,1,1,1,1,1,2,1,2,2,1.692147559571376,1.5675276256394517,1.375,0,1.75,0,1.6,0,1.3333333333333333,0,1.5,0,1.1666666666666667,0,1.4285714285714286,0,1,0,1.3513513513513513,0,0,0,0,-0.9650991599346849,-1.008665799834826,-0.3605105619019602,-0.6845881808683931,2,2,3,1,2,3,2,2,1,0.9759000729485332,2.142857142857143,0,1.5,-0.10103984158003264,5,5,5,4,2,3,4,7,6,5,4,1.3801311186847085,6.5,4,0,1.0808314045082337,0,0.958931103549576,2,2,1,3,2,4,4,5,5,5,5,4,5,3,4,5,5,5,4,5,1.6417180315870614,2,0,4.6,0,4.6,0,4.4,0,4.533333333333333,0,3,1,2,4,4,4,3,4,3,2,4,3,3,2,1,3,1,4,1,3,1.1367080817685316,2.75,0,I lived with my mother and father an equal amount of time (joint custody),0,Black or African American,0,29,1,2,NA,1,3,6,Software engineer,4,180,67,2,5,2,0,0,1,0,0,TRUE,TRUE,TRUE,TRUE,TRUE,3,0.5332612903228691,0.481593749998603,0.5017687499998137,0.5931290322566225,0.5192896551726194,0.5668066666662693,1,1,1,0.96875,0.90625,0.967741935483871,0.064,0.347,0.464,0.017,1.714,136.1448088011982,1960.2474715294932,0.05,0.361,0.47,0.024,1.688,79.08647172977095,1935.53427388407,0.057,0.393,0.437,0.019,1.492,90.64703618945,1917.7641524496091,100.8235294117647,70.33333333333333,78.52631578947368,FALSE,365,1.0814814814814815,0,1,0,3,6,FALSE
299,2022-03-18T19:02:39Z,2022-03-18T19:21:17Z,1117,1,2022-03-18T19:21:18Z,1,Chrome,97.0.4692.71,Macintosh,1440,900,Nothing,1.6,513,87,276,57,33,86,-0.33896913080729635,-0.17059318888717268,-0.4916914928248004,-0.5070941524856671,-0.5719314496405833,-0.14138540621267498,2,2,2,1,2,1,1,2,1,2,2,1,2,1,2,2,1,1,2,2,0.9679060415469871,0,1,1,4,4,1.6,0,2,2,2,2,2,2,2,2,2,2,2,2,2,2,2,2,1,3,1,1,2,2,1,2,1,1,0,1,0,2,2,2,1,1,1,1,1,1,2,2,1,1,2,2,2,2,2,1,1,2,3,1,4,1,3,1,1,2,1,1,1,1,1,1,1,1,1,2,2,2,1.6237723475403307,1.0327955589886444,1.625,0,1.75,0,2,0,1.3333333333333333,0,1.6666666666666667,0,2.1666666666666665,0,1.1428571428571428,0,1,0,1.5135135135135136,0,1,0,0,-0.6975276066453571,-0.6540754024836353,-0.14114775846592847,-0.39761158047478184,2,2,3,2,1,3,3,2,1,0.9759000729485332,2.2857142857142856,0,1.5,-0.01810525457425849,4,4,4,4,3,3,4,8,8,3,3,0.7867957924694432,8,3.7142857142857144,0,0.5809148901979743,0,0.4996318456278071,3,3,3,3,3,3,2,3,3,4,2,2,3,3,2,2,2,4,2,2,0.8338093878327919,3,0,2.6,0,2.6,0,2.6,0,2.6,0,1,1,1,3,2,1,2,3,1,1,2,3,1,1,1,3,1,2,1,2,0.5104177855340404,1.65,0,"I lived with my mother, but not father, most of the time. & I lived with my extended family on mother's side (grandparents, aunts ,uncles, cousins)",1,"Asian or Asian American (e.g., Chinese, Japanese, and others)",0,20,1,2,NA,1,4,3,Student,4,95,62,2,5,2,0,0,1,0,0,TRUE,TRUE,TRUE,TRUE,TRUE,3,0.6875281249955296,0.6253749999850988,0.5836161290599454,0.770459374986589,0.6747124999985099,0.7101000000163913,1,1,1,1,1,1,0.124,0.408,0.681,0.012,1.573,96.98797736286943,1880.966521801336,0.124,0.389,0.501,0.033,1.176,53.454476200642155,1834.4410426701036,0.107,0.422,0.416,0.016,1.556,37.81271785058971,1822.3570543890328,131.08333333333331,35.63636363636363,97.25,FALSE,432,1.28,0,1,0,0,3,FALSE
300,2022-03-18T18:53:00Z,2022-03-18T19:23:26Z,1825,1,2022-03-18T19:23:26Z,0.800000011920929,Chrome,96.0.4664.110,Macintosh,1440,900,"No feedback, just hope you have a great day :)",1.6,437,314,772,85,58,96,-0.4952327134674863,1.082845352288936,1.3104102173559313,-0.1617795080405368,-0.05928466939598191,-0.029003180558918575,2,2,1,1,2,1,2,3,1,2,4,2,2,1,3,3,2,1,3,4,0.7677718959499145,0,0,2,3,3,2.1,0,4,3,4,4,4,5,4,3,3,3,4,4,3,3,4,4,4,3,2,4,3,5,4,1,2,0,0,0,0,3,4,2,5,5,5,4,5,5,4,4,4,3,4,3,1,5,5,5,3,5,3,2,3,2,4,5,4,2,1,1,4,5,4,4,4,4,2,3,1,1,1.4237369936287485,0.9258200997725514,3.625,0,1.75,0,3.6666666666666665,0,4.222222222222222,0,3.8333333333333335,0,3.1666666666666665,0,3,0,4,0,3.675675675675676,0,1,0,0,2.0045064396862147,1.890794115943658,-0.14114775846592847,0.8748231787388648,3,2,3,2,2,2,2,4,3,0.4879500364742666,2.2857142857142856,0,3.5,0.755503241136586,2,2,2,2,1,1,2,6,1,2,1,1,3.5,1.7142857142857142,0,-1.1321657682664374,0,-1.6274250758424933,3,2,2,4,3,3,5,4,4,3,5,3,3,5,4,2,4,5,5,3,1.3201731488169053,2.8,0,4,0,3.6,0,4,0,3.8666666666666667,0,2,3,3,3,4,3,3,3,3,1,4,3,2,3,1,3,1,2,4,3,0.9459053029269173,2.7,0,I lived with my mother and father an equal amount of time (joint custody),0,"White, Caucasian, Anglo, European American",0,29,1,2,NA,1,1,4,Supervisor at a catering company,3,150,66,2,5,2,1,0,0,0,1,TRUE,TRUE,TRUE,TRUE,TRUE,5,0.4429062500018626,0.41756129031892747,0.4424906249977648,0.5235333333335541,0.5157777777777778,0.5091071428635291,1,0.96875,1,0.84375,0.84375,0.875,0.049,0.347,0.429,0.032,2.019,118.44253866491972,2044.0598836479687,0.045,0.325,0.455,0.019,1.955,97.96861576088388,2001.0871674688556,0.053,0.349,0.592,0.016,1.743,24.176736521452014,1885.178550672652,63.09375,102.89473684210527,108.9375,FALSE,328,0.9718518518518519,0,1,0,0,3,FALSE
302,2022-03-18T19:06:16Z,2022-03-18T19:25:10Z,1133,1,2022-03-18T19:25:11Z,0.8999999761581421,Chrome,99.0.4844.74,Windows NT 10.0,1536,864,NA,1.7777777777777777,469,83,374,30,28,101,-0.429437520768459,-0.1926802116391746,-0.13563107428102675,-0.840076131057757,-0.6744608056895036,0.027187932267959625,2,2,1,1,2,1,1,3,1,2,2,1,1,1,1,2,1,1,3,2,1.050062654772261,0,1,5,4,5,1.55,0,2,2,2,2,2,1,3,2,3,1,1,2,2,2,2,1,1,1,1,1,1,1,1,0,2,0,0,0,0,1,2,1,1,1,2,2,2,2,2,2,2,1,3,1,2,2,2,2,1,3,2,1,1,1,2,1,1,1,1,1,2,2,1,1,1,1,1,1,1,1,1.5017507300664965,1.2227992865708155,1,0,1,0,1.9333333333333333,0,1.5555555555555556,0,1.9166666666666667,0,1.3333333333333333,0,1.2857142857142858,0,1,0,1.5405405405405406,0,0,0,0,-1.0857256798602015,-0.9442573943259439,-0.6189692744445258,-0.7816133343852348,2,1,3,1,1,2,2,1,1,1.1547005383792515,1.7142857142857142,0,1,-0.5432457265250663,5,5,5,5,2,2,5,6,7,NA,3,1.8126539343499315,6.5,4.142857142857143,0,0.5451397626206321,1,0.7100496162304737,3,3,2,3,2,3,3,3,3,2,3,2,3,2,3,3,2,4,3,3,0.4879500364742666,2.6,0,2.8,0,2.8,0,2.8,0,2.8,0,2,2,1,4,1,1,1,3,1,2,2,1,2,2,2,1,1,2,2,1,0.8944271909999159,1.7,0,I lived with my mother and father an equal amount of time (joint custody),0,"White, Caucasian, Anglo, European American",0,19,1,2,NA,1,3,3,student,3,140,66,2,5,2,0,0,0,0,0,TRUE,TRUE,TRUE,TRUE,TRUE,6,0.5438774193794497,0.43875312501192093,0.4697677418801092,0.6175599999427795,0.5232066665967305,0.583278125077486,0.96875,1,0.96875,0.967741935483871,0.967741935483871,1,0.094,0.315,0.617,0.013,1.736,146.73134844656732,1970.1228268424595,0.062,0.342,0.669,0.019,1.767,103.94321284261189,1944.213234669664,0.057,0.403,0.397,0.016,1.454,148.94595750880072,2018.8592513890408,133.53846153846155,93,90.875,FALSE,304,0.9007407407407407,1,1,0,0,3,FALSE
303,2022-03-18T19:09:06Z,2022-03-18T19:27:50Z,1123,1,2022-03-18T19:27:51Z,0.8999999761581421,Chrome,99.0.4844.74,Windows NT 10.0,2560,1440,NA,1.7777777777777777,558,61,260,62,33,80,-0.24644464107428912,-0.31415883677518514,-0.5498238060564369,-0.4454308231204653,-0.5719314496405833,-0.20881474160492883,2,2,1,1,2,1,1,2,1,2,2,1,1,1,2,2,1,1,2,2,1.025978352085154,0,1,1,3,3,1.5,0,2,2,3,2,3,2,4,2,2,2,2,2,2,2,3,2,2,1,1,2,2,2,2,2,2,0,0,0,0,2,2,3,2,3,1,1,1,1,2,1,2,1,2,1,2,1,1,2,3,2,2,1,1,1,2,1,1,3,3,1,1,1,1,1,1,1,1,1,2,2,1.5562525251134285,0.9154754164341269,1.75,0,1.5,0,2.3333333333333335,0,1.7777777777777777,0,1.6666666666666667,0,1.3333333333333333,0,1.5714285714285714,0,1,0,1.5675675675675675,0,1,0,0,-0.5812875056262229,-0.4303668184642345,-0.22730066264678367,-0.32883374055550907,3,3,3,3,3,4,4,2,2,0.4879500364742666,3.2857142857142856,0,2,0.7558389783938718,5,5,5,5,2,2,5,4,5,4,3,1.8126539343499315,4.5,4.142857142857143,0,0.1625358753388918,0,0.4770095999368606,3,2,3,2,3,4,3,4,4,4,4,4,3,4,4,3,3,4,2,2,0.8837151016885368,2.6,0,3.8,0,3,0,3.6,0,3.466666666666667,0,1,1,1,4,1,1,1,2,1,1,1,2,1,3,1,3,2,2,1,1,0.7591546545162482,1.55,0,I lived with my mother and father an equal amount of time (joint custody),0,"White, Caucasian, Anglo, European American",0,21,0,2,NA,1,3,4,Software developer,4,115,67,2,5,2,0,0,1,0,0,TRUE,TRUE,TRUE,TRUE,TRUE,5,0.5209281250014901,0.4428354838740441,0.46337500000186266,0.5653781249988824,0.5264032258083744,0.5530593750085682,1,1,1,1,1,1,0.118,0.29,0.688,0.01,1.203,53.9187263086425,1839.4552776150222,0.104,0.322,0.84,0.018,1.593,39.123210602619956,1820.7117157018595,0.076,0.39,0.598,0.038,1.958,56.570694398552604,1839.4098872141624,120.30000000000001,88.5,51.526315789473685,FALSE,372,1.1022222222222222,0,1,0,3,6,FALSE
305,2022-03-18T18:37:50Z,2022-03-18T19:29:15Z,3085,1,2022-03-18T19:29:17Z,0.8999999761581421,Firefox,98.0,Windows NT 10.0,1920,1080,No comments.,1.7777777777777777,475,68,453,100,43,87,-0.41710092213739136,-0.2755065469591818,0.15139722230017852,0.023210480055068695,-0.36687273754274274,-0.13014718364729932,2,1,2,1,3,1,1,2,1,2,1,2,2,1,2,1,1,2,4,2,1.105012502906165,0,1,4,5,4,1.7,0,4,2,1,4,1,1,4,1,1,2,1,2,1,2,3,1,2,2,1,2,1,1,1,2,2,0,0,0,0,2,3,2,2,3,3,2,2,2,1,2,1,1,2,3,2,1,2,2,1,3,2,2,1,1,3,1,1,1,2,1,2,1,2,1,1,1,2,1,2,2,1.2956383286545203,1.1952286093343936,1.375,0,1.75,0,2,0,2.3333333333333335,0,1.75,0,1.6666666666666667,0,1.4285714285714286,0,1,0,1.7567567567567568,0,1,0,0,-0.7019140255517393,-0.6570254057893857,-0.14114775846592847,-0.39908658212765713,2,1,3,1,2,1,1,2,1,1.2149857925879117,1.5714285714285714,0,1.5,-0.4327781896031293,4,4,5,4,4,4,4,7,7,6,5,0.8997354108424374,7,4.142857142857143,0,1.7281822263108981,0,1.4306283771341746,1,1,2,1,2,5,3,5,5,3,5,4,4,3,4,5,4,3,4,2,1.2983506020002016,1.4,0,4.2,0,3.8,0,3.8,0,3.933333333333333,0,1,2,1,4,2,2,1,2,1,1,1,2,2,1,1,2,1,2,1,1,0.7591546545162482,1.55,0,I lived with my mother and father an equal amount of time (joint custody),0,"White, Caucasian, Anglo, European American",0,29,1,2,NA,1,5,6,IT Expert,6,162,65,4,5,2,0,0,1,0,0,TRUE,TRUE,TRUE,TRUE,TRUE,4,0.5295161290322581,0.48453125,0.49235483870967744,0.6156774193548387,0.5700714285714286,0.5527777777777778,0.96875,1,0.96875,0.96875,0.875,0.84375,0.048,0.377,0.44,0.005,1.021,167.8229599462823,2117.8087018399624,0.052,0.382,0.526,0.007,1.154,54.89578686215596,1952.0326125125466,0.059,0.413,0.488,0.024,1.888,162.54957287031934,2029.8804800352739,204.2,164.85714285714283,78.66666666666666,FALSE,320,0.9481481481481481,0,1,0,0,3,FALSE
306,2022-03-18T19:04:27Z,2022-03-18T19:29:26Z,1498,1,2022-03-18T19:29:28Z,0.8999999761581421,Chrome,99.0.4844.74,Windows NT 10.0,1920,1080,n/a,1.7777777777777777,525,183,463,92,56,93,-0.3142959335451611,0.35949535716087333,0.18772991806995135,-0.07545084692925424,-0.10029641181555002,-0.06271784825504549,3,3,3,3,3,1,2,3,1,3,2,2,3,2,3,3,2,2,3,3,0.5525062514530825,0,1,1,4,5,2.5,0,4,3,3,4,3,2,4,4,5,4,3,4,2,3,5,3,4,1,2,3,4,4,4,0,1,0,0,1,0,3,3,4,3,3,3,5,5,5,2,4,3,1,3,5,3,4,4,4,4,4,3,1,1,1,3,2,3,1,2,1,3,1,2,2,3,3,2,2,1,3,1.1203817453240013,1.0327955589886444,3.125,0,2,0,3.533333333333333,0,3.7777777777777777,0,3.4166666666666665,0,1.8333333333333333,0,1.8571428571428572,0,2.6666666666666665,0,2.891891891891892,0,0,0,0,1.1710868474735547,1.2720800892842867,-0.274357657721105,0.49886121578159087,2,3,5,2,1,2,2,1,1,1.0690449676496976,2.4285714285714284,0,1,-0.1285727914961955,2,2,3,2,1,1,2,3,3,2,2,1.0690449676496976,3,1.8571428571428572,0,-0.8792700537047221,0,-1.3959862723733312,3,3,4,2,3,3,2,2,3,3,4,3,4,4,3,3,4,5,3,2,0.8837151016885368,3,0,3.8,0,3,0,2.8,0,3.2,0,1,1,2,3,3,3,3,3,2,2,2,2,1,2,1,3,1,2,2,4,0.8255779474818965,2.15,0,NA,NA,"White, Caucasian, Anglo, European American",0,25,0,3,NA,1,2,2,n/a,2,128,66,5,5,2,0,0,0,0,0,TRUE,TRUE,TRUE,TRUE,TRUE,5,0.48307419355838527,0.3985031250044703,0.4356031249947846,0.5289965517233158,0.5157071428639548,0.5036548387081392,0.96875,1,1,0.90625,0.875,0.96875,0.058,0.336,0.675,0.022,1.941,96.19545371497884,1923.594260131759,0.061,0.296,0.614,0.015,1.908,34.67537085112686,1898.432012643045,0.046,0.382,0.545,0.021,1.808,161.44168626372544,2063.275159340038,88.22727272727273,127.2,86.09523809523809,FALSE,282,0.8355555555555556,0,1,0,3,6,FALSE
307,2022-03-18T19:16:03Z,2022-03-18T19:29:27Z,804,1,2022-03-18T19:29:28Z,0.8999999761581421,Chrome,99.0.4844.51,Macintosh,1280,800,NA,1.6,475,38,156,27,21,49,-0.41710092213739136,-0.4411592175991962,-0.9276838420620742,-0.8770741286768782,-0.818001904157992,-0.5571996411315737,2,2,1,1,2,1,1,2,1,2,2,1,1,1,2,2,1,1,2,2,1.025978352085154,0,1,1,4,4,1.5,0,2,2,2,2,2,2,2,2,2,2,2,2,2,2,2,2,2,1,1,2,2,2,2,3,2,0,0,0,0,1,1,2,2,2,2,2,2,2,2,4,2,2,2,2,2,2,2,2,2,2,3,2,1,1,3,2,2,2,2,1,2,2,2,2,2,1,2,2,2,2,1.1598902298689069,1.0327955589886444,1.75,0,2,0,2,0,1.7777777777777777,0,2.1666666666666665,0,2,0,1.8571428571428572,0,1.6666666666666667,0,1.945945945945946,0,2,0,0,-0.3356480468688072,-0.4107001297592323,0.16436794915095845,-0.12316609030413693,2,2,3,2,2,2,2,1,1,0.7867957924694432,2.142857142857143,0,1,-0.29444196550774376,4,4,4,4,2,2,3,6,4,2,3,0.9511897312113419,5,3.2857142857142856,0,-0.17479982686521142,0,-0.19287409088895574,2,2,2,2,2,4,4,4,4,4,4,4,4,4,3,4,4,3,3,2,0.9258200997725514,2,0,3.8,0,3.8,0,3.4,0,3.6666666666666665,0,1,2,1,4,1,1,2,4,1,1,1,2,1,1,1,2,1,1,1,1,0.6569466853317864,1.5,0,I lived with my mother and father an equal amount of time (joint custody),0,"White, Caucasian, Anglo, European American",0,24,1,2,NA,1,3,6,buyer,3,155,66,1,5,2,0,0,1,0,0,TRUE,TRUE,TRUE,TRUE,TRUE,3,0.6745032257956843,0.5562218749858439,0.6554124999903143,0.7346562499813736,0.6244967742043157,0.7302531249932945,0.96875,1,1,1,0.96875,1,0.161,0.446,0.755,0.012,1.156,41.83201017479568,1825.056045630995,0.106,0.42,0.772,0.014,1.317,150.65154955107997,1983.4780677210483,0.067,0.535,0.455,0.028,1.669,103.92385012057962,1931.7505644778053,96.33333333333333,94.07142857142857,59.607142857142854,FALSE,361,1.0696296296296297,0,1,1,3,6,FALSE
309,2022-03-18T19:13:55Z,2022-03-18T19:32:09Z,1094,1,2022-03-18T19:32:10Z,1,Firefox,98.0,Windows NT 10.0,1920,1080,NA,1.7777777777777777,438,53,385,74,39,63,-0.49317661369564175,-0.35833288227918897,-0.09566510893427665,-0.29743883264398085,-0.448896222381879,-0.3998645252163147,1,1,1,1,1,1,1,2,1,1,1,1,1,1,1,1,1,1,1,2,1.465390194130093,0,0,3,5,5,1.1,0,1,3,1,2,1,1,1,1,1,1,1,1,1,1,5,1,1,1,1,1,1,1,1,1,2,0,0,0,0,2,5,5,3,4,2,5,3,5,1,1,1,1,5,1,5,3,1,1,1,1,5,1,5,1,1,1,1,1,1,1,2,2,2,3,4,1,1,1,2,1,1.3019966187341636,1.8439088914585775,1,0,1.25,0,1.4666666666666666,0,3.7777777777777777,0,1.8333333333333333,0,2.3333333333333335,0,1.4285714285714286,0,2.6666666666666665,0,2.3783783783783785,0,1,0,0,-0.5418097354687811,-0.7822038793967251,-0.31345356682763886,-0.547828723112182,1,1,5,1,1,1,1,1,1,1.5118578920369088,1.5714285714285714,0,1,-0.6261803135308405,2,2,2,5,1,1,1,3,10,1,1,1.7182493859684491,6.5,2,0,-0.804101655862914,0,-1.272799314117985,1,1,1,1,1,5,3,2,5,3,2,3,4,2,4,4,3,4,1,2,1.121223821162776,1,0,3.4,0,3,0,3,0,3.1333333333333333,0,1,1,1,1,1,1,1,3,1,1,1,2,1,2,1,1,1,1,1,1,1,1.2,0,"I lived with my mother, but not father, most of the time.",0,"White, Caucasian, Anglo, European American",0,20,0,1,NA,1,1,4,Retail Front End Associate,1,125,66,1,5,2,0,0,1,0,0,TRUE,TRUE,TRUE,TRUE,TRUE,4,0.417625,0.337,0.422875,0.4835625,0.41510714285714284,0.47238709677419355,1,1,1,1,0.9032258064516129,0.96875,0.058,0.325,0.605,0.018,1.37,108.96587005387002,1935.6235523555665,0.05,0.278,0.882,0.022,1.803,27.031806400430323,1884.1808294319371,0.085,0.309,0.835,0.031,1.99,39.4257559417793,1823.111422337421,76.11111111111113,81.95454545454545,64.19354838709677,FALSE,320,0.9481481481481481,0,1,0,3,6,FALSE
310,2022-03-18T19:06:14Z,2022-03-18T19:32:11Z,1556,1,2022-03-18T19:32:11Z,0.8999999761581421,Chrome,99.0.4844.74,Macintosh,1280,800,No thanks for the opportunity.,1.6,884,87,314,49,47,76,0.42384388454705213,-0.17059318888717268,-0.3536272488996637,-0.6057554794699901,-0.28484925270360656,-0.25376763186643136,1,2,1,2,2,1,2,2,1,2,2,1,1,2,1,1,1,2,2,2,1.0894228312566052,0,0,3,3,3,1.55,0,4,3,4,2,3,3,3,3,2,3,3,3,4,3,2,3,3,1,3,3,3,3,3,3,1,2,0,4,0,2,3,2,2,3,2,2,3,2,1,3,2,1,3,4,2,2,2,4,3,3,2,1,1,1,2,2,2,3,3,3,2,2,2,2,4,1,2,3,3,3,1.0904995136125413,0.6399404734221844,2.75,0,2.75,0,3,0,2.3333333333333335,0,2.5,0,1.5,0,2.4285714285714284,0,2.3333333333333335,0,2.27027027027027,0,2,0,0,0.5240900587821474,0.6041010074188848,0.42282666169352406,0.5134638345562045,3,3,4,2,3,3,4,3,3,0.6900655593423543,3.142857142857143,0,3,1.05970863924352,4,4,4,3,3,3,3,3,3,4,3,0.5345224838248488,3,3.4285714285714284,0,-0.10840883202778547,0,-0.07503335677599673,3,2,3,4,3,3,4,3,3,3,4,3,4,3,3,5,3,3,3,3,0.6761234037828132,3,0,3.2,0,3.8,0,3,0,3.3333333333333335,0,2,3,2,2,2,1,2,2,1,1,2,2,2,2,1,3,1,2,1,1,0.7451598203705946,1.75,0,"I lived with my extended family on mother's side (grandparents, aunts ,uncles, cousins)",0,"Hispanic of Latino (e.g., Mexican American, Central American, and others)",0,29,0,1,NA,1,3,3,Music Producer,3,240,74,2,5,2,0,0,1,0,0,TRUE,TRUE,TRUE,TRUE,TRUE,3,0.6002612903291179,0.6436749999951571,0.597009374992922,0.686400000001703,0.7170322580664389,0.6891600000123183,1,1,1,0.875,1,0.967741935483871,0.088,0.448,0.658,0.015,1.754,90.58926010633438,1918.8889831871184,0.081,0.457,0.406,0.028,1.791,60.37604125311207,1842.251610312115,0.061,0.464,0.478,0.016,1.925,48.116216146973294,1910.6654501021349,116.93333333333334,63.96428571428571,120.3125,FALSE,514,1.522962962962963,0,1,0,3,6,FALSE
311,2022-03-18T19:11:52Z,2022-03-18T19:34:08Z,1335,1,2022-03-18T19:34:09Z,0.8999999761581421,Chrome,99.0.4844.74,Windows NT 10.0,1920,1080,NA,1.7777777777777777,514,87,407,80,34,146,-0.3369130310354517,-0.17059318888717268,-0.01573317824077645,-0.22344283740573864,-0.5514255784307993,0.5329079477098634,1,1,4,4,1,4,4,1,1,1,1,1,2,1,2,2,1,1,2,1,1.2977713690461004,0,1,2,3,3,1.8,0,5,2,2,1,1,1,2,1,3,1,1,2,1,1,2,2,2,1,1,1,1,3,1,1,2,0,0,0,0,1,1,1,1,1,2,1,2,2,1,1,1,1,2,1,1,1,1,1,1,1,1,1,1,1,1,1,1,3,3,3,1,1,1,1,1,1,1,1,1,1,1.8034001919297482,1.6417180315870614,1.5,0,1,0,1.7333333333333334,0,1.3333333333333333,0,1.0833333333333333,0,1,0,1.8571428571428572,0,1,0,1.2702702702702702,0,1,0,0,-0.9365874370431991,-0.9312773797806423,-0.39960647100849406,-0.6654419253945681,2,1,3,1,1,4,3,1,1,1.3972762620115438,2.142857142857143,0,1,-0.29444196550774376,5,5,5,5,4,4,5,9,10,NA,4,1.4638501094227998,9.5,4.714285714285714,0,1.8727898102465754,1,1.8283180413190596,3,3,3,1,3,4,2,4,5,2,4,2,2,2,4,4,2,1,1,3,1.121223821162776,2.6,0,2.6,0,2.2,0,3.6,0,2.8,0,1,4,2,2,1,2,3,4,3,2,4,4,3,2,1,3,3,2,4,3,1.0399898784932577,2.65,0,Prefer not to say.,0,Prefer not to say,0,21,3,5,NA,1,4,3,walmart,2,140,67,1,5,2,0,0,1,0,0,TRUE,TRUE,TRUE,TRUE,TRUE,6,0.5680677419247165,0.5313531249687076,0.6060387096481938,0.6394218750223517,0.6205781249850988,0.6102032257818406,1,1,1,1,1,0.96875,0.067,0.37,0.357,0.025,1.957,124.38498993295384,1950.3822417166107,0.088,0.312,0.415,0.023,1.879,50.33097449111316,1835.0180771658072,0.097,0.337,0.406,0.028,1.637,31.764148978265737,1812.6236120538372,78.28,81.69565217391305,58.464285714285715,FALSE,304,0.9007407407407407,1,1,0,0,3,FALSE
312,2022-03-18T19:03:33Z,2022-03-18T19:38:03Z,2069,1,2022-03-18T19:38:05Z,1,Chrome,96.0.4664.110,Macintosh,1440,900,Thank you!,1.6,671,137,774,150,133,91,-0.014105366855848747,0.10549459551285129,1.317676756509886,0.6398437737070871,1.4786556713378223,-0.08519429338579677,2,2,1,1,2,1,1,2,1,1,2,1,1,2,2,2,1,1,2,2,1.0711528467275955,0,1,1,4,4,1.5,0,2,2,2,2,3,1,2,2,2,1,3,2,1,2,2,2,2,1,1,1,2,1,1,2,2,0,0,0,0,2,4,1,2,3,2,2,3,2,1,3,1,1,1,2,2,2,2,3,1,3,2,1,1,1,1,1,1,2,1,1,1,2,2,1,2,1,1,1,2,2,1.3814515584733358,1.245945806357946,1.375,0,1.5,0,1.9333333333333333,0,2.3333333333333335,0,1.8333333333333333,0,1.1666666666666667,0,1.4285714285714286,0,1.3333333333333333,0,1.7297297297297298,0,1,0,0,-0.7194597011772692,-0.6979321182957905,-0.22730066264678367,-0.4626163904712871,1,2,2,1,1,1,1,1,1,1.6761634196950514,1.2857142857142858,0,1,-0.7920494875423887,5,5,5,5,3,3,4,7,8,6,4,1.2909944487358056,7.5,4.285714285714286,0,1.475286511749183,0,1.3539949241463662,2,3,3,1,2,4,4,4,4,3,4,4,4,4,4,3,4,4,3,3,0.8837151016885368,2.2,0,4,0,3.4,0,3.8,0,3.7333333333333334,0,2,1,2,2,2,2,2,3,1,2,2,2,2,3,1,2,1,2,1,2,0.6863327411532597,1.85,0,NA,NA,"White, Caucasian, Anglo, European American",0,23,0,1,NA,1,4,6,Knife maker,5,180,75,4,5,2,0,0,0,0,0,TRUE,TRUE,TRUE,TRUE,TRUE,3,0.5938968749493361,0.4969625000208616,0.5823937499821186,0.6537000000317892,0.5670562499314546,0.6204687499701976,1,1,1,0.9375,1,1,0.085,0.372,0.44,0.02,1.49,84.01635531013955,1865.9010391096667,0.079,0.346,0.551,0.016,1.272,163.95859072303938,1955.328525480283,0.063,0.399,0.302,0.02,1.593,72.17746191541261,1940.0414901774038,74.5,79.5,79.64999999999999,FALSE,516,1.528888888888889,0,1,0,0,3,FALSE
313,2022-03-18T19:15:14Z,2022-03-18T19:38:27Z,1392,1,2022-03-18T19:38:28Z,0.8999999761581421,Chrome,99.0.4844.74,Windows NT 10.0,1536,864,I took a stretch break during the game when you said I could take a break,1.7777777777777777,668,91,338,85,58,73,-0.02027366617138256,-0.14850616613517076,-0.2664287790522089,-0.1617795080405368,-0.05928466939598191,-0.2874822995625583,4,4,2,2,4,1,1,4,1,4,4,2,3,2,4,4,1,2,4,4,0.5871429486123998,0,1,2,2,1,2.85,0,3,3,5,3,5,1,5,3,3,4,3,4,2,4,5,2,4,1,1,3,3,3,4,1,2,0,0,0,0,4,5,5,5,5,2,5,5,4,2,2,2,1,3,3,4,5,3,3,3,3,5,1,5,1,4,3,1,2,1,1,2,5,4,1,3,2,2,2,1,1,1.3378302544754286,1.2798809468443688,2.625,0,1.5,0,3.533333333333333,0,4.444444444444445,0,2.8333333333333335,0,3.1666666666666665,0,2.2857142857142856,0,2,0,3.108108108108108,0,1,0,0,0.9868572534054928,1.148179950442772,-0.22730066264678367,0.4604396438979942,4,4,5,3,2,3,2,5,1,0.9759000729485332,3.2857142857142856,0,3,1.142643226249294,3,3,5,4,1,1,2,5,4,NA,2,1.5275252316519468,4.5,2.7142857142857144,0,-0.511565577638634,1,-0.707605279792704,3,3,3,2,3,3,1,2,4,1,3,3,4,3,3,5,3,4,1,3,0.9759000729485332,2.8,0,3.2,0,2.4,0,3,0,2.8666666666666667,0,1,1,1,1,2,1,2,4,1,1,3,2,1,1,1,1,1,1,1,2,1.0399898784932577,1.45,0,I lived with my mother and father an equal amount of time (joint custody),0,"White, Caucasian, Anglo, European American",0,30,1,3,NA,1,2,6,Worker,7,160,65,1,5,2,1,0,1,0,1,TRUE,TRUE,TRUE,TRUE,TRUE,2,0.506362500000745,0.5187281250022352,0.47487187499552963,0.5830199999968211,0.5816400000055632,0.5831807692326032,1,1,1,0.9375,0.967741935483871,0.8125,0.062,0.359,0.597,0.014,1.987,109.53165358132102,1967.5263009177147,0.062,0.401,0.547,0.026,1.796,36.58969076380355,1863.0807023160985,0.066,0.367,0.534,0.015,1.755,128.2492594269969,1973.7707352773011,141.92857142857144,69.07692307692308,117,FALSE,396,1.1733333333333333,0,1,0,0,3,FALSE
314,2022-03-18T19:09:16Z,2022-03-18T19:40:23Z,1867,1,2022-03-18T19:40:24Z,0.8999999761581421,Chrome,99.0.4844.51,Windows NT 10.0,1920,1080,No probz,1.7777777777777777,588,114,731,169,108,95,-0.18476164791895097,-0.021505785311159747,1.1614461646998628,0.874164425294854,0.966008891093221,-0.040241403124294216,1,2,2,2,1,1,2,1,1,1,3,1,1,3,1,1,2,2,2,1,1.1821033884786185,0,1,1,4,2,1.55,0,1,1,3,1,2,3,3,3,1,1,1,2,1,2,2,2,1,2,1,1,3,1,3,2,2,0,0,0,0,1,3,4,1,2,2,1,1,3,3,2,2,1,2,1,1,4,1,3,1,1,2,2,1,2,4,2,1,2,1,1,4,4,3,2,2,1,2,2,1,1,1.4311002927985332,1.5118578920369088,1.75,0,1.5,0,1.8,0,2,0,1.8333333333333333,0,2.1666666666666665,0,2.2857142857142856,0,1.6666666666666667,0,2,0,1,0,0,-0.3005566956177479,-0.4744202011634396,-0.22730066264678367,-0.3508604319051116,1,1,4,1,1,3,1,1,2,1.5275252316519468,1.7142857142857142,0,1.5,-0.3498436025973552,4,4,4,4,3,2,3,6,4,4,3,0.7867957924694432,5,3.4285714285714284,0,0.25285077779445086,0,0.14500608390329842,4,1,2,5,3,3,5,4,3,5,3,3,1,3,5,5,2,3,4,3,1.2344267996967353,3,0,2.8,0,4,0,3.6,0,3.466666666666667,0,1,1,4,3,3,4,4,3,3,1,1,3,1,4,4,4,1,3,4,2,1.2732056517228265,2.7,0,I lived with my mother and father an equal amount of time (joint custody),0,"White, Caucasian, Anglo, European American",0,21,0,1,NA,1,3,3,Student(Software Engineering Major),3,330,71,1,5,2,0,0,1,0,0,TRUE,TRUE,TRUE,TRUE,TRUE,2,0.6768709677457809,0.6697281250134111,0.6329499999992549,0.8342000000067056,0.680800000000745,0.7377718750052153,1,1,1,1,1,1,0.108,0.36,0.374,0.031,2.002,117.97277214891469,1904.167109168779,0.129,0.333,0.402,0.053,1.409,49.35500365643067,1832.2754653851066,0.123,0.387,0.402,0.015,1.644,67.88828724835507,1850.3744367686065,64.58064516129032,26.58490566037736,109.6,FALSE,328,0.9718518518518519,0,0,0,3,6,FALSE
315,2022-03-18T19:24:22Z,2022-03-18T19:44:34Z,1211,1,2022-03-18T19:44:36Z,1,Firefox,98.0,Windows NT 10.0,1920,1080,NA,1.7777777777777777,502,70,377,83,66,66,-0.361586228297587,-0.26446303558318085,-0.12473126555009491,-0.18644483978661755,0.10476230028229055,-0.3661498575201878,1,1,1,1,1,1,1,1,1,1,1,1,1,1,1,1,1,1,1,1,1.538967528127731,0,1,2,2,1,1,0,4,2,4,3,3,3,3,2,2,2,1,2,1,2,2,4,3,4,1,1,3,2,1,2,1,1,1,2,2,1,2,1,1,1,1,1,1,1,2,2,2,1,1,2,1,1,1,2,3,2,4,4,1,2,2,2,2,2,1,1,1,1,2,1,2,2,2,2,1,1,1.6014257911512992,1.082325538564332,2.375,0,1.5,0,2.4,0,1.1111111111111112,0,1.6666666666666667,0,2.5,0,1.4285714285714286,0,1.6666666666666667,0,1.6216216216216217,0,1,2,1,-0.1404524055347893,-0.10478478695292218,2.0775628493833422,0.98638903121521,2,2,4,1,1,2,1,2,2,1.0690449676496976,1.8571428571428572,0,2,-0.07350689166386981,4,4,4,4,1,1,3,1,1,2,2,1.4142135623730951,1,3,0,-1.2405296635269585,0,-0.9968043111272092,2,3,2,2,2,4,4,4,4,1,5,5,4,4,5,3,5,5,2,2,1.505545305418162,2.2,0,4.8,0,2.8,0,3.8,0,3.8,0,1,2,2,2,2,1,3,1,1,2,2,1,2,2,1,2,1,2,2,2,0.9119095061289915,1.7,0,I lived with my mother and father an equal amount of time (joint custody),0,"Hispanic of Latino (e.g., Mexican American, Central American, and others)",0,19,0,1,NA,1,2,4,Full-Time Student,2,170,65,2,5,2,0,0,1,0,0,TRUE,TRUE,TRUE,TRUE,TRUE,1,0.54265625,0.45428125,0.4852666666666667,0.57284375,0.49989655172413794,0.5268387096774194,1,1,0.9375,1,0.90625,0.96875,0.054,0.329,0.297,0.027,1.869,230.89375007764454,2145.5693428862132,0.054,0.342,0.548,0.025,1.961,78.87442635395323,1935.4518813234786,0.219,0.214,0.682,0.035,1.836,92.6110450595517,1876.6329909290182,69.22222222222223,78.44,52.457142857142856,FALSE,488,1.4459259259259258,0,1,0,3,6,FALSE
316,2022-03-18T19:00:42Z,2022-03-18T19:44:58Z,2655,1,2022-03-18T19:44:59Z,0.8999999761581421,Chrome,99.0.4844.74,Windows NT 10.0,1920,1080,I really enjoyed taking part in this research study,1.7777777777777777,645,154,811,59,51,131,-0.06756396092380848,0.19936444220885943,1.4521077308580455,-0.4824288207395864,-0.20282576786447032,0.36433460922922883,1,1,1,1,2,1,1,3,1,1,1,1,1,1,1,1,1,2,1,1,1.4290224851827542,0,1,1,5,5,1.2,0,4,1,2,2,1,2,2,1,1,1,1,1,2,2,2,5,1,1,2,1,1,1,1,2,2,0,0,0,0,2,1,1,1,1,1,1,1,1,2,1,1,2,2,2,1,3,2,2,2,2,1,1,1,1,3,2,2,2,2,2,2,1,1,2,2,1,2,2,2,2,1.5701800742161598,1.5491933384829668,1.625,0,2,0,1.6666666666666667,0,1.1111111111111112,0,1.8333333333333333,0,1.5,0,1.7142857142857142,0,1.6666666666666667,0,1.5675675675675675,0,1,0,0,-0.6624362553942977,-0.7760088724546493,-0.05499485428507328,-0.4155018633698613,1,1,3,1,1,1,2,2,1,1.5275252316519468,1.4285714285714286,0,1.5,-0.5157127766089035,5,5,5,5,3,4,4,6,6,5,3,1.2149857925879117,6,4.428571428571429,0,0.6473058850354002,0,0.9270832807034747,1,1,2,2,1,5,5,5,5,4,4,4,4,4,5,5,4,4,5,3,1.5796322658258457,1.4,0,4.2,0,4.6,0,4.4,0,4.4,0,1,1,1,2,1,2,1,1,1,1,2,1,2,1,1,2,1,2,1,1,1.0310954828418375,1.3,0,I lived with my mother and father an equal amount of time (joint custody),0,"White, Caucasian, Anglo, European American",0,26,0,1,NA,1,3,6,Analyst,5,170,67,2,5,2,0,0,1,0,0,TRUE,TRUE,TRUE,TRUE,TRUE,5,0.610653124999255,0.5126156249959022,0.5970156250055879,0.6235666666785876,0.5825137931067368,0.6719741935480026,1,1,1,0.967741935483871,0.9666666666666667,1,0.082,0.394,0.419,0.012,1.214,80.26852391671294,1861.899975791754,0.083,0.363,0.581,0.017,1.498,147.32678973279224,1977.5870584016589,0.067,0.418,0.392,0.019,1.326,87.8766692808758,1914.8597455628585,101.16666666666666,88.11764705882352,69.78947368421053,FALSE,438,1.2977777777777777,0,1,0,0,3,FALSE
317,2022-03-18T19:22:26Z,2022-03-18T19:47:16Z,1489,1,2022-03-18T19:47:16Z,0.8999999761581421,Chrome,99.0.4844.74,Windows NT 10.0,1280,800,None,1.6,597,90,408,118,53,130,-0.16625674997234952,-0.15402792182317124,-0.01209990866379917,0.24519846576979532,-0.1618140254449022,0.3530963866638532,1,2,1,1,2,1,2,1,1,2,1,2,1,1,1,1,1,1,1,1,1.3562719801759993,0,1,3,5,4,1.25,0,5,1,2,2,1,1,1,1,1,2,1,1,1,1,2,1,1,1,2,1,1,1,1,1,2,0,0,0,0,2,1,2,1,1,2,1,2,1,1,3,4,1,2,1,1,1,4,3,2,3,1,1,2,1,2,1,1,2,3,1,1,1,1,1,1,1,4,2,2,2,1.6398747480186373,1.804755622554715,1.125,0,2.5,0,1.5333333333333334,0,1.4444444444444444,0,2.1666666666666665,0,1.3333333333333333,0,1.4285714285714286,0,1,0,1.6216216216216217,0,1,0,0,-0.9519399032155373,-1.0289224892009785,0.11731095407663712,-0.45580576756217067,1,1,2,1,1,1,1,2,1,1.7320508075688772,1.1428571428571428,0,1.5,-0.6815819506204519,5,4,4,5,4,3,5,6,6,2,3,1.3801311186847085,6,4.285714285714286,0,0.005829978045906746,0,0.4589643561354318,1,1,1,1,1,4,3,1,5,1,5,5,5,3,4,3,5,5,3,1,1.6417180315870614,1,0,4.8,0,3,0,2.8,0,3.533333333333333,0,1,1,1,1,1,1,4,1,1,2,1,1,2,1,1,1,1,1,1,1,1.3088765773505315,1.25,0,I lived with my mother and father an equal amount of time (joint custody),0,"White, Caucasian, Anglo, European American",0,27,0,1,NA,1,4,6,Data Scientist,3,130,68,3,5,2,0,0,1,0,0,TRUE,TRUE,TRUE,TRUE,TRUE,1,0.8568333333333333,0.6058064516129033,0.6137096774193549,0.8770645161290322,0.6008709677419355,0.6408,0.9375,0.96875,0.96875,0.96875,1,0.967741935483871,0.061,0.446,0.367,0.025,1.79,195.48906473905973,2061.0336265173723,0.071,0.398,0.34,0.252,1.614,73.4610600676985,1900.7501096906988,0.076,0.533,0.202,0.275,1.849,89.3002913953145,1977.3383486156254,71.6,6.404761904761905,6.723636363636363,FALSE,338,1.0014814814814814,0,1,0,0,3,FALSE
318,2022-03-18T19:32:13Z,2022-03-18T19:47:23Z,909,1,2022-03-18T19:47:24Z,0.8999999761581421,Chrome,99.0.4844.51,Windows NT 10.0,1920,1080,NA,1.7777777777777777,482,57,204,38,40,56,-0.4027082237344791,-0.33624585952718705,-0.7532869023671647,-0.7414148040734341,-0.42839035117209495,-0.4785320831739442,3,3,3,3,3,1,3,3,2,2,4,2,2,3,3,3,3,2,3,3,0.6155870112510925,0,1,2,2,1,2.7,0,3,3,4,3,5,4,2,3,3,2,4,3,2,3,5,3,2,3,4,3,4,4,4,2,1,2,2,1,1,2,2,2,2,2,2,2,2,2,2,3,1,2,3,3,2,5,4,4,2,3,3,4,2,3,3,3,2,2,2,1,2,2,3,1,1,2,2,2,2,3,1.092562901481509,0.990430401872025,3.375,0,2.25,0,3.2666666666666666,0,2,0,2.8333333333333335,0,3,0,2,0,1.3333333333333333,0,2.3783783783783785,0,1,1,2,1.0000165101246405,1.0406031632264099,2.5427900396045806,1.7916966014154951,3,2,3,1,1,1,1,1,1,0.9511897312113419,1.7142857142857142,0,1,-0.5432457265250663,4,4,4,4,2,2,4,4,8,2,2,1.0690449676496976,6,3.4285714285714284,0,-0.33738063897136766,0,-0.21449768370694006,4,4,4,4,4,2,4,1,2,2,2,2,4,3,4,1,2,3,4,5,1.2227992865708155,4,0,2.2,0,3,0,3,0,2.7333333333333334,0,2,3,3,4,4,4,3,3,4,4,4,4,2,3,1,4,2,4,3,3,1.1285761872936695,3.2,0,I lived with my mother and father an equal amount of time (joint custody),0,"White, Caucasian, Anglo, European American",0,20,0,1,NA,1,2,4,student,3,130,71,1,5,2,0,0,0,0,0,TRUE,TRUE,TRUE,TRUE,TRUE,4,0.4406250000074506,0.3630062500089407,0.3903593749850988,0.5540375000052155,0.4446100000063578,0.5532137930968712,1,1,1,1,0.9375,0.90625,0.085,0.276,0.757,0.012,1.904,70.84060957508711,1934.1287215702357,0.052,0.289,0.741,0.013,1.501,103.3218224574208,1958.898059967524,0.106,0.295,0.716,0.02,1.898,219.0095802098594,2007.9106274716607,158.66666666666666,115.46153846153845,94.89999999999999,FALSE,348,1.031111111111111,0,1,0,3,6,FALSE
319,2022-03-18T19:19:30Z,2022-03-18T19:48:29Z,1738,1,2022-03-18T19:48:30Z,0.8999999761581421,Chrome,99.0.4844.74,Windows NT 10.0,1280,720,no,1.7777777777777777,659,120,524,116,51,130,-0.038778564117984006,0.01162474881684313,0.4093593622655655,0.22053313402371458,-0.20282576786447032,0.3530963866638532,1,1,1,1,1,1,2,2,2,2,1,3,1,1,1,1,1,1,3,2,1.2763022245616642,0,0,4,3,1,1.45,0,4,3,1,2,2,1,3,2,1,1,1,1,1,2,4,1,3,4,1,1,1,1,1,2,2,0,0,0,0,1,4,5,3,4,4,5,2,5,2,1,3,1,4,1,4,1,1,1,1,1,3,3,4,2,5,2,1,2,1,1,1,2,1,2,3,1,2,2,2,1,1.3231593822177095,1.3201731488169053,1.625,0,1.75,0,1.9333333333333333,0,3.6666666666666665,0,1.75,0,3.1666666666666665,0,1.2857142857142858,0,2,0,2.3783783783783785,0,1,0,0,-0.13606598662840672,-0.30558167863099506,-0.14114775846592847,-0.22336471854846177,3,3,5,4,3,1,2,5,2,1.1338934190276817,3,0,3.5,1.170176176165457,2,5,5,3,3,4,2,4,7,1,2,1.1126972805283737,5.5,3.4285714285714284,0,-0.6415208437567579,0,-0.3997462936525523,2,2,3,4,4,5,4,4,4,1,3,4,2,2,3,3,2,2,3,3,1.0327955589886444,3,0,3.2,0,2.6,0,3.2,0,3,0,1,2,2,4,1,1,2,4,1,2,3,3,2,1,1,1,1,1,2,2,0.812727700887249,1.85,0,"I lived with my mother, but not father, most of the time.",0,Black or African American,0,20,0,1,NA,1,3,4,Trader,2,105,67,1,5,2,0,0,0,0,0,TRUE,TRUE,TRUE,TRUE,TRUE,6,0.5874483870940823,0.5753906250018627,0.5650906249983236,0.6205812499979511,0.5914322580656698,0.5967187499981373,1,1,1,1,1,1,0.113,0.389,0.679,0.029,1.454,72.71927996677445,1859.2907564936265,0.09,0.374,0.532,0.019,1.313,72.8873144351077,1854.4638508224791,0.101,0.408,0.567,0.034,1.369,61.27471442352384,1845.1624096478918,50.137931034482754,69.10526315789474,40.264705882352935,FALSE,354,1.0488888888888888,0,1,0,0,3,FALSE
320,2022-03-18T19:27:19Z,2022-03-18T19:48:38Z,1279,1,2022-03-18T19:48:39Z,1,Chrome,99.0.4844.51,Windows NT 10.0,1536,864,No,1.7777777777777777,509,90,334,108,52,122,-0.3471935298946748,-0.15402792182317124,-0.28096185736011803,0.12187180703939164,-0.18231989665468626,0.26319060614084805,2,2,1,1,2,1,1,2,1,2,2,1,1,1,2,2,1,1,2,2,1.025978352085154,0,1,1,5,5,1.5,0,2,1,3,2,3,3,2,2,2,2,2,2,2,3,3,1,1,1,1,1,2,3,1,1,2,0,0,0,0,1,1,1,1,1,1,1,1,1,1,1,1,1,2,1,1,3,1,2,2,2,1,1,1,1,1,1,1,2,2,1,2,2,2,1,1,1,1,2,1,2,1.7774023627640307,0.9611501047232549,1.375,0,1.5,0,2.2666666666666666,0,1,0,1.5,0,1,0,1.7142857142857142,0,1,0,1.2972972972972974,0,1,0,0,-1.000190511185744,-0.7411988334467955,-0.22730066264678367,-0.48424974804678955,1,1,1,1,1,2,1,1,1,1.889822365046136,1.1428571428571428,0,1,-0.874984074548163,5,5,5,5,3,3,5,8,8,5,4,1.5735915849388864,8,4.428571428571429,0,1.351776111874911,0,1.3561687097810788,1,2,2,2,2,4,3,3,4,3,5,4,4,4,4,3,4,4,3,2,0.9611501047232549,1.8,0,4.2,0,3.2,0,3.4,0,3.6,0,1,1,1,1,2,1,2,1,1,1,1,1,1,2,1,1,1,1,1,1,1.2085223687584246,1.15,0,I lived with my mother and father an equal amount of time (joint custody),0,"White, Caucasian, Anglo, European American",0,19,1,2,NA,1,4,3,Student,5,115,63,4,5,2,0,0,1,0,0,TRUE,TRUE,TRUE,TRUE,TRUE,1,0.6223718750104308,0.5138062499985099,0.649800000000745,0.768465624999255,0.592584375012666,0.7210406250096858,1,1,1,1,1,1,0.169,0.276,0.458,0.02,1.687,61.37494503658391,1843.7262688447245,0.093,0.333,0.541,0.017,1.698,82.63384651442843,1865.6732942007877,0.154,0.281,0.44,0.011,1.597,26.79972150311478,1809.1243003973332,84.35,99.88235294117646,145.1818181818182,FALSE,336,0.9955555555555555,0,1,0,0,3,FALSE
321,2022-03-18T19:32:24Z,2022-03-18T19:48:47Z,982,1,2022-03-18T19:48:49Z,0.699999988079071,Safari,15.2,Macintosh,1440,900,NA,1.6,478,183,154,23,17,76,-0.4109326228218575,0.35949535716087333,-0.9349503812160288,-0.9264047921690396,-0.9000253889971283,-0.25376763186643136,1,1,1,1,1,1,1,1,1,1,1,1,2,1,2,3,3,3,3,2,1.2763022245616642,0,1,1,2,2,1.55,0,3,3,3,3,3,3,4,3,3,2,2,4,3,3,4,4,1,1,1,3,2,2,2,12,2,0,0,0,0,4,3,4,3,2,3,3,4,3,2,3,2,2,4,3,4,2,2,3,3,3,4,3,3,2,3,3,2,3,3,3,2,2,3,3,2,3,4,3,3,3,0.5876609101729886,0.4879500364742666,2,0,3.25,0,3.066666666666667,0,3.2222222222222223,0,2.75,0,3,0,2.5714285714285716,0,2.6666666666666665,0,2.864864864864865,0,6,0,0,0.4232024239353518,0.5653576306700305,1.4725836837993613,1.018970657234696,3,3,5,2,3,3,3,4,1,0.7867957924694432,3.142857142857143,0,2.5,0.8663065153158088,1,2,2,2,1,1,1,4,5,1,2,1.4142135623730951,4.5,1.4285714285714286,0,-0.822150648667876,0,-1.5934034673616795,3,3,3,3,4,3,4,4,3,2,2,2,3,3,3,2,4,4,4,3,0.7988086367179802,3.2,0,3,0,3,0,3.2,0,3.066666666666667,0,2,3,2,3,4,4,4,2,4,3,2,2,3,4,4,1,4,3,4,4,0.8013147091860318,3.1,0,"I lived with my mother, but not father, most of the time.",0,"Black or African American & White, Caucasian, Anglo, European American",1,20,1,2,NA,1,2,4,medical scribe,1,112,67,1,5,2,0,0,1,0,0,TRUE,TRUE,TRUE,TRUE,TRUE,1,0.5229062500000091,0.48471874999999726,0.5629375000000009,0.6371249999999982,0.5505000000000009,0.6485806451612908,1,1,1,1,1,1,0.089,0.415,0.585,0.009,1.034,37.679055759091746,1819.7087127766442,0.088,0.362,0.763,0.019,1.589,109.45936373070909,1890.1233269472782,0.093,0.374,0.675,0.006,1.202,50.70901063169486,1837.814361646538,114.8888888888889,83.63157894736842,200.33333333333331,FALSE,368,1.0903703703703704,0,1,0,0,3,FALSE
322,2022-03-18T19:24:55Z,2022-03-18T19:49:24Z,1468,1,2022-03-18T19:49:25Z,1,Chrome,97.0.4692.102,CrOS x86_64 14324.80.0,1517,853,"not really. One thing that wasnt asked about that heavily impacted my childhood was sibling abuse from my older brother. One caregiver may have been scary and unpredictable, but my older brother was a monster to me. He physically, mentally and sexually abused me during the majority my childhood. He created more of my unsafe home life than my caregivers (however their neglect allowed for him to do what he did...)",1.7784290738569755,628,97,328,70,35,98,-0.10251765704516676,-0.1153756320071679,-0.30276147482198174,-0.34676949613614233,-0.5309197072210152,-0.0065267354281672955,4,3,2,2,4,1,1,4,1,4,4,1,1,2,4,3,1,1,4,4,0.4442616583193193,0,1,2,2,2,2.55,0,3,3,4,3,5,3,4,3,5,3,3,4,2,3,3,2,3,1,1,2,3,2,5,0,2,0,0,0,0,2,4,3,4,3,4,3,2,4,1,3,5,2,4,3,3,4,4,5,5,5,3,1,3,1,2,1,1,1,1,1,4,5,5,1,2,5,1,2,1,2,1.4415540496554675,0.9154754164341269,2.375,0,1.5,0,3.4,0,3.2222222222222223,0,3.6666666666666665,0,1.8333333333333333,0,2.5714285714285716,0,2.6666666666666665,0,2.972972972972973,0,0,0,0,0.7368313757416948,0.9218163634481962,-0.4466634660828154,0.2375764486826904,3,1,4,1,1,3,2,3,5,0.8997354108424374,2.142857142857143,0,4,0.865970778058523,5,3,3,3,1,1,4,8,7,3,2,1.3972762620115438,7.5,2.857142857142857,0,0.14738937072514077,0,-0.22884005438438854,2,3,2,2,2,4,5,4,3,3,3,4,4,3,4,3,5,4,4,4,1.0600988273786194,2.2,0,4,0,3.8,0,3.6,0,3.8,0,3,3,3,4,4,3,4,3,4,3,4,3,3,3,1,3,2,2,4,4,0.9880869341680844,3.15,0,I lived with my mother and father an equal amount of time (joint custody),0,"White, Caucasian, Anglo, European American",0,19,1,1,NA,1,2,3,cannabis farmer,3,205,67,2,5,2,0,0,1,0,0,TRUE,TRUE,TRUE,TRUE,TRUE,3,0.6047531249942258,0.47854193548233276,0.4887531249970198,0.6611354838696218,0.5061645161230718,0.5380033333351215,1,1,1,0.96875,0.96875,0.9375,0.068,0.321,0.426,0.019,1.709,148.2416296085854,1996.8258168700213,0.066,0.309,0.427,0.022,1.551,67.1941721110605,1892.3610683086245,0.075,0.361,0.364,0.01,1.45,70.66355987311967,1894.8789587799,89.94736842105264,70.5,145,FALSE,506,1.4992592592592593,0,1,0,0,3,FALSE
323,2022-03-18T19:34:24Z,2022-03-18T19:50:19Z,955,1,2022-03-18T19:50:21Z,0.8999999761581421,Chrome,99.0.4844.74,Windows NT 10.0,2560,1080,NA,2.3703703703703702,444,54,266,64,36,52,-0.4808400150645741,-0.3528111265911885,-0.5280241885945732,-0.4207654913743845,-0.5104138360112311,-0.5234849734354468,2,3,2,1,3,1,1,2,1,3,3,1,2,1,2,2,1,1,2,3,0.812727700887249,0,1,1,2,1,1.85,0,3,2,2,3,1,4,4,3,3,3,4,3,3,3,4,2,3,1,1,3,3,3,3,0,2,0,0,0,0,3,2,3,2,1,3,3,2,2,1,2,3,1,3,2,2,3,3,5,5,5,2,1,1,1,2,1,1,1,1,1,1,2,2,1,2,2,1,1,2,2,1.4311002927985332,0.8338093878327919,2.375,0,1.5,0,3,0,2.3333333333333335,0,2.9166666666666665,0,1.3333333333333333,0,1.2857142857142858,0,1.6666666666666667,0,2.108108108108108,0,0,0,0,0.17536975572474475,0.3695757446117323,-0.4466634660828154,-0.03854386073554153,1,2,4,2,2,2,2,1,2,1.1338934190276817,2.142857142857143,0,1.5,-0.10103984158003264,4,4,4,3,1,1,4,6,3,4,3,1.3801311186847085,4.5,3,0,0.1625358753388918,0,-0.14221180198855665,2,3,2,2,3,4,5,5,4,3,2,4,3,3,5,5,4,3,4,4,1.2798809468443688,2.4,0,3.4,0,4,0,4.2,0,3.8666666666666667,0,2,1,2,4,4,4,4,4,2,2,4,4,1,2,1,3,1,2,2,4,1.1821033884786185,2.65,0,I lived with my mother and father an equal amount of time (joint custody),0,"White, Caucasian, Anglo, European American",0,30,0,1,NA,1,2,6,Logistics Analyst,3,150,67,3,5,2,0,0,1,0,0,TRUE,TRUE,TRUE,TRUE,TRUE,4,0.4621187500007218,0.4204750000006752,0.44403437500097787,0.5656937500006752,0.48795806451670587,0.5053200000007947,1,1,1,1,1,0.967741935483871,0.061,0.369,0.853,0.028,1.93,24.81231453057325,1852.3569642669058,0.073,0.334,0.828,0.035,1.981,86.93543279355762,1871.6977553538743,0.129,0.295,0.788,0.015,1.681,23.15508408828966,1808.4366956309188,68.92857142857143,56.599999999999994,112.06666666666668,FALSE,406,1.202962962962963,0,1,0,0,3,FALSE
324,2022-03-18T19:05:36Z,2022-03-18T19:51:08Z,2732,1,2022-03-18T19:51:09Z,0.8999999761581421,Chrome,99.0.4844.74,Windows NT 10.0,1920,1080,NA,1.7777777777777777,913,249,409,273,53,67,0.48347077793054566,0.723931232568905,-0.008466639086821888,2.1567616760910524,-0.1618140254449022,-0.35491163495481215,2,3,2,1,2,1,1,2,1,3,3,1,1,2,3,3,1,1,3,4,0.7326950970650465,0,1,1,3,3,2,0,4,2,3,3,1,2,2,2,1,1,1,2,1,3,2,1,1,1,1,1,1,2,1,0,2,0,0,0,0,1,2,5,2,2,2,2,2,3,1,2,1,1,4,1,2,2,1,2,3,2,5,1,1,1,1,1,1,1,1,1,2,1,2,1,1,2,1,1,1,1,1.3495633817354862,1.2421180068162376,1.125,0,1,0,2,0,2.3333333333333335,0,1.8333333333333333,0,1.6666666666666667,0,1.2857142857142858,0,1.3333333333333333,0,1.7837837837837838,0,0,0,0,-0.8466658494623595,-0.754375514879147,-0.6189692744445258,-0.6866723946618364,2,1,3,1,1,1,2,1,1,1.2149857925879117,1.5714285714285714,0,1,-0.6261803135308405,1,1,1,1,3,3,5,6,6,5,3,0.9759000729485332,6,2.142857142857143,0,0.6473058850354002,0,-0.3113595231473596,3,2,1,3,1,4,3,2,3,4,3,3,4,2,2,2,3,4,2,2,0.8338093878327919,2,0,3.4,0,3,0,2.2,0,2.8666666666666667,0,1,3,1,4,3,2,3,4,3,1,1,3,1,2,1,4,1,1,1,3,0.8750939799154206,2.15,0,I lived with my mother and father an equal amount of time (joint custody),0,Black or African American & Native American/Alaskan Native/indigenous,1,23,1,2,NA,1,3,3,Student,5,140,70,1,5,2,0,0,0,0,0,TRUE,TRUE,TRUE,TRUE,TRUE,4,0.5822937499973923,0.49818437500298024,0.5686548386985256,0.6074451612868617,0.5581625000033528,0.616862500000745,1,1,1,0.96875,1,1,0.096,0.393,0.602,0.022,1.596,71.64890339515057,1856.4047347516669,0.143,0.308,0.734,0.04,2.069,43.235877625495,1824.5893086448896,0.06,0.456,0.502,0.035,1.803,135.56994627447574,1965.1132720258709,72.54545454545455,51.724999999999994,51.514285714285705,FALSE,476,1.4103703703703703,0,1,0,0,3,FALSE
325,2022-03-18T19:07:05Z,2022-03-18T19:52:17Z,2711,1,2022-03-18T19:52:18Z,0.8999999761581421,Chrome,101.0.4911.0,Windows NT 10.0,1095,730,NA,1.5,1288,121,741,237,46,100,1.2545081923722725,0.01714650450484361,1.1977788604696358,1.712785704661599,-0.3053551239133906,0.015949709702583987,3,4,3,2,4,3,3,4,2,4,4,2,3,2,4,4,2,2,4,4,0.7863975156570492,0,0,4,4,4,3.15,0,5,3,5,5,5,4,5,5,4,5,5,5,2,5,5,5,5,5,4,5,5,5,5,3,1,4,0,2,0,4,4,5,4,4,4,4,4,5,5,5,5,4,5,5,4,5,5,5,5,4,5,4,4,4,3,5,4,4,4,3,4,4,4,2,4,5,2,2,3,3,1.4415540496554675,1.8309508328682538,4.875,0,2.5,0,4.533333333333333,0,4.222222222222222,0,4.75,0,4.166666666666667,0,3.857142857142857,0,3.6666666666666665,0,4.27027027027027,0,2,0,0,3.201998801128616,3.0745321090977438,0.33667375751266887,1.7056029333052063,2,2,4,2,1,3,2,8,3,0.9511897312113419,2.2857142857142856,0,5.5,1.5291117368474307,3,2,3,3,1,1,2,1,1,1,2,1.1338934190276817,1,2.142857142857143,0,-1.4543549658567896,0,-1.5914591123470605,5,5,5,5,5,1,5,3,1,3,2,2,2,3,3,3,3,3,3,5,1.1126972805283737,5,0,2.2,0,3.2,0,3,0,2.8,0,4,4,4,4,4,4,4,4,4,4,4,4,4,4,4,4,4,4,4,4,1.231174022502185,4,0,I lived with my mother and father an equal amount of time (joint custody),0,"Asian or Asian American (e.g., Chinese, Japanese, and others)",0,18,3,2,NA,1,3,4,Student,2,120,67,2,5,2,1,1,1,0,2,TRUE,TRUE,TRUE,TRUE,TRUE,4,0.5324718749998137,0.4796161290324263,0.5036562499997672,0.5918387096769386,0.5555225806446565,0.5711129032256863,1,1,1,1,1,1,0.155,0.285,0.752,0.009,1.171,155.2239109370159,1948.4992231448512,0.115,0.315,0.735,0.025,2.082,42.153796079941394,1827.328058859971,0.137,0.304,0.626,0.01,1.119,67.49439986811349,1850.79433055772,130.11111111111111,83.27999999999999,111.89999999999999,FALSE,304,0.9007407407407407,1,1,1,15,18,FALSE
328,2022-03-18T19:31:08Z,2022-03-18T19:54:26Z,1398,1,2022-03-18T19:54:27Z,0.800000011920929,Chrome,99.0.4844.74,Windows NT 10.0,3440,1440,n/a,2.388888888888889,621,134,395,97,33,50,-0.116910355448079,0.08892932844884985,-0.059332413164503835,-0.013787517564052406,-0.5719314496405833,-0.5459614185661981,2,1,1,1,1,1,1,2,1,1,1,1,1,1,1,1,1,1,1,1,1.465390194130093,0,1,2,3,3,1.1,0,5,2,1,3,1,2,5,3,3,3,2,4,1,5,2,5,5,1,1,1,3,5,2,1,2,0,0,0,0,1,3,3,3,3,1,3,2,2,1,1,2,1,4,3,2,4,4,3,5,5,5,2,1,1,2,1,1,1,1,1,3,3,2,1,1,1,2,1,1,1,1.4441556652887477,1.1254628677422756,2.875,0,1.25,0,2.8,0,2.3333333333333335,0,2.9166666666666665,0,2,0,1.7142857142857142,0,1,0,2.2432432432432434,0,1,0,0,0.5876931329246929,0.5595559575020543,-0.31345356682763886,0.12305119533720774,1,1,3,1,1,1,1,3,1,1.5735915849388864,1.2857142857142858,0,2,-0.40524523968696646,5,4,4,3,3,3,5,6,1,3,3,1.2535663410560174,3.5,3.857142857142857,0,-0.23191923190205752,0,0.08194577934007008,1,1,2,3,2,4,4,5,5,5,4,3,2,5,4,5,3,4,4,4,1.4074631010979937,1.8,0,3.6,0,4,0,4.6,0,4.066666666666666,0,1,2,2,4,4,1,1,4,2,1,4,4,1,2,1,4,1,2,1,2,0.9403246919632545,2.2,0,I lived with my mother and father an equal amount of time (joint custody),0,"Hispanic of Latino (e.g., Mexican American, Central American, and others)",0,23,1,2,NA,1,3,5,Student,5,145,64,2,5,2,0,0,2,0,0,TRUE,TRUE,TRUE,TRUE,TRUE,6,0.45522187500074507,0.48646562499180435,0.4668656250145286,0.5004281250014901,0.5011875000037253,0.5623700000007947,1,1,1,1,1,0.967741935483871,0.078,0.33,0.614,0.018,1.962,100.45586618550878,1932.9129234747668,0.087,0.342,0.649,0.047,1.89,172.72471717639158,1957.5369987289318,0.101,0.275,0.617,0.024,1.694,79.76814848987979,1863.4705320518412,109,40.212765957446805,70.58333333333333,FALSE,364,1.0785185185185184,0,1,0,9,12,FALSE
329,2022-03-18T18:38:28Z,2022-03-18T19:55:25Z,4617,1,2022-03-18T19:55:26Z,0.8999999761581421,Chrome,99.0.4844.51,Windows NT 10.0,1366,768,no,1.7786458333333333,1868,465,1227,170,385,197,2.4470460600421435,1.9166304611770084,2.963547874880595,0.8864970911678944,6.6461352162034055,1.1060572985440211,3,3,1,1,3,1,2,4,1,3,3,1,1,1,3,3,2,1,3,4,0.512989176042577,0,1,1,3,3,2.2,0,5,5,1,5,3,1,5,3,5,3,3,5,1,4,5,1,5,1,1,1,3,1,1,3,1,5,0,3,3,3,5,5,5,5,5,5,5,5,5,4,1,4,5,1,5,5,1,1,4,4,5,1,5,2,3,1,2,2,2,1,5,5,5,4,5,4,5,2,1,1,1.5962606453985038,1.245945806357946,1.75,0,2.25,0,3.6,0,4.777777777777778,0,3.3333333333333335,0,2.8333333333333335,0,3.142857142857143,0,4.333333333333333,0,3.6486486486486487,0,2,3,0,0.7697295175395634,1.0312614860915337,2.3486158876832675,1.6899386868874005,2,1,2,1,1,1,3,3,1,1.4638501094227998,1.5714285714285714,0,2,-0.23937606567541822,1,1,1,1,1,1,1,1,2,1,1,1.5118578920369088,1.5,1,0,-1.7072506804185048,0,-2.3647166425009627,4,4,3,3,3,3,5,5,4,3,4,1,4,3,3,3,3,4,3,3,0.9856107606091623,3.4,0,3,0,3.6,0,3.6,0,3.4,0,3,1,3,4,3,3,3,3,2,2,2,3,2,2,1,3,2,2,1,2,0.6863327411532597,2.35,0,"I lived with my mother, but not father, most of the time.",0,"Hispanic of Latino (e.g., Mexican American, Central American, and others) & White, Caucasian, Anglo, European American",1,28,1,2,NA,1,2,6,sales,3,122,60,3,5,2,0,0,1,0,0,TRUE,TRUE,TRUE,TRUE,TRUE,3,0.5434187499997206,0.534078124998603,0.5716875,0.6070774193545503,0.5874344827584151,0.6196566666672627,1,1,1,0.96875,0.90625,0.967741935483871,0.078,0.4,0.468,0.019,1.591,125.76453772348232,1955.0656661049475,0.05,0.407,0.357,0.027,1.827,81.45904022122811,1984.8827795273944,0.074,0.368,0.479,0.012,1.489,120.34350965239716,1942.4562877417552,83.73684210526316,67.66666666666667,124.08333333333334,FALSE,638,1.8903703703703705,0,1,0,6,9,FALSE
330,2022-03-18T19:31:25Z,2022-03-18T19:55:58Z,1473,1,2022-03-18T19:55:59Z,1,Chrome,97.0.4692.71,Windows NT 6.2,1366,768,Thanks for doing studies like these. I use the money to feed my cats and myself and every little bit helps. Best of luck with your research!,1.7786458333333333,497,79,548,90,60,89,-0.37186672715681,-0.2147672343911765,0.4965578321130203,-0.10011617867533498,-0.018272926976413795,-0.10767073851654806,3,3,3,3,3,2,3,4,1,3,4,2,2,2,3,4,2,2,4,4,0.6708203932499369,0,0,4,3,3,2.85,0,4,4,4,5,4,1,4,3,4,4,4,5,1,4,5,4,1,1,1,2,2,2,3,5,2,0,0,0,0,3,5,5,4,4,4,5,5,5,3,4,2,4,5,2,4,3,5,2,1,3,2,1,1,1,4,3,3,4,2,2,4,4,3,4,5,2,2,3,3,2,1.2124231810593074,1.2983506020002016,2,0,2.5,0,3.7333333333333334,0,4.444444444444445,0,3.1666666666666665,0,2,0,3.142857142857143,0,3.6666666666666665,0,3.324324324324324,0,3,0,0,0.7214789095693566,1.057024848295087,0.5560365609487006,0.8065307046218938,4,4,5,2,2,4,4,3,1,1.2535663410560174,3.5714285714285716,0,2,0.9217081524054204,1,1,2,1,1,1,1,3,6,2,1,1.4960264830861913,4.5,1.1428571428571428,0,-0.9515359633553193,0,-1.8270160564655544,2,3,2,3,3,4,4,4,4,1,3,3,4,4,5,5,5,4,4,2,1.3345232785352157,2.6,0,3.8,0,3.6,0,3.8,0,3.7333333333333334,0,3,2,3,4,2,3,3,4,3,1,3,3,3,3,3,3,1,3,2,3,0.812727700887249,2.75,0,"I lived with my mother, but not father, most of the time.",0,"White, Caucasian, Anglo, European American",0,26,0,1,NA,1,1,4,Bank Teller,3,145,77,1,5,2,0,0,1,0,0,TRUE,TRUE,TRUE,TRUE,TRUE,3,0.5911499999761581,0.466515624910593,0.4776516128970731,0.6344516130262805,0.5120129032750284,0.5214580646022674,1,1,1,0.96875,0.96875,0.96875,0.062,0.351,0.544,0.027,1.879,34.21218037644641,1856.7541534604527,0.061,0.356,0.63,0.024,1.766,100.82180224336004,1927.4815779843373,0.063,0.437,0.408,0.029,1.744,89.5125825495108,1915.52100110682,69.5925925925926,73.58333333333333,60.137931034482754,FALSE,370,1.0962962962962963,0,1,0,0,3,FALSE
331,2022-03-18T19:37:13Z,2022-03-18T19:56:47Z,1174,1,2022-03-18T19:56:48Z,1,Chrome,99.0.4844.51,Windows NT 6.1,1920,1080,NA,1.7777777777777777,583,86,280,72,52,61,-0.195042146778174,-0.17611494457517315,-0.4771584145168912,-0.3221041643900616,-0.18231989665468626,-0.42234097034706597,2,2,1,1,1,1,2,2,1,2,2,1,1,1,2,2,2,1,1,2,1.105012502906165,1,1,2,4,3,1.5,0,2,2,3,2,3,2,2,3,2,1,1,2,1,2,2,2,2,4,1,1,2,2,1,0,2,0,0,0,0,1,2,1,1,1,1,1,1,1,2,1,1,1,2,1,1,2,1,1,2,2,3,1,1,1,1,1,1,1,1,1,2,1,1,1,1,1,1,2,1,1,1.7735968103392739,1.2227992865708155,1.875,0,1.25,0,2,0,1.1111111111111112,0,1.4166666666666667,0,1.3333333333333333,0,1.1428571428571428,0,1,0,1.2432432432432432,0,0,0,0,-0.7106868633645046,-0.6629254124008863,-0.5328163702636706,-0.5978708913322784,1,1,2,1,1,1,1,1,1,1.7320508075688772,1.1428571428571428,0,1,-0.874984074548163,5,5,5,5,3,3,4,7,6,3,3,1.2909944487358056,6.5,4.285714285714286,0,0.309970182831297,0,0.6442129660810442,2,2,2,2,2,4,3,4,4,4,4,4,4,2,4,4,4,4,3,3,0.8837151016885368,2,0,4,0,3.6,0,3.4,0,3.6666666666666665,0,2,2,1,1,1,1,2,2,1,1,2,1,3,2,1,1,1,2,1,2,1.0760551736979407,1.5,0,I lived with my mother and father an equal amount of time (joint custody),0,"White, Caucasian, Anglo, European American",0,27,0,1,NA,1,3,7,Accountant,3,161,68,3,5,2,0,0,1,0,0,TRUE,TRUE,TRUE,TRUE,TRUE,2,0.487090624993667,0.4400843750014901,0.48552500000596044,0.588689285710454,0.5385064516048278,0.5812566666642824,1,1,1,0.9032258064516129,0.96875,0.9375,0.069,0.345,0.522,0.015,1.937,94.45743968301606,1943.5067454770335,0.066,0.323,0.538,0.016,1.641,82.70240546004955,1912.8402892753138,0.069,0.338,0.545,0.013,1.77,71.73457522930963,1930.7785034365277,129.13333333333335,102.5625,136.15384615384616,FALSE,352,1.0429629629629629,0,1,0,9,12,FALSE
332,2022-03-18T19:36:00Z,2022-03-18T19:57:28Z,1287,1,2022-03-18T19:57:29Z,0.8999999761581421,Chrome,99.0.4844.74,Windows NT 10.0,1920,1080,"Everything went well, thank you.",1.7777777777777777,536,74,395,82,42,92,-0.29167883605487044,-0.2423760128311789,-0.059332413164503835,-0.1987775056596579,-0.38737860875252683,-0.07395607082042113,4,4,2,2,4,1,1,4,1,4,4,2,2,1,4,4,1,1,4,4,0.41039134083406165,0,1,1,2,1,2.7,0,4,4,3,4,2,2,5,3,2,3,3,5,2,5,5,4,3,1,1,3,3,3,3,1,2,0,0,0,0,4,5,5,4,4,3,4,3,5,2,5,4,2,4,2,5,2,4,4,4,3,3,1,2,1,4,3,1,2,1,2,3,1,3,3,4,3,3,2,2,4,1.0505253940784125,0.7559289460184544,2.625,0,2.75,0,3.466666666666667,0,4.111111111111111,0,3.4166666666666665,0,2.3333333333333335,0,1.8571428571428572,0,3.3333333333333335,0,3.108108108108108,0,1,0,0,0.9868572534054928,1.119073251159369,0.20346385825749233,0.6612685547084307,3,3,5,2,2,1,2,4,5,0.816496580927726,2.5714285714285716,0,4.5,1.308176663003557,2,2,2,2,1,1,3,3,3,3,2,0.6900655593423543,3,1.8571428571428572,0,-0.665444751374891,0,-1.2657475225975428,2,2,2,2,2,4,4,4,5,2,5,4,5,3,4,1,4,4,3,5,1.3522468075656264,2,0,4.2,0,3,0,4.2,0,3.8,0,2,2,4,4,4,4,4,1,4,2,4,4,2,4,2,4,2,4,3,4,1.2096106376585989,3.2,0,I lived with my mother and father an equal amount of time (joint custody),0,"White, Caucasian, Anglo, European American",0,29,0,1,NA,1,2,3,Gig worker/MTurk/Prolific/DoorDash,2,220,67,1,5,2,0,0,1,0,0,TRUE,TRUE,TRUE,TRUE,TRUE,1,0.5298312499970198,0.4612343750167638,0.5038093749992549,0.5784645161186495,0.5316714285782406,0.5789620689729165,1,1,1,0.96875,0.875,0.90625,0.058,0.37,0.438,0.007,1.066,60.79087634049731,1946.9602413306206,0.049,0.364,0.512,0.017,1.605,42.146019128522475,1902.5403969207023,0.058,0.424,0.558,0.024,1.49,77.3338484323052,1903.1807164759475,152.28571428571428,94.41176470588235,62.08333333333333,FALSE,274,0.8118518518518519,0,1,0,3,6,FALSE
334,2022-03-18T19:39:51Z,2022-03-18T19:59:18Z,1166,1,2022-03-18T19:59:19Z,0.8999999761581421,Chrome,99.0.4844.51,Windows NT 10.0,1280,720,NA,1.7777777777777777,461,44,104,20,19,52,-0.4458863189432158,-0.4080286834711933,-1.116613860064893,-0.9634027897881607,-0.8590136465775602,-0.5234849734354468,2,2,2,2,3,1,1,3,1,3,3,3,2,2,3,2,3,2,3,3,0.6407232755171874,0,1,1,2,3,2.3,0,2,1,4,3,3,1,4,1,2,3,3,3,3,3,2,4,3,1,1,1,1,1,1,1,2,0,0,0,0,2,2,1,2,2,2,2,2,1,4,3,3,1,3,2,3,3,3,3,4,4,2,5,4,5,4,3,3,2,2,2,2,2,3,1,1,1,4,2,2,3,1.1644122362187095,1.0997835284835873,1.625,0,2.75,0,2.533333333333333,0,1.7777777777777777,0,3,0,3.8333333333333335,0,2.2857142857142856,0,1,0,2.5405405405405403,0,1,0,0,-0.030791932875229078,0.027178694257642806,0.20346385825749233,0.11532127625756756,2,2,3,2,2,5,4,1,1,1.2149857925879117,2.857142857142857,0,1,0.12023096952112716,3,2,3,3,2,3,3,5,2,2,2,0.4879500364742666,3.5,2.7142857142857144,0,-0.788955151249163,0,-0.8765603607594444,5,4,4,3,2,1,3,4,4,2,4,4,3,2,2,4,2,3,3,1,1.082325538564332,3.6,0,2.8,0,3,0,2.6,0,2.8,0,3,1,1,4,1,1,1,2,1,1,1,3,2,1,1,4,1,1,1,3,0.7539370349250519,1.7,0,"I lived with my extended family on mother's side (grandparents, aunts ,uncles, cousins)",0,"Asian or Asian American (e.g., Chinese, Japanese, and others)",0,24,1,2,NA,1,4,8,auditor,5,113,65,1,5,2,0,0,0,0,0,TRUE,TRUE,TRUE,TRUE,TRUE,2,0.5685806451574449,0.5160344827586207,0.527949999999255,0.6344370370418937,0.569280645166674,0.6208799999976158,0.96875,0.9666666666666667,1,0.8709677419354839,0.96875,0.8064516129032258,0.062,0.391,0.469,0.015,2.051,64.24121989052614,1923.5834288822546,0.05,0.409,0.417,0.024,1.495,177.9399595816108,2056.7826372179366,0.055,0.444,0.502,0.019,2.001,143.98168800788264,2048.441097606319,136.73333333333335,62.29166666666667,105.3157894736842,FALSE,291,0.8622222222222223,0,1,0,0,3,FALSE
336,2022-03-18T19:11:05Z,2022-03-18T20:00:15Z,2950,1,2022-03-18T20:00:16Z,0.8999999761581421,Firefox,98.0,Windows NT 10.0,1366,768,NA,1.7786458333333333,1875,92,493,224,87,92,2.461438758445056,-0.14298441044717028,0.2967280053792698,1.5524610483120742,0.5353855956877558,-0.07395607082042113,3,4,4,4,4,3,4,4,3,4,4,2,2,3,4,4,4,2,4,4,1.2096106376585989,1,1,3,3,2,3.5,0,4,3,3,3,4,3,4,3,2,2,4,3,2,3,3,2,3,1,1,1,3,2,3,3,1,2,0,0,0,3,3,4,4,3,3,3,3,3,2,3,4,2,3,2,3,3,4,4,5,5,3,1,1,1,3,2,1,3,3,3,4,4,4,1,1,2,1,1,2,2,1.0766425401028696,0.6761234037828132,2,0,1.5,0,3.066666666666667,0,3.2222222222222223,0,3.3333333333333335,0,1.8333333333333333,0,3.142857142857143,0,1.3333333333333333,0,2.864864864864865,0,2,0,0,0.4232024239353518,0.5653576306700305,-0.007937859210751935,0.2787098857296393,1,2,2,2,2,3,1,1,3,1.3801311186847085,1.8571428571428572,0,2,-0.07350689166386981,5,5,5,5,5,5,5,6,8,6,4,1.5118578920369088,7,5,0,1.384971609293624,0,1.6859984401799282,4,4,3,3,2,3,5,1,4,3,4,3,3,5,2,5,5,4,5,5,1.505545305418162,3.2,0,3.8,0,4.2,0,3.4,0,3.8,0,3,2,4,4,4,4,4,4,4,4,3,4,2,2,3,3,3,4,4,4,1.145931016569864,3.45,0,"I lived with my mother and father an equal amount of time (joint custody) & I lived with my extended family on mother's side (grandparents, aunts ,uncles, cousins)",1,"White, Caucasian, Anglo, European American",0,22,1,2,NA,1,3,4,student,5,354,62,1,5,2,0,0,1,0,0,TRUE,TRUE,TRUE,TRUE,TRUE,1,0.6311612903225806,0.5335333333333333,0.5419375,0.7514666666666666,0.598375,0.6263461538461539,0.96875,0.967741935483871,1,0.9375,1,0.8125,0.054,0.412,0.436,0.013,1.9,73.12055611908583,1934.7593529872522,0.16,0.304,0.718,0.013,1.193,219.0156811995977,2045.4558671510954,0.071,0.42,0.328,0.013,1.754,116.2402932929873,2024.3122094708606,146.15384615384616,91.76923076923077,134.92307692307693,FALSE,357,1.0577777777777777,0,1,0,0,3,FALSE
337,2022-03-18T19:36:01Z,2022-03-18T20:01:11Z,1509,1,2022-03-18T20:01:11Z,0.8999999761581421,Chrome,95.0.4638.69,Macintosh,1440,900,N/A,1.6,596,119,443,95,60,74,-0.16831284974419414,0.006102993128842652,0.11506452653040569,-0.03845284931013314,-0.018272926976413795,-0.2762440769971827,2,2,2,2,2,2,1,3,1,3,3,3,2,3,3,2,2,1,2,3,0.6958523739384593,0,1,2,3,3,2.2,0,3,2,3,3,4,3,3,3,3,2,2,3,2,3,4,3,3,5,2,2,3,3,2,1,1,1,0,1,0,3,4,2,3,3,2,1,1,2,2,3,2,3,3,3,2,4,4,3,3,3,4,4,5,3,3,4,2,2,3,1,2,2,2,2,2,2,2,2,1,2,0.9984973695493629,0.6399404734221844,2.875,0,1.75,0,2.8666666666666667,0,2.3333333333333335,0,2.9166666666666665,0,3.8333333333333335,0,2,0,2,0,2.675675675675676,0,1,0,0,0.8684239429331674,0.7774628683534798,-0.14114775846592847,0.3181575549437756,1,2,3,1,2,2,1,2,1,1.3801311186847085,1.7142857142857142,0,1.5,-0.3498436025973552,5,4,5,4,1,1,3,7,3,2,2,1.7043362064926932,5,3.2857142857142856,0,-0.5180104438824858,0,-0.40192007928726475,3,2,3,3,3,3,4,3,4,4,4,4,3,3,4,4,3,4,4,3,0.7988086367179802,2.8,0,3.6,0,3.8,0,3.4,0,3.6,0,2,3,2,3,2,2,3,2,1,2,2,2,2,3,3,2,1,3,2,3,0.6708203932499369,2.25,0,"I lived with my mother, but not father, most of the time.",0,"White, Caucasian, Anglo, European American",0,23,0,1,NA,1,2,6,Educational Services,2,145,66,3,5,2,0,0,2,0,0,TRUE,TRUE,TRUE,TRUE,TRUE,2,0.4893437500447035,0.4201656249910593,0.4321749999821186,0.5868000000098655,0.5304275862430704,0.5443249999455043,1,1,1,0.90625,0.90625,0.875,0.066,0.348,0.836,0.017,1.993,34.186813777419175,1901.8238318507647,0.079,0.32,0.872,0.012,1.722,25.48054343592986,1881.1565022580294,0.061,0.351,0.489,0.015,1.866,76.49560359687548,1936.1889561446185,117.23529411764706,143.5,124.4,FALSE,438,1.2977777777777777,0,1,0,0,3,FALSE
338,2022-03-18T19:42:09Z,2022-03-18T20:01:50Z,1180,1,2022-03-18T20:01:52Z,0.8999999761581421,Chrome,99.0.4844.74,Windows NT 10.0,1920,1080,"I slept less than usual, but did not have trouble falling or staying asleep.",1.7777777777777777,442,67,378,83,55,59,-0.4849522146082633,-0.28102830264718226,-0.12109799597311763,-0.18644483978661755,-0.12080228302533408,-0.4448174154778173,3,3,2,2,4,2,1,4,1,3,4,1,1,1,3,3,1,1,3,3,0.512989176042577,0,1,1,1,1,2.3,0,1,1,4,2,5,2,2,2,2,3,1,3,2,3,2,2,4,1,1,2,3,3,2,1,1,1,0,0,0,1,1,1,1,3,1,2,2,2,3,1,1,1,3,1,2,4,3,4,4,4,3,1,1,1,2,1,1,2,1,1,3,3,2,1,5,3,1,3,3,2,1.5161790127814059,1.2798809468443688,2.25,0,2.25,0,2.3333333333333335,0,1.5555555555555556,0,2.5833333333333335,0,1.5,0,1.8571428571428572,0,3,0,2.054054054054054,0,1,0,0,0.05912965470561092,3.336641753150592e-4,0.031158049895781924,0.015745857035548493,2,2,5,1,1,2,2,1,1,1.0690449676496976,2.142857142857143,0,1,-0.29444196550774376,4,4,4,2,1,1,5,5,5,2,2,1.5118578920369088,5,3,0,-0.5180104438824858,0,-0.5567254297686189,2,2,1,2,2,5,5,4,5,3,5,4,3,4,5,3,5,5,3,1,1.5796322658258457,1.8,0,4.8,0,3.4,0,3.8,0,4,0,1,1,1,1,1,1,1,1,1,1,1,2,3,1,1,1,1,1,1,1,1.1821033884786185,1.15,0,I lived with my mother and father an equal amount of time (joint custody),0,"Asian or Asian American (e.g., Chinese, Japanese, and others)",0,27,0,1,NA,1,2,4,Unemployed student,2,153,72,2,5,2,0,0,1,0,0,TRUE,TRUE,TRUE,TRUE,TRUE,2,0.44789375000074505,0.37739375000819564,0.4230937500074506,0.539696428575686,0.47291481482982634,0.4963033333222071,1,1,1,0.875,0.8709677419354839,0.9375,0.05,0.349,0.653,0.023,1.819,90.7778034256135,1941.1630539300538,0.054,0.307,0.739,0.025,2.097,70.90868277410937,1935.4108745271944,0.054,0.342,0.569,0.015,1.715,57.975429153119684,1921.7797986839325,79.08695652173913,83.88,114.33333333333334,FALSE,428,1.268148148148148,0,1,0,0,3,FALSE
339,2022-03-18T19:48:31Z,2022-03-18T20:03:35Z,904,1,2022-03-18T20:03:36Z,1,Chrome,98.0.4758.109,Macintosh,1440,900,Thank you for the opportunity!,1.6,537,61,149,23,23,62,-0.2896227362830258,-0.31415883677518514,-0.9531167291009152,-0.9264047921690396,-0.776990161738424,-0.41110274778169037,2,2,3,3,2,3,4,2,3,2,2,3,3,4,2,2,3,2,2,2,0.3940344628262062,0,1,1,4,4,2.55,0,2,3,4,3,2,1,4,2,2,2,2,3,2,2,3,2,1,1,1,1,2,1,1,4,2,0,0,0,0,2,3,4,2,3,3,4,3,4,3,4,2,2,4,2,3,2,2,3,2,2,2,2,3,2,3,3,2,2,3,1,2,3,2,2,2,2,2,2,2,2,0.7311186870368822,0.9102589898327995,1.25,0,2,0,2.466666666666667,0,3.111111111111111,0,2.5833333333333335,0,2.5,0,2.142857142857143,0,2,0,2.5675675675675675,0,2,0,0,-0.2566925065539237,-0.1538531752719025,0.16436794915095845,0.005257386939527972,3,2,4,3,3,3,3,1,2,0.4879500364742666,3,0,1.5,0.39656768045461255,4,4,4,4,3,2,3,6,3,2,2,0.7867957924694432,4.5,3.4285714285714284,0,-0.6083253463380449,0,-0.37952726421641136,3,2,3,2,3,4,3,4,3,2,4,3,4,3,2,4,3,4,3,3,0.5163977794943222,2.6,0,3.6,0,3.2,0,3,0,3.2666666666666666,0,3,2,2,2,2,1,2,2,3,2,2,2,3,2,2,2,2,2,3,2,0.5871429486123998,2.15,0,Prefer not to say.,0,"Asian or Asian American (e.g., Chinese, Japanese, and others)",0,20,1,2,NA,1,3,4,"Student, part-time teacher",2,131,62,3,5,2,0,0,1,0,0,TRUE,TRUE,TRUE,TRUE,TRUE,6,0.6608374999947846,0.5040250000022352,0.5850562500096858,0.6959843749813736,0.5493499999977648,0.5958999999992309,1,1,1,1,1,1,0.138,0.312,0.514,0.044,0.875,54.28713552204971,1837.5765244062673,0.197,0.25,0.781,0.033,1.654,37.46210597341251,1820.0372650635577,0.215,0.217,0.514,0.012,1.186,51.70263402570076,1835.3975054515006,19.886363636363637,50.12121212121212,98.83333333333333,FALSE,430,1.2740740740740741,0,1,0,0,3,FALSE
341,2022-03-18T19:37:03Z,2022-03-18T20:08:57Z,1913,1,2022-03-18T20:08:59Z,0.8999999761581421,Chrome,99.0.4844.51,Macintosh,1440,900,NA,1.6,703,110,637,109,57,219,0.05168982584317862,-0.04359280806316166,0.8199188244639983,0.134204472912432,-0.07979054060576597,1.353298194982285,2,3,2,3,3,1,1,3,3,3,4,2,1,3,3,3,1,1,2,3,0.7591546545162482,0,0,2,1,1,2.35,0,4,3,2,4,1,1,3,3,3,2,4,4,1,4,5,5,2,3,1,5,4,5,4,12,1,1,0,1,1,4,3,3,2,4,4,3,3,4,3,5,2,5,4,3,3,5,5,4,2,3,4,2,5,1,4,1,3,5,5,1,3,3,3,5,5,4,1,3,5,3,1.2991103446927392,0.9154754164341269,3.625,0,3,0,2.933333333333333,0,3.3333333333333335,0,3.6666666666666665,0,2.8333333333333335,0,3.2857142857142856,0,4.666666666666667,0,3.4594594594594597,0,6,1,0,1.8641410346819776,1.4762203180422102,2.085795791068991,1.7810080545556004,3,1,4,1,1,2,1,3,1,0.7867957924694432,1.8571428571428572,0,2,-0.07350689166386981,2,2,2,1,2,3,1,4,3,2,1,1.2724180205607036,3.5,1.8571428571428572,0,-1.1321657682664374,0,-1.5500224006018164,2,3,3,5,3,4,4,4,5,4,3,3,4,5,4,2,3,4,5,2,1.2071217242444348,3.2,0,3.4,0,3.8,0,4,0,3.7333333333333334,0,2,3,2,3,3,3,3,3,1,3,4,3,3,2,1,2,3,3,2,3,0.7608859102526822,2.6,0,"I lived with my mother, but not father, most of the time. & I lived with my extended family on mother's side (grandparents, aunts ,uncles, cousins) & I lived with my extended family on father's side (grandparents, aunts ,uncles, cousins)",1,"White, Caucasian, Anglo, European American",0,22,1,2,NA,1,2,4,Sales Associate,2,102,64,3,5,2,0,0,0,0,0,TRUE,TRUE,TRUE,TRUE,TRUE,5,0.5303903225814143,0.4594437499968335,0.47393437499925495,0.5768125000004657,0.533403448275451,0.5438483870981201,0.96875,1,1,1,0.90625,0.96875,0.06,0.364,0.564,0.018,1.575,38.85459017631302,1865.3397406701556,0.053,0.372,0.58,0.018,1.623,35.65591041619875,1889.7080756597845,0.115,0.32,0.569,0.026,1.687,212.5492693036692,2043.6575923397615,87.5,90.16666666666667,64.88461538461539,FALSE,436,1.2918518518518518,0,1,0,0,3,FALSE
342,2022-03-18T19:44:48Z,2022-03-18T20:15:01Z,1812,1,2022-03-18T20:15:03Z,0.8999999761581421,Chrome,99.0.4844.74,Windows NT 10.0,1366,768,NA,1.7786458333333333,1031,95,331,79,54,112,0.7260905510082091,-0.12641914338316884,-0.29186166609104985,-0.23577550327877903,-0.14130815423511814,0.15080838048709166,2,3,1,1,3,1,1,3,1,2,3,1,1,2,2,2,1,1,3,3,0.7863975156570492,0,1,3,4,3,1.85,0,5,4,4,4,4,5,5,5,5,4,5,4,2,5,5,5,5,5,3,4,5,5,5,4,2,0,0,0,0,5,5,5,5,5,5,5,5,5,3,2,2,3,4,4,5,5,5,4,4,4,4,2,5,5,5,5,4,4,4,4,4,5,5,4,5,3,2,3,2,2,1.5877723454642423,1.6676187756655838,4.625,0,2.25,0,4.4,0,5,0,3.75,0,4.333333333333333,0,4.285714285714286,0,4,0,4.27027027027027,0,2,0,0,3.0397013015924665,2.907168588218175,0.2505208533318137,1.5788447207749943,5,5,5,5,3,4,4,8,1,1.7043362064926932,4.428571428571429,0,4.5,2.3863262940786214,1,1,2,1,1,1,1,3,1,2,1,1.4960264830861913,2,1.1428571428571428,0,-1.4031104756331148,0,-2.1020653573146735,2,2,2,1,2,3,5,5,4,4,5,4,5,5,5,5,4,4,5,5,1.709915063331955,1.8,0,4,0,4.8,0,4.8,0,4.533333333333333,0,2,2,3,4,2,3,4,3,2,1,2,3,1,2,1,3,1,2,3,4,0.9119095061289915,2.4,0,"I lived with my father, but not mother, most of the time. & I lived with my mother and father an equal amount of time (joint custody)",1,"White, Caucasian, Anglo, European American",0,20,1,2,NA,1,1,3,Google Rater,1,210,62,1,5,2,0,0,0,0,0,TRUE,TRUE,TRUE,TRUE,TRUE,2,0.4965437499843538,0.4154937499910593,0.4599562500119209,0.5865379310476369,0.4811172413784882,0.532752000002861,1,1,1,0.90625,0.90625,0.78125,0.053,0.344,0.5,0.016,1.845,116.44936769605627,2016.9549147219434,0.052,0.324,0.601,0.013,1.284,80.81429549046689,1974.9423350875197,0.059,0.361,0.443,0.016,1.657,114.30775812821327,1970.5279222922425,115.3125,98.76923076923077,103.5625,FALSE,390,1.1555555555555557,0,1,0,0,3,FALSE
343,2022-03-18T19:53:00Z,2022-03-18T20:16:17Z,1397,1,2022-03-18T20:16:17Z,0.8999999761581421,Chrome,99.0.4844.74,Windows NT 10.0,1366,768,NA,1.7786458333333333,520,136,372,93,60,101,-0.3245764324043841,0.0999728398248508,-0.1428976134349813,-0.06311818105621388,-0.018272926976413795,0.027187932267959625,1,1,1,1,1,1,2,1,1,1,2,1,1,1,2,1,1,1,2,2,1.348488432516786,0,1,1,5,5,1.25,0,2,1,2,1,2,1,2,2,2,1,2,2,2,2,3,1,1,1,1,1,3,1,2,1,2,0,0,0,0,3,1,1,1,1,1,1,1,1,1,1,2,1,1,2,1,1,2,3,2,2,1,1,1,1,1,1,1,2,1,1,1,1,2,1,1,1,2,1,1,1,1.7929625525132182,1.3557637102737474,1.375,0,1.25,0,1.8,0,1.2222222222222223,0,1.5833333333333333,0,1,0,1.2857142857142858,0,1,0,1.2972972972972974,0,1,0,0,-1.000190511185744,-0.9449457284306189,-0.31345356682763886,-0.6291996476291288,2,2,2,1,1,2,1,1,1,1.3451854182690985,1.5714285714285714,0,1,-0.6261803135308405,5,5,5,5,2,2,5,6,6,2,2,1.8126539343499315,6,4.142857142857143,0,-0.33738063897136766,0,0.1725156924964459,2,2,2,2,2,4,4,3,4,3,5,4,4,3,3,2,4,4,3,3,0.9154754164341269,2,0,4.2,0,3.2,0,3.2,0,3.533333333333333,0,1,1,1,1,3,1,1,2,1,1,1,1,1,1,1,1,1,1,1,1,1.1821033884786185,1.15,0,NA,NA,"White, Caucasian, Anglo, European American",0,26,0,1,NA,1,2,5,Data analyst,3,130,69,3,5,2,0,0,1,0,0,TRUE,TRUE,TRUE,TRUE,TRUE,4,0.5031156249940395,0.46040312499925495,0.4783999999910593,0.5655843749977648,0.5210937499962747,0.579735483873275,1,1,1,1,1,0.96875,0.088,0.313,0.589,0.017,1.987,105.52164363396645,1933.2546152630966,0.105,0.265,0.537,0.016,1.319,41.621918800441826,1825.7791369884928,0.093,0.355,0.657,0.012,1.173,25.849454883000544,1808.7958268706675,116.88235294117646,82.4375,97.75,FALSE,279,0.8266666666666667,0,1,0,3,6,FALSE
344,2022-03-18T19:36:35Z,2022-03-18T20:20:00Z,2604,1,2022-03-18T20:20:01Z,0.8999999761581421,Chrome,99.0.4844.51,Windows NT 10.0,1272,716,NA,1.776536312849162,1396,133,395,96,43,85,1.4765669677314899,0.08340757276084937,-0.059332413164503835,-0.026120183437092773,-0.36687273754274274,-0.1526236287780506,2,2,2,1,2,1,2,2,1,2,4,2,2,2,3,2,1,1,3,3,0.7947194142390263,0,1,1,3,2,2,0,5,3,5,4,5,5,3,5,5,3,5,4,1,4,5,3,5,1,1,3,5,5,4,5,2,0,0,0,0,2,4,3,4,5,3,3,2,5,2,2,2,2,3,2,4,5,4,5,3,5,5,1,1,1,3,1,1,5,3,1,3,5,3,2,4,3,3,3,3,2,1.3512312258920847,1.65615734242165,3.375,0,2.75,0,4.133333333333334,0,3.4444444444444446,0,3.25,0,2,0,3,0,3,0,3.027027027027027,0,3,0,0,1.4211127251373528,1.7021905712626866,0.6421894651295558,1.1721900181961211,2,1,3,1,1,2,1,1,3,1.2149857925879117,1.5714285714285714,0,2,-0.23937606567541822,3,3,4,4,1,1,1,3,5,4,3,1.5275252316519468,4,2.4285714285714284,0,0.072220972883332707,0,-0.506832363121089,2,2,2,4,2,3,5,1,5,1,5,5,3,4,5,5,4,4,5,3,1.65615734242165,2.4,0,4.2,0,3.8,0,3.6,0,3.8666666666666667,0,1,2,3,4,2,4,2,2,3,1,3,2,2,3,2,2,3,3,3,2,0.8255779474818965,2.45,0,I lived with my mother and father an equal amount of time (joint custody),0,"Hispanic of Latino (e.g., Mexican American, Central American, and others) & White, Caucasian, Anglo, European American",1,26,1,2,NA,1,2,5,Data Entry Specialist,2,220,65,1,5,2,0,0,1,0,0,TRUE,TRUE,TRUE,TRUE,TRUE,1,0.48573870968241845,0.47464062499254944,0.5585374999959022,0.5292516128997649,0.537146874986589,0.6001312500033528,1,1,1,1,1,1,0.169,0.262,0.574,0.032,1.647,45.33192381345083,1827.2353581192797,0.116,0.285,0.63,0.03,2.064,47.44621287356618,1834.9221542793412,0.078,0.342,0.573,0.011,1.144,82.95231275501976,1866.9849526943506,51.46875,68.80000000000001,104,FALSE,310,0.9185185185185185,0,1,0,0,3,FALSE
346,2022-03-18T20:03:16Z,2022-03-18T20:22:20Z,1144,1,2022-03-18T20:22:21Z,0.8999999761581421,Chrome,99.0.4844.74,Windows NT 10.0,1280,720,NA,1.7777777777777777,545,54,297,65,36,85,-0.273173938108269,-0.3528111265911885,-0.41539283170827745,-0.4084328255013442,-0.5104138360112311,-0.1526236287780506,2,2,1,1,2,1,1,2,1,2,2,1,1,1,2,2,1,1,2,2,1.025978352085154,0,0,3,3,3,1.5,0,1,1,2,2,2,1,1,2,2,1,1,1,1,1,1,1,1,2,1,1,1,1,1,0,2,0,0,0,0,1,1,2,1,3,1,1,1,1,1,1,1,1,2,1,1,2,1,1,1,1,4,1,1,2,2,1,1,1,1,1,1,1,1,1,1,1,1,1,1,1,1.7710552325200466,1.791514389985135,1.125,0,1,0,1.3333333333333333,0,1.3333333333333333,0,1.1666666666666667,0,1.8333333333333333,0,1,0,1,0,1.2702702702702702,0,0,0,0,-1.1800336863474237,-1.2696427589502066,-0.6189692744445258,-0.9443060166973662,1,1,2,1,1,1,1,1,1,1.7320508075688772,1.1428571428571428,0,1,-0.874984074548163,5,5,5,5,3,3,4,6,6,3,3,1.2909944487358056,6,4.285714285714286,0,0.2196552803757379,0,0.5892031059112204,2,2,3,3,3,4,3,3,4,4,4,3,4,3,4,4,4,3,3,3,0.7432233529572065,2.6,0,3.6,0,3.6,0,3.4,0,3.533333333333333,0,1,1,1,1,1,1,1,1,1,1,1,1,1,1,1,1,1,1,1,1,1.231174022502185,1,0,"I lived with my mother, but not father, most of the time.",0,"White, Caucasian, Anglo, European American",0,28,0,1,NA,1,3,4,operations manager,2,250,75,3,5,2,0,0,1,0,0,TRUE,TRUE,TRUE,TRUE,TRUE,1,0.5057937499918044,0.4855156250055879,0.48301249999739226,0.5909531249981373,0.5781225806436231,0.5972062499988824,1,1,1,1,1,1,0.08,0.367,0.669,0.006,1.073,47.408165730435535,1830.0354252045101,0.16,0.313,0.908,0.016,1.547,122.84030897861513,1912.5877289916662,0.154,0.314,0.848,0.009,1.228,84.07244424098589,1866.5283056803355,178.83333333333331,96.6875,136.44444444444446,FALSE,295,0.874074074074074,0,1,1,3,6,FALSE
347,2022-03-18T20:03:55Z,2022-03-18T20:26:27Z,1352,1,2022-03-18T20:26:28Z,0.8999999761581421,Chrome,99.0.4844.74,Windows NT 10.0,2560,1440,NA,1.7777777777777777,583,76,398,96,59,79,-0.195042146778174,-0.23133250145517795,-0.04843260443357199,-0.026120183437092773,-0.03877879818619785,-0.22005296417030445,1,2,1,1,2,1,1,3,1,2,2,1,1,2,2,3,2,1,2,2,0.998683343734455,0,0,2,4,4,1.65,0,2,2,1,2,1,2,1,2,1,1,1,2,2,1,3,1,2,1,1,1,1,3,1,1,2,0,0,0,0,1,2,3,2,2,1,2,1,3,1,1,4,1,3,1,1,3,2,2,3,3,2,1,1,1,3,1,1,2,2,2,3,3,2,1,2,1,2,1,2,2,1.3917388177876397,1.5430334996209192,1.375,0,1.75,0,1.6,0,1.8888888888888888,0,2.0833333333333335,0,1.5,0,2.142857142857143,0,1.3333333333333333,0,1.8918918918918919,0,1,0,0,-0.614185647424091,-0.772665535374799,-0.14114775846592847,-0.45690664692036376,3,3,4,3,2,2,1,1,1,0.7559289460184544,2.5714285714285716,0,1,-0.04563820449042111,4,3,4,3,1,1,1,3,3,4,2,1.5275252316519468,3,2.4285714285714284,0,-0.45161944904505985,0,-0.8258980718590456,3,2,2,2,2,2,5,4,4,4,5,4,3,4,4,4,2,4,3,2,1.162919151265879,2.2,0,3.4,0,3.8,0,3.6,0,3.6,0,1,2,1,2,2,2,2,2,2,2,1,2,1,2,1,2,1,2,2,2,0.7181848464596079,1.7,0,I lived with my mother and father an equal amount of time (joint custody),0,"White, Caucasian, Anglo, European American",0,27,1,2,NA,1,2,3,artist,2,124,66,2,5,2,0,0,1,0,0,TRUE,TRUE,TRUE,TRUE,TRUE,4,0.4936218749769032,0.4602468750104308,0.45231874998286364,0.5834857142737934,0.5532032258202952,0.5862481481278384,1,1,1,0.9032258064516129,0.96875,0.84375,0.06,0.333,0.543,0.006,1.329,74.11092436038642,1933.9131353522287,0.079,0.303,0.498,0.015,1.688,76.73860646260125,1907.0653226135635,0.068,0.331,0.462,0.009,1.459,115.22282696305312,1972.7503693507738,221.5,112.53333333333333,162.11111111111114,FALSE,368,1.0903703703703704,0,1,0,6,9,FALSE
348,2022-03-18T20:08:57Z,2022-03-18T20:29:29Z,1232,1,2022-03-18T20:29:30Z,0.8999999761581421,Chrome,99.0.4844.74,Windows NT 10.0,1536,864,no,1.7777777777777777,509,80,353,102,55,84,-0.3471935298946748,-0.20924547870317603,-0.21192973539754967,0.04787581180114943,-0.12080228302533408,-0.16386185134342626,1,1,2,1,1,1,1,2,1,1,1,1,1,1,1,1,1,1,1,1,1.4689774459950382,0,1,2,3,4,1.1,0,1,1,1,1,1,1,1,1,1,1,1,1,1,1,1,1,2,1,1,1,1,1,1,1,2,0,0,0,0,1,2,2,2,2,1,2,1,2,1,1,1,1,1,1,1,1,1,1,1,1,1,1,1,1,3,1,1,2,2,1,2,1,1,1,1,1,2,1,2,1,1.7084843923544981,2.065591117977289,1.125,0,1.5,0,1,0,1.6666666666666667,0,1,0,1.3333333333333333,0,1.4285714285714286,0,1,0,1.2972972972972974,0,1,0,0,-1.1624880107218938,-1.4033762421442217,-0.22730066264678367,-0.8153384523955027,1,1,1,1,1,1,1,1,1,1.9518001458970664,1,0,1,-0.9579186615539372,5,5,5,5,3,3,5,6,6,6,3,1.5735915849388864,6,4.428571428571429,0,0.8611311873652313,0,1.0573220304792632,3,4,4,2,3,4,4,3,4,3,4,3,4,3,2,4,4,4,1,1,1.0465362369445672,3.2,0,3.8,0,3.2,0,2.6,0,3.2,0,1,1,1,1,1,1,1,1,1,1,2,2,1,2,1,1,1,1,1,1,1.1367080817685316,1.15,0,I lived with my mother and father an equal amount of time (joint custody),0,"White, Caucasian, Anglo, European American",0,22,0,1,NA,1,4,5,student,1,200,70,2,5,2,0,0,1,0,0,TRUE,TRUE,TRUE,TRUE,TRUE,4,0.559406249997206,0.4603875000011176,0.48421562499925497,0.6163593750009313,0.532079999996225,0.5651258064518052,1,1,1,1,0.967741935483871,0.96875,0.067,0.361,0.582,0.013,1.494,55.652169634686516,1884.9628124320225,0.049,0.369,0.511,0.007,1.049,140.42767464590872,1967.0341432226553,0.147,0.332,0.668,0.022,1.593,48.16654678697904,1831.6113231073543,114.92307692307693,149.85714285714283,72.4090909090909,FALSE,386,1.1437037037037037,0,1,1,0,3,FALSE
349,2022-03-18T19:51:04Z,2022-03-18T20:31:47Z,2442,1,2022-03-18T20:31:49Z,0.800000011920929,Chrome,99.0.4844.74,Windows NT 10.0,1360,768,Thank you.,1.7708333333333333,623,175,818,148,81,462,-0.11279815590438978,0.3153213116568695,1.4775406178968864,0.6151784419610064,0.41235036842905143,4.084186278368565,1,1,1,1,2,1,1,2,1,1,1,2,1,1,1,1,1,1,1,1,1.4317821063276353,0,1,2,5,4,1.15,0,4,4,4,4,4,3,3,3,3,3,4,4,3,3,3,1,2,3,2,2,3,3,3,0,1,0,0,1,1,3,2,4,1,2,2,2,1,2,2,3,1,1,3,3,1,2,3,3,3,4,2,3,1,2,3,1,2,2,2,1,3,3,3,3,3,3,1,2,2,2,1.1250625608230707,0.7037315505489968,2.375,0,1.75,0,3.466666666666667,0,2.111111111111111,0,2.4166666666666665,0,2,0,2.2857142857142856,0,3,0,2.2972972972972974,0,0,1,0,0.2981894851034528,0.6559227321565655,0.33885444954852423,0.49738859085254483,3,3,4,3,3,3,3,4,5,0.3779644730092272,3.142857142857143,0,4.5,1.6399150110266534,3,4,5,3,1,1,1,5,6,2,2,1.6761634196950514,5.5,2.5714285714285716,0,-0.42769554142692673,0,-0.7339235953208264,3,2,2,3,2,4,4,4,4,3,5,5,5,4,4,3,5,4,4,1,1.4074631010979937,2.4,0,4.6,0,3.8,0,3.4,0,3.933333333333333,0,2,1,1,2,2,2,3,2,2,3,1,2,2,1,1,1,1,1,2,3,0.9445132413883326,1.75,0,"I lived with my mother, but not father, most of the time.",0,"White, Caucasian, Anglo, European American",0,22,0,1,NA,1,2,3,Music Producer,3,124,65,2,5,2,1,0,1,0,1,TRUE,TRUE,TRUE,TRUE,TRUE,1,0.6166812500001397,0.4906483870969424,0.5690562499997904,0.6828249999996042,0.5493656250000931,0.5847875000002095,1,1,1,1,1,1,0.164,0.332,0.7,0.097,1.545,104.22704544789659,1887.6895725788834,0.141,0.295,0.735,0.03,1.82,9.953244361278006,1789.852156497258,0.114,0.325,0.394,0.037,1.955,20.371976415095137,1802.3264652561268,15.92783505154639,60.66666666666667,52.837837837837846,FALSE,138,0.40888888888888886,0,1,0,0,3,FALSE
350,2022-03-18T20:10:51Z,2022-03-18T20:32:50Z,1318,1,2022-03-18T20:32:51Z,0.8999999761581421,Chrome,99.0.4844.51,Macintosh,1440,900,no,1.6,695,89,324,68,24,57,0.03524102766842178,-0.15954967751117172,-0.31729455312989086,-0.37143482788222304,-0.7564842905286399,-0.46729386060856853,3,4,1,1,3,2,4,4,1,3,4,1,1,1,3,4,3,1,3,3,0.8207826816681233,0,1,1,3,1,2.5,0,5,3,4,4,4,4,4,4,5,3,4,5,4,5,5,4,5,5,2,4,5,5,5,6,1,1,0,0,0,2,3,3,4,4,3,4,4,5,3,2,4,4,5,3,4,5,5,5,5,5,5,3,5,4,5,5,2,5,1,1,2,2,1,3,5,3,1,2,3,1,1.4498627873361334,1.4074631010979937,4.375,0,1.75,0,4.2,0,3.5555555555555554,0,4.166666666666667,0,4.5,0,2,0,3.6666666666666665,0,3.6216216216216215,0,3,0,0,2.456307587043604,2.42749805070317,0.297577848406135,1.3625379495546526,3,3,5,3,3,4,3,3,1,0.8997354108424374,3.4285714285714284,0,2,0.838773565399646,1,2,3,3,1,1,1,3,2,1,1,1.4960264830861913,2.5,1.7142857142857142,0,-1.5266208755073867,0,-1.8676835459579295,3,3,3,4,3,3,5,4,4,3,5,3,4,3,3,4,4,5,4,4,1.1126972805283737,3.2,0,4,0,4,0,3.6,0,3.8666666666666667,0,3,2,4,4,4,4,4,4,4,4,4,4,4,4,4,4,4,4,4,4,1.2513150976809202,3.85,0,"I lived with my mother, but not father, most of the time. & I lived with my mother and father an equal amount of time (joint custody)",1,"Hispanic of Latino (e.g., Mexican American, Central American, and others) & White, Caucasian, Anglo, European American",1,26,1,3,NA,1,2,6,filmmaker,1,163,65,1,5,2,0,0,0,0,0,TRUE,TRUE,TRUE,TRUE,TRUE,6,0.46820000004023316,0.40844999998807907,0.4508935483963259,0.5725444444727015,0.5082724137881707,0.5439000000158946,1,1,0.96875,0.8709677419354839,0.90625,0.84375,0.051,0.327,0.376,0.008,1.322,148.04612899156197,2105.7490711575324,0.057,0.317,0.608,0.008,1.271,91.48938566068217,1978.9970406415134,0.066,0.334,0.521,0.013,1.845,47.48013428036351,1912.7601115787759,165.25,158.87499999999997,141.92307692307693,FALSE,430,1.2740740740740741,0,1,0,3,6,FALSE
351,2022-03-18T20:08:26Z,2022-03-18T20:32:58Z,1472,1,2022-03-18T20:33:00Z,0.8999999761581421,Chrome,99.0.4844.74,Macintosh,1440,900,I got a splitting headache halfway through the game.,1.6,534,97,399,88,66,73,-0.2957910355985596,-0.1153756320071679,-0.04479933485659471,-0.12478151042141572,0.10476230028229055,-0.2874822995625583,3,2,3,2,3,1,2,3,1,2,4,2,2,2,2,3,2,1,3,3,0.6488856845230502,0,1,1,5,5,2.3,0,2,3,3,1,2,2,4,2,2,3,3,2,2,2,1,2,3,1,1,2,3,2,2,0,2,0,0,0,0,1,2,1,2,1,1,4,3,2,2,2,2,1,2,2,1,4,2,4,3,3,2,1,1,1,4,1,2,1,1,1,4,5,5,1,3,1,2,1,1,1,1.5235883044055312,1.0997835284835873,2,0,1.25,0,2.2666666666666666,0,1.8888888888888888,0,2.3333333333333335,0,1.6666666666666667,0,2.7142857142857144,0,1.6666666666666667,0,2.135135135135135,0,0,0,0,-0.05053081795394988,-0.10252311775184667,-0.5328163702636706,-0.3176697440077586,2,2,4,2,2,2,2,1,3,0.7559289460184544,2.2857142857142856,0,2,0.17529686935345262,4,5,5,4,2,4,4,6,6,3,3,1.2535663410560174,6,4,0,0.2196552803757379,0,0.4343977554298661,2,3,3,4,3,4,4,4,4,3,3,3,3,3,3,4,4,4,2,4,0.7237468644557459,3,0,3.6,0,3.2,0,3.6,0,3.466666666666667,0,2,3,2,2,3,2,3,4,2,1,2,2,3,4,2,2,1,3,2,4,0.8870412083230169,2.45,0,I lived with my mother and father an equal amount of time (joint custody),0,"White, Caucasian, Anglo, European American",0,29,1,2,NA,1,2,7,Digital Imaging Technician,2,250,70,1,5,2,0,0,1,0,0,TRUE,TRUE,TRUE,TRUE,TRUE,5,0.49105312500015136,0.44508749999979047,0.4632812499995925,0.5816733333334326,0.520514285714299,0.5946655172415335,1,1,1,0.9375,0.875,0.90625,0.074,0.33,0.56,0.009,1.546,26.68576454797772,1883.3890002646842,0.048,0.364,0.565,0.024,1.844,103.5051712580809,2000.6986729937562,0.067,0.359,0.538,0.018,2.014,29.01191675028379,1872.5604007604932,171.7777777777778,76.83333333333333,111.88888888888889,FALSE,424,1.2562962962962962,0,1,0,0,3,FALSE
353,2022-03-18T20:03:24Z,2022-03-18T20:35:10Z,1905,1,2022-03-18T20:35:10Z,0.8999999761581421,Chrome,99.0.4844.74,Windows NT 10.0,1920,1080,"i dont have any feedback, everything went well thank you :D",1.7777777777777777,986,105,365,81,67,195,0.6335660612752019,-0.07120158650316406,-0.16833050047382228,-0.2111101715326983,0.12526817149207461,1.0835808534132698,3,3,2,2,2,2,3,3,3,3,4,1,1,3,3,2,3,2,2,3,0.6958523739384593,0,1,1,3,2,2.5,0,2,2,2,2,2,1,2,2,1,1,1,1,3,1,4,1,1,1,1,1,1,2,1,4,2,0,0,0,0,3,2,1,2,4,1,2,3,3,2,1,1,2,1,1,4,1,1,1,3,4,1,1,1,1,1,1,1,3,1,1,2,2,2,1,2,1,1,2,1,1,1.4806053465364064,1.486446705914413,1.125,0,1.25,0,1.8,0,2.3333333333333335,0,1.8333333333333333,0,1,0,1.7142857142857142,0,1.3333333333333333,0,1.7567567567567568,0,2,0,0,-0.864211525087889,-0.8534956259523583,-0.09409076339160714,-0.4737931946719827,1,1,1,1,1,2,1,1,3,1.889822365046136,1.1428571428571428,0,2,-0.48817982669274074,5,5,5,5,3,3,4,3,6,NA,3,1.2909944487358056,4.5,4.285714285714286,0,0.003250347887277641,1,0.45739313045220775,3,3,3,4,3,3,5,2,2,2,5,3,1,3,2,5,5,4,4,2,1.3732131246511903,3.2,0,4,0,3.4,0,2.2,0,3.2,0,2,1,4,4,3,4,4,4,4,4,3,4,1,4,1,4,4,4,4,2,1.3869694338832115,3.25,0,I lived with my mother and father an equal amount of time (joint custody),0,"White, Caucasian, Anglo, European American",0,26,0,1,NA,1,1,3,unemployed,7,292,72,1,5,2,1,0,0,0,1,TRUE,TRUE,TRUE,TRUE,TRUE,6,0.5351406250009313,0.4339031249999534,0.4808187499982305,0.5840733333346745,0.5018096774203643,0.5254999999977924,1,1,1,0.967741935483871,0.96875,0.8709677419354839,0.052,0.349,0.447,0.011,1.177,147.15472710616322,2026.152086795407,0.073,0.324,0.652,0.024,1.778,33.46825220710793,1857.6167073084007,0.063,0.365,0.405,0.024,1.919,101.96416688278529,1927.335378543479,107.00000000000001,74.08333333333333,79.95833333333333,FALSE,307,0.9096296296296296,0,1,0,33,36,FALSE
354,2022-03-18T20:10:44Z,2022-03-18T20:37:20Z,1595,1,2022-03-18T20:37:21Z,0.8999999761581421,Firefox,98.0,Macintosh,1440,900,n/a,1.6,898,93,335,71,59,87,0.4526292813528766,-0.1374626547591698,-0.27732858778314073,-0.33443683026310195,-0.03877879818619785,-0.13014718364729932,3,3,1,1,3,1,1,4,1,3,4,2,2,2,3,3,1,1,3,3,0.5104177855340404,0,1,1,2,1,2.25,0,4,3,2,3,2,4,3,3,2,3,4,4,1,4,5,3,4,5,3,3,5,4,3,3,1,1,1,0,0,4,5,4,5,5,3,4,4,3,2,2,2,3,3,2,4,5,5,4,3,5,5,3,5,2,4,4,2,1,1,1,5,5,4,2,5,3,1,3,1,1,1.3874166371083074,0.9154754164341269,3.75,0,1.5,0,3.1333333333333333,0,4.111111111111111,0,3.3333333333333335,0,3.8333333333333335,0,2.7142857142857144,0,3.3333333333333335,0,3.4864864864864864,0,2,0,1,1.9628354600755815,1.629915490271803,0.8981956299184052,1.264055560095104,4,3,5,2,2,3,2,3,1,0.6900655593423543,3,0,2,0.5899698043823236,2,2,4,3,1,1,1,6,4,1,2,1.5118578920369088,5,2,0,-0.731835746212317,0,-1.2287829062291473,2,2,2,3,2,4,5,5,5,2,4,5,4,3,4,4,5,3,3,5,1.4375905768565218,2.2,0,4.2,0,3.6,0,4.4,0,4.066666666666666,0,4,1,3,4,3,4,4,4,4,3,4,2,2,3,2,3,2,4,4,4,1.1192102478745307,3.2,0,"I lived with my mother, but not father, most of the time.",0,"White, Caucasian, Anglo, European American",0,29,1,2,NA,1,1,4,"n/a looking for work, artist",1,145,68,2,5,2,0,0,1,0,0,TRUE,TRUE,TRUE,TRUE,TRUE,4,0.47050000000000003,0.41978125,0.4626875,0.5501290322580645,0.48789655172413793,0.5605,1,1,1,0.96875,0.9354838709677419,0.967741935483871,0.068,0.372,0.772,0.006,1.046,38.56053444073532,1865.4941408267468,0.039,0.373,0.849,0.004,0.782,114.01525033189951,1983.299984386215,0.068,0.343,0.594,0.014,1.639,92.70655398923004,1919.998991946694,174.33333333333334,195.5,117.07142857142857,FALSE,434,1.285925925925926,0,1,0,0,3,FALSE
355,2022-03-18T20:10:22Z,2022-03-18T20:37:38Z,1635,1,2022-03-18T20:37:39Z,0.800000011920929,Chrome,99.0.4844.51,Windows NT 10.0,1536,960,NA,1.6,579,134,486,116,67,148,-0.2032665458655524,0.08892932844884985,0.2712951183404288,0.22053313402371458,0.12526817149207461,0.5553843928406147,1,1,1,1,4,1,1,1,1,2,2,1,1,1,1,2,1,1,2,2,1.2937094768634556,0,1,2,3,3,1.4,0,4,3,2,4,3,1,3,1,1,2,1,3,1,3,4,3,1,1,1,1,2,2,2,1,2,0,0,0,0,2,4,4,3,5,3,5,5,4,2,3,3,3,4,2,2,3,3,2,3,3,3,1,5,1,3,3,2,2,1,1,3,2,2,1,2,1,2,2,1,2,0.9962391743414292,0.8451542547285166,1.625,0,1.75,0,2.4,0,3.888888888888889,0,2.75,0,2.6666666666666665,0,1.8571428571428572,0,1.3333333333333333,0,2.72972972972973,0,1,0,0,0.09202779650347893,0.051565388251846145,-0.14114775846592847,-0.044791185107041165,3,2,5,1,2,2,2,1,1,0.6900655593423543,2.4285714285714284,0,1,-0.1285727914961955,2,3,3,2,1,1,4,3,9,2,2,0.816496580927726,6,2.2857142857142856,0,-0.33738063897136766,0,-0.8337190856323571,2,2,3,3,2,4,4,3,4,3,4,3,4,4,5,1,3,5,2,3,1.162919151265879,2.4,0,3.8,0,2.8,0,3.8,0,3.466666666666667,0,1,2,1,3,2,1,2,4,1,1,2,2,3,3,1,2,1,1,2,2,0.7863975156570492,1.85,0,"I lived with my mother, but not father, most of the time.",0,"Hispanic of Latino (e.g., Mexican American, Central American, and others)",0,23,0,1,NA,1,2,5,Student / retail worker,1,230,72,1,5,2,0,0,0,0,0,TRUE,TRUE,TRUE,TRUE,TRUE,6,0.588118749999965,0.5219562499999884,0.5494874999998137,0.6526125000000466,0.617425000000163,0.6563375000000233,1,1,1,1,1,1,0.148,0.32,0.642,0.016,1.767,49.174029680653675,1834.8238562096906,0.22,0.259,0.856,0.016,1.724,51.26947223726682,1833.8940506068595,0.087,0.437,0.677,0.014,1.54,189.20472699247648,1975.6864676340795,110.43749999999999,107.75,110,TRUE,398,1.1792592592592592,0,1,0,0,3,FALSE
356,2022-03-18T19:59:34Z,2022-03-18T20:38:32Z,2337,1,2022-03-18T20:38:34Z,0.8999999761581421,Chrome,99.0.4844.74,Windows NT 10.0,1920,1080,No,1.7777777777777777,1355,60,274,389,79,64,1.392266877085861,-0.31968059246318564,-0.49895803197875493,3.5873509173637355,0.3713386260094833,-0.38862630265093906,3,3,2,2,3,1,2,3,1,3,3,1,1,2,3,3,2,1,3,3,0.4442616583193193,0,1,1,2,2,2.25,0,2,1,2,2,2,1,1,2,1,1,1,2,2,1,2,1,2,1,1,1,1,1,1,1,2,0,0,0,0,2,1,1,1,1,1,1,1,1,2,1,3,1,1,2,4,1,3,3,4,3,1,1,1,1,1,1,1,2,2,1,1,1,3,1,1,1,2,1,2,2,1.7185614488441936,1.5976172734359604,1.125,0,1.75,0,1.5333333333333334,0,1.1111111111111112,0,2.3333333333333335,0,1,0,1.5714285714285714,0,1,0,1.5675675675675675,0,1,0,0,-0.987031254466597,-1.0525225156469813,-0.14114775846592847,-0.5968351370564549,2,2,3,2,1,1,2,1,1,1.0690449676496976,1.8571428571428572,0,1,-0.4603111395192921,4,4,4,4,2,2,3,1,6,3,2,0.9511897312113419,3.5,3.2857142857142856,0,-0.5751298489193319,0,-0.4367109100209476,2,2,3,3,3,4,4,3,4,3,3,3,3,3,3,3,3,3,3,3,0.45773770821706344,2.6,0,3.2,0,3.2,0,3.2,0,3.2,0,1,1,1,3,3,1,1,3,1,1,1,3,2,1,2,3,1,1,1,2,0.6048053188292994,1.65,0,I lived with my mother and father an equal amount of time (joint custody),0,"Asian or Asian American (e.g., Chinese, Japanese, and others) & White, Caucasian, Anglo, European American",1,26,1,2,NA,1,2,7,Clinical Specialist,3,147,65,1,5,2,0,0,1,0,0,TRUE,TRUE,TRUE,TRUE,TRUE,2,0.5762218750007451,0.6263781249895691,0.5053096774162784,0.6827354838655841,0.6861656250022352,0.6216366666674614,1,1,1,0.96875,1,0.967741935483871,0.085,0.336,0.548,0.015,1.964,32.53901029275052,1857.7532088436258,0.097,0.279,0.266,0.125,1.517,121.13143139111176,1905.8940425778915,0.082,0.324,0.354,0.014,1.92,66.62989375315398,1891.1826037584458,130.93333333333334,12.136,137.14285714285714,FALSE,304,0.9007407407407407,1,1,0,3,6,FALSE
357,2022-03-18T20:23:08Z,2022-03-18T20:41:16Z,1088,1,2022-03-18T20:41:17Z,1,Firefox,98.0,Macintosh,2048,1152,NA,1.7777777777777777,469,70,309,76,44,76,-0.429437520768459,-0.26446303558318085,-0.3717935967845501,-0.27277350089790015,-0.3463668663329587,-0.25376763186643136,1,2,1,1,1,1,1,1,1,1,1,1,1,1,1,1,1,1,2,1,1.465390194130093,0,1,2,5,5,1.1,0,1,3,3,3,4,5,2,2,4,2,2,3,2,3,2,2,4,3,1,3,5,2,3,3,2,0,0,0,0,1,3,1,2,2,1,1,1,1,1,1,2,1,2,2,2,2,2,3,4,4,2,1,1,1,2,2,1,3,1,1,2,1,3,1,1,1,2,2,3,1,1.5658709882847794,1.0327955589886444,2.875,0,2,0,2.7333333333333334,0,1.4444444444444444,0,2.1666666666666665,0,1.5,0,1.7142857142857142,0,1,0,1.7027027027027026,0,2,0,0,0.23677962041409875,0.29444899375862393,0.16436794915095845,0.2294084714547912,2,1,3,1,1,1,1,2,4,1.2535663410560174,1.4285714285714286,0,3,0.06449359517422987,5,5,5,4,3,1,4,7,3,4,3,1.618347187425374,5,3.857142857142857,0,0.25285077779445086,0,0.37721410962533,3,2,2,3,2,5,5,5,5,3,5,5,3,4,4,2,5,4,4,5,1.624221425205085,2.4,0,4.8,0,3.4,0,4.6,0,4.266666666666667,0,3,2,3,2,4,2,2,3,1,1,1,2,3,1,1,2,1,3,1,2,0.9679060415469871,2,0,I lived with my mother and father an equal amount of time (joint custody),0,"White, Caucasian, Anglo, European American",0,25,1,3,NA,1,2,5,Graphic Designer,2,228,62,2,5,2,0,0,1,0,0,TRUE,TRUE,TRUE,TRUE,TRUE,1,0.5364193548387097,0.4596875,0.49325,0.606875,0.5299354838709678,0.5511785714285714,0.96875,1,1,1,0.96875,0.9032258064516129,0.051,0.366,0.451,0.013,1.525,194.13662804735787,2074.215162475707,0.064,0.348,0.636,0.009,1.186,188.0501865199918,2015.5050012561107,0.131,0.29,0.536,0.014,1.371,174.72680480206574,2000.399745485215,117.3076923076923,131.77777777777777,97.92857142857143,FALSE,304,0.9007407407407407,1,1,0,3,6,FALSE
358,2022-03-18T20:05:18Z,2022-03-18T20:42:39Z,2240,1,2022-03-18T20:42:40Z,0.8999999761581421,Firefox,99.0,Windows NT 6.1,1366,768,It was very enjoyable study it feels good.,1.7786458333333333,807,107,570,117,78,187,0.26552420211501754,-0.0601580751271631,0.5764897628065205,0.23286579989675493,0.3508327547996992,0.9936750728902647,2,3,1,2,4,1,1,1,3,2,2,2,2,1,2,2,2,2,3,2,0.8944271909999159,0,1,3,4,4,2,0,3,2,1,3,1,1,3,2,1,1,1,1,3,2,3,1,2,1,3,4,1,2,1,2,1,4,2,3,2,2,3,2,2,3,2,3,2,3,1,2,2,2,2,2,2,1,1,3,4,3,2,3,1,3,4,1,2,3,2,1,1,2,1,1,1,1,4,3,4,4,1.2520253861514021,1.3522468075656264,1.875,0,3.75,0,1.8666666666666667,0,2.4444444444444446,0,2.0833333333333335,0,2.3333333333333335,0,1.7142857142857142,0,1,0,2.054054054054054,0,1,2,2,-0.1843165945986138,-0.3671384142776524,3.7590724761401964,1.695967030931272,2,1,3,1,1,1,1,4,3,1.2535663410560174,1.4285714285714286,0,3.5,0.257895719101941,3,4,4,4,3,3,5,7,7,3,3,1.0690449676496976,7,3.7142857142857144,0,0.4002850852868561,0,0.38961212528815947,1,1,2,3,2,5,3,5,5,4,4,4,4,3,3,4,4,4,3,2,1.121223821162776,1.8,0,4.2,0,3.6,0,3.6,0,3.8,0,2,2,1,1,3,2,3,3,1,3,1,2,2,2,1,1,1,2,1,2,0.9679060415469871,1.8,0,"I lived with my extended family on father's side (grandparents, aunts ,uncles, cousins)",0,"White, Caucasian, Anglo, European American",0,28,0,1,NA,1,4,7,Banking,5,145,66,3,5,2,0,0,1,0,0,TRUE,TRUE,TRUE,TRUE,TRUE,3,0.73071875,0.71840625,0.6441875,0.7649032258064516,0.7699032258064517,0.71665625,1,1,1,1,1,1,0.203,0.354,0.703,0.022,1.676,44.07925242696928,1828.6340698512347,0.084,0.553,0.481,0.061,1.923,21.44455847425234,1803.86739759019,0.097,0.543,0.493,0.167,1.698,109.46144234027092,1898.5291963322718,76.18181818181819,31.524590163934427,10.167664670658683,TRUE,380,1.125925925925926,0,1,0,0,3,FALSE
359,2022-03-18T20:25:41Z,2022-03-18T20:44:28Z,1127,1,2022-03-18T20:44:29Z,1,Chrome,97.0.4692.99,Windows NT 10.0,1920,1080,No.,1.7777777777777777,497,87,277,62,36,60,-0.37186672715681,-0.17059318888717268,-0.4880582232478231,-0.4454308231204653,-0.5104138360112311,-0.4335791929124416,2,2,2,1,3,1,3,2,2,2,3,3,1,1,2,2,2,1,3,2,0.8335087534664907,0,0,3,3,3,2,0,1,1,2,1,1,1,2,1,1,1,1,2,3,2,5,1,3,1,1,1,1,1,1,0,2,0,0,0,0,5,5,1,3,3,1,2,1,1,1,1,1,1,2,1,1,1,1,1,3,1,2,1,1,1,1,1,1,1,1,1,2,3,1,1,1,1,1,1,1,1,1.6302323937579137,1.7237832147426693,1.25,0,1,0,1.6666666666666667,0,2.4444444444444446,0,1.25,0,1.1666666666666667,0,1.4285714285714286,0,1,0,1.5405405405405406,0,0,0,0,-0.9234281803240519,-0.9515340691467947,-0.6189692744445258,-0.7852516717956602,3,3,3,3,3,3,2,3,1,0.3779644730092272,2.857142857142857,0,2,0.5070352173765494,5,5,5,5,4,4,5,3,3,4,3,1.4638501094227998,3,4.714285714285714,0,-0.10840883202778547,0,0.6215907203900977,2,1,2,2,1,4,5,5,5,3,5,4,4,4,3,5,5,3,4,5,1.4960264830861913,1.6,0,4.2,0,4.2,0,4.4,0,4.266666666666667,0,1,1,1,3,2,1,1,2,1,2,1,1,1,1,1,3,1,1,1,1,0.8255779474818965,1.35,0,I lived with my mother and father an equal amount of time (joint custody),0,"White, Caucasian, Anglo, European American",0,27,1,2,NA,1,2,6,Administrative Assistant,4,130,65,2,5,2,0,0,1,0,0,TRUE,TRUE,TRUE,TRUE,TRUE,1,0.4309218748807907,0.40365937507152555,0.43359375005960465,0.5291516127740183,0.46853703707235833,0.49266428569384985,1,1,1,0.96875,0.8709677419354839,0.875,0.045,0.36,0.645,0.021,1.674,29.483778316363484,1891.2541745710394,0.05,0.343,0.848,0.025,1.942,91.63519745967892,1959.5014367701312,0.085,0.315,0.798,0.015,1.835,124.10491950015995,1946.6094427329501,79.71428571428571,77.67999999999999,122.33333333333333,FALSE,317,0.9392592592592592,0,1,0,3,6,FALSE
360,2022-03-18T20:17:52Z,2022-03-18T20:47:09Z,1757,1,2022-03-18T20:47:10Z,0.8999999761581421,Chrome,99.0.4844.74,Macintosh,1680,1050,none,1.6,1311,75,207,19,19,61,1.3017984871246986,-0.23685425714317843,-0.7423870936362328,-0.9757354556612011,-0.8590136465775602,-0.42234097034706597,2,2,2,3,4,1,2,4,1,2,3,4,4,3,3,2,1,1,3,4,1.0399898784932577,0,1,3,4,4,2.55,0,3,4,1,4,5,2,4,1,4,2,4,2,5,4,3,3,2,2,1,3,2,4,4,1,2,0,0,0,0,2,2,4,5,3,4,4,5,2,2,4,1,4,3,3,4,5,4,2,3,1,2,5,2,2,1,4,3,2,4,4,1,2,3,2,2,1,3,4,2,2,1.2393692089268784,1.3201731488169053,2.625,0,2.75,0,3.2,0,3.4444444444444446,0,3,0,2.6666666666666665,0,2.7142857142857144,0,1.6666666666666667,0,2.891891891891892,0,1,0,0,0.8464918484012556,0.9082463482417449,0.20346385825749233,0.5558551032496186,4,2,5,3,3,2,3,2,3,0.7559289460184544,3.142857142857143,0,2.5,0.8663065153158088,2,4,3,3,2,1,4,7,7,1,2,0.9759000729485332,7,2.7142857142857144,0,-0.3705761363900806,0,-0.6217300893464665,4,4,5,3,4,4,3,5,5,4,4,3,1,4,3,5,2,4,4,5,1.3020130933435712,4,0,3.4,0,3.4,0,4.4,0,3.7333333333333334,0,2,2,4,2,4,4,2,3,2,1,3,3,4,3,3,1,3,3,2,3,0.8944271909999159,2.7,0,I lived with my mother and father an equal amount of time (joint custody),0,Black or African American,0,24,0,1,NA,1,2,7,IT Technician,2,166,68,3,5,2,0,0,1,0,0,TRUE,TRUE,TRUE,TRUE,TRUE,5,0.5497677419355079,0.49233437499997673,0.5355838709679102,0.6386615384615815,0.5672593749998487,0.5885483870967141,0.96875,1,1,0.8125,1,0.96875,0.047,0.468,0.708,0.033,1.865,70.67233035677378,1897.2229571104933,0.136,0.314,0.726,0.019,1.399,105.84136714867385,1889.8460123088555,0.053,0.406,0.375,0.012,1.758,109.25023820680128,2057.264643132895,56.515151515151516,73.63157894736842,146.5,FALSE,392,1.1614814814814816,0,1,0,0,3,FALSE
362,2022-03-18T20:09:34Z,2022-03-18T20:50:07Z,2432,1,2022-03-18T20:50:08Z,1,Chrome,98.0.4758.102,Windows NT 10.0,1366,768,Everything worked fine.,1.7786458333333333,854,124,843,217,87,105,0.362160891391714,0.03371177156884505,1.5683723573213184,1.4661323872007916,0.5353855956877558,0.07214082252946219,1,1,1,1,1,1,1,1,1,1,2,1,1,1,1,1,1,1,1,1,1.5035046776746235,0,1,1,4,4,1.05,0,1,1,2,1,2,1,1,1,2,1,1,2,1,1,2,3,2,5,1,2,2,2,1,4,2,0,0,0,0,1,1,1,1,1,1,2,1,1,2,1,1,1,2,1,2,1,1,1,2,1,3,1,1,2,3,3,1,5,1,1,1,1,1,1,2,1,2,2,2,1,1.7617047435945683,1.791514389985135,2.25,0,1.75,0,1.3333333333333333,0,1.1111111111111112,0,1.3333333333333333,0,2.1666666666666665,0,1.5714285714285714,0,1.3333333333333333,0,1.4594594594594594,0,2,0,0,-0.32687520905604234,-0.6958671159817653,0.07821504497010326,-0.30882603550583104,1,1,3,1,1,2,1,2,1,1.5275252316519468,1.4285714285714286,0,1.5,-0.5157127766089035,4,5,5,5,1,1,3,4,3,1,2,1.8126539343499315,3.5,3.4285714285714284,0,-1.0027804535789941,0,-0.6197857343318475,1,2,2,2,2,4,5,3,5,2,4,4,4,4,5,3,4,4,3,1,1.3020130933435712,1.8,0,4,0,3.4,0,3.6,0,3.6666666666666665,0,1,1,1,1,2,1,2,1,1,1,1,1,1,1,1,1,1,1,1,1,1.2182817926554552,1.1,0,"I lived with my mother, but not father, most of the time.",0,"White, Caucasian, Anglo, European American",0,24,0,1,NA,1,3,4,none,2,180,67,1,5,2,0,0,1,0,0,TRUE,TRUE,TRUE,TRUE,TRUE,1,0.6572032258064305,0.563050000000032,0.6275906250000407,0.7556625000000349,0.6482399999999752,0.6956812500000232,0.96875,1,1,1,0.9375,1,0.115,0.427,0.586,0.01,1.041,152.62223893443348,1935.3315682032467,0.078,0.393,0.501,0.016,1.985,106.13719603641313,1951.1681098096803,0.197,0.285,0.537,0.01,1.332,110.89666889229986,1933.615082799695,104.1,124.0625,133.20000000000002,FALSE,338,1.0014814814814814,0,1,0,0,3,FALSE
363,2022-03-18T20:34:24Z,2022-03-18T20:58:27Z,1442,1,2022-03-18T20:58:29Z,1,Chrome,97.0.4692.71,Windows NT 10.0,1920,1080,"No, there is nothing.",1.7777777777777777,558,46,400,98,44,65,-0.24644464107428912,-0.39698517209519235,-0.04116606527961743,-0.0014548516910120387,-0.3463668663329587,-0.3773880800855634,1,2,1,1,4,1,1,3,1,3,4,1,1,1,1,4,1,1,4,4,1,0,0,4,3,2,2,0,3,2,1,3,1,1,3,1,1,1,1,3,1,3,5,1,3,1,1,1,2,2,1,0,2,0,0,0,0,2,3,4,3,3,2,1,1,2,1,1,1,1,4,1,5,1,1,2,3,1,3,1,1,2,1,1,1,1,1,1,2,1,1,1,2,1,2,1,1,1,1.3732756044894578,1.1254628677422756,1.5,0,1.25,0,2,0,2.3333333333333335,0,1.8333333333333333,0,1.5,0,1.1428571428571428,0,1.3333333333333333,0,1.7297297297297298,0,0,0,0,-0.6383109514091944,-0.6142503578560059,-0.5328163702636706,-0.5735333640598382,1,1,5,1,1,1,1,3,2,1.5118578920369088,1.5714285714285714,0,2.5,-0.04597394174770708,4,5,5,4,1,1,4,3,3,2,2,1.7728105208558367,3,3.4285714285714284,0,-0.8792700537047221,0,-0.5445568447258828,1,2,1,2,2,4,3,4,5,3,3,2,5,3,3,4,1,5,3,4,0.8338093878327919,1.6,0,3,0,3.6,0,3.8,0,3.466666666666667,0,1,1,1,3,1,2,2,2,1,1,2,2,4,2,1,2,1,1,1,1,0.9233805168766387,1.6,0,"I lived with my extended family on mother's side (grandparents, aunts ,uncles, cousins)",0,"White, Caucasian, Anglo, European American",0,27,0,1,NA,1,4,5,CEO,4,265,71,3,5,2,0,0,1,0,0,TRUE,TRUE,TRUE,TRUE,TRUE,2,0.5642838710661857,0.5030031249523162,0.5646687501370907,0.7263656248748303,0.641406249910593,0.6819299999554952,0.96875,1,1,1,1,1,0.141,0.328,0.6,0.012,1.549,26.47821779864742,1807.6407745394372,0.165,0.254,0.666,0.014,1.896,39.272815882501355,1824.0411939804978,0.157,0.302,0.597,0.009,1.597,132.88847516109126,1956.7253123502471,129.08333333333331,135.42857142857142,177.44444444444446,FALSE,288,0.8533333333333333,0,1,0,6,9,FALSE
367,2022-03-18T20:40:44Z,2022-03-18T21:07:15Z,1591,1,2022-03-18T21:07:16Z,0.8999999761581421,Chrome,99.0.4844.51,Macintosh,1920,1080,None,1.7777777777777777,797,54,245,42,40,53,0.2449632043965715,-0.3528111265911885,-0.6043228497110961,-0.6920841405812727,-0.42839035117209495,-0.5122467508700711,2,1,2,1,3,1,1,2,1,1,1,2,1,1,2,2,1,1,3,1,1.1964860832322377,0,1,4,3,3,1.5,0,2,2,2,2,1,1,2,2,1,2,1,2,2,2,3,1,1,1,1,1,1,1,1,0,2,0,0,0,0,1,2,2,1,2,1,1,1,1,2,1,1,1,3,2,2,1,1,1,1,1,1,1,1,1,1,1,1,1,1,1,1,1,1,1,1,1,2,1,1,1,1.7710552325200466,1.2983506020002016,1,0,1.25,0,1.8,0,1.3333333333333333,0,1.4166666666666667,0,1,0,1,0,1,0,1.2162162162162162,0,0,0,0,-1.2962737873665577,-1.1440709515687668,-0.5328163702636706,-0.8384436609162187,2,1,4,1,1,3,2,1,1,1.1547005383792515,2,0,1,-0.3773765525135179,2,2,4,3,2,1,4,1,1,2,2,0.9511897312113419,1,2.5714285714285716,0,-1.2405296635269585,0,-1.2290123368492405,2,1,1,2,1,4,4,5,5,2,4,4,5,5,3,4,1,5,4,4,1.3451854182690985,1.4,0,3.6,0,3.8,0,4.4,0,3.933333333333333,0,1,1,1,2,2,1,2,2,1,1,1,2,2,1,1,1,1,2,1,2,0.9233805168766387,1.4,0,I lived with my mother and father an equal amount of time (joint custody),0,"Asian or Asian American (e.g., Chinese, Japanese, and others)",0,27,0,1,NA,1,4,7,Marketing Manager,6,140,65,4,5,2,0,0,1,0,0,TRUE,TRUE,TRUE,TRUE,TRUE,1,0.49182187499757857,0.48150312499981374,0.5134781250013039,0.5812714285733445,0.5244406249979511,0.5588249999945983,1,1,1,0.9032258064516129,1,1,0.156,0.3,0.748,0.019,1.411,140.26596659222105,1927.282200116987,0.107,0.352,0.877,0.042,2.017,15.508413748263163,1797.135916542358,0.065,0.372,0.579,0.017,1.978,84.72934317855118,1941.670241889824,74.26315789473685,48.02380952380952,116.35294117647058,FALSE,314,0.9303703703703704,0,1,0,3,6,FALSE
368,2022-03-18T20:51:13Z,2022-03-18T21:13:57Z,1363,1,2022-03-18T21:13:58Z,0.8999999761581421,Chrome,99.0.4844.74,Windows NT 10.0,1536,864,I would recommend a different color for the background on the flanker game as staring intensively at a white screen is not good for your eyes,1.7777777777777777,558,57,349,35,27,101,-0.24644464107428912,-0.33624585952718705,-0.22646281370545882,-0.7784128016925552,-0.6949666768992877,0.027187932267959625,2,2,3,2,2,2,3,3,3,2,2,2,2,3,2,3,1,2,2,3,0.6069769786668839,0,0,4,3,1,2.3,0,3,4,4,3,3,2,3,5,5,3,3,4,3,3,2,3,3,5,1,3,1,3,2,2,1,1,0,0,0,4,3,1,3,4,2,2,3,3,3,4,3,4,2,2,2,3,2,4,2,4,3,3,2,3,3,4,2,2,4,3,3,2,3,3,3,3,1,2,1,2,0.7988354887823513,0.9411239481143202,2.625,0,1.5,0,3.3333333333333335,0,2.7777777777777777,0,2.9166666666666665,0,3,0,2.7142857142857144,0,3,0,2.864864864864865,0,1,0,0,0.8289461727757258,0.9546597335855501,-0.22730066264678367,0.36367953546938325,3,4,3,2,3,3,2,3,2,0.6900655593423543,2.857142857142857,0,2.5,0.7004373413042606,1,1,3,3,1,2,4,4,1,1,2,0.8997354108424374,2.5,2.142857142857143,0,-1.1834102584901123,0,-1.4264295318375892,3,3,2,2,3,3,1,4,2,3,3,4,4,2,4,4,3,5,2,3,0.9856107606091623,2.6,0,3.6,0,2.8,0,3,0,3.1333333333333333,0,2,2,1,3,3,2,2,2,2,2,1,2,2,3,2,3,3,2,4,3,0.7326950970650465,2.3,0,"I lived with my father, but not mother, most of the time.",0,"Hispanic of Latino (e.g., Mexican American, Central American, and others)",0,19,0,1,NA,1,2,3,Unemployed looking,1,161,71,2,5,2,0,0,1,0,0,TRUE,TRUE,TRUE,TRUE,TRUE,1,0.4551096774147403,0.40423437500186266,0.5398687500003725,0.5322874999977648,0.445587096773809,0.5612724137922813,1,1,1,1,0.96875,0.9666666666666667,0.071,0.318,0.37,0.02,1.707,115.01872015517412,1940.4277575921406,0.062,0.266,0.443,0.038,1.839,85.82626890565392,1911.1010320742007,0.086,0.283,0.496,0.016,1.58,72.13972967401016,1854.6564152911199,85.35000000000001,48.39473684210526,98.75,FALSE,343,1.0162962962962963,0,1,0,3,6,FALSE
369,2022-03-18T20:52:19Z,2022-03-18T21:14:05Z,1306,1,2022-03-18T21:14:06Z,0.8999999761581421,Chrome,99.0.4844.74,Windows NT 10.0,1280,800,I do not have any,1.6,543,75,283,98,63,106,-0.2772861376519582,-0.23685425714317843,-0.4662586057859594,-0.0014548516910120387,0.043244686652938374,0.08337904509483783,1,2,1,1,2,1,1,1,1,2,1,2,1,1,1,1,1,1,2,1,1.348488432516786,0,1,2,4,4,1.25,0,3,1,2,2,1,1,1,1,1,1,1,1,1,1,2,1,1,1,3,1,1,1,1,0,2,0,0,0,0,2,2,1,1,2,1,2,1,2,1,2,3,1,2,1,1,1,4,3,2,3,1,1,1,1,1,1,2,1,2,1,1,1,1,1,2,1,3,2,3,2,1.633912381270694,1.7994708216848747,1.25,0,2.5,0,1.3333333333333333,0,1.5555555555555556,0,2,0,1,0,1.2857142857142858,0,1.3333333333333333,0,1.5405405405405406,0,0,0,0,-0.9234281803240519,-1.0970675655638116,-0.10205184935939461,-0.5995597074616031,1,1,2,2,1,1,1,2,2,1.6761634196950514,1.2857142857142858,0,2,-0.40524523968696646,5,5,5,5,4,3,5,6,6,3,3,1.5275252316519468,6,4.571428571428571,0,0.2196552803757379,0,0.7440084563925745,1,2,2,1,1,5,1,5,4,1,5,4,5,3,4,4,5,5,2,2,1.424279266355945,1.4,0,4.8,0,2.6,0,3.6,0,3.6666666666666665,0,1,1,1,1,1,1,3,1,1,1,2,1,3,1,1,1,1,2,1,1,1.2523661815266247,1.3,0,I lived with my mother and father an equal amount of time (joint custody),0,"White, Caucasian, Anglo, European American",0,26,0,1,NA,1,5,6,Data Programmer,4,139.5,64,4,5,2,0,0,1,0,0,TRUE,TRUE,TRUE,TRUE,TRUE,2,0.7547666666666667,0.6614193548387097,0.6357741935483872,0.7745806451612903,0.6693548387096774,0.6675806451612903,0.9375,0.96875,0.96875,0.96875,0.96875,1,0.078,0.349,0.274,0.037,1.382,97.53146941748264,1920.9398218939943,0.065,0.431,0.28,0.255,1.774,75.85597282495213,1941.5097172697735,0.074,0.439,0.214,0.256,1.717,114.89937091478188,2022.5372874074858,37.35135135135135,6.956862745098039,6.70703125,FALSE,336,0.9955555555555555,0,1,0,0,3,FALSE
370,2022-03-18T20:36:35Z,2022-03-18T21:17:11Z,2436,1,2022-03-18T21:17:12Z,0.8999999761581421,Chrome,99.0.4844.51,Windows NT 10.0,1366,768,N/A,1.7786458333333333,1022,185,652,86,124,103,0.7075856530616076,0.3705388685368743,0.8744178681186576,-0.14944684216749646,1.294102830449766,0.04966437739871091,2,2,3,2,2,1,2,2,1,2,3,3,3,3,2,2,1,2,2,3,0.7591546545162482,0,1,1,3,2,2.15,0,3,3,2,3,2,1,2,2,2,2,2,3,3,2,2,2,3,1,1,1,1,2,1,1,1,2,0,0,0,2,2,3,2,2,1,1,1,1,1,1,3,1,3,1,1,2,2,2,2,2,3,1,1,1,3,1,1,1,1,1,2,3,3,1,1,1,1,1,2,2,1.519147065891847,0.8997354108424374,1.5,0,1.5,0,2.2666666666666666,0,1.6666666666666667,0,1.75,0,1.6666666666666667,0,1.7142857142857142,0,1,0,1.6486486486486487,0,1,0,0,-0.6909479782857835,-0.5332236003913966,-0.22730066264678367,-0.38026213151909016,3,2,4,2,1,3,2,2,1,0.6900655593423543,2.4285714285714284,0,1.5,0.06482933243151565,3,3,4,4,2,2,4,4,1,NA,2,0.8997354108424374,2.5,3.142857142857143,0,-1.0534549923719885,1,-0.8054564150896155,2,2,2,2,2,4,3,4,4,4,5,3,5,3,4,3,3,4,3,3,0.9102589898327995,2,0,3.8,0,3.6,0,3.6,0,3.6666666666666665,0,2,1,2,2,2,2,3,2,2,1,2,2,4,2,2,2,1,1,1,3,0.8750939799154206,1.95,0,NA,NA,Black or African American,0,28,0,1,NA,1,3,4,Warehouse Worker,7,140,64,3,5,2,0,0,2,0,0,TRUE,TRUE,TRUE,TRUE,TRUE,3,0.6309656249992549,0.5355656249932945,0.5425468750074506,0.6879281249940395,0.610449999988079,0.6598709677496264,1,1,1,1,1,1,0.217,0.271,0.794,0.008,1.237,29.67239725363008,1814.2723485459687,0.145,0.267,0.567,0.018,1.906,42.23655831485796,1823.800746784815,0.096,0.376,0.412,0.027,1.777,54.804829700661415,1838.4388106995468,154.625,105.88888888888889,65.81481481481481,FALSE,449,1.3303703703703704,0,1,0,0,3,FALSE
371,2022-03-18T20:55:27Z,2022-03-18T21:19:13Z,1426,1,2022-03-18T21:19:14Z,1,Firefox,98.0,Windows NT 10.0,1366,768,NA,1.7786458333333333,506,79,230,46,28,469,-0.3533618292102086,-0.2147672343911765,-0.6588218933657554,-0.6427534770891111,-0.6744608056895036,4.162853836326195,1,1,1,1,1,1,1,2,1,1,2,1,1,1,2,2,1,1,2,2,1.2814465510343749,0,1,2,4,3,1.3,0,2,2,3,2,2,2,3,3,3,2,3,3,3,3,2,2,3,3,2,2,2,2,2,0,1,1,0,0,0,1,1,2,1,1,1,1,1,1,1,1,5,1,2,2,1,2,2,3,3,3,3,2,2,2,3,2,2,1,1,1,2,2,2,1,2,2,2,2,1,1,1.518158359593888,0.7037315505489968,2.25,0,1.5,0,2.533333333333333,0,1.1111111111111112,0,2.1666666666666665,0,2.3333333333333335,0,1.5714285714285714,0,1.6666666666666667,0,1.7837837837837838,0,0,0,0,-0.1163271015496859,-0.030346370204488746,-0.4466634660828154,-0.23850491814365207,4,4,4,3,3,4,5,6,3,1.1126972805283737,3.857142857142857,0,4.5,2.0545879460555243,4,4,4,4,2,2,3,3,3,2,2,0.9511897312113419,3,3.2857142857142856,0,-0.8792700537047221,0,-0.62195951996656,3,4,3,2,3,4,4,3,3,4,4,3,4,4,4,4,4,4,3,3,0.8451542547285166,3,0,3.8,0,3.8,0,3.4,0,3.6666666666666665,0,1,1,2,2,2,2,2,2,2,2,2,2,2,2,2,2,2,2,2,3,0.5871429486123998,1.95,0,"I lived with my mother, but not father, most of the time.",0,"White, Caucasian, Anglo, European American",0,27,1,2,NA,1,3,4,artist,2,110,60,2,5,2,0,0,1,0,0,TRUE,TRUE,TRUE,TRUE,TRUE,6,0.546875,0.482,0.54740625,0.6145625,0.5585625,0.68275,1,1,1,1,1,1,0.1,0.381,0.595,0.015,1.85,52.670358790899485,1837.2540070521165,0.092,0.373,0.895,0.012,1.319,46.22242391603809,1835.603279186508,0.123,0.357,0.656,0.026,1.818,29.87103636071133,1810.237466084213,123.33333333333334,109.91666666666666,69.92307692307693,FALSE,338,1.0014814814814814,0,1,0,3,6,FALSE
372,2022-03-18T20:52:51Z,2022-03-18T21:19:33Z,1601,1,2022-03-18T21:19:33Z,0.800000011920929,Chrome,99.0.4844.74,Windows NT 10.0,1920,1080,Thank you.,1.7777777777777777,688,98,398,126,56,115,0.02084832926550954,-0.10985387631916742,-0.04843260443357199,0.34385979275411827,-0.10029641181555002,0.1845230481832186,1,3,1,1,2,1,1,1,1,2,2,1,1,1,1,2,1,1,2,2,1.2096106376585989,0,0,1,3,5,1.4,0,1,1,1,2,2,2,1,1,2,1,1,1,1,1,1,1,1,1,1,1,1,1,1,0,2,0,0,0,0,1,1,2,1,2,2,2,2,3,1,2,1,1,4,1,4,3,2,1,1,2,2,1,1,1,1,1,1,1,1,1,2,1,1,1,1,1,1,2,4,4,1.4876872027456622,1.8516401995451028,1,0,2.75,0,1.2666666666666666,0,1.7777777777777777,0,1.9166666666666667,0,1.1666666666666667,0,1.1428571428571428,0,1,0,1.5405405405405406,0,0,0,0,-1.0857256798602015,-1.2353243871599773,-0.01589894517853939,-0.6256116661692583,4,4,4,3,3,3,4,3,3,0.816496580927726,3.5714285714285716,0,3,1.3085124002608426,5,5,5,5,1,1,5,4,3,3,3,2.138089935299395,3.5,3.857142857142857,0,-0.23191923190205752,0,0.08194577934007008,2,3,3,2,2,4,4,4,4,3,4,3,5,3,4,3,5,4,2,3,1.0327955589886444,2.4,0,4,0,3.4,0,3.6,0,3.6666666666666665,0,1,1,1,3,2,1,1,2,1,1,2,2,1,1,1,2,1,1,1,1,0.7591546545162482,1.35,0,I lived with my mother and father an equal amount of time (joint custody),0,"Hispanic of Latino (e.g., Mexican American, Central American, and others) & White, Caucasian, Anglo, European American",1,30,0,4,they,1,3,6,e commerce,1,240,74,1,5,2,0,0,0,0,0,TRUE,TRUE,TRUE,TRUE,TRUE,1,0.5427312499999826,0.46425161290320477,0.5122968750000109,0.5924580645161275,0.5113966666666403,0.5814322580645169,1,1,1,1,0.9375,1,0.079,0.371,0.553,0.017,1.327,13.32462245944159,1794.016760415982,0.054,0.367,0.558,0.011,1.083,156.18099619998964,2003.8202861218053,0.121,0.37,0.733,0.036,1.879,73.81678517889729,1857.073319652097,78.05882352941175,98.45454545454545,52.19444444444445,FALSE,279,0.8266666666666667,0,1,0,9,12,FALSE
373,2022-03-18T20:58:03Z,2022-03-18T21:19:47Z,1303,1,2022-03-18T21:19:48Z,0.8999999761581421,Chrome,99.0.4844.51,Windows NT 10.0,1920,1080,NA,1.7777777777777777,530,84,361,67,60,97,-0.30401543468593806,-0.1871584559511741,-0.18286357878173143,-0.3837674937552634,-0.018272926976413795,-0.017764957993542937,1,1,1,1,1,1,4,1,1,1,4,1,1,1,1,4,1,1,3,1,1.4823523268955432,0,1,2,3,3,1.55,0,4,1,3,3,3,1,5,3,3,1,3,5,2,5,5,3,1,2,1,1,2,3,2,0,2,0,0,0,0,1,5,4,1,5,5,3,3,5,1,1,5,5,5,2,1,1,5,5,4,4,5,1,1,1,1,1,1,1,1,1,1,1,1,1,1,2,4,4,3,3,1.7329174830334544,1.2071217242444348,1.875,0,3.5,0,3.1333333333333333,0,3.5555555555555554,0,3.25,0,1.6666666666666667,0,1,0,1.3333333333333333,0,2.4864864864864864,0,0,0,0,0.09641421540986095,0.37468908367503295,0.24255976736402618,0.30862442551952957,4,5,3,3,3,5,5,4,1,1.2535663410560174,4,0,2.5,1.3639140373504541,5,3,3,3,1,1,3,9,9,NA,1,1.3801311186847085,9,2.7142857142857144,0,0.1928696799855022,1,-0.2785411500975462,3,3,3,1,3,3,5,5,5,5,1,5,3,1,5,3,3,1,3,2,1.5522640914238175,2.6,0,2.6,0,3.8,0,3.6,0,3.3333333333333335,0,4,2,4,4,4,4,1,4,4,2,2,4,4,2,1,3,4,4,4,4,1.332784974957958,3.25,0,NA,NA,"Asian or Asian American (e.g., Chinese, Japanese, and others)",0,24,0,1,NA,1,2,6,Self-employed (Side-job selling things online slowly) and unemployed,7,280,68,1,5,2,0,0,1,0,0,TRUE,TRUE,TRUE,TRUE,TRUE,6,0.5834218750074506,0.46096874998509885,0.5601343750003726,0.6107827586264446,0.5171064516036741,0.6468133333345254,1,1,1,0.90625,0.96875,0.9375,0.074,0.29,0.305,0.012,1.528,169.2914284548985,2035.7298768361886,0.06,0.334,0.513,0.015,1.269,52.118959765018836,1879.116190977611,0.058,0.398,0.383,0.024,2.023,99.68843071629186,1954.4968439502788,127.33333333333333,84.6,84.29166666666667,FALSE,312,0.9244444444444444,0,1,0,0,3,FALSE
374,2022-03-18T20:58:05Z,2022-03-18T21:20:17Z,1332,1,2022-03-18T21:20:18Z,1,Chrome,98.0.4758.109,Macintosh,1440,900,NA,1.6,618,112,334,73,55,72,-0.12307865476361282,-0.0325492966871607,-0.28096185736011803,-0.30977149851702124,-0.12080228302533408,-0.29872052212793393,2,2,1,1,2,1,2,4,1,3,4,2,2,1,2,2,2,1,3,3,0.812727700887249,0,0,4,2,2,2.05,0,5,5,5,4,5,5,5,5,5,5,5,5,2,5,5,4,5,5,4,4,5,5,5,2,1,1,0,2,0,5,5,5,5,5,5,5,5,5,4,4,5,4,5,3,2,5,5,5,5,5,5,3,5,5,5,3,4,2,2,2,4,5,5,5,5,5,2,4,3,2,1.7346495349231237,1.9639610121239315,4.625,0,2.75,0,4.733333333333333,0,5,0,4.333333333333333,0,4.333333333333333,0,3.4285714285714284,0,5,0,4.378378378378378,0,1,0,0,3.1098840040945857,3.099902137527198,0.20346385825749233,1.651682997892345,5,4,5,4,3,5,5,8,8,1.7043362064926932,4.428571428571429,0,8,3.740141161572599,2,2,2,1,1,1,1,3,3,NA,2,1.4142135623730951,3,1.4285714285714286,0,-0.9179826386886498,1,-1.6517737277230051,3,4,4,5,4,4,5,4,4,4,5,5,1,3,5,5,5,4,5,5,1.6987390281365427,4,0,4.6,0,4,0,4.2,0,4.266666666666667,0,2,4,4,3,4,4,4,3,1,3,4,3,1,2,1,2,3,4,2,4,1.1516578439248717,2.9,0,NA,NA,"Hispanic of Latino (e.g., Mexican American, Central American, and others)",0,21,1,2,NA,1,2,4,customer service,2,200,63,3,5,2,1,1,1,0,2,TRUE,TRUE,TRUE,TRUE,TRUE,2,0.6968093750006519,0.5699999999990386,0.5346562500004657,0.7774064516127109,0.667087096773809,0.679659374999348,1,1,1,0.96875,1,1,0.101,0.348,0.54,0.014,1.962,49.417443770010415,1835.0571325563644,0.168,0.283,0.596,0.007,1.107,38.43061996379507,1822.5645815244363,0.254,0.138,0.492,0.014,1.798,161.0249010178807,1988.8242519112805,140.14285714285714,158.14285714285714,128.42857142857142,FALSE,434,1.285925925925926,0,1,0,0,3,FALSE
375,2022-03-18T20:54:57Z,2022-03-18T21:20:27Z,1530,1,2022-03-18T21:20:28Z,0.8999999761581421,Chrome,99.0.4844.74,Windows NT 10.0,2560,1080,NA,2.3703703703703702,1001,59,225,43,41,57,0.664407557852871,-0.3252023481511861,-0.6769882412506417,-0.6797514747082323,-0.40788447996231086,-0.46729386060856853,1,2,1,1,2,1,1,1,1,1,2,1,1,1,1,3,1,1,1,2,1.3218806379747876,0,1,2,3,3,1.3,0,2,1,2,2,1,1,2,2,1,1,1,1,2,2,3,2,3,1,1,1,2,3,2,3,2,0,0,0,0,1,2,1,2,3,3,4,4,3,2,2,3,1,1,3,1,3,2,3,1,2,2,1,1,1,3,2,2,5,4,1,1,1,1,1,2,1,2,1,2,3,1.4311002927985332,1.5430334996209192,1.875,0,2,0,1.6,0,2.5555555555555554,0,2,0,1.6666666666666667,0,2.142857142857143,0,1.3333333333333333,0,2.054054054054054,0,2,0,0,-0.1843165945986138,-0.48356521141126574,0.16436794915095845,-0.15959863113015366,1,2,3,2,1,2,2,4,2,1.2724180205607036,1.8571428571428572,0,3,0.3132973561915524,4,3,3,4,5,4,4,6,5,5,4,0.9759000729485332,5.5,3.857142857142857,0,0.9002015995971155,0,0.7715087079692513,2,3,3,4,3,2,3,3,4,3,4,3,2,4,3,5,3,4,3,3,0.8338093878327919,3,0,3.2,0,3.2,0,3.4,0,3.2666666666666666,0,1,1,1,1,2,1,3,2,1,1,2,1,2,1,1,1,1,1,1,1,1.1516578439248717,1.3,0,I lived with my mother and father an equal amount of time (joint custody),0,"White, Caucasian, Anglo, European American",0,21,0,1,NA,1,4,5,Software Engineer,3,150,68,2,5,2,0,0,1,0,0,TRUE,TRUE,TRUE,TRUE,TRUE,5,0.463906249998603,0.37327419354886776,0.41295312500093134,0.5333551724131765,0.4560875000022352,0.4929107142841177,1,1,1,0.90625,0.75,0.875,0.066,0.277,0.538,0.018,2.014,93.66622948238823,1961.453530159552,0.051,0.28,0.608,0.017,2.055,37.5643107407313,1931.0580111982129,0.06,0.319,0.469,0.02,2.016,32.42160752520742,1886.148365331706,111.88888888888889,120.88235294117648,100.8,FALSE,322,0.9540740740740741,0,1,0,15,18,FALSE
376,2022-03-18T21:09:02Z,2022-03-18T21:23:43Z,881,1,2022-03-18T21:23:44Z,0.8999999761581421,Firefox,98.0,Windows NT 10.0,1280,720,NA,1.7777777777777777,450,59,191,47,34,58,-0.46850341643350646,-0.3252023481511861,-0.8005194068678694,-0.6304208112160707,-0.5514255784307993,-0.4560556380431929,3,3,3,3,3,2,3,3,2,3,4,3,2,4,3,4,3,2,4,3,0.7677718959499145,0,1,2,3,3,3,0,1,1,2,2,2,2,2,2,2,1,1,2,1,2,2,2,1,1,1,1,2,1,1,1,2,0,0,0,0,1,2,1,2,2,1,2,2,2,2,1,1,1,2,2,1,2,2,2,1,2,1,1,1,1,1,1,2,2,1,1,2,2,2,1,1,1,1,1,1,1,1.5552874071755738,1.4573295865416045,1.25,0,1,0,1.6666666666666667,0,1.6666666666666667,0,1.5833333333333333,0,1,0,1.7142857142857142,0,1,0,1.4864864864864864,0,1,0,0,-0.9585195315751113,-0.9751340955927975,-0.39960647100849406,-0.6873702833006458,1,2,1,1,1,2,2,1,1,1.7182493859684491,1.4285714285714286,0,1,-0.7091149005366146,4,5,5,5,2,2,4,8,8,4,3,1.5118578920369088,8,3.857142857142857,0,0.7947401925278054,0,0.7072732706442727,4,3,2,2,2,3,4,4,4,4,5,5,4,3,5,3,4,4,4,4,1.2227992865708155,2.6,0,4.2,0,3.8,0,4,0,4,0,2,1,3,4,2,2,2,4,3,2,2,3,2,2,2,3,1,3,4,2,0.7591546545162482,2.45,0,I lived with my mother and father an equal amount of time (joint custody),0,"Asian or Asian American (e.g., Chinese, Japanese, and others) & White, Caucasian, Anglo, European American",1,25,1,2,NA,1,2,6,case manager,2,116,62,1,5,2,0,0,1,0,0,TRUE,TRUE,TRUE,TRUE,TRUE,5,0.44159375,0.42116129032258065,0.4721875,0.5201153846153846,0.5255333333333333,0.5902068965517241,1,0.96875,1,0.8125,0.9375,0.90625,0.069,0.334,0.513,0.009,1.496,54.21456936987422,1909.205686567085,0.051,0.338,0.555,0.018,1.855,116.12888164422472,2003.175439929503,0.05,0.343,0.551,0.016,1.9,79.14517579793655,1937.411350314403,166.22222222222223,103.05555555555556,118.74999999999999,FALSE,366,1.0844444444444443,0,1,0,0,3,FALSE
377,2022-03-18T20:59:20Z,2022-03-18T21:25:07Z,1546,1,2022-03-18T21:25:08Z,0.8999999761581421,Chrome,99.0.4844.74,Windows NT 10.0,1366,768,NA,1.7786458333333333,620,113,460,100,77,101,-0.1189664552199236,-0.027027540999160226,0.1768301093390195,0.023210480055068695,0.3303268835899152,0.027187932267959625,3,2,2,1,3,1,1,3,1,2,2,1,1,2,3,2,2,1,3,2,0.7880689256524124,0,1,1,4,4,1.9,0,1,3,4,4,3,2,3,2,2,2,4,3,2,4,4,4,4,5,2,3,4,3,5,7,1,0,0,1,1,3,4,3,4,4,4,5,5,4,4,3,4,3,4,2,4,2,4,4,4,4,5,2,4,3,4,3,2,4,3,2,2,1,2,4,4,3,3,3,4,4,1.038305387676515,0.9611501047232549,3.75,0,3.5,0,2.8666666666666667,0,4,0,3.5,0,3.5,0,2.2857142857142856,0,3.6666666666666665,0,3.4054054054054053,0,4,1,0,1.9101984331989927,1.4780886534691855,1.8193759925586375,1.6487323230139115,3,2,4,1,1,2,1,3,1,0.7559289460184544,2,0,2,0.009427695341904336,3,2,3,3,2,2,3,4,1,NA,2,0.5345224838248488,2.5,2.5714285714285716,0,-1.0534549923719885,1,-1.115067116052324,3,2,3,2,3,4,4,3,4,2,5,4,1,3,3,3,4,4,3,3,1.0327955589886444,2.6,0,4.2,0,2.6,0,3.2,0,3.3333333333333335,0,2,1,2,3,3,2,2,3,3,3,3,3,2,1,2,3,1,3,3,3,0.6958523739384593,2.4,0,"I lived with my mother, but not father, most of the time.",0,"Hispanic of Latino (e.g., Mexican American, Central American, and others) & White, Caucasian, Anglo, European American",1,25,1,2,NA,1,2,2,Nanny,1,270,64,3,5,2,0,0,0,0,0,TRUE,TRUE,TRUE,TRUE,TRUE,2,0.7582966666678588,0.5900250000040979,0.7228874999955297,0.8682566666642825,0.7655062499996275,1.0448062499966473,0.9375,1,1,0.967741935483871,1,1,0.137,0.25,0.246,0.009,1.907,64.95695252853172,1847.5268899810862,0.272,0.177,0.643,0.007,1.422,19.022635704654192,1800.5000068486897,0.078,0.431,0.205,0.014,1.507,124.80703089829666,2031.1474069571907,211.88888888888891,203.14285714285714,107.64285714285714,TRUE,340,1.0074074074074075,0,1,0,0,3,FALSE
378,2022-03-18T21:06:23Z,2022-03-18T21:29:08Z,1365,1,2022-03-18T21:29:09Z,0.8999999761581421,Chrome,99.0.4844.51,Macintosh,1440,900,none,1.6,571,97,364,81,108,76,-0.21971534404030926,-0.1153756320071679,-0.17196377005079957,-0.2111101715326983,0.966008891093221,-0.25376763186643136,1,2,1,1,3,1,1,2,1,2,2,1,1,1,1,2,1,1,3,2,1.1239029738980326,0,1,1,3,3,1.5,0,2,1,3,2,3,1,2,2,2,1,1,1,3,1,2,1,1,3,1,1,1,2,1,0,1,2,0,2,0,1,1,1,1,1,1,1,1,1,2,1,1,1,2,1,1,2,1,1,1,1,3,1,2,1,3,2,1,1,1,1,1,3,1,1,1,1,2,2,2,1,1.798397685228224,1.4573295865416045,1.375,0,1.75,0,1.8,0,1,0,1.25,0,2,0,1.2857142857142858,0,1,0,1.2972972972972974,0,0,0,0,-1.000190511185744,-0.9449457284306189,-0.3605105619019602,-0.6527281451662895,3,3,5,2,2,4,4,3,1,1.1126972805283737,3.2857142857142856,0,2,0.7558389783938718,4,4,4,4,1,1,3,3,3,2,1,1.4142135623730951,3,3,0,-1.2224806707219966,0,-0.9858108588462231,3,3,2,3,3,4,5,3,5,3,5,5,4,5,3,5,5,4,3,4,1.505545305418162,2.8,0,4.6,0,4,0,4,0,4.2,0,1,1,1,2,1,1,2,1,2,1,2,1,1,2,1,2,1,2,1,2,1.0052493799000692,1.4,0,"I lived with my mother, but not father, most of the time. & I lived with my extended family on mother's side (grandparents, aunts ,uncles, cousins)",1,"Hispanic of Latino (e.g., Mexican American, Central American, and others) & Filipino",1,27,1,2,NA,1,2,6,RN,5,150,65,2,5,2,0,1,2,0,1,TRUE,TRUE,TRUE,TRUE,TRUE,5,0.6663843749947846,0.6061419354831019,0.608106249999255,0.7282838709710105,0.6690999999940396,0.7083781250026077,1,1,1,1,1,1,0.155,0.326,0.558,0.012,1.402,19.993586291027054,1801.836912473237,0.185,0.299,0.637,0.018,1.683,74.18169876319938,1859.9914818761586,0.152,0.356,0.5,0.01,1.106,91.99029285016269,1878.339437592536,116.83333333333333,93.50000000000001,110.60000000000001,FALSE,440,1.3037037037037038,0,1,0,0,3,FALSE
379,2022-03-18T21:11:41Z,2022-03-18T21:37:01Z,1520,1,2022-03-18T21:37:03Z,1,Chrome,99.0.4844.51,Macintosh,1280,800,"the question ""are you currently sick?"" was too vague. If you're doing a study relating to possible childhood trauma, you have to expect that several of your participants are chronically ill from the stress they have endured. I selected ""yes"" to the question but I am sick with chronic illnesses, one of which is flaring badly today. I am not sick with the flu or a cold or anything acute.",1.6,548,98,340,88,55,83,-0.26700563879273514,-0.10985387631916742,-0.2591622398982543,-0.12478151042141572,-0.12080228302533408,-0.1751000739088019,3,3,2,3,3,1,2,3,1,3,3,2,2,2,3,3,2,1,3,3,0.44721359549995793,1,1,2,3,2,2.4,0,5,3,5,4,5,4,4,5,4,3,5,5,4,5,3,5,5,1,1,5,5,5,5,2,2,0,0,0,0,3,3,3,3,3,3,5,4,4,5,2,5,4,3,5,3,5,5,5,5,5,5,2,1,1,1,1,2,2,2,1,2,3,4,3,1,5,1,5,4,5,1.4719601443879744,1.52127765851133,4,0,3.75,0,4.266666666666667,0,3.4444444444444446,0,4.333333333333333,0,1.8333333333333333,0,2.2857142857142856,0,3,0,3.2162162162162162,0,1,0,0,1.9496762033564343,2.115879368172409,0.5480754749809131,1.331977421576661,2,2,1,1,1,2,2,8,7,1.5118578920369088,1.5714285714285714,0,7.5,1.888047297529404,5,5,5,5,2,3,5,7,7,6,4,1.7043362064926932,7,4.285714285714286,0,1.384971609293624,0,1.2989850639765426,3,3,3,3,3,3,3,4,3,2,5,5,2,3,4,2,2,3,3,3,1,3,0,3.6,0,2.4,0,3.4,0,3.1333333333333333,0,2,2,2,3,3,2,4,2,2,3,3,3,4,1,2,2,2,2,4,3,0.8255779474818965,2.55,0,I lived with my mother and father an equal amount of time (joint custody),0,"White, Caucasian, Anglo, European American",0,28,1,2,NA,1,1,4,Dog Care & Training,2,186,67,2,5,2,0,0,1,0,0,TRUE,TRUE,TRUE,TRUE,TRUE,4,0.6201875000037252,0.5660968749970198,0.5777562500014901,0.6759312500022352,0.6469580645368945,0.6294548386989102,1,1,1,1,1,1,0.119,0.387,0.63,0.02,1.415,177.1401934084297,1966.550406665099,0.109,0.405,0.677,0.017,1.545,33.747784708275375,1816.2715412044906,0.103,0.423,0.551,0.016,1.418,68.86362723191017,1855.5461241152027,70.75,90.88235294117646,88.625,FALSE,354,1.0488888888888888,0,1,0,0,3,FALSE
380,2022-03-18T20:58:29Z,2022-03-18T21:37:09Z,2319,1,2022-03-18T21:37:11Z,0.8999999761581421,Chrome,99.0.4844.74,Windows NT 10.0,1920,1080,Very good questions.,1.7777777777777777,850,449,554,203,62,76,0.35393649230433555,1.8282823701690007,0.5183574495748839,1.2934750649782265,0.02273881544315432,-0.25376763186643136,3,2,3,2,3,1,2,3,2,2,3,3,2,2,2,3,3,2,3,3,0.5501196042201808,0,1,4,3,3,2.45,0,3,2,2,2,1,1,2,1,1,1,1,2,1,2,3,2,3,2,2,3,2,3,3,0,1,1,0,2,1,2,1,2,1,1,2,3,2,2,1,2,1,2,2,1,2,1,4,1,1,1,4,2,4,4,3,3,1,1,2,2,2,1,1,1,1,1,2,2,2,2,1.4806053465364064,1.3972762620115438,2.5,0,2,0,1.6666666666666667,0,1.7777777777777777,0,1.5833333333333333,0,3.3333333333333335,0,1.4285714285714286,0,1,0,1.837837837837838,0,0,1,0,0.08106174923752274,-0.2759833121299669,0.4250073537293794,0.07451202079970626,1,1,2,1,1,1,2,1,1,1.6761634196950514,1.2857142857142858,0,1,-0.7920494875423887,4,5,5,5,2,2,5,3,7,5,4,1.7182493859684491,5,4,0,0.8098866971415565,0,0.7939015230401045,3,2,2,2,2,5,3,5,5,1,5,3,5,3,4,2,4,4,3,1,1.4074631010979937,2.2,0,4.2,0,2.8,0,3.6,0,3.533333333333333,0,2,2,2,2,3,2,1,2,1,1,3,2,1,2,1,3,3,2,2,1,0.7947194142390263,1.9,0,"I lived with my father, but not mother, most of the time. & I lived with my mother and father an equal amount of time (joint custody) & I lived with my extended family on father's side (grandparents, aunts ,uncles, cousins)",1,"White, Caucasian, Anglo, European American",0,22,0,1,NA,1,4,3,Student,5,195,68,1,5,2,1,0,0,0,1,TRUE,TRUE,TRUE,TRUE,TRUE,5,0.5508999999843794,0.4490968750156462,0.435234375,0.6049607142720904,0.5295812499932945,0.5281290322465282,0.9354838709677419,1,1,0.875,1,0.96875,0.065,0.338,0.677,0.015,1.592,86.23713233882445,1916.6400797794263,0.156,0.248,0.79,0.012,1.343,29.68934454462706,1816.2311110882208,0.051,0.377,0.289,0.016,1.642,118.55184291189062,2065.9282585032997,106.13333333333334,111.91666666666666,102.62499999999999,FALSE,326,0.965925925925926,0,1,0,3,6,FALSE
381,2022-03-18T21:19:05Z,2022-03-18T21:38:33Z,1167,1,2022-03-18T21:38:33Z,0.8999999761581421,Chrome,99.0.4844.74,Windows NT 10.0,1536,864,NA,1.7777777777777777,617,64,274,65,37,61,-0.12513475453545742,-0.2975935697111837,-0.49895803197875493,-0.4084328255013442,-0.4899079648014471,-0.42234097034706597,3,2,1,1,3,1,1,3,1,3,2,1,1,2,3,3,1,1,3,3,0.6708203932499369,0,1,1,3,3,1.95,0,2,1,2,2,2,1,1,2,2,2,2,2,2,2,2,1,1,1,1,2,2,2,1,0,2,0,0,0,0,1,1,1,1,3,2,2,2,2,2,2,3,2,3,2,2,3,4,4,3,3,2,1,1,1,3,4,1,1,3,3,2,2,2,1,1,1,2,2,2,2,1.3322067312451078,1.3093073414159542,1.375,0,2,0,1.8,0,1.6666666666666667,0,2.75,0,2,0,2,0,1,0,2.081081081081081,0,0,0,0,-0.4913659180453832,-0.6027453449635795,-0.274357657721105,-0.4385515013423422,2,1,4,2,1,2,3,3,3,1.0690449676496976,2.142857142857143,0,3,0.47916653020310074,4,4,5,4,3,3,5,3,3,3,3,1.2724180205607036,3,4,0,-0.3222341343576166,0,0.10433859441092333,3,3,3,3,3,4,3,5,3,1,2,2,5,4,5,2,2,3,4,2,1.3020130933435712,3,0,2.6,0,3,0,3.8,0,3.1333333333333333,0,2,3,3,2,1,3,3,4,2,2,3,3,2,3,2,3,1,3,2,2,0.7163503994113789,2.45,0,I lived with my mother and father an equal amount of time (joint custody),0,"White, Caucasian, Anglo, European American",0,27,0,1,NA,1,2,3,Self Employed,2,110,70,3,5,2,0,0,0,0,0,TRUE,TRUE,TRUE,TRUE,TRUE,5,0.5652312500327825,0.4101281249076128,0.46843437503278257,0.619222580709765,0.44261999991734824,0.5148812500685453,1,1,1,0.96875,0.9375,1,0.07,0.34,0.54,0.04,1.85,96.0134403441342,1882.627849035469,0.045,0.341,0.741,0.034,1.731,79.65671575002841,1937.5906687434974,0.071,0.41,0.447,0.026,1.569,64.47358161966481,1889.7990961425678,46.25,50.911764705882355,60.34615384615385,FALSE,420,1.2444444444444445,0,1,0,3,6,FALSE
382,2022-03-18T21:12:34Z,2022-03-18T21:39:37Z,1622,1,2022-03-18T21:39:39Z,0.8999999761581421,Chrome,99.0.4844.74,Windows NT 10.0,1536,864,N/A,1.7777777777777777,602,96,564,68,53,106,-0.1559762511131265,-0.12089738769516838,0.5546901453446568,-0.37143482788222304,-0.1618140254449022,0.08337904509483783,4,4,4,3,4,1,2,4,2,4,4,2,2,2,4,4,3,1,4,4,0.8825799501580878,0,1,1,3,2,3.1,0,4,3,4,3,3,2,4,3,3,4,3,4,2,4,3,2,3,1,1,2,4,2,3,0,2,0,0,0,0,2,1,2,2,4,2,1,1,3,2,2,3,1,4,2,4,3,2,3,3,3,3,1,1,1,3,3,1,1,1,1,2,2,2,3,4,3,2,2,1,2,1.244205790071742,0.7037315505489968,2.25,0,1.75,0,3.2666666666666666,0,2,0,2.6666666666666665,0,2,0,1.4285714285714286,0,3.3333333333333335,0,2.2162162162162162,0,0,0,0,0.16440370845878854,0.47862753348097037,-0.3605105619019602,0.059058485789505094,3,2,4,1,1,2,2,1,1,0.6900655593423543,2.142857142857143,0,1,-0.29444196550774376,2,3,3,2,1,1,2,3,4,2,2,1.1126972805283737,3.5,2,0,-0.788955151249163,0,-1.2635737369628302,2,3,2,2,2,4,4,4,4,3,5,3,4,3,3,4,3,4,3,4,0.7432233529572065,2.2,0,3.8,0,3.6,0,3.6,0,3.6666666666666665,0,2,1,3,4,2,4,4,4,3,2,3,3,2,4,2,4,1,4,4,3,1.145931016569864,2.95,0,I lived with my mother and father an equal amount of time (joint custody),0,"Hispanic of Latino (e.g., Mexican American, Central American, and others) & White, Caucasian, Anglo, European American",1,21,0,1,NA,1,2,4,"Student, unemployed",2,170,66,1,5,2,0,0,2,0,0,TRUE,TRUE,TRUE,TRUE,TRUE,6,0.6429562499999738,0.6802375000000029,0.5439093749999884,0.6941499999999869,0.7275709677419641,0.5897062499999957,1,1,1,1,1,1,0.16,0.306,0.678,0.032,1.715,56.468710279493195,1842.5585847499744,0.095,0.32,0.297,0.207,1.815,73.76415411020709,1856.8797510554386,0.21,0.31,0.636,0.018,1.358,21.306382677215442,1803.666693610241,53.59375,8.768115942028986,75.44444444444446,FALSE,376,1.114074074074074,0,1,0,3,6,FALSE
383,2022-03-18T21:11:11Z,2022-03-18T21:40:59Z,1788,1,2022-03-18T21:41:00Z,1,Safari,15.3,Macintosh,1440,900,The study was very simple yet interesting,1.6,661,134,573,95,60,94,-0.0346663645742948,0.08892932844884985,0.5873895715374523,-0.03845284931013314,-0.018272926976413795,-0.05147962568966986,1,3,1,2,2,1,1,3,1,3,2,1,2,2,3,3,3,2,2,2,0.8522416262267903,0,1,1,3,3,2,0,4,3,2,4,2,1,3,1,2,1,1,5,1,4,4,2,1,3,1,1,2,3,2,1,2,0,0,0,0,2,4,4,5,4,3,2,2,3,1,2,2,3,4,1,3,2,3,2,3,2,5,1,1,2,2,2,1,2,1,1,3,2,1,1,1,1,2,2,3,2,0.9984973695493629,0.7037315505489968,1.875,0,2.25,0,2.533333333333333,0,3.2222222222222223,0,2.3333333333333335,0,2.1666666666666665,0,1.5714285714285714,0,1,0,2.27027027027027,0,1,0,0,-0.04395118959437628,0.01832868434039202,0.031158049895781924,0.024743367118086973,2,1,4,1,1,2,2,3,3,1.0690449676496976,1.8571428571428572,0,3,0.3132973561915524,2,4,3,3,1,1,4,5,3,1,2,1.1126972805283737,4,2.5714285714285716,0,-0.9124655511234351,0,-1.0291919256060862,1,1,2,2,2,5,3,2,5,4,5,4,4,4,4,5,4,4,4,3,1.3201731488169053,1.6,0,4.4,0,4,0,3.6,0,4,0,2,1,1,3,1,2,2,2,1,1,2,3,1,2,1,3,1,1,1,2,0.6048053188292994,1.65,0,I lived with my mother and father an equal amount of time (joint custody),0,Black or African American,0,21,0,1,NA,1,3,3,DayTrader,2,135,69,3,5,2,0,0,1,0,0,TRUE,TRUE,TRUE,TRUE,TRUE,4,0.4816451612903169,0.4295312499999955,0.5149374999999909,0.5097419354838691,0.5007333333333353,0.5926000000000117,0.96875,1,1,0.96875,0.9375,0.9375,0.067,0.349,0.429,0.021,2.064,41.24843894913052,1884.244775902078,0.058,0.337,0.654,0.02,1.811,71.12370354341506,1920.4029696025632,0.047,0.394,0.51,0.049,1.761,158.29321088523864,2027.499802514892,98.28571428571428,90.55,35.93877551020408,FALSE,436,1.2918518518518518,0,1,0,0,3,FALSE
384,2022-03-18T21:26:59Z,2022-03-18T21:46:56Z,1196,1,2022-03-18T21:46:57Z,0.8999999761581421,Chrome,99.0.4844.74,Macintosh,1440,900,This study was easy to complete and easy to answer. There were no technical issues.,1.6,613,67,258,67,44,61,-0.13335915362283585,-0.28102830264718226,-0.5570903452103915,-0.3837674937552634,-0.3463668663329587,-0.42234097034706597,3,2,1,1,3,1,1,3,1,2,3,1,1,1,3,3,1,1,3,3,0.6805570473787206,0,0,4,2,3,1.9,0,4,3,1,2,2,2,3,4,2,2,3,3,4,3,4,2,3,1,1,1,1,2,1,0,2,0,0,0,0,2,4,3,2,2,1,2,2,2,1,2,4,1,3,2,2,3,1,3,2,2,2,1,1,1,3,2,1,1,1,1,2,3,1,1,1,2,2,2,1,1,1.3254270092150517,0.8997354108424374,1.5,0,1.5,0,2.8,0,2.2222222222222223,0,2.1666666666666665,0,1.6666666666666667,0,1.4285714285714286,0,1.3333333333333333,0,1.8918918918918919,0,0,0,0,-0.5330368976560161,-0.19416988711715735,-0.4466634660828154,-0.32041667659998635,2,1,3,1,1,2,2,2,1,1.1547005383792515,1.7142857142857142,0,1.5,-0.3498436025973552,4,5,4,4,2,2,5,6,4,3,3,1.4638501094227998,5,3.7142857142857144,0,0.03902547546461973,0,0.16957268460886432,3,2,3,2,2,3,3,2,4,3,5,4,5,3,2,3,3,5,4,3,1.0465362369445672,2.4,0,4,0,3.6,0,2.8,0,3.466666666666667,0,1,2,1,1,1,1,2,1,1,1,2,2,2,1,1,2,1,1,1,1,1.0310954828418375,1.3,0,I lived with my mother and father an equal amount of time (joint custody),0,"White, Caucasian, Anglo, European American",0,20,1,2,NA,1,3,4,Student,4,140,63,3,5,2,0,0,1,0,0,TRUE,TRUE,TRUE,TRUE,TRUE,5,0.5219516129041871,0.43554193548521686,0.4543968749996275,0.5888645161265327,0.4793499999980132,0.5471935483890195,1,0.96875,1,0.96875,0.967741935483871,0.96875,0.073,0.312,0.513,0.018,1.831,62.88911624906869,1887.6368722631005,0.054,0.307,0.412,0.037,2.154,119.52921596055344,1988.5590788630564,0.068,0.386,0.552,0.02,1.759,80.1009334256796,1900.7933195352757,101.72222222222223,58.21621621621622,87.94999999999999,FALSE,386,1.1437037037037037,0,1,0,0,3,FALSE
385,2022-03-18T21:24:24Z,2022-03-18T21:47:04Z,1359,1,2022-03-18T21:47:05Z,0.8999999761581421,Chrome,99.0.4844.51,Windows NT 10.0,1536,864,NA,1.7777777777777777,563,50,355,37,27,261,-0.2361641422150661,-0.37489814934319043,-0.2046631962435951,-0.7537474699464745,-0.6949666768992877,1.8253035427280622,1,2,2,2,2,2,1,2,2,2,2,2,2,2,2,1,2,2,2,2,0.7591546545162482,0,1,1,3,3,1.85,0,1,1,1,1,1,1,1,1,1,1,1,1,1,1,1,1,1,1,1,1,1,1,1,0,2,0,0,0,0,1,1,1,1,1,1,1,1,1,1,1,1,1,1,1,1,1,1,1,1,1,1,1,1,1,1,1,1,1,1,1,1,1,1,1,1,1,1,1,1,1,1.9666895707934864,2.065591117977289,1,0,1,0,1,0,1,0,1,0,1,0,1,0,1,0,1,0,0,0,0,-1.4366391923707953,-1.587751448753618,-0.6189692744445258,-1.103360361599072,1,1,1,1,1,1,1,2,1,1.9518001458970664,1,0,1.5,-0.7645165376262261,5,5,5,5,3,3,5,6,6,6,4,1.5735915849388864,6,4.428571428571429,0,1.2043418043825058,0,1.2663680188775723,1,1,1,1,1,4,4,4,4,4,3,5,5,4,2,3,4,4,5,4,1.2535663410560174,1,0,4,0,4.2,0,3.6,0,3.933333333333333,0,2,2,1,2,3,2,2,1,1,1,2,2,2,2,1,2,1,2,2,2,0.8255779474818965,1.75,0,I lived with my mother and father an equal amount of time (joint custody),0,"White, Caucasian, Anglo, European American",0,29,0,1,NA,1,4,6,Engineer,4,145,65,2,5,2,0,0,1,0,0,TRUE,TRUE,TRUE,TRUE,TRUE,3,0.457712499987334,0.3648656250052154,0.3756593749932945,0.507828571417502,0.4052518518500858,0.4459466666976611,1,1,1,0.9032258064516129,0.84375,0.9375,0.056,0.284,0.628,0.018,1.57,61.56690949260089,1905.7088516802246,0.034,0.301,0.399,0.041,1.33,117.67601666989242,2087.2325889814133,0.057,0.348,0.592,0.019,1.682,137.7442244317538,2038.2742110831082,87.22222222222223,32.4390243902439,88.52631578947368,FALSE,304,0.9007407407407407,1,1,0,0,3,FALSE
386,2022-03-18T21:06:16Z,2022-03-18T21:50:05Z,2629,1,2022-03-18T21:50:06Z,1,Firefox,98.0,Macintosh,1440,900,NA,1.6,1041,330,419,66,34,71,0.7466515487266552,1.1711934432969437,0.027866056682950932,-0.3961001596283038,-0.5514255784307993,-0.3099587446933096,1,2,2,1,2,1,2,2,1,2,2,1,1,1,2,2,1,1,3,2,1.0208355710680808,0,1,1,3,3,1.6,0,4,2,4,4,5,2,4,4,3,3,1,4,4,4,4,3,4,5,1,2,4,4,3,2,1,1,0,1,0,3,5,5,5,5,5,5,5,5,5,5,1,4,4,3,4,5,3,3,2,2,4,1,1,1,3,1,1,5,5,1,4,4,1,3,1,1,2,2,2,1,1.3819949022734888,1.1464230084422218,3.25,0,1.75,0,3.466666666666667,0,4.777777777777778,0,3.4166666666666665,0,1.8333333333333333,0,3,0,1.6666666666666667,0,3.27027027027027,0,1,0,0,1.497875055999045,1.4627486362792836,-0.14114775846592847,0.6608004389066776,2,1,2,3,1,1,1,1,1,1.4638501094227998,1.5714285714285714,0,1,-0.6261803135308405,4,5,4,3,1,1,3,2,6,3,2,1.5275252316519468,4,3,0,-0.4848149464637728,0,-0.536506400332478,1,3,2,1,2,4,4,4,5,1,5,5,5,4,4,4,4,5,4,2,1.4960264830861913,1.8,0,4.6,0,3.6,0,3.8,0,4,0,1,1,1,1,2,2,2,2,1,1,2,2,1,1,1,1,1,1,1,1,1.0310954828418375,1.3,0,"I lived with my father, but not mother, most of the time.",0,"Asian or Asian American (e.g., Chinese, Japanese, and others)",0,26,1,2,NA,1,2,6,Register Nurse,3,125,62,3,5,2,0,0,1,0,0,TRUE,TRUE,TRUE,TRUE,TRUE,5,0.5594516129032258,0.5176774193548387,0.5286129032258065,0.58821875,0.6062580645161291,0.646896551724138,1,1,1,1,1,0.90625,0.061,0.391,0.375,0.015,1.605,112.03258671352312,2022.527336299888,0.071,0.349,0.411,0.046,1.879,66.49284189018475,1846.9991851209895,0.09,0.329,0.443,0.031,1.957,121.38933478851503,1902.8215506952192,107,40.84782608695652,63.12903225806452,FALSE,446,1.3214814814814815,0,1,0,0,3,FALSE
388,2022-03-18T21:32:38Z,2022-03-18T21:53:00Z,1221,1,2022-03-18T21:53:03Z,0.8999999761581421,Chrome,99.0.4844.51,Macintosh,1280,800,NA,1.6,564,55,221,241,37,61,-0.23410804244322148,-0.347289370903188,-0.6915213195585509,1.7621163681537606,-0.4899079648014471,-0.42234097034706597,2,2,2,2,2,1,2,2,1,3,3,3,1,1,2,2,1,2,2,2,0.8335087534664907,0,1,1,3,4,1.9,0,1,1,2,2,1,1,2,1,1,1,1,2,2,2,2,1,2,1,1,1,1,1,1,0,2,0,0,0,0,1,4,3,4,3,2,2,1,1,1,1,2,1,3,1,1,2,1,1,2,2,2,1,1,1,2,1,2,1,1,1,1,1,1,1,2,1,2,1,1,1,1.506741607001768,1.632993161855452,1.125,0,1.25,0,1.4666666666666666,0,2.3333333333333335,0,1.5,0,1.3333333333333333,0,1.1428571428571428,0,1.3333333333333333,0,1.5945945945945945,0,0,0,0,-0.9694855788410672,-1.0698292017073834,-0.5328163702636706,-0.801322785985527,1,2,3,1,1,1,1,1,1,1.5275252316519468,1.4285714285714286,0,1,-0.7091149005366146,3,3,5,5,1,1,1,6,4,2,2,1.7994708216848747,5,2.7142857142857144,0,-0.5180104438824858,0,-0.7115307802499731,3,4,3,5,3,3,5,2,3,4,5,3,2,3,4,5,3,4,4,4,1.162919151265879,3.6,0,3.6,0,4,0,3.2,0,3.6,0,2,1,1,3,2,1,2,3,1,2,2,2,2,1,1,3,1,1,1,2,0.5982430416161189,1.7,0,I lived with my mother and father an equal amount of time (joint custody),0,"White, Caucasian, Anglo, European American",0,24,1,2,NA,1,3,6,Lawyer,3,185,64,2,5,2,0,0,0,0,0,TRUE,TRUE,TRUE,TRUE,TRUE,1,0.6261687499999534,0.568890625,0.6264968750000116,0.7336812499997905,0.6482906250000233,0.7323156249999302,1,1,1,1,1,1,0.195,0.378,0.797,0.007,1.239,92.57038129224186,1878.2864410824748,0.148,0.405,0.865,0.013,1.238,124.80547668874954,1909.8531955337273,0.092,0.506,0.75,0.011,1.414,15.631813304330924,1796.706526610273,177,95.23076923076924,128.54545454545453,FALSE,432,1.28,0,1,0,0,3,FALSE
389,2022-03-18T21:40:46Z,2022-03-18T21:57:01Z,975,1,2022-03-18T21:57:03Z,0.8999999761581421,Chrome,99.0.4844.74,Windows NT 10.0,1463,915,NA,1.5989071038251366,496,45,247,51,25,76,-0.37392282692865464,-0.4025069277831928,-0.5970563105571416,-0.5810901477239093,-0.7359784193188558,-0.25376763186643136,2,2,1,2,2,1,1,3,1,2,2,1,2,2,2,2,2,2,3,3,0.7880689256524124,0,1,2,3,3,1.9,0,5,4,3,3,3,3,4,3,3,4,4,5,1,4,5,4,4,1,1,4,4,4,4,1,2,0,0,0,0,3,3,4,3,5,3,2,2,5,1,5,4,3,4,3,2,5,5,5,5,2,3,1,1,1,3,1,1,2,1,1,2,2,3,1,1,3,1,4,2,1,1.3868754174126179,1.0555973258234952,3.25,0,2,0,3.6,0,3.3333333333333335,0,3.6666666666666665,0,1.6666666666666667,0,1.7142857142857142,0,1.6666666666666667,0,2.72972972972973,0,1,0,0,1.1469615434884515,1.284961770386063,-0.05499485428507328,0.6149834580504948,2,1,3,1,1,1,1,3,1,1.2535663410560174,1.4285714285714286,0,2,-0.32231065268119236,5,5,5,5,3,3,5,1,5,4,3,1.5735915849388864,3,4.428571428571429,0,-0.10840883202778547,0,0.4667853699087434,4,4,4,2,4,2,2,2,3,2,2,2,4,3,3,3,2,2,2,1,1,3.6,0,2,0,2.6,0,2.4,0,2.3333333333333335,0,1,1,1,4,1,1,1,4,1,1,1,1,1,1,1,2,1,1,1,1,0.7863975156570492,1.35,0,I lived with my mother and father an equal amount of time (joint custody),0,"Asian or Asian American (e.g., Chinese, Japanese, and others)",0,25,0,1,NA,1,4,6,Software engineer,6,190,68,4,5,2,0,0,1,0,0,TRUE,TRUE,TRUE,TRUE,TRUE,2,0.5089156249947846,0.4218218749947846,0.44425806451612904,0.530653333334128,0.4881000000025545,0.5170535714264427,1,1,1,0.9375,0.875,0.9032258064516129,0.062,0.323,0.595,0.019,1.949,107.67275882113282,1961.6776100663026,0.05,0.329,0.573,0.017,1.56,128.5503414576631,2031.4855759898423,0.053,0.37,0.42,0.034,1.924,79.9815636160111,1924.3102814448505,102.57894736842105,91.76470588235294,56.58823529411764,FALSE,440,1.3037037037037038,0,1,0,3,6,FALSE
390,2022-03-18T21:38:25Z,2022-03-18T22:00:51Z,1345,1,2022-03-18T22:00:52Z,0.8999999761581421,Chrome,99.0.4844.74,Windows NT 10.0,1280,720,"no, it went well",1.7777777777777777,523,134,409,56,77,100,-0.3184081330888503,0.08892932844884985,-0.008466639086821888,-0.5194268183587075,0.3303268835899152,0.015949709702583987,1,1,1,1,1,1,1,1,1,1,2,1,1,1,1,1,1,1,1,1,1.5035046776746235,0,1,1,5,5,1.05,0,3,3,3,2,3,2,3,3,3,1,3,3,3,3,3,3,3,1,2,2,2,3,2,0,2,0,0,0,0,1,2,3,1,1,1,2,1,1,2,1,1,1,3,3,3,4,4,3,5,5,2,1,2,1,2,1,2,1,1,1,1,1,1,1,1,1,1,1,1,1,1.6693671815352027,0.6399404734221844,2.25,0,1,0,2.7333333333333334,0,1.4444444444444444,0,2.9166666666666665,0,1.5,0,1.1428571428571428,0,1,0,1.837837837837838,0,0,0,0,-0.08123575029862688,0.08057375409172465,-0.6189692744445258,-0.26919776017640057,1,1,2,1,1,1,1,3,1,1.7320508075688772,1.1428571428571428,0,2,-0.48817982669274074,5,5,5,5,3,2,5,6,6,4,4,1.7043362064926932,6,4.285714285714286,0,0.7766911997228434,0,0.9284878440853178,1,1,1,3,1,5,5,5,5,3,5,5,3,5,5,5,5,5,5,4,1.869555587629877,1.4,0,5,0,4.2,0,4.8,0,4.666666666666667,0,1,2,1,2,3,1,2,2,2,2,3,2,1,2,1,2,2,2,1,1,0.8255779474818965,1.75,0,I lived with my mother and father an equal amount of time (joint custody),0,"White, Caucasian, Anglo, European American",0,20,1,2,NA,1,4,4,full time student,1,140,68,4,5,2,0,0,1,0,0,TRUE,TRUE,TRUE,TRUE,TRUE,1,0.6526343749891966,0.5469548387104465,0.5921125000081956,0.7037249999940396,0.5941000000033527,0.7267906250040979,1,1,1,1,1,1,0.139,0.319,0.493,0.016,1.86,43.22170367091414,1826.053502550967,0.077,0.411,0.594,0.037,1.777,48.56009568843734,1835.3283029391228,0.143,0.301,0.404,0.057,1.863,37.749225410810574,1820.1312041122148,116.25,48.027027027027025,32.68421052631579,FALSE,374,1.108148148148148,0,1,0,0,3,FALSE
391,2022-03-18T21:44:59Z,2022-03-18T22:05:24Z,1224,1,2022-03-18T22:05:25Z,1,Chrome,99.0.4844.51,Windows NT 10.0,1536,864,NA,1.7777777777777777,508,79,349,75,45,88,-0.34924962966651935,-0.2147672343911765,-0.22646281370545882,-0.2851061667709405,-0.3258609951231747,-0.1189089610819237,2,2,2,1,1,1,1,3,1,1,3,1,2,1,2,2,1,1,2,2,1.0711528467275955,0,1,1,4,4,1.6,0,1,1,1,1,2,2,2,1,2,2,1,1,1,2,1,2,1,1,1,1,1,2,2,0,1,2,0,1,0,2,4,1,1,1,1,1,1,1,1,1,3,2,1,2,1,2,2,3,2,2,2,1,1,1,1,1,1,1,1,1,2,3,2,1,2,1,2,1,1,1,1.643989873053573,1.7320508075688772,1.375,0,1.25,0,1.4,0,1.4444444444444444,0,1.8333333333333333,0,1.1666666666666667,0,1.5714285714285714,0,1.3333333333333333,0,1.5405405405405406,0,0,0,0,-0.8422794305559772,-1.013385805124027,-0.5328163702636706,-0.7731010876938488,1,1,2,1,1,1,1,1,1,1.7320508075688772,1.1428571428571428,0,1,-0.874984074548163,5,5,5,4,2,2,4,6,6,NA,3,1.5118578920369088,6,3.857142857142857,0,0.40966740893729353,1,0.47272947549438354,2,2,2,2,2,3,4,5,5,3,3,2,4,3,5,1,4,4,4,3,1.2535663410560174,2,0,3.2,0,3.2,0,4.2,0,3.533333333333333,0,1,2,1,2,3,2,2,4,1,1,3,1,1,2,1,2,1,3,1,1,0.9880869341680844,1.75,0,I lived with my mother and father an equal amount of time (joint custody),0,"White, Caucasian, Anglo, European American",0,18,1,3,NA,1,2,4,Student,7,130,61,1,5,2,0,0,0,0,0,TRUE,TRUE,TRUE,TRUE,TRUE,5,0.42678749999590215,0.4212000000034609,0.42399032257641517,0.5494793103501714,0.44925312500633297,0.4657516128997649,1,1,1,0.9354838709677419,1,0.96875,0.056,0.336,0.691,0.04,2.1,167.12822470957568,2002.4635354583763,0.07,0.333,0.826,0.014,0.858,16.449895481304868,1799.5355492068772,0.07,0.32,0.663,0.016,1.98,127.20468558535646,1976.7259190949462,52.5,61.285714285714285,123.75,FALSE,388,1.1496296296296296,0,1,0,0,3,FALSE
392,2022-03-18T21:41:47Z,2022-03-18T22:10:40Z,1733,1,2022-03-18T22:10:42Z,1,Chrome,98.0.4758.102,Windows NT 10.0,1536,864,NA,1.7777777777777777,585,213,492,126,90,111,-0.19092994723448478,0.5251480278008878,0.2930947358022925,0.34385979275411827,0.5969032093171079,0.13957015792171604,1,1,2,1,2,1,1,2,1,1,2,1,1,1,1,2,1,1,3,2,1.2396943596157715,0,1,1,3,3,1.4,0,2,3,2,3,1,1,2,2,2,2,2,2,2,2,1,2,2,3,1,2,2,3,2,3,2,0,0,0,0,1,1,1,1,1,1,1,1,1,2,1,1,1,1,2,1,3,2,1,1,1,4,2,2,1,5,2,1,3,2,1,2,3,3,2,3,1,2,2,2,2,1.6499158227686108,1.2227992865708155,2.125,0,2,0,1.9333333333333333,0,1,0,1.4166666666666667,0,2.6666666666666665,0,2.142857142857143,0,2,0,1.7027027027027026,0,2,0,0,-0.25011287819435013,-0.382281764580504,0.16436794915095845,-0.10895690771477277,3,2,3,2,1,2,2,1,2,0.6900655593423543,2.142857142857143,0,1.5,-0.10103984158003264,3,4,4,3,1,2,3,7,9,NA,2,1.0690449676496976,8,2.857142857142857,0,0.4367408981447365,1,-0.0525990727688771,3,2,2,3,2,4,4,3,5,2,5,3,2,3,4,5,4,4,3,4,1.121223821162776,2.4,0,4,0,3.2,0,3.8,0,3.6666666666666665,0,1,1,2,2,3,4,2,2,2,2,3,2,1,4,2,2,2,3,2,2,0.8825799501580878,2.2,0,NA,NA,"White, Caucasian, Anglo, European American",0,29,1,3,NA,1,2,4,Baker,3,316,67,1,5,2,0,0,0,0,0,TRUE,TRUE,TRUE,TRUE,TRUE,3,0.5832343749850989,0.5153906249701977,0.5386437500268221,0.639865625038743,0.5819258063993147,0.6417718750536442,1,1,1,1,1,1,0.146,0.37,0.895,0.008,1.199,107.12978279774124,1888.8521558940085,0.141,0.327,0.724,0.027,1.685,73.67701484579118,1856.152445875837,0.201,0.277,0.666,0.015,1.264,48.97864310910833,1831.994548533525,149.875,62.40740740740741,84.26666666666667,FALSE,382,1.1318518518518519,0,1,0,0,3,FALSE
393,2022-03-18T21:52:57Z,2022-03-18T22:14:52Z,1314,1,2022-03-18T22:14:53Z,0.8999999761581421,Firefox,98.0,Windows NT 10.0,1920,1080,"I'm curious as to why Filipino was a separate option for race/ethnicity. I've only seen it once before. I'm Filipino and sometimes I mark ""other"" and type in Filipino. I would love if someone could message me on Prolific because I'm very curious.",1.7777777777777777,535,77,338,69,54,84,-0.29373493582671506,-0.22581074576717747,-0.2664287790522089,-0.3591021620091827,-0.14130815423511814,-0.16386185134342626,4,4,2,2,4,1,2,4,3,4,3,2,4,2,4,3,2,2,3,3,0.7677718959499145,0,1,1,2,2,2.9,0,4,3,4,4,4,4,4,2,4,2,1,5,1,4,5,3,4,1,1,2,4,3,3,0,2,0,0,0,0,4,3,4,4,4,3,5,4,4,3,2,4,1,4,3,3,3,4,4,5,3,3,2,1,1,2,1,1,1,1,1,4,3,3,1,1,3,1,2,1,1,1.1021409686218524,1.1751393027860062,2.625,0,1.25,0,3.4,0,3.888888888888889,0,3.25,0,1.6666666666666667,0,2,0,1.6666666666666667,0,2.7837837837837838,0,0,0,0,0.776309145899137,0.9483663931999491,-0.5328163702636706,0.20777501146813926,2,2,3,2,1,2,2,1,2,0.9511897312113419,2,0,1.5,-0.1839744285858068,4,4,4,4,3,3,4,6,6,3,3,0.7867957924694432,6,3.7142857142857144,0,0.2196552803757379,0,0.2795924049485119,4,2,4,3,4,2,3,4,4,2,4,4,5,3,3,2,3,4,2,3,0.8997354108424374,3.4,0,3.4,0,2.8,0,3.4,0,3.2,0,2,1,1,4,2,2,3,4,3,2,3,4,4,1,1,4,1,3,2,4,1.050062654772261,2.55,0,I lived with my mother and father an equal amount of time (joint custody),0,"Hispanic of Latino (e.g., Mexican American, Central American, and others) & Filipino",1,27,0,1,NA,1,3,5,Unemployed (previously retail),4,185,66,1,5,2,0,0,0,0,0,TRUE,TRUE,TRUE,TRUE,TRUE,2,0.423,0.405875,0.414125,0.527125,0.488125,0.4667,1,1,1,1,1,0.9375,0.058,0.303,0.523,0.028,1.933,160.02381565008673,2009.7230879568917,0.081,0.303,0.796,0.024,1.843,21.669532187428185,1804.974443493119,0.188,0.232,0.967,0.016,1.778,98.16173616943907,1888.7288537268466,69.03571428571429,76.79166666666666,111.125,FALSE,310,0.9185185185185185,0,1,0,3,6,FALSE
394,2022-03-18T21:30:39Z,2022-03-18T22:17:12Z,2792,1,2022-03-18T22:17:14Z,1,Edge,99.0.1150.39,Windows NT 10.0,1920,1080,My socioeconomic status changed at age 10. My parents were in high school when I was born. There was no family support so we were in debt until my father became a doctor. Wanted to explain why some of my answers don't line up with others.,1.7777777777777777,943,325,670,85,111,93,0.5451537710858838,1.1435846648569414,0.9398167205042487,-0.1617795080405368,1.0275265047225732,-0.06271784825504549,1,2,1,1,1,1,2,2,1,1,1,1,3,1,2,2,1,1,3,2,1.2182817926554552,0,1,1,4,4,1.5,0,2,1,3,2,2,1,1,1,2,1,1,2,1,3,2,2,1,1,2,1,3,1,3,7,1,1,0,1,0,1,3,3,2,2,4,2,1,2,3,3,4,1,2,2,1,1,3,4,3,1,2,1,1,1,3,1,1,3,3,3,1,1,1,3,3,2,4,4,4,4,1.3506755066722445,1.533747356112131,1.75,0,4,0,1.6666666666666667,0,2.2222222222222223,0,2.3333333333333335,0,1.5,0,1.8571428571428572,0,2.6666666666666665,0,2.108108108108108,0,4,0,0,-0.23037399311562928,-0.48543354683824114,1.2923167894698635,0.4034416213158112,4,4,4,5,3,5,5,8,8,1.3801311186847085,4.285714285714286,0,8,3.6572065745668247,2,3,3,2,1,1,2,8,7,2,2,1.1126972805283737,7.5,2,0,-0.06643593160469037,0,-0.8234948556042399,2,2,2,2,2,4,4,4,4,4,5,5,4,4,4,4,5,5,4,3,1.3627702877384937,2,0,4.8,0,4,0,3.8,0,4.2,0,2,2,3,1,2,3,2,3,1,2,3,3,1,3,2,3,1,3,2,2,0.7677718959499145,2.2,0,I lived with my mother and father an equal amount of time (joint custody),0,"White, Caucasian, Anglo, European American",0,27,0,1,NA,1,2,6,College Tutor,2,250,76,2,5,2,0,0,1,0,0,TRUE,TRUE,TRUE,TRUE,TRUE,5,0.5452499999962747,0.5011624999996275,0.545409375006333,0.6556612903206579,0.5481874999925495,0.6525387096789576,1,1,1,1,1,1,0.131,0.343,0.631,0.018,1.837,49.10557878876497,1836.4292186393404,0.062,0.387,0.537,0.041,1.572,53.08380543603817,1836.319839647337,0.099,0.394,0.611,0.008,1.175,68.33579094222073,1856.398281648408,102.05555555555556,38.34146341463415,146.875,FALSE,430,1.2740740740740741,0,1,0,6,9,FALSE
395,2022-03-18T21:58:10Z,2022-03-18T22:17:50Z,1179,1,2022-03-18T22:17:51Z,0.8999999761581421,Chrome,99.0.4844.51,Windows NT 10.0,1368,912,no additional feedback.,1.5,504,73,309,69,83,76,-0.3574740287538978,-0.24789776851917938,-0.3717935967845501,-0.3591021620091827,0.4533621108486195,-0.25376763186643136,2,2,2,2,3,1,1,2,1,2,3,2,2,2,2,2,2,1,2,2,0.7677718959499145,0,1,1,3,4,1.9,0,2,2,2,2,2,2,2,2,2,2,2,2,2,2,2,2,2,2,2,1,1,2,1,2,2,0,0,0,0,1,1,2,2,2,1,2,2,2,1,5,1,1,2,3,2,2,2,3,3,3,2,4,1,1,2,1,1,3,1,1,2,2,1,1,3,1,2,2,2,2,1.4379038798082324,1.0327955589886444,1.625,0,2,0,2,0,1.6666666666666667,0,2.3333333333333335,0,1.8333333333333333,0,1.5714285714285714,0,1.6666666666666667,0,1.8918918918918919,0,1,0,0,-0.45188814788794135,-0.48887521736161643,-0.05499485428507328,-0.2719350358233449,1,2,3,1,1,2,2,2,1,1.3801311186847085,1.7142857142857142,0,1.5,-0.3498436025973552,4,5,4,4,3,4,4,5,2,3,3,0.9511897312113419,3.5,4,0,-0.23191923190205752,0,0.15934845458074715,2,2,2,2,2,4,5,4,4,3,4,3,2,4,4,5,4,4,3,4,1.1254628677422756,2,0,3.8,0,3.6,0,4,0,3.8,0,2,1,2,3,2,2,4,2,2,2,3,2,2,2,1,2,1,3,1,4,0.910465468000326,2.15,0,NA,NA,"Hispanic of Latino (e.g., Mexican American, Central American, and others)",0,29,1,2,NA,1,3,6,Instructional Assistant,3,240,65,3,5,2,0,0,1,0,0,TRUE,TRUE,TRUE,TRUE,TRUE,2,0.6721937500238419,0.5240937501192093,0.5896968749761582,0.7109468749761582,0.5717375000715256,0.6425437500476837,1,1,1,1,1,1,0.295,0.18,0.713,0.036,1.812,49.726508073642975,1832.4966590931595,0.128,0.319,0.629,0.017,1.318,70.14774296833428,1855.821036094941,0.245,0.258,0.603,0.03,1.429,48.65120610527465,1830.8134250327378,50.333333333333336,77.52941176470588,47.63333333333334,TRUE,396,1.1733333333333333,0,1,0,0,3,FALSE
396,2022-03-18T21:46:15Z,2022-03-18T22:20:43Z,2067,1,2022-03-18T22:20:43Z,0.8999999761581421,Chrome,99.0.4844.51,Macintosh,1920,1080,no,1.7777777777777777,620,82,648,291,73,96,-0.1189664552199236,-0.19820196732717507,0.8598847898107485,2.378749661805779,0.24830339875077895,-0.029003180558918575,2,4,4,3,4,3,4,4,2,4,4,4,4,4,3,2,4,2,3,4,1.2354415362426845,0,1,2,2,1,3.4,0,4,3,5,5,5,3,5,5,4,5,5,5,1,5,5,4,4,1,1,3,5,5,5,3,2,0,0,0,0,1,3,5,5,4,3,2,1,4,5,4,5,4,4,3,1,5,5,5,5,5,4,1,1,1,1,4,1,2,3,1,4,4,5,3,2,3,4,5,2,2,1.5625112612206804,1.8073922282301278,3.5,0,3.25,0,4.333333333333333,0,3.111111111111111,0,4.25,0,2,0,2.857142857142857,0,2.6666666666666665,0,3.2162162162162162,0,2,0,0,1.6250812042841352,1.9266858228302868,0.5951324700552345,1.2609091464427606,3,3,4,3,1,2,1,1,1,0.8997354108424374,2.4285714285714284,0,1,-0.1285727914961955,4,4,5,4,2,3,4,6,7,4,4,1.1338934190276817,6.5,3.7142857142857144,0,0.8670061021784026,0,0.6738870032924332,5,5,5,5,5,1,5,1,1,5,1,4,3,5,5,5,4,4,4,1,1.2649110640673518,5,0,2.8,0,4.4,0,2.6,0,3.2666666666666666,0,4,4,4,4,4,4,3,4,3,3,4,4,3,4,1,4,3,4,4,4,1.2565617248750864,3.6,0,I lived with my mother and father an equal amount of time (joint custody),0,"Hispanic of Latino (e.g., Mexican American, Central American, and others)",0,26,1,2,NA,1,2,6,Pharmaceutical Customer Service Rep,2,180,61,3,5,2,1,0,1,0,1,TRUE,TRUE,TRUE,TRUE,TRUE,3,0.6077548387435174,0.5444406249970197,0.5771838709615892,0.6332806451705194,0.583313793108381,0.6264806451566758,0.96875,1,0.96875,0.96875,0.9354838709677419,0.96875,0.061,0.402,0.381,0.011,1.374,125.79349663208781,1994.8887089736013,0.063,0.384,0.446,0.018,1.666,67.78977417175405,1913.8902025878874,0.06,0.431,0.349,0.034,1.792,129.26949377522794,1994.912285791083,124.90909090909092,92.55555555555556,52.705882352941174,FALSE,324,0.96,0,1,0,0,3,FALSE
397,2022-03-18T22:00:05Z,2022-03-18T22:27:41Z,1655,1,2022-03-18T22:27:41Z,0.8999999761581421,Chrome,99.0.4844.74,Windows NT 10.0,1920,1080,NA,1.7777777777777777,1008,90,319,71,51,68,0.6788002562557831,-0.15402792182317124,-0.33546090101477727,-0.33443683026310195,-0.20282576786447032,-0.3436734123894365,3,4,1,1,3,3,2,4,1,4,2,2,4,2,3,4,1,1,4,4,0.8750939799154206,0,0,5,3,3,2.65,0,5,1,2,3,1,4,4,4,1,4,1,5,1,5,5,3,5,5,2,2,5,5,4,1,2,0,0,0,0,1,5,5,4,5,2,4,2,5,2,1,5,4,3,2,1,5,5,5,5,5,5,5,5,2,2,1,1,1,1,1,1,1,1,1,1,5,1,5,1,1,1.797562580616105,1.4573295865416045,3.875,0,2,0,3.066666666666667,0,3.6666666666666665,0,3.5833333333333335,0,3.3333333333333335,0,1,0,2.3333333333333335,0,2.972972972972973,0,1,0,0,1.7106163729585926,1.4311836009077548,-0.05499485428507328,0.6880943733113407,1,1,2,1,1,1,3,5,5,1.7043362064926932,1.4285714285714286,0,5,0.8381020908850744,5,5,5,5,1,1,5,3,3,5,3,2.138089935299395,3,3.857142857142857,0,0.10541647030204569,0,0.28741341872182335,3,1,3,4,3,3,4,3,3,1,1,4,2,5,2,2,3,4,1,1,1.3345232785352157,2.8,0,3,0,2,0,2.8,0,2.6,0,2,2,2,1,4,1,2,4,2,2,3,2,1,2,4,2,1,2,1,2,1.0052493799000692,2.1,0,"I lived with my mother, but not father, most of the time.",0,"White, Caucasian, Anglo, European American",0,22,0,1,NA,1,1,4,NA,1,161,74,3,5,2,0,0,1,0,0,TRUE,TRUE,TRUE,TRUE,TRUE,2,0.47891874999552964,0.4801593749988824,0.479003125006333,0.5729233333230018,0.5556033333301544,0.5935000000041106,1,1,1,0.967741935483871,0.9375,0.90625,0.06,0.354,0.46,0.011,1.484,69.2627331714444,1925.0024884407308,0.062,0.342,0.446,0.021,1.753,39.61139381605195,1880.9482230749543,0.08,0.353,0.673,0.018,1.805,89.82533622691368,1915.6047633425098,134.9090909090909,83.47619047619047,100.27777777777779,FALSE,304,0.9007407407407407,1,1,0,0,3,FALSE
398,2022-03-18T22:09:00Z,2022-03-18T22:31:13Z,1333,1,2022-03-18T22:31:14Z,1,Firefox,98.0,Windows NT 10.0,1920,1080,No,1.7777777777777777,527,94,356,68,53,150,-0.31018373400147187,-0.13194089907116932,-0.20102992666661784,-0.37143482788222304,-0.1618140254449022,0.577860837971366,2,2,1,1,2,1,1,3,1,2,2,1,1,1,2,3,1,1,3,3,0.8944271909999159,0,1,1,3,3,1.7,0,2,2,2,2,3,2,2,2,2,2,2,2,2,3,4,2,2,1,1,2,2,1,3,1,1,1,0,0,0,2,2,2,2,3,2,2,2,3,1,2,2,1,3,2,3,2,2,2,1,2,2,1,1,1,2,1,1,2,2,1,2,2,2,1,1,1,2,2,1,2,1.2030991012578505,0.9411239481143202,1.75,0,1.75,0,2.2666666666666666,0,2.2222222222222223,0,1.9166666666666667,0,1.3333333333333333,0,1.7142857142857142,0,1,0,1.7837837837837838,0,1,0,0,-0.44092210062198545,-0.365073411963627,-0.14114775846592847,-0.25311058521477775,2,2,4,1,1,1,2,3,2,1.0690449676496976,1.8571428571428572,0,2.5,0.11989523226384131,4,4,4,4,2,2,4,3,3,2,2,1.0690449676496976,3,3.4285714285714284,0,-0.8792700537047221,0,-0.5445568447258828,2,3,3,3,2,4,4,4,4,3,3,4,3,4,4,4,4,4,3,2,0.8837151016885368,2.6,0,3.8,0,3.4,0,3.6,0,3.6,0,1,1,1,1,2,1,1,2,1,1,2,1,1,2,2,2,1,1,2,1,1.019545822516343,1.35,0,I lived with my mother and father an equal amount of time (joint custody),0,"Hispanic of Latino (e.g., Mexican American, Central American, and others)",0,25,0,1,NA,1,2,6,Library Assistant,2,175,71,2,5,2,0,0,1,0,0,TRUE,TRUE,TRUE,TRUE,TRUE,3,0.54809375,0.4954375,0.53434375,0.5833,0.5582,0.6335666666666666,1,1,1,0.9375,0.9375,0.9375,0.062,0.41,0.476,0.007,1.154,87.90296669233435,1932.0699395180607,0.065,0.361,0.542,0.017,1.781,139.1967116196127,1986.1671872577651,0.058,0.414,0.48,0.026,1.96,97.57630481431136,1945.9719199933631,164.85714285714283,104.76470588235293,75.38461538461539,FALSE,436,1.2918518518518518,0,1,0,0,3,FALSE
399,2022-03-18T21:13:42Z,2022-03-18T22:31:36Z,4673,1,2022-03-18T22:31:37Z,0.8999999761581421,Chrome,99.0.4844.51,Windows NT 6.3,1920,1080,NA,1.7777777777777777,3883,79,309,60,53,66,6.590087100309023,-0.2147672343911765,-0.3717935967845501,-0.470096154866546,-0.1618140254449022,-0.3661498575201878,2,2,2,1,2,1,2,2,1,2,3,2,1,1,2,3,1,1,3,3,0.8255779474818965,0,1,1,4,4,1.85,0,3,3,4,4,3,3,5,3,4,3,3,4,2,3,4,2,3,4,1,3,4,3,3,2,2,0,0,0,0,3,2,3,2,4,2,2,2,3,1,2,3,2,3,3,2,4,3,3,3,4,4,3,3,2,3,2,1,3,1,1,2,2,3,1,2,2,3,2,2,2,1.0037467347431361,0.7988086367179802,2.875,0,2.25,0,3.4,0,2.5555555555555554,0,2.75,0,2.8333333333333335,0,1.8571428571428572,0,1.6666666666666667,0,2.4594594594594597,0,1,0,0,0.7280585379289302,0.9159163568366958,0.031158049895781924,0.4735372033662389,3,3,4,3,3,3,2,3,4,0.4879500364742666,3,0,3.5,1.170176176165457,4,4,5,2,1,1,3,5,4,2,2,1.5735915849388864,4.5,2.857142857142857,0,-0.6083253463380449,0,-0.6891379651791198,2,2,2,3,2,4,3,3,4,3,5,3,4,4,4,4,4,4,3,3,0.8837151016885368,2.2,0,4,0,3.4,0,3.6,0,3.6666666666666665,0,3,2,2,2,4,3,4,2,2,2,2,2,2,3,2,3,1,4,2,4,0.8750939799154206,2.55,0,I lived with my mother and father an equal amount of time (joint custody),0,"White, Caucasian, Anglo, European American & Native American/Alaskan Native/indigenous",1,30,0,3,NA,1,1,5,Freelancer,2,152,68,2,5,2,0,0,0,0,0,TRUE,TRUE,TRUE,TRUE,TRUE,3,0.5257093750052154,0.5173593749962747,0.5340812499895692,0.6229633333325386,0.5841199999968211,0.6266033333142599,1,1,1,0.967741935483871,0.9375,0.9375,0.061,0.422,0.568,0.01,1.434,105.82124914233783,1973.2411690872946,0.062,0.403,0.543,0.022,1.818,33.55593712323031,1877.0617476266586,0.083,0.357,0.529,0.013,1.703,82.00526039034388,1906.4281633993194,143.39999999999998,82.63636363636364,131,FALSE,322,0.9540740740740741,0,1,0,0,3,FALSE
400,2022-03-18T22:11:09Z,2022-03-18T22:33:55Z,1365,1,2022-03-18T22:33:57Z,1,Chrome,99.0.4844.57,CrOS x86_64 14469.41.0,1366,768,No feedback,1.7786458333333333,542,85,391,134,61,91,-0.2793422374238028,-0.18163670026317363,-0.07386549147241296,0.4425211197384412,0.0022329442333702625,-0.08519429338579677,2,3,1,1,3,1,1,3,1,2,3,1,1,1,3,3,1,1,3,3,0.6805570473787206,0,1,3,3,2,1.9,0,2,3,2,3,2,1,3,2,2,1,2,2,2,3,3,1,1,1,1,1,1,1,1,2,2,0,0,0,0,1,3,2,2,2,2,2,2,2,1,2,2,1,1,2,2,3,1,1,2,2,2,1,4,1,3,1,1,3,3,2,3,4,2,1,1,1,1,1,2,2,1.355114879387108,0.9154754164341269,1,0,1.5,0,2.2,0,2,0,1.6666666666666667,0,2,0,2.5714285714285716,0,1,0,1.9189189189189189,0,1,0,0,-0.8400862211027859,-0.6626304120703113,-0.22730066264678367,-0.4449655373585475,2,2,3,2,1,1,2,1,1,1.0690449676496976,1.8571428571428572,0,1,-0.4603111395192921,4,4,4,4,4,4,4,5,5,NA,2,0.7559289460184544,5,4,0,-0.3760932239552953,1,0.07153358762812576,2,2,3,3,2,3,3,4,5,2,5,3,5,3,4,4,4,4,3,3,0.990430401872025,2.4,0,3.8,0,3.4,0,3.8,0,3.6666666666666665,0,1,1,1,3,1,1,3,2,1,1,2,2,2,2,2,2,1,1,1,1,0.812727700887249,1.55,0,I lived with my mother and father an equal amount of time (joint custody),0,"White, Caucasian, Anglo, European American",0,22,0,1,NA,1,3,3,none,7,260,66,2,5,2,0,0,1,0,0,TRUE,TRUE,TRUE,TRUE,TRUE,5,0.4917250000000058,0.45495625000003204,0.5156406250000145,0.5496896551724941,0.5511466666667412,0.5803931034482566,1,1,1,0.90625,0.9375,0.90625,0.057,0.373,0.433,0.021,1.949,44.765921244600776,1898.9253054352146,0.06,0.335,0.499,0.009,1.25,84.27627647598113,1930.9781055387327,0.065,0.336,0.481,0.021,2.117,69.08677443858217,1926.0155794366567,92.80952380952381,138.88888888888889,100.8095238095238,FALSE,400,1.1851851851851851,0,1,0,0,3,FALSE
401,2022-03-18T22:02:59Z,2022-03-18T22:35:13Z,1933,1,2022-03-18T22:35:13Z,1,Chrome,97.0.4692.102,CrOS x86_64 14324.80.0,1366,768,None,1.7786458333333333,647,179,657,147,92,141,-0.06345176138011926,0.3374083344088714,0.892584216003544,0.602845776087966,0.637914951736676,0.4767168348829852,2,3,1,1,3,1,1,4,1,2,2,1,1,4,2,3,1,1,3,4,0.9665456669582609,0,1,2,2,2,2.05,0,2,2,1,1,2,2,1,2,1,1,1,2,1,3,3,2,3,1,2,1,1,2,2,1,1,3,0,0,0,1,2,4,2,3,3,3,3,3,2,2,1,1,3,3,1,2,1,1,3,3,3,3,1,1,1,1,1,2,1,1,2,2,2,1,1,1,1,1,1,1,1.244205790071742,1.5023790657297036,1.75,0,1,0,1.6666666666666667,0,2.6666666666666665,0,1.9166666666666667,0,1.6666666666666667,0,1.5714285714285714,0,1,0,1.9189189189189189,0,1,0,0,-0.353193722494337,-0.5680336393992503,-0.39960647100849406,-0.48382005520387217,2,2,3,1,1,2,2,6,1,1.0690449676496976,1.8571428571428572,0,3.5,0.5066994801192636,4,5,5,5,2,2,5,6,4,NA,4,1.7182493859684491,5,4,0,0.6535386270965279,1,0.6986715528230527,1,2,2,1,1,4,3,5,5,3,5,1,4,3,4,4,4,4,3,2,1.121223821162776,1.4,0,3.6,0,3.4,0,3.8,0,3.6,0,1,1,2,1,1,3,3,4,1,1,2,2,3,1,1,3,1,2,1,2,0.9514531821875089,1.8,0,"I lived with my extended family on mother's side (grandparents, aunts ,uncles, cousins)",0,Black or African American,0,19,1,2,NA,1,3,3,Retail,3,133,67,3,5,2,0,0,1,0,0,TRUE,TRUE,TRUE,TRUE,TRUE,5,0.5021468749998603,0.45552499999955764,0.4800096774197394,0.5890133333329112,0.5118612903229172,0.5563000000008614,1,1,1,0.9375,1,1,0.085,0.364,0.739,0.022,1.695,25.449717557820122,1806.9811796792717,0.164,0.254,0.792,0.018,1.232,115.9826018016411,1903.5607833480396,0.072,0.351,0.513,0.017,1.976,55.070208219952974,1898.0477848947692,77.04545454545455,68.44444444444444,116.23529411764704,FALSE,460,1.3629629629629632,0,1,0,0,3,FALSE
402,2022-03-18T22:01:56Z,2022-03-18T22:36:05Z,2048,1,2022-03-18T22:36:05Z,1,Opera,84.0.4316.36,Windows NT 10.0,1920,1080,NA,1.7777777777777777,1420,82,314,59,49,67,1.5259133622557604,-0.19820196732717507,-0.3536272488996637,-0.4824288207395864,-0.2438375102840384,-0.35491163495481215,3,3,1,1,3,3,2,3,2,4,4,3,1,1,3,3,3,3,3,4,0.7451598203705946,0,0,2,2,2,2.65,0,3,1,2,1,2,2,2,2,1,1,1,2,1,2,2,2,4,5,1,1,2,2,1,6,2,0,0,0,0,1,5,3,5,2,2,2,3,1,1,1,1,1,2,1,2,1,1,1,4,1,3,4,1,1,1,1,1,4,4,2,2,2,2,1,1,1,2,2,2,2,1.5156837721956706,1.486446705914413,2.25,0,2,0,1.6666666666666667,0,2.6666666666666665,0,1.4166666666666667,0,1.8333333333333333,0,2.4285714285714284,0,1,0,1.945945945945946,0,3,0,0,-0.01105304779650827,-0.3379333815507239,0.3837307525869902,0.02289868551813315,2,1,4,2,1,3,1,1,1,1.1547005383792515,2,0,1,-0.3773765525135179,5,5,5,5,1,1,4,5,1,2,2,1.9880595947760098,3,3.7142857142857144,0,-0.8792700537047221,0,-0.3897514942445284,5,5,5,5,5,2,3,2,2,3,5,3,2,2,4,1,4,5,3,4,1.1872336794093274,5,0,3.8,0,2.4,0,2.8,0,3,0,1,3,2,2,3,2,4,2,1,2,4,3,1,1,1,3,1,2,1,3,1.0208355710680808,2.1,0,"I lived with my mother, but not father, most of the time.",0,"White, Caucasian, Anglo, European American",0,24,1,2,NA,1,2,5,Student,3,150,64,1,5,2,0,0,1,0,0,TRUE,TRUE,TRUE,TRUE,TRUE,1,0.5010645161213413,0.517765625,0.5387124999966473,0.6248758620722541,0.6394964285684483,0.7063387096774194,1,1,1,0.90625,0.875,0.96875,0.114,0.305,0.537,0.008,1.784,74.808921560096593,1903.6941170684352,0.06,0.393,0.471,0.014,1.912,143.275251695861,2014.9295802725733,0.08,0.318,0.513,0.009,1.611,53.894030611942114,1909.565220859186,223,136.57142857142856,179,FALSE,278,0.8237037037037037,0,1,0,3,6,FALSE
403,2022-03-18T22:13:55Z,2022-03-18T22:38:30Z,1474,1,2022-03-18T22:38:30Z,0.8999999761581421,Chrome,99.0.4844.74,Windows NT 10.0,1280,720,none,1.7777777777777777,504,82,581,115,70,81,-0.3574740287538978,-0.19820196732717507,0.6164557281532705,0.2082004681506742,0.18678578512142677,-0.19757651903955317,3,4,3,3,3,1,4,4,2,4,4,3,3,3,3,4,3,2,3,4,0.9445132413883326,0,0,1,3,3,3.15,0,4,4,3,3,3,2,5,4,4,3,3,4,1,3,5,3,4,3,1,4,4,2,4,0,2,0,0,0,0,3,4,4,3,4,5,4,2,5,3,2,3,2,4,3,1,4,4,5,3,4,4,3,1,1,4,5,1,1,1,1,2,1,3,1,3,2,3,4,1,1,1.300842877595981,0.990430401872025,3.125,0,2.25,0,3.4,0,3.7777777777777777,0,3.1666666666666665,0,3,0,1.4285714285714286,0,2,0,2.864864864864865,0,0,0,0,1.153541171848025,1.2020666774944784,-0.1882047535402498,0.5069309619771143,2,2,4,1,1,2,1,2,2,1.0690449676496976,1.8571428571428572,0,2,-0.07350689166386981,3,3,4,4,1,1,3,6,1,2,2,1.2535663410560174,3.5,2.7142857142857144,0,-0.788955151249163,0,-0.8765603607594444,3,4,3,3,3,4,5,4,3,2,2,2,4,4,3,1,1,3,3,5,1.2649110640673518,3.2,0,2.4,0,3,0,3.8,0,3.066666666666667,0,2,4,4,4,4,4,4,4,4,3,4,4,2,4,1,4,1,4,4,4,1.3869694338832115,3.45,0,"I lived with my mother, but not father, most of the time.",0,"White, Caucasian, Anglo, European American & Native American/Alaskan Native/indigenous",1,20,1,2,NA,1,3,3,student,3,115,63,3,5,2,0,0,0,0,0,TRUE,TRUE,TRUE,TRUE,TRUE,1,0.4873875000048429,0.4047218750007451,0.46387812500074505,0.5596766666611036,0.4862366666595141,0.5291566666642825,1,1,1,0.9375,0.9375,0.9375,0.062,0.307,0.418,0.012,1.395,30.458818277228314,1875.3336195330735,0.053,0.325,0.684,0.019,1.685,27.658532293929856,1876.116420895167,0.062,0.363,0.495,0.02,1.66,111.41150981983918,1987.3361119625383,116.25,88.6842105263158,83,FALSE,362,1.0725925925925925,0,1,0,0,3,FALSE
404,2022-03-18T22:12:59Z,2022-03-18T22:39:12Z,1572,1,2022-03-18T22:39:14Z,0.8999999761581421,Chrome,99.0.4844.51,Windows NT 10.0,1280,720,NA,1.7777777777777777,645,110,384,111,90,143,-0.06756396092380848,-0.04359280806316166,-0.09929837851125393,0.15886980465851275,0.5969032093171079,0.49919328001373653,2,1,2,1,2,1,2,1,1,1,2,2,2,1,2,1,2,1,1,1,1.190974832912761,0,1,3,4,4,1.45,0,1,1,1,1,1,1,1,1,1,1,1,1,1,1,1,2,1,1,1,1,1,1,1,5,2,0,0,0,0,1,1,2,1,1,1,1,1,1,1,1,1,1,1,1,1,1,1,1,1,1,1,1,2,1,1,1,1,3,3,3,1,1,1,1,1,1,2,1,3,3,1.8716311076178989,2.065591117977289,1.125,0,2.25,0,1,0,1.1111111111111112,0,1,0,1.1666666666666667,0,1.8571428571428572,0,1,0,1.2162162162162162,0,3,0,0,-1.215125037598483,-1.438776281813226,0.4698836567678454,-0.48444631252269027,1,1,3,1,1,1,1,1,1,1.5735915849388864,1.2857142857142858,0,1,-0.7920494875423887,5,5,5,5,3,3,4,6,6,NA,3,1.2909944487358056,6,4.285714285714286,0,0.40966740893729353,1,0.7049375012164149,1,1,1,3,1,5,4,2,5,2,5,5,3,4,5,5,5,5,4,5,1.6987390281365427,1.4,0,5,0,3.6,0,4.2,0,4.266666666666667,0,1,2,1,1,1,1,2,2,2,1,1,1,1,1,1,1,1,1,1,2,1.118033988749895,1.25,0,"I lived with my mother and father an equal amount of time (joint custody) & I lived with my extended family on mother's side (grandparents, aunts ,uncles, cousins)",1,"White, Caucasian, Anglo, European American",0,27,1,2,NA,1,2,4,Homemaker/Student,2,89,60,2,5,2,0,0,0,0,0,TRUE,TRUE,TRUE,TRUE,TRUE,2,0.5675531249865889,0.5143937500119209,0.5916290322273008,0.6303096773855148,0.5657312500029802,0.6471281249895692,1,1,1,0.96875,1,1,0.086,0.364,0.397,0.032,1.819,53.79370678140194,1835.6736452921984,0.122,0.304,0.631,0.022,1.639,52.83340103265547,1835.656085665804,0.069,0.403,0.429,0.025,1.825,78.41567827121605,1905.8927705748267,56.84375,74.5,73,FALSE,382,1.1318518518518519,0,1,0,0,3,FALSE
406,2022-03-18T22:10:26Z,2022-03-18T22:45:33Z,2106,1,2022-03-18T22:45:34Z,0.8999999761581421,Chrome,99.0.4844.74,Macintosh,1440,900,NA,1.6,1127,120,490,142,69,102,0.9234761291052912,0.01162474881684313,0.2858281966483379,0.5411824467227642,0.1662799139116427,0.038426154833335266,2,2,1,1,2,1,2,3,1,2,3,2,1,2,2,3,1,2,3,3,0.7591546545162482,0,0,4,4,3,1.95,0,2,1,1,1,1,1,1,2,2,1,3,1,2,2,2,2,3,1,1,1,2,1,1,0,2,0,0,0,0,1,2,1,2,3,2,3,1,3,1,1,1,1,1,1,1,1,1,2,2,2,2,1,1,1,1,1,1,1,1,1,1,1,1,1,1,1,1,1,1,1,1.6508256192660766,1.647508942095828,1.5,0,1,0,1.5333333333333334,0,2,0,1.25,0,1.1666666666666667,0,1,0,1,0,1.3513513513513513,0,0,0,0,-0.88395041016661,-0.9831974379618483,-0.6189692744445258,-0.801083356203187,2,2,3,2,2,2,3,3,1,0.7867957924694432,2.2857142857142856,0,2,0.17529686935345262,5,5,5,5,3,3,5,6,4,4,3,1.5735915849388864,5,4.428571428571429,0,0.25285077779445086,0,0.6868248105880386,4,3,3,4,3,4,4,5,4,3,2,3,2,4,4,5,5,4,4,4,1.2535663410560174,3.4,0,3.6,0,3.6,0,4.2,0,3.8,0,1,3,2,3,2,2,3,2,1,1,4,3,2,2,1,2,1,2,2,3,0.8522416262267903,2.1,0,I lived with my mother and father an equal amount of time (joint custody),0,"White, Caucasian, Anglo, European American",0,29,1,2,NA,1,2,6,RN,3,103,60,3,5,2,0,0,1,0,0,TRUE,TRUE,TRUE,TRUE,TRUE,1,0.57609062500298025,0.5275218749567866,0.5849187499955296,0.6215387096558848,0.5551965517093396,0.6256387096681902,1,1,1,0.96875,0.9354838709677419,0.96875,0.095,0.395,0.528,0.016,1.505,152.37678850687385,1987.3043863653854,0.054,0.409,0.542,0.029,1.797,77.52816420814132,1947.2766597788416,0.058,0.457,0.57,0.018,1.533,56.41527348355437,1877.4756389337842,94.06249999999999,61.9655172413793,85.16666666666667,FALSE,325,0.9629629629629629,0,1,0,0,3,FALSE
407,2022-03-18T22:16:52Z,2022-03-18T22:45:49Z,1736,1,2022-03-18T22:45:50Z,NA,Chrome,99.0.4844.74,Windows NT 10.0,1366,768,NA,1.7786458333333333,614,124,592,125,130,90,-0.13130305385099122,0.03371177156884505,0.6564216935000207,0.3315271268810779,1.41713805770847,-0.09643251595117242,3,2,3,1,3,1,1,3,1,2,2,1,1,1,3,3,1,2,3,3,0.7677718959499145,0,1,1,2,3,2,0,2,3,1,2,1,1,5,3,3,2,2,3,3,3,3,3,5,5,1,1,3,2,3,5,2,0,0,0,0,2,5,5,3,5,2,5,5,5,3,2,5,1,5,1,3,4,4,4,3,3,5,4,3,3,3,4,1,3,1,1,2,2,3,3,3,3,3,3,2,1,1.2810703107718722,1.0600988273786194,2.875,0,2.25,0,2.466666666666667,0,4.111111111111111,0,3.1666666666666665,0,3.6666666666666665,0,1.8571428571428572,0,3,0,3.2162162162162162,0,3,0,0,1.219337455443761,0.8388229371130868,0.4698836567678454,0.6543532969404661,3,2,5,3,1,2,2,4,3,0.816496580927726,2.5714285714285716,0,3.5,0.9213724151481345,3,4,4,3,1,1,3,3,3,2,2,1.2535663410560174,3,2.7142857142857144,0,-0.8792700537047221,0,-0.9315702209292682,3,3,4,4,3,3,4,3,4,4,4,3,3,3,3,4,3,5,3,3,0.7745966692414834,3.4,0,3.6,0,3.6,0,3.2,0,3.466666666666667,0,1,2,1,2,2,1,2,2,1,1,4,2,2,1,1,3,1,1,1,2,0.910465468000326,1.65,0,"I lived with my mother, but not father, most of the time.",0,Black or African American,0,21,1,2,NA,1,2,4,Student,2,180,65,1,5,2,0,0,0,0,0,TRUE,TRUE,TRUE,TRUE,TRUE,1,0.6812275861953867,0.5351624999940395,0.5849906249977648,0.8754115384725424,0.5881838709731255,0.6125428571317877,0.9354838709677419,1,1,0.8387096774193549,0.96875,0.875,0.056,0.417,0.383,0.022,1.935,79.6079628396012,1941.757698263611,0.079,0.312,0.377,0.013,1.617,166.7621854309687,1995.7276290868404,0.069,0.422,0.196,0.013,1.791,168.97083967257873,2133.52364231678,87.95454545454547,124.38461538461539,137.76923076923077,FALSE,446,1.3214814814814815,0,1,0,0,3,FALSE
408,2022-03-18T22:12:07Z,2022-03-18T22:49:52Z,2265,1,2022-03-18T22:49:54Z,1,Chrome,99.0.4844.74,Windows NT 10.0,1536,864,NA,1.7777777777777777,796,299,464,300,67,192,0.2429071046247269,1.000019016968929,0.1913631876469286,2.489743654663142,0.12526817149207461,1.049866185717143,1,1,1,1,1,1,1,1,1,1,1,1,1,1,1,1,1,1,1,1,1.538967528127731,0,1,2,4,4,1,0,4,2,2,2,2,3,4,4,2,3,4,3,3,4,3,2,3,1,1,3,3,3,4,0,2,0,0,0,0,1,1,4,2,5,1,4,4,3,2,1,4,4,1,4,2,4,4,4,4,4,4,1,1,1,1,1,1,1,1,1,3,3,3,1,1,3,1,1,1,1,1.4982472241738827,0.8338093878327919,2.5,0,1,0,3,0,2.7777777777777777,0,3.1666666666666665,0,1.5,0,1.8571428571428572,0,1.6666666666666667,0,2.4324324324324325,0,0,0,0,0.46706661299917596,0.56575096444413,-0.6189692744445258,-0.026609155000197893,1,1,2,1,1,1,1,3,2,1.7320508075688772,1.1428571428571428,0,2.5,-0.2947777027650296,5,5,5,5,2,2,4,5,5,3,3,1.6035674514745464,5,4,0,0.03902547546461973,0,0.3243780350902185,1,1,3,2,2,4,3,4,4,2,4,2,4,3,2,3,3,3,2,4,0.4879500364742666,1.8,0,3.2,0,2.8,0,3.4,0,3.1333333333333333,0,1,1,2,4,1,2,1,4,1,1,1,2,1,1,1,2,1,1,1,1,0.6569466853317864,1.5,0,NA,NA,Black or African American,0,28,0,1,NA,1,3,5,technical support,2,175,71,3,5,2,0,0,1,0,0,TRUE,TRUE,TRUE,TRUE,TRUE,6,0.5109483871075414,0.46388064515975214,0.4708812499903142,0.604440625000745,0.5461593749970197,0.5472516128978422,1,1,1,1,1,0.96875,0.065,0.376,0.762,0.019,1.751,39.52296331022844,1861.2044283002913,0.127,0.314,0.838,0.02,1.783,38.887396011843485,1821.9445153411334,0.092,0.378,0.708,0.02,1.898,76.90134874908372,1856.3087071942703,92.1578947368421,89.14999999999999,94.89999999999999,FALSE,396,1.1733333333333333,0,1,0,0,3,FALSE
409,2022-03-18T22:24:30Z,2022-03-18T22:50:35Z,1564,1,2022-03-18T22:50:37Z,0.8999999761581421,Chrome,99.0.4844.74,Windows NT 10.0,2048,1152,best of luck with your research,1.7777777777777777,684,66,401,181,63,90,0.01262393017813112,-0.28655005833518277,-0.03753279570264014,1.0221564157713385,0.043244686652938374,-0.09643251595117242,2,1,1,2,3,1,2,4,1,3,4,1,2,2,3,2,1,1,4,3,0.8506963092234007,0,1,1,2,2,2.15,0,4,2,5,3,3,3,3,2,2,2,3,2,3,3,5,3,3,1,1,2,2,2,3,2,2,0,0,0,0,2,4,3,4,2,1,4,2,3,2,4,1,1,2,3,1,4,3,2,3,3,2,1,1,1,2,2,1,2,1,1,4,4,4,1,3,3,3,2,1,1,1.2369438265459067,0.990430401872025,2.125,0,1.75,0,3,0,2.7777777777777777,0,2.4166666666666665,0,1.5,0,2.4285714285714284,0,2.3333333333333335,0,2.3513513513513513,0,1,0,0,0.17098333681836214,0.36662574130598247,-0.14114775846592847,0.112738991420027,1,2,3,2,1,2,2,5,3,1.2724180205607036,1.8571428571428572,0,4,0.7001016040469747,2,3,5,3,1,1,4,6,5,5,2,1.3972762620115438,5.5,2.7142857142857144,0,0.21378036556256672,0,-0.2658046707527837,3,4,3,4,3,3,3,3,4,4,2,3,3,3,2,1,3,3,2,4,0.8451542547285166,3.4,0,2.8,0,2.6,0,3.2,0,2.8666666666666667,0,2,2,3,2,3,3,4,4,3,1,3,4,2,3,3,4,2,3,3,3,0.8870412083230169,2.85,0,I lived with my mother and father an equal amount of time (joint custody),0,"White, Caucasian, Anglo, European American & Native American/Alaskan Native/indigenous",1,27,1,2,NA,1,3,6,naturalist supervisor`,3,107,65,4,5,2,0,0,0,0,0,TRUE,TRUE,TRUE,TRUE,TRUE,6,0.5693562499987893,0.5535709677420316,0.5927531250012107,0.6036968749989755,0.6700718749999068,0.7369531250006984,1,1,1,1,1,1,0.13,0.359,0.609,0.014,1.886,192.22239388267062,1984.3363451959476,0.075,0.414,0.531,0.011,1.251,103.50747042837872,1886.8204602938356,0.107,0.391,0.6,0.037,1.515,23.61992262815234,1806.6726455856335,134.7142857142857,113.72727272727272,40.945945945945944,FALSE,242,0.7170370370370371,0,1,0,0,3,FALSE
410,2022-03-18T22:37:06Z,2022-03-18T22:50:48Z,821,1,2022-03-18T22:50:48Z,0.800000011920929,Chrome,99.0.4844.74,Windows NT 10.0,2926,823,NA,3.555285540704739,478,36,162,37,19,45,-0.4109326228218575,-0.45220272897519714,-0.9058842246002106,-0.7537474699464745,-0.8590136465775602,-0.6021525313930762,2,1,1,1,2,1,1,2,1,1,2,1,3,1,2,1,2,1,1,1,1.2732056517228265,0,0,3,3,3,1.4,0,2,1,2,1,3,2,2,2,3,1,2,2,2,2,1,1,1,2,2,2,1,1,2,2,2,0,0,0,0,2,1,1,2,2,2,2,2,1,2,1,2,2,1,1,2,1,2,1,4,3,2,1,1,1,2,1,2,3,3,2,2,2,2,2,2,2,2,2,3,2,1.3847084232492477,1.3201731488169053,1.5,0,2.25,0,1.8666666666666667,0,1.6666666666666667,0,1.8333333333333333,0,1.3333333333333333,0,2.2857142857142856,0,2,0,1.8108108108108107,0,1,0,0,-0.5856739245326056,-0.6370637167538084,0.031158049895781924,-0.3029528334290132,2,1,3,1,1,2,2,4,2,1.1547005383792515,1.7142857142857142,0,3,0.23036276918577817,3,4,4,3,1,1,3,3,5,3,2,1.2535663410560174,4,2.7142857142857144,0,-0.4848149464637728,0,-0.6913117508138321,4,5,4,5,5,2,1,2,2,1,2,2,2,1,1,1,3,1,2,1,1.5796322658258457,4.6,0,2,0,1.4,0,1.4,0,1.6,0,3,3,2,4,3,3,3,3,3,4,3,4,3,3,3,4,3,3,4,3,0.8645047258706176,3.2,0,I lived with my mother and father an equal amount of time (joint custody),0,"Asian or Asian American (e.g., Chinese, Japanese, and others)",0,19,0,1,NA,1,3,4,student,5,142,70,2,5,2,0,0,1,0,0,TRUE,TRUE,TRUE,TRUE,TRUE,1,0.452028124999968,0.4355281250000699,0.424109375,0.5169483870967863,0.48630322580641855,0.4902548387096594,1,1,1,0.96875,1,0.96875,0.061,0.32,0.581,0.018,1.399,74.88550865467705,1900.2370965009613,0.065,0.307,0.555,0.033,1.652,99.74902295696143,1885.3446412143837,0.066,0.346,0.659,0.027,2.086,50.497509396844876,1874.3873573821713,77.72222222222223,50.060606060606055,77.25925925925925,FALSE,406,1.202962962962963,0,1,0,0,3,FALSE
411,2022-03-18T22:28:50Z,2022-03-18T22:51:33Z,1363,1,2022-03-18T22:51:34Z,0.8999999761581421,Chrome,99.0.4844.74,Windows NT 10.0,2560,1440,NA,1.7777777777777777,522,103,421,92,51,80,-0.3204642328606949,-0.08224509787916502,0.03513259583690549,-0.07545084692925424,-0.20282576786447032,-0.20881474160492883,1,1,1,1,1,1,1,1,1,1,2,1,1,1,1,1,1,1,1,1,1.5035046776746235,0,1,1,3,3,1.05,0,1,1,1,1,1,1,2,1,2,1,1,1,2,1,2,2,2,5,2,1,1,1,1,1,2,0,0,0,0,1,2,4,2,2,1,3,2,1,1,2,1,1,4,1,2,3,3,1,3,2,1,1,1,1,1,1,1,1,1,1,1,1,1,1,1,1,1,1,1,1,1.5644319887574043,1.8464895909600492,1.875,0,1,0,1.2666666666666666,0,2,0,2,0,1,0,1,0,1,0,1.5675675675675675,0,1,0,0,-0.5001387558581482,-0.8414989458423069,-0.39960647100849406,-0.6205527084254004,1,1,3,1,1,1,1,2,1,1.5735915849388864,1.2857142857142858,0,1.5,-0.5986473636146776,4,5,5,5,3,3,5,3,3,3,3,1.4960264830861913,3,4.285714285714286,0,-0.3222341343576166,0,0.25914394489227754,2,1,2,2,2,4,4,4,5,3,5,5,5,5,5,4,5,5,3,4,1.61245154965971,1.8,0,4.8,0,3.8,0,4.6,0,4.4,0,1,1,1,3,1,1,1,2,1,1,1,1,1,1,1,1,1,1,1,1,0.998683343734455,1.15,0,I lived with my mother and father an equal amount of time (joint custody),0,"White, Caucasian, Anglo, European American",0,29,0,1,NA,1,2,6,IT support,2,185,75,2,5,2,0,0,1,0,0,TRUE,TRUE,TRUE,TRUE,TRUE,5,0.49162999999920526,0.5340343749988824,0.5243687500013039,0.5644343749955296,0.6484766666650772,0.5793281250037253,0.967741935483871,1,1,1,0.9375,1,0.087,0.375,0.597,0.034,1.797,60.88481906039556,1846.4587415482508,0.063,0.384,0.384,0.017,1.69,73.51043070857898,1939.8613995924982,0.12,0.316,0.684,0.021,1.721,163.3061443202603,1988.0506538338075,52.85294117647058,99.41176470588235,81.95238095238095,FALSE,304,0.9007407407407407,1,1,0,0,3,FALSE
412,2022-03-18T22:27:21Z,2022-03-18T22:55:58Z,1716,1,2022-03-18T22:55:59Z,0.8999999761581421,Chrome,99.0.4844.51,Windows NT 10.0,1920,1080,No.,1.7777777777777777,616,324,402,108,51,92,-0.12719085430730204,1.138062909168941,-0.03389952612566286,0.12187180703939164,-0.20282576786447032,-0.07395607082042113,2,3,2,2,3,1,3,4,1,3,4,2,1,1,3,4,2,1,4,4,0.6805570473787206,0,0,3,5,4,2.5,0,4,4,5,5,5,4,4,4,5,3,3,4,3,4,5,4,5,4,2,3,4,3,3,10,2,0,0,0,0,3,5,5,5,5,3,5,5,5,4,4,3,3,4,3,3,5,4,4,3,4,5,4,3,3,5,5,3,5,4,2,5,5,5,2,4,3,2,3,3,3,1.4019505930900225,1.3870146083619754,3.5,0,2.75,0,4.133333333333334,0,4.555555555555555,0,3.6666666666666665,0,4.166666666666667,0,4.142857142857143,0,3,0,4,0,5,0,0,2.133905797424496,2.1815661084471163,1.0809150720016192,1.6312405902243676,4,4,5,3,2,4,3,4,1,1.1126972805283737,3.5714285714285716,0,2.5,1.1151102763331315,2,3,4,1,1,1,1,5,1,2,1,1.618347187425374,3,1.8571428571428572,0,-1.2224806707219966,0,-1.6050322607716403,1,1,1,1,1,5,4,5,5,4,5,5,5,4,5,5,5,5,4,5,1.804755622554715,1,0,5,0,4.4,0,4.8,0,4.733333333333333,0,2,3,4,4,4,4,4,3,3,3,3,3,4,4,2,2,2,3,2,4,0.9445132413883326,3.15,0,"I lived with my mother, but not father, most of the time. & I lived with my mother and father an equal amount of time (joint custody) & I lived with my extended family on mother's side (grandparents, aunts ,uncles, cousins)",1,"White, Caucasian, Anglo, European American",0,28,1,2,NA,1,1,3,Keyholder manager,2,278,64,2,5,2,0,0,1,0,0,TRUE,TRUE,TRUE,TRUE,TRUE,6,0.5951593749932945,0.5006656250096857,0.5837093749903143,0.6303266666571299,0.5579758620755426,0.6523500000039737,1,1,1,0.9375,0.9354838709677419,0.967741935483871,0.075,0.388,0.438,0.012,1.527,57.891480854900685,1884.9143574412367,0.059,0.379,0.548,0.023,1.959,55.03959895520847,1901.0020970882217,0.069,0.393,0.371,0.013,1.434,108.24233686278664,1949.4843513370254,127.24999999999999,85.17391304347827,110.3076923076923,FALSE,426,1.2622222222222224,0,1,0,0,3,FALSE
413,2022-03-18T22:28:52Z,2022-03-18T22:56:43Z,1671,1,2022-03-18T22:56:45Z,0.8999999761581421,Chrome,99.0.4844.74,Windows NT 10.0,1536,864,thank you,1.7777777777777777,499,97,685,157,78,77,-0.36775452761312083,-0.1153756320071679,0.9943157641589079,0.7261724348183697,0.3508327547996992,-0.24252940930105574,2,2,3,2,3,1,1,2,1,2,3,3,2,2,3,2,3,3,3,1,0.8207826816681233,0,1,2,2,1,2.2,0,2,2,2,2,2,2,2,3,1,1,4,2,4,2,2,2,1,1,1,1,1,2,2,0,1,2,0,2,0,1,1,1,1,1,1,4,3,1,1,1,1,1,1,1,2,1,1,4,3,2,1,1,1,1,2,1,2,1,2,1,1,3,2,1,1,2,2,2,2,2,1.7137493798501977,1.1872336794093274,1.375,0,2,0,2.2,0,1.5555555555555556,0,1.5833333333333333,0,1.1666666666666667,0,1.7142857142857142,0,1.3333333333333333,0,1.5135135135135136,0,0,0,0,-0.8598251061815066,-0.6759054269461877,-0.274357657721105,-0.47513154233364635,1,1,2,1,1,2,2,1,5,1.6035674514745464,1.4285714285714286,0,3,0.06449359517422987,4,4,4,4,2,2,5,4,9,1,2,1.2909944487358056,6.5,3.5714285714285716,0,-0.46089103884563964,0,-0.21232389807222737,5,5,5,5,5,1,1,1,5,3,5,3,2,2,3,4,5,5,5,1,1.6676187756655838,5,0,3.8,0,3,0,2.4,0,3.066666666666667,0,3,1,1,2,2,2,3,2,1,1,4,3,1,2,2,3,1,2,1,2,0.8870412083230169,1.95,0,"I lived with my mother and father an equal amount of time (joint custody) & I lived with my extended family on mother's side (grandparents, aunts ,uncles, cousins)",1,"Asian or Asian American (e.g., Chinese, Japanese, and others)",0,27,0,1,NA,1,2,4,i am unemployed,1,200,67,2,5,2,0,0,0,0,0,TRUE,TRUE,TRUE,TRUE,TRUE,4,0.4227124999994412,0.3841812500000233,0.43276129032250854,0.5048137931033712,0.46680333333338303,0.5090580645161531,1,1,1,0.90625,0.967741935483871,0.96875,0.068,0.321,0.663,0.017,1.65,86.60596688262426,1912.780789991818,0.065,0.299,0.801,0.014,1.488,22.729375274251666,1849.6384345002623,0.052,0.343,0.695,0.023,1.96,54.9902955684145,1909.54413726044,97.05882352941175,106.28571428571428,85.21739130434783,FALSE,506,1.4992592592592593,0,1,0,0,3,FALSE
414,2022-03-18T22:36:38Z,2022-03-18T23:03:06Z,1588,1,2022-03-18T23:03:08Z,1,Firefox,98.0,Windows NT 10.0,1536,864,The highest education level either caregiver had was elementary school.,1.7777777777777777,719,89,387,119,65,118,0.0845874221926923,-0.15954967751117172,-0.0883985697803221,0.2575311316428357,0.0842564290725065,0.2182377158793455,2,1,1,1,2,2,1,3,1,3,3,1,1,1,3,3,2,2,3,3,0.812727700887249,0,1,2,4,4,1.95,0,2,2,2,3,2,2,2,2,2,2,1,2,1,2,3,4,2,1,1,2,1,2,2,0,2,0,0,0,0,1,1,4,2,3,2,3,3,2,1,2,1,1,4,1,3,2,1,1,1,1,2,1,1,1,3,1,1,1,3,1,2,2,2,1,3,1,1,1,1,1,1.3361456826578775,1.1126972805283737,1.875,0,1,0,2,0,2.3333333333333335,0,1.5833333333333333,0,1.5,0,1.7142857142857142,0,1.6666666666666667,0,1.7837837837837838,0,0,0,0,-0.3597733508539106,-0.42692514794085923,-0.6189692744445258,-0.5229472111926925,3,3,5,2,1,2,2,1,1,0.816496580927726,2.5714285714285716,0,1,-0.04563820449042111,2,3,4,2,1,1,3,1,1,2,2,1.1126972805283737,1,2.2857142857142856,0,0.20450877576198692,0,-0.5036599246134142,2,2,2,2,2,4,3,4,4,4,3,3,5,3,3,4,3,4,2,3,0.7432233529572065,2,0,3.4,0,3.6,0,3.4,0,3.466666666666667,0,3,2,2,2,1,2,2,2,2,2,1,4,3,3,1,4,2,1,2,2,0.7591546545162482,2.15,0,I lived with my mother and father an equal amount of time (joint custody),0,"Hispanic of Latino (e.g., Mexican American, Central American, and others)",0,23,1,2,NA,1,3,6,Unemployed,3,120,65,2,5,2,0,0,0,0,0,TRUE,TRUE,TRUE,TRUE,TRUE,3,0.53559375,0.46719354838709676,0.5245625,0.57946875,0.54190625,0.61275,1,1,1,1,1,1,0.143,0.339,0.811,0.014,1.516,37.453568732353986,1820.1553711971924,0.1,0.32,0.687,0.025,1.954,21.599557144031614,1803.0451325510428,0.141,0.316,0.667,0.025,1.702,91.97277709480677,1876.299728618885,108.28571428571428,78.16,68.08,FALSE,435,1.2888888888888888,0,1,0,0,3,FALSE
415,2022-03-18T22:44:56Z,2022-03-18T23:06:07Z,1271,1,2022-03-18T23:06:09Z,0.8999999761581421,Chrome,99.0.4844.51,Macintosh,1280,800,Thank you!,1.6,537,87,319,116,49,99,-0.2896227362830258,-0.17059318888717268,-0.33546090101477727,0.22053313402371458,-0.2438375102840384,0.004711487137208345,2,1,2,1,2,2,4,2,2,2,4,2,1,3,2,2,3,1,3,3,0.9403246919632545,0,1,4,4,4,2.2,0,1,1,1,2,1,1,1,1,1,1,1,1,1,1,3,1,1,1,1,1,1,1,1,3,2,0,0,0,0,2,1,1,1,1,1,2,1,1,2,1,1,1,1,2,5,2,1,1,2,3,1,1,1,1,1,1,1,2,2,1,1,1,1,1,1,1,1,1,1,1,1.772326477018594,1.9148542155126762,1,0,1,0,1.2,0,1.2222222222222223,0,1.8333333333333333,0,1,0,1.2857142857142858,0,1,0,1.3783783783783783,0,2,0,0,-1.1909997336133797,-1.335231165781389,-0.18024366757246235,-0.7577374166769256,1,1,1,1,1,1,3,1,1,1.9023794624226837,1.2857142857142858,0,1,-0.7920494875423887,4,5,5,5,5,5,5,8,8,6,4,1.4960264830861913,8,4.857142857142857,0,1.565601414204742,0,1.7186154852788984,2,2,2,2,2,4,5,4,5,4,5,4,5,4,4,4,4,5,4,3,1.424279266355945,2,0,4.4,0,4.4,0,4,0,4.266666666666667,0,2,2,1,4,3,2,2,3,3,2,2,4,2,3,1,3,1,3,1,2,0.7181848464596079,2.3,0,I lived with my mother and father an equal amount of time (joint custody),0,Native American/Alaskan Native/indigenous,0,24,0,1,NA,1,4,6,Health management office worker/Masters student.,6,172,71,3,5,2,0,0,1,0,0,TRUE,TRUE,TRUE,TRUE,TRUE,2,0.6151718750004657,0.5773656250000931,0.6358354838716407,0.663906249998603,0.6390593749997207,0.7024656249992549,1,1,1,1,1,1,0.152,0.436,0.771,0.025,1.846,33.97320035242262,1817.5206667101952,0.069,0.486,0.741,0.024,1.644,113.25316751165315,1895.1920489196173,0.1,0.51,0.975,0.014,1.152,34.98233435606136,1819.2678307330345,73.84,68.5,82.28571428571428,FALSE,469,1.3896296296296295,0,1,0,0,3,FALSE
416,2022-03-18T22:38:03Z,2022-03-18T23:06:21Z,1697,1,2022-03-18T23:06:23Z,0.8999999761581421,Chrome,99.0.4844.74,Windows NT 10.0,2560,1440,N/A,1.7777777777777777,547,150,541,111,99,105,-0.26906173856457977,0.17727741945685752,0.47112494507417935,0.15886980465851275,0.7814560502051644,0.07214082252946219,2,2,2,2,2,1,3,2,2,2,2,2,1,2,2,2,2,1,2,2,0.7539370349250519,0,1,2,3,2,1.9,0,4,2,4,2,3,3,3,3,2,2,2,2,2,3,3,3,2,4,1,2,2,3,2,0,1,0,0,0,0,3,2,5,2,2,2,2,2,2,3,2,2,1,3,2,5,3,2,2,2,2,2,1,1,1,3,2,1,1,1,1,1,2,2,1,2,1,2,2,1,1,1.2550199500705457,0.7988086367179802,2.375,0,1.5,0,2.6666666666666665,0,2.4444444444444446,0,2.4166666666666665,0,1.6666666666666667,0,1.2857142857142858,0,1.3333333333333333,0,2,0,0,0,0,0.10518705322262613,0.1768421953027105,-0.4466634660828154,-0.13491063539005244,4,3,4,2,2,3,3,3,1,0.5345224838248488,3,0,2,0.5899698043823236,4,3,4,3,2,2,3,3,3,2,1,0.816496580927726,3,3,0,-1.2224806707219966,0,-0.9858108588462231,2,3,2,2,3,4,4,4,4,2,3,4,4,4,4,4,4,4,4,2,1,2.4,0,3.8,0,3.6,0,3.6,0,3.6666666666666665,0,2,2,1,2,3,1,2,2,1,1,2,2,2,1,1,2,2,2,1,1,0.812727700887249,1.65,0,"I lived with my mother, but not father, most of the time. & I lived with my mother and father an equal amount of time (joint custody) & I lived with my extended family on mother's side (grandparents, aunts ,uncles, cousins)",1,"White, Caucasian, Anglo, European American",0,20,0,1,NA,1,2,5,Data Management,2,155,69,3,5,2,0,0,2,0,0,TRUE,TRUE,TRUE,TRUE,TRUE,3,0.48295483871044653,0.40847187500167637,0.45374062500242146,0.5653172413788993,0.48873571428975887,0.5595900000025829,0.96875,1,1,0.90625,0.875,0.9375,0.07,0.359,0.8,0.014,1.733,82.62653503024879,1929.8695993073636,0.058,0.337,0.873,0.015,1.557,110.71250437771998,1977.381943557166,0.055,0.38,0.549,0.011,1.428,250.99752940327886,2162.851205379201,123.78571428571429,103.8,129.8181818181818,FALSE,362,1.0725925925925925,0,0,0,3,6,FALSE
417,2022-03-18T22:49:15Z,2022-03-18T23:10:22Z,1267,1,2022-03-18T23:10:23Z,1,Firefox,98.0,Windows NT 10.0,1280,720,NA,1.7777777777777777,572,92,327,73,49,94,-0.21765924426846464,-0.14298441044717028,-0.30639474439895903,-0.30977149851702124,-0.2438375102840384,-0.05147962568966986,2,3,2,1,3,2,3,4,1,3,4,3,1,3,4,3,4,1,4,4,0.9333020044867296,1,1,2,2,1,2.75,0,4,5,5,4,5,2,4,2,2,2,4,3,3,3,4,1,4,1,3,1,3,2,3,1,1,1,0,1,0,2,5,5,4,5,3,4,4,4,4,2,1,1,2,3,2,5,1,3,5,3,4,4,1,1,2,2,4,2,1,1,2,1,1,4,4,2,1,1,1,1,1.346221494521727,1.1751393027860062,2.25,0,1,0,3.466666666666667,0,4,0,2.6666666666666665,0,2.3333333333333335,0,1.7142857142857142,0,3.3333333333333335,0,2.810810810810811,0,1,0,0,0.5504085722204418,0.8255479222372103,-0.39960647100849406,0.21297072561435812,3,3,4,3,1,2,1,1,1,0.8997354108424374,2.4285714285714284,0,1,-0.1285727914961955,4,4,3,3,1,1,1,1,4,1,1,1.5275252316519468,2.5,2.4285714285714284,0,-1.5266208755073867,0,-1.480670169754544,2,2,2,5,4,4,5,5,5,4,3,5,3,4,5,5,5,4,5,5,1.6846647257229665,3,0,4.2,0,4.4,0,4.8,0,4.466666666666667,0,3,1,2,3,2,2,2,3,1,1,3,3,2,3,1,3,3,2,3,3,0.7181848464596079,2.3,0,I lived with my mother and father an equal amount of time (joint custody),0,"Hispanic of Latino (e.g., Mexican American, Central American, and others) & White, Caucasian, Anglo, European American",1,23,1,2,NA,1,2,6,student,2,160,64,2,5,2,0,0,1,0,0,TRUE,TRUE,TRUE,TRUE,TRUE,1,0.76903125,0.5841612903225807,0.56796875,0.9158620689655173,0.617875,0.6635,1,1,1,0.9354838709677419,1,1,0.084,0.385,0.432,0.021,1.803,76.33959182931969,1863.0205899947302,0.104,0.386,0.549,0.031,1.668,96.9877837962424,1879.1957680062706,0.089,0.346,0.218,0.009,1.6,87.81159526489148,1933.2742082696886,85.85714285714285,53.806451612903224,177.7777777777778,FALSE,356,1.0548148148148149,0,1,0,0,3,FALSE
418,2022-03-18T22:48:46Z,2022-03-18T23:13:48Z,1501,1,2022-03-18T23:13:49Z,0.8999999761581421,Chrome,99.0.4844.74,Windows NT 10.0,1536,864,I have no feedback or comments about the survey.,1.7777777777777777,592,114,470,107,34,97,-0.17653724883157254,-0.021505785311159747,0.21316280510879232,0.10953914116635127,-0.5514255784307993,-0.017764957993542937,2,2,1,1,3,1,1,2,1,2,2,1,1,1,2,2,1,1,2,2,0.998683343734455,0,1,1,4,4,1.55,0,2,1,1,2,1,1,1,1,1,1,1,1,2,2,2,1,1,1,1,1,1,1,1,0,2,0,0,0,0,2,3,2,1,2,1,3,3,2,1,1,1,1,2,1,1,1,1,1,1,1,1,1,1,1,2,1,1,1,1,1,1,1,1,1,1,1,2,1,1,2,1.6398747480186373,1.7593288763724921,1,0,1.5,0,1.3333333333333333,0,2.111111111111111,0,1.0833333333333333,0,1.1666666666666667,0,1,0,1,0,1.3243243243243243,0,0,0,0,-1.2260910848644389,-1.300617793660585,-0.4466634660828154,-0.8736406298717001,1,1,2,1,1,1,1,1,1,1.7320508075688772,1.1428571428571428,0,1,-0.874984074548163,5,5,5,4,3,3,4,3,3,2,3,1.2149857925879117,3,4.142857142857143,0,-0.5360594366874477,0,0.05150251987581217,1,2,2,1,2,4,3,3,5,3,5,4,4,4,3,4,4,4,3,3,0.9759000729485332,1.6,0,4.2,0,3.4,0,3.6,0,3.7333333333333334,0,1,1,1,1,1,1,1,1,1,1,1,1,1,1,1,1,1,1,1,1,1.231174022502185,1,0,I lived with my mother and father an equal amount of time (joint custody),0,"White, Caucasian, Anglo, European American",0,26,0,1,NA,1,3,3,Retail store management,2,230,74,3,5,2,0,0,1,0,0,TRUE,TRUE,TRUE,TRUE,TRUE,2,0.5720937500037253,0.5597593749947846,0.5181749999895692,0.6834312499910593,0.6322806451551376,0.641212500013411,1,1,1,1,1,1,0.112,0.369,0.781,0.016,1.955,63.34990334462208,1843.1253415778506,0.111,0.39,0.666,0.008,1.078,64.5599517710416,1851.5359783945878,0.192,0.3,0.732,0.012,1.624,55.936997766474704,1840.278696780515,122.1875,134.75,135.33333333333334,FALSE,390,1.1555555555555557,0,1,0,0,3,FALSE
419,2022-03-18T22:55:18Z,2022-03-18T23:18:06Z,1367,1,2022-03-18T23:18:06Z,1,Chrome,98.0.4758.107,CrOS x86_64 14388.61.0,1200,800,NA,1.5,535,96,352,128,69,142,-0.29373493582671506,-0.12089738769516838,-0.21556300497452696,0.368525124500199,0.1662799139116427,0.4879550574483609,2,2,1,1,2,1,1,3,1,2,2,1,1,1,2,3,1,1,3,2,0.9333020044867296,0,1,1,4,4,1.65,0,1,1,1,1,1,1,1,1,1,1,1,1,2,1,1,1,1,1,1,1,1,1,1,0,2,0,0,0,0,1,3,4,2,2,1,3,1,1,1,1,1,1,2,1,1,2,1,1,1,1,2,1,1,1,1,1,1,1,1,1,2,1,1,1,1,1,1,1,1,1,1.635290241570032,2.016597794967223,1,0,1,0,1.0666666666666667,0,2,0,1.1666666666666667,0,1.1666666666666667,0,1.1428571428571428,0,1,0,1.3513513513513513,0,0,0,0,-1.2085454092389094,-1.4052445775711968,-0.6189692744445258,-1.0121069260078612,1,1,2,2,1,1,2,3,2,1.6035674514745464,1.4285714285714286,0,2.5,-0.12890852875348124,5,5,5,5,4,4,5,7,7,5,3,1.4638501094227998,7,4.714285714285714,0,0.8279356899465183,0,1.1919083515244764,2,2,1,1,2,4,4,4,4,5,5,5,5,5,5,3,4,4,3,2,1.4735767952260144,1.6,0,4.4,0,4,0,4,0,4.133333333333334,0,1,1,1,1,1,1,1,1,1,1,1,1,1,2,2,1,2,2,1,1,1.1964860832322377,1.2,0,I lived with my mother and father an equal amount of time (joint custody),0,"White, Caucasian, Anglo, European American",0,25,0,1,NA,1,3,6,Corporate Wellness Performance Coach,3,197,75,5,5,2,0,0,1,0,0,TRUE,TRUE,TRUE,TRUE,TRUE,4,0.49263749999948775,0.4727187499993015,0.48409687500074505,0.6289833333333333,0.5608354838706794,0.6229655172411224,1,1,1,0.9375,0.96875,0.90625,0.067,0.376,0.609,0.007,1.446,202.44683169891877,2095.481843610152,0.068,0.357,0.599,0.02,1.868,53.06507191930663,1882.768440262799,0.068,0.367,0.593,0.006,1.296,170.9043972205359,2016.6829686230676,206.57142857142856,93.4,216,FALSE,404,1.1970370370370371,0,1,0,0,3,FALSE
421,2022-03-18T23:09:53Z,2022-03-18T23:28:39Z,1126,1,2022-03-18T23:28:40Z,0.8999999761581421,Chrome,99.0.4844.74,Windows NT 10.0,1536,864,NA,1.7777777777777777,543,72,264,51,41,69,-0.2772861376519582,-0.2534195242071799,-0.5352907277485278,-0.5810901477239093,-0.40788447996231086,-0.33243518982406084,3,4,4,4,3,3,4,4,3,3,3,3,3,2,4,4,3,2,3,4,1.0310954828418375,0,1,1,1,1,3.3,0,2,2,5,3,2,2,5,3,2,1,1,5,3,4,3,2,3,1,1,1,4,2,3,0,2,0,0,0,0,1,5,2,2,3,3,5,3,2,1,2,2,1,3,2,1,5,2,2,2,2,4,1,1,1,1,1,1,1,1,1,5,5,5,2,4,3,1,1,1,1,1.4632638658632766,1.245945806357946,2.125,0,1,0,2.8666666666666667,0,2.888888888888889,0,2.0833333333333335,0,1.5,0,2.7142857142857144,0,3,0,2.3783783783783785,0,0,0,0,0.18852901244389253,0.3202123559621772,-0.6189692744445258,-0.1493784592411743,3,3,5,2,2,3,2,4,1,0.7559289460184544,2.857142857142857,0,2.5,0.7004373413042606,2,2,2,2,1,1,2,3,3,1,1,1,3,1.7142857142857142,0,-1.4363059730518277,0,-1.8126736857881058,1,1,1,1,1,5,5,5,5,2,2,5,5,5,5,4,5,4,5,3,1.7674302033770737,1,0,4.2,0,4.2,0,4.6,0,4.333333333333333,0,2,4,4,3,2,4,4,4,4,4,4,3,3,3,2,4,2,3,2,3,1.0563093645728086,3.2,0,"I lived with my extended family on father's side (grandparents, aunts ,uncles, cousins)",0,"White, Caucasian, Anglo, European American",0,27,0,3,NA,1,1,6,unemployed,1,170,68,2,5,2,0,0,1,0,0,TRUE,TRUE,TRUE,TRUE,TRUE,5,0.5673656249999695,0.47267812499999856,0.5092093750000131,0.6377937499999825,0.5549656249999898,0.5811968750000015,1,1,1,1,1,1,0.1,0.33,0.561,0.002,0.564,59.624806452568905,1842.5800325539583,0.091,0.303,0.508,0.029,1.929,74.05424281976649,1856.382856293057,0.126,0.308,0.519,0.022,2.031,97.72411877727953,1882.4124238986567,281.99999999999994,66.51724137931035,92.31818181818183,FALSE,387,1.1466666666666667,0,1,0,0,3,FALSE
422,2022-03-18T23:12:12Z,2022-03-18T23:31:35Z,1162,1,2022-03-18T23:31:36Z,1,Firefox,97.0,Windows NT 10.0,1920,1080,NA,1.7777777777777777,471,78,279,111,68,102,-0.42532532122476974,-0.220288990079177,-0.4807916840938685,0.15886980465851275,0.14577404270185867,0.038426154833335266,2,2,2,2,2,1,2,2,1,2,2,2,2,2,2,2,2,2,2,3,0.6708203932499369,0,1,3,3,3,1.95,0,2,3,3,2,3,2,4,2,1,1,2,2,3,3,2,2,3,1,1,1,3,2,2,1,2,0,0,0,0,1,1,1,2,2,2,2,2,2,2,2,2,1,2,3,2,3,3,3,3,3,4,2,1,1,2,1,1,1,1,1,1,1,2,1,1,1,2,2,1,1,1.4379038798082324,1.0327955589886444,1.875,0,1.5,0,2.3333333333333335,0,1.6666666666666667,0,2.4166666666666665,0,1.8333333333333333,0,1.1428571428571428,0,1,0,1.7837837837837838,0,1,0,0,-0.3597733508539106,-0.2813916515238424,-0.22730066264678367,-0.25434615708531305,2,2,3,1,2,2,2,3,1,0.9511897312113419,2,0,2,0.009427695341904336,4,4,4,4,2,2,3,3,2,3,2,0.9511897312113419,2.5,3.2857142857142856,0,-0.7557596538304501,0,-0.5467306303605951,2,3,3,2,3,3,3,3,4,3,3,4,4,4,3,3,4,4,3,3,0.6546536707079771,2.6,0,3.6,0,3.2,0,3.4,0,3.4,0,3,2,2,1,3,2,2,2,1,2,2,2,2,2,3,2,1,2,2,3,0.7451598203705946,2.05,0,I lived with my mother and father an equal amount of time (joint custody),0,"White, Caucasian, Anglo, European American",0,18,0,1,NA,1,3,5,student,2,180,74,3,5,2,0,0,2,0,0,TRUE,TRUE,TRUE,TRUE,TRUE,4,0.576125,0.56984375,0.5881724137931035,0.6496774193548387,0.6637037037037037,0.775,1,1,0.9666666666666667,0.96875,0.8709677419354839,0.9375,0.064,0.405,0.298,0.018,1.757,225.96507691771464,2118.3789223154913,0.059,0.395,0.351,0.007,1.251,112.78293098572647,2017.2966055560419,0.079,0.406,0.52,0.02,2.06,64.33038500204978,1885.9517318968396,97.61111111111111,178.7142857142857,103,FALSE,476,1.4103703703703703,0,1,0,0,3,FALSE
424,2022-03-18T23:23:10Z,2022-03-18T23:40:36Z,1045,1,2022-03-18T23:40:39Z,0.8999999761581421,Chrome,99.0.4844.51,Macintosh,1440,900,NA,1.6,487,67,263,57,41,84,-0.39242772487525607,-0.28102830264718226,-0.538923997325505,-0.5070941524856671,-0.40788447996231086,-0.16386185134342626,2,2,1,1,2,1,1,2,1,2,3,1,1,1,2,2,1,1,2,2,0.998683343734455,0,0,3,2,2,1.55,0,4,2,2,3,2,3,4,4,3,3,3,5,1,4,2,3,5,1,1,3,4,4,4,1,2,0,0,0,0,2,4,3,2,2,3,3,3,4,3,3,5,4,3,4,1,4,4,4,4,4,4,4,1,2,2,1,1,3,3,1,3,3,2,3,2,4,2,2,2,2,1.092562901481509,0.9856107606091623,3.125,0,2,0,3,0,2.888888888888889,0,3.5833333333333335,0,2.3333333333333335,0,2.2857142857142856,0,3,0,2.918918918918919,0,1,0,0,1.1886325230990846,1.0510265082400614,-0.05499485428507328,0.498015826977494,1,2,3,1,1,3,1,3,3,1.4960264830861913,1.7142857142857142,0,3,0.23036276918577817,5,5,5,5,2,2,4,6,9,NA,3,1.6035674514745464,7.5,4,0,0.8160844699873094,1,0.7976765214992676,3,3,3,3,3,3,5,4,3,3,4,3,3,3,5,3,4,2,4,5,1.082325538564332,3,0,3.2,0,3.6,0,4,0,3.6,0,2,3,2,2,3,4,3,3,2,3,4,3,2,3,2,3,3,3,2,2,0.6805570473787206,2.7,0,"I lived with my mother, but not father, most of the time.",0,"White, Caucasian, Anglo, European American",0,20,1,3,NA,1,2,4,student,1,180,64,1,5,2,0,0,1,0,0,TRUE,TRUE,TRUE,TRUE,TRUE,2,0.5667258064516129,0.5019064515982905,0.5378806451712885,0.647235483865584,0.6226999999960263,0.6618633333444596,1,0.96875,1,0.96875,0.967741935483871,0.9375,0.072,0.402,0.582,0.008,1.414,56.77726777534214,1901.0102201847146,0.062,0.376,0.504,0.015,1.835,122.29996269385185,1993.0779758162787,0.061,0.412,0.4,0.013,1.393,80.68661411467566,1903.1200957065485,176.75,122.33333333333333,107.15384615384616,FALSE,432,1.28,0,1,0,0,3,FALSE
425,2022-03-18T23:28:22Z,2022-03-18T23:47:34Z,1151,1,2022-03-18T23:47:36Z,0.8999999761581421,Chrome,99.0.4844.51,Macintosh,1440,900,None,1.6,548,78,272,67,38,75,-0.26700563879273514,-0.220288990079177,-0.5062245711327095,-0.3837674937552634,-0.46940209359166307,-0.265005854431807,3,3,3,3,3,2,2,4,1,3,4,2,3,3,4,4,2,3,4,4,0.7880689256524124,0,1,1,3,3,3,0,4,3,3,4,3,3,4,3,4,3,3,5,3,4,5,3,3,1,1,4,4,3,3,0,2,0,0,0,0,2,5,5,5,5,4,5,5,5,2,4,2,1,4,3,4,5,3,3,4,2,5,1,1,1,2,1,1,1,1,1,4,4,3,1,3,1,3,3,2,2,1.109608593708264,0.8338093878327919,2.75,0,2.5,0,3.6,0,4.555555555555555,0,3.0833333333333335,0,1.8333333333333333,0,2.142857142857143,0,1.6666666666666667,0,2.945945945945946,0,0,0,0,0.9627319494203894,1.1610616315445492,-0.10205184935939461,0.5295048910925773,3,2,5,2,2,1,1,2,1,0.7559289460184544,2.2857142857142856,0,1.5,-0.01810525457425849,3,3,3,2,2,2,3,4,4,3,2,0.5345224838248488,4,2.5714285714285716,0,-0.4848149464637728,0,-0.7687144260545092,2,2,3,3,2,3,4,4,5,2,5,4,4,3,4,3,3,4,3,5,1.0600988273786194,2.4,0,3.8,0,3.2,0,4.2,0,3.7333333333333334,0,3,3,3,4,3,3,2,2,3,3,3,3,3,3,2,3,2,3,4,3,0.6569466853317864,2.9,0,I lived with my mother and father an equal amount of time (joint custody),0,"White, Caucasian, Anglo, European American",0,21,1,2,NA,1,2,3,Cashier,1,250,67,2,5,2,0,0,3,0,0,TRUE,TRUE,TRUE,TRUE,TRUE,4,0.4744187500048429,0.4436838709673574,0.46875624999962745,0.55819285714307,0.5176896551724138,0.5760699999998014,1,0.96875,1,0.875,0.90625,0.9375,0.063,0.364,0.628,0.011,1.464,66.03976974331098,1915.9515803347183,0.053,0.344,0.495,0.018,1.762,115.159562267981,2016.9508705843737,0.057,0.372,0.602,0.017,1.891,51.422244178757914,1912.7838768639408,133.0909090909091,97.8888888888889,111.23529411764706,FALSE,438,1.2977777777777777,0,1,0,0,3,FALSE
426,2022-03-18T23:37:19Z,2022-03-18T23:56:22Z,1143,1,2022-03-18T23:56:24Z,1,Firefox,98.0,Windows NT 10.0,1920,1080,NA,1.7777777777777777,489,89,318,73,46,68,-0.3883155253315669,-0.15954967751117172,-0.33909417059175456,-0.30977149851702124,-0.3053551239133906,-0.3436734123894365,2,2,1,1,2,1,1,3,1,2,3,1,2,1,1,1,1,1,2,1,1.1652874052533586,1,1,2,3,2,1.5,0,4,3,1,4,1,2,2,3,3,1,3,3,1,4,5,4,4,5,3,4,4,3,3,3,1,1,0,0,0,5,3,4,4,4,2,3,3,3,1,4,1,4,4,3,2,5,4,2,2,3,4,1,3,3,2,5,2,4,3,1,3,3,2,2,1,1,4,4,2,2,1.1203817453240013,0.990430401872025,3.75,0,3,0,2.6666666666666665,0,3.4444444444444446,0,2.9166666666666665,0,3,0,2.5714285714285716,0,1.3333333333333333,0,2.864864864864865,0,2,0,0,1.5592849206883992,1.154768291158948,0.5089795658743793,0.8318739285166636,1,1,3,1,1,1,1,1,1,1.5735915849388864,1.2857142857142858,0,1,-0.7920494875423887,3,3,3,2,1,1,3,2,3,1,2,0.9511897312113419,2.5,2.2857142857142856,0,-1.1834102584901123,0,-1.349026856596912,4,5,4,1,3,2,2,3,2,3,4,2,5,4,4,1,3,1,3,2,1.162919151265879,3.4,0,2.4,0,2.8,0,3,0,2.7333333333333334,0,1,3,1,3,3,2,3,3,1,1,3,2,2,2,1,2,1,2,2,1,0.8255779474818965,1.95,0,"I lived with my mother, but not father, most of the time. & I lived with my father, but not mother, most of the time. & I lived with my mother and father an equal amount of time (joint custody)",1,"White, Caucasian, Anglo, European American",0,19,0,3,NA,1,2,3,Unemployed - seeking work,1,145,71,1,5,2,0,0,1,0,0,TRUE,TRUE,TRUE,TRUE,TRUE,6,0.5420344827586207,0.45503225806451614,0.4549375,0.5166451612903226,0.4983548387096774,0.5686129032258065,0.90625,1,1,1,0.96875,0.96875,0.066,0.343,0.51,0.017,1.622,83.04346764019034,1904.1240790418465,0.061,0.326,0.485,0.041,2.123,66.79158528478311,1892.502910324288,0.048,0.393,0.326,0.201,1.722,270.05507149034594,2161.7051598025746,95.41176470588235,51.78048780487805,8.567164179104477,FALSE,304,0.9007407407407407,1,1,0,0,3,FALSE
427,2022-03-18T23:18:01Z,2022-03-18T23:59:34Z,2492,1,2022-03-18T23:59:36Z,0.8999999761581421,Chrome,99.0.4844.51,Windows NT 10.0,1536,864,NA,1.7777777777777777,620,187,1029,209,133,238,-0.1189664552199236,0.38158237991287525,2.244160498639093,1.3674710602164688,1.4786556713378223,1.5668244237244224,4,3,2,1,3,1,1,3,1,4,3,3,1,1,4,3,1,1,3,3,0.6069769786668839,0,0,1,3,2,2.3,0,3,4,3,4,4,2,5,3,3,2,2,5,2,4,5,2,1,1,1,1,3,2,3,2,1,1,0,1,0,3,4,5,3,3,3,4,3,4,2,3,4,1,4,3,3,4,3,4,5,3,4,1,3,3,3,1,2,2,2,2,3,3,3,1,1,1,1,2,2,2,0.9894336657800659,0.8618916073713346,1.75,0,1.75,0,3.4,0,3.5555555555555554,0,3.25,0,2.5,0,2.4285714285714284,0,1,0,2.864864864864865,0,1,0,0,0.26090492439920215,0.6017410047742845,-0.14114775846592847,0.230296623154178,3,2,4,3,1,3,3,2,1,0.7867957924694432,2.7142857142857144,0,1.5,0.2306985064430642,3,3,3,2,1,1,3,4,9,NA,6,0.9511897312113419,6.5,2.2857142857142856,0,2.089587539198367,1,0.6445217858940611,3,3,3,3,3,3,3,3,3,2,3,2,3,2,1,3,5,4,1,5,1.0600988273786194,3,0,3.4,0,2.4,0,2.8,0,2.8666666666666667,0,2,1,3,4,4,3,2,3,4,2,1,3,1,3,2,3,1,3,3,2,0.9514531821875089,2.5,0,"I lived with my extended family on mother's side (grandparents, aunts ,uncles, cousins)",0,"Hispanic of Latino (e.g., Mexican American, Central American, and others) & Filipino",1,27,1,2,NA,1,3,6,Customer Representative,3,115,60,2,5,2,0,0,1,0,0,TRUE,TRUE,TRUE,TRUE,TRUE,2,0.4945562500059605,0.41629374998435376,0.45082812499254943,0.538931250013411,0.4656566666563352,0.5060193548356333,1,1,1,1,0.967741935483871,0.96875,0.057,0.346,0.661,0.022,1.816,209.24201009710836,2043.6952801926916,0.058,0.325,0.654,0.031,1.762,42.086674955793825,1867.4834409204755,0.103,0.285,0.505,0.019,1.458,152.3010313994696,1937.0567029972563,82.54545454545455,56.83870967741935,76.73684210526316,FALSE,388,1.1496296296296296,0,1,0,0,3,FALSE
429,2022-03-18T23:29:47Z,2022-03-19T00:03:18Z,2011,1,2022-03-19T00:03:19Z,0.8999999761581421,Chrome,99.0.4844.51,Windows NT 10.0,1366,768,No.,1.7786458333333333,571,125,759,190,115,118,-0.21971534404030926,0.03923352725684553,1.2631777128552268,1.1331504086287019,1.1095499895617094,0.2182377158793455,2,2,1,1,2,1,1,3,1,2,2,1,1,1,2,2,1,1,2,2,0.998683343734455,0,1,1,4,3,1.55,0,2,2,2,2,1,1,2,2,2,1,1,3,2,3,2,2,4,1,1,1,3,1,1,10,2,0,0,0,0,1,2,2,3,2,1,2,2,2,2,2,2,1,3,2,1,1,3,4,4,3,4,2,3,1,4,1,1,5,2,1,2,1,1,1,3,2,2,1,3,1,1.3847084232492477,1.245945806357946,1.75,0,1.75,0,1.8666666666666667,0,1.8888888888888888,0,2.3333333333333335,0,2.5,0,1.8571428571428572,0,2,0,2.135135135135135,0,5,0,0,-0.2128283174900995,-0.3863134357650295,0.7363034552781984,0.17499500975658444,3,1,4,1,1,1,1,2,1,0.7867957924694432,1.7142857142857142,0,1.5,-0.3498436025973552,3,3,5,2,2,1,4,4,3,NA,2,1.2724180205607036,3.5,2.857142857142857,0,-0.7825102850053112,1,-0.7952321850614983,1,2,2,2,2,4,5,4,4,2,5,4,4,4,3,5,4,5,4,3,1.2909944487358056,1.8,0,4.4,0,4,0,3.6,0,4,0,1,3,1,1,1,1,3,1,1,1,3,1,2,1,1,2,1,1,1,2,1.190974832912761,1.45,0,"I lived with my mother, but not father, most of the time. & I lived with my extended family on father's side (grandparents, aunts ,uncles, cousins)",1,"White, Caucasian, Anglo, European American & Native American/Alaskan Native/indigenous",1,26,1,2,NA,1,2,5,N/A,2,115,63,2,5,1,0,0,0,1,0,TRUE,TRUE,TRUE,TRUE,TRUE,3,0.5666468750014901,0.5438093749973923,0.5212906250022351,0.6323225806441999,0.5710096774178166,0.6069718749998138,1,1,1,0.96875,1,1,0.072,0.425,0.775,0.013,1.454,39.81738538873488,1825.0318715031626,0.085,0.412,0.646,0.029,1.166,45.583989528105526,1826.4991278034806,0.064,0.427,0.498,0.023,1.952,65.40366787307282,1891.7768841616821,111.84615384615385,40.206896551724135,84.8695652173913,FALSE,374,1.108148148148148,0,1,0,0,3,FALSE
430,2022-03-18T23:07:41Z,2022-03-19T00:03:36Z,3354,1,2022-03-19T00:03:37Z,0.8999999761581421,Chrome,99.0.4844.51,Macintosh,1440,900,n/a,1.6,2497,65,515,85,68,75,3.7403328165324004,-0.2920718140231832,0.37665993607277,-0.1617795080405368,0.14577404270185867,-0.265005854431807,3,3,1,1,3,1,2,3,1,3,3,1,1,1,3,3,2,2,3,3,0.4893604849295929,0,1,1,3,2,2.15,0,3,4,3,4,3,3,4,3,4,3,3,3,3,5,5,4,4,4,1,4,4,4,4,4,1,1,0,1,0,3,4,5,2,5,3,4,4,3,2,3,2,2,4,3,5,4,4,2,3,2,5,3,2,2,1,1,1,2,1,1,4,2,2,1,2,3,2,2,2,2,0.9062677977956192,0.828078671210825,3.625,0,2,0,3.533333333333333,0,3.6666666666666665,0,3,0,2.3333333333333335,0,1.8571428571428572,0,2,0,2.7567567567567566,0,2,0,0,1.4079534684182051,1.4313802677948049,0.16436794915095845,0.7978741084728816,3,3,4,2,1,4,3,2,1,0.9759000729485332,2.857142857142857,0,1.5,0.3136330934488383,3,3,3,3,1,1,3,9,9,1,2,0.9759000729485332,9,2.4285714285714284,0,-0.009316526567844171,0,-0.5564959991485257,2,1,1,4,2,3,3,3,4,4,2,4,2,4,4,5,5,5,4,3,1.162919151265879,2,0,3.8,0,3.6,0,3.6,0,3.6666666666666665,0,4,1,2,3,2,3,2,3,2,2,3,3,1,4,3,3,3,4,4,4,0.99472291830968,2.8,0,"I lived with my mother, but not father, most of the time.",0,"Hispanic of Latino (e.g., Mexican American, Central American, and others)",0,22,1,2,NA,1,2,3,College Student,1,175,61,2,5,2,0,0,0,0,0,TRUE,TRUE,TRUE,TRUE,TRUE,2,0.56125,0.44460322580678807,0.47159354838656803,0.610218750001397,0.5037933333329856,0.535240625000326,1,1,1,1,0.967741935483871,1,0.135,0.293,0.778,0.021,1.709,85.2886148568855,1866.7609595234578,0.06,0.335,0.62,0.015,1.55,104.50555323448447,1928.94002188574,0.184,0.245,0.587,0.026,1.482,115.57297554864205,1898.7587608259962,81.38095238095238,103.33333333333334,57,FALSE,304,0.9007407407407407,1,1,0,12,15,FALSE
431,2022-03-18T23:47:09Z,2022-03-19T00:05:55Z,1125,1,2022-03-19T00:05:56Z,0.8999999761581421,Chrome,99.0.4844.51,Windows NT 10.0,1280,1024,NA,1.25,594,66,249,65,50,60,-0.17242504928788333,-0.28655005833518277,-0.589789771403187,-0.4084328255013442,-0.22333163907425438,-0.4335791929124416,2,2,1,2,2,1,2,2,1,2,3,1,1,1,2,1,2,1,2,2,0.9880869341680844,0,1,1,1,1,1.65,0,5,3,4,5,3,5,4,3,5,3,5,5,5,5,5,5,5,4,1,5,5,5,5,4,2,0,0,0,0,3,4,5,5,5,4,5,5,5,1,4,5,5,5,3,3,5,5,5,5,5,5,5,4,1,4,3,2,4,4,3,4,3,3,3,5,5,3,1,2,2,1.572091432287407,1.6417180315870614,4.375,0,2,0,4.333333333333333,0,4.555555555555555,0,4.25,0,3.6666666666666665,0,3.2857142857142856,0,4.333333333333333,0,4.054054054054054,0,2,0,0,2.7370383970520797,2.674511660837999,0.16436794915095845,1.4194398049944787,5,5,5,5,5,5,5,8,3,1.9518001458970664,5,0,5.5,3.10486888995714,3,2,4,2,1,1,2,4,4,2,2,1.2724180205607036,4,2.142857142857143,0,-0.698640248793604,0,-1.1311612015523294,3,3,3,3,3,4,3,3,4,3,5,4,3,3,5,3,4,1,4,4,1.1254628677422756,3,0,3.6,0,3.2,0,3.8,0,3.533333333333333,0,3,1,2,3,3,2,3,2,2,3,4,3,1,2,2,3,3,3,3,4,0.8271701918685112,2.6,0,I lived with my mother and father an equal amount of time (joint custody),0,"Black or African American & Hispanic of Latino (e.g., Mexican American, Central American, and others) & Native American/Alaskan Native/indigenous",1,25,1,3,NA,1,1,4,Disabled,1,247,62,2,5,2,0,0,0,0,0,TRUE,TRUE,TRUE,TRUE,TRUE,6,0.5663031249046325,0.490971874922514,0.493890625,0.6817931035140465,0.5398032258249098,0.6111333333969116,1,1,1,0.90625,0.96875,0.967741935483871,0.073,0.337,0.505,0.009,1.362,35.29226931459814,1860.7156580331418,0.072,0.322,0.464,0.022,1.881,76.2036371107483,1902.4853355081823,0.069,0.336,0.272,0.014,1.817,153.27777656790255,2042.1490029443225,151.33333333333334,85.5,129.78571428571428,FALSE,472,1.3985185185185185,0,1,0,0,3,FALSE
432,2022-03-18T23:48:33Z,2022-03-19T00:11:17Z,1364,1,2022-03-19T00:11:18Z,0.8999999761581421,Safari,15.3,Macintosh,1440,900,I had to leave full screen mode once in the childhood part because the screen would not scroll. once I refreshed the page it let me scroll,1.6,502,111,465,69,53,67,-0.361586228297587,-0.03807105237516118,0.1949964572239059,-0.3591021620091827,-0.1618140254449022,-0.35491163495481215,1,1,1,1,1,1,1,3,1,2,3,1,2,1,3,1,1,1,3,3,1.1697953037312037,0,0,3,3,2,1.6,0,2,2,2,2,3,2,3,2,2,2,1,2,2,2,2,2,1,3,1,1,1,2,1,3,2,0,0,0,0,2,3,4,4,3,2,2,2,4,3,3,2,1,2,2,1,2,1,1,1,3,3,3,1,2,3,2,1,3,1,1,2,2,2,1,1,1,1,2,1,1,1.1598902298689069,1.0600988273786194,1.5,0,1.25,0,2.066666666666667,0,2.888888888888889,0,1.8333333333333333,0,2.3333333333333335,0,1.7142857142857142,0,1,0,2.081081081081081,0,2,0,0,-0.4102171682773084,-0.43174348667358475,-0.09409076339160714,-0.26291712503259596,2,2,3,2,2,2,1,1,1,0.9511897312113419,2,0,1,-0.3773765525135179,4,4,4,4,2,2,3,7,7,2,3,0.9511897312113419,7,3.2857142857142856,0,0.18645978295702492,0,0.027165349790339424,1,2,2,2,2,4,4,4,4,3,5,4,4,3,3,3,4,4,3,3,0.8837151016885368,1.8,0,4.2,0,3.4,0,3.4,0,3.6666666666666665,0,2,3,3,4,2,2,2,3,2,2,2,3,2,3,1,3,3,3,2,2,0.5871429486123998,2.45,0,I lived with my mother and father an equal amount of time (joint custody),0,"White, Caucasian, Anglo, European American",0,21,1,2,NA,1,3,4,student,2,200,67,3,5,2,0,1,0,0,1,TRUE,TRUE,TRUE,TRUE,TRUE,3,0.7143749999999963,0.5685937499999987,0.5740625000000072,0.7728709677419392,0.6267187500000032,0.6267666666666638,1,1,1,0.96875,1,0.967741935483871,0.072,0.407,0.475,0.017,1.731,151.71287944027142,1978.1771299183065,0.126,0.319,0.518,0.012,1.171,73.8448559263002,1856.824592624784,0.083,0.467,0.316,0.011,1.087,81.36720261264101,1905.9727443403158,101.82352941176471,97.58333333333333,98.81818181818183,FALSE,358,1.0607407407407408,0,1,0,0,3,FALSE
433,2022-03-18T23:47:01Z,2022-03-19T00:12:16Z,1514,1,2022-03-19T00:12:18Z,0.8999999761581421,Chrome,99.0.4844.51,Macintosh,1680,1050,NA,1.6,562,175,427,114,88,85,-0.2382202419869107,0.3153213116568695,0.056932213298769185,0.19586780227763384,0.5558914668975398,-0.1526236287780506,2,2,2,1,3,1,2,2,1,1,3,2,2,1,2,3,2,1,3,2,0.8522416262267903,0,1,1,3,2,1.9,0,3,2,3,3,3,3,4,3,2,3,4,3,2,3,3,2,3,2,1,1,2,3,1,4,1,1,0,0,0,2,4,2,2,2,1,1,1,2,2,2,1,1,2,2,1,3,2,2,3,3,2,4,1,1,3,1,1,3,1,1,2,2,1,2,4,1,2,1,1,1,1.416865380869865,0.5936168397046637,1.875,0,1.25,0,2.933333333333333,0,1.8888888888888888,0,2,0,2,0,1.5714285714285714,0,2.3333333333333335,0,1.9189189189189189,0,2,0,0,-0.2720449727262622,0.03956870814179425,-0.09409076339160714,-0.027261027624906446,1,2,2,3,2,2,2,3,1,1.2149857925879117,2,0,2,0.009427695341904336,4,4,4,5,2,2,2,7,7,3,2,1.1338934190276817,7,3.2857142857142856,0,0.05707446826958167,0,-0.051641888832181,2,2,3,5,3,4,5,3,4,3,5,4,2,3,4,5,4,4,4,5,1.3020130933435712,3,0,4.2,0,3.8,0,3.8,0,3.933333333333333,0,1,1,2,2,2,3,3,2,2,1,3,2,1,3,1,2,3,3,4,3,0.9403246919632545,2.2,0,"I lived with my mother, but not father, most of the time.",0,Black or African American,0,26,1,2,NA,1,2,7,Volunteer Coordinator,2,260,66,1,5,2,0,0,1,0,0,TRUE,TRUE,TRUE,TRUE,TRUE,4,0.5626354838686605,0.45753749999962745,0.502934374993667,0.6418451612880153,0.5151258064431529,0.6042137931009819,0.96875,1,1,0.96875,0.96875,0.90625,0.064,0.405,0.698,0.009,1.351,38.646941038009174,1892.6484956093452,0.048,0.387,0.63,0.03,1.558,70.46039293684622,1894.399207422774,0.063,0.441,0.49,0.022,1.902,184.11127267686734,2047.9092391416991,150.11111111111111,51.93333333333334,86.45454545454545,FALSE,434,1.285925925925926,0,1,0,0,3,FALSE
434,2022-03-18T23:53:56Z,2022-03-19T00:14:52Z,1255,1,2022-03-19T00:14:53Z,0.8999999761581421,Firefox,98.0,Windows NT 10.0,1366,768,Nope.,1.7786458333333333,561,81,365,72,44,86,-0.2402763417587553,-0.20372372301517555,-0.16833050047382228,-0.3221041643900616,-0.3463668663329587,-0.14138540621267498,3,3,1,1,2,1,1,3,1,3,4,1,1,1,2,3,1,1,4,3,0.6882472016116853,0,1,1,2,2,2,0,4,3,3,4,2,2,3,3,3,2,1,4,1,3,3,2,3,1,1,2,3,3,2,1,2,0,0,0,0,2,3,1,3,4,3,4,4,4,2,3,2,1,4,4,2,2,2,2,4,4,4,1,1,1,4,4,1,2,3,2,4,3,2,2,3,1,2,1,2,2,1.070348375831741,0.7237468644557459,2.125,0,1.75,0,2.7333333333333334,0,3.111111111111111,0,2.6666666666666665,0,2.5,0,2.4285714285714284,0,2,0,2.6486486486486487,0,1,0,0,0.36398576869918936,0.37999908962538365,-0.14114775846592847,0.11942566557972759,3,3,5,2,2,3,2,3,1,0.7559289460184544,2.857142857142857,0,2,0.5070352173765494,1,2,3,3,1,1,2,4,10,1,1,1.2149857925879117,7,1.8571428571428572,0,-0.713786753407355,0,-1.2951921291888384,3,2,2,3,2,3,2,3,3,2,2,2,3,2,2,4,3,4,2,2,0.7367883976130072,2.4,0,2.8,0,2.6,0,2.4,0,2.6,0,1,1,1,2,2,1,3,3,1,1,4,3,2,1,1,2,1,1,1,2,0.9233805168766387,1.7,0,"I lived with my mother and father an equal amount of time (joint custody) & I lived with my extended family on father's side (grandparents, aunts ,uncles, cousins)",1,"Asian or Asian American (e.g., Chinese, Japanese, and others)",0,24,0,1,NA,1,2,6,Unemployed,2,130,66,1,5,2,0,0,0,0,0,TRUE,TRUE,TRUE,TRUE,TRUE,5,0.6184375,0.4782258064516129,0.5634838709677419,0.71553125,0.5701379310344827,0.5923870967741935,1,0.96875,0.96875,1,0.90625,0.96875,0.07,0.341,0.319,0.016,1.384,210.25069568313302,2085.4053265267617,0.055,0.36,0.406,0.015,1.622,128.48199363359112,2055.6814683634125,0.235,0.23,0.636,0.012,1.558,23.199898958274456,1804.8492338902365,86.49999999999999,108.13333333333334,129.83333333333334,FALSE,384,1.1377777777777778,0,1,0,0,3,FALSE
436,2022-03-18T23:41:46Z,2022-03-19T00:17:36Z,2149,1,2022-03-19T00:17:38Z,0.800000011920929,Chrome,99.0.4844.74,Windows NT 10.0,1536,1024,NA,1.5,1573,61,294,72,31,71,1.840496627347985,-0.31415883677518514,-0.4262926404392093,-0.3221041643900616,-0.6129431920601515,-0.3099587446933096,3,3,2,2,2,1,1,3,1,2,3,2,2,3,3,3,1,2,3,3,0.6048053188292994,0,1,1,2,3,2.25,0,5,3,3,3,4,3,3,3,4,2,2,3,1,3,4,3,5,5,5,5,4,4,5,3,1,0,0,5,0,3,2,2,2,5,3,4,4,5,2,2,3,3,5,5,3,5,5,5,5,5,5,1,1,2,1,1,4,2,5,5,1,1,5,1,5,2,3,4,5,5,1.624234631492057,0.8997354108424374,4.5,0,4.25,0,3.066666666666667,0,3.3333333333333335,0,4,0,1.8333333333333333,0,3.2857142857142856,0,2.6666666666666665,0,3.2432432432432434,0,2,0,0,2.291816878054264,1.822059038919675,0.9397440867786553,1.3809015628491652,4,3,3,5,3,4,4,8,8,0.9759000729485332,3.7142857142857144,0,8,3.3254682265437276,3,3,3,3,2,2,2,3,3,3,2,0.6900655593423543,3,2.5714285714285716,0,-0.665444751374891,0,-0.8787341463941569,4,4,4,2,4,2,2,2,2,2,5,3,5,4,3,1,2,2,3,2,1.2227992865708155,3.6,0,2.8,0,2.6,0,2.6,0,2.6666666666666665,0,2,4,4,3,4,4,4,3,4,4,4,3,3,4,1,3,3,3,3,3,0.9679060415469871,3.3,0,I lived with my mother and father an equal amount of time (joint custody),0,"Asian or Asian American (e.g., Chinese, Japanese, and others)",0,24,1,3,NA,1,1,4,Student,1,113,66,1,5,2,0,1,1,0,1,TRUE,TRUE,TRUE,TRUE,TRUE,6,0.41795312499720605,0.40303437499981376,0.4366218750001863,0.5142037037025999,0.45513571428507565,0.4880466666628917,1,1,1,0.84375,0.875,0.9375,0.055,0.351,0.758,0.025,1.872,74.97766681181282,1923.8062372833872,0.052,0.334,0.864,0.024,1.816,112.62899319978062,1977.422887530143,0.054,0.35,0.842,0.02,2.036,86.80582943726999,1962.9895774157599,74.88,75.66666666666667,101.8,FALSE,434,1.285925925925926,0,1,0,3,6,FALSE
437,2022-03-18T23:57:27Z,2022-03-19T00:19:24Z,1316,1,2022-03-19T00:19:24Z,0.8999999761581421,Safari,15.1,Macintosh,1680,1050,NA,1.6,510,234,301,83,52,80,-0.34513743012283016,0.6411048972488977,-0.40085975340036833,-0.18644483978661755,-0.18231989665468626,-0.20881474160492883,3,3,2,3,3,1,2,3,1,3,3,1,1,2,3,3,2,1,4,3,0.5501196042201808,0,0,1,2,1,2.35,0,1,1,1,1,1,1,2,2,1,1,1,2,1,2,2,1,1,1,1,1,1,1,1,0,2,0,0,0,0,2,2,1,1,1,1,1,1,1,1,1,1,1,2,1,1,2,1,1,1,1,1,1,1,1,1,1,1,1,1,1,2,2,1,1,1,1,2,1,1,2,1.8195633571851273,1.7593288763724921,1,0,1.5,0,1.3333333333333333,0,1.2222222222222223,0,1.1666666666666667,0,1,0,1.2857142857142858,0,1,0,1.162162162162162,0,0,0,0,-1.331365138617617,-1.371417872998593,-0.4466634660828154,-0.9090406695407043,1,1,3,1,1,1,1,1,1,1.5735915849388864,1.2857142857142858,0,1,-0.7920494875423887,4,4,3,4,3,3,4,6,6,NA,3,0.7559289460184544,6,3.5714285714285716,0,0.40966740893729353,1,0.31792412501302936,1,1,1,2,1,5,4,4,5,3,5,1,4,4,4,4,4,4,3,4,1.1832159566199232,1.2,0,3.8,0,3.6,0,4.2,0,3.8666666666666667,0,1,3,3,4,3,4,4,3,1,2,3,3,4,4,1,3,3,4,3,3,1.0894228312566052,2.95,0,NA,NA,"White, Caucasian, Anglo, European American",0,28,1,2,NA,1,3,4,Full-time student,3,121,60,2,5,2,0,0,1,0,0,TRUE,TRUE,TRUE,TRUE,TRUE,5,0.6802903225806456,0.49812903225806265,0.5253749999999981,0.7657666666666653,0.5849199999999977,0.6388620689655192,0.96875,0.96875,1,0.9375,0.8064516129032258,0.9354838709677419,0.069,0.364,0.432,0.015,1.955,99.67380679604915,1971.8791285727702,0.048,0.384,0.413,0.02,2.016,76.47396362499455,1975.3266711606095,0.065,0.428,0.305,0.012,1.454,193.27736835671422,2101.7011879782526,130.33333333333334,100.8,121.16666666666666,FALSE,420,1.2444444444444445,0,1,0,0,3,FALSE
438,2022-03-18T23:59:40Z,2022-03-19T00:19:51Z,1211,1,2022-03-19T00:19:52Z,0.8999999761581421,Chrome,99.0.4844.74,Windows NT 10.0,1600,900,"Fun game and enjoyable survey, thanks for it",1.7777777777777777,754,44,195,33,36,44,0.15655091420725348,-0.4080286834711933,-0.7859863285599602,-0.8030781334386359,-0.5104138360112311,-0.6133907539584519,1,2,1,1,2,1,1,2,1,2,3,1,1,2,2,2,1,1,2,3,1.025978352085154,0,0,3,5,3,1.6,0,5,2,2,3,1,2,2,2,3,3,2,5,4,5,4,2,3,1,2,4,1,3,2,4,1,1,0,3,0,2,2,3,2,2,1,1,1,2,1,1,3,2,3,3,3,1,1,1,2,2,3,1,3,1,3,2,2,4,4,2,1,1,1,1,3,3,3,3,1,1,1.3710871160797478,1.1126972805283737,2.25,0,2,0,3,0,1.7777777777777777,0,1.9166666666666667,0,2.1666666666666665,0,2.142857142857143,0,2.3333333333333335,0,2,0,2,0,0,0.024038303454551324,0.2678006305633457,0.16436794915095845,0.21608428985715206,1,2,5,2,1,3,1,3,1,1.4638501094227998,2.142857142857143,0,2,0.09236228234767849,5,4,4,3,2,1,4,3,4,3,3,1.4142135623730951,3.5,3.2857142857142856,0,-0.23191923190205752,0,-0.22766492162263857,3,2,3,2,2,5,4,5,5,5,5,3,5,4,4,4,5,5,2,5,1.5946338585572373,2.4,0,4.6,0,4,0,4.6,0,4.4,0,2,2,1,3,3,1,1,4,2,2,2,4,3,2,2,2,1,1,1,2,0.7163503994113789,2.05,0,"I lived with my mother, but not father, most of the time.",0,Black or African American,0,25,0,1,NA,1,2,4,Tax Preparer,2,158,68,2,5,2,0,0,0,0,0,TRUE,TRUE,TRUE,TRUE,TRUE,6,0.3963531250013039,0.36529687499813734,0.40708749999757854,0.4661960000002384,0.44005333333214125,0.47799285714434725,1,1,1,0.78125,0.9375,0.875,0.051,0.325,0.67,0.022,2.026,61.406573520927836,1922.3987371079327,0.057,0.282,0.742,0.016,1.615,103.52780700439311,1955.813681459545,0.037,0.345,0.76,0.014,1.457,32.912830867551286,1933.513401274307,92.0909090909091,100.9375,104.07142857142857,FALSE,320,0.9481481481481481,0,1,0,0,3,FALSE
439,2022-03-19T00:07:28Z,2022-03-19T00:23:18Z,950,1,2022-03-19T00:23:21Z,0.8999999761581421,Chrome,99.0.4844.51,Windows NT 10.0,1536,864,NA,1.7777777777777777,478,75,174,49,33,81,-0.4109326228218575,-0.23685425714317843,-0.8622849896764831,-0.6057554794699901,-0.5719314496405833,-0.19757651903955317,2,2,1,1,4,1,2,2,1,2,2,1,1,1,2,2,1,1,2,1,1.0760551736979407,0,1,3,3,2,1.6,0,2,1,4,1,3,1,1,3,1,2,3,1,1,3,3,3,2,1,1,1,2,3,1,1,2,0,0,0,0,1,1,2,1,1,1,1,1,1,1,1,1,1,1,2,1,4,3,1,1,1,2,1,1,1,1,1,1,2,1,1,2,3,2,1,1,1,1,1,1,1,1.7929625525132182,1.4735767952260144,1.75,0,1,0,2,0,1.1111111111111112,0,1.5,0,1.1666666666666667,0,1.7142857142857142,0,1,0,1.3513513513513513,0,1,0,0,-0.7216529106304604,-0.6703004206652622,-0.39960647100849406,-0.5349534458368781,1,1,1,1,1,1,1,1,1,1.9518001458970664,1,0,1,-0.9579186615539372,5,5,5,5,4,4,5,5,5,5,4,1.4638501094227998,5,4.714285714285714,0,0.8098866971415565,0,1.1809148992434904,3,3,4,3,2,2,5,3,4,3,5,4,3,4,5,5,4,4,5,3,1.3345232785352157,3,0,3.8,0,4.2,0,3.8,0,3.933333333333333,0,2,1,1,4,1,2,3,2,1,1,2,1,1,2,1,2,1,1,1,2,0.9233805168766387,1.6,0,NA,NA,"White, Caucasian, Anglo, European American",0,23,0,1,NA,1,4,6,Student/ Musician,4,145,67,2,5,2,0,0,1,0,0,TRUE,TRUE,TRUE,TRUE,TRUE,5,0.6150677419343302,0.48297187500353905,0.5296593749951571,0.6393750000021288,0.5983862068940853,0.8025888888913172,1,1,1,0.9032258064516129,0.90625,0.84375,0.089,0.296,0.414,0.006,1.667,120.23861808672804,1996.8285931014748,0.082,0.268,0.421,0.008,1.643,190.83002984552954,2054.8389994059694,0.073,0.339,0.352,0.017,2.013,118.94527390920365,1975.0246220993758,277.8333333333333,205.375,118.41176470588233,FALSE,338,1.0014814814814814,0,1,0,0,3,FALSE
440,2022-03-18T23:42:35Z,2022-03-19T00:23:29Z,2453,1,2022-03-19T00:23:30Z,0.8999999761581421,Chrome,99.0.4844.74,Windows NT 10.0,1536,864,NA,1.7777777777777777,1022,207,758,131,42,122,0.7075856530616076,0.49201749367288483,1.2595444432782494,0.40552312211932007,-0.38737860875252683,0.26319060614084805,4,4,4,4,4,4,4,4,4,4,4,4,4,4,4,4,4,4,4,4,1.538967528127731,0,0,4,1,1,4,0,5,5,5,5,5,5,5,5,5,5,5,5,1,5,5,5,5,2,3,5,5,5,5,8,1,2,0,6,0,5,5,5,5,5,5,5,5,5,4,5,5,1,5,5,5,5,5,5,5,5,5,1,3,4,3,4,5,4,3,3,4,5,5,5,5,5,1,5,2,2,1.8025674049114637,2.065591117977289,4.375,0,2.5,0,4.733333333333333,0,5,0,4.583333333333333,0,3.3333333333333335,0,4.142857142857143,0,5,0,4.4324324324324325,0,4,0,0,2.9826778558094946,3.014352041660438,0.7753993643847322,1.8948757030225851,5,5,5,5,3,5,5,8,3,1.9023794624226837,4.714285714285714,0,5.5,2.9389997159455916,2,1,2,1,1,1,1,1,1,1,1,1.4638501094227998,1,1.2857142857142858,0,-1.797565582874064,0,-2.2649211521894324,1,1,1,1,1,5,5,5,5,1,5,5,3,5,5,5,5,5,5,5,1.98086080374405,1,0,5,0,3.8,0,5,0,4.6,0,4,4,4,4,4,4,4,4,4,4,4,4,4,4,2,4,3,4,4,4,1.2513150976809202,3.85,0,"I lived with my extended family on father's side (grandparents, aunts ,uncles, cousins) & I was in foster care most of the time.",1,"White, Caucasian, Anglo, European American",0,26,1,2,NA,1,2,6,unemployed,2,98,62,1,5,2,0,0,0,0,0,TRUE,TRUE,TRUE,TRUE,TRUE,3,0.6930225806447767,0.49794062500074504,0.589003125000745,0.7498281249972061,0.6110300000011921,0.6848733333344261,1,1,1,1,0.967741935483871,0.9375,0.065,0.414,0.399,0.012,1.549,28.736315870932117,1869.5289924152041,0.073,0.362,0.513,0.013,1.509,67.6819204371305,1893.8441312498774,0.201,0.314,0.547,0.02,1.72,36.58500101590286,1819.4274143978296,129.08333333333331,116.07692307692308,86,FALSE,390,1.1555555555555557,0,1,0,0,3,FALSE
441,2022-03-18T23:59:40Z,2022-03-19T00:23:51Z,1450,1,2022-03-19T00:23:52Z,0.8999999761581421,Chrome,99.0.4844.51,Windows NT 10.0,1500,1000,None,1.5,555,86,417,85,58,88,-0.25261294038982296,-0.17611494457517315,0.020599517528996365,-0.1617795080405368,-0.05928466939598191,-0.1189089610819237,1,1,2,1,2,1,1,2,1,1,1,1,2,1,1,1,1,2,2,1,1.3178930553209385,0,1,1,3,2,1.3,0,3,3,4,4,4,3,4,3,2,2,2,3,1,4,5,2,5,1,3,2,2,3,2,6,1,1,0,3,1,4,5,4,5,4,2,5,5,5,3,4,1,1,4,2,2,4,3,4,1,3,5,1,4,3,5,2,3,5,5,5,3,4,3,2,4,1,3,1,3,3,1.3836236534601505,0.9154754164341269,2.5,0,2.5,0,3.1333333333333333,0,4.333333333333333,0,2.6666666666666665,0,3.3333333333333335,0,4,0,2.3333333333333335,0,3.4054054054054053,0,3,1,0,1.0987109355182447,1.0487648390389859,1.255401572399185,1.1520832057190855,1,1,2,2,2,3,3,5,3,1.3451854182690985,2,0,4,0.7830361910527488,3,4,4,1,1,1,1,2,3,2,1,1.7043362064926932,2.5,2.142857142857143,0,-1.3127955731775556,0,-1.5052367704601095,2,3,3,5,3,2,3,1,4,2,4,4,2,5,4,3,3,2,2,1,1.1254628677422756,3.2,0,3,0,2.4,0,3,0,2.8,0,1,1,1,2,4,2,2,3,1,1,4,1,1,1,1,1,1,2,2,3,1.190974832912761,1.75,0,"I lived with my mother, but not father, most of the time.",0,"White, Caucasian, Anglo, European American",0,29,0,1,NA,1,3,6,IT Technician,5,251,72,3,5,2,0,0,1,0,0,TRUE,TRUE,TRUE,TRUE,TRUE,3,0.604546875,0.5365812500026077,0.5577000000067055,0.6523437500037252,0.6107593750003725,0.6697718750014902,1,1,1,1,1,1,0.15,0.312,0.587,0.013,1.57,183.63422077183031,1980.3676235346607,0.076,0.425,0.695,0.015,1.315,49.4463215250393,1836.459151760645,0.26,0.3,0.846,0.013,1.076,68.22062014719816,1851.6415299737641,120.76923076923077,87.66666666666667,82.76923076923077,TRUE,450,1.3333333333333335,0,1,0,0,3,FALSE
443,2022-03-18T23:58:06Z,2022-03-19T00:30:21Z,1935,1,2022-03-19T00:30:23Z,0.8999999761581421,Safari,15.2,Macintosh,1440,900,NA,1.6,583,209,353,79,591,65,-0.195042146778174,0.5030610050488858,-0.21192973539754967,-0.23577550327877903,10.870344685418921,-0.3773880800855634,3,4,3,3,4,3,4,4,1,4,4,1,1,3,4,4,1,4,4,3,1.105012502906165,0,1,2,3,2,3.1,0,2,2,3,2,1,1,5,2,2,2,3,3,5,3,4,1,1,1,1,2,2,1,2,4,2,0,0,0,0,1,3,4,3,5,2,3,1,5,3,2,5,1,4,1,2,1,1,1,3,1,5,1,1,1,1,1,1,4,4,3,2,1,2,1,1,2,2,3,2,3,1.4221541838079732,1.2344267996967353,1.375,0,2.5,0,2.6666666666666665,0,3,0,2.0833333333333335,0,1.6666666666666667,0,2.4285714285714284,0,1.3333333333333333,0,2.2432432432432434,0,2,0,0,-0.38609186429220504,-0.15355817494132767,0.33667375751266887,0.0915577912856706,3,4,4,2,1,3,4,6,2,1.1126972805283737,3,0,4,1.363578300093168,5,5,5,5,1,2,4,7,10,2,2,1.8126539343499315,8.5,3.857142857142857,0,0.11419387330642776,0,0.29275964286421047,2,2,2,2,2,4,5,4,5,2,5,4,5,3,5,4,4,5,5,2,1.5675276256394517,2,0,4.4,0,4.2,0,3.8,0,4.133333333333334,0,2,2,4,2,1,4,4,2,1,1,2,3,3,3,1,3,2,3,3,4,1.0513149660756937,2.5,0,"I lived with my mother, but not father, most of the time.",0,Black or African American,0,21,1,2,NA,1,3,3,student,3,140,66,1,5,2,0,0,1,0,0,TRUE,TRUE,TRUE,TRUE,TRUE,6,0.6069677419354811,0.5408749999999982,0.4999687500000036,0.6387187499999996,0.5702500000000018,0.53209375,1,1,1,1,1,1,0.074,0.364,0.591,0.043,1.991,108.99231687773903,1900.6442197732226,0.151,0.302,0.621,0.067,1.633,21.53076478996741,1803.662420247055,0.108,0.404,0.547,0.035,1.489,9.408672211055988,1789.6938208045415,46.30232558139536,24.37313432835821,42.542857142857144,FALSE,438,1.2977777777777777,0,1,0,0,3,FALSE
445,2022-03-19T00:12:44Z,2022-03-19T00:31:39Z,1135,1,2022-03-19T00:31:40Z,0.8999999761581421,Chrome,99.0.4844.51,Macintosh,1440,900,NA,1.6,463,67,353,88,64,60,-0.4417741193995266,-0.28102830264718226,-0.21192973539754967,-0.12478151042141572,0.06375055786272243,-0.4335791929124416,3,4,3,3,4,1,2,4,1,4,4,2,2,1,4,4,2,1,4,4,0.6863327411532597,0,1,1,2,2,2.85,0,4,4,3,3,3,3,5,4,2,2,3,2,2,3,3,3,2,1,1,2,2,2,1,0,2,0,0,0,0,1,2,3,4,4,2,4,3,3,4,4,1,2,2,3,3,3,2,4,4,4,2,1,1,1,1,1,1,1,1,1,3,3,3,2,3,2,1,1,1,1,1.1930731006201687,0.816496580927726,1.75,0,1,0,3.066666666666667,0,2.888888888888889,0,3,0,1.1666666666666667,0,1.8571428571428572,0,2.3333333333333335,0,2.4054054054054053,0,0,0,0,-0.03737156123480268,0.2556072835662443,-0.6189692744445258,-0.18168099543914074,4,4,3,3,3,5,4,3,1,0.9759000729485332,3.7142857142857144,0,2,1.0046427394111945,4,3,3,4,2,2,4,5,8,5,3,0.8997354108424374,6.5,3.142857142857143,0,0.7376207874909593,0,0.28546906370720415,3,3,3,3,3,4,2,4,4,1,5,3,4,2,3,3,4,4,3,3,0.816496580927726,3,0,4,0,2.6,0,3.2,0,3.2666666666666666,0,2,1,1,4,2,1,2,3,3,3,2,3,1,2,1,3,1,1,2,1,0.6708203932499369,1.95,0,I lived with my mother and father an equal amount of time (joint custody),0,Filipino,0,20,0,1,NA,1,3,4,student,5,145,65,3,5,2,0,0,3,0,0,TRUE,TRUE,TRUE,TRUE,TRUE,6,0.4237999999998137,0.39223548386750684,0.4215812499998137,0.4890851851845229,0.46551666666766006,0.5105214285722801,1,1,1,0.8709677419354839,0.9375,0.875,0.051,0.349,0.709,0.012,1.42,53.30665854259437,1926.7400665808298,0.052,0.323,0.742,0.011,1.167,105.04121767123603,1951.1760348434295,0.047,0.327,0.494,0.017,1.675,173.0728108513194,2071.379776883833,118.33333333333333,106.0909090909091,98.52941176470588,FALSE,438,1.2977777777777777,0,1,0,3,6,FALSE
446,2022-03-19T00:17:06Z,2022-03-19T00:33:57Z,1011,1,2022-03-19T00:33:58Z,0.8999999761581421,Chrome,99.0.4844.74,Windows NT 10.0,1536,864,No thank you.,1.7777777777777777,534,58,205,49,40,82,-0.2957910355985596,-0.3307241038391866,-0.7496536327901874,-0.6057554794699901,-0.42839035117209495,-0.18633829647417754,4,3,3,3,4,1,2,4,1,4,4,4,4,2,4,4,2,2,4,4,1.019545822516343,0,1,1,2,1,3.15,0,4,4,3,4,3,2,5,2,2,5,5,5,1,4,4,2,3,1,1,1,2,2,1,1,2,0,0,0,0,1,1,1,1,1,1,1,1,1,1,1,1,1,1,2,1,2,1,1,1,3,2,1,1,1,3,1,1,5,5,1,3,3,2,1,1,1,1,1,2,2,1.8224492644025296,1.2344267996967353,1.625,0,1.5,0,3.533333333333333,0,1,0,1.3333333333333333,0,1.5,0,2.857142857142857,0,1,0,1.5405405405405406,0,1,0,0,-0.6799819310198275,0.02717869425764339,-0.22730066264678367,-0.10006098419457014,1,1,1,1,1,1,1,1,1,1.9518001458970664,1,0,1,-0.9579186615539372,5,5,5,5,4,4,5,6,7,3,3,1.4638501094227998,6.5,4.714285714285714,0,0.309970182831297,0,0.8764209918030756,3,3,3,1,3,3,5,5,5,5,1,4,5,4,2,5,3,5,5,4,1.6846647257229665,2.6,0,3.2,0,5,0,4,0,4.066666666666666,0,4,4,4,1,4,4,4,2,2,2,4,3,1,2,3,3,1,3,1,4,1.1652874052533586,2.8,0,I lived with my mother and father an equal amount of time (joint custody),0,"White, Caucasian, Anglo, European American",0,26,0,1,NA,1,3,5,Question and Answer Analyst,2,216,70,3,5,2,0,0,1,0,0,TRUE,TRUE,TRUE,TRUE,TRUE,1,0.5877968750037253,0.5464406249970197,0.584393750000745,0.7196925925965663,0.6944733333329359,0.8027700000067551,1,1,1,0.8709677419354839,0.9375,0.967741935483871,0.096,0.391,0.486,0.006,1.354,20.456061428860313,1844.2392438144352,0.094,0.362,0.542,0.008,1.485,44.60333540392592,1888.9727852159895,0.075,0.402,0.419,0.012,2.041,116.02385564944392,2020.2425235145931,225.66666666666669,185.625,170.08333333333331,FALSE,385,1.1407407407407408,0,1,0,0,3,FALSE
447,2022-03-19T00:15:38Z,2022-03-19T00:34:04Z,1106,1,2022-03-19T00:34:06Z,0.8999999761581421,Chrome,99.0.4844.51,Macintosh,1440,900,NA,1.6,490,66,293,81,48,76,-0.38625942555972226,-0.28655005833518277,-0.4299259100161866,-0.2111101715326983,-0.26434338149382247,-0.25376763186643136,1,1,1,1,1,1,1,1,1,1,1,1,1,1,1,1,1,1,1,1,1.538967528127731,0,1,1,4,4,1,0,3,2,3,3,3,2,3,3,2,2,3,3,2,3,2,1,2,2,1,1,3,3,2,2,2,0,0,0,0,1,2,3,2,3,2,2,1,3,2,2,2,1,3,2,3,4,4,1,3,3,4,1,3,1,1,1,1,1,1,1,2,3,2,1,1,1,2,2,1,1,1.3254270092150517,0.6399404734221844,1.875,0,1.5,0,2.6,0,2.111111111111111,0,2.5,0,1.8333333333333333,0,1.5714285714285714,0,1,0,2,0,1,0,0,-0.2194079458496731,-0.07056474860621828,-0.22730066264678367,-0.14893270562650096,2,3,3,2,2,2,2,3,1,0.7867957924694432,2.2857142857142856,0,2,0.17529686935345262,4,4,4,4,3,2,4,6,4,5,3,0.9511897312113419,5,3.5714285714285716,0,0.466676080124282,0,0.35264750891976426,3,1,1,4,2,3,5,3,4,2,5,4,3,4,4,4,3,2,2,2,1.0997835284835873,2.2,0,3.4,0,3.2,0,3.4,0,3.3333333333333335,0,2,2,1,1,2,1,1,1,1,1,2,1,2,2,1,1,1,1,2,1,1.145931016569864,1.35,0,"I lived with my mother, but not father, most of the time.",0,"White, Caucasian, Anglo, European American",0,27,1,2,NA,1,2,6,Student,1,111,62,2,5,2,0,0,1,0,0,TRUE,TRUE,TRUE,TRUE,TRUE,5,0.44894062500260773,0.41851874999981376,0.45918750000279396,0.5300821428575686,0.4919142857119441,0.5707838709671651,1,1,1,0.875,0.875,0.96875,0.084,0.328,0.708,0.016,2.009,127.2506131213098,1961.8118882931165,0.055,0.33,0.75,0.021,1.953,118.01370779745604,1987.1822826234486,0.058,0.321,0.522,0.014,1.807,77.87586077110662,1940.0918697190589,125.56249999999999,93,129.07142857142856,FALSE,434,1.285925925925926,0,1,0,0,3,FALSE
448,2022-03-19T00:07:23Z,2022-03-19T00:36:44Z,1760,1,2022-03-19T00:36:44Z,0.8999999761581421,Chrome,99.0.4844.74,Macintosh,1440,900,NA,1.6,608,123,580,156,66,126,-0.14363965248205887,0.02819001588084457,0.6128224585762934,0.7138397689453293,0.10476230028229055,0.3081434964023506,2,2,1,1,2,1,1,3,1,2,3,1,1,1,2,2,1,1,2,3,0.9333020044867296,0,1,1,3,2,1.65,0,2,2,2,2,2,2,3,3,2,3,4,4,2,3,2,1,5,1,1,2,4,2,3,1,1,1,0,1,0,1,2,1,1,2,1,2,1,4,2,1,2,1,2,2,2,2,2,5,5,2,4,1,1,1,3,1,2,2,2,1,1,2,2,3,4,4,2,2,2,2,1.4907119849998598,0.8837151016885368,2.375,0,2,0,2.533333333333333,0,1.6666666666666667,0,2.3333333333333335,0,1.8333333333333333,0,1.7142857142857142,0,3.6666666666666665,0,2.081081081081081,0,1,0,0,0.15782408009921495,0.15402883640490772,-0.05499485428507328,0.04951699105991722,2,2,3,2,2,3,2,3,1,0.7867957924694432,2.2857142857142856,0,2,0.17529686935345262,3,3,3,3,1,1,4,6,6,5,3,0.9511897312113419,6,2.5714285714285716,0,0.6473058850354002,0,-0.07915149742532807,2,5,3,3,4,3,5,3,3,4,3,3,3,5,4,4,4,3,4,2,0.8338093878327919,3.4,0,3.2,0,4,0,3.4,0,3.533333333333333,0,3,2,3,1,3,3,3,2,3,3,3,3,3,3,2,3,3,3,3,3,0.4893604849295929,2.75,0,I lived with my mother and father an equal amount of time (joint custody),0,"Hispanic of Latino (e.g., Mexican American, Central American, and others) & White, Caucasian, Anglo, European American",1,19,1,2,NA,1,3,4,Cashier,5,107,67,1,5,2,0,0,1,0,0,TRUE,TRUE,TRUE,TRUE,TRUE,2,0.4578312500000066,0.47601562500001093,0.4875218750000004,0.5484379310344771,0.49592758620690136,0.5560419354838725,1,1,1,0.9354838709677419,0.9354838709677419,0.96875,0.061,0.385,0.568,0.026,1.688,40.2579931270761,1862.5618151095507,0.057,0.345,0.493,0.038,2.063,155.26482151055777,2002.1572678987225,0.061,0.35,0.557,0.018,1.738,63.915692577121106,1911.83470653273,64.92307692307692,54.289473684210535,96.55555555555556,FALSE,468,1.3866666666666665,0,1,0,0,3,FALSE
449,2022-03-19T00:18:53Z,2022-03-19T00:37:24Z,1111,1,2022-03-19T00:37:25Z,0.800000011920929,Chrome,99.0.4844.51,Macintosh,1280,800,no,1.6,499,68,297,45,40,73,-0.36775452761312083,-0.2755065469591818,-0.41539283170827745,-0.6550861429621515,-0.42839035117209495,-0.2874822995625583,2,2,1,1,1,1,2,3,1,1,4,1,1,2,1,2,1,1,4,2,1.1697953037312037,0,1,4,4,4,1.7,0,4,3,3,3,3,4,2,4,3,3,4,3,3,4,4,3,4,1,1,3,4,4,3,4,1,0,0,1,0,2,4,3,3,3,3,2,2,3,2,2,3,2,3,3,2,4,4,3,4,4,4,1,1,1,3,2,1,3,3,3,4,5,4,3,5,3,2,2,2,2,1.0540925533894598,0.7037315505489968,2.875,0,2,0,3.3333333333333335,0,2.7777777777777777,0,3,0,2,0,3.2857142857142856,0,3.6666666666666665,0,2.891891891891892,0,2,0,0,1.0087893479374053,1.075609869121314,0.16436794915095845,0.6199889091361362,2,2,3,2,1,2,2,3,2,0.9511897312113419,2,0,2.5,0.20282981926961546,3,3,3,3,1,1,1,4,5,NA,2,1.3801311186847085,4.5,2.142857142857143,0,-0.511565577638634,1,-1.0172159807554126,3,3,3,5,3,4,5,4,4,2,5,5,1,3,4,2,5,4,3,5,1.486446705914413,3.4,0,4.6,0,2.6,0,4,0,3.7333333333333334,0,1,1,1,2,1,2,2,2,2,1,2,1,1,2,1,2,2,2,2,2,0.8522416262267903,1.6,0,I lived with my mother and father an equal amount of time (joint custody),0,"White, Caucasian, Anglo, European American",0,26,1,2,NA,1,2,4,unemployed,1,280,66,1,5,2,0,0,0,0,0,TRUE,TRUE,TRUE,TRUE,TRUE,1,0.6069562500012107,0.48723124999925493,0.5151625000003259,0.7404656249999534,0.5446968750001397,0.5760125000004191,1,1,1,1,1,1,0.113,0.315,0.575,0.028,1.896,40.21991791266455,1821.4922742083652,0.09,0.35,0.655,0.03,1.839,6.975606579401835,1787.2329149692669,0.135,0.334,0.498,0.006,1.164,32.08852245450169,1815.3241541704776,67.71428571428571,61.300000000000004,193.99999999999997,FALSE,324,0.96,0,1,0,0,3,FALSE
450,2022-03-19T00:24:55Z,2022-03-19T00:37:41Z,765,1,2022-03-19T00:37:41Z,0.8999999761581421,Firefox,98.0,Windows NT 10.0,1536,864,NA,1.7777777777777777,430,39,140,34,25,52,-0.5096254118703986,-0.4356374619111957,-0.9858161552937107,-0.7907454675655956,-0.7359784193188558,-0.5234849734354468,3,2,2,2,3,2,2,2,1,2,4,1,1,1,3,3,1,1,3,2,0.7451598203705946,0,1,1,3,3,2.05,0,5,3,3,3,2,3,3,4,3,3,4,5,1,5,4,2,3,1,1,2,3,3,3,1,2,0,0,0,0,3,1,1,2,3,1,1,1,1,2,2,5,1,3,2,3,3,5,5,5,5,3,1,2,2,2,2,2,2,2,1,1,2,2,1,3,2,1,2,2,2,1.4627507100116683,1.0600988273786194,2.25,0,1.75,0,3.4,0,1.5555555555555556,0,3.4166666666666665,0,2,0,1.7142857142857142,0,2,0,2.2972972972972974,0,1,0,0,0.21704073533537793,0.5722409717167811,-0.14114775846592847,0.21554660662542632,2,2,3,1,1,2,4,2,1,1.2724180205607036,2.142857142857143,0,1.5,-0.10103984158003264,3,3,4,4,1,1,3,5,3,3,2,1.2535663410560174,4,2.7142857142857144,0,-0.4848149464637728,0,-0.6913117508138321,3,2,3,3,2,3,2,3,3,2,5,3,4,3,3,1,3,3,2,2,0.9411239481143202,2.6,0,3.4,0,2.2,0,2.8,0,2.8,0,1,1,2,4,2,2,3,4,3,2,2,3,2,3,3,3,1,2,3,2,0.7254762501100116,2.4,0,I lived with my mother and father an equal amount of time (joint custody),0,"White, Caucasian, Anglo, European American",0,26,1,2,NA,1,1,6,office assistant,2,116,62,2,5,2,0,0,1,0,0,TRUE,TRUE,TRUE,TRUE,TRUE,4,0.4304375,0.39515625,0.43524999999999997,0.5136551724137931,0.4765666666666667,0.49825,1,1,1,0.90625,0.9375,1,0.098,0.308,0.764,0.031,1.886,33.66346848708619,1818.4546586639153,0.06,0.315,0.773,0.026,2.121,69.15312153853961,1915.9886210634554,0.056,0.339,0.655,0.019,1.892,133.03889874202164,1988.0946342684747,60.83870967741935,81.57692307692308,99.57894736842105,FALSE,303,0.8977777777777777,0,1,0,3,6,FALSE
451,2022-03-19T00:02:44Z,2022-03-19T00:37:48Z,2104,1,2022-03-19T00:37:49Z,1,Chrome,96.0.4664.111,CrOS x86_64 14268.67.0,1536,864,no,1.7777777777777777,546,98,661,334,102,190,-0.2711178383364244,-0.10985387631916742,0.9071172943114532,2.9090542943465145,0.8429736638345166,1.0273897405863917,1,2,1,1,1,1,1,2,1,1,4,1,1,1,1,1,1,1,1,3,1.3869694338832115,0,1,2,4,5,1.35,0,3,2,1,2,1,2,1,2,1,1,1,3,2,3,4,2,1,2,1,1,1,1,1,4,2,0,0,0,0,1,2,1,3,5,2,4,2,3,2,1,1,1,3,1,1,1,1,1,1,1,3,4,1,1,4,1,1,3,2,1,1,1,1,1,2,2,1,2,2,2,1.513205138039714,1.2909944487358056,1.25,0,1.75,0,1.9333333333333333,0,2.5555555555555554,0,1.25,0,2.3333333333333335,0,1.4285714285714286,0,1.6666666666666667,0,1.8108108108108107,0,2,0,0,-0.7479714240687552,-0.7171071397831675,0.07821504497010326,-0.31944604740653215,1,2,4,1,1,2,1,1,1,1.4142135623730951,1.7142857142857142,0,1,-0.5432457265250663,2,4,4,4,1,2,3,3,5,NA,2,1.2149857925879117,4,2.857142857142857,0,-0.6470379313219725,1,-0.7127173948067627,2,4,2,2,1,5,3,4,4,2,5,3,3,3,2,2,4,5,2,3,0.9856107606091623,2.2,0,4.4,0,2.4,0,3.2,0,3.3333333333333335,0,1,1,1,3,1,1,1,3,2,1,2,2,1,1,1,2,1,2,1,1,0.6863327411532597,1.45,0,"I lived with my mother, but not father, most of the time.",0,"White, Caucasian, Anglo, European American",0,29,1,2,NA,1,1,4,unemployed,1,160,57,1,5,2,0,0,0,0,0,TRUE,TRUE,TRUE,TRUE,TRUE,3,0.7480125000011176,0.5582161290299508,0.6385000000074506,0.7816500000003725,0.6908967741900874,0.7082937500029802,1,1,1,1,0.96875,1,0.099,0.381,0.411,0.015,1.674,82.32953830744277,1864.3207371009757,0.084,0.401,0.544,0.011,1.639,55.43557075428763,1880.6010970460156,0.151,0.34,0.404,0.011,1.192,87.45220623351726,1871.5917838990383,111.6,149,108.36363636363636,FALSE,338,1.0014814814814814,0,1,0,0,3,FALSE
452,2022-03-19T00:18:58Z,2022-03-19T00:39:57Z,1258,1,2022-03-19T00:39:59Z,0.8999999761581421,Chrome,99.0.4844.74,Windows NT 10.0,1366,768,NA,1.7786458333333333,595,96,275,68,54,92,-0.17036894951603873,-0.12089738769516838,-0.49532476240177764,-0.37143482788222304,-0.14130815423511814,-0.07395607082042113,2,2,2,1,2,1,1,2,1,2,2,1,1,1,2,2,1,1,2,3,0.9733285267845752,0,1,3,3,3,1.6,0,1,1,2,1,2,1,1,1,1,1,1,1,2,1,1,1,1,1,1,1,1,1,1,2,2,0,0,0,0,1,1,1,1,1,1,1,1,1,1,1,1,1,2,1,1,1,1,1,1,1,1,1,2,1,2,1,1,2,2,1,1,1,1,1,1,1,1,1,1,1,1.8776382839954893,1.9073791542572855,1,0,1,0,1.2,0,1,0,1.0833333333333333,0,1.3333333333333333,0,1.2857142857142858,0,1,0,1.135135135135135,0,1,0,0,-1.3489108142431467,-1.4414312847884012,-0.39960647100849406,-0.9205188778984477,1,1,1,1,1,1,1,1,1,1.9518001458970664,1,0,1,-0.9579186615539372,5,5,5,5,3,4,5,6,7,2,3,1.5275252316519468,6.5,4.571428571428571,0,0.09614488050146584,0,0.6687795667866098,2,2,2,2,2,4,5,4,4,3,4,4,1,5,4,3,5,5,5,4,1.4474937289114918,2,0,4.4,0,3.4,0,4.2,0,4,0,1,1,2,3,2,2,2,4,2,1,4,3,3,2,2,3,1,1,1,1,0.7863975156570492,2.05,0,I lived with my mother and father an equal amount of time (joint custody),0,Black or African American,0,30,0,1,NA,1,4,6,Finance Admin,4,300,76,2,5,2,0,0,1,0,0,TRUE,TRUE,TRUE,TRUE,TRUE,3,0.5612875000024214,0.4610500000007451,0.4825656249979511,0.7088066666632891,0.5496562500009313,0.5680125000039116,1,1,1,0.9375,1,1,0.082,0.359,0.69,0.017,1.692,53.06494769366332,1836.176591524184,0.127,0.298,0.789,0.011,1.288,20.70805398854864,1802.07196276339,0.069,0.416,0.472,0.012,1.708,46.238270050982194,1894.6807133398552,99.52941176470587,117.09090909090911,142.33333333333331,FALSE,352,1.0429629629629629,0,1,0,0,3,FALSE
453,2022-03-19T00:03:37Z,2022-03-19T00:42:19Z,2321,1,2022-03-19T00:42:20Z,0.8999999761581421,Chrome,99.0.4844.51,Windows NT 10.0,1366,768,"I am pretty sure I was in the same income bracket as I am now growing up, but I don't know cause my mom didn't tell us our income.",1.7786458333333333,621,158,877,147,123,123,-0.116910355448079,0.22145146496086135,1.691903522938546,0.602845776087966,1.2735969592399818,0.2744288287062237,2,3,2,1,2,1,2,2,1,2,2,1,1,2,2,2,2,2,3,2,0.812727700887249,0,1,1,4,3,1.85,0,3,1,2,2,3,5,3,3,2,3,2,3,3,3,2,3,3,4,3,2,3,2,4,0,1,0,0,1,1,1,1,2,2,3,1,3,1,2,1,2,4,2,4,2,1,2,3,5,4,4,5,2,5,2,4,3,2,1,1,1,4,4,2,2,3,3,1,3,2,2,1.3617468025864259,0.9411239481143202,3,0,2,0,2.6666666666666665,0,1.7777777777777777,0,2.8333333333333335,0,3.5,0,2.142857142857143,0,2.6666666666666665,0,2.5405405405405403,0,0,1,0,0.8618443145735938,0.6857177655446437,0.4250073537293794,0.5553625596370115,2,2,4,3,1,2,2,1,1,0.9511897312113419,2.2857142857142856,0,1,-0.21150737850196963,4,5,4,5,2,2,3,4,6,NA,2,1.2724180205607036,5,3.5714285714285716,0,-0.3760932239552953,1,-0.16067443809390553,3,4,3,2,3,3,4,4,4,4,4,4,4,5,5,4,5,4,4,3,1.2227992865708155,3,0,4,0,4,0,4.2,0,4.066666666666666,0,2,1,3,3,2,3,3,3,3,3,2,2,2,3,2,2,2,2,1,2,0.6569466853317864,2.3,0,"I lived with my mother, but not father, most of the time.",0,"White, Caucasian, Anglo, European American",0,28,1,2,NA,1,1,4,Disabled,1,116,60,2,5,2,0,0,0,0,0,TRUE,TRUE,TRUE,TRUE,TRUE,6,0.7124937499761581,0.6599906250014901,0.6658468749970198,0.7425062500014902,0.71462903226191,0.7399781249910593,1,1,1,1,1,1,0.121,0.472,0.638,0.015,1.438,6.257055174556915,1786.5973671151357,0.106,0.496,0.697,0.025,1.798,51.959576780409215,1836.9694025703238,0.224,0.374,0.638,0.061,1.22,115.33541062494307,1901.4902905930198,95.86666666666666,71.92,20,TRUE,344,1.0192592592592593,0,0,0,0,3,FALSE
454,2022-03-19T00:28:05Z,2022-03-19T00:50:34Z,1349,1,2022-03-19T00:50:34Z,0.8999999761581421,Chrome,99.0.4844.74,Windows NT 10.0,1920,1080,None!,1.7777777777777777,540,105,421,81,57,81,-0.283454436967492,-0.07120158650316406,0.03513259583690549,-0.2111101715326983,-0.07979054060576597,-0.19757651903955317,3,2,2,1,3,1,1,2,1,2,3,1,1,2,3,2,1,1,3,3,0.7677718959499145,0,1,2,2,2,1.9,0,2,2,3,2,2,1,2,3,2,1,2,2,2,2,3,1,3,5,1,2,2,3,1,2,2,0,0,0,0,2,3,4,2,2,3,4,2,2,1,2,1,1,2,2,1,3,1,1,2,2,3,4,1,2,3,1,1,2,1,1,1,2,1,1,1,1,2,2,2,1,1.3378302544754286,1.1254628677422756,2.25,0,1.75,0,2.066666666666667,0,2.6666666666666665,0,1.5833333333333333,0,2.3333333333333335,0,1.2857142857142858,0,1,0,1.864864864864865,0,1,0,0,-0.06369007467309709,-0.1986932255193078,-0.14114775846592847,-0.16992049199261813,1,1,2,1,1,1,1,1,1,1.7320508075688772,1.1428571428571428,0,1,-0.874984074548163,4,4,5,5,3,4,5,8,6,4,3,1.3801311186847085,7,4.285714285714286,0,0.6141103876166872,0,0.8294615760266565,3,3,3,5,4,3,4,4,3,3,5,4,2,4,4,5,4,5,4,3,1.1952286093343936,3.6,0,4.2,0,3.6,0,3.6,0,3.8,0,1,1,1,3,1,1,3,2,1,1,3,1,1,2,2,1,1,1,1,2,1.0563093645728086,1.5,0,I lived with my mother and father an equal amount of time (joint custody),0,"White, Caucasian, Anglo, European American",0,29,1,2,NA,1,2,6,Homemaker,3,120,61,1,5,2,0,0,0,0,0,TRUE,TRUE,TRUE,TRUE,TRUE,1,0.5713433333307505,0.500159374997951,0.5028937499979511,0.6063612903173893,0.5574258064454601,0.607093333329757,0.967741935483871,1,1,0.96875,0.96875,0.967741935483871,0.1,0.353,0.661,0.012,1.449,115.74526458777292,1938.357504877839,0.073,0.353,0.582,0.012,1.401,124.57932650169838,1952.2381701905183,0.052,0.448,0.407,0.029,1.575,108.94487633531394,1980.6556145320947,120.75,116.75,54.3103448275862,FALSE,236,0.6992592592592592,0,1,0,0,3,FALSE
456,2022-03-19T00:38:44Z,2022-03-19T00:57:14Z,1110,1,2022-03-19T00:57:15Z,0.8999999761581421,Chrome,99.0.4844.51,Macintosh,1440,900,The survey was extremely fun and interesting.,1.6,655,50,204,42,42,73,-0.04700296320536243,-0.37489814934319043,-0.7532869023671647,-0.6920841405812727,-0.38737860875252683,-0.2874822995625583,1,2,2,2,2,1,1,2,1,2,2,1,2,1,2,2,1,1,3,2,0.9880869341680844,0,1,1,4,4,1.65,0,1,1,2,1,1,1,2,2,1,1,1,2,4,2,1,1,1,1,1,1,1,1,1,0,2,0,0,0,0,1,1,4,2,1,1,2,1,2,1,1,1,1,2,4,2,1,1,1,1,1,1,1,1,1,1,1,1,1,1,1,5,1,1,1,1,1,1,1,1,1,1.7264068119885534,1.7320508075688772,1,0,1,0,1.5333333333333334,0,1.6666666666666667,0,1.4166666666666667,0,1,0,1.5714285714285714,0,1,0,1.4054054054054055,0,0,0,0,-1.17345405798785,-1.1778976561413708,-0.6189692744445258,-0.8984334652929482,2,1,4,2,1,1,2,1,1,1.0690449676496976,1.8571428571428572,0,1,-0.4603111395192921,3,3,3,3,1,1,5,3,3,1,2,1.0690449676496976,3,2.7142857142857144,0,-1.0930953560345533,0,-1.0618089707050569,1,1,1,2,2,4,4,4,2,4,4,4,5,4,5,5,5,5,4,1,1.52127765851133,1.4,0,4.4,0,4.4,0,3.2,0,4,0,1,1,1,1,1,1,2,1,1,1,1,2,1,1,1,3,1,1,1,1,1,1.2,0,I lived with my mother and father an equal amount of time (joint custody),0,"White, Caucasian, Anglo, European American",0,18,0,1,NA,1,3,3,Team Leader at a fast food establishment,1,170,69,5,5,2,0,0,1,0,0,TRUE,TRUE,TRUE,TRUE,TRUE,6,0.5283062500003726,0.6433933333362143,0.5061096774185857,0.6082838709666845,0.8036250000004657,0.5948433333342273,1,0.967741935483871,1,1,1,0.9375,0.063,0.383,0.483,0.025,1.87,89.37220140638533,1961.5284437281555,0.081,0.325,0.241,0.013,1.243,92.89247474306887,1918.5433744340125,0.083,0.347,0.467,0.025,1.944,99.61286439331525,1882.8969789683458,74.8,95.61538461538463,77.75999999999999,FALSE,446,1.3214814814814815,0,1,0,3,6,FALSE
458,2022-03-19T00:36:04Z,2022-03-19T01:01:44Z,1539,1,2022-03-19T01:01:45Z,1,Opera,84.0.4316.36,Windows NT 10.0,1920,1080,NA,1.7777777777777777,622,98,388,75,47,73,-0.11485425567623439,-0.10985387631916742,-0.08476530020334481,-0.2851061667709405,-0.28484925270360656,-0.2874822995625583,3,4,4,4,4,3,4,4,4,4,4,3,2,2,4,4,4,4,4,4,1.332784974957958,0,0,1,2,1,3.65,0,5,4,3,4,4,5,5,5,4,3,4,5,1,5,5,5,5,1,1,5,5,5,4,10,2,0,0,0,0,3,1,5,2,5,1,4,1,2,2,2,5,3,1,2,5,2,5,5,5,5,5,1,1,1,5,5,1,5,5,5,3,3,4,3,5,5,5,5,5,5,1.6421622017013717,1.5522640914238175,3.875,0,5,0,4.133333333333334,0,2.6666666666666665,0,3.5,0,3,0,3.7142857142857144,0,4.333333333333333,0,3.324324324324324,0,5,0,0,1.9387101560904787,2.0502909613412266,1.856291209629316,1.9532910854852714,5,5,5,5,5,5,4,8,1,1.889822365046136,4.857142857142857,0,4.5,2.635130055095943,2,2,2,2,1,1,1,1,2,NA,1,1.3451854182690985,1.5,1.5714285714285714,0,-1.8392156252645773,1,-2.135484405843999,2,2,2,3,3,4,4,4,4,2,5,3,5,4,5,3,3,4,4,4,1.1751393027860062,2.4,0,3.8,0,3.6,0,4.2,0,3.8666666666666667,0,3,4,4,3,3,4,2,4,4,4,4,4,4,4,2,4,4,4,4,4,1.1821033884786185,3.65,0,"I lived with my mother and father an equal amount of time (joint custody) & I lived with my extended family on mother's side (grandparents, aunts ,uncles, cousins)",1,"Hispanic of Latino (e.g., Mexican American, Central American, and others) & White, Caucasian, Anglo, European American",1,19,1,2,NA,1,2,1,Student,7,112,62,2,5,2,0,0,0,0,0,TRUE,TRUE,TRUE,TRUE,TRUE,3,0.4229781249985099,0.40920000000484286,0.41734838709523603,0.5397499999920528,0.4969437499959022,0.5022258064496902,1,1,0.96875,0.9375,1,0.96875,0.056,0.314,0.521,0.021,1.715,142.5304734803329,2014.4011226790255,0.093,0.264,0.639,0.022,1.993,36.811495458132526,1823.312969678645,0.065,0.307,0.585,0.013,1.782,107.44651161297406,1962.8856778795448,81.66666666666667,90.59090909090911,137.0769230769231,FALSE,449,1.3303703703703704,0,1,0,0,3,FALSE
459,2022-03-19T00:42:29Z,2022-03-19T01:02:00Z,1171,1,2022-03-19T01:02:02Z,0.8999999761581421,Chrome,99.0.4844.74,Windows NT 10.0,1920,1080,No.,1.7777777777777777,592,70,257,41,96,59,-0.17653724883157254,-0.26446303558318085,-0.5607236147873688,-0.704416806454313,0.7199384365758122,-0.4448174154778173,2,2,1,1,2,1,1,3,1,2,2,1,2,1,2,2,1,1,3,3,0.9119095061289915,0,1,1,3,3,1.7,0,4,2,3,3,3,3,3,3,3,3,3,3,3,3,3,4,4,4,2,3,3,3,4,1,2,0,0,0,0,4,4,4,4,4,2,4,4,4,3,4,3,2,4,2,3,3,3,4,3,4,4,4,4,4,3,2,2,2,1,1,2,3,3,2,2,3,2,3,2,3,0.8647240876416868,0.3779644730092272,3.375,0,2.5,0,3,0,3.7777777777777777,0,3.1666666666666665,0,3.5,0,2,0,2.3333333333333335,0,3.081081081081081,0,1,0,0,1.4562040763884119,1.2309767098908322,0.11731095407663712,0.6741438319837346,2,2,3,2,1,2,2,3,3,0.9511897312113419,2,0,3,0.3962319431973266,4,4,4,4,3,3,5,4,4,NA,3,1.1126972805283737,4,3.857142857142857,0,-0.13222200579606097,1,0.14267031447544076,3,3,3,3,3,3,3,3,3,2,2,3,3,3,4,3,3,4,2,3,0.5936168397046637,3,0,3,0,2.6,0,3.2,0,2.933333333333333,0,1,1,2,2,2,2,2,3,2,2,2,3,2,2,1,3,1,2,2,2,0.4893604849295929,1.95,0,"I lived with my mother, but not father, most of the time.",0,"White, Caucasian, Anglo, European American",0,19,0,1,NA,1,3,4,NA,7,185,72,3,5,2,0,0,0,0,0,TRUE,TRUE,TRUE,TRUE,TRUE,1,0.4837968750006985,0.45688750000006983,0.455109375,0.5742103448280229,0.5250533333335072,0.5743586206899891,1,1,1,0.90625,0.967741935483871,0.90625,0.062,0.35,0.597,0.012,1.753,114.61575878477689,1970.8365676061435,0.064,0.322,0.518,0.013,1.412,33.85608656642906,1858.0650783702492,0.068,0.336,0.521,0.015,2.04,152.86776875905556,2011.0713782676041,146.08333333333331,108.61538461538461,136,FALSE,318,0.9422222222222223,0,1,0,0,3,FALSE
460,2022-03-19T00:44:55Z,2022-03-19T01:09:26Z,1470,1,2022-03-19T01:09:27Z,0.8999999761581421,Chrome,99.0.4844.74,Windows NT 10.0,1536,864,NA,1.7777777777777777,537,79,437,197,50,97,-0.2896227362830258,-0.2147672343911765,0.093264909068542,1.2194790697399844,-0.22333163907425438,-0.017764957993542937,2,2,1,2,2,1,1,2,1,2,2,1,1,1,2,2,1,1,2,2,0.998683343734455,0,1,1,3,3,1.55,0,4,2,1,2,1,1,2,2,1,1,2,2,3,2,3,2,3,1,1,1,2,2,1,1,2,0,0,0,0,2,3,2,2,4,2,4,4,3,2,2,4,1,2,1,3,2,2,2,2,2,2,1,1,1,3,1,2,3,3,1,1,1,2,1,1,1,2,1,2,2,1.2099437854561526,1.3020130933435712,1.625,0,1.75,0,1.9333333333333333,0,2.888888888888889,0,2.0833333333333335,0,1.5,0,1.8571428571428572,0,1,0,2.054054054054054,0,1,0,0,-0.3466140941347634,-0.44718183730701166,-0.14114775846592847,-0.2941647978864701,2,2,3,2,1,2,2,4,3,0.9511897312113419,2,0,3.5,0.5896340671250377,4,4,4,4,3,3,5,1,1,NA,4,1.1126972805283737,1,3.857142857142857,0,-0.43024020237018124,1,-0.038849444455509974,2,2,3,3,2,4,4,2,4,3,3,4,4,4,4,3,5,4,3,2,0.9611501047232549,2.4,0,4,0,3.4,0,3.2,0,3.533333333333333,0,2,2,2,1,2,2,3,3,2,2,2,3,3,3,2,3,1,2,1,2,0.6708203932499369,2.15,0,I lived with my mother and father an equal amount of time (joint custody),0,"White, Caucasian, Anglo, European American",0,27,0,1,NA,1,3,6,Tech Support Specialist,2,165,69,2,5,2,0,0,1,0,0,TRUE,TRUE,TRUE,TRUE,TRUE,1,0.5806437499932945,0.4933625000193715,0.5491218750029803,0.641568965533684,0.5723281250149012,0.6260437500029803,1,1,1,0.9354838709677419,1,1,0.088,0.394,0.553,0.022,1.699,90.47438107150091,1874.5481099507085,0.131,0.331,0.807,0.013,1.322,85.14715105291553,1878.6826935900801,0.056,0.454,0.486,0.014,1.479,100.89377106723943,1947.517420322819,77.22727272727273,101.69230769230771,105.64285714285715,FALSE,320,0.9481481481481481,0,1,0,0,3,FALSE
461,2022-03-19T00:53:14Z,2022-03-19T01:19:22Z,1567,1,2022-03-19T01:19:24Z,0.800000011920929,Firefox,98.0,Windows NT 10.0,2560,1440,NA,1.7777777777777777,581,296,398,88,80,72,-0.1991543463218632,0.9834537499049275,-0.04843260443357199,-0.12478151042141572,0.39184449721926734,-0.29872052212793393,2,2,2,2,2,1,2,2,1,2,3,3,3,3,3,3,2,1,3,3,0.7163503994113789,0,1,2,4,4,2.25,0,4,4,4,3,4,4,4,4,4,4,3,4,1,4,2,2,3,1,1,2,2,4,2,0,2,0,0,0,0,2,4,2,2,3,1,2,1,1,3,3,2,1,2,3,1,5,4,3,3,3,3,2,2,1,1,1,1,1,1,1,2,2,4,1,1,1,2,2,3,2,1.4415540496554675,1.0690449676496976,2.125,0,2.25,0,3.533333333333333,0,2,0,2.75,0,1.6666666666666667,0,1.7142857142857142,0,1,0,2.054054054054054,0,0,0,0,-0.02201909506246389,0.4696791901201942,-0.1882047535402498,0.1407372182899722,2,2,4,2,2,2,2,1,2,0.7559289460184544,2.2857142857142856,0,1.5,-0.01810525457425849,5,4,5,3,1,1,3,1,1,1,2,1.6761634196950514,1,3.142857142857143,0,-1.4543549658567896,0,-1.0496403856623207,2,2,2,2,2,4,4,4,4,4,4,4,5,4,3,2,4,3,4,3,1.0327955589886444,2,0,3.8,0,3.8,0,3.6,0,3.7333333333333334,0,2,2,2,1,2,3,1,2,1,2,1,2,2,2,1,1,1,3,1,1,0.998683343734455,1.65,0,I lived with my mother and father an equal amount of time (joint custody),0,"White, Caucasian, Anglo, European American",0,25,0,1,NA,1,3,6,broker,5,270,68,1,5,2,0,1,0,0,1,TRUE,TRUE,TRUE,TRUE,TRUE,6,0.6437419354838709,0.60071875,0.65640625,0.7383870967741936,0.7133870967741935,0.924125,1,1,1,0.96875,0.96875,1,0.191,0.21,0.425,0.006,1.689,27.952722826047175,1810.039171534698,0.104,0.33,0.369,0.015,1.725,84.2147762623215,1910.2062538355765,0.086,0.392,0.329,0.018,1.87,72.52749059601767,1897.4108840206438,281.5,115.00000000000001,103.8888888888889,TRUE,172,0.5096296296296297,0,1,0,0,3,FALSE
462,2022-03-19T00:51:18Z,2022-03-19T01:19:46Z,1707,1,2022-03-19T01:19:46Z,1,Edge,99.0.1150.39,Windows NT 10.0,1600,900,No. Thanks!,1.7777777777777777,779,128,481,85,53,80,0.2079534085033686,0.055798794320846966,0.2531287704555424,-0.1617795080405368,-0.1618140254449022,-0.20881474160492883,2,2,1,1,1,1,1,2,1,2,1,1,1,1,1,2,1,1,2,2,1.2258187382102494,0,1,2,2,2,1.35,0,3,4,3,3,4,2,4,3,3,3,4,3,1,3,3,3,3,1,2,3,3,4,3,1,1,2,0,0,0,3,3,2,3,3,2,3,3,3,3,2,2,2,4,4,2,4,3,3,4,4,5,1,1,1,1,2,2,1,1,1,3,4,4,2,3,3,2,2,3,2,1.1068989227681203,0.7745966692414834,2.75,0,2.25,0,3.066666666666667,0,2.7777777777777777,0,3.0833333333333335,0,1.8333333333333333,0,2.2857142857142856,0,2.6666666666666665,0,2.6216216216216215,0,1,0,0,0.752183841914033,0.7866078786013059,0.031158049895781924,0.4088829642485439,4,3,4,3,1,3,3,3,1,0.7867957924694432,3,0,2,0.5899698043823236,2,3,3,2,1,2,3,4,10,2,2,0.7559289460184544,7,2.2857142857142856,0,-0.15675083406024948,0,-0.7236993652927095,2,2,1,2,2,4,4,4,5,3,4,4,4,5,4,4,4,5,3,3,1.2071217242444348,1.8,0,4.2,0,3.6,0,4.2,0,4,0,1,1,2,1,1,2,2,2,1,1,2,1,2,2,1,2,2,2,1,2,0.9445132413883326,1.55,0,NA,NA,Native American/Alaskan Native/indigenous,0,28,1,2,NA,1,2,6,Office Worker,2,120,64,2,5,2,0,0,1,0,0,TRUE,TRUE,TRUE,TRUE,TRUE,6,0.6143406249992549,0.5523718749843538,0.5395875000096857,0.6981032258041443,0.5969468749985098,0.7192093750014901,1,1,1,1,1,1,0.11,0.318,0.408,0.018,1.964,178.183068431486,1964.768066481921,0.182,0.253,0.638,0.018,1.375,39.95539390940345,1821.568416460475,0.088,0.393,0.419,0.015,1.659,72.41127027872486,1854.5907812241526,109.11111111111111,76.3888888888889,110.60000000000001,FALSE,364,1.0785185185185184,0,1,0,0,3,FALSE
463,2022-03-19T00:47:46Z,2022-03-19T01:20:48Z,1981,1,2022-03-19T01:20:49Z,0.8999999761581421,Chrome,99.0.4844.74,Windows NT 10.0,1920,1080,NA,1.7777777777777777,880,180,360,36,16,49,0.4156194854596737,0.34293009009687186,-0.1864968483587087,-0.7660801358195148,-0.9205312602069123,-0.5571996411315737,1,1,1,1,1,1,1,1,1,1,1,1,1,1,1,1,1,1,1,1,1.538967528127731,0,1,2,3,2,1,0,3,2,3,3,3,3,4,4,3,3,2,3,1,3,3,3,1,1,1,3,3,3,3,0,2,0,0,0,0,2,2,2,2,2,2,2,2,2,1,2,5,1,2,3,2,3,4,5,5,5,4,1,1,1,3,1,1,1,1,1,1,1,1,1,1,3,1,1,1,1,1.5725689088154367,0.7432233529572065,2.25,0,1,0,2.8666666666666667,0,2,0,3.1666666666666665,0,1.8333333333333333,0,1,0,1.6666666666666667,0,2.135135135135135,0,0,0,0,0.11176668158219974,0.26858729811154597,-0.6189692744445258,-0.1751909881664899,1,1,1,1,1,1,1,3,1,1.9518001458970664,1,0,2,-0.571114413698515,5,5,5,5,3,3,5,4,4,2,4,1.5735915849388864,4,4.428571428571429,0,-0.01221901475905518,0,0.52537357909512294,2,2,1,4,3,2,1,2,2,3,4,4,3,4,4,4,4,4,3,3,0.990430401872025,2.4,0,3.6,0,2.8,0,3,0,3.1333333333333333,0,1,1,1,4,1,1,1,2,1,1,1,2,1,1,1,1,1,1,1,1,0.8750939799154206,1.25,0,I lived with my mother and father an equal amount of time (joint custody),0,"White, Caucasian, Anglo, European American",0,28,0,1,NA,1,2,4,Sales rep,2,225,71,1,5,2,0,0,1,0,0,TRUE,TRUE,TRUE,TRUE,TRUE,6,0.5784799999999504,0.6100250000001397,0.6804718749998138,0.6268624999991153,0.6625448275845627,0.7704241379311887,0.967741935483871,1,1,1,0.9354838709677419,0.9354838709677419,0.074,0.506,0.398,0.017,1.776,219.95915451961315,2087.754874360332,0.073,0.43,0.422,0.02,1.867,175.6679530399738,2051.0515715067127,0.266,0.265,0.874,0.022,1.469,169.38589938498757,1993.620964085751,104.47058823529412,93.35,66.77272727272728,FALSE,344,1.0192592592592593,0,1,0,9,12,FALSE
464,2022-03-19T01:04:15Z,2022-03-19T01:22:24Z,1089,1,2022-03-19T01:22:25Z,0.8999999761581421,Chrome,99.0.4844.51,Windows NT 10.0,1280,720,NA,1.7777777777777777,459,73,256,65,52,72,-0.44999851848690503,-0.24789776851917938,-0.5643568843643461,-0.4084328255013442,-0.18231989665468626,-0.29872052212793393,3,1,1,1,3,1,1,4,1,3,4,1,1,1,3,3,1,1,3,4,0.7591546545162482,0,1,2,2,1,2.05,0,5,3,4,3,5,4,4,4,3,4,5,5,1,5,4,3,4,1,1,5,5,4,4,0,2,0,0,0,0,2,4,3,3,4,1,2,2,4,3,1,5,1,3,2,3,4,5,5,5,5,4,1,1,1,2,1,1,1,2,1,4,4,4,1,1,5,2,3,1,2,1.5368350145223337,1.4573295865416045,3.375,0,2,0,3.933333333333333,0,2.7777777777777777,0,3.5,0,1.6666666666666667,0,2.4285714285714284,0,2.3333333333333335,0,2.72972972972973,0,0,0,0,1.2281102932565262,1.485070327959461,-0.274357657721105,0.605356335119178,2,2,5,2,1,3,1,1,1,1.1547005383792515,2.2857142857142856,0,1,-0.21150737850196963,5,5,5,4,3,3,4,6,4,3,2,1.2149857925879117,5,4.142857142857143,0,-0.30418514155265464,0,0.1927347219325869,3,3,3,2,3,3,3,4,4,3,5,3,4,3,4,1,3,4,3,5,1.0465362369445672,2.8,0,3.6,0,2.8,0,4,0,3.466666666666667,0,1,1,2,3,3,2,2,4,3,1,4,3,1,2,3,3,1,2,3,2,0.8583950752789521,2.3,0,I lived with my mother and father an equal amount of time (joint custody),0,"White, Caucasian, Anglo, European American",0,21,1,2,NA,1,2,4,"student, unemployed",3,186,64,2,5,1,0,0,1,1,0,TRUE,TRUE,TRUE,TRUE,TRUE,4,0.42322333332896234,0.40950967741589395,0.42065806452112814,0.5813227272711017,0.47518333332737284,0.5694681818160143,0.9375,0.96875,0.96875,0.6875,0.75,0.6875,0.055,0.286,0.409,0.01,1.856,128.63779659959576,2072.003139359872,0.042,0.306,0.396,0.008,1.302,88.96563429497252,2057.7919408347693,0.053,0.311,0.458,0.009,1.86,156.25834709936126,2140.880793004667,185.6,162.75,206.66666666666669,FALSE,360,1.0666666666666667,0,1,0,0,3,FALSE
466,2022-03-19T01:06:12Z,2022-03-19T01:29:13Z,1381,1,2022-03-19T01:29:14Z,0.8999999761581421,Chrome,99.0.4844.51,Macintosh,1440,900,NA,1.6,857,71,235,36,29,85,0.3683291907072478,-0.25894127989518034,-0.6406555454808689,-0.7660801358195148,-0.6539549344797195,-0.1526236287780506,3,3,1,1,4,1,1,3,1,3,4,1,1,2,4,4,1,1,4,4,0.4442616583193193,0,1,1,2,2,2.35,0,3,3,2,3,2,2,3,3,2,3,3,2,3,4,3,2,2,3,3,4,2,3,3,1,1,2,0,2,1,3,2,4,3,3,3,4,2,3,2,3,4,3,3,3,4,3,3,4,3,2,3,2,2,3,3,3,3,2,3,3,2,3,3,3,2,3,4,2,2,3,0.6139029865352317,0.5936168397046637,2.75,0,2.75,0,2.7333333333333334,0,3,0,3.0833333333333335,0,2.6666666666666665,0,2.7142857142857144,0,2.6666666666666665,0,2.891891891891892,0,1,1,0,0.9276405981693304,0.7590745144143026,0.9028288697079768,0.8309516920611397,3,4,3,2,3,3,2,3,2,0.6900655593423543,2.857142857142857,0,2.5,0.7004373413042606,2,2,3,3,2,3,3,6,8,6,3,0.5345224838248488,7,2.5714285714285716,0,1.0417609922763496,0,0.16110697269010804,3,2,3,3,2,4,3,3,4,3,3,2,3,4,2,3,3,2,3,3,0.6399404734221844,2.6,0,2.8,0,3,0,3.2,0,3,0,2,3,2,3,3,3,3,4,1,1,1,3,1,1,2,4,2,2,1,1,0.7863975156570492,2.15,0,I lived with my mother and father an equal amount of time (joint custody),0,"Asian or Asian American (e.g., Chinese, Japanese, and others)",0,22,0,1,NA,1,4,4,nursing,3,170,67,3,5,2,0,0,1,0,0,TRUE,TRUE,TRUE,TRUE,TRUE,6,0.7638538461533877,0.7030965517240352,0.7795774193559923,0.7992583333334575,0.8043722222215599,0.9495880000007153,0.896551724137931,0.9354838709677419,0.96875,0.8,0.5806451612903226,0.8333333333333334,0.079,0.34,0.225,0.006,1.785,152.5179492618151,2057.546202314725,0.057,0.42,0.143,0.008,1.819,169.54060274370818,2250.5643624136637,0.066,0.427,0.174,0.013,1.784,229.65977900047682,2261.642782739952,297.5,227.375,137.23076923076923,TRUE,304,0.9007407407407407,1,1,0,0,3,FALSE
467,2022-03-19T01:15:32Z,2022-03-19T01:33:45Z,1093,1,2022-03-19T01:33:47Z,1,Firefox,98.0,Macintosh,1440,900,NA,1.6,505,63,251,53,45,64,-0.3554179289820532,-0.3031153253991842,-0.5825232322492324,-0.5564248159778286,-0.3258609951231747,-0.38862630265093906,3,2,2,2,3,1,1,2,1,3,4,2,2,2,3,2,2,1,2,3,0.6863327411532597,0,1,2,1,3,2.15,0,3,4,4,3,4,4,3,4,3,2,3,4,1,4,4,3,4,1,1,3,5,4,5,4,2,0,0,0,0,2,4,4,4,5,1,1,1,3,1,3,5,1,3,2,1,5,4,5,5,4,4,1,1,1,4,1,1,3,1,1,5,5,4,1,4,3,3,2,3,1,1.6186785104276018,0.9411239481143202,3.25,0,2.25,0,3.3333333333333335,0,2.7777777777777777,0,3.25,0,2,0,2.857142857142857,0,2.6666666666666665,0,2.810810810810811,0,2,0,0,1.1995985703650403,1.2039350129214537,0.2505208533318137,0.7272279331266337,2,1,3,1,1,3,1,1,1,1.2909944487358056,1.7142857142857142,0,1,-0.5432457265250663,3,3,4,3,1,1,3,3,3,NA,2,1.1338934190276817,3,2.5714285714285716,0,-0.9179826386886498,1,-1.0325523257975882,2,3,2,3,2,4,5,4,4,3,5,4,3,3,3,5,5,4,4,2,1.2798809468443688,2.4,0,4.4,0,4,0,3.2,0,3.8666666666666667,0,2,3,3,4,3,3,4,3,3,1,4,3,2,3,1,3,1,3,3,4,1,2.8,0,I lived with my mother and father an equal amount of time (joint custody),0,"White, Caucasian, Anglo, European American",0,24,1,1,NA,1,2,3,Retail,2,175,64,2,5,2,0,0,0,0,0,TRUE,TRUE,TRUE,TRUE,TRUE,6,0.52028125,0.40975,0.44378125,0.5515,0.5079655172413793,0.5654814814814815,1,1,1,0.875,0.90625,0.84375,0.059,0.345,0.595,0.013,1.789,43.55021302274506,1907.7563156578274,0.053,0.317,0.54,0.016,1.71,127.73241653527911,2019.000850081004,0.053,0.372,0.41,0.018,1.764,119.08406704137344,1982.3796506491956,137.6153846153846,106.875,98.00000000000001,FALSE,378,1.12,0,1,0,0,3,FALSE
468,2022-03-19T00:56:53Z,2022-03-19T01:37:44Z,2450,1,2022-03-19T01:37:45Z,0.8999999761581421,Chrome,99.0.4844.74,Windows NT 10.0,1536,864,No.,1.7777777777777777,1245,136,710,69,129,90,1.1660959021829544,0.0999728398248508,1.08514750358334,-0.3591021620091827,1.396632186498686,-0.09643251595117242,2,2,2,1,2,1,2,3,1,2,3,1,1,1,2,2,1,2,2,2,0.8870412083230169,0,1,2,2,1,1.75,0,5,3,5,4,5,3,5,5,5,4,5,5,2,5,4,5,5,5,2,5,5,5,5,40,2,0,0,0,0,5,5,4,3,4,5,4,4,5,4,5,5,5,5,2,2,5,5,5,5,5,5,5,5,5,5,5,2,5,5,5,2,2,3,4,5,5,4,5,5,5,1.6598961579735207,1.6903085094570331,4.625,0,4.75,0,4.333333333333333,0,4.333333333333333,0,4.416666666666667,0,5,0,3.4285714285714284,0,4.666666666666667,0,4.324324324324325,0,6,0,0,3.074792652843526,2.9016619153807746,1.9895011088844925,2.4455815121326334,4,4,3,4,2,5,5,8,5,1.2724180205607036,3.857142857142857,0,6.5,2.8281964417663685,2,3,3,1,2,1,2,4,4,2,2,1.1126972805283737,4,2,0,-0.698640248793604,0,-1.2085638767930065,1,4,2,3,3,5,5,5,5,2,5,5,4,5,4,5,5,5,5,3,1.820517979665599,2.6,0,5,0,4.2,0,4.4,0,4.533333333333333,0,3,4,4,4,3,4,4,3,3,4,4,3,4,4,3,4,2,3,1,4,1.1239029738980326,3.4,0,NA,NA,"White, Caucasian, Anglo, European American",0,28,1,2,NA,1,2,3,Prep Cook,1,170,65,3,5,2,1,0,2,0,1,TRUE,TRUE,TRUE,TRUE,TRUE,6,0.6594749999791384,0.5364468749761582,0.6164290322795991,0.8014499999880791,0.5678406250178814,0.6103875000178814,1,1,1,1,1,1,0.127,0.346,0.602,0.024,1.481,54.919906980689035,1836.2928239872242,0.153,0.284,0.627,0.037,1.872,161.66605554792017,1946.3447850207042,0.139,0.281,0.353,0.01,1.243,177.506865891563,1961.8890468011227,61.708333333333336,50.5945945945946,124.30000000000001,FALSE,386,1.1437037037037037,0,1,0,3,6,FALSE
469,2022-03-19T00:34:15Z,2022-03-19T01:41:00Z,4004,1,2022-03-19T01:41:01Z,1,Chrome,98.0.4758.109,Macintosh,1440,900,none,1.6,1189,108,714,98,51,87,1.0509543149596567,-0.05463631943916262,1.0996805818912492,-0.0014548516910120387,-0.20282576786447032,-0.13014718364729932,3,3,3,2,4,2,3,3,3,3,3,3,3,3,3,4,3,2,3,4,0.6958523739384593,0,0,3,1,1,3,0,3,2,4,4,3,4,2,3,2,3,4,5,3,4,4,2,4,5,1,2,4,3,3,0,2,0,0,0,0,4,5,4,4,3,4,5,5,4,1,3,2,3,3,2,2,4,4,3,5,4,5,4,1,3,3,1,1,1,4,1,2,1,1,1,1,3,1,3,3,4,1.244205790071742,0.9611501047232549,3,0,2.75,0,3.3333333333333335,0,4.222222222222222,0,3,0,2.8333333333333335,0,1.5714285714285714,0,1.6666666666666667,0,2.891891891891892,0,0,0,0,1.08993809770548,1.1301849302776952,-0.01589894517853939,0.5571429925495779,3,2,3,3,2,2,2,3,2,0.5345224838248488,2.4285714285714284,0,2.5,0.4516335802869379,5,5,5,5,3,4,4,3,3,5,4,1.2149857925879117,3,4.428571428571429,0,0.4486270873193201,0,0.806070108082841,4,3,3,4,4,4,4,4,3,4,5,3,5,3,4,1,4,5,4,4,1.3020130933435712,3.6,0,4.2,0,3.6,0,3.6,0,3.8,0,4,4,4,4,4,4,1,3,4,4,4,4,2,3,1,4,3,4,2,4,1.3088765773505315,3.35,0,I lived with my mother and father an equal amount of time (joint custody),0,"White, Caucasian, Anglo, European American",0,23,1,2,NA,1,2,3,Direct Support Professional,2,135,66,2,4,2,0,0,1,1,0,TRUE,TRUE,TRUE,TRUE,TRUE,3,0.6248781250012108,0.48431250000046566,0.5271466666678587,0.6846645161293207,0.5237466666668653,0.5689827586206897,1,1,0.967741935483871,0.96875,0.967741935483871,0.9354838709677419,0.043,0.447,0.527,0.03,1.663,78.12174289038768,1966.7186551398167,0.057,0.375,0.552,0.037,1.942,123.86848010146477,1950.9538466983245,0.222,0.276,0.636,0.021,1.55,129.23905866845774,1955.3672464546817,55.43333333333334,52.486486486486484,73.80952380952381,FALSE,304,0.9007407407407407,1,1,0,0,3,FALSE
470,2022-03-19T00:48:27Z,2022-03-19T01:43:29Z,3301,1,2022-03-19T01:43:31Z,0.8999999761581421,Chrome,99.0.4844.51,Windows NT 6.1,1366,768,NA,1.7786458333333333,2344,126,471,101,69,108,3.425749551440176,0.04475528294484601,0.21679607468576959,0.03554314592810907,0.1662799139116427,0.10585549022558911,2,1,2,1,2,1,1,2,1,1,3,2,2,1,2,2,1,1,2,2,1.0563093645728086,0,1,4,3,2,1.6,0,5,3,3,3,4,1,4,5,5,3,3,4,5,4,3,5,5,5,3,5,5,4,4,2,2,0,0,0,0,1,1,5,3,1,1,5,2,1,1,3,5,5,3,5,1,5,5,5,5,5,5,3,5,5,5,3,3,3,1,1,3,3,2,1,3,4,3,5,4,2,1.5552874071755738,1.3093073414159542,4.5,0,3.5,0,3.6666666666666665,0,2.2222222222222223,0,4,0,4.333333333333333,0,2.2857142857142856,0,2.6666666666666665,0,3.189189189189189,0,1,0,0,2.2567255268032045,2.0604193060243023,0.46192257080005794,1.26117093841218,4,3,5,3,1,3,3,1,1,0.9511897312113419,3.142857142857143,0,1,0.28610014353267543,4,4,4,4,1,1,2,2,3,NA,2,1.4638501094227998,2.5,2.857142857142857,0,-1.0534549923719885,1,-0.9602617655709698,4,4,5,5,5,3,2,2,2,1,5,3,1,4,3,1,5,5,2,3,1.4375905768565218,4.6,0,4.2,0,1.4,0,2.8,0,2.8,0,1,4,1,2,3,2,3,4,1,1,3,4,3,4,4,4,1,3,4,4,1.2732056517228265,2.8,0,"I lived with my mother, but not father, most of the time.",0,"White, Caucasian, Anglo, European American",0,26,1,2,NA,1,2,3,Bookkeeper,7,132,65,3,5,2,0,0,1,0,0,TRUE,TRUE,TRUE,TRUE,TRUE,4,0.6007124999910594,0.5341906250417232,0.5499812499582768,0.6530500000417233,0.5900343749672174,0.6490258064423838,1,1,1,1,1,1,0.158,0.365,0.852,0.014,1.561,16.418368317593742,1797.29662940167,0.191,0.301,0.868,0.013,1.232,36.18301761590841,1820.3664523574041,0.152,0.364,0.643,0.018,1.411,115.52431763218213,1896.9164074834139,111.5,94.76923076923077,78.3888888888889,FALSE,304,0.9007407407407407,1,1,1,21,24,FALSE
471,2022-03-19T01:45:58Z,2022-03-19T02:05:26Z,1167,1,2022-03-19T02:05:28Z,1,Chrome,98.0.4758.102,Windows NT 10.0,1536,864,NA,1.7777777777777777,484,81,360,83,35,63,-0.3985960241907899,-0.20372372301517555,-0.1864968483587087,-0.18644483978661755,-0.5309197072210152,-0.3998645252163147,1,1,1,1,2,1,1,2,1,1,1,1,1,1,1,1,1,1,2,2,1.3803127029389886,0,1,1,4,5,1.2,0,2,2,2,2,2,1,2,2,2,2,1,2,2,2,2,2,2,1,1,2,1,1,2,0,1,0,0,2,0,2,2,3,2,4,2,4,4,3,2,2,2,1,3,1,2,2,1,2,1,1,1,1,1,1,2,1,1,1,1,1,1,1,1,1,2,1,2,1,2,2,1.3077500564749405,1.2071217242444348,1.5,0,1.75,0,1.8666666666666667,0,2.888888888888889,0,1.6666666666666667,0,1.1666666666666667,0,1,0,1.3333333333333333,0,1.7297297297297298,0,0,0,0,-0.6383109514091944,-0.6724637564228123,-0.3605105619019602,-0.5164871591623863,1,1,1,2,1,2,2,1,2,1.7182493859684491,1.4285714285714286,0,1.5,-0.5157127766089035,4,4,4,4,2,1,4,3,3,2,2,1.2909944487358056,3,3.2857142857142856,0,-0.8792700537047221,0,-0.62195951996656,2,2,2,2,2,4,2,4,4,4,5,4,4,4,4,5,4,4,3,3,1.1126972805283737,2,0,4.2,0,3.6,0,3.8,0,3.8666666666666667,0,1,1,1,1,1,1,1,2,1,1,1,2,1,1,1,2,1,1,1,1,0.9445132413883326,1.15,0,I lived with my mother and father an equal amount of time (joint custody),0,"White, Caucasian, Anglo, European American",0,25,0,1,NA,1,3,6,Police Officer,3,190,72,3,5,2,0,0,0,0,0,TRUE,TRUE,TRUE,TRUE,TRUE,2,0.5394031250029803,0.4524999999925494,0.5136156250312924,0.5860718749985099,0.516356249988079,0.5782625000104308,1,1,1,1,1,1,0.13,0.326,0.718,0.022,1.662,33.48635496983766,1815.5525731853604,0.069,0.341,0.598,0.022,1.585,63.50707916485324,1848.9514762858414,0.117,0.338,0.591,0.032,1.769,60.020759392945,1841.2756491566884,75.54545454545455,72.04545454545455,55.28124999999999,FALSE,320,0.9481481481481481,0,1,0,0,3,FALSE
472,2022-03-19T01:38:17Z,2022-03-19T02:07:03Z,1726,1,2022-03-19T02:07:05Z,0.8999999761581421,Chrome,98.0.4758.80,Macintosh,1366,768,No feedback,1.7786458333333333,603,67,683,152,71,77,-0.1539201513412819,-0.28102830264718226,0.9870492250049534,0.6645091054531678,0.20729165633121083,-0.24252940930105574,2,3,1,1,2,1,1,3,1,2,3,1,1,1,3,3,1,1,3,3,0.7451598203705946,0,1,1,2,2,1.85,0,2,2,2,3,3,2,2,2,2,2,1,2,3,2,3,2,3,3,1,2,1,1,1,3,2,0,0,0,0,2,2,3,3,3,2,2,2,2,2,2,1,1,3,3,2,2,2,1,1,1,3,1,2,1,3,1,1,2,1,1,2,2,2,1,1,1,2,2,2,2,1.2216760996649203,0.990430401872025,1.75,0,2,0,2.2,0,2.3333333333333335,0,1.75,0,1.8333333333333333,0,1.5714285714285714,0,1,0,1.8108108108108107,0,2,0,0,-0.4233764249964559,-0.382380098024029,0.16436794915095845,-0.10900607443653527,2,1,3,1,1,1,1,1,1,1.2535663410560174,1.4285714285714286,0,1,-0.7091149005366146,4,4,4,3,3,3,4,4,4,1,2,0.7559289460184544,4,3.5714285714285716,0,-0.9124655511234351,0,-0.48737319892134634,3,3,3,3,3,3,4,3,3,2,4,3,3,3,2,2,4,3,3,3,0.6546536707079771,3,0,3.4,0,2.8,0,2.8,0,3,0,1,1,2,2,3,2,2,3,2,1,3,2,1,3,1,3,1,1,1,1,0.8335087534664907,1.8,0,I lived with my mother and father an equal amount of time (joint custody),0,"Hispanic of Latino (e.g., Mexican American, Central American, and others) & White, Caucasian, Anglo, European American",1,23,0,1,NA,1,2,3,Labor,1,140,70,2,5,2,0,0,1,0,0,TRUE,TRUE,TRUE,TRUE,TRUE,1,0.5592000000092291,0.5411199999928474,0.5235419354823327,0.6157399999896686,0.5988266666650772,0.6026586206986986,1,1,1,0.9375,0.9375,0.90625,0.052,0.41,0.464,0.013,1.419,117.31625994747412,2005.0324177875834,0.063,0.371,0.392,0.016,1.503,45.43000413277544,1888.8691567916037,0.053,0.426,0.385,0.01,1.033,115.20274186936136,1981.682609751362,109.15384615384616,93.93749999999999,103.29999999999998,FALSE,460,1.3629629629629632,0,1,0,0,3,FALSE
473,2022-03-19T01:29:55Z,2022-03-19T02:07:38Z,2262,1,2022-03-19T02:07:38Z,1,Chrome,97.0.4692.102,CrOS aarch64 14324.80.0,1366,768,"No feedback, thank you!",1.7786458333333333,1130,148,568,117,101,102,0.929644428420825,0.16623390808085656,0.569223223652566,0.23286579989675493,0.8224677926247326,0.038426154833335266,2,2,2,1,3,1,1,3,1,2,4,2,1,4,3,3,1,1,3,3,0.8750939799154206,0,1,1,4,2,2.15,0,5,1,4,2,3,5,5,5,5,4,4,4,3,5,3,1,4,3,1,2,5,5,2,5,2,0,0,0,0,1,1,1,1,2,1,1,1,1,2,2,4,2,1,3,1,3,2,2,3,3,4,1,1,1,2,1,1,5,2,1,2,3,2,1,1,1,1,1,2,1,1.5986105077709065,1.4960264830861913,2.875,0,1.25,0,3.8666666666666667,0,1.1111111111111112,0,2.3333333333333335,0,1.6666666666666667,0,2.2857142857142856,0,1,0,1.8108108108108107,0,3,0,0,0.30696232291621733,0.8364629344684865,0.12527204004442455,0.48086748725645556,1,2,3,1,2,2,2,1,1,1.2724180205607036,1.8571428571428572,0,1,-0.4603111395192921,5,5,5,5,2,3,4,4,4,3,3,1.4638501094227998,4,4.142857142857143,0,-0.14160432944649845,0,0.2917609899912483,1,3,2,3,2,4,5,4,4,2,4,5,4,5,3,4,3,4,5,3,1.3093073414159542,2.2,0,4,0,4,0,3.8,0,3.933333333333333,0,1,2,1,3,2,1,2,3,2,2,1,3,1,1,1,3,1,1,1,2,0.512989176042577,1.7,0,I lived with my mother and father an equal amount of time (joint custody),0,"White, Caucasian, Anglo, European American",0,19,1,2,NA,1,3,3,student,3,106,63,3,5,2,0,0,0,0,0,TRUE,TRUE,TRUE,TRUE,TRUE,6,0.5549249999988825,0.4552468750067055,0.44549062500707803,0.6197548387127538,0.5186593750044703,0.5333566666722298,1,1,1,0.96875,1,0.9375,0.075,0.296,0.526,0.02,2.043,73.59432217092757,1921.1636577380712,0.091,0.297,0.603,0.014,1.388,60.72363175665989,1844.209433702421,0.212,0.196,0.594,0.018,1.436,177.48790741784998,2003.843985848641,102.15,99.14285714285714,79.77777777777779,FALSE,460,1.3629629629629632,0,1,0,0,3,FALSE
474,2022-03-19T01:39:53Z,2022-03-19T02:08:20Z,1706,1,2022-03-19T02:08:21Z,1,Chrome,99.0.4844.74,Windows NT 10.0,1920,1080,I think the study should give you a score for the given game at the end of the test.,1.7777777777777777,578,200,474,112,139,101,-0.20532264563739702,0.4533652038568815,0.22769588341670144,0.1712024705315531,1.6016908985965266,0.027187932267959625,2,2,2,1,3,1,2,2,2,3,3,1,1,1,2,2,2,1,3,2,0.7947194142390263,0,1,2,4,4,1.9,0,4,3,4,3,3,3,2,3,2,4,2,4,2,4,3,4,4,1,1,2,3,4,1,2,1,1,0,1,0,2,2,3,3,3,3,3,3,3,2,3,3,1,3,2,1,5,4,3,4,4,4,1,1,1,3,2,1,3,3,1,3,2,3,1,1,4,2,3,3,3,1.151445103261908,0.7745966692414834,2.5,0,2.75,0,3.066666666666667,0,2.7777777777777777,0,2.9166666666666665,0,2,0,2.2857142857142856,0,2,0,2.5405405405405403,0,1,0,0,0.5372493155012946,0.6420577166195388,0.20346385825749233,0.4227607874385156,4,3,4,3,3,3,3,2,3,0.4879500364742666,3.2857142857142856,0,2.5,0.949241102321583,3,4,4,3,2,1,4,9,10,2,2,1.1126972805283737,9.5,3,0,0.2948236782175459,0,-0.061636688240204796,2,2,3,2,2,4,3,3,4,2,5,3,5,3,4,4,3,5,3,1,1.1254628677422756,2.2,0,4,0,3.4,0,3,0,3.466666666666667,0,1,1,1,1,3,2,4,2,2,2,2,2,3,2,1,3,1,2,1,3,0.9880869341680844,1.95,0,I lived with my mother and father an equal amount of time (joint custody),0,"Hispanic of Latino (e.g., Mexican American, Central American, and others)",0,20,0,1,NA,1,2,4,Team Memeber,4,205,72,2,5,2,0,0,0,0,0,TRUE,TRUE,TRUE,TRUE,TRUE,5,0.6438718750178813,0.5902656249925494,0.6846000000089407,0.7103718750067055,0.6522387096843412,0.785832258062978,1,1,1,1,1,1,0.245,0.157,0.477,0.01,1.664,59.51709044953026,1845.2338714609928,0.139,0.366,0.615,0.028,1.871,70.12150246836936,1854.3045090404894,0.23,0.267,0.621,0.018,1.515,14.652435762539799,1795.7932173174042,166.39999999999998,66.82142857142857,84.16666666666667,FALSE,355,1.0518518518518518,0,1,0,6,9,FALSE
475,2022-03-19T01:53:46Z,2022-03-19T02:10:53Z,1027,1,2022-03-19T02:10:54Z,0.8999999761581421,Chrome,99.0.4844.74,Windows NT 10.0,1920,1080,NA,1.7777777777777777,450,71,284,63,49,61,-0.46850341643350646,-0.25894127989518034,-0.4626253362089821,-0.4330981572474249,-0.2438375102840384,-0.42234097034706597,3,3,3,3,3,1,1,4,1,3,4,1,1,1,3,3,2,1,4,3,0.6805570473787206,0,1,1,2,1,2.4,0,4,4,5,2,5,3,5,4,5,2,3,4,1,4,4,3,4,1,1,3,4,3,5,4,2,0,0,0,0,3,1,3,3,4,2,5,1,3,3,2,5,1,4,4,2,4,5,5,5,5,3,1,1,1,3,3,1,3,3,2,3,4,3,2,2,1,2,4,2,2,1.3639502778182058,1.4074631010979937,3,0,2.5,0,3.6666666666666665,0,2.7777777777777777,0,3.75,0,2,0,2.7142857142857144,0,1.6666666666666667,0,2.864864864864865,0,2,0,0,1.0723924220799503,1.2639184134717107,0.33667375751266887,0.8002960854921898,1,1,3,1,1,1,1,1,1,1.5735915849388864,1.2857142857142858,0,1,-0.7920494875423887,3,4,4,3,1,1,3,4,4,2,2,1.2535663410560174,4,2.7142857142857144,0,-0.698640248793604,0,-0.8215505005896206,3,4,2,2,2,4,5,4,5,3,4,4,3,2,5,3,3,4,5,5,1.3557637102737474,2.6,0,3.8,0,3.8,0,4.2,0,3.933333333333333,0,2,2,2,4,4,3,4,4,4,4,4,3,1,4,1,4,1,4,4,4,1.348488432516786,3.15,0,I lived with my mother and father an equal amount of time (joint custody),0,"White, Caucasian, Anglo, European American",0,20,0,1,NA,1,2,4,IT worker and student,1,235,69,2,5,2,0,0,0,0,0,TRUE,TRUE,TRUE,TRUE,TRUE,4,0.4530406250096857,0.4514437499977648,0.44884687499701975,0.5619933333277702,0.5167967741873957,0.5473322580591324,1,1,1,0.9375,0.96875,0.96875,0.077,0.318,0.605,0.013,1.625,59.51884095113882,1882.5985725201404,0.072,0.312,0.557,0.018,1.727,66.46964414392156,1889.104691550224,0.069,0.318,0.499,0.015,1.924,102.47937719697771,1968.3919247502024,125,95.94444444444446,128.26666666666668,FALSE,432,1.28,0,1,0,0,3,FALSE
476,2022-03-19T01:43:37Z,2022-03-19T02:11:47Z,1690,1,2022-03-19T02:11:49Z,0.8999999761581421,Chrome,99.0.4844.74,Windows NT 10.0,1920,1080,"If I had to nitpick, maybe change the game up a little bit and add some variety",1.7777777777777777,737,101,336,84,76,96,0.12159721808589519,-0.09328860925516598,-0.27369531820616344,-0.1741121739135772,0.3098210123801311,-0.029003180558918575,3,2,3,3,4,2,4,4,1,3,3,4,3,3,4,4,3,3,4,4,1.0563093645728086,0,1,1,3,3,3.2,0,3,2,4,2,2,2,3,4,2,2,4,2,3,3,1,2,2,1,1,1,2,1,3,1,2,0,0,0,0,1,1,4,2,4,1,4,1,4,2,2,1,2,3,2,1,1,2,2,3,3,2,1,1,1,3,1,1,2,2,1,1,1,2,1,1,1,2,1,2,2,1.4441556652887477,0.9611501047232549,1.625,0,1.75,0,2.6,0,2.4444444444444446,0,2,0,1.5,0,1.4285714285714286,0,1,0,1.837837837837838,0,1,0,0,-0.4869794991390009,-0.25051495025698906,-0.14114775846592847,-0.19583135436145876,1,1,2,2,1,2,3,3,2,1.5118578920369088,1.7142857142857142,0,2.5,0.036960645258067054,4,3,4,4,3,3,4,6,6,3,3,0.7559289460184544,6,3.5714285714285716,0,0.2196552803757379,0,0.2021897297078348,3,3,4,3,3,3,4,4,4,3,4,4,3,3,4,4,5,4,4,3,0.9611501047232549,3.2,0,4,0,3.6,0,3.6,0,3.7333333333333334,0,3,4,2,3,3,2,2,2,4,1,2,3,2,2,2,3,1,3,3,3,0.8207826816681233,2.5,0,I lived with my mother and father an equal amount of time (joint custody),0,"Asian or Asian American (e.g., Chinese, Japanese, and others)",0,21,0,1,NA,1,3,4,Student and part time waiter,3,130,67,1,5,2,0,0,0,0,0,TRUE,TRUE,TRUE,TRUE,TRUE,4,0.4457718750052154,0.4086968750208616,0.4103903225814143,0.5008064516129033,0.47459354839786405,0.4954062499925494,1,1,1,0.96875,1,1,0.104,0.275,0.741,0.028,1.85,41.33128736725236,1823.716353031487,0.082,0.296,0.724,0.009,0.955,41.89356090055149,1826.936161577532,0.082,0.296,0.612,0.017,1.624,50.603834982541585,1874.838378386648,66.07142857142857,106.11111111111111,95.52941176470588,FALSE,526,1.5585185185185184,0,1,0,15,18,FALSE
477,2022-03-19T01:55:47Z,2022-03-19T02:22:17Z,1589,1,2022-03-19T02:22:19Z,0.8999999761581421,Chrome,99.0.4844.51,Windows NT 10.0,1366,768,NA,1.7786458333333333,616,234,347,108,64,65,-0.12719085430730204,0.6411048972488977,-0.23372935285941338,0.12187180703939164,0.06375055786272243,-0.3773880800855634,1,2,1,1,2,2,2,2,1,2,2,1,1,2,1,1,2,2,2,1,1.0990426455975697,0,1,1,5,4,1.55,0,3,2,2,2,1,3,3,2,2,2,3,1,2,2,1,1,1,1,1,1,2,1,1,1,2,0,0,0,0,1,1,1,1,1,1,1,1,1,1,2,1,1,2,1,1,1,1,1,1,2,1,1,1,1,1,2,1,2,1,1,2,1,2,2,3,1,2,1,1,1,1.7849891277501346,1.1952286093343936,1.125,0,1.25,0,2.066666666666667,0,1,0,1.25,0,1.1666666666666667,0,1.4285714285714286,0,2,0,1.2702702702702702,0,1,0,0,-1.1800336863474237,-0.9494690668327693,-0.31345356682763886,-0.6314613168302041,1,1,4,1,1,2,1,1,1,1.4638501094227998,1.5714285714285714,0,1,-0.6261803135308405,3,3,3,3,1,1,2,7,6,1,1,1.1338934190276817,6.5,2.2857142857142856,0,-0.804101655862914,0,-1.1179939636366307,2,2,2,2,3,4,4,3,4,5,3,4,5,4,4,4,4,4,4,2,1.1464230084422218,2.2,0,3.8,0,4.4,0,3.4,0,3.8666666666666667,0,1,1,1,2,1,1,1,1,1,1,1,1,1,1,1,1,1,2,1,1,1.142481141154959,1.1,0,I lived with my mother and father an equal amount of time (joint custody),0,"White, Caucasian, Anglo, European American",0,30,0,1,NA,1,2,6,Mailman,5,180,70,3,5,2,0,0,1,0,0,TRUE,TRUE,TRUE,TRUE,TRUE,2,0.6229612903210424,0.5685129032327283,0.5515843750052154,0.7127656250074506,0.6367466666618983,0.6503218750171363,1,1,1,1,0.967741935483871,1,0.126,0.361,0.659,0.015,1.628,114.69913681316578,1902.054045623759,0.065,0.435,0.543,0.025,1.854,53.03020643703979,1876.7436883956855,0.091,0.454,0.601,0.015,1.714,83.50884325361118,1864.4725943708675,108.53333333333333,74.16,114.26666666666667,FALSE,388,1.1496296296296296,0,1,0,0,0,FALSE
478,2022-03-19T02:04:41Z,2022-03-19T02:25:14Z,1232,1,2022-03-19T02:25:16Z,0.8999999761581421,Firefox,98.0,Windows NT 10.0,3840,1080,NA,3.5555555555555554,464,46,542,35,35,61,-0.439718019627682,-0.39698517209519235,0.4747582146511566,-0.7784128016925552,-0.5309197072210152,-0.42234097034706597,2,2,2,1,2,2,1,3,1,2,2,2,1,1,2,2,1,1,3,2,0.8870412083230169,0,1,1,3,2,1.75,0,3,1,2,2,3,2,3,2,1,1,1,3,2,3,2,2,3,1,1,1,2,2,3,4,1,0,0,1,0,2,2,4,2,1,1,1,1,2,2,1,1,1,4,1,3,2,3,3,3,4,3,1,1,1,5,1,2,5,1,1,1,1,1,1,1,1,1,1,3,2,1.6168222271214958,1.1832159566199232,1.875,0,1.75,0,2.066666666666667,0,1.7777777777777777,0,2.3333333333333335,0,2,0,1.7142857142857142,0,1,0,1.9189189189189189,0,2,0,0,-0.2720449727262622,-0.3388183825424489,0.07821504497010326,-0.13030166878617283,1,2,3,2,1,2,1,2,1,1.3801311186847085,1.7142857142857142,0,1.5,-0.3498436025973552,5,5,5,5,3,3,4,4,3,3,3,1.2909944487358056,3.5,4.285714285714286,0,-0.23191923190205752,0,0.3141538050621014,2,3,3,2,3,5,3,4,3,2,2,3,4,3,5,3,3,4,3,3,0.9411239481143202,2.6,0,3.4,0,3,0,3.6,0,3.3333333333333335,0,2,1,3,3,2,3,1,3,3,1,1,2,2,4,1,1,1,2,1,2,0.998683343734455,1.95,0,I lived with my mother and father an equal amount of time (joint custody),0,"White, Caucasian, Anglo, European American",0,30,0,1,NA,1,3,8,Marketing Manager,4,160,72,3,5,2,0,0,1,0,0,TRUE,TRUE,TRUE,TRUE,TRUE,6,0.5315625,0.44425,0.45221875,0.5625161290322581,0.5123548387096775,0.52859375,1,1,1,0.96875,0.96875,1,0.106,0.273,0.608,0.019,1.78,40.45018932175908,1822.117290340995,0.061,0.343,0.676,0.022,1.928,170.69637844534577,1992.7389933647314,0.081,0.316,0.433,0.022,1.836,104.48583573840837,1928.8256933035966,93.6842105263158,87.63636363636364,83.45454545454547,FALSE,400,1.1851851851851851,0,1,0,0,3,FALSE
479,2022-03-19T02:13:43Z,2022-03-19T02:30:17Z,993,1,2022-03-19T02:30:17Z,0.8999999761581421,Chrome,99.0.4844.74,Windows NT 10.0,2560,1440,NA,1.7777777777777777,466,88,248,42,39,67,-0.4356058200839928,-0.1650714331991722,-0.5934230409801643,-0.6920841405812727,-0.448896222381879,-0.35491163495481215,2,2,1,1,2,1,2,1,1,1,2,1,1,1,2,2,2,1,2,2,1.105012502906165,0,0,2,5,5,1.5,0,1,1,1,1,1,1,1,1,1,1,1,1,1,1,3,1,1,1,1,1,1,1,1,0,2,0,0,0,0,2,1,1,2,1,1,1,1,1,3,1,1,1,1,2,1,4,3,2,2,2,1,1,1,1,1,1,1,1,2,1,1,1,1,1,1,1,1,1,1,1,1.7816212207352533,1.98086080374405,1,0,1,0,1.1333333333333333,0,1.2222222222222223,0,1.9166666666666667,0,1,0,1.1428571428571428,0,1,0,1.3783783783783783,0,0,0,0,-1.1909997336133797,-1.3643378650647924,-0.6189692744445258,-0.9916535697546591,1,1,1,1,1,1,1,2,1,1.9518001458970664,1,0,1.5,-0.7645165376262261,5,5,5,5,4,4,5,6,6,6,4,1.4638501094227998,6,4.714285714285714,0,1.2043418043825058,0,1.4211733693589266,1,2,2,1,2,5,1,5,5,1,5,1,5,1,1,5,3,4,2,5,0.5936168397046637,1.6,0,3.6,0,2.8,0,3.4,0,3.2666666666666666,0,2,2,1,3,2,1,1,2,2,3,2,1,2,1,1,2,1,1,1,1,0.8944271909999159,1.6,0,I lived with my mother and father an equal amount of time (joint custody),0,"White, Caucasian, Anglo, European American",0,25,0,1,NA,1,4,4,NA,6,130,65,2,5,2,0,0,1,0,0,TRUE,TRUE,TRUE,TRUE,TRUE,2,0.5276281250000465,0.4630531249999185,0.47982812500017463,0.6024451612902264,0.5307533333335692,0.5820225806451973,1,1,1,1,0.9375,0.96875,0.072,0.357,0.591,0.016,1.698,90.13807486664918,1916.6842664166995,0.056,0.321,0.357,0.016,1.329,116.44601854088495,1982.7470322169015,0.09,0.35,0.539,0.014,1.447,26.84463989657927,1807.4875347540599,106.125,83.0625,103.35714285714286,FALSE,370,1.0962962962962963,0,1,0,3,6,FALSE
480,2022-03-19T02:12:23Z,2022-03-19T02:34:14Z,1311,1,2022-03-19T02:34:15Z,1,Firefox,98.0,Windows NT 10.0,1920,1080,NA,1.7777777777777777,526,87,336,147,72,78,-0.3122398337733165,-0.17059318888717268,-0.27369531820616344,0.602845776087966,0.2277975275409949,-0.2312911867356801,2,3,2,1,2,4,4,4,4,2,3,2,1,2,2,3,3,3,3,4,0.99472291830968,0,1,1,4,3,2.7,0,1,2,3,2,3,2,2,3,2,2,2,3,1,2,4,1,1,1,1,1,1,1,1,2,2,0,0,0,0,1,1,1,1,1,1,1,1,1,2,1,5,2,1,2,1,5,2,5,5,5,2,1,1,1,3,1,1,2,2,2,3,3,4,1,1,3,2,1,1,3,1.65763317647414,1.0997835284835873,1,0,1.75,0,2.2666666666666666,0,1,0,3,0,1.5,0,2.4285714285714284,0,1.6666666666666667,0,2.054054054054054,0,1,0,0,-0.7523578429751374,-0.5745236466719011,-0.14114775846592847,-0.35783570256891484,1,1,2,1,1,2,1,1,1,1.6761634196950514,1.2857142857142858,0,1,-0.7920494875423887,4,5,5,4,5,5,4,4,3,4,3,1.1126972805283737,3.5,4.571428571428571,0,-0.018093929572226358,0,0.5991979053192441,1,2,2,2,2,4,5,5,4,5,4,5,5,4,4,1,5,5,3,2,1.624221425205085,1.8,0,4.6,0,3.8,0,3.8,0,4.066666666666666,0,2,1,2,2,3,2,2,2,2,2,3,2,1,4,1,2,1,2,2,3,0.8506963092234007,2.05,0,I lived with my mother and father an equal amount of time (joint custody),0,"White, Caucasian, Anglo, European American",0,19,0,3,NA,1,4,2,student,1,175,70,2,5,2,0,0,1,0,0,TRUE,TRUE,TRUE,TRUE,TRUE,3,0.4661290322580645,0.4695625,0.4875,0.5796875,0.5190625,0.55990625,1,1,1,1,1,1,0.262,0.162,0.816,0.015,1.356,66.3208123392586,1845.8366348953946,0.067,0.365,0.624,0.02,1.249,39.907361114468955,1820.8017667032561,0.069,0.357,0.626,0.012,1.546,108.14392237988058,1891.8299768373693,90.4,62.45,128.83333333333334,FALSE,278,0.8237037037037037,0,1,0,0,3,FALSE
481,2022-03-19T02:07:36Z,2022-03-19T02:37:59Z,1823,1,2022-03-19T02:38:01Z,0.8999999761581421,Chrome,99.0.4844.74,Macintosh,1280,800,The game was fun I could have kept playing it.,1.6,1032,104,378,80,61,90,0.7281466507800537,-0.07672334219116454,-0.12109799597311763,-0.22344283740573864,0.0022329442333702625,-0.09643251595117242,3,3,2,3,4,2,2,3,2,3,4,2,2,2,2,3,2,1,3,4,0.5525062514530825,0,1,1,3,3,2.6,0,5,5,2,5,1,2,3,2,2,1,1,4,1,4,3,2,1,1,2,1,2,2,2,3,1,1,0,0,0,2,2,1,2,1,1,3,1,1,2,2,5,1,4,1,2,1,2,5,5,5,2,1,1,1,1,1,1,3,3,4,2,2,2,1,4,4,2,2,2,4,1.5877723454642423,0.7237468644557459,1.625,0,2.5,0,2.7333333333333334,0,1.5555555555555556,0,2.9166666666666665,0,1.1666666666666667,0,2.4285714285714284,0,3,0,2.2162162162162162,0,2,0,0,-0.2413400403815852,-0.027101366568162897,0.33667375751266887,0.15478619547225297,5,5,5,2,2,2,2,1,1,1.3451854182690985,3.2857142857142856,0,1,0.3690347305384496,1,1,1,1,1,1,1,7,3,NA,1,1.5118578920369088,5,1,0,-0.8909091494812069,1,-1.8674915750235574,2,4,4,1,2,4,4,5,5,1,5,4,5,5,5,1,5,5,2,1,1.8464895909600492,2.6,0,4.6,0,2.6,0,4.2,0,3.8,0,1,3,4,4,1,4,4,4,4,2,1,4,1,1,1,4,1,4,3,2,1.3168942730211068,2.65,0,I lived with my mother and father an equal amount of time (joint custody),0,"White, Caucasian, Anglo, European American",0,25,0,1,NA,1,1,3,Disabled,7,200,66,3,5,2,1,0,1,0,1,TRUE,TRUE,TRUE,TRUE,TRUE,1,0.527528124993667,0.47254062499664723,0.5258906249888241,0.5666548387062165,0.5207580645180517,0.6063562500011176,1,1,1,0.96875,1,1,0.134,0.336,0.727,0.013,1.33,21.874149638650614,1802.6945628027972,0.08,0.38,0.894,0.038,1.824,39.61086404186838,1818.8279933360027,0.055,0.427,0.576,0.035,1.936,103.91685363611445,1929.1445502564047,102.30769230769232,48,55.31428571428571,FALSE,368,1.0903703703703704,0,1,0,0,3,FALSE
482,2022-03-19T02:20:35Z,2022-03-19T02:43:20Z,1364,1,2022-03-19T02:43:23Z,1,Chrome,98.0.4758.82,Windows NT 10.0,1536,864,I do not have any feedback.,1.7777777777777777,500,83,372,156,48,110,-0.3656984278412762,-0.1926802116391746,-0.1428976134349813,0.7138397689453293,-0.26434338149382247,0.12833193535634038,1,1,1,1,1,1,1,1,1,1,1,1,1,1,1,1,1,1,1,1,1.538967528127731,0,1,1,3,4,1,0,1,1,1,1,1,1,1,1,1,1,1,1,1,1,4,1,1,1,1,1,1,1,1,2,2,0,0,0,0,2,5,5,5,5,1,4,3,1,1,1,1,1,4,1,1,1,1,1,1,1,1,1,1,1,1,1,1,2,1,1,1,1,1,1,1,1,1,1,1,1,1.5304712811230214,1.9880595947760098,1,0,1,0,1.2,0,3.4444444444444446,0,1.25,0,1,0,1.1428571428571428,0,1,0,1.7027027027027026,0,1,0,0,-0.9804516261070234,-1.1936310071053726,-0.39960647100849406,-0.7966187390569334,1,1,3,1,1,1,1,1,1,1.5735915849388864,1.2857142857142858,0,1,-0.7920494875423887,5,5,5,5,3,3,5,3,7,2,3,1.5735915849388864,5,4.428571428571429,0,-0.17479982686521142,0,0.4263473110364615,1,1,2,3,2,4,4,4,5,1,5,4,3,3,4,2,4,4,3,3,1.162919151265879,1.8,0,4.2,0,2.6,0,3.8,0,3.533333333333333,0,1,1,1,1,1,1,1,1,1,1,1,1,1,1,1,1,1,1,1,1,1.231174022502185,1,0,"I lived with my mother, but not father, most of the time.",0,"White, Caucasian, Anglo, European American",0,29,0,1,NA,1,3,5,Unemployed,2,140,68,1,5,2,0,0,0,0,0,TRUE,TRUE,TRUE,TRUE,TRUE,6,0.4317064516159796,0.4149125000089407,0.4546193548171751,0.48521851850439,0.48061612907532725,0.5253225805836339,0.96875,1,0.96875,0.84375,0.96875,0.96875,0.05,0.364,0.554,0.022,1.774,132.44001691889684,2000.5237125478895,0.054,0.346,0.818,0.028,1.949,79.72749110653824,1906.0022637203506,0.036,0.367,0.488,0.023,1.503,150.6703844294805,2143.8430354665325,80.63636363636364,69.60714285714286,65.34782608695652,FALSE,380,1.125925925925926,0,1,0,0,3,FALSE
484,2022-03-19T02:31:20Z,2022-03-19T02:50:51Z,1170,1,2022-03-19T02:50:52Z,0.8999999761581421,Chrome,99.0.4844.51,Macintosh,1440,900,No feedback.,1.6,472,85,306,69,80,109,-0.42326922145292517,-0.18163670026317363,-0.3826934055154819,-0.3591021620091827,0.39184449721926734,0.11709371279096474,2,3,3,3,3,2,3,3,2,3,2,3,3,2,3,3,3,1,2,3,0.5982430416161189,0,1,1,2,2,2.6,0,4,2,3,2,3,2,4,4,3,2,3,3,2,3,3,2,4,1,1,2,3,3,2,1,2,0,0,0,0,2,2,3,3,3,3,3,3,3,2,2,2,2,2,2,1,2,3,3,4,4,2,1,1,1,1,1,1,2,3,2,2,2,2,2,2,3,2,2,1,2,1.0856696913328099,0.7432233529572065,2.25,0,1.75,0,2.8666666666666667,0,2.7777777777777777,0,2.4166666666666665,0,1.1666666666666667,0,2,0,2.3333333333333335,0,2.2162162162162162,0,1,0,0,0.16440370845878854,0.30398733778055026,-0.14114775846592847,0.08141978965731089,2,2,3,2,1,2,2,3,2,0.9511897312113419,2,0,2.5,0.20282981926961546,4,4,5,4,3,3,4,7,5,6,4,0.9759000729485332,6,3.857142857142857,0,1.2043418043825058,0,0.9567573179148636,2,2,2,3,2,4,5,4,4,3,4,4,4,4,5,5,4,4,5,3,1.3345232785352157,2.2,0,4,0,4.4,0,4,0,4.133333333333334,0,1,1,2,2,2,2,1,1,2,2,2,2,1,2,3,2,2,2,1,2,0.8255779474818965,1.75,0,I lived with my mother and father an equal amount of time (joint custody),0,"White, Caucasian, Anglo, European American",0,24,0,1,NA,1,3,6,Unemployed,3,172,71,4,5,2,0,0,0,0,0,TRUE,TRUE,TRUE,TRUE,TRUE,6,0.46746874998882415,0.43170312499441205,0.43437187499739227,0.5356241379298012,0.487210714291249,0.5109620689688058,1,1,1,0.90625,0.875,0.9354838709677419,0.059,0.334,0.616,0.021,1.914,58.62954642231184,1903.8515176781593,0.045,0.358,0.627,0.019,1.634,82.03127008415106,1981.376147574171,0.05,0.38,0.51,0.012,1.217,349.0858306167777,2213.639974606313,91.14285714285714,86,101.41666666666667,FALSE,436,1.2918518518518518,0,1,0,3,6,FALSE
486,2022-03-19T02:33:42Z,2022-03-19T03:00:13Z,1590,1,2022-03-19T03:00:14Z,0.8999999761581421,Chrome,99.0.4844.74,Windows NT 10.0,1600,900,Great Survey! :),1.7777777777777777,596,112,451,104,72,118,-0.16831284974419414,-0.0325492966871607,0.14413068314622396,0.07254114354723017,0.2277975275409949,0.2182377158793455,1,1,2,1,2,1,1,1,1,1,2,1,2,1,1,1,1,1,2,1,1.3562719801759993,0,1,2,4,4,1.25,0,3,2,3,2,2,2,4,3,2,1,3,2,1,2,3,3,4,5,2,2,3,4,2,2,2,0,0,0,0,1,2,4,2,1,1,3,3,1,2,1,2,2,3,1,2,2,2,3,3,3,4,3,1,1,3,3,1,2,4,4,1,2,2,1,1,1,3,3,2,2,1.3506755066722445,1.0327955589886444,3.125,0,2.5,0,2.3333333333333335,0,2,0,2.1666666666666665,0,2.5,0,2.2857142857142856,0,1,0,2.108108108108108,0,1,0,0,0.6622622543331936,0.40595911871598694,0.11731095407663712,0.261635036396312,1,1,3,1,1,1,2,2,1,1.5275252316519468,1.4285714285714286,0,1.5,-0.5157127766089035,4,4,5,3,2,3,3,7,4,3,3,0.9759000729485332,5.5,3.4285714285714284,0,0.1293403779201788,0,0.06977719429733369,1,3,3,2,2,4,5,4,5,4,5,5,3,5,5,5,5,5,5,2,1.7511900715418263,2.2,0,4.8,0,4.4,0,4.2,0,4.466666666666667,0,2,1,1,3,3,2,1,2,1,2,1,1,1,1,1,1,1,2,1,2,1.0052493799000692,1.5,0,"I lived with my mother, but not father, most of the time.",0,"White, Caucasian, Anglo, European American",0,23,0,1,NA,1,3,3,Web Developer,2,125,66,2,5,2,0,0,1,0,0,TRUE,TRUE,TRUE,TRUE,TRUE,5,0.7391161290318254,0.5812718750000931,0.7595406250003726,0.8150031250000466,0.6824843750009313,0.8363312499999301,1,1,1,1,1,1,0.164,0.319,0.388,0.02,1.818,66.09910291567897,1849.2200098284795,0.138,0.293,0.532,0.014,1.75,46.61364472623006,1829.9690363180293,0.085,0.505,0.418,0.009,1.02,75.26972178576924,1856.2459023255196,90.9,125,113.33333333333334,TRUE,316,0.9362962962962963,0,1,0,0,3,FALSE
487,2022-03-19T02:58:40Z,2022-03-19T03:19:23Z,1242,1,2022-03-19T03:19:23Z,0.8999999761581421,Chrome,99.0.4844.51,Windows NT 10.0,1920,1080,NA,1.7777777777777777,524,85,343,83,67,86,-0.3163520333170057,-0.18163670026317363,-0.2482624311673225,-0.18644483978661755,0.12526817149207461,-0.14138540621267498,1,1,2,2,2,1,1,1,1,1,3,1,2,1,1,1,1,1,2,2,1.2732056517228265,0,1,1,3,3,1.4,0,2,2,1,2,1,2,1,1,3,1,1,1,2,1,1,1,1,1,1,3,2,2,1,1,2,0,0,0,0,1,2,1,1,1,1,1,1,1,1,1,1,1,1,2,1,1,1,1,1,1,1,1,1,1,3,1,1,2,1,1,1,1,3,1,3,1,2,1,1,1,1.8538977687394032,1.709915063331955,1.5,0,1.25,0,1.4666666666666666,0,1.1111111111111112,0,1.0833333333333333,0,1.3333333333333333,0,1.4285714285714286,0,1.6666666666666667,0,1.2432432432432432,0,1,0,0,-0.954133112668729,-1.059504190137257,-0.31345356682763886,-0.6864788784824479,2,1,4,2,2,3,3,1,1,0.9759000729485332,2.4285714285714284,0,1,-0.1285727914961955,3,4,3,4,1,1,3,3,3,2,2,1.2535663410560174,3,2.7142857142857144,0,-0.8792700537047221,0,-0.9315702209292682,2,3,3,3,3,4,4,3,4,2,5,4,4,4,3,4,4,4,4,3,1.01418510567422,2.8,0,4.2,0,3.6,0,3.4,0,3.7333333333333334,0,1,1,2,1,1,1,1,2,1,1,2,1,2,1,1,2,1,1,1,1,1.0399898784932577,1.25,0,I lived with my mother and father an equal amount of time (joint custody),0,"White, Caucasian, Anglo, European American",0,24,0,1,NA,1,3,6,Help Desk Associate / Student,1,155,73,2,5,2,0,0,1,0,0,TRUE,TRUE,TRUE,TRUE,TRUE,2,0.5754875000044704,0.48609354838440494,0.5861064516229014,0.6368531250003725,0.5039193548425551,0.6282129032265755,1,1,0.96875,1,0.96875,0.96875,0.066,0.401,0.365,0.022,1.614,103.10933710755333,1974.4641131477379,0.057,0.363,0.467,0.055,1.821,91.86437498455592,1918.0785469317213,0.211,0.252,0.661,0.018,1.504,19.989405557110743,1802.6600329615837,73.36363636363637,33.10909090909091,83.55555555555556,FALSE,272,0.8059259259259259,0,1,0,0,3,FALSE
488,2022-03-19T03:02:53Z,2022-03-19T03:29:27Z,1594,1,2022-03-19T03:29:28Z,0.8999999761581421,Chrome,99.0.4844.51,Windows NT 10.0,1536,864,:P,1.7777777777777777,561,115,509,126,82,127,-0.2402763417587553,-0.015984029623159264,0.3548603186109063,0.34385979275411827,0.43285623963883546,0.31938171896772627,1,1,1,1,1,1,2,1,1,1,1,1,1,1,1,1,2,1,1,1,1.465390194130093,0,1,2,4,5,1.1,0,3,2,2,2,2,2,3,3,2,2,2,3,2,3,2,2,3,5,1,2,2,2,2,1,2,0,0,0,0,1,2,2,2,2,3,4,2,3,4,2,2,1,3,2,1,3,3,2,2,3,4,1,5,1,3,1,1,1,1,1,2,1,2,1,1,2,2,3,2,1,1.3445474360571321,0.7988086367179802,2.375,0,2,0,2.3333333333333335,0,2.3333333333333335,0,2.3333333333333335,0,2.5,0,1.2857142857142858,0,1.3333333333333333,0,2.081081081081081,0,1,0,0,0.15782408009921495,0.06670873855469797,-0.05499485428507328,0.005856942134812346,2,3,3,2,3,3,3,1,1,0.5773502691896257,2.7142857142857144,0,1,0.037296382515353055,5,5,5,3,1,1,3,3,3,2,2,1.7994708216848747,3,3.2857142857142856,0,-0.8792700537047221,0,-0.62195951996656,2,2,2,3,2,4,4,4,4,4,4,4,4,4,4,3,4,4,4,3,0.9611501047232549,2.2,0,4,0,3.8,0,3.8,0,3.8666666666666667,0,1,1,2,1,2,1,1,1,1,1,1,1,1,2,1,1,2,2,1,1,1.1821033884786185,1.25,0,"I lived with my mother, but not father, most of the time.",0,"Hispanic of Latino (e.g., Mexican American, Central American, and others)",0,21,0,1,NA,1,2,4,Student,2,133,70,3,5,2,1,1,0,0,2,TRUE,TRUE,TRUE,TRUE,TRUE,3,0.5194249999996974,0.5409218750002328,0.5010499999998137,0.5491870967738571,0.5714906250002095,0.5754032258064516,1,1,1,1,1,0.96875,0.078,0.354,0.554,0.014,1.509,92.79525154007983,1918.3617962546532,0.102,0.311,0.443,0.055,1.945,81.45081727861519,1862.6954506364157,0.097,0.332,0.569,0.018,1.312,104.11769355819013,1885.7474792848768,107.78571428571428,35.36363636363637,72.8888888888889,FALSE,400,1.1851851851851851,0,1,0,0,3,FALSE
489,2022-03-19T03:12:03Z,2022-03-19T03:35:20Z,1396,1,2022-03-19T03:35:22Z,NA,Edge,99.0.1150.39,Windows NT 10.0,1536,864,NA,1.7777777777777777,645,100,360,68,55,89,-0.06756396092380848,-0.09881036494316646,-0.1864968483587087,-0.37143482788222304,-0.12080228302533408,-0.10767073851654806,1,1,1,2,1,1,2,2,1,1,3,1,1,2,2,2,1,1,2,2,1.1742858972247996,0,1,1,4,4,1.5,0,2,2,3,2,3,3,2,2,2,2,2,1,3,1,3,2,2,1,1,2,1,1,1,0,1,1,0,1,0,2,2,2,2,2,1,1,1,1,1,1,1,1,2,2,2,2,1,1,1,3,1,1,1,1,3,2,1,1,1,1,1,1,2,1,1,1,1,1,1,2,1.6598961579735207,1.0327955589886444,1.375,0,1.25,0,2.2,0,1.5555555555555556,0,1.5,0,1.5,0,1.1428571428571428,0,1,0,1.4054054054054055,0,0,0,0,-0.9300078086836255,-0.7231054798381933,-0.5328163702636706,-0.6279609250509319,1,2,4,1,1,2,2,2,1,1.3451854182690985,1.8571428571428572,0,1.5,-0.2669090155915809,4,4,4,4,2,2,4,3,6,NA,3,1.0690449676496976,4.5,3.4285714285714284,0,0.003250347887277641,1,-0.007022920991855086,1,1,1,1,1,5,4,4,5,3,3,4,4,3,3,4,5,4,3,3,1.0997835284835873,1,0,4.2,0,3.6,0,3.6,0,3.8,0,1,1,1,2,2,1,2,3,2,1,2,2,2,1,1,2,1,1,1,3,0.8013147091860318,1.6,0,I lived with my mother and father an equal amount of time (joint custody),0,"White, Caucasian, Anglo, European American",0,23,0,1,NA,1,3,1,N/A,7,160,69,4,5,2,0,0,0,0,0,TRUE,TRUE,TRUE,TRUE,TRUE,5,0.5238645161255714,0.4113968750052154,0.4475093749929219,0.5600843749977649,0.5121451612922453,0.5331968749929219,1,1,1,1,0.96875,1,0.12,0.286,0.779,0.014,1.472,49.975644583935996,1837.1341277211131,0.069,0.293,0.569,0.019,1.92,50.11238372452958,1877.044777637575,0.111,0.308,0.581,0.028,1.952,86.23285698476298,1868.0520310600073,105.14285714285714,101.05263157894737,69.71428571428571,FALSE,424,1.2562962962962962,0,1,0,0,3,FALSE
490,2022-03-19T03:11:12Z,2022-03-19T03:38:02Z,1610,1,2022-03-19T03:38:03Z,0.8999999761581421,Chrome,99.0.4844.74,Windows NT 10.0,1680,1050,I noticed that the first few questions with the scales of 1-5 or so that there was a horizontal scroll bar and if you scrolled to the right there was an unused option that had the default text as its title.,1.6,475,174,442,84,40,72,-0.41710092213739136,0.309799555968869,0.11143125695342841,-0.1741121739135772,-0.42839035117209495,-0.29872052212793393,1,1,1,1,1,1,1,2,1,1,2,1,1,1,1,2,1,1,1,1,1.4244112357114616,0,1,4,5,4,1.15,0,3,2,2,2,1,1,2,3,1,1,2,3,2,3,5,2,4,1,1,1,3,2,1,4,2,0,0,0,0,2,2,3,1,2,1,1,1,1,1,1,1,1,3,1,4,3,1,1,3,3,3,1,1,1,3,1,1,3,1,1,2,1,2,1,1,1,2,1,2,1,1.5562525251134285,1.1751393027860062,1.875,0,1.5,0,2.2,0,1.5555555555555556,0,1.9166666666666667,0,1.6666666666666667,0,1.5714285714285714,0,1,0,1.6486486486486487,0,2,0,0,-0.44750172898155904,-0.398605116205656,-0.007937859210751935,-0.20327148770820397,1,1,2,1,1,1,1,1,1,1.7320508075688772,1.1428571428571428,0,1,-0.874984074548163,5,5,5,5,4,4,5,5,8,4,4,1.4638501094227998,6.5,4.714285714285714,0,0.8670061021784026,0,1.2157057299771732,2,2,2,1,2,4,3,3,4,3,4,3,4,4,5,2,3,3,3,3,0.8451542547285166,1.8,0,3.4,0,3,0,3.8,0,3.4,0,1,1,1,1,3,1,1,2,1,1,1,1,1,2,1,1,1,1,1,2,1.164157703189193,1.25,0,I lived with my mother and father an equal amount of time (joint custody),0,"White, Caucasian, Anglo, European American",0,30,0,1,NA,1,4,4,Unemployed,6,145,72,2,5,2,0,1,0,0,1,TRUE,TRUE,TRUE,TRUE,TRUE,2,0.49024999999441204,0.4772906250078231,0.4688531250022352,0.5565437499899417,0.5369343750011176,0.547678125004284,1,1,1,1,1,1,0.083,0.344,0.668,0.016,1.467,34.62654636618576,1816.853419602149,0.162,0.311,0.97,0.03,1.842,36.424316366379536,1819.4726315944345,0.143,0.298,0.743,0.019,1.566,38.91730409427286,1820.0570539799191,91.6875,61.400000000000006,82.42105263157896,FALSE,384,1.1377777777777778,0,1,0,0,3,FALSE
491,2022-03-19T03:19:16Z,2022-03-19T03:43:28Z,1451,1,2022-03-19T03:43:29Z,0.8999999761581421,Chrome,99.0.4844.74,Windows NT 10.0,1366,768,"Great survey, more of these would be great, thanks.",1.7786458333333333,610,142,363,62,46,85,-0.13952745293836966,0.13310337395285368,-0.17559703962777687,-0.4454308231204653,-0.3053551239133906,-0.1526236287780506,2,2,3,3,3,2,4,3,2,2,2,2,2,2,2,2,2,2,2,2,0.5982430416161189,0,1,1,3,2,2.3,0,3,2,2,2,2,3,4,3,3,2,3,2,3,4,3,3,5,2,2,3,4,4,4,1,1,1,0,0,0,3,2,2,2,2,2,2,2,2,2,3,3,4,3,4,2,3,5,4,5,3,4,1,2,1,3,2,3,2,2,2,3,2,2,2,2,3,1,1,2,2,1.0404722882338493,0.7432233529572065,3.375,0,1.5,0,2.7333333333333334,0,2.111111111111111,0,3.4166666666666665,0,2.1666666666666665,0,2.2857142857142856,0,2.3333333333333335,0,2.5945945945945947,0,1,0,0,1.1403819151288779,0.9021496747431939,-0.22730066264678367,0.33742450604820506,3,2,3,3,3,2,3,2,1,0.4879500364742666,2.7142857142857144,0,1.5,0.2306985064430642,4,4,4,3,4,4,4,6,5,3,3,0.7867957924694432,5.5,3.857142857142857,0,0.1293403779201788,0,0.30198522001936523,3,2,3,3,2,4,3,4,3,4,2,4,4,3,4,4,2,3,4,2,0.8837151016885368,2.6,0,3,0,3.8,0,3.2,0,3.3333333333333335,0,2,3,3,3,2,3,4,3,2,3,3,2,2,3,2,2,3,3,2,2,0.5982430416161189,2.6,0,I lived with my mother and father an equal amount of time (joint custody),0,"Hispanic of Latino (e.g., Mexican American, Central American, and others)",0,27,0,1,NA,1,3,6,Clerk,4,151,63,3,5,2,0,0,0,0,0,TRUE,TRUE,TRUE,TRUE,TRUE,1,0.5104300003051758,0.46184333318074544,0.5069968748688698,0.601074999888738,0.5276545456106012,0.5788520000457764,0.9375,0.967741935483871,1,0.75,0.6875,0.78125,0.053,0.367,0.433,0.013,1.809,71.2347875949128,1993.6490874974702,0.036,0.396,0.515,0.018,1.712,117.4953904539121,2086.1377280050006,0.047,0.403,0.445,0.01,1.474,88.62481626053741,2106.7207773988157,139.15384615384616,95.11111111111111,147.4,FALSE,315,0.9333333333333332,0,1,0,0,3,FALSE
492,2022-03-19T03:39:24Z,2022-03-19T03:59:42Z,1217,1,2022-03-19T03:59:44Z,0.8999999761581421,Chrome,99.0.4844.74,Windows NT 10.0,2560,1440,NA,1.7777777777777777,604,58,314,82,47,71,-0.15186405156943728,-0.3307241038391866,-0.3536272488996637,-0.1987775056596579,-0.28484925270360656,-0.3099587446933096,2,3,1,1,3,1,1,4,1,3,4,1,1,1,2,2,1,1,2,3,0.8207826816681233,0,1,2,1,1,1.9,0,2,2,2,2,2,1,2,2,2,1,3,2,2,2,2,1,3,1,1,1,2,1,1,1,2,0,0,0,0,1,1,1,2,2,1,2,2,2,1,1,1,1,2,3,2,4,2,3,3,2,1,1,1,1,1,1,1,2,2,2,1,1,3,1,1,1,1,1,1,1,1.5882451078226316,1.1872336794093274,1.375,0,1,0,1.9333333333333333,0,1.5555555555555556,0,2.0833333333333335,0,1,0,1.7142857142857142,0,1,0,1.6216216216216217,0,1,0,0,-0.7896424036793878,-0.7451321711877957,-0.39960647100849406,-0.5723693210981449,2,2,3,1,2,2,1,2,2,1.0690449676496976,1.8571428571428572,0,2,-0.07350689166386981,5,5,5,5,1,2,5,6,6,3,3,1.9880595947760098,6,4,0,0.2196552803757379,0,0.4343977554298661,3,3,3,4,3,4,3,5,4,2,4,4,3,3,3,2,4,4,3,4,0.8997354108424374,3.2,0,4,0,2.6,0,3.8,0,3.466666666666667,0,2,3,2,3,4,1,4,4,1,1,4,3,2,3,1,3,1,1,1,3,1.0990426455975697,2.35,0,I lived with my mother and father an equal amount of time (joint custody),0,"White, Caucasian, Anglo, European American",0,27,0,1,NA,1,3,7,Manager of Student Financial Services,5,145,63,2,5,2,0,0,1,0,0,TRUE,TRUE,TRUE,TRUE,TRUE,4,0.4160718749994412,0.41212499999953434,0.4163531250001397,0.5469173913057084,0.5065740740740741,0.5411208333335817,1,1,1,0.71875,0.84375,0.75,0.056,0.323,0.638,0.009,1.503,44.346169365013004,1936.2536950335566,0.059,0.316,0.638,0.017,1.908,87.17551456021269,1948.866334365978,0.057,0.325,0.647,0.009,1.639,28.96386627318549,1914.5556265953774,167,112.23529411764704,182.11111111111111,FALSE,308,0.9125925925925925,0,1,0,3,6,FALSE
493,2022-03-19T04:10:33Z,2022-03-19T04:35:50Z,1517,1,2022-03-19T04:35:51Z,0.8999999761581421,Safari,14.0.2,Macintosh,1440,900,No.,1.6,687,188,355,85,49,66,0.018792229493664936,0.3871041356008757,-0.2046631962435951,-0.1617795080405368,-0.2438375102840384,-0.3661498575201878,2,3,2,2,2,3,4,3,1,2,4,2,3,3,2,3,2,3,2,3,0.7591546545162482,0,1,3,1,2,2.55,0,4,2,4,3,4,4,5,4,2,3,4,4,4,4,4,3,5,1,1,3,3,4,4,2,1,1,0,0,0,3,2,1,4,5,4,4,4,4,1,2,2,1,4,1,3,2,3,4,5,5,1,1,1,1,5,5,1,5,1,1,2,3,2,1,1,3,2,2,2,1,1.517663764904237,1.0690449676496976,3,0,1.75,0,3.6666666666666665,0,3.4444444444444446,0,2.75,0,2.3333333333333335,0,2.142857142857143,0,1.6666666666666667,0,2.6486486486486487,0,1,0,0,0.932027017075713,1.1695183076876998,-0.14114775846592847,0.5141852746108857,1,1,4,1,1,1,1,1,1,1.4960264830861913,1.4285714285714286,0,1,-0.7091149005366146,5,5,5,5,3,5,4,1,2,3,3,1.2535663410560174,1.5,4.571428571428571,0,-0.5931788417242938,0,0.24891971486416042,4,3,5,5,5,2,5,3,3,3,2,2,1,4,4,5,2,2,5,2,1.1872336794093274,4.4,0,2,0,3.8,0,3.2,0,3,0,4,4,4,3,4,4,3,2,4,4,4,3,4,4,4,3,4,4,4,4,0.7539370349250519,3.7,0,I lived with my mother and father an equal amount of time (joint custody),0,"White, Caucasian, Anglo, European American",0,21,0,1,NA,1,3,4,Unemployed,3,220,71,2,5,2,0,0,1,0,0,TRUE,TRUE,TRUE,TRUE,TRUE,5,0.5226451612903221,0.47238709677418605,0.4795625,0.5937333333333352,0.5215333333333333,0.5646896551724098,1,0.96875,1,0.9375,0.967741935483871,0.90625,0.06,0.365,0.556,0.015,1.795,62.958043640262,1916.8285751351623,0.05,0.371,0.435,0.035,1.504,117.23771399670845,1986.5059395942794,0.057,0.415,0.514,0.028,1.972,24.852759735110446,1866.2447043937427,119.66666666666667,42.97142857142857,70.42857142857143,FALSE,330,0.9777777777777777,0,1,0,0,3,FALSE
494,2022-03-19T04:23:02Z,2022-03-19T04:38:35Z,932,1,2022-03-19T04:38:37Z,0.8999999761581421,Opera,83.0.4254.70,Windows NT 10.0,5120,1440,NA,3.5555555555555554,456,67,224,51,35,60,-0.45616681780243884,-0.28102830264718226,-0.680621510827619,-0.5810901477239093,-0.5309197072210152,-0.4335791929124416,3,3,3,2,3,1,3,3,1,3,4,3,3,3,3,3,3,2,2,3,0.6958523739384593,0,1,1,2,2,2.7,0,2,2,2,3,5,2,2,3,4,2,4,3,1,3,5,2,3,1,1,2,2,3,3,0,2,0,0,0,0,2,3,4,4,4,1,3,2,1,3,1,2,2,3,3,1,2,2,3,5,5,2,1,1,3,2,1,1,1,1,1,1,3,5,1,1,2,1,2,2,2,1.4745081126172803,1.1952286093343936,2.125,0,1.75,0,2.8666666666666667,0,2.6666666666666665,0,2.6666666666666665,0,1.6666666666666667,0,1.8571428571428572,0,1.3333333333333333,0,2.2432432432432434,0,0,0,0,0.10080063431624411,0.2612122898471704,-0.3605105619019602,-0.0496491360273949,2,2,2,3,1,2,2,4,5,1.1338934190276817,2,0,4.5,0.9764383149804601,4,5,5,5,3,3,4,1,4,4,4,1.2149857925879117,2.5,4.142857142857143,0,0.14448688253392986,0,0.4660161476558744,3,4,2,3,3,4,5,4,5,4,4,5,3,4,4,4,5,4,4,5,1.4375905768565218,3,0,4.4,0,4,0,4.4,0,4.266666666666667,0,3,4,4,4,4,4,4,4,4,3,4,3,4,4,3,4,3,4,4,4,1.118033988749895,3.75,0,"I lived with my extended family on father's side (grandparents, aunts ,uncles, cousins)",0,"White, Caucasian, Anglo, European American",0,25,0,1,NA,1,3,4,Student,3,230,74,2,5,2,0,0,1,0,0,TRUE,TRUE,TRUE,TRUE,TRUE,6,0.4905531250004424,0.41570937500090804,0.4730999999997439,0.5906354838710639,0.5003103448281,0.5910068965519554,1,1,1,0.96875,0.90625,0.90625,0.06,0.345,0.457,0.01,1.51,56.8334983162788,1912.6905464757485,0.053,0.32,0.504,0.024,1.891,151.98223666384993,2007.658507371532,0.066,0.346,0.459,0.016,1.675,43.26191232590843,1867.1296481436784,151,78.79166666666667,104.6875,FALSE,362,1.0725925925925925,0,1,0,0,3,FALSE
495,2022-03-19T04:29:36Z,2022-03-19T04:48:15Z,1118,1,2022-03-19T04:48:17Z,0.8999999761581421,Chrome,99.0.4844.51,Windows NT 10.0,1536,864,.,1.7777777777777777,488,79,294,69,51,85,-0.39037162510341145,-0.2147672343911765,-0.4262926404392093,-0.3591021620091827,-0.20282576786447032,-0.1526236287780506,2,2,1,4,2,2,3,2,1,3,3,2,3,3,2,2,1,3,3,1,0.8870412083230169,0,1,4,5,3,2.25,0,3,2,1,3,1,1,2,2,3,1,1,1,1,3,3,1,3,2,1,1,1,1,2,2,2,0,0,0,0,2,5,3,1,2,3,5,5,1,1,1,1,1,2,1,2,2,3,1,1,2,2,4,4,1,3,1,1,2,1,1,2,1,2,1,1,1,2,2,3,1,1.4694077579620841,1.3522468075656264,1.5,0,2,0,1.8666666666666667,0,3,0,1.5,0,2.5,0,1.4285714285714286,0,1,0,1.972972972972973,0,1,0,0,-0.4803998707794273,-0.5662636374158003,-0.05499485428507328,-0.31062924585043683,3,3,4,4,1,1,1,3,1,1.2149857925879117,2.4285714285714284,0,2,0.2582314563592268,2,3,3,1,2,2,2,6,6,NA,1,0.9759000729485332,6,2.142857142857143,0,-0.6199644421145296,1,-1.083240592588669,3,3,4,1,3,3,4,2,4,2,4,3,2,4,3,3,3,4,3,2,0.7988086367179802,2.8,0,3.4,0,2.8,0,3,0,3.066666666666667,0,1,1,1,2,4,1,2,3,2,1,1,2,1,1,1,1,1,1,2,2,1.019545822516343,1.55,0,"I lived with my mother, but not father, most of the time.",0,"White, Caucasian, Anglo, European American",0,24,0,1,NA,1,2,6,Systems Administrator,3,110,70,2,5,2,0,1,2,0,1,TRUE,TRUE,TRUE,TRUE,TRUE,1,0.6062548387096707,0.48122812500000145,0.504606250000008,0.6562156249999862,0.5599724137930978,0.6383999999999923,1,1,1,1,1,0.9375,0.073,0.325,0.425,0.013,1.857,138.2787231294459,1986.5796500209563,0.157,0.201,0.566,0.022,1.703,28.642847071244873,1810.074847663436,0.167,0.236,0.453,0.025,1.728,28.731423616101004,1811.0845621649319,142.84615384615384,77.40909090909092,69.11999999999999,FALSE,390,1.1555555555555557,0,1,0,0,3,FALSE
496,2022-03-19T05:11:00Z,2022-03-19T05:30:37Z,1177,1,2022-03-19T05:30:39Z,0.8999999761581421,Chrome,99.0.4844.51,Windows NT 10.0,1280,720,NA,1.7777777777777777,479,85,292,73,56,77,-0.40887652305001293,-0.18163670026317363,-0.43355917959316387,-0.30977149851702124,-0.10029641181555002,-0.24252940930105574,3,3,2,1,3,1,2,4,1,3,3,2,1,2,3,4,2,1,4,4,0.5104177855340404,0,1,1,4,4,2.45,0,2,2,2,2,2,1,1,1,1,1,1,2,1,2,2,2,3,4,1,1,1,1,1,0,2,0,0,0,0,2,1,1,1,1,1,1,1,2,1,1,1,1,1,2,1,2,1,3,2,2,3,1,1,2,2,1,1,1,1,1,2,2,1,1,1,1,2,2,2,2,1.7054056433612528,1.5491933384829668,1.75,0,2,0,1.5333333333333334,0,1.2222222222222223,0,1.5,0,1.6666666666666667,0,1.2857142857142858,0,1,0,1.3783783783783783,0,0,0,0,-0.704107235004931,-0.8622473024260843,-0.274357657721105,-0.5683024800735946,1,1,2,1,1,1,1,2,1,1.7320508075688772,1.1428571428571428,0,1.5,-0.6815819506204519,5,5,5,5,3,3,5,6,6,3,3,1.5735915849388864,6,4.428571428571429,0,0.2196552803757379,0,0.6666057811518976,2,1,2,2,2,4,5,4,5,2,3,4,4,4,5,4,4,4,5,4,1.3627702877384937,1.8,0,3.8,0,4,0,4.4,0,4.066666666666666,0,2,4,2,3,2,2,1,3,2,1,1,3,2,3,1,3,1,2,1,1,0.7677718959499145,2,0,I lived with my mother and father an equal amount of time (joint custody),0,"White, Caucasian, Anglo, European American",0,21,0,1,NA,1,3,4,student,2,200,79,2,5,2,0,0,1,0,0,TRUE,TRUE,TRUE,TRUE,TRUE,3,0.4785281250178814,0.4246531249731779,0.4493968750089407,0.5632387096651139,0.495359375,0.5293096774008966,1,1,1,0.96875,1,0.96875,0.066,0.346,0.659,0.019,1.674,80.25314746999057,1909.2269895862373,0.122,0.258,0.757,0.017,1.572,52.1988127572364,1835.1927648756155,0.063,0.36,0.578,0.022,2.055,132.88847185950573,1966.393037532135,88.10526315789474,92.47058823529412,93.40909090909092,FALSE,354,1.0488888888888888,0,1,0,0,3,FALSE
497,2022-03-19T05:06:16Z,2022-03-19T05:30:38Z,1461,1,2022-03-19T05:30:40Z,0.800000011920929,Firefox,98.0,Windows NT 10.0,1920,1080,NA,1.7777777777777777,567,110,411,94,83,89,-0.22793974312768767,-0.04359280806316166,-0.0012000999328673247,-0.05078551518317351,0.4533621108486195,-0.10767073851654806,1,1,1,2,1,1,1,2,1,1,4,1,1,1,1,1,1,1,1,1,1.460893742308382,0,1,1,4,4,1.25,0,1,1,3,2,4,1,4,3,1,1,1,2,4,2,2,2,3,1,1,1,2,2,1,3,2,0,0,0,0,1,2,2,1,1,1,1,1,1,2,1,3,4,2,4,1,1,4,3,3,1,2,1,5,1,3,1,1,3,1,1,1,1,1,1,1,1,2,2,2,2,1.698789535488692,1.486446705914413,1.625,0,2,0,2.1333333333333333,0,1.2222222222222223,0,2.4166666666666665,0,2.1666666666666665,0,1.2857142857142858,0,1,0,1.7567567567567568,0,2,0,0,-0.5396165260155897,-0.48966188490981644,0.16436794915095845,-0.162646967879429,1,1,2,1,1,1,1,2,3,1.7320508075688772,1.1428571428571428,0,2.5,-0.2947777027650296,5,5,5,5,5,5,5,4,4,6,5,1.5118578920369088,4,5,0,1.1862928115775437,0,1.5649852675592943,2,3,3,3,3,4,5,4,4,1,5,4,4,5,5,1,4,4,1,1,1.6676187756655838,2.8,0,4.2,0,2.4,0,3.8,0,3.466666666666667,0,1,2,1,1,1,1,4,4,1,1,4,3,4,3,2,3,1,2,1,4,1.2523661815266247,2.2,0,I lived with my mother and father an equal amount of time (joint custody),0,"White, Caucasian, Anglo, European American",0,30,0,1,NA,1,4,4,Consultant,6,275,70,2,5,2,0,0,1,0,0,TRUE,TRUE,TRUE,TRUE,TRUE,1,0.5183125,0.5058125,0.58828125,0.6379666666666667,0.595741935483871,0.61603125,1,1,1,0.9375,0.96875,1,0.217,0.299,0.734,0.049,1.489,88.99651984824575,1873.9572066425785,0.068,0.373,0.565,0.015,1.597,92.45212250558315,1918.4586329660401,0.076,0.347,0.474,0.012,1.735,29.19105644824809,1871.3140990226264,30.387755102040817,106.46666666666667,144.58333333333334,FALSE,320,0.9481481481481481,0,1,0,0,3,FALSE
498,2022-03-19T05:19:11Z,2022-03-19T05:35:25Z,974,1,2022-03-19T05:35:27Z,0.800000011920929,Chrome,99.0.4844.74,Windows NT 10.0,2560,1440,NA,1.7777777777777777,493,52,231,61,24,55,-0.38009112624418845,-0.3638546379671895,-0.6551886237887781,-0.4577634889935056,-0.7564842905286399,-0.48977030573931984,1,1,1,1,1,1,1,1,1,1,1,1,1,1,1,1,1,1,1,1,1.538967528127731,0,1,1,3,4,1,0,4,1,3,3,1,1,1,1,1,1,1,1,2,2,2,1,1,1,1,1,1,1,1,0,2,0,0,0,0,2,3,2,2,1,1,1,1,4,1,1,1,1,2,1,2,4,1,1,1,1,2,1,1,1,2,1,1,1,1,1,2,1,1,1,1,2,1,1,1,1,1.6168222271214958,1.6388149028228556,1,0,1,0,1.6666666666666667,0,1.8888888888888888,0,1.4166666666666667,0,1.3333333333333333,0,1.1428571428571428,0,1.3333333333333333,0,1.4594594594594594,0,0,0,0,-1.1383627067367903,-1.0960842311285612,-0.6189692744445258,-0.8575267527865436,5,5,5,4,5,5,4,4,1,1.8126539343499315,4.714285714285714,0,2.5,1.7785869723793248,5,5,5,5,3,3,4,1,6,3,3,1.2909944487358056,3.5,4.285714285714286,0,-0.23191923190205752,0,0.3141538050621014,2,1,1,2,2,5,4,5,5,5,3,5,5,5,5,5,5,3,4,3,1.7265434778633235,1.6,0,4.2,0,4.6,0,4.6,0,4.466666666666667,0,1,1,1,4,1,1,1,3,1,1,1,2,1,1,1,2,1,1,1,1,0.6386663736585051,1.35,0,I lived with my mother and father an equal amount of time (joint custody),0,"Hispanic of Latino (e.g., Mexican American, Central American, and others) & White, Caucasian, Anglo, European American",1,23,0,1,NA,1,3,5,Student,1,200,72,1,5,2,0,0,1,0,0,TRUE,TRUE,TRUE,TRUE,TRUE,5,0.5602687500268221,0.4461312499977648,0.511225000012666,0.6456937500163913,0.5268656249791384,0.5955218750052154,1,1,1,1,1,1,0.122,0.294,0.531,0.009,1.06,107.92921614061628,1891.1325798163953,0.115,0.279,0.716,0.017,1.602,24.44366144194784,1806.1870169728356,0.239,0.169,0.602,0.013,1.357,36.09154204796755,1817.4373254212553,117.77777777777779,94.23529411764706,104.38461538461539,FALSE,388,1.1496296296296296,0,1,0,3,6,FALSE
499,2022-03-19T05:22:28Z,2022-03-19T05:44:02Z,1293,1,2022-03-19T05:44:03Z,0.8999999761581421,Chrome,99.0.4844.74,Windows NT 10.0,1920,1080,NA,1.7777777777777777,505,81,309,131,52,127,-0.3554179289820532,-0.20372372301517555,-0.3717935967845501,0.40552312211932007,-0.18231989665468626,0.31938171896772627,2,3,2,2,2,1,1,1,1,1,4,1,2,1,2,2,1,1,3,3,1.025978352085154,0,1,1,4,4,1.8,0,4,2,1,2,1,1,1,1,1,1,1,1,2,1,4,1,1,1,1,1,1,1,1,4,2,0,0,0,0,1,1,3,1,1,1,1,1,1,1,2,1,1,3,1,2,1,1,2,2,1,1,1,1,1,3,1,1,3,3,1,2,2,2,1,1,1,1,1,2,2,1.6743068127745593,1.6818357317441643,1,0,1.5,0,1.6,0,1.2222222222222223,0,1.5,0,1.3333333333333333,0,2,0,1,0,1.4594594594594594,0,2,0,0,-1.1383627067367903,-1.1251909304119647,-0.007937859210751935,-0.5665643948113583,1,1,3,1,1,1,1,3,2,1.5735915849388864,1.2857142857142858,0,2.5,-0.21184311575925535,5,5,5,5,3,2,4,6,6,5,4,1.4638501094227998,6,4.142857142857143,0,0.9905165020526746,0,0.9813239186204294,2,3,4,4,4,4,2,3,4,2,5,1,4,4,5,5,5,5,3,3,1.3557637102737474,3.4,0,4,0,3.2,0,3.8,0,3.6666666666666665,0,1,2,2,2,1,3,2,3,3,2,2,2,3,3,2,3,1,2,3,3,0.7163503994113789,2.25,0,I lived with my mother and father an equal amount of time (joint custody),0,"Black or African American & Hispanic of Latino (e.g., Mexican American, Central American, and others) & White, Caucasian, Anglo, European American",1,24,0,1,NA,1,3,4,Student,3,173,74,1,5,2,0,0,1,0,0,TRUE,TRUE,TRUE,TRUE,TRUE,3,0.40434687498956917,0.4991343749910593,0.41893750001117586,0.4553799999952316,0.5233250000029802,0.480890625,1,1,1,1,1,1,0.117,0.246,0.673,0.021,1.553,94.00312518614696,1876.0092660833825,0.063,0.411,0.689,0.095,1.451,88.52717087974597,1868.2550489722844,0.086,0.3,0.87,0.021,1.533,63.58638692674493,1851.3688742707104,73.95238095238095,15.273684210526316,72.99999999999999,FALSE,478,1.4162962962962962,0,1,0,6,9,FALSE
500,2022-03-19T05:35:09Z,2022-03-19T05:55:38Z,1229,1,2022-03-19T05:55:40Z,0.8999999761581421,Chrome,99.0.4844.51,Windows NT 10.0,2560,1440,"None, though on that 2nd screen question; I did have it connected, but nothing was on it!",1.7777777777777777,565,87,255,96,44,78,-0.23205194267137688,-0.17059318888717268,-0.5679901539413234,-0.026120183437092773,-0.3463668663329587,-0.2312911867356801,2,2,2,2,2,1,1,3,1,3,3,1,1,1,3,3,1,1,2,3,0.7677718959499145,0,1,2,3,2,1.9,0,1,1,2,2,1,2,3,1,1,1,1,2,1,2,3,1,1,1,1,1,3,1,1,0,2,0,0,0,0,1,4,1,2,3,2,4,1,4,1,1,2,1,3,2,1,3,2,2,1,2,1,1,1,1,3,2,1,1,1,1,2,2,1,1,1,1,1,1,1,1,1.478575728931794,1.5522640914238175,1.25,0,1,0,1.6,0,2.4444444444444446,0,1.75,0,1.5,0,1.2857142857142858,0,1,0,1.7297297297297298,0,0,0,0,-0.8006084509453439,-0.8980406758691885,-0.6189692744445258,-0.7585049751568571,2,1,2,1,1,1,1,1,1,1.4638501094227998,1.2857142857142858,0,1,-0.7920494875423887,5,5,5,5,3,3,5,7,4,4,4,1.5735915849388864,5.5,4.428571428571429,0,0.6863762972672843,0,0.9508806591561714,2,2,2,3,2,4,4,3,5,3,4,5,4,4,3,5,4,4,4,2,1.2227992865708155,2.2,0,4.2,0,4,0,3.4,0,3.8666666666666667,0,2,1,2,2,3,2,2,3,1,1,3,3,3,3,1,3,1,3,3,2,0.7880689256524124,2.2,0,I lived with my mother and father an equal amount of time (joint custody),0,"White, Caucasian, Anglo, European American",0,24,0,1,NA,1,4,6,Aerospace Engineer,4,180,74,2,5,2,0,0,1,0,0,TRUE,TRUE,TRUE,TRUE,TRUE,6,0.4393499999977648,0.3941687499973923,0.40724687500856815,0.5100531249977648,0.4516312499884516,0.4821656249966472,1,1,1,1,1,1,0.091,0.272,0.667,0.022,1.729,78.9737429522967,1860.1567250609146,0.109,0.269,0.878,0.026,1.673,53.38591576399895,1836.7610318789652,0.152,0.265,0.874,0.016,1.371,30.496682739263385,1813.3906820470495,78.5909090909091,64.34615384615385,85.6875,FALSE,366,1.0844444444444443,0,1,0,0,3,FALSE
501,2022-03-19T05:35:13Z,2022-03-19T05:56:31Z,1277,1,2022-03-19T05:56:31Z,0.8999999761581421,Chrome,99.0.4844.74,Windows NT 10.0,1920,1080,I enjoyed this study!,1.7777777777777777,460,96,257,153,30,123,-0.4479424187150604,-0.12089738769516838,-0.5607236147873688,0.6768417713262082,-0.6334490632699356,0.2744288287062237,1,1,3,3,1,2,4,1,2,1,1,3,3,3,1,1,4,4,1,1,0.6863327411532597,0,1,2,4,4,2.05,0,4,2,3,3,2,3,3,4,3,3,3,3,4,3,3,5,4,4,3,3,3,4,2,5,1,2,0,2,0,2,3,1,3,3,3,3,2,3,1,1,3,3,1,1,1,2,2,2,2,2,3,2,1,1,2,1,1,5,5,5,1,2,2,1,1,1,3,4,4,5,1.4606962838433024,0.5936168397046637,3.5,0,4,0,3.066666666666667,0,2.5555555555555554,0,1.75,0,1.6666666666666667,0,3,0,1,0,2.108108108108108,0,3,0,0,0.9057085036374181,0.8898579943025677,1.0729539860338317,0.9814059901681997,3,3,4,3,3,3,2,3,2,0.4879500364742666,3,0,2.5,0.7833719283100348,5,5,5,3,3,3,4,9,9,3,2,1.2535663410560174,9,4,0,0.4183340780918181,0,0.5554109280505,3,2,4,3,4,2,3,3,4,2,4,3,4,3,2,4,4,4,2,3,0.7367883976130072,3.2,0,3.4,0,3,0,3,0,3.1333333333333333,0,3,2,2,3,2,1,2,2,2,1,4,2,2,2,1,3,1,1,1,1,0.8522416262267903,1.9,0,I lived with my mother and father an equal amount of time (joint custody),0,"Hispanic of Latino (e.g., Mexican American, Central American, and others)",0,18,0,1,NA,1,3,3,student,4,200,67,3,5,2,0,0,0,0,0,TRUE,TRUE,TRUE,TRUE,TRUE,5,0.5514062500004656,0.48095806451622514,0.5482374999999301,0.6257419354838709,0.5556064516130474,0.637363333333532,1,1,1,1,0.96875,0.967741935483871,0.078,0.33,0.363,0.029,1.838,148.16663944806078,1975.362897333808,0.07,0.326,0.486,0.02,1.815,23.9218705280808,1847.0338853003,0.169,0.211,0.513,0.021,1.956,75.15235300237846,1862.78883170006,63.37931034482759,90.75,93.14285714285714,FALSE,304,0.9007407407407407,1,1,0,6,9,FALSE
502,2022-03-19T05:14:34Z,2022-03-19T06:13:06Z,3512,1,2022-03-19T06:13:08Z,0.8999999761581421,Chrome,99.0.4844.51,Windows NT 10.0,1536,864,This was a creative survey,1.7777777777777777,833,610,1113,298,71,113,0.31898279618297726,2.717285035937078,2.5493551431051844,2.4650783229170616,0.20729165633121083,0.16204660305246732,3,2,3,3,3,1,2,2,2,3,2,1,2,2,3,3,2,2,2,3,0.6155870112510925,0,1,1,2,2,2.3,0,5,2,2,3,2,2,3,2,1,2,3,2,1,3,2,1,2,1,1,2,2,3,1,0,2,0,0,0,0,1,2,2,4,3,3,2,1,2,3,3,4,2,2,2,1,1,1,2,2,2,1,1,1,1,1,1,1,1,1,1,1,1,1,1,1,1,2,3,2,2,1.517663764904237,1.0600988273786194,1.625,0,2.25,0,2.3333333333333335,0,2.2222222222222223,0,2.0833333333333335,0,1,0,1,0,1,0,1.6486486486486487,0,0,0,0,-0.6097992285177086,-0.4495418399516116,-0.1882047535402498,-0.3188732967459307,1,1,3,2,2,1,2,5,4,1.3801311186847085,1.7142857142857142,0,4.5,0.8105691409689116,5,5,5,5,4,4,5,8,8,4,4,1.4638501094227998,8,4.714285714285714,0,1.1379508095450799,0,1.3807353104866444,3,2,2,3,2,4,4,4,4,3,4,4,3,4,3,4,5,4,4,4,1.0327955589886444,2.4,0,4.2,0,3.6,0,3.8,0,3.8666666666666667,0,2,3,2,2,1,4,2,3,3,1,4,3,1,3,2,3,1,3,4,2,0.9880869341680844,2.45,0,I lived with my mother and father an equal amount of time (joint custody),0,"White, Caucasian, Anglo, European American",0,19,0,1,NA,1,4,4,Student,5,166,69,3,5,2,0,0,2,0,0,TRUE,TRUE,TRUE,TRUE,TRUE,4,0.5766593750016764,0.6662625000001863,0.5103624999970198,0.6073374999985098,0.6669875000016764,0.6033387096783808,1,1,1,1,1,0.96875,0.076,0.388,0.651,0.014,1.635,64.64418200453817,1893.2862794187242,0.119,0.27,0.309,0.078,1.695,146.20167663340337,1933.325149757776,0.144,0.323,0.583,0.046,1.821,84.77555689413306,1867.4301622623095,116.78571428571428,21.73076923076923,39.58695652173913,FALSE,374,1.108148148148148,0,1,1,6,9,FALSE
503,2022-03-19T05:51:11Z,2022-03-19T06:13:18Z,1327,1,2022-03-19T06:13:19Z,0.8999999761581421,Chrome,99.0.4844.51,Windows NT 10.0,1920,1080,NA,1.7777777777777777,539,95,328,121,54,67,-0.28551053673933663,-0.12641914338316884,-0.30276147482198174,0.2821964633889164,-0.14130815423511814,-0.35491163495481215,3,3,3,4,3,2,3,4,2,4,4,3,1,2,4,4,3,1,3,4,0.9119095061289915,0,1,2,3,3,3,0,2,3,3,3,4,2,2,3,2,3,3,3,2,3,3,2,2,1,1,1,1,1,1,3,1,0,0,1,1,2,3,2,3,3,3,4,4,4,3,2,2,2,4,1,3,2,2,3,3,3,3,2,1,1,3,3,1,3,1,1,3,4,3,3,2,1,1,1,2,2,0.930788035143537,0.6546536707079771,1.25,0,1.5,0,2.7333333333333334,0,3.111111111111111,0,2.5,0,2.1666666666666665,0,2.2857142857142856,0,2,0,2.5135135135135136,0,2,1,0,-0.291783857804983,-0.06102640458429197,0.6914271522397325,0.31520037382772026,3,2,5,1,1,3,2,2,1,0.8997354108424374,2.4285714285714284,0,1.5,0.06482933243151565,2,3,2,4,1,1,2,9,10,1,1,1.2724180205607036,9.5,2.142857142857143,0,-0.2622122411295596,0,-0.8653374778583651,3,4,3,2,3,3,2,3,2,2,5,4,3,2,3,3,4,4,3,3,0.8618916073713346,3,0,4,0,2.6,0,2.6,0,3.066666666666667,0,3,1,4,2,3,4,3,3,3,2,2,2,2,3,1,3,1,3,2,3,0.8885233166386386,2.5,0,"I lived with my mother, but not father, most of the time.",0,"Asian or Asian American (e.g., Chinese, Japanese, and others)",0,27,0,1,NA,1,2,6,Freelance,2,171,71,2,5,2,0,1,0,0,1,TRUE,TRUE,TRUE,TRUE,TRUE,5,0.5769312499994412,0.47995806451694617,0.5387468749997206,0.5862718749998603,0.5794899999996026,0.6479999999997672,1,1,1,1,0.9375,1,0.078,0.4,0.548,0.018,1.762,98.80589464717922,1884.6345243881963,0.084,0.346,0.73,0.016,1.836,76.13860015862812,1923.3900254421878,0.153,0.346,0.676,0.035,0.936,64.6246226877639,1849.7440870266691,97.8888888888889,114.75,26.74285714285714,FALSE,348,1.031111111111111,0,1,0,6,9,FALSE
504,2022-03-19T06:53:53Z,2022-03-19T07:16:08Z,1335,1,2022-03-19T07:16:10Z,0.800000011920929,Chrome,99.0.4844.51,Macintosh,1440,900,None,1.6,489,135,419,86,58,85,-0.3883155253315669,0.09445108413685033,0.027866056682950932,-0.14944684216749646,-0.05928466939598191,-0.1526236287780506,1,1,1,1,1,1,1,1,1,1,1,1,1,1,1,1,1,1,1,1,1.538967528127731,0,1,1,4,4,1,0,1,1,1,1,1,1,1,1,1,1,1,1,1,1,1,2,2,3,1,1,1,1,1,1,2,0,0,0,0,1,2,1,1,1,1,1,1,1,1,1,1,1,1,1,1,1,1,1,1,1,2,1,1,1,3,1,1,2,1,1,1,1,1,1,1,1,1,1,1,1,1.879636409796595,2.065591117977289,1.5,0,1,0,1,0,1.1111111111111112,0,1,0,1.5,0,1.1428571428571428,0,1,0,1.135135135135135,0,1,0,0,-1.0243158151708476,-1.3104511380130859,-0.39960647100849406,-0.85502880451079,1,1,2,1,1,1,1,1,1,1.7320508075688772,1.1428571428571428,0,1,-0.874984074548163,5,5,5,5,3,3,5,7,5,6,4,1.5735915849388864,6,4.428571428571429,0,1.2043418043825058,0,1.2663680188775723,2,2,2,3,2,4,5,4,4,5,5,5,5,5,5,5,5,4,5,5,1.8464895909600492,2.2,0,4.6,0,5,0,4.6,0,4.733333333333333,0,1,1,1,1,2,2,2,1,1,1,3,1,1,2,1,1,1,2,1,1,1.190974832912761,1.35,0,I lived with my mother and father an equal amount of time (joint custody),0,"White, Caucasian, Anglo, European American",0,25,0,1,NA,1,3,4,Electrician,5,160,72,5,5,2,0,0,1,0,0,TRUE,TRUE,TRUE,TRUE,TRUE,5,0.5616093749997672,0.4920032258061392,0.5041718750002329,0.617038709677155,0.5460249999995577,0.5667741935486275,1,1,1,0.96875,1,0.96875,0.074,0.376,0.635,0.02,1.776,50.82281890747301,1873.2406840289248,0.147,0.32,0.856,0.046,2.049,57.91800313909065,1837.8207769470962,0.072,0.374,0.394,0.024,2.052,48.66102493029684,1872.6484486253205,88.8,44.54347826086956,85.5,FALSE,388,1.1496296296296296,0,1,0,0,3,FALSE
505,2022-03-19T06:55:52Z,2022-03-19T07:21:40Z,1548,1,2022-03-19T07:21:42Z,0.8999999761581421,Chrome,99.0.4844.74,Windows NT 10.0,1920,1200,NA,1.6,959,46,234,114,30,122,0.5780513674353975,-0.39698517209519235,-0.6442888150578462,0.19586780227763384,-0.6334490632699356,0.26319060614084805,1,1,1,1,1,1,1,2,1,2,3,1,1,1,1,1,1,1,1,2,1.3717065820970682,0,1,2,3,4,1.25,0,4,3,1,4,2,1,4,2,1,1,1,4,2,3,5,3,4,1,1,2,2,3,2,0,2,0,0,0,0,2,3,4,2,4,2,2,2,2,2,1,1,1,3,2,1,4,3,3,1,2,2,2,1,1,3,4,1,1,1,1,3,2,2,1,1,1,2,2,2,2,1.3254270092150517,0.7037315505489968,2.25,0,2,0,2.533333333333333,0,2.5555555555555554,0,2,0,2.1666666666666665,0,1.5714285714285714,0,1,0,2,0,0,0,0,0.024038303454551324,0.06405373557952233,-0.274357657721105,-0.10515196107079133,2,2,3,2,1,3,3,1,2,0.9759000729485332,2.2857142857142856,0,1.5,-0.01810525457425849,4,4,4,4,2,2,3,1,4,1,2,0.9511897312113419,2.5,3.2857142857142856,0,-1.1834102584901123,0,-0.8072081299121721,1,3,3,4,3,3,3,4,3,1,2,4,4,3,2,3,4,4,4,4,0.9411239481143202,2.8,0,3.4,0,3,0,3.2,0,3.2,0,2,1,1,1,1,1,1,2,2,1,1,2,1,1,1,3,1,1,1,1,0.8885233166386386,1.3,0,I lived with my mother and father an equal amount of time (joint custody),0,"White, Caucasian, Anglo, European American",0,24,0,1,NA,1,2,5,free lancer,1,300,69,1,5,2,0,0,0,0,0,TRUE,TRUE,TRUE,TRUE,TRUE,6,0.5034437499996275,0.5141562499981374,0.5336156249986962,0.5812999999979511,0.6647064516159796,0.6725999999991779,1,1,1,1,0.96875,0.9354838709677419,0.087,0.318,0.408,0.014,1.817,109.19387543395403,1959.9384391107656,0.072,0.336,0.365,0.02,1.995,62.88045885289012,1887.9161934149645,0.114,0.296,0.549,0.02,1.725,28.332073134629052,1809.7847563668063,129.78571428571428,99.75,86.25,FALSE,303,0.8977777777777777,0,1,0,9,12,FALSE
506,2022-03-19T07:31:38Z,2022-03-19T07:58:33Z,1615,1,2022-03-19T07:58:36Z,0.8999999761581421,Chrome,99.0.4844.51,Windows NT 10.0,1920,1080,"Nope, was fun to do and I was very honest. I didn't have a good life growing up and I'm still poor, give me a bonus haha :) Enjoy the rest of your week",1.7777777777777777,514,72,563,167,60,145,-0.3369130310354517,-0.2534195242071799,0.5510568757676795,0.8494990935487733,-0.018272926976413795,0.5216697251444878,3,3,1,1,3,2,2,4,1,3,3,2,1,1,3,3,2,1,3,3,0.4893604849295929,0,1,1,3,3,2.25,0,5,3,4,4,3,1,2,5,3,2,5,4,3,4,5,4,4,5,2,2,5,4,4,0,2,0,0,0,0,2,4,4,4,1,1,3,2,3,3,2,5,1,5,3,2,5,5,5,5,5,5,2,4,4,3,1,1,1,1,1,3,4,5,2,4,5,2,2,1,1,1.5245734893157248,1.3345232785352157,3.75,0,1.5,0,3.533333333333333,0,2.6666666666666665,0,3.8333333333333335,0,3.1666666666666665,0,2.2857142857142856,0,3.6666666666666665,0,3.135135135135135,0,0,0,0,1.7347416769436959,1.651155514073205,-0.4466634660828154,0.6022460239951948,1,1,4,1,1,1,1,2,2,1.4960264830861913,1.4285714285714286,0,2,-0.32231065268119236,4,4,4,5,1,2,1,6,3,2,1,1.5118578920369088,4.5,3,0,-0.9515359633553193,0,-0.8207812783367516,5,5,4,4,4,2,4,2,2,2,3,2,3,3,3,1,3,4,2,4,0.9611501047232549,4.4,0,2.8,0,2.4,0,2.8,0,2.6666666666666665,0,2,1,2,4,4,2,3,3,4,2,1,2,1,1,2,2,1,3,4,4,1.1285761872936695,2.4,0,"I lived with my mother, but not father, most of the time.",0,"White, Caucasian, Anglo, European American",0,28,0,1,NA,1,1,4,unemployed,1,192,67,1,5,2,0,0,0,0,0,TRUE,TRUE,TRUE,TRUE,TRUE,5,0.5570874999947846,0.5656562499981374,0.5286749999988825,0.6131906250007451,0.699393750006333,0.7028935483867123,1,1,1,1,1,0.96875,0.099,0.324,0.46,0.011,1.876,56.50826265589593,1883.0882443689738,0.14,0.293,0.486,0.012,1.56,74.83154651871374,1858.7999753453817,0.215,0.248,0.708,0.012,1.112,37.566676224447505,1820.2328779279273,170.54545454545453,130,92.66666666666667,FALSE,304,0.9007407407407407,1,1,0,3,6,FALSE
507,2022-03-19T07:43:25Z,2022-03-19T08:10:52Z,1646,1,2022-03-19T08:10:52Z,1,Edge,99.0.1150.39,Windows NT 10.0,1536,864,NA,1.7777777777777777,716,94,484,98,63,96,0.07841912287715848,-0.13194089907116932,0.26402857918647427,-0.0014548516910120387,0.043244686652938374,-0.029003180558918575,2,2,1,2,2,1,1,1,1,2,2,1,1,1,2,2,1,1,2,2,1.0711528467275955,0,1,3,3,2,1.5,0,2,2,3,3,3,2,2,3,3,2,3,2,2,2,2,1,1,2,1,2,1,1,2,1,2,0,0,0,0,1,2,2,1,1,1,1,1,2,1,2,1,1,2,2,1,3,2,1,1,2,2,1,1,1,2,2,1,2,2,1,2,3,3,1,3,1,2,1,1,2,1.5572170448993052,0.7745966692414834,1.375,0,1.5,0,2.4,0,1.3333333333333333,0,1.5833333333333333,0,1.5,0,2,0,1.6666666666666667,0,1.5945945945945945,0,1,0,0,-0.8071880793049175,-0.553185289426974,-0.22730066264678367,-0.39024297603687885,1,2,3,2,1,1,2,2,1,1.3801311186847085,1.7142857142857142,0,1.5,-0.3498436025973552,3,3,5,3,1,1,2,3,3,2,2,1.4638501094227998,3,2.5714285714285716,0,-0.8792700537047221,0,-1.0089728961699453,3,4,4,2,3,3,4,4,3,2,3,3,5,4,2,4,3,4,3,3,0.816496580927726,3.2,0,3.2,0,3.6,0,3.2,0,3.3333333333333335,0,1,1,2,3,2,1,2,4,2,1,1,2,2,2,1,2,1,1,1,2,0.6805570473787206,1.7,0,"I lived with my mother, but not father, most of the time.",0,"Hispanic of Latino (e.g., Mexican American, Central American, and others) & White, Caucasian, Anglo, European American",1,27,0,1,NA,1,3,3,Waiter,3,170,69,1,5,2,0,0,1,0,0,TRUE,TRUE,TRUE,TRUE,TRUE,1,0.49504687501862643,0.4622718750089407,0.5181838709731256,0.5997599999944369,0.5829366666674614,0.6093156250044703,1,1,1,0.9375,1,1,0.113,0.335,0.641,0.018,1.832,53.67986396749323,1839.468838916589,0.105,0.304,0.653,0.017,1.836,57.61889473560605,1839.4345087989122,0.058,0.369,0.487,0.017,1.87,53.08533022935735,1899.126947770981,101.77777777777779,108,110,FALSE,368,1.0903703703703704,0,1,0,0,3,FALSE
508,2022-03-19T07:03:49Z,2022-03-19T08:26:44Z,4974,1,2022-03-19T08:26:45Z,0.8999999761581421,Chrome,99.0.4844.51,Windows NT 10.0,1707,1067,No problems.,1.5998125585754452,687,112,390,170,32,87,0.018792229493664936,-0.0325492966871607,-0.07749876104939024,0.8864970911678944,-0.5924373208503674,-0.13014718364729932,1,1,1,1,1,1,1,2,1,1,2,1,1,1,1,2,1,1,2,1,1.3803127029389886,0,1,1,5,5,1.2,0,2,1,2,1,2,1,1,2,2,1,2,2,1,2,1,2,2,1,1,1,2,2,1,1,2,0,0,0,0,1,1,2,1,1,1,1,1,1,1,1,2,1,2,1,1,2,1,2,1,1,1,1,1,1,1,1,1,2,2,1,1,1,2,1,1,1,2,1,1,1,1.8158461656476568,1.6035674514745464,1.5,0,1.25,0,1.5333333333333334,0,1.1111111111111112,0,1.3333333333333333,0,1,0,1.4285714285714286,0,1,0,1.2162162162162162,0,1,0,0,-0.9716787882942585,-1.0421975040768552,-0.31345356682763886,-0.677825535452247,1,1,2,1,1,1,1,1,1,1.7320508075688772,1.1428571428571428,0,1,-0.874984074548163,5,5,5,5,3,3,5,6,4,4,3,1.5735915849388864,5,4.428571428571429,0,0.25285077779445086,0,0.6868248105880386,2,2,2,2,2,5,2,2,4,4,5,4,3,4,4,3,4,5,3,2,1.2227992865708155,2,0,4.6,0,3,0,3.2,0,3.6,0,1,1,1,1,1,1,1,2,1,1,1,2,1,1,1,2,1,1,1,1,0.9445132413883326,1.15,0,I lived with my mother and father an equal amount of time (joint custody),0,"White, Caucasian, Anglo, European American",0,30,0,1,NA,1,3,4,Restaurant manager,5,160,73,3,5,2,0,0,1,0,0,TRUE,TRUE,TRUE,TRUE,TRUE,4,0.44046875000093133,0.38463225806504486,0.4490031250009779,0.4999677419362049,0.4432375000007451,0.4754833333333333,1,0.96875,1,0.96875,1,0.967741935483871,0.051,0.35,0.572,0.039,1.741,93.58058794950126,1922.8075452061712,0.054,0.301,0.643,0.03,1.715,175.95523766516314,2008.893427931464,0.05,0.345,0.598,0.016,1.55,168.55181319553856,1989.713953897772,44.64102564102564,57.16666666666667,96.875,FALSE,422,1.2503703703703704,0,1,0,3,6,FALSE
509,2022-03-19T09:21:05Z,2022-03-19T09:44:42Z,1416,1,2022-03-19T09:44:44Z,1,Edge,99.0.1150.39,Windows NT 10.0,1536,864,"I enjoyed the Flanker game, and answering the questions.  I hadn't thought about my life before I was 13 as in-depth as this before, so it was interesting.",1.7777777777777777,657,78,293,66,60,84,-0.042890763661673215,-0.220288990079177,-0.4299259100161866,-0.3961001596283038,-0.018272926976413795,-0.16386185134342626,1,2,2,1,2,1,2,2,1,2,2,3,3,1,3,2,2,1,2,2,0.9333020044867296,0,1,1,3,3,1.85,0,3,2,3,2,2,3,4,3,2,3,4,3,3,3,1,2,4,1,1,2,3,3,2,0,2,0,0,0,0,1,1,1,1,1,1,1,1,3,2,2,3,1,2,2,1,5,5,3,4,4,3,1,1,1,4,3,1,1,1,1,3,5,3,1,1,1,2,2,1,1,1.6526437097061275,0.8338093878327919,2.25,0,1.5,0,2.7333333333333334,0,1.2222222222222223,0,2.8333333333333335,0,2.1666666666666665,0,2.142857142857143,0,1,0,2.054054054054054,0,0,0,0,0.05912965470561092,0.17497385987573516,-0.4466634660828154,-0.1358448031035401,1,1,2,1,1,2,1,1,1,1.6761634196950514,1.2857142857142858,0,1,-0.7920494875423887,5,5,5,5,3,3,4,6,3,6,5,1.2909944487358056,4.5,4.285714285714286,0,1.2766077140331027,0,1.2329817515257324,1,1,1,1,1,4,5,3,5,5,5,4,5,3,4,1,5,4,2,3,1.533747356112131,1,0,4.4,0,3.6,0,3.6,0,3.8666666666666667,0,1,1,2,2,3,2,2,2,1,1,2,2,3,3,1,3,1,1,1,2,0.8522416262267903,1.8,0,I lived with my mother and father an equal amount of time (joint custody),0,"White, Caucasian, Anglo, European American",0,27,0,1,NA,1,2,7,"PhD Candidate, Finance",2,147,68,5,5,2,0,0,1,0,0,TRUE,TRUE,TRUE,TRUE,TRUE,2,0.5094812499918043,0.40185624999552966,0.4897677419262548,0.5406218749955296,0.4841533333381017,0.5466161290407181,1,1,1,1,0.9375,0.96875,0.066,0.376,0.619,0.02,1.552,74.19076121008813,1899.5571598602592,0.061,0.305,0.645,0.024,2.013,20.96139627180465,1863.351865832331,0.161,0.238,0.611,0.02,1.12,134.48507991977039,1926.054723954046,77.6,83.875,56.00000000000001,FALSE,386,1.1437037037037037,0,1,0,0,3,FALSE
510,2022-03-19T09:58:23Z,2022-03-19T10:21:00Z,1357,1,2022-03-19T10:21:02Z,1,Edge,99.0.1150.39,Windows NT 10.0,1920,1080,No.,1.7777777777777777,551,145,387,96,45,75,-0.26083733947720134,0.14966864101685512,-0.0883985697803221,-0.026120183437092773,-0.3258609951231747,-0.265005854431807,2,2,2,2,1,1,2,2,3,1,2,3,1,1,1,1,1,1,2,2,1.0990426455975697,0,1,1,2,2,1.65,0,3,2,3,3,3,3,2,2,3,1,1,2,1,2,5,1,2,1,1,1,2,2,2,1,2,0,0,0,0,2,2,3,2,5,2,5,4,5,3,2,1,1,3,2,2,1,1,1,2,1,2,1,1,1,3,1,1,2,2,1,2,2,1,3,3,1,3,1,2,2,1.2284172780488758,1.1751393027860062,1.5,0,2,0,2.4,0,3.3333333333333335,0,1.6666666666666667,0,1.5,0,1.5714285714285714,0,2.3333333333333335,0,2.081081081081081,0,1,0,0,-0.4102171682773084,-0.2862099902565679,-0.05499485428507328,-0.1706024222708206,2,1,2,1,1,1,1,3,2,1.4638501094227998,1.2857142857142858,0,2.5,-0.21184311575925535,2,4,4,4,4,3,3,7,6,6,4,0.7867957924694432,6.5,3.4285714285714284,0,1.2946567068380648,0,0.7795591523626557,4,2,3,3,4,2,4,5,5,4,5,4,4,5,5,2,3,4,4,2,1.424279266355945,3.2,0,3.6,0,3.6,0,4.4,0,3.8666666666666667,0,1,2,1,2,3,4,4,3,2,1,3,3,1,1,1,4,1,3,1,1,1.0711528467275955,2.1,0,I lived with my mother and father an equal amount of time (joint custody),0,Filipino,0,19,0,1,NA,1,3,3,Student,6,150,64,1,5,2,0,0,1,0,0,TRUE,TRUE,TRUE,TRUE,TRUE,6,0.4858000000100583,0.4248031250089407,0.5172562499959021,0.5712531250100583,0.5036562500018626,0.6029032258083743,1,1,1,1,1,0.96875,0.066,0.33,0.321,0.016,1.612,137.15313859899885,1962.8211211634264,0.088,0.276,0.61,0.015,1.488,30.29292650354297,1809.9013417423373,0.09,0.321,0.509,0.019,1.507,20.346235100598765,1802.9216378467186,100.75,99.2,79.3157894736842,FALSE,294,0.8711111111111112,0,1,0,0,3,FALSE
511,2022-03-19T10:57:13Z,2022-03-19T11:20:45Z,1411,1,2022-03-19T11:20:47Z,1,Firefox,98.0,Windows NT 10.0,1920,1080,Study worked perfectly fine,1.7777777777777777,583,117,307,95,132,114,-0.195042146778174,-0.004940518247158307,-0.3790601359385046,-0.03845284931013314,1.4581498001280382,0.17328482561784295,2,2,2,2,2,1,3,2,1,1,3,1,1,1,1,2,1,1,2,2,1.0699237552766379,0,1,1,2,2,1.65,0,2,1,2,2,1,3,2,2,1,1,1,1,2,2,1,1,3,1,1,1,2,2,3,0,2,0,0,0,0,1,2,3,1,1,1,4,2,1,1,2,5,1,2,2,1,3,5,5,5,2,1,5,1,1,3,3,1,1,1,1,2,2,2,1,1,1,2,2,1,1,1.6823585617609376,1.5796322658258457,1.75,0,1.5,0,1.6,0,1.7777777777777777,0,2.8333333333333335,0,2.3333333333333335,0,1.4285714285714286,0,1,0,2.081081081081081,0,0,0,0,-0.2479196687411588,-0.5263402593446456,-0.4466634660828154,-0.48650186271373047,1,2,3,1,1,1,1,3,1,1.5275252316519468,1.4285714285714286,0,2,-0.32231065268119236,5,5,5,5,2,3,5,4,3,5,3,1.7043362064926932,3.5,4.285714285714286,0,0.1957313727576048,0,0.5746313046136784,2,3,3,1,2,4,4,3,4,3,5,1,4,3,3,5,4,4,4,4,1.0600988273786194,2.2,0,3.6,0,4,0,3.4,0,3.6666666666666665,0,2,1,1,3,1,2,2,4,3,1,2,3,3,4,2,4,1,3,4,2,0.9733285267845752,2.4,0,NA,NA,"White, Caucasian, Anglo, European American",0,28,0,1,NA,1,1,3,Unemployed looking for work,1,264,76,1,5,2,0,0,1,0,0,TRUE,TRUE,TRUE,TRUE,TRUE,5,0.49290625,0.46209375,0.50278125,0.582103448275862,0.5973846153846154,0.6607931034482759,1,1,1,0.90625,0.8125,0.90625,0.075,0.351,0.498,0.01,1.886,102.30913354400258,1960.688021762655,0.066,0.365,0.646,0.014,2.034,76.3712338144011,1937.2706967730323,0.061,0.376,0.601,0.013,1.772,108.22584957368588,1963.692067576409,188.6,145.28571428571428,136.30769230769232,FALSE,304,0.9007407407407407,1,1,0,6,9,FALSE
513,2022-03-19T11:51:27Z,2022-03-19T12:24:07Z,1959,1,2022-03-19T12:24:10Z,0.5,Chrome,99.0.4844.74,Windows NT 10.0,1536,864,NA,1.7777777777777777,986,117,411,82,55,125,0.6335660612752019,-0.004940518247158307,-0.0012000999328673247,-0.1987775056596579,-0.12080228302533408,0.296905273836975,1,1,1,1,1,1,1,1,1,1,1,1,1,1,1,1,1,1,1,1,1.538967528127731,1,0,2,2,1,1,0,5,5,1,3,2,5,4,5,3,3,4,4,3,5,5,2,4,1,5,5,4,4,3,3,1,3,0,4,0,2,2,3,3,3,2,4,2,3,2,4,2,2,3,3,3,3,2,2,3,3,3,1,1,1,4,2,5,1,1,1,4,4,5,2,3,1,2,2,1,1,1.138989594902999,1.4074631010979937,3.5,0,1.5,0,3.8,0,2.6666666666666665,0,2.6666666666666665,0,2,0,3,0,2,0,2.5675675675675675,0,2,0,0,1.203984989271423,1.4106319112110275,-0.007937859210751935,0.7013470260001378,1,1,5,1,1,1,1,8,1,1.5118578920369088,1.5714285714285714,0,4.5,0.7276345539631375,3,3,3,4,1,1,1,1,1,2,1,1.4638501094227998,1,2.2857142857142856,0,-1.5837402805442329,0,-1.5928636757289039,2,2,4,3,4,5,3,5,5,2,5,1,5,5,5,5,4,4,3,1,1.6388149028228556,3,0,3.8,0,3.6,0,4.2,0,3.8666666666666667,0,1,3,1,4,4,2,1,1,1,1,2,1,2,1,1,1,2,2,1,1,1.190974832912761,1.65,0,I lived with my mother and father an equal amount of time (joint custody),0,"White, Caucasian, Anglo, European American",0,30,0,1,NA,1,2,4,Assistant Manager,2,195,70,3,5,2,1,0,1,0,1,TRUE,TRUE,TRUE,TRUE,TRUE,4,0.6027249999903143,0.6216562499850988,0.6180156250111759,0.7090800000111261,0.6422100000063579,0.6724896551699474,1,1,1,0.9375,0.967741935483871,0.90625,0.076,0.324,0.26,0.016,1.959,90.42274726867015,1997.6227863900133,0.075,0.385,0.315,0.032,1.545,37.223890395682496,1861.3334656919865,0.084,0.403,0.427,0.016,2.06,192.41103035258712,2062.6219866320816,122.4375,48.28125,128.75,FALSE,434,1.285925925925926,0,1,0,0,3,FALSE
514,2022-03-19T13:06:09Z,2022-03-19T13:33:36Z,1647,1,2022-03-19T13:33:37Z,0.800000011920929,Chrome,99.0.4844.74,Windows NT 10.0,1920,1080,N/A,1.7777777777777777,547,122,603,142,48,87,-0.26906173856457977,0.02266826019284409,0.6963876588467708,0.5411824467227642,-0.26434338149382247,-0.13014718364729932,1,1,1,1,1,1,1,1,1,1,1,1,1,1,1,1,1,1,1,1,1.538967528127731,0,1,1,5,5,1,0,4,3,2,3,3,3,2,3,3,3,2,3,2,3,3,3,4,1,1,3,3,3,2,2,2,0,0,0,0,1,4,4,4,5,4,4,4,4,2,3,2,3,3,3,2,5,4,4,5,5,4,4,1,1,3,1,1,2,2,1,4,3,2,2,3,3,3,2,2,1,1.2124231810593074,0.560611910581388,2.5,0,2,0,2.8,0,3.7777777777777777,0,3.4166666666666665,0,2.3333333333333335,0,2.142857142857143,0,2.6666666666666665,0,3.027027027027027,0,1,0,0,0.8530714767608292,0.7380311574999499,-0.05499485428507328,0.34151815160743826,4,3,5,3,3,3,3,3,1,0.7867957924694432,3.4285714285714284,0,2,0.838773565399646,3,4,4,4,2,2,3,4,1,2,2,0.8997354108424374,2.5,3.142857142857143,0,-0.9695849561602813,0,-0.7543720553770608,3,2,4,4,4,3,4,4,3,3,5,3,3,4,4,5,4,3,4,4,1.0327955589886444,3.4,0,3.6,0,3.8,0,3.8,0,3.7333333333333334,0,1,1,1,1,1,1,1,1,1,1,1,1,1,1,1,1,1,1,1,1,1.231174022502185,1,0,I lived with my mother and father an equal amount of time (joint custody),0,"White, Caucasian, Anglo, European American",0,30,0,1,NA,1,3,6,Social Worker,4,195,70,2,5,2,0,0,1,0,0,TRUE,TRUE,TRUE,TRUE,TRUE,6,0.6385624999962747,0.5292774193498396,0.5676125000081956,0.6973874999973924,0.62003125,0.6912967741950866,1,1,1,1,1,0.96875,0.088,0.383,0.517,0.017,2.239,82.98118562622078,1911.0349864381826,0.12,0.349,0.703,0.011,1.406,79.8355975547421,1863.2214111544044,0.148,0.385,0.59,0.026,1.763,69.98034596698942,1851.5275553417512,131.70588235294116,127.81818181818181,67.8076923076923,FALSE,304,0.9007407407407407,1,1,0,3,6,FALSE
515,2022-03-19T13:34:26Z,2022-03-19T13:50:31Z,964,1,2022-03-19T13:50:33Z,0.8999999761581421,Chrome,99.0.4844.51,Windows NT 10.0,1920,1080,NA,1.7777777777777777,486,75,206,61,40,53,-0.3944838246471007,-0.23685425714317843,-0.7460203632132101,-0.4577634889935056,-0.42839035117209495,-0.5122467508700711,1,2,1,1,1,1,2,1,1,2,1,2,3,1,1,2,1,1,2,1,1.2773327473170102,0,1,3,4,4,1.4,0,2,1,2,2,1,1,2,2,2,1,1,1,3,2,1,2,1,1,1,1,2,1,1,0,2,0,0,0,0,1,1,1,2,1,1,2,1,1,1,1,1,1,2,1,1,1,1,1,1,1,1,1,1,1,3,1,1,1,1,1,1,1,1,1,1,1,1,1,1,2,1.8652021281831572,1.5796322658258457,1.25,0,1.25,0,1.6,0,1.2222222222222223,0,1.0833333333333333,0,1.3333333333333333,0,1,0,1,0,1.135135135135135,0,0,0,0,-1.1866133147069973,-1.1576409667752183,-0.5328163702636706,-0.8452286685194444,1,1,2,1,1,1,1,1,1,1.7320508075688772,1.1428571428571428,0,1,-0.874984074548163,5,4,5,5,4,3,5,6,6,4,4,1.4638501094227998,6,4.428571428571429,0,0.7766911997228434,0,1.005890519325995,2,1,3,1,1,4,4,4,5,5,4,5,5,2,4,5,5,5,4,2,1.5976172734359604,1.6,0,4.6,0,4.6,0,3.4,0,4.2,0,1,3,1,4,1,2,1,1,1,1,2,1,1,2,2,1,1,2,1,2,1.0894228312566052,1.55,0,NA,NA,"White, Caucasian, Anglo, European American",0,28,0,1,NA,1,4,6,Hospital Technician,2,140,67,4,5,2,0,0,1,0,0,TRUE,TRUE,TRUE,TRUE,TRUE,2,0.46018709677265535,0.3999935483932495,0.42157419355069436,0.5916071428358555,0.47192666666110356,0.5257599999904633,0.96875,1,0.96875,0.875,0.9375,0.9375,0.057,0.33,0.578,0.02,1.974,140.4162248729556,2023.2396494611055,0.067,0.308,0.773,0.02,1.81,111.93574760609735,1957.7636242010992,0.058,0.341,0.515,0.011,1.792,140.04260248409307,2044.7978835231534,98.7,90.5,162.90909090909093,FALSE,307,0.9096296296296296,0,0,0,0,3,FALSE
516,2022-03-19T13:18:52Z,2022-03-19T13:56:10Z,2237,1,2022-03-19T13:56:11Z,0.8999999761581421,Firefox,98.0,Windows NT 10.0,1920,1080,NA,1.7777777777777777,815,150,513,159,128,90,0.2819730002897744,0.17727741945685752,0.36939339691881545,0.7508377665644503,1.3761263152889018,-0.09643251595117242,3,1,2,1,3,1,1,3,1,2,2,2,2,1,3,3,2,1,3,3,0.7880689256524124,0,0,4,3,3,2,0,2,2,3,2,2,3,2,2,1,2,3,2,2,2,1,2,2,1,1,1,2,2,2,1,2,0,0,0,0,1,2,2,1,1,2,1,2,3,1,2,2,1,3,2,1,1,2,2,2,2,2,1,1,1,2,1,1,2,2,1,2,2,1,1,1,1,1,1,1,1,1.4836445670042409,1.1254628677422756,1.625,0,1,0,2.066666666666667,0,1.6666666666666667,0,1.75,0,1.3333333333333333,0,1.5714285714285714,0,1,0,1.5675675675675675,0,1,0,0,-0.6624362553942977,-0.6013686767542292,-0.39960647100849406,-0.5004875738813617,1,1,2,2,1,1,2,1,3,1.6035674514745464,1.4285714285714286,0,2,-0.32231065268119236,5,5,5,5,4,4,5,6,6,5,4,1.4638501094227998,6,4.714285714285714,0,0.9905165020526746,0,1.290934619583138,3,3,3,3,3,3,3,3,3,3,2,3,2,3,3,3,4,4,3,2,0.560611910581388,3,0,3.2,0,2.8,0,2.8,0,2.933333333333333,0,1,2,1,2,2,1,1,3,1,2,2,2,3,2,2,2,1,2,2,2,0.7181848464596079,1.8,0,I lived with my mother and father an equal amount of time (joint custody),0,"White, Caucasian, Anglo, European American",0,19,0,1,NA,1,4,4,landscaping,5,180,71,2,5,2,0,0,1,0,0,TRUE,TRUE,TRUE,TRUE,TRUE,2,0.5694827586206896,0.584125,0.57,0.6169677419354839,0.6043793103448276,0.6252413793103448,0.90625,1,1,0.96875,0.9666666666666667,0.9666666666666667,0.058,0.433,0.433,0.022,1.558,58.712381164101345,1885.5886683194099,0.059,0.421,0.394,0.028,1.739,106.23734816543183,1937.4950200134454,0.063,0.358,0.288,0.019,1.888,356.59180642357563,2284.8943047565062,70.81818181818183,62.10714285714286,99.36842105263158,FALSE,506,1.4992592592592593,0,1,0,3,6,FALSE
517,2022-03-19T13:54:08Z,2022-03-19T14:12:50Z,1122,1,2022-03-19T14:12:52Z,1,Firefox,98.0,Windows NT 10.0,1920,1080,NA,1.7777777777777777,440,72,308,113,52,86,-0.4890644141519525,-0.2534195242071799,-0.37542686636152733,0.18353513640459349,-0.18231989665468626,-0.14138540621267498,2,2,2,1,2,1,3,4,1,1,4,1,1,1,3,4,1,1,2,4,1.019545822516343,0,1,1,3,2,2.05,0,1,1,1,1,1,1,1,1,3,1,1,1,1,1,5,3,1,1,3,1,2,2,1,7,1,1,0,1,0,1,5,5,5,5,5,5,5,5,2,1,1,1,2,1,5,1,1,1,5,1,1,1,2,1,4,5,3,5,5,5,1,1,1,1,1,1,3,1,5,5,1.7544452337072474,1.98086080374405,1.75,0,3.5,0,1.4,0,4.555555555555555,0,1.8333333333333333,0,2.3333333333333335,0,3,0,1,0,2.72972972972973,0,4,0,0,0.17317654627155374,-0.33046003984282296,1.1200109811081531,0.39477547063266505,5,5,5,5,5,5,5,4,3,1.9518001458970664,5,0,3.5,2.3312603942462955,3,2,5,3,1,1,1,6,1,2,2,1.6761634196950514,3.5,2.2857142857142856,0,-0.788955151249163,0,-1.108768386481476,1,5,1,5,1,5,5,5,5,1,5,5,5,5,5,5,3,1,5,1,2,2.6,0,3.8,0,4.2,0,4.2,0,4.066666666666666,0,4,1,4,1,4,3,4,4,4,2,2,3,4,4,1,4,1,2,2,4,1.3018205875255096,2.9,0,I lived with my mother and father an equal amount of time (joint custody),0,"Hispanic of Latino (e.g., Mexican American, Central American, and others) & Native American/Alaskan Native/indigenous",1,27,0,2,NA,1,1,4,Unemployed,2,360,74,3,5,2,0,0,0,0,0,TRUE,TRUE,TRUE,TRUE,TRUE,5,0.431625,0.40403125,0.4376451612903226,0.5053793103448276,0.4962857142857143,0.5155666666666667,1,1,1,0.90625,0.9032258064516129,0.9375,0.065,0.331,0.642,0.011,1.357,130.88010724936777,1997.4039498560555,0.067,0.314,0.808,0.016,1.801,21.64915168076714,1875.9175118761514,0.065,0.303,0.562,0.02,2.134,150.6888954516886,2008.2813213952202,123.36363636363637,112.5625,106.69999999999999,FALSE,410,1.2148148148148148,0,1,1,0,3,FALSE
518,2022-03-19T14:31:22Z,2022-03-19T14:47:19Z,957,1,2022-03-19T14:47:21Z,0.8999999761581421,Chrome,99.0.4844.74,Macintosh,2048,1152,N/A,1.7777777777777777,499,70,231,45,28,47,-0.36775452761312083,-0.26446303558318085,-0.6551886237887781,-0.6550861429621515,-0.6744608056895036,-0.5796760862623249,2,2,2,2,3,1,3,2,2,3,3,2,1,2,3,2,3,1,3,3,0.6708203932499369,0,0,2,4,3,2.25,0,3,2,4,2,3,1,3,3,2,1,2,3,1,2,2,2,3,1,1,2,3,1,2,1,1,0,0,1,0,2,2,2,2,2,2,2,2,2,2,2,3,2,3,4,3,3,2,3,3,2,3,1,1,1,2,2,1,3,1,1,2,1,1,1,1,1,2,3,1,1,1.2369438265459067,1.1464230084422218,1.875,0,1.75,0,2.2666666666666666,0,2,0,2.6666666666666665,0,1.6666666666666667,0,1.4285714285714286,0,1,0,1.972972972972973,0,1,0,0,-0.2369536214752029,-0.22789825824623636,-0.14114775846592847,-0.18452300835608243,2,1,3,1,1,1,1,2,1,1.2535663410560174,1.4285714285714286,0,1.5,-0.5157127766089035,4,4,5,4,3,3,5,8,7,5,3,1.2724180205607036,7.5,4,0,0.9182505924020775,0,0.8599048354909147,3,3,4,3,2,3,4,4,4,4,5,4,4,3,3,5,4,4,4,5,1.1751393027860062,3,0,4,0,4.2,0,3.8,0,4,0,2,1,1,2,2,1,3,3,1,2,1,3,1,2,1,2,1,2,1,3,0.7863975156570492,1.75,0,I lived with my mother and father an equal amount of time (joint custody),0,"Asian or Asian American (e.g., Chinese, Japanese, and others)",0,24,0,1,NA,1,4,6,Student,6,155,72,2,5,2,0,0,1,0,0,TRUE,TRUE,TRUE,TRUE,TRUE,3,0.5162593750000014,0.47419062499999565,0.5468343749999949,0.5624884615384732,0.5226259259259225,0.6201781249999876,1,1,1,0.8666666666666667,0.8709677419354839,1,0.09,0.368,0.513,0.016,1.453,46.046864421756034,1827.3130045346193,0.052,0.363,0.513,0.023,2.012,252.28971071489286,2179.268584057716,0.056,0.37,0.411,0.015,1.606,108.71122089331048,2006.7197974167227,90.8125,87.47826086956522,107.06666666666668,FALSE,372,1.1022222222222222,0,1,0,0,3,FALSE
519,2022-03-19T14:31:27Z,2022-03-19T14:50:00Z,1112,1,2022-03-19T14:50:00Z,0.8999999761581421,Chrome,99.0.4844.51,Windows NT 10.0,1536,864,NA,1.7777777777777777,528,77,238,71,47,84,-0.30812763422962725,-0.22581074576717747,-0.6297557367499371,-0.33443683026310195,-0.28484925270360656,-0.16386185134342626,3,2,3,2,3,1,1,2,1,3,2,2,3,3,3,3,1,1,3,3,0.7591546545162482,0,1,1,3,3,2.25,0,1,1,1,1,1,1,1,1,1,1,1,1,1,1,1,1,1,1,1,1,1,1,1,0,2,0,0,0,0,1,1,3,1,1,1,1,1,1,1,1,1,1,1,1,1,1,1,1,2,2,1,1,1,1,2,1,1,1,1,1,1,1,1,1,1,1,1,1,1,1,1.879636409796595,2.065591117977289,1,0,1,0,1,0,1.2222222222222223,0,1.1666666666666667,0,1.1666666666666667,0,1,0,1,0,1.135135135135135,0,0,0,0,-1.3489108142431467,-1.5287513826386112,-0.6189692744445258,-1.0738603285415684,1,1,1,1,1,1,1,1,1,1.9518001458970664,1,0,1,-0.9579186615539372,5,5,5,5,3,3,5,7,3,6,4,1.5735915849388864,5,4.428571428571429,0,1.0237119994713875,0,1.1563482985379245,2,2,2,3,2,4,3,4,5,1,5,4,3,3,4,3,5,4,3,3,1.1751393027860062,2.2,0,4.4,0,2.6,0,3.8,0,3.6,0,1,1,1,2,1,1,1,1,1,1,2,1,2,1,1,1,1,1,1,1,1.1367080817685316,1.15,0,I lived with my mother and father an equal amount of time (joint custody),0,"White, Caucasian, Anglo, European American",0,28,0,1,NA,1,3,7,Teacher of the deaf,3,155,69,2,5,2,0,0,1,0,0,TRUE,TRUE,TRUE,TRUE,TRUE,4,0.4516906249932945,0.4144218750111759,0.447609375,0.5402566666722298,0.480658620694588,0.5267781249880791,1,1,1,0.9375,0.90625,1,0.071,0.328,0.597,0.013,1.282,71.30530267541258,1858.4801513029786,0.053,0.321,0.617,0.016,1.444,79.00330234682355,1935.031087398332,0.06,0.344,0.612,0.018,1.805,135.85340894127734,1986.0447155583815,98.61538461538463,90.25,100.27777777777779,FALSE,386,1.1437037037037037,0,1,0,0,3,FALSE
520,2022-03-19T14:40:57Z,2022-03-19T14:59:27Z,1109,1,2022-03-19T14:59:29Z,1,Firefox,98.0,Windows NT 10.0,1920,1080,NA,1.7777777777777777,459,133,302,44,48,63,-0.44999851848690503,0.08340757276084937,-0.39722648382339104,-0.6674188088351919,-0.26434338149382247,-0.3998645252163147,2,3,1,1,3,1,3,3,1,3,3,1,1,1,2,2,2,1,2,3,0.812727700887249,0,0,2,3,4,1.95,0,4,2,2,2,3,4,4,5,3,4,5,3,2,4,3,3,5,5,1,3,5,4,5,5,2,0,0,0,0,1,1,1,1,1,2,3,1,3,2,2,5,4,4,4,4,5,5,5,5,5,5,1,1,3,1,1,1,3,3,2,3,3,2,1,2,3,1,1,1,1,1.5299806668193037,1.082325538564332,3.875,0,1,0,3.3333333333333335,0,1.5555555555555556,0,4.166666666666667,0,2,0,2.4285714285714284,0,2,0,2.675675675675676,0,3,0,0,1.5176139410777658,1.4178102525883536,0.03911913586356937,0.7284646942259615,1,1,2,1,1,1,1,3,4,1.7320508075688772,1.1428571428571428,0,3.5,0.0920265450903926,5,5,5,5,5,5,4,6,5,6,4,1.1338934190276817,5.5,4.857142857142857,0,1.1140269019269466,0,1.4435661844297796,4,4,5,5,5,1,2,5,1,1,1,2,2,4,4,2,3,1,2,2,1.4540583599999397,4.6,0,1.6,0,1.8,0,3.2,0,2.2,0,1,1,4,3,3,4,2,3,3,4,3,3,1,4,1,4,1,4,2,3,1.187655806953123,2.7,0,NA,NA,"White, Caucasian, Anglo, European American",0,24,0,1,NA,1,2,6,Freelance Writer,2,150,73,1,5,2,0,0,1,0,0,TRUE,TRUE,TRUE,TRUE,TRUE,1,0.4638125,0.40596875,0.43409375,0.6246,0.508,0.5319285714285714,1,1,1,0.9375,0.90625,0.9032258064516129,0.056,0.334,0.538,0.012,1.464,40.588760980899806,1928.389807237611,0.064,0.315,0.769,0.014,1.642,98.93621669132474,1958.1756505205453,0.065,0.336,0.489,0.011,1.839,116.05508148580053,1965.9737008124873,122,117.28571428571428,167.1818181818182,FALSE,294,0.8711111111111112,0,1,0,3,6,FALSE
521,2022-03-19T14:52:06Z,2022-03-19T15:13:13Z,1266,1,2022-03-19T15:13:13Z,0.8999999761581421,Chrome,99.0.4844.51,Macintosh,1440,900,NA,1.6,580,84,315,93,73,72,-0.2012104460937078,-0.1871584559511741,-0.3499939793226864,-0.06311818105621388,0.24830339875077895,-0.29872052212793393,3,3,2,3,3,1,2,2,1,3,3,2,4,3,3,3,2,1,3,3,0.7181848464596079,0,0,4,4,4,2.5,0,4,4,4,4,3,2,3,3,2,3,3,4,2,4,5,3,2,1,1,1,3,3,2,2,1,1,0,1,0,2,3,3,4,5,4,4,4,4,3,3,3,1,4,4,3,4,4,3,3,3,4,3,2,1,3,1,3,2,2,2,5,4,2,2,3,2,2,2,2,2,0.9012837024557319,0.7367883976130072,2,0,2,0,3.3333333333333335,0,3.6666666666666665,0,3.1666666666666665,0,2.3333333333333335,0,2.857142857142857,0,2.3333333333333335,0,3.027027027027027,0,1,0,0,0.52847647768853,0.752584507141652,-0.05499485428507328,0.3487948264282894,4,3,4,4,3,4,3,3,1,0.816496580927726,3.5714285714285716,0,2,0.9217081524054204,3,3,3,3,1,1,2,4,4,2,2,1.1338934190276817,4,2.2857142857142856,0,-0.698640248793604,0,-1.0537585263116522,4,5,4,4,4,2,4,3,2,3,3,3,3,3,2,4,3,4,4,3,0.7037315505489968,4.2,0,3,0,3.6,0,2.6,0,3.066666666666667,0,3,2,3,4,2,3,3,3,2,1,2,3,3,3,3,4,2,3,4,3,0.8207826816681233,2.8,0,I lived with my mother and father an equal amount of time (joint custody),0,"White, Caucasian, Anglo, European American",0,28,0,1,NA,1,3,7,Financial Analyst,3,165,70,3,5,2,0,0,1,0,0,TRUE,TRUE,TRUE,TRUE,TRUE,4,0.49186250000074505,0.4746870967745781,0.4925000000028841,0.5842806451599444,0.5589599999984105,0.5536766666650772,1,1,1,0.96875,0.9375,0.9375,0.06,0.375,0.562,0.02,1.73,52.903660898227436,1897.664112725901,0.059,0.391,0.722,0.019,1.766,17.617887177921496,1860.1935571963818,0.079,0.368,0.717,0.01,1.445,66.91543935051206,1891.4151782774718,86.5,92.94736842105263,144.5,FALSE,416,1.2325925925925925,0,1,0,3,6,FALSE
522,2022-03-19T15:15:24Z,2022-03-19T15:38:32Z,1387,1,2022-03-19T15:38:34Z,1,Chrome,99.0.4844.51,Windows NT 10.0,1920,1080,NA,1.7777777777777777,540,120,441,95,65,70,-0.283454436967492,0.01162474881684313,0.10779798737645113,-0.03845284931013314,0.0842564290725065,-0.32119696725868524,3,2,3,3,4,2,1,4,1,3,4,3,3,2,3,3,2,1,3,4,0.7880689256524124,0,1,1,4,2,2.7,0,3,3,4,3,3,2,2,3,2,3,3,3,1,3,2,3,3,4,1,2,3,3,2,1,2,0,0,0,0,2,3,4,3,4,2,4,4,3,3,3,2,1,3,2,4,4,2,2,4,4,4,4,1,3,3,3,1,2,1,1,3,5,4,3,4,1,2,2,1,1,1.0856696913328099,0.7988086367179802,2.625,0,1.5,0,2.6666666666666665,0,3.2222222222222223,0,2.8333333333333335,0,3,0,2.4285714285714284,0,2.6666666666666665,0,2.864864864864865,0,1,0,0,0.8289461727757258,0.6635927407515164,-0.22730066264678367,0.21814603905236638,2,1,3,2,1,2,1,1,2,1.1547005383792515,1.7142857142857142,0,1.5,-0.3498436025973552,2,2,2,2,1,1,2,3,3,3,1,1,3,1.7142857142857142,0,-1.0086553683921653,0,-1.5521961862365288,2,3,2,2,2,4,4,5,5,3,5,4,3,4,2,5,4,4,4,4,1.245945806357946,2.2,0,4.2,0,3.8,0,4,0,4,0,1,1,3,4,2,3,3,4,2,1,3,3,2,2,2,3,1,3,2,3,0.7947194142390263,2.4,0,I lived with my mother and father an equal amount of time (joint custody),0,"White, Caucasian, Anglo, European American",0,25,0,1,NA,1,2,4,Instacart Shopper,1,245,71,2,5,2,0,0,0,0,0,TRUE,TRUE,TRUE,TRUE,TRUE,3,0.4286000000089407,0.4116312500089407,0.43966249999776486,0.5706071428656578,0.5293000000139763,0.5736142856989588,1,1,1,0.875,0.90625,0.875,0.068,0.317,0.556,0.011,1.641,25.54408802336867,1887.4580377004588,0.065,0.295,0.536,0.013,1.707,166.4727538505304,2055.4531394588025,0.069,0.298,0.556,0.009,1.646,77.10681823113445,1938.2194012275709,149.1818181818182,131.30769230769232,182.88888888888889,FALSE,328,0.9718518518518519,0,1,0,3,6,FALSE
523,2022-03-19T15:15:17Z,2022-03-19T15:42:55Z,1657,1,2022-03-19T15:42:56Z,0.8999999761581421,Chrome,99.0.4844.74,Windows NT 10.0,1536,864,No feedback to report.,1.7777777777777777,751,73,386,73,52,268,0.15038261489171967,-0.24789776851917938,-0.09203183935729937,-0.30977149851702124,-0.18231989665468626,1.9039711006856916,1,2,1,2,1,1,2,2,1,1,2,2,1,2,1,1,1,1,2,1,1.2354415362426845,0,0,4,4,3,1.4,0,2,3,1,3,2,1,2,1,2,1,2,3,1,2,4,2,1,1,1,2,1,2,2,1,1,0,0,2,0,3,2,3,4,4,1,3,3,2,2,3,1,1,3,2,1,1,1,2,1,3,2,1,1,1,1,2,1,2,1,1,3,3,4,1,2,1,2,1,1,1,1.2339053944782488,1.162919151265879,1.5,0,1.25,0,2,0,2.7777777777777777,0,1.75,0,1.3333333333333333,0,2.142857142857143,0,1.3333333333333333,0,1.972972972972973,0,1,0,0,-0.4803998707794273,-0.5080502388489936,-0.31345356682763886,-0.4107519028383162,1,1,4,1,1,3,2,3,1,1.4638501094227998,1.8571428571428572,0,2,-0.07350689166386981,3,4,5,4,2,2,3,4,3,1,3,1.1126972805283737,3.5,3.2857142857142856,0,-0.6595698365617197,0,-0.4881424211742156,1,1,2,2,1,4,4,4,5,1,5,4,4,3,5,4,5,5,3,3,1.4040757000349275,1.4,0,4.6,0,3.2,0,4,0,3.933333333333333,0,1,1,1,2,2,1,2,1,1,1,3,1,1,1,1,1,1,1,1,1,1.164157703189193,1.25,0,I lived with my mother and father an equal amount of time (joint custody),0,"White, Caucasian, Anglo, European American",0,22,0,1,NA,1,3,4,Unemployed,1,102.4,63,2,5,2,0,0,0,0,0,TRUE,TRUE,TRUE,TRUE,TRUE,4,0.6789322580649487,0.5497187500002328,0.5183656250000931,0.7533843750001397,0.6092499999988359,0.5826562500004656,1,1,1,1,1,1,0.144,0.308,0.723,0.012,1.23,96.39564161740509,1882.915726173448,0.081,0.361,0.429,0.024,1.546,73.52892940394963,1862.4668962705568,0.191,0.277,0.491,0.016,1.601,104.4371167149783,1889.9522470765512,102.5,64.41666666666667,100.0625,FALSE,384,1.1377777777777778,0,1,0,0,3,FALSE
524,2022-03-19T15:30:47Z,2022-03-19T15:50:58Z,1211,1,2022-03-19T15:50:59Z,0.8999999761581421,Chrome,99.0.4844.74,Windows NT 10.0,2048,1152,NA,1.7777777777777777,481,62,398,82,44,80,-0.4047643235063237,-0.3086370810871847,-0.04843260443357199,-0.1987775056596579,-0.3463668663329587,-0.20881474160492883,2,1,2,1,2,2,3,2,1,2,1,2,1,3,2,2,1,2,2,2,0.9459053029269173,0,0,3,3,3,1.8,0,2,2,2,3,2,1,3,1,2,1,1,2,1,2,3,3,2,2,1,3,3,1,1,0,1,1,0,0,0,2,2,2,3,4,3,3,3,4,2,4,3,1,2,1,2,1,2,1,1,2,3,1,1,1,3,2,1,1,1,1,3,4,2,1,1,1,2,2,1,2,1.1343662489631763,1.2421180068162376,2,0,1.75,0,1.8666666666666667,0,2.888888888888889,0,1.8333333333333333,0,1.8333333333333333,0,1.8571428571428572,0,1,0,2.027027027027027,0,0,0,0,-0.1207135204560685,-0.3243633663442723,-0.3605105619019602,-0.34243696412311625,2,1,3,1,1,2,3,1,1,1.2149857925879117,1.8571428571428572,0,1,-0.4603111395192921,5,5,5,5,4,4,4,6,6,4,3,1.1126972805283737,6,4.571428571428571,0,0.43348058270556905,0,0.874247206168363,2,1,2,2,2,4,3,4,5,4,5,3,4,4,4,1,3,4,2,2,1.2071217242444348,1.8,0,3.8,0,2.8,0,3.8,0,3.466666666666667,0,1,1,1,4,1,1,1,2,1,1,2,1,1,2,1,1,1,1,1,1,1,1.3,0,I lived with my mother and father an equal amount of time (joint custody),0,"White, Caucasian, Anglo, European American",0,26,0,1,NA,1,2,4,Online freelancing,3,145,70,3,5,2,0,0,1,0,0,TRUE,TRUE,TRUE,TRUE,TRUE,1,0.44601290326733745,0.4263903225391142,0.4058580644976708,0.4999645161551814,0.505596874974668,0.5036064516190559,0.96875,1,0.96875,1,1,0.96875,0.062,0.302,0.538,0.013,1.431,166.17545047157594,2049.20907267152,0.069,0.342,0.843,0.018,1.658,113.25639194883753,1898.5653725422148,0.055,0.346,0.532,0.02,1.4,144.70028375943255,1973.9976210503366,110.07692307692308,92.11111111111111,70,FALSE,304,0.9007407407407407,1,1,0,3,6,FALSE
525,2022-03-19T15:43:01Z,2022-03-19T16:03:28Z,1226,1,2022-03-19T16:03:30Z,0.8999999761581421,Chrome,99.0.4844.74,Windows NT 10.0,1920,1080,No comments,1.7777777777777777,476,66,407,80,68,74,-0.41504482236554674,-0.28655005833518277,-0.01573317824077645,-0.22344283740573864,0.14577404270185867,-0.2762440769971827,1,1,1,1,1,1,1,1,1,1,1,1,1,1,1,1,1,1,1,1,1.538967528127731,0,1,1,5,5,1,0,1,2,1,1,1,1,1,1,2,1,1,1,1,1,2,1,1,1,1,1,1,1,1,1,2,0,0,0,0,1,2,3,2,3,1,3,2,1,1,1,1,1,1,1,2,2,1,1,1,1,1,1,1,1,1,1,1,2,2,1,3,4,3,1,1,1,1,1,2,2,1.5891902106184537,1.8973665961010275,1,0,1.5,0,1.2,0,2,0,1.1666666666666667,0,1,0,2.2857142857142856,0,1,0,1.5405405405405406,0,1,0,0,-1.0857256798602015,-1.2644310864433808,-0.22730066264678367,-0.7458658745450822,1,1,3,1,1,2,2,1,1,1.4638501094227998,1.5714285714285714,0,1,-0.6261803135308405,5,5,5,5,4,4,4,3,3,2,3,1.1126972805283737,3,4.571428571428571,0,-0.5360594366874477,0,0.28371054559784326,2,2,2,2,2,4,5,4,4,3,4,5,4,3,3,4,3,3,3,4,1.01418510567422,2,0,3.8,0,3.8,0,3.6,0,3.7333333333333334,0,1,1,1,2,1,1,1,2,1,1,1,2,1,1,1,2,1,1,2,1,0.8255779474818965,1.25,0,I lived with my mother and father an equal amount of time (joint custody),0,"Hispanic of Latino (e.g., Mexican American, Central American, and others) & White, Caucasian, Anglo, European American",1,25,0,2,NA,1,3,6,Inspector,3,130,64,1,5,2,0,0,1,0,0,TRUE,TRUE,TRUE,TRUE,TRUE,6,0.4484838709678621,0.4200687500000349,0.4503812499999185,0.5199666666667908,0.4942960000000894,0.5506230769230482,0.96875,1,1,0.84375,0.78125,0.8125,0.055,0.348,0.553,0.012,1.677,35.79861351611889,1940.1796547987567,0.049,0.341,0.656,0.018,1.775,91.64608077659547,1946.203632158463,0.052,0.333,0.46,0.011,1.505,115.26209031153626,2099.2125465204435,139.75,98.61111111111111,136.8181818181818,FALSE,311,0.9214814814814816,0,1,0,3,6,FALSE
527,2022-03-19T15:50:39Z,2022-03-19T16:11:13Z,1233,1,2022-03-19T16:11:14Z,1,Firefox,98.0,Windows NT 10.0,1920,1080,NA,1.7777777777777777,462,61,499,60,43,59,-0.4438302191713712,-0.31415883677518514,0.3185276228411335,-0.470096154866546,-0.36687273754274274,-0.4448174154778173,2,3,3,1,3,2,1,2,1,1,3,1,1,1,2,3,1,1,2,3,0.9445132413883326,0,0,2,2,4,1.85,0,3,2,1,2,1,1,3,2,2,1,2,2,1,3,3,3,2,1,1,2,1,3,2,5,2,0,0,0,0,2,3,2,1,2,3,4,2,1,1,1,2,1,2,4,1,2,1,3,2,4,3,1,1,1,1,1,3,4,1,1,1,2,1,1,1,2,1,2,2,3,1.4972447167185936,1.1751393027860062,1.875,0,2,0,1.9333333333333333,0,2.2222222222222223,0,2,0,1.3333333333333333,0,1.8571428571428572,0,1.3333333333333333,0,1.864864864864865,0,3,0,0,-0.3071363239773215,-0.4206318075552585,0.3837307525869902,-0.018450527484134144,1,1,2,1,1,1,1,3,1,1.7320508075688772,1.1428571428571428,0,2,-0.48817982669274074,4,5,5,3,2,3,5,7,6,4,4,1.4960264830861913,6.5,3.857142857142857,0,0.8670061021784026,0,0.75128967853311035,4,2,3,3,2,3,5,4,5,3,5,5,3,3,3,5,5,3,5,4,1.4638501094227998,2.8,0,4.2,0,4.2,0,3.8,0,4.066666666666666,0,1,1,1,3,3,2,3,3,3,1,2,3,1,1,1,3,1,3,1,2,0.7863975156570492,1.95,0,"I lived with my extended family on father's side (grandparents, aunts ,uncles, cousins)",0,"Hispanic of Latino (e.g., Mexican American, Central American, and others) & White, Caucasian, Anglo, European American",1,22,0,1,NA,1,2,2,Unemployed,2,195,69,3,5,2,0,0,1,0,0,TRUE,TRUE,TRUE,TRUE,TRUE,2,0.5269032258064517,0.49315625,0.51109375,0.6089677419354839,0.5435483870967742,0.627,1,1,1,1,1,1,0.181,0.224,0.622,0.011,1.283,78.04370465620599,1863.9130652179863,0.101,0.358,0.775,0.029,1.797,76.09974503461211,1856.0180346258455,0.185,0.266,0.745,0.014,1.473,57.71095523471782,1839.9505772482364,116.63636363636364,61.9655172413793,105.21428571428572,FALSE,420,1.2444444444444445,0,1,0,0,3,FALSE
528,2022-03-19T16:01:32Z,2022-03-19T16:21:13Z,1181,1,2022-03-19T16:21:14Z,0.8999999761581421,Chrome,99.0.4844.51,Windows NT 10.0,1920,1080,none,1.7777777777777777,646,90,238,36,38,62,-0.06550786115196387,-0.15402792182317124,-0.6297557367499371,-0.7660801358195148,-0.46940209359166307,-0.41110274778169037,3,2,3,3,3,2,2,3,3,2,3,2,3,3,2,2,3,3,2,2,0.4893604849295929,0,1,4,5,5,2.55,0,3,3,3,3,3,2,4,3,4,4,3,3,3,3,3,3,4,4,3,3,2,4,3,0,2,0,0,0,0,3,4,2,2,3,3,3,4,4,3,3,3,3,3,3,2,4,4,3,3,3,3,3,3,3,3,3,3,3,2,2,2,4,3,3,3,3,3,3,3,3,0.5747437083869038,0.5345224838248488,3.25,0,3,0,3.1333333333333333,0,3.111111111111111,0,3.0833333333333335,0,3,0,2.7142857142857144,0,3,0,3,0,0,0,0,1.3224182997437484,1.1992150076322532,0.0702539590023158,0.6347344833172845,3,3,2,4,2,3,5,1,1,0.9759000729485332,3.142857142857143,0,1,0.28610014353267543,3,3,4,4,2,2,2,7,7,3,3,0.8997354108424374,7,2.857142857142857,0,0.4002850852868561,0,-0.07480392615590334,3,3,3,3,3,3,3,4,4,4,2,3,3,3,2,4,3,3,3,3,0.6399404734221844,3,0,2.8,0,3.4,0,3.2,0,3.1333333333333333,0,2,2,3,2,3,2,1,3,2,2,2,3,2,2,3,2,3,2,2,2,0.5501196042201808,2.25,0,I lived with my mother and father an equal amount of time (joint custody),0,"White, Caucasian, Anglo, European American",0,21,0,1,NA,1,3,5,Retail,3,180,72,3,5,2,0,1,2,0,1,TRUE,TRUE,TRUE,TRUE,TRUE,4,0.7100031250044704,0.5177580645122836,0.7916218750067056,0.8316500000119209,0.5835068965574791,0.8465166666666667,1,1,1,0.967741935483871,0.9354838709677419,0.967741935483871,0.092,0.388,0.251,0.009,1.545,97.27821005177773,1923.5347013216426,0.06,0.411,0.612,0.015,1.504,30.701315263840304,1876.6323603392202,0.098,0.404,0.332,0.014,2.004,46.584704904601374,1871.1595079382712,171.66666666666669,100.26666666666667,143.14285714285714,FALSE,304,0.9007407407407407,1,1,0,0,3,FALSE
529,2022-03-19T16:06:05Z,2022-03-19T16:22:43Z,997,1,2022-03-19T16:22:44Z,0.8999999761581421,Chrome,99.0.4844.74,Windows NT 10.0,1536,864,NA,1.7777777777777777,586,35,151,66,50,55,-0.1888738474626402,-0.4577244846631976,-0.9458501899469606,-0.3961001596283038,-0.22333163907425438,-0.48977030573931984,2,2,1,1,2,1,1,2,1,2,2,1,1,1,2,2,1,1,2,2,1.025978352085154,0,1,2,4,4,1.5,0,2,2,1,2,1,1,2,1,1,1,1,2,1,2,2,1,1,1,1,1,1,1,1,0,2,0,0,0,0,3,3,3,3,3,3,3,3,3,1,2,1,1,2,1,2,1,1,1,1,1,2,1,1,1,1,1,1,1,1,1,2,1,1,1,1,1,1,1,1,1,1.196842693269434,1.5491933384829668,1,0,1,0,1.4666666666666666,0,3,0,1.25,0,1.1666666666666667,0,1.1428571428571428,0,1,0,1.6216216216216217,0,0,0,0,-1.0330886529836123,-1.1126042496407633,-0.6189692744445258,-0.8657867620426445,2,2,3,1,1,1,1,1,1,1.2149857925879117,1.5714285714285714,0,1,-0.6261803135308405,4,4,4,4,2,2,5,3,3,2,3,1.2909944487358056,3,3.5714285714285716,0,-0.5360594366874477,0,-0.2581081810868965,1,1,1,1,1,5,4,5,5,4,5,4,5,4,4,5,4,5,4,5,1.5491933384829668,1,0,4.6,0,4.4,0,4.6,0,4.533333333333333,0,1,1,1,2,1,1,1,1,1,1,1,1,1,1,1,1,1,1,1,1,1.145931016569864,1.05,0,I lived with my mother and father an equal amount of time (joint custody),0,"White, Caucasian, Anglo, European American",0,28,0,1,NA,1,3,5,sales,1,132,66,3,5,2,0,0,1,0,0,TRUE,TRUE,TRUE,TRUE,TRUE,1,0.502322580647084,0.5005843750089407,0.5273218750040978,0.6021187499910593,0.5569714285752603,0.5870551724166706,0.96875,1,1,1,0.9032258064516129,0.9354838709677419,0.06,0.381,0.486,0.018,1.766,80.07327165022764,1929.2618429925546,0.051,0.36,0.367,0.019,1.361,173.42928727030173,2061.6650571794826,0.104,0.336,0.665,0.016,1.87,96.95705311725418,1919.9969115599674,98.11111111111111,71.63157894736842,116.875,FALSE,372,1.1022222222222222,0,1,0,0,3,FALSE
530,2022-03-19T16:15:20Z,2022-03-19T16:42:12Z,1612,1,2022-03-19T16:42:14Z,0.8999999761581421,Chrome,99.0.4844.74,Windows NT 10.0,1920,1080,Thank you for this interesting study!,1.7777777777777777,539,90,658,83,40,52,-0.28551053673933663,-0.15402792182317124,0.8962174855805213,-0.18644483978661755,-0.42839035117209495,-0.5234849734354468,2,2,2,1,3,1,2,2,1,3,3,2,1,1,2,3,2,1,3,2,0.7591546545162482,0,0,2,3,4,1.95,0,3,2,3,2,2,2,2,2,2,2,2,2,2,2,2,2,2,1,1,1,2,2,2,0,2,0,0,0,0,2,2,4,2,4,2,2,2,2,2,2,3,2,2,2,2,2,2,3,4,4,2,1,1,1,1,2,1,1,1,1,2,2,2,1,1,1,2,2,1,1,1.282827208023608,0.9611501047232549,1.625,0,1.5,0,2.1333333333333333,0,2.4444444444444446,0,2.5,0,1.3333333333333333,0,1.4285714285714286,0,1,0,1.972972972972973,0,0,0,0,-0.3992511210113525,-0.3952617791258056,-0.4466634660828154,-0.4209626226043105,2,2,2,2,1,2,2,2,1,1.1338934190276817,1.8571428571428572,0,1.5,-0.2669090155915809,2,2,4,3,1,1,3,6,6,2,3,1.1126972805283737,6,2.2857142857142856,0,0.005829978045906746,0,-0.6246730972340481,1,2,2,3,2,4,3,4,4,2,5,3,4,2,3,3,4,5,3,3,0.828078671210825,2,0,4.2,0,3,0,3.2,0,3.466666666666667,0,1,1,1,1,1,1,1,2,1,1,1,1,1,1,1,1,1,1,1,1,1.145931016569864,1.05,0,I lived with my mother and father an equal amount of time (joint custody),0,"Asian or Asian American (e.g., Chinese, Japanese, and others)",0,21,0,1,NA,1,2,4,Student,2,140,68,2,5,2,0,0,2,0,0,TRUE,TRUE,TRUE,TRUE,TRUE,5,0.45939687502384186,0.40065937499329446,0.44202500000968575,0.5239516129147622,0.4741999999900018,0.5937900000135103,1,1,1,0.96875,0.96875,0.9375,0.06,0.344,0.545,0.009,1.464,206.15266174919867,2054.942610961813,0.064,0.304,0.683,0.011,1.287,37.9310679976479,1862.5200410207194,0.069,0.327,0.537,0.023,1.858,114.23537541327663,1940.9661155158378,162.66666666666669,117,80.78260869565219,FALSE,306,0.9066666666666667,0,1,0,6,9,FALSE
531,2022-03-19T16:18:56Z,2022-03-19T16:42:44Z,1427,1,2022-03-19T16:42:44Z,0.8999999761581421,Chrome,99.0.4844.74,Windows NT 10.0,1536,864,NA,1.7777777777777777,516,53,421,109,63,71,-0.33280083149176254,-0.35833288227918897,0.03513259583690549,0.134204472912432,0.043244686652938374,-0.3099587446933096,1,1,1,1,1,1,1,1,1,1,1,1,1,1,1,1,1,1,1,1,1.538967528127731,0,1,1,5,5,1,0,1,1,1,1,1,1,1,1,1,1,2,2,1,1,2,1,1,2,1,1,1,1,1,1,2,0,0,0,0,1,1,1,1,2,4,4,1,2,1,1,1,1,2,1,1,5,5,3,3,3,1,5,1,3,4,1,1,2,1,1,1,1,1,1,1,1,1,1,1,1,1.75401726803831,1.8973665961010275,1.125,0,1,0,1.2,0,1.8888888888888888,0,2.25,0,2.5,0,1.1428571428571428,0,1,0,1.8918918918918919,0,1,0,0,-0.7764831469602406,-1.056455853387982,-0.39960647100849406,-0.728031162198238,1,2,1,1,1,1,1,1,1,1.889822365046136,1.1428571428571428,0,1,-0.874984074548163,5,5,5,5,4,4,5,6,3,3,4,1.4638501094227998,4.5,4.714285714285714,0,0.29192119002633504,0,0.8654275395220894,3,2,3,1,1,5,5,5,5,5,5,5,5,4,5,5,5,5,3,3,1.8593393604027366,2,0,5,0,4.6,0,4.4,0,4.666666666666667,0,2,1,1,1,1,2,1,1,1,1,1,2,2,3,1,2,1,2,1,1,1.0563093645728086,1.4,0,I lived with my mother and father an equal amount of time (joint custody),0,"White, Caucasian, Anglo, European American",0,30,0,1,NA,1,3,7,Speech Therapist,2,145,64,3,5,2,0,0,1,0,0,TRUE,TRUE,TRUE,TRUE,TRUE,3,0.48652187500707805,0.4307967741931638,0.4975562500022352,0.5972099999984105,0.4895483870986969,0.6297387096804957,1,1,1,0.9375,0.96875,0.96875,0.082,0.341,0.526,0.019,2.41,83.44588859164773,1910.617539403955,0.061,0.319,0.59,0.02,1.692,47.121036567828334,1876.6933941389027,0.079,0.311,0.472,0.015,2.013,84.70495157171149,1935.7626787247423,126.8421052631579,84.6,134.2,FALSE,460,1.3629629629629632,0,1,1,6,9,FALSE
532,2022-03-19T16:19:42Z,2022-03-19T16:46:45Z,1622,1,2022-03-19T16:46:46Z,0.800000011920929,Chrome,99.0.4844.51,Windows NT 6.3,1440,960,Very interesting and active study,1.5,1127,65,165,29,23,102,0.9234761291052912,-0.2920718140231832,-0.8949844158692787,-0.8524087969307974,-0.776990161738424,0.038426154833335266,2,3,1,1,3,1,1,2,2,2,2,4,3,3,1,2,2,2,2,1,1,0,1,1,5,4,2,0,3,2,4,3,3,1,3,3,2,1,2,2,3,2,1,4,3,3,3,2,3,4,5,1,1,2,1,0,0,2,3,2,3,4,3,2,3,4,3,2,4,3,3,4,3,3,3,4,4,3,3,2,3,2,2,3,3,4,4,3,1,4,3,3,2,1,2,1,2,3,0.8219949365267865,1.1338934190276817,3.375,0,2,0,2.3333333333333335,0,2.888888888888889,0,3.25,0,2.5,0,3.142857142857143,0,2,0,2.918918918918919,0,1,0,1,1.3509300226352343,0.8691096377187905,0.8511386348440838,0.8601241362814371,3,2,2,3,4,4,3,1,2,0.7559289460184544,3,0,1.5,0.39656768045461255,3,4,4,3,2,3,2,6,6,1,3,0.7559289460184544,6,3,0,-0.20799532428392437,0,-0.3678984708064509,3,4,4,3,3,3,2,4,3,3,2,3,4,3,3,2,3,4,3,2,0.7037315505489968,3.4,0,3,0,2.8,0,3,0,2.933333333333333,0,2,3,3,3,2,3,3,2,2,2,3,2,2,3,3,3,2,1,1,1,0.7326950970650465,2.3,0,"I lived with my mother, but not father, most of the time. & I lived with my father, but not mother, most of the time.",1,"Asian or Asian American (e.g., Chinese, Japanese, and others)",0,28,0,1,NA,1,3,6,IT,3,135,63,4,5,2,0,0,4,0,0,TRUE,TRUE,TRUE,TRUE,TRUE,2,0.8895625,0.8384193548387097,0.92596875,0.9649354838709677,0.8919375,0.9641935483870968,1,1,1,1,1,1,0.497,0.398,0.944,0.025,1.171,60.93161710029496,1844.4091539494984,0.225,0.534,0.741,0.028,1.734,25.279953805041636,1806.7678583018258,0.394,0.424,0.853,0.017,1.56,58.95973848129887,1840.6020525716076,46.839999999999996,61.92857142857142,91.76470588235294,TRUE,304,0.9007407407407407,1,1,0,0,3,FALSE
533,2022-03-19T16:23:39Z,2022-03-19T17:02:28Z,2329,1,2022-03-19T17:02:30Z,0.8999999761581421,Chrome,99.0.4844.51,Windows NT 10.0,1366,768,I do not have any feedback for this survey.,1.7786458333333333,581,164,713,300,193,193,-0.1991543463218632,0.2545819990888642,1.0960473123142718,2.489743654663142,2.7090079439248655,1.0611044082825185,1,1,1,1,2,1,1,2,1,2,3,1,1,3,2,3,1,1,3,2,1.0990426455975697,0,0,2,3,3,1.65,0,3,2,5,3,4,2,5,2,3,2,1,3,1,3,2,2,4,2,1,1,1,1,1,1,2,0,0,0,0,1,2,3,1,1,1,1,2,1,3,1,3,2,3,4,3,5,5,5,2,5,3,2,1,1,5,4,3,1,1,1,2,2,3,1,1,1,2,1,1,1,1.5528719880954165,1.2227992865708155,1.625,0,1.25,0,2.7333333333333334,0,1.4444444444444444,0,3.4166666666666665,0,2.6666666666666665,0,1.8571428571428572,0,1,0,2.324324324324324,0,1,0,0,-0.1711573378794666,0.020098686323842062,-0.31345356682763886,-0.1466774402518984,2,1,3,1,1,2,1,2,1,1.2149857925879117,1.5714285714285714,0,1.5,-0.4327781896031293,5,4,5,5,4,4,3,4,3,5,4,0.7559289460184544,3.5,4.285714285714286,0,0.5389419897748792,0,0.7836772930119874,3,2,3,2,3,4,5,5,5,2,5,4,4,5,3,2,5,4,1,2,1.5675276256394517,2.6,0,4.4,0,2.8,0,4,0,3.7333333333333334,0,2,1,1,2,3,2,3,2,2,1,4,2,1,2,1,2,1,2,1,2,0.9445132413883326,1.85,0,I lived with my mother and father an equal amount of time (joint custody),0,"White, Caucasian, Anglo, European American",0,27,0,1,NA,1,3,4,Unable to work,2,75,54,1,5,2,0,0,1,0,0,TRUE,TRUE,TRUE,TRUE,TRUE,5,0.6073548387096774,0.5807562500536442,0.6599718750268221,0.6282374999970197,0.599183870976971,0.7089999999671147,0.96875,1,1,1,1,0.90625,0.063,0.459,0.265,0.034,1.379,92.6315313423686,1978.7692566026512,0.155,0.354,0.661,0.365,1.869,75.13918070827468,1861.0333037465705,0.173,0.305,0.572,0.075,1.374,162.41546440888348,1986.581361475243,40.55882352941176,5.120547945205479,18.320000000000004,FALSE,232,0.6874074074074075,0,1,0,0,3,FALSE
534,2022-03-19T16:49:02Z,2022-03-19T17:11:14Z,1332,1,2022-03-19T17:11:19Z,0.8999999761581421,Chrome,99.0.4844.51,Windows NT 10.0,1707,960,NA,1.778125,523,116,395,88,66,82,-0.3184081330888503,-0.010462273935158787,-0.059332413164503835,-0.12478151042141572,0.10476230028229055,-0.18633829647417754,3,4,2,2,4,1,3,4,1,3,4,3,1,4,4,3,2,2,4,4,0.8645047258706176,0,0,2,3,2,2.9,0,2,1,2,1,2,2,2,2,2,1,3,2,3,2,2,2,3,4,2,1,2,2,2,1,2,0,0,0,0,1,2,1,1,1,1,2,1,1,1,1,2,1,2,1,2,1,2,1,1,2,3,1,1,2,3,1,1,3,2,1,1,2,2,1,1,1,1,2,2,2,1.653552005300781,1.245945806357946,2.25,0,1.75,0,1.9333333333333333,0,1.2222222222222223,0,1.4166666666666667,0,1.8333333333333333,0,1.7142857142857142,0,1,0,1.4594594594594594,0,1,0,0,-0.32687520905604234,-0.43390682243113493,-0.14114775846592847,-0.2875272904485317,1,2,3,2,1,2,2,3,1,1.2724180205607036,1.8571428571428572,0,2,-0.07350689166386981,5,5,5,5,3,3,5,8,6,6,3,1.5735915849388864,7,4.428571428571429,0,1.0417609922763496,0,1.1673417508189108,2,3,3,2,2,4,4,4,5,3,4,4,5,4,4,5,5,4,4,4,1.3345232785352157,2.4,0,4.2,0,4.2,0,4.2,0,4.2,0,1,3,4,4,4,4,3,4,3,3,2,3,2,4,2,3,3,4,3,3,1.0310954828418375,3.1,0,I lived with my mother and father an equal amount of time (joint custody),0,"White, Caucasian, Anglo, European American",0,29,0,1,NA,1,2,7,Graduate Student Researcher,2,150,72,2,5,2,0,0,1,0,0,TRUE,TRUE,TRUE,TRUE,TRUE,3,0.5020874999910593,0.4592874999977648,0.4796218750067055,0.587190000017484,0.5172193548371715,0.5440937499962747,1,1,1,0.967741935483871,0.96875,1,0.126,0.301,0.771,0.018,1.626,77.87070636564268,1861.2638045082265,0.063,0.354,0.623,0.028,1.91,49.83674026017546,1873.7075640919168,0.071,0.39,0.683,0.021,1.934,70.08097178711557,1894.969576239209,90.33333333333333,68.21428571428571,92.09523809523809,FALSE,426,1.2622222222222224,0,1,0,0,3,FALSE
535,2022-03-19T16:56:22Z,2022-03-19T17:15:19Z,1136,1,2022-03-19T17:15:22Z,0.8999999761581421,Chrome,99.0.4844.74,Windows NT 10.0,1920,1080,N/A,1.7777777777777777,571,84,265,69,42,52,-0.21971534404030926,-0.1871584559511741,-0.5316574581715505,-0.3591021620091827,-0.38737860875252683,-0.5234849734354468,2,3,2,2,4,1,2,4,2,3,4,2,2,2,3,4,2,1,2,4,0.6386663736585051,0,1,1,3,3,2.55,0,4,4,3,4,3,3,4,3,3,3,3,4,2,4,4,5,4,3,2,5,5,4,4,5,2,0,0,0,0,3,4,4,4,4,3,4,4,4,3,4,4,3,4,3,4,4,4,4,5,5,4,4,1,3,5,1,3,4,3,1,3,3,3,3,2,3,3,2,3,2,1.067539057664702,0.5163977794943222,4,0,2.5,0,3.4,0,3.7777777777777777,0,3.9166666666666665,0,3,0,2.857142857142857,0,2.6666666666666665,0,3.4324324324324325,0,3,0,0,2.0900416083606723,1.831892383272176,0.5560365609487006,1.1939644721104383,3,2,5,2,1,2,2,4,3,0.6900655593423543,2.4285714285714284,0,3.5,0.8384378281423601,3,3,3,2,1,1,2,3,1,2,2,1.1338934190276817,2,2.142857142857143,0,-1.0598998586158404,0,-1.3512006422316245,2,2,2,2,2,4,4,4,4,3,3,4,4,4,4,4,4,4,4,4,0.9611501047232549,2,0,3.8,0,3.8,0,4,0,3.8666666666666667,0,1,3,4,4,4,4,4,4,4,3,3,4,3,3,2,4,1,4,2,4,1.268027892769755,3.25,0,"I lived with my mother, but not father, most of the time.",0,"White, Caucasian, Anglo, European American",0,24,0,1,NA,1,2,4,Unemployed,1,300,72,1,5,2,0,0,1,0,0,TRUE,TRUE,TRUE,TRUE,TRUE,1,0.5555781250074506,0.49754516127032616,0.5704093749783933,0.6139935484086313,0.49705937498807906,0.6471032257810716,1,1,1,1,1,1,0.162,0.218,0.448,0.028,2.005,106.41290864544314,1892.2003473216691,0.131,0.312,0.713,0.164,1.19,39.32920113889041,1819.1927965045184,0.084,0.374,0.476,0.027,1.626,92.5390743690736,1880.102731744925,71.60714285714285,7.2560975609756095,60.22222222222222,FALSE,281,0.8325925925925926,0,1,0,0,3,FALSE
536,2022-03-19T17:07:43Z,2022-03-19T17:40:55Z,1991,1,2022-03-19T17:40:57Z,0.8999999761581421,Chrome,99.0.4844.74,Windows NT 6.1,1280,720,Thank you and goodluck in your research!! :),1.7777777777777777,929,117,534,103,69,92,0.5163683742800593,-0.004940518247158307,0.44569205803533835,0.0602084776741898,0.1662799139116427,-0.07395607082042113,2,3,2,2,3,2,2,3,1,3,2,2,2,2,2,3,2,1,2,3,0.5525062514530825,0,0,3,3,3,2.2,0,4,3,3,3,4,3,3,4,2,3,2,4,2,4,4,4,4,1,1,4,4,4,3,20,2,0,0,0,0,2,2,4,2,3,1,2,1,2,2,1,1,1,3,2,1,5,3,2,3,3,3,1,1,1,3,1,1,5,5,5,3,3,2,1,4,1,3,2,3,3,1.4811123163668898,0.7237468644557459,3.125,0,2.75,0,3.2,0,2.111111111111111,0,2.25,0,1.6666666666666667,0,3.4285714285714284,0,2,0,2.324324324324324,0,6,0,0,0.8026276593374314,0.8787463151842415,1.300277875437651,1.0895120953109463,3,3,4,2,2,3,3,3,3,0.5345224838248488,2.857142857142857,0,3,0.8938394652319717,3,3,3,2,1,1,2,6,3,2,2,1.1338934190276817,4.5,2.142857142857143,0,-0.6083253463380449,0,-1.0761513413825055,2,2,2,2,2,4,5,4,4,5,4,4,5,5,5,4,4,3,5,3,1.4474937289114918,2,0,3.8,0,4.8,0,4.2,0,4.266666666666667,0,1,1,1,1,1,2,2,1,1,2,3,3,1,1,2,3,1,3,2,2,0.9679060415469871,1.7,0,I lived with my mother and father an equal amount of time (joint custody),0,"White, Caucasian, Anglo, European American",0,27,0,1,NA,1,3,3,Business Owner,4,225,71,4,5,2,0,0,1,0,0,TRUE,TRUE,TRUE,TRUE,TRUE,6,0.5951250000000146,0.4881968749999796,0.5482343750000291,0.6487399999999751,0.587106249999968,0.7064966666667412,1,1,1,0.9375,1,0.967741935483871,0.097,0.342,0.51,0.005,1.283,113.83531453360062,1941.8168887097163,0.092,0.266,0.397,0.026,2.116,52.731285047587335,1835.2547728784057,0.079,0.323,0.297,0.017,2.071,133.35489851803368,1981.630421394941,256.59999999999997,81.38461538461539,121.82352941176471,FALSE,212,0.6281481481481481,0,1,0,0,3,FALSE
537,2022-03-19T18:17:09Z,2022-03-19T18:34:44Z,1055,1,2022-03-19T18:34:46Z,1,Firefox,98.0,Windows NT 10.0,1920,1080,N/A,1.7777777777777777,495,64,232,117,41,63,-0.37597892670049926,-0.2975935697111837,-0.6515553542118008,0.23286579989675493,-0.40788447996231086,-0.3998645252163147,3,2,2,2,2,1,1,3,1,3,4,1,1,1,3,2,1,1,3,3,0.7326950970650465,0,0,2,2,2,2,0,2,1,1,2,1,1,1,1,1,1,1,2,2,3,2,3,2,1,1,1,1,1,1,0,2,0,0,0,0,1,2,1,1,2,1,1,2,2,1,2,1,1,2,2,2,1,1,1,1,4,1,1,1,1,3,3,1,1,1,1,2,1,3,1,1,1,3,2,1,1,1.6589913357978252,1.6417180315870614,1.375,0,1.75,0,1.4666666666666666,0,1.4444444444444444,0,1.5833333333333333,0,1.6666666666666667,0,1.4285714285714286,0,1,0,1.4864864864864864,0,0,0,0,-0.8773707818070364,-1.007879132286626,-0.3605105619019602,-0.6841948470942931,1,1,2,1,1,1,1,1,2,1.7320508075688772,1.1428571428571428,0,1.5,-0.6815819506204519,5,5,5,4,1,1,4,6,6,2,2,1.889822365046136,6,3.5714285714285716,0,-0.33738063897136766,0,-0.1370950084662627,3,2,2,3,2,3,3,4,5,2,1,4,4,3,5,5,4,5,4,5,1.4375905768565218,2.4,0,3.4,0,3.6,0,4.4,0,3.8,0,2,1,1,2,2,2,4,4,1,1,1,3,1,1,1,3,1,2,3,1,0.8750939799154206,1.85,0,I lived with my mother and father an equal amount of time (joint custody),0,"Asian or Asian American (e.g., Chinese, Japanese, and others)",0,19,0,1,NA,1,2,4,Student,2,220,68,2,5,2,0,0,1,0,0,TRUE,TRUE,TRUE,TRUE,TRUE,3,0.43884375,0.4131290322580645,0.43240625,0.5497333333333333,0.47103125,0.49789655172413794,1,0.96875,1,0.9375,1,0.9354838709677419,0.06,0.325,0.617,0.022,1.909,138.59177454261834,1991.5407696619222,0.053,0.319,0.534,0.029,1.84,137.75343186906272,1961.2067389296938,0.072,0.322,0.624,0.016,1.907,89.19182196911254,1935.9071442039556,86.77272727272728,63.44827586206897,119.1875,FALSE,272,0.8059259259259259,0,1,0,0,3,FALSE
538,2022-03-19T18:12:03Z,2022-03-19T18:38:39Z,1596,1,2022-03-19T18:38:41Z,1,Firefox,98.0,Windows NT 10.0,1536,864,NA,1.7777777777777777,572,108,520,171,56,97,-0.21765924426846464,-0.05463631943916262,0.3948262839576564,0.8988297570409348,-0.10029641181555002,-0.017764957993542937,1,2,1,1,1,1,1,2,1,2,1,1,1,2,2,2,1,1,2,2,1.1964860832322377,0,1,1,4,4,1.4,0,2,2,2,1,2,1,2,1,2,1,1,2,1,2,3,2,2,1,1,1,1,1,1,0,1,0,0,1,0,1,5,4,3,5,3,4,3,4,1,3,4,2,3,1,3,2,2,1,1,1,3,1,5,1,4,2,2,1,1,1,3,4,2,1,1,1,1,1,1,1,1.20559257357262,1.4540583599999397,1.25,0,1,0,1.6666666666666667,0,3.5555555555555554,0,2,0,2.6666666666666665,0,2,0,1,0,2.4054054054054053,0,0,0,0,-0.3619665603071019,-0.5739336460107513,-0.6189692744445258,-0.5964514602276385,1,1,4,2,1,1,1,2,2,1.4638501094227998,1.5714285714285714,0,2,-0.23937606567541822,5,5,4,4,1,1,4,4,5,3,2,1.7728105208558367,4.5,3.4285714285714284,0,-0.39450004400821376,0,-0.2492885144406229,2,2,3,2,3,3,3,3,4,4,2,2,5,4,2,2,2,3,3,1,1.0690449676496976,2.4,0,2.4,0,3.4,0,2.8,0,2.8666666666666667,0,1,2,3,2,2,3,2,3,1,1,4,2,1,2,1,3,1,2,1,2,0.8870412083230169,1.95,0,"I lived with my mother, but not father, most of the time.",0,"White, Caucasian, Anglo, European American",0,29,0,1,NA,1,2,7,Staff Accountant,2,205,69,2,5,2,0,0,0,0,0,TRUE,TRUE,TRUE,TRUE,TRUE,1,0.5475,0.478375,0.5166875,0.6165333333333334,0.50375,0.5646,1,1,1,0.967741935483871,1,0.967741935483871,0.064,0.378,0.49,0.031,2.01,32.292929045512246,1859.0655945617405,0.07,0.334,0.535,0.04,1.925,141.51735184229008,1924.1978935609102,0.068,0.41,0.491,0.025,1.855,110.85223042845841,1940.82215890001,64.83870967741935,48.125,74.19999999999999,FALSE,390,1.1555555555555557,0,1,0,0,3,FALSE
539,2022-03-19T18:22:00Z,2022-03-19T18:52:46Z,1845,1,2022-03-19T18:52:47Z,1,Edge,99.0.1150.46,Windows NT 10.0,1366,768,NA,1.7786458333333333,603,147,742,133,59,92,-0.1539201513412819,0.16071215239285608,1.201412130046613,0.43018845386540083,-0.03877879818619785,-0.07395607082042113,2,3,1,1,3,1,2,3,1,3,3,2,1,1,2,3,2,1,3,3,0.6386663736585051,0,0,2,3,3,2.05,0,4,2,3,3,5,1,4,1,3,1,1,2,2,3,5,2,1,1,1,1,1,1,1,0,2,0,0,0,0,2,5,4,3,5,2,4,4,3,1,3,1,1,4,3,4,4,3,2,2,3,3,1,1,1,4,1,1,1,1,1,2,1,1,1,1,1,1,1,1,1,1.1176981923798792,1.2983506020002016,1.125,0,1,0,2.6666666666666665,0,3.5555555555555554,0,2.5833333333333335,0,1.8333333333333333,0,1.1428571428571428,0,1,0,2.2972972972972974,0,0,0,0,-0.5132980125772953,-0.2391082708080874,-0.6189692744445258,-0.4290387726263066,1,1,4,1,1,1,1,1,1,1.4960264830861913,1.4285714285714286,0,1,-0.7091149005366146,4,4,4,3,2,2,4,3,3,2,2,1,3,3.2857142857142856,0,-0.8792700537047221,0,-0.62195951996656,2,1,1,1,1,5,3,2,5,1,5,4,5,3,4,5,4,5,2,3,1.3345232785352157,1.2,0,4.6,0,3.2,0,3.4,0,3.7333333333333334,0,1,2,1,2,2,2,1,2,2,2,2,2,2,1,1,2,1,2,1,1,0.7677718959499145,1.6,0,"I lived with my mother, but not father, most of the time.",0,"White, Caucasian, Anglo, European American",0,23,0,1,NA,1,1,2,unemployed,1,150,68,3,5,2,0,0,1,0,0,TRUE,TRUE,TRUE,TRUE,TRUE,6,0.566203125,0.6702843750026077,0.6046062500011176,0.6333064516071351,0.7598645161255714,0.7103419354769491,1,1,1,1,0.96875,1,0.072,0.428,0.437,0.019,1.88,103.82253847223575,1888.0215389841355,0.087,0.343,0.222,0.163,1.561,229.53243168430015,2053.5059651807055,0.172,0.255,0.581,0.016,1.6,72.34140685278759,1860.4363092273531,98.94736842105263,9.576687116564417,100,FALSE,344,1.0192592592592593,0,1,0,0,3,FALSE
540,2022-03-19T18:48:48Z,2022-03-19T19:12:55Z,1446,1,2022-03-19T19:13:01Z,0.8999999761581421,Chrome,99.0.4844.51,Windows NT 10.0,1440,900,"Interesting study, enjoyed it!",1.6,559,106,438,94,75,94,-0.2443885413024445,-0.06567983081516358,0.09689817864551929,-0.05078551518317351,0.28931514117034707,-0.05147962568966986,2,3,1,1,2,1,1,3,1,2,3,1,2,2,2,1,1,1,3,3,0.9119095061289915,0,0,4,4,3,1.8,0,3,3,4,2,3,3,4,4,3,3,3,3,2,3,2,2,2,1,1,2,2,3,3,0,2,0,0,0,0,2,4,1,3,4,2,4,3,3,2,1,2,1,3,2,1,2,2,2,1,3,1,1,1,1,3,1,2,1,1,1,3,2,3,1,1,1,2,2,2,1,1.292156983369153,0.6399404734221844,2,0,1.75,0,3,0,2.888888888888889,0,1.8333333333333333,0,1.3333333333333333,0,1.8571428571428572,0,1,0,1.945945945945946,0,0,0,0,-0.1733505473326576,0.13505048180458043,-0.3605105619019602,-0.11273004004868988,1,2,3,2,1,2,2,3,4,1.2724180205607036,1.8571428571428572,0,3.5,0.5066994801192636,4,4,5,3,3,2,4,3,4,5,3,1.1126972805283737,3.5,3.5714285714285716,0,0.1957313727576048,0,0.18761792841029293,3,2,2,3,3,3,4,3,4,2,4,3,1,3,3,4,3,4,3,2,0.8837151016885368,2.6,0,3.4,0,2.8,0,3,0,3.066666666666667,0,1,2,2,2,2,2,3,3,3,2,2,4,3,3,2,4,1,3,2,3,0.7451598203705946,2.45,0,I lived with my mother and father an equal amount of time (joint custody),0,"White, Caucasian, Anglo, European American",0,27,0,1,NA,1,2,4,Winemaker,5,187,74,2,5,2,0,0,1,0,0,TRUE,TRUE,TRUE,TRUE,TRUE,1,0.8797225806463149,0.4768468749970198,0.5865093749985099,0.8305870967718862,0.5515620689659283,0.6936838709731256,1,1,1,0.96875,0.9354838709677419,1,0.136,0.362,0.605,0.013,1.543,62.08982199075193,1845.7443319896493,0.06,0.365,0.532,0.026,2.095,99.36791089666323,1969.8486209356681,0.094,0.413,0.212,0.125,1.549,157.67478809807076,1985.0215045115467,118.6923076923077,80.5769230769231,12.392,FALSE,312,0.9244444444444444,0,1,0,0,3,FALSE
541,2022-03-19T19:15:22Z,2022-03-19T19:38:53Z,1411,1,2022-03-19T19:38:55Z,0.8999999761581421,Chrome,99.0.4844.74,Windows NT 10.0,1920,1080,Interesting study. The game was kind of fun.,1.7777777777777777,573,112,310,81,62,100,-0.21560314449662005,-0.0325492966871607,-0.3681603272075728,-0.2111101715326983,0.02273881544315432,0.015949709702583987,2,2,3,2,3,1,1,2,1,3,3,1,3,1,3,2,1,1,3,3,0.8255779474818965,0,1,4,3,2,2.05,0,2,1,2,1,2,2,1,2,1,1,2,1,1,1,2,2,2,1,1,2,2,2,1,1,2,0,0,0,0,1,1,3,1,2,1,1,1,1,2,1,1,1,1,2,1,2,1,1,2,2,1,5,1,1,1,1,1,5,5,1,1,2,2,2,1,1,1,1,2,2,1.8025674049114637,1.6676187756655838,1.625,0,1.5,0,1.4666666666666666,0,1.3333333333333333,0,1.4166666666666667,0,1.6666666666666667,0,2.4285714285714284,0,1.3333333333333333,0,1.6216216216216217,0,1,0,0,-0.6273449041432382,-0.8397289438588569,-0.22730066264678367,-0.5335148032528203,3,2,3,3,2,2,2,3,2,0.5345224838248488,2.4285714285714284,0,2.5,0.4516335802869379,5,5,5,5,3,3,5,6,6,5,3,1.5735915849388864,6,4.428571428571429,0,0.6473058850354002,0,0.9270832807034747,2,2,3,3,2,3,5,3,4,3,4,4,3,4,4,4,4,4,2,3,0.9611501047232549,2.4,0,3.8,0,3.4,0,3.6,0,3.6,0,1,2,1,2,1,1,2,2,1,1,2,1,1,1,1,2,1,2,2,1,0.9233805168766387,1.4,0,I lived with my mother and father an equal amount of time (joint custody),0,"Asian or Asian American (e.g., Chinese, Japanese, and others)",0,20,0,1,NA,1,3,4,Student,6,134,67,3,5,2,0,0,1,0,0,TRUE,TRUE,TRUE,TRUE,TRUE,3,0.6043187499986962,0.5949781249994412,0.5823781249988824,0.6891218749997206,0.6611290322578242,0.6601531250001863,1,1,1,1,1,1,0.176,0.328,0.738,0.009,1.227,15.10961272647832,1797.4966219037155,0.15,0.361,0.625,0.018,1.423,40.60119824821155,1822.0162913587906,0.248,0.317,0.851,0.007,1.002,35.98140982212031,1820.9593403125625,136.33333333333334,79.05555555555556,143.14285714285714,FALSE,280,0.8296296296296296,0,1,0,3,6,FALSE
543,2022-03-19T20:09:04Z,2022-03-19T20:31:54Z,1370,1,2022-03-19T20:31:56Z,0.8999999761581421,Chrome,99.0.4844.74,Windows NT 10.0,1536,864,NA,1.7777777777777777,549,74,405,94,38,66,-0.2649495390208906,-0.2423760128311789,-0.022999717394731015,-0.05078551518317351,-0.46940209359166307,-0.3661498575201878,2,2,2,2,3,1,2,3,1,3,4,4,3,2,3,3,4,1,4,3,0.9119095061289915,0,1,1,3,3,2.6,0,4,1,2,3,4,2,4,3,2,2,2,4,2,4,3,2,5,1,1,3,5,3,1,1,2,0,0,0,0,1,1,3,2,2,1,1,1,1,3,1,1,2,3,1,1,3,1,1,1,3,5,1,1,1,1,1,1,1,1,1,4,5,3,1,1,1,1,1,1,1,1.6934780387911346,0.9154754164341269,2.625,0,1,0,2.8,0,1.4444444444444444,0,1.75,0,1.6666666666666667,0,2.2857142857142856,0,1,0,1.7027027027027026,0,1,0,0,0.07448212087794913,0.21440557072926442,-0.39960647100849406,-0.09260045013961482,1,1,1,1,1,1,1,3,1,1.9518001458970664,1,0,2,-0.571114413698515,5,5,5,5,2,2,5,6,3,4,3,1.8126539343499315,4.5,4.142857142857143,0,0.1625358753388918,0,0.4770095999368606,2,2,2,2,2,4,4,4,4,3,5,3,5,4,4,4,4,5,3,5,1.1872336794093274,2,0,4.2,0,3.8,0,4.2,0,4.066666666666666,0,1,1,1,2,3,1,2,3,1,1,2,2,2,1,1,3,1,1,1,2,0.7539370349250519,1.6,0,I lived with my mother and father an equal amount of time (joint custody),0,"White, Caucasian, Anglo, European American",0,30,0,1,NA,1,2,6,Self Employed,3,225,73,1,5,2,0,0,1,0,0,TRUE,TRUE,TRUE,TRUE,TRUE,6,0.6236967741866265,0.5891562499925495,0.573337500013411,0.6052281250022352,0.617318750012666,0.7242366666754086,1,1,1,1,1,0.967741935483871,0.084,0.364,0.428,0.012,1.934,47.75323788288868,1875.5214629381992,0.06,0.411,0.371,0.024,1.44,180.74465696410226,1965.8565969219887,0.104,0.401,0.503,0.048,0.565,30.30475780902881,1810.0702486997602,161.16666666666666,60,11.770833333333332,FALSE,342,1.0133333333333332,0,1,0,0,3,FALSE
544,2022-03-19T20:24:25Z,2022-03-19T20:39:22Z,896,1,2022-03-19T20:39:22Z,1,Opera,84.0.4316.31,Windows NT 10.0,1920,1080,n/a,1.7777777777777777,476,48,215,39,22,57,-0.41504482236554674,-0.3859416607191914,-0.7133209370204145,-0.7290821382003937,-0.7974960329482079,-0.46729386060856853,2,2,1,1,1,1,1,2,1,2,2,1,1,1,1,1,1,1,2,1,1.2814465510343749,0,1,2,3,3,1.3,0,1,1,1,1,1,1,1,1,1,1,1,1,1,1,1,1,1,1,1,1,1,1,1,4,1,2,0,2,0,1,1,3,1,1,1,4,1,1,1,1,1,1,3,3,1,1,1,1,1,1,1,1,1,1,3,1,2,2,3,1,1,1,1,1,1,1,2,1,1,1,1.757438075321173,2.065591117977289,1,0,1.25,0,1,0,1.5555555555555556,0,1.3333333333333333,0,1.3333333333333333,0,1.5714285714285714,0,1,0,1.4054054054054055,0,2,0,0,-1.17345405798785,-1.4107512504085977,-0.09409076339160714,-0.7524210069001024,1,1,3,1,1,1,2,3,3,1.5275252316519468,1.4285714285714286,0,3,0.06449359517422987,4,4,4,4,2,2,3,7,4,5,3,0.9511897312113419,5.5,3.2857142857142856,0,0.5569909825798411,0,0.25285201860823364,1,1,1,1,1,5,5,5,5,5,5,5,5,5,4,5,5,5,5,3,1.9444671200491874,1,0,5,0,5,0,4.4,0,4.8,0,1,1,1,1,1,1,1,1,1,1,1,1,1,1,1,1,1,1,1,1,1.231174022502185,1,0,I lived with my mother and father an equal amount of time (joint custody),0,"Asian or Asian American (e.g., Chinese, Japanese, and others)",0,26,0,1,NA,1,3,6,speech language pathologist assistant,3,160,69,3,5,2,0,0,1,0,0,TRUE,TRUE,TRUE,TRUE,TRUE,6,0.5102093750001514,0.45293124999979045,0.490971875000163,0.5979437499998022,0.5315833333333333,0.610209375000326,1,1,1,1,0.9375,1,0.197,0.262,0.852,0.005,1.003,38.81379538326164,1822.5859200960113,0.064,0.338,0.607,0.02,2,96.85516911217009,1945.4068239102478,0.112,0.326,0.593,0.011,1.26,31.996905335251586,1815.346653932249,200.59999999999997,100,114.54545454545455,FALSE,304,0.9007407407407407,1,1,0,3,6,FALSE
545,2022-03-19T20:15:43Z,2022-03-19T20:40:38Z,1495,1,2022-03-19T20:40:40Z,0.8999999761581421,Chrome,99.0.4844.74,Windows NT 10.0,1920,1080,NA,1.7777777777777777,606,125,468,84,58,99,-0.1477518520257481,0.03923352725684553,0.20589626595483773,-0.1741121739135772,-0.05928466939598191,0.004711487137208345,2,1,3,1,1,1,1,1,1,1,1,1,2,1,2,1,1,1,1,1,1.394538218230416,0,1,1,5,4,1.25,0,2,3,2,2,1,4,4,1,3,2,1,4,1,3,5,3,1,1,1,2,1,2,1,2,2,0,0,0,0,1,5,5,1,1,1,1,1,2,1,3,5,1,4,3,1,4,2,5,5,4,1,1,1,1,3,2,3,2,2,2,2,3,3,2,2,1,1,2,2,3,1.5625112612206804,1.162919151265879,1.5,0,2,0,2.533333333333333,0,2,0,3.1666666666666665,0,1.5,0,2.4285714285714284,0,1.6666666666666667,0,2.3513513513513513,0,1,0,0,-0.2347604120220116,-0.10999645945974755,-0.05499485428507328,-0.08249565687241042,1,1,5,1,1,1,1,3,6,1.5118578920369088,1.5714285714285714,0,4.5,0.7276345539631375,1,2,2,2,1,1,1,1,1,2,2,1.4142135623730951,1,1.4285714285714286,0,-1.2405296635269585,0,-1.8482337387746575,1,1,1,1,2,5,5,5,5,5,5,5,5,5,5,5,5,5,5,3,2,1.2,0,5,0,5,0,4.6,0,4.866666666666666,0,1,1,1,1,3,1,1,1,2,1,4,1,1,1,1,1,1,1,1,1,1.3337718577107003,1.3,0,"I lived with my extended family on mother's side (grandparents, aunts ,uncles, cousins)",0,Black or African American,0,22,0,1,NA,1,3,4,Data Analyst,3,192,72,4,5,2,0,0,1,0,0,TRUE,TRUE,TRUE,TRUE,TRUE,5,0.5916312500014901,0.4726843749955296,0.5759593749959022,0.6163843750022352,0.5287290322588336,0.5966967741962402,1,1,1,1,1,1,0.112,0.392,0.603,0.035,1.284,36.13299847241323,1818.8045627586366,0.144,0.288,0.769,0.038,1.991,26.87711289986779,1808.9003132096984,0.216,0.318,0.816,0.04,1.586,27.728607307663626,1808.2353624830823,36.68571428571428,52.39473684210527,39.65,FALSE,320,0.9481481481481481,0,1,0,0,3,FALSE
546,2022-03-19T20:15:11Z,2022-03-19T20:46:29Z,1877,1,2022-03-19T20:46:31Z,0.8999999761581421,Firefox,98.0,Macintosh,1920,1080,I do not.,1.7777777777777777,562,160,763,100,89,85,-0.2382202419869107,0.2324949763368623,1.2777107911631358,0.023210480055068695,0.5763973381073239,-0.1526236287780506,2,3,2,1,3,1,2,3,1,3,4,1,1,3,2,3,2,1,3,4,0.7163503994113789,0,0,2,3,3,2.25,0,2,1,2,2,2,2,1,3,5,1,3,3,2,2,1,2,5,3,1,2,3,2,2,2,2,0,0,0,0,1,3,5,2,2,2,3,3,3,2,1,4,1,4,3,1,5,5,4,5,5,5,1,4,1,4,3,1,5,1,1,2,3,1,2,4,2,2,2,2,1,1.4977460543240444,1.3451854182690985,2.5,0,1.75,0,2.1333333333333333,0,2.6666666666666665,0,3.3333333333333335,0,3,0,2,0,2.6666666666666665,0,2.810810810810811,0,1,0,0,0.7127060717565914,0.3525640588819057,-0.14114775846592847,0.1057081502079886,1,1,1,1,1,1,1,1,2,1.9518001458970664,1,0,1.5,-0.7645165376262261,3,5,5,5,2,2,1,5,4,3,2,1.4638501094227998,4.5,3.2857142857142856,0,-0.39450004400821376,0,-0.32669118968129995,2,2,1,1,2,5,5,4,5,3,5,5,4,4,4,5,5,5,3,3,1.5796322658258457,1.6,0,5,0,4,0,4,0,4.333333333333333,0,2,4,1,4,1,3,2,4,3,2,1,4,2,3,1,4,1,2,2,2,0.8944271909999159,2.4,0,I lived with my mother and father an equal amount of time (joint custody),0,"White, Caucasian, Anglo, European American",0,27,0,2,NA,1,2,3,Unemployed,2,125,68,1,5,2,0,1,2,0,1,TRUE,TRUE,TRUE,TRUE,TRUE,1,0.46175,0.45440625,0.47190625,0.5356129032258065,0.5091875,0.5207666666666667,1,1,1,1,1,0.9375,0.04,0.408,0.652,0.029,1.806,127.93400291820198,1982.4767315823683,0.056,0.374,0.766,0.048,2.007,57.04609685208234,1841.1138309322364,0.064,0.392,0.889,0.016,1.367,76.60247197881287,1867.8214447877776,62.275862068965516,41.8125,85.4375,FALSE,354,1.0488888888888888,0,1,0,0,3,FALSE
548,2022-03-19T20:58:31Z,2022-03-19T21:46:46Z,2894,1,2022-03-19T21:46:47Z,1,Chrome,98.0.4758.80,Macintosh,1280,800,no,1.6,517,87,1939,93,76,106,-0.3307447317199179,-0.17059318888717268,5.550435813688419,-0.06311818105621388,0.3098210123801311,0.08337904509483783,2,2,1,1,2,1,1,3,1,2,2,1,1,1,2,2,1,1,3,2,0.9679060415469871,0,1,4,4,4,1.6,0,3,2,3,3,2,2,4,2,3,2,2,3,2,3,3,2,3,1,1,2,2,2,2,0,1,1,0,1,0,2,3,3,2,3,3,3,3,3,2,2,3,1,3,1,3,3,3,3,3,4,4,1,1,1,4,2,1,1,1,1,2,2,2,2,2,2,2,1,2,2,1.0433544884595018,0.6324555320336759,1.875,0,1.75,0,2.6,0,2.7777777777777777,0,2.5833333333333335,0,2.1666666666666665,0,1.4285714285714286,0,2,0,2.2972972972972974,0,0,0,0,-0.026405513968846484,0.05923539684679709,-0.3605105619019602,-0.15063758252758155,2,2,4,3,1,2,2,3,4,0.9511897312113419,2.2857142857142856,0,3.5,0.755503241136586,3,4,4,3,2,2,3,6,6,3,2,0.816496580927726,6,3,0,-0.12355533664153649,0,-0.3164669596531828,2,3,3,3,3,4,4,4,4,3,3,4,3,3,3,3,3,4,3,3,0.6399404734221844,2.8,0,3.6,0,3.2,0,3.4,0,3.4,0,1,2,3,2,2,3,2,2,2,2,3,2,1,3,2,2,3,3,3,2,0.6863327411532597,2.25,0,I lived with my mother and father an equal amount of time (joint custody),0,"White, Caucasian, Anglo, European American",0,26,0,1,NA,1,2,4,mental health tech,2,210,70,4,5,2,1,1,0,0,2,TRUE,TRUE,TRUE,TRUE,TRUE,6,0.6786166666676601,0.5907499999962748,0.5786875000018626,0.7101843750001863,0.6521281249988824,0.6729500000011176,0.967741935483871,1,1,1,1,1,0.26,0.265,0.846,0.018,1.908,133.24745836646264,1923.1296663848775,0.076,0.461,0.631,0.026,1.817,64.4221356259113,1846.0392178424204,0.067,0.489,0.38,0.051,1.551,77.77738968569533,1903.831525040215,106,69.88461538461539,30.411764705882355,TRUE,334,0.9896296296296296,0,1,0,0,3,FALSE
550,2022-03-19T21:56:41Z,2022-03-19T22:20:32Z,1430,1,2022-03-19T22:20:34Z,1,Firefox,98.0,Windows NT 10.0,1920,1080,NA,1.7777777777777777,498,138,471,88,78,61,-0.3698106273849654,0.11101635120085177,0.21679607468576959,-0.12478151042141572,0.3508327547996992,-0.42234097034706597,3,3,2,1,3,1,2,3,1,3,4,2,2,4,3,3,2,1,2,3,0.7181848464596079,0,1,2,2,2,2.4,0,1,2,2,1,2,1,1,2,1,1,2,1,3,1,1,1,2,1,1,1,3,1,1,1,2,0,0,0,0,1,1,4,1,1,1,2,1,1,1,1,1,1,2,2,1,4,2,1,2,4,2,2,1,1,2,2,1,2,1,1,2,2,2,1,1,1,2,1,2,1,1.643989873053573,1.6987390281365427,1.375,0,1.5,0,1.4666666666666666,0,1.4444444444444444,0,1.8333333333333333,0,1.6666666666666667,0,1.5714285714285714,0,1,0,1.5945945945945945,0,1,0,0,-0.8071880793049175,-0.9606790793946209,-0.22730066264678367,-0.5939898710207023,1,1,3,1,1,1,1,1,2,1.5735915849388864,1.2857142857142858,0,1.5,-0.5986473636146776,5,5,5,4,2,3,4,4,3,2,3,1.3801311186847085,3.5,4,0,-0.44574453423188864,0,0.029109704804958614,2,1,3,4,2,4,4,4,5,3,4,3,3,4,4,5,4,4,4,3,1.082325538564332,2.4,0,3.8,0,3.8,0,4,0,3.8666666666666667,0,2,2,1,4,4,3,4,4,4,3,4,3,1,1,2,3,2,2,2,4,1.1367080817685316,2.75,0,I lived with my mother and father an equal amount of time (joint custody),0,"White, Caucasian, Anglo, European American",0,22,0,1,NA,1,3,4,Student,2,160,63,1,5,2,0,0,1,0,0,TRUE,TRUE,TRUE,TRUE,TRUE,6,0.39728125000000003,0.36478125,0.39825,0.46462068965517245,0.44064285714285717,0.4979642857142857,1,1,1,0.90625,0.875,0.9032258064516129,0.055,0.307,0.617,0.009,1.302,81.03537387704131,1943.104611628686,0.053,0.304,0.839,0.023,1.83,33.67262844814081,1892.7131507573224,0.055,0.314,0.741,0.022,1.892,73.11191490394062,1926.812168586925,144.66666666666669,79.56521739130436,86,FALSE,312,0.9244444444444444,0,1,0,0,3,FALSE
551,2022-03-19T23:54:47Z,2022-03-20T00:22:50Z,1683,1,2022-03-20T00:22:52Z,1,Opera,84.0.4316.36,Windows NT 10.0,1920,1080,"I had a difficult family dynamic growing up so at times I was not sure what to answer. Like what house I was referring to, since I did a week with one and a week with the other.",1.7777777777777777,787,71,405,72,83,88,0.22440220667812544,-0.25894127989518034,-0.022999717394731015,-0.3221041643900616,0.4533621108486195,-0.1189089610819237,2,2,2,1,2,1,1,2,1,1,2,2,1,1,2,2,1,1,2,2,1.0399898784932577,0,1,2,3,3,1.55,0,3,3,3,3,3,3,4,2,2,2,2,4,1,4,4,4,2,3,1,1,4,4,3,5,2,0,0,0,0,2,4,2,3,3,2,4,3,3,2,1,5,1,3,2,1,5,5,5,5,5,3,1,4,4,3,1,2,3,2,2,3,3,3,2,2,4,2,3,1,4,1.2657417201396586,0.6172133998483676,2.75,0,2.5,0,2.8666666666666667,0,2.888888888888889,0,3.3333333333333335,0,2.6666666666666665,0,2.5714285714285716,0,2.6666666666666665,0,2.918918918918919,0,3,0,0,0.9451862737948602,0.8290879262041103,0.5560365609487006,0.6925622435764054,2,1,4,1,1,1,1,8,8,1.1338934190276817,1.5714285714285714,0,8,2.081449421457115,5,5,5,5,2,3,5,9,9,3,3,1.7043362064926932,9,4.285714285714286,0,0.7615446951090925,0,0.9192622669301631,2,4,3,4,3,4,5,4,5,3,5,4,3,3,4,4,5,4,4,4,1.3020130933435712,3.2,0,4.4,0,3.8,0,4,0,4.066666666666666,0,1,2,2,2,2,1,3,2,2,1,3,2,3,3,1,2,1,2,1,4,0.9514531821875089,2,0,I lived with my mother and father an equal amount of time (joint custody),0,"White, Caucasian, Anglo, European American",0,25,0,1,NA,1,1,3,Unemployed/Disabled,1,370,73,3,5,2,0,0,1,0,0,TRUE,TRUE,TRUE,TRUE,TRUE,3,0.5713249999769032,0.5600218750201166,0.60222666665713,0.6814999999701977,0.6487666666944821,0.6500218749940395,1,1,0.967741935483871,1,0.9375,1,0.081,0.386,0.386,0.04,1.993,120.49968841160552,1949.192953193606,0.073,0.356,0.396,0.008,1.36,80.66068754468455,1926.2237182036704,0.2,0.239,0.601,0.018,1.959,18.67453901535093,1801.1706458457652,49.825,170,108.83333333333334,FALSE,326,0.965925925925926,0,1,0,0,3,FALSE
552,2022-03-20T00:06:23Z,2022-03-20T00:29:53Z,1409,1,2022-03-20T00:29:55Z,0.8999999761581421,Chrome,99.0.4844.74,Windows NT 10.0,1920,1080,N/A,1.7777777777777777,516,180,365,108,59,89,-0.33280083149176254,0.34293009009687186,-0.16833050047382228,0.12187180703939164,-0.03877879818619785,-0.10767073851654806,3,3,2,2,3,3,3,3,1,3,3,3,1,2,3,3,3,2,3,3,0.5525062514530825,0,1,1,2,3,2.6,0,3,2,4,2,2,2,3,2,4,2,1,2,2,2,4,3,2,1,1,3,3,4,2,0,2,0,0,0,0,2,5,4,5,5,2,5,5,5,2,2,1,1,4,1,2,4,1,1,3,3,2,1,1,1,1,1,1,1,1,1,4,4,3,1,1,1,1,1,1,1,1.2136609794225788,1.0600988273786194,2.375,0,1,0,2.466666666666667,0,4.222222222222222,0,2.0833333333333335,0,1.1666666666666667,0,2.142857142857143,0,1,0,2.3783783783783785,0,0,0,0,0.35082651198004217,0.2547222825745193,-0.6189692744445258,-0.18212349593500324,1,2,2,1,1,1,1,1,1,1.6761634196950514,1.2857142857142858,0,1,-0.7920494875423887,4,4,4,4,2,2,3,2,4,2,2,0.9511897312113419,3,3.2857142857142856,0,-0.8792700537047221,0,-0.62195951996656,3,4,3,2,3,2,4,2,3,4,2,2,3,4,4,4,3,2,4,3,0.7432233529572065,3,0,2.2,0,3.8,0,3.2,0,3.066666666666667,0,3,2,4,4,4,4,1,3,4,2,4,3,1,3,1,3,1,4,1,3,1.234376040972246,2.75,0,I lived with my mother and father an equal amount of time (joint custody),0,"White, Caucasian, Anglo, European American",0,22,0,1,NA,1,2,5,Freelancer,2,180,70,2,5,2,0,0,0,0,0,TRUE,TRUE,TRUE,TRUE,TRUE,1,0.6276593749979511,0.5402562499982305,0.5847562500010245,0.7441531250011176,0.6533187499996275,0.734265625001397,1,1,1,1,1,1,0.102,0.407,0.634,0.007,1.352,69.59098990825025,1855.7170001950642,0.09,0.414,0.698,0.015,1.663,55.837323606404254,1837.399269214088,0.116,0.412,0.535,0.014,1.719,39.14089056089761,1823.5823360691065,193.14285714285714,110.86666666666667,122.78571428571429,FALSE,304,0.9007407407407407,1,0,0,0,3,FALSE
553,2022-03-20T03:27:08Z,2022-03-20T03:51:01Z,1433,1,2022-03-20T03:51:03Z,0.800000011920929,Chrome,99.0.4844.74,Windows NT 6.3,1366,768,NA,1.7786458333333333,547,107,381,91,60,96,-0.26906173856457977,-0.0601580751271631,-0.11019818724218579,-0.08778351280229461,-0.018272926976413795,-0.029003180558918575,3,4,2,2,3,2,3,4,2,3,3,3,2,3,3,4,2,4,3,3,0.7181848464596079,0,1,1,3,2,2.9,0,1,2,3,3,4,2,3,3,2,2,2,3,3,3,3,1,1,1,1,1,2,1,2,1,2,0,0,0,0,2,2,1,2,2,3,3,2,3,3,2,2,1,3,2,2,2,2,3,3,3,1,1,1,1,2,1,2,2,1,1,2,2,2,1,1,1,2,2,2,2,1.2603922360077393,0.8451542547285166,1.25,0,2,0,2.6,0,2.2222222222222223,0,2.3333333333333335,0,1.1666666666666667,0,1.7142857142857142,0,1,0,1.8918918918918919,0,1,0,0,-0.6953343971921657,-0.3906401072801299,-0.05499485428507328,-0.22281748078260158,2,2,4,2,1,2,2,4,1,0.8997354108424374,2.142857142857143,0,2.5,0.2857644062753896,4,5,5,4,3,3,4,7,3,NA,3,1.1126972805283737,5,4,0,0.13872270157061628,1,0.38510257022558925,3,3,3,2,3,3,5,3,3,3,3,3,4,3,3,4,3,3,4,3,0.7037315505489968,2.8,0,3,0,4,0,3,0,3.3333333333333335,0,2,3,2,3,3,3,2,3,4,2,2,3,2,2,1,4,1,2,1,2,0.7591546545162482,2.35,0,I lived with my mother and father an equal amount of time (joint custody),0,"White, Caucasian, Anglo, European American",0,25,0,1,NA,1,3,3,unemployed,7,175,74,1,5,2,0,0,0,0,0,TRUE,TRUE,TRUE,TRUE,TRUE,2,0.5335593750000699,0.4828687500000233,0.5736218749999534,0.5700290322581366,0.5327633333332836,0.6275781249996507,1,1,1,0.96875,0.9375,1,0.173,0.292,0.619,0.023,1.554,109.09705654603752,1891.7389928145305,0.057,0.385,0.594,0.019,1.42,24.33988835859024,1868.4417720452284,0.06,0.395,0.476,0.023,1.517,55.82779987092883,1883.6251168842764,67.56521739130434,74.73684210526315,65.95652173913044,TRUE,352,1.0429629629629629,0,1,0,3,6,FALSE
554,2022-03-20T05:33:33Z,2022-03-20T05:53:25Z,1192,1,2022-03-20T05:53:27Z,0.8999999761581421,Chrome,99.0.4844.74,Macintosh,1440,900,NA,1.6,502,71,282,58,41,190,-0.361586228297587,-0.25894127989518034,-0.4698918753629367,-0.49476148661262676,-0.40788447996231086,1.0273897405863917,4,4,3,4,4,2,2,3,1,4,2,2,2,2,4,2,1,1,4,4,0.910465468000326,0,1,1,3,2,2.75,0,4,3,4,3,4,4,4,4,3,3,4,4,2,4,3,2,1,1,1,3,3,3,2,1,2,0,0,0,0,2,2,1,2,2,2,2,2,2,3,2,3,1,3,2,1,3,3,3,2,3,2,1,1,1,2,1,2,2,2,1,3,4,4,1,1,1,2,2,1,3,1.2938988268694636,0.8451542547285166,2,0,2,0,3.533333333333333,0,1.8888888888888888,0,2.4166666666666665,0,1.3333333333333333,0,2.5714285714285716,0,1,0,2.027027027027027,0,1,0,0,-0.1207135204560685,0.4033041157408113,-0.05499485428507328,0.17415463072786902,2,1,3,2,1,1,1,2,2,1.2149857925879117,1.5714285714285714,0,2,-0.23937606567541822,3,4,4,4,1,3,4,6,6,3,3,1.1547005383792515,6,3.2857142857142856,0,0.2196552803757379,0,0.047384379226480366,4,4,4,3,4,2,5,3,2,5,4,2,5,4,3,4,5,4,4,4,1.3201731488169053,3.8,0,3.4,0,4.6,0,3.2,0,3.7333333333333334,0,1,1,1,2,4,2,4,2,2,1,1,2,2,2,1,3,1,2,1,4,1.0990426455975697,1.95,0,I lived with my mother and father an equal amount of time (joint custody),0,"White, Caucasian, Anglo, European American",0,20,0,1,NA,1,4,5,Aquatics supervisor,4,170,74,2,5,2,0,0,1,0,0,TRUE,TRUE,TRUE,TRUE,TRUE,1,0.5156375000001281,0.53015625,0.5978156249997555,0.6478687500000233,0.5778741935484352,0.7114903225807413,1,1,1,1,0.96875,1,0.195,0.264,0.56,0.012,1.446,74.09813622702853,1859.9792064717496,0.054,0.429,0.567,0.017,1.198,53.27690822606191,1879.814626422636,0.115,0.335,0.637,0.008,1.281,56.09198686205523,1841.8026682824247,120.5,70.47058823529412,160.125,FALSE,632,1.8725925925925926,0,1,0,0,3,FALSE
555,2022-03-20T06:08:02Z,2022-03-20T06:37:24Z,1762,1,2022-03-20T06:37:26Z,0.8999999761581421,Chrome,99.0.4844.74,Windows NT 10.0,1920,1080,No,1.7777777777777777,586,180,549,167,70,129,-0.1888738474626402,0.34293009009687186,0.5001911016899976,0.8494990935487733,0.18678578512142677,0.3418581640984775,2,3,1,1,2,1,1,4,1,3,4,2,1,3,3,3,1,1,4,3,0.7539370349250519,0,1,1,2,2,2.2,0,3,2,2,2,2,1,2,2,2,1,1,2,2,2,3,1,3,5,1,1,3,2,2,2,1,2,0,1,0,2,1,2,2,2,1,3,3,3,2,2,1,1,2,2,2,1,2,3,1,2,3,4,1,2,4,1,1,2,2,2,2,2,2,1,1,1,2,3,2,2,1.3025731060852963,1.1832159566199232,2.25,0,2.25,0,1.9333333333333333,0,2.111111111111111,0,1.75,0,2.5,0,1.8571428571428572,0,1,0,1.9189189189189189,0,1,0,0,-0.02859872342203749,-0.2333065976401118,0.031158049895781924,-0.10107427387216494,1,2,3,1,1,2,1,1,1,1.4638501094227998,1.5714285714285714,0,1,-0.6261803135308405,5,4,4,4,3,3,4,6,3,NA,3,0.9759000729485332,4.5,3.857142857142857,0,0.003250347887277641,1,0.22518510473017647,2,1,2,2,2,4,4,4,5,2,3,4,3,5,5,3,5,4,3,3,1.245945806357946,1.8,0,4,0,3,0,4.4,0,3.8,0,1,2,4,4,3,4,3,4,4,3,2,3,3,3,1,4,1,4,2,2,1.1367080817685316,2.85,0,"I lived with my mother, but not father, most of the time.",0,"White, Caucasian, Anglo, European American",0,23,0,1,NA,1,4,6,Unemployed,3,230,70,1,5,2,0,0,1,0,0,TRUE,TRUE,TRUE,TRUE,TRUE,3,0.430131250007078,0.3999562499914318,0.4198843750022352,0.4867800000031789,0.43208666666746137,0.4703774193525314,1,1,1,0.9375,0.9375,0.96875,0.055,0.346,0.74,0.024,1.497,44.36682279745223,1873.5203829767506,0.042,0.336,0.676,0.022,1.215,105.34237913776633,1971.9960737523827,0.044,0.361,0.654,0.023,1.584,48.316422337145696,1896.0469089907424,62.375,55.227272727272734,68.86956521739131,FALSE,315,0.9333333333333332,0,1,0,0,3,FALSE
556,2022-03-20T07:09:58Z,2022-03-20T07:27:42Z,1063,1,2022-03-20T07:27:44Z,0.800000011920929,Firefox,98.0,Windows NT 10.0,1920,1080,Interesting survey! Thank you!,1.7777777777777777,498,83,244,53,30,74,-0.3698106273849654,-0.1926802116391746,-0.6079561192880734,-0.5564248159778286,-0.6334490632699356,-0.2762440769971827,2,1,2,2,4,1,1,2,1,2,3,1,2,1,3,2,1,2,2,2,0.9445132413883326,0,1,2,3,4,1.85,0,4,5,1,5,4,5,5,3,3,1,4,5,4,5,4,4,5,1,1,5,5,4,5,2,1,1,0,1,0,1,4,5,4,5,1,5,4,4,2,1,5,1,3,2,5,5,5,5,5,5,5,1,1,1,5,5,3,2,3,2,5,5,5,4,5,5,2,1,2,3,1.7381084606609052,1.4375905768565218,3.75,0,2,0,3.8666666666666667,0,3.6666666666666665,0,3.6666666666666665,0,3,0,3.5714285714285716,0,4.666666666666667,0,3.6216216216216215,0,1,0,0,2.05056383820323,2.0090892485042464,-0.05499485428507328,0.9770471971095865,3,3,5,3,2,2,3,1,1,0.7867957924694432,3,0,1,0.20316555652690138,3,3,2,2,1,1,1,6,1,3,2,1.3972762620115438,3.5,1.8571428571428572,0,-0.5751298489193319,0,-1.2107376624277189,5,5,5,5,4,1,3,1,1,1,5,2,2,1,4,2,5,5,1,3,1.6903085094570331,4.8,0,3.6,0,1.8,0,2,0,2.466666666666667,0,1,1,1,1,4,1,2,2,1,1,1,1,1,1,1,1,1,2,1,3,1.2523661815266247,1.4,0,I lived with my mother and father an equal amount of time (joint custody),0,"Hispanic of Latino (e.g., Mexican American, Central American, and others)",0,24,1,3,NA,1,3,4,Retail cashier,2,210,63,2,5,2,0,0,1,0,0,TRUE,TRUE,TRUE,TRUE,TRUE,2,0.4174375,0.36378125,0.41103125,0.5334,0.45675862068965517,0.5044074074074074,1,1,1,0.9375,0.90625,0.84375,0.06,0.318,0.692,0.014,1.719,72.75016661525693,1935.0508538639992,0.055,0.287,0.673,0.025,2.015,82.59074585930824,1940.5293234208805,0.062,0.327,0.708,0.016,2.02,91.6128233791539,1940.2783344467884,122.78571428571429,80.6,126.25,FALSE,279,0.8266666666666667,0,1,0,0,3,FALSE
557,2022-03-20T07:15:16Z,2022-03-20T07:57:42Z,2545,1,2022-03-20T07:57:44Z,0.8999999761581421,Chrome,99.0.4844.74,Windows NT 6.1,1920,1080,Nope,1.7777777777777777,681,169,1033,221,125,141,0.006455630862597304,0.2821907775288666,2.258693576947002,1.5154630506929532,1.3146087016595498,0.4767168348829852,3,2,3,3,3,3,4,3,2,3,3,3,3,2,3,3,4,1,3,3,0.7591546545162482,0,1,1,2,2,2.85,0,4,3,4,3,4,3,4,4,3,2,2,3,2,3,3,3,4,2,1,4,4,4,2,5,2,0,0,0,0,2,3,2,1,4,3,4,4,4,3,2,3,2,4,2,2,5,4,4,5,5,4,3,3,1,5,1,1,5,5,3,2,2,3,1,2,3,2,4,4,4,1.2991103446927392,0.7432233529572065,3,0,3.5,0,3.1333333333333333,0,3,0,3.4166666666666665,0,2.8333333333333335,0,3,0,2,0,3.027027027027027,0,3,0,0,1.1776664758331283,1.1018648985424924,0.9006481776721214,1.0012565381073069,2,2,4,2,1,3,1,3,2,1.0690449676496976,2.142857142857143,0,2.5,0.2857644062753896,4,3,4,1,2,2,2,2,1,2,2,1.2149857925879117,1.5,2.5714285714285716,0,-1.1502147610713993,0,-1.1740024766794166,3,2,3,4,3,4,2,4,4,3,1,2,3,4,5,1,2,2,3,3,1.1872336794093274,3,0,2.2,0,2.4,0,4,0,2.8666666666666667,0,2,1,3,4,2,3,1,3,1,2,3,2,1,1,2,3,1,3,2,2,0.7880689256524124,2.1,0,I lived with my mother and father an equal amount of time (joint custody),0,"Hispanic of Latino (e.g., Mexican American, Central American, and others)",0,30,0,1,NA,1,1,3,unemployed,1,297,71,3,5,2,0,0,1,0,0,TRUE,TRUE,TRUE,TRUE,TRUE,5,0.50984375,0.4993870967741936,0.5378125,0.58332,0.5718666666666666,0.6623333333333333,1,0.96875,1,0.8064516129032258,0.9375,0.84375,0.064,0.422,0.591,0.006,1.31,33.68197119271561,1897.842778927047,0.06,0.403,0.639,0.019,1.67,80.00378150814076,1989.6726364600916,0.052,0.376,0.428,0.015,1.879,89.1272447045749,1992.1928128322224,218.33333333333334,87.89473684210526,125.26666666666667,FALSE,276,0.8177777777777777,0,1,0,0,3,FALSE
558,2022-03-20T10:46:07Z,2022-03-20T11:05:03Z,1135,1,2022-03-20T11:05:05Z,1,Chrome,99.0.4844.51,Windows NT 10.0,1366,768,NA,1.7786458333333333,710,64,194,26,23,78,0.06608252424609085,-0.2975935697111837,-0.7896195981369375,-0.8894067945499184,-0.776990161738424,-0.2312911867356801,4,4,2,1,4,2,1,3,1,4,4,1,1,3,3,3,1,1,4,4,0.5871429486123998,0,1,1,4,3,2.55,0,4,2,4,3,2,2,4,2,1,1,3,3,3,2,2,2,3,1,1,1,3,2,2,1,2,0,0,0,0,3,4,3,3,5,4,3,3,3,2,3,3,2,3,3,4,2,3,3,2,2,3,2,2,1,4,1,1,1,3,1,4,3,3,2,2,2,2,1,1,1,0.7836543333090898,1.0465362369445672,1.875,0,1.25,0,2.533333333333333,0,3.4444444444444446,0,2.6666666666666665,0,2.1666666666666665,0,2.2857142857142856,0,2,0,2.6486486486486487,0,1,0,0,0.20168826916303972,0.18352886946241112,-0.31345356682763886,-0.06496234868261387,2,4,2,4,4,3,3,2,1,0.4879500364742666,3.142857142857143,0,1.5,0.4795022674603866,5,5,5,5,4,4,4,6,7,5,3,1.1126972805283737,6.5,4.571428571428571,0,0.7376207874909593,0,1.0594958161139754,3,4,3,2,3,3,3,5,3,3,3,3,4,1,3,3,3,4,2,3,0.7432233529572065,3,0,3.2,0,3,0,3,0,3.066666666666667,0,2,2,2,3,2,1,1,4,2,2,1,3,2,2,1,4,2,2,1,2,0.4893604849295929,2.05,0,I lived with my mother and father an equal amount of time (joint custody),0,"White, Caucasian, Anglo, European American",0,30,0,1,NA,1,3,4,Freelancer,4,200,69,3,5,2,0,0,1,0,0,TRUE,TRUE,TRUE,TRUE,TRUE,1,0.5851774193509932,0.6097656249962747,0.633680645158214,0.6519464285756861,0.6838580645092072,0.6984269230847175,0.96875,1,1,0.875,0.96875,0.8387096774193549,0.057,0.456,0.348,0.015,1.64,49.86172453296942,1951.5911218219621,0.082,0.389,0.389,0.023,1.859,73.0978647844192,1900.651863393035,0.06,0.395,0.389,0.008,1.388,108.94249865123466,2015.300057293254,109.33333333333333,80.82608695652173,173.49999999999997,FALSE,388,1.1496296296296296,0,1,0,0,3,FALSE
559,2022-03-20T10:51:08Z,2022-03-20T11:10:00Z,1131,1,2022-03-20T11:10:02Z,1,Edge,99.0.1150.46,Windows NT 10.0,2048,1152,NA,1.7777777777777777,496,79,303,75,58,78,-0.37392282692865464,-0.2147672343911765,-0.39359321424641375,-0.2851061667709405,-0.05928466939598191,-0.2312911867356801,3,2,2,1,2,1,2,3,1,2,3,1,1,3,3,2,2,1,4,3,0.7880689256524124,0,1,2,3,2,2.1,0,4,2,1,2,2,1,1,1,1,1,1,1,1,1,2,2,2,1,1,1,1,1,1,1,2,0,0,0,0,1,2,1,1,5,2,4,1,2,1,1,1,1,3,1,1,2,1,1,2,2,2,1,1,2,1,1,1,1,1,1,1,1,1,1,1,1,1,1,1,1,1.643989873053573,1.7265434778633235,1.25,0,1,0,1.4666666666666666,0,2.111111111111111,0,1.4166666666666667,0,1.3333333333333333,0,1,0,1,0,1.4594594594594594,0,1,0,0,-0.9760652072006408,-1.0742542066660088,-0.39960647100849406,-0.7369303388372515,3,2,4,3,2,3,3,5,3,0.5345224838248488,2.857142857142857,0,4,1.280643713087394,4,4,4,4,2,2,5,4,3,3,3,1.2909944487358056,3.5,3.5714285714285716,0,-0.23191923190205752,0,-0.07285957114128414,2,2,3,3,2,4,4,5,4,2,2,2,5,4,5,3,4,4,2,1,1.3557637102737474,2.4,0,3.2,0,3.2,0,3.8,0,3.4,0,2,4,3,3,3,4,4,4,3,2,3,4,2,2,1,3,1,2,1,2,1.019545822516343,2.65,0,"I lived with my mother, but not father, most of the time. & I lived with my extended family on mother's side (grandparents, aunts ,uncles, cousins)",1,"Black or African American & Hispanic of Latino (e.g., Mexican American, Central American, and others)",1,28,0,1,NA,1,2,4,Closed Captioner,1,135,68,2,5,2,0,0,1,0,0,TRUE,TRUE,TRUE,TRUE,TRUE,2,0.45934687500167637,0.4549125000005588,0.4784468749985099,0.549420689658872,0.5194531250018627,0.5677241379330898,1,1,1,0.90625,1,0.90625,0.058,0.369,0.556,0.017,1.904,35.64554333519135,1890.4989012089693,0.083,0.353,0.79,0.019,1.426,46.94289843615043,1832.2396274168248,0.057,0.353,0.586,0.011,1.518,102.38292595600755,1957.7549774108015,111.99999999999999,75.05263157894737,138,FALSE,266,0.788148148148148,0,1,0,3,6,FALSE
560,2022-03-20T11:46:10Z,2022-03-20T12:21:54Z,2143,1,2022-03-20T12:21:56Z,0.8999999761581421,Chrome,99.0.4844.74,Windows NT 10.0,1920,1080,-,1.7777777777777777,691,372,462,335,53,67,0.027016628581043353,1.403107182192964,0.18409664849297405,2.921386960219555,-0.1618140254449022,-0.35491163495481215,3,3,2,1,3,1,1,2,1,2,3,2,1,2,3,3,3,3,3,3,0.6863327411532597,0,0,3,3,4,2.25,0,4,2,2,3,3,2,4,3,2,4,2,5,1,5,4,2,1,1,1,2,4,2,2,2,2,0,0,0,0,4,4,5,5,5,1,3,2,3,2,2,2,1,4,2,5,4,3,2,2,2,5,1,1,1,4,4,1,2,3,1,2,1,2,1,1,2,2,1,1,2,1.1823273226555742,0.9611501047232549,1.875,0,1.5,0,3.066666666666667,0,3.5555555555555554,0,2.5833333333333335,0,2.6666666666666665,0,1.7142857142857142,0,1.3333333333333333,0,2.5675675675675675,0,1,0,0,0.14905124228645034,0.380982424060634,-0.22730066264678367,0.07684088070692516,1,1,3,1,1,1,1,1,1,1.5735915849388864,1.2857142857142858,0,1,-0.7920494875423887,4,4,4,4,1,1,4,8,6,NA,3,1.4638501094227998,7,3.142857142857143,0,0.6806121163039708,1,0.25074567980046913,1,1,2,2,2,5,3,4,4,2,5,4,5,4,4,1,5,4,3,2,1.4074631010979937,1.6,0,4.6,0,2.8,0,3.6,0,3.6666666666666665,0,3,1,3,4,1,2,1,4,1,1,2,2,3,1,1,3,1,1,3,3,0.910465468000326,2.05,0,I lived with my mother and father an equal amount of time (joint custody),0,Black or African American,0,30,0,1,NA,1,2,6,Unemployed,3,236,71,2,5,2,0,0,1,0,0,TRUE,TRUE,TRUE,TRUE,TRUE,2,0.4966968750003725,0.428499999998603,0.4691625000005588,0.5608218750008382,0.4960750000020489,0.522448387096005,1,1,1,1,1,0.96875,0.073,0.346,0.628,0.02,1.835,113.86236341886554,1946.6144325445084,0.086,0.318,0.799,0.02,1.614,64.9565303462394,1845.2503006546888,0.095,0.33,0.59,0.024,1.916,59.009879176534966,1839.9154061111778,91.75,80.7,79.83333333333333,FALSE,306,0.9066666666666667,0,1,0,3,6,FALSE
561,2022-03-20T13:15:27Z,2022-03-20T13:37:54Z,1347,1,2022-03-20T13:37:55Z,1,Chrome,98.0.4758.80,Linux aarch64,1920,1080,NA,1.7777777777777777,531,58,526,62,35,72,-0.30195933491409344,-0.3307241038391866,0.4166259014195201,-0.4454308231204653,-0.5309197072210152,-0.29872052212793393,2,3,1,1,2,1,1,1,1,3,2,1,1,1,2,3,1,1,3,3,0.9514531821875089,0,0,4,3,2,1.7,0,4,3,2,3,3,1,3,3,3,3,2,3,1,4,3,1,3,1,1,2,4,3,1,2,2,0,0,0,0,1,3,5,5,5,5,5,5,5,4,4,1,1,5,1,1,4,1,2,4,3,4,1,1,1,3,3,1,2,2,1,2,1,1,1,2,2,2,1,1,3,1.2681120250624975,0.7432233529572065,2,0,1.75,0,2.7333333333333334,0,4.333333333333333,0,2.5833333333333335,0,2.1666666666666665,0,1.4285714285714286,0,1.6666666666666667,0,2.6486486486486487,0,1,0,0,0.2828370189311145,0.32542402846900254,-0.14114775846592847,0.09213813500153703,5,4,5,1,4,5,3,1,1,1.7043362064926932,3.857142857142857,0,1,0.7007730785615464,2,3,3,1,1,1,3,6,6,1,2,1,6,2,0,-0.5512059413011987,0,-1.1187631858894997,1,1,1,1,1,5,4,5,5,5,5,5,5,5,5,5,5,5,5,5,2.007130147392398,1,0,5,0,4.8,0,5,0,4.933333333333334,0,1,1,1,2,2,1,1,1,1,1,1,4,1,2,1,4,1,1,1,1,0.812727700887249,1.45,0,I lived with my mother and father an equal amount of time (joint custody),0,"White, Caucasian, Anglo, European American",0,22,0,1,NA,1,2,6,Software Developer,2,130,67,1,5,2,0,0,1,0,0,TRUE,TRUE,TRUE,TRUE,TRUE,1,0.5781625000005588,0.508268750000745,0.5254156249994412,0.6679499999955296,0.5590387096741507,0.6141999999996155,1,1,1,1,0.96875,0.96875,0.068,0.413,0.599,0.015,1.625,49.247953684769634,1870.6583642972919,0.061,0.414,0.625,0.032,1.732,139.54026913030597,1968.617269557142,0.103,0.413,0.676,0.01,1.308,89.07426426968081,1874.256726203408,108.33333333333334,54.125,130.8,FALSE,530,1.5703703703703704,0,1,0,0,3,FALSE
562,2022-03-20T14:16:18Z,2022-03-20T14:54:57Z,2319,1,2022-03-20T14:54:58Z,1,Edge,99.0.1150.46,Windows NT 10.0,1536,864,NA,1.7777777777777777,602,893,445,103,119,76,-0.1559762511131265,4.279941895641214,0.12233106568436027,0.0602084776741898,1.1915734744008455,-0.25376763186643136,3,3,1,1,3,1,1,3,1,3,4,1,1,1,3,3,1,1,3,3,0.5104177855340404,0,0,2,3,2,2.05,0,2,2,2,2,2,1,2,2,2,2,1,2,2,2,3,2,2,1,1,1,1,1,1,1,2,0,0,0,0,1,2,2,2,4,2,2,2,2,1,2,1,1,3,2,5,4,1,3,1,1,1,1,1,1,2,2,1,2,2,1,1,1,1,1,1,1,1,1,1,2,1.4729798605784363,1.162919151265879,1.25,0,1.25,0,1.9333333333333333,0,2.111111111111111,0,2.0833333333333335,0,1.3333333333333333,0,1.2857142857142858,0,1,0,1.7297297297297298,0,1,0,0,-0.8006084509453439,-0.7525071794521716,-0.31345356682763886,-0.5329803731399052,5,5,5,4,4,5,4,5,2,1.7182493859684491,4.571428571428571,0,3.5,2.082456633228973,3,3,3,3,1,1,4,3,3,2,2,0.9511897312113419,3,2.5714285714285716,0,-0.8792700537047221,0,-1.0089728961699453,2,2,2,3,2,4,4,4,4,1,2,5,5,4,4,4,5,4,3,3,1.3345232785352157,2.2,0,4,0,3.4,0,3.8,0,3.7333333333333334,0,1,1,1,2,3,2,1,2,1,1,2,3,1,2,1,3,1,2,1,1,0.7539370349250519,1.6,0,I lived with my mother and father an equal amount of time (joint custody),0,"Asian or Asian American (e.g., Chinese, Japanese, and others)",0,18,0,1,NA,1,2,4,Student,2,208,71,2,5,2,1,1,1,0,2,TRUE,TRUE,TRUE,TRUE,TRUE,6,0.5155387096635757,0.43882812501117585,0.45480937499180435,0.582666666674614,0.5124806451566758,0.5132466666618983,0.96875,1,1,0.9375,0.96875,0.9375,0.068,0.298,0.455,0.022,1.947,114.3122069762339,1962.4016700565312,0.06,0.339,0.619,0.014,1.385,61.506304781056706,1886.7619064179903,0.052,0.37,0.394,0.015,1.546,112.9092627609087,2002.7203202327307,88.50000000000001,98.92857142857143,103.06666666666668,FALSE,366,1.0844444444444443,0,1,0,3,6,FALSE
563,2022-03-20T15:36:57Z,2022-03-20T16:07:34Z,1836,1,2022-03-20T16:07:36Z,0.8999999761581421,Chrome,99.0.4844.74,Windows NT 10.0,1500,1000,No comments.,1.5,1076,82,377,116,54,84,0.8186150407412163,-0.19820196732717507,-0.12473126555009491,0.22053313402371458,-0.14130815423511814,-0.16386185134342626,1,2,1,1,2,1,1,2,1,2,2,1,1,1,2,2,1,1,1,2,1.1652874052533586,0,0,2,3,2,1.4,0,4,2,3,2,3,3,3,3,2,2,4,4,2,5,4,2,4,1,1,2,3,3,2,0,2,0,0,0,0,3,4,4,3,3,1,4,2,3,1,2,1,1,4,2,3,1,1,1,3,3,3,1,1,1,3,1,1,1,1,1,2,2,2,1,1,2,2,1,1,1,1.1290592432528839,0.8997354108424374,2.25,0,1.25,0,3.066666666666667,0,3,0,1.9166666666666667,0,1.6666666666666667,0,1.4285714285714286,0,1.3333333333333333,0,2,0,0,0,0,0.024038303454551324,0.2969073298467495,-0.5328163702636706,-0.11795452020846053,2,2,2,2,2,2,1,2,1,1.1338934190276817,1.8571428571428572,0,1.5,-0.2669090155915809,3,4,4,4,2,2,4,6,6,3,3,1,6,3.2857142857142856,0,0.2196552803757379,0,0.047384379226480366,1,1,1,1,1,5,5,5,5,3,4,5,5,4,4,5,5,5,4,5,1.7237832147426693,1,0,4.8,0,4.4,0,4.6,0,4.6,0,1,1,1,1,1,2,2,2,2,1,2,3,1,1,1,3,2,2,1,2,0.8013147091860318,1.6,0,I lived with my mother and father an equal amount of time (joint custody),0,"White, Caucasian, Anglo, European American",0,24,0,1,NA,1,3,7,Graphic Designer,3,130,69,3,5,2,0,0,1,0,0,TRUE,TRUE,TRUE,TRUE,TRUE,2,0.5154093750026076,0.45743437499925493,0.4805906250011176,0.5757066666662694,0.5172290322578722,0.5672299999982119,1,1,1,0.9375,0.96875,0.9375,0.062,0.318,0.417,0.014,1.687,89.94839440412777,1934.0833204703006,0.08,0.32,0.6,0.007,0.952,131.04699998736265,1975.0855153558566,0.063,0.367,0.441,0.02,1.771,53.79680628530305,1896.1965835022208,120.5,136,88.55,FALSE,436,1.2918518518518518,0,1,0,0,3,FALSE
564,2022-03-20T15:43:40Z,2022-03-20T16:12:36Z,1736,1,2022-03-20T16:12:39Z,0.8999999761581421,Safari,15.3,Macintosh,1440,900,I enjoyed the survey and found the questions interesting. Thanks!,1.6,843,139,372,92,53,111,0.3395437939014233,0.11653810688885224,-0.1428976134349813,-0.07545084692925424,-0.1618140254449022,0.13957015792171604,2,2,1,1,3,1,2,2,1,1,4,1,1,2,2,2,2,1,1,2,1.0711528467275955,0,0,2,4,4,1.7,0,3,1,2,2,2,2,1,2,2,1,3,3,1,3,2,2,2,1,1,1,3,3,2,1,1,1,1,0,0,1,2,4,1,1,1,1,1,1,1,1,1,1,3,2,1,4,2,3,4,4,3,2,1,1,3,1,1,2,2,1,1,1,1,1,1,1,2,2,2,2,1.6689173991798651,1.2649110640673518,1.875,0,2,0,2,0,1.4444444444444444,0,2.25,0,1.8333333333333333,0,1.2857142857142858,0,1,0,1.7027027027027026,0,1,0,1,-0.4124103777304997,-0.46232518760986324,0.8511386348440838,0.19440672361711028,1,1,1,1,1,1,1,1,1,1.9518001458970664,1,0,1,-0.9579186615539372,5,5,5,5,3,1,5,3,3,5,4,1.9023794624226837,3,4.142857142857143,0,0.4486270873193201,0,0.6512647576014867,2,3,2,2,2,5,4,4,5,4,5,5,5,4,4,5,5,4,5,3,1.6417180315870614,2.2,0,4.8,0,4.6,0,4,0,4.466666666666667,0,1,2,3,1,2,3,2,4,1,1,1,2,1,4,2,4,1,3,2,3,1.050062654772261,2.15,0,I lived with my mother and father an equal amount of time (joint custody),0,"White, Caucasian, Anglo, European American",0,23,0,1,NA,1,2,4,Administrator,3,130,70,2,5,2,0,0,1,0,0,TRUE,TRUE,TRUE,TRUE,TRUE,1,0.8435624999999891,0.8716875000000073,0.7934375000000055,0.9800666666666705,0.9798064516129033,0.8969687500000091,1,1,1,0.967741935483871,1,1,0.246,0.22,0.449,0.014,1.863,110.76431551656285,1891.9171982616313,0.141,0.316,0.245,0.174,1.203,184.32317269365183,1971.4203718564102,0.104,0.377,0.229,0.009,1.522,19.530373454454562,1842.2489020580488,133.07142857142856,6.913793103448277,169.11111111111111,FALSE,392,1.1614814814814816,0,1,0,3,6,FALSE
565,2022-03-20T15:51:28Z,2022-03-20T16:30:09Z,2321,1,2022-03-20T16:30:11Z,0.8999999761581421,Chrome,99.0.4844.74,Windows NT 10.0,1920,1080,NA,1.7777777777777777,637,215,782,101,331,104,-0.08401275909856531,0.5361915391768887,1.3467429131257043,0.03554314592810907,5.538818170875066,0.06090259996408655,3,3,3,3,3,1,3,3,1,3,3,1,1,2,3,3,2,1,3,3,0.6407232755171874,1,0,2,3,3,2.4,0,1,2,2,2,3,1,2,1,2,1,1,2,2,2,2,2,1,1,1,2,2,1,2,0,1,0,0,1,0,1,3,1,1,2,1,1,1,2,2,1,1,1,2,2,1,3,2,2,3,3,1,1,1,1,2,2,1,1,1,1,2,2,2,1,1,1,1,1,1,1,1.6098421014470927,1.424279266355945,1.5,0,1,0,1.7333333333333334,0,1.4444444444444444,0,1.9166666666666667,0,1.3333333333333333,0,1.4285714285714286,0,1,0,1.5405405405405406,0,0,0,0,-0.7611306807879024,-0.8132772475506287,-0.6189692744445258,-0.7161232609975772,1,2,4,2,2,2,2,1,1,1.1338934190276817,2.142857142857143,0,1,-0.29444196550774376,4,4,5,5,1,1,4,1,6,2,2,1.7728105208558367,3.5,3.4285714285714284,0,-0.788955151249163,0,-0.48954698455605894,2,2,2,3,3,4,4,4,4,3,4,4,3,3,4,4,4,4,4,3,0.8837151016885368,2.4,0,4,0,3.6,0,3.6,0,3.7333333333333334,0,2,2,3,3,2,3,2,3,2,2,2,3,3,3,1,3,1,2,2,3,0.5871429486123998,2.35,0,"I lived with my extended family on mother's side (grandparents, aunts ,uncles, cousins)",0,Native American/Alaskan Native/indigenous,0,25,0,1,NA,1,2,5,Computer Lab Teacher/Technology Assistant,2,215,70,3,5,2,0,1,1,0,1,TRUE,TRUE,TRUE,TRUE,TRUE,5,0.521,0.43724062500055877,0.4885562499957159,0.5433774193539734,0.5105312499990686,0.5477312499978579,1,1,1,0.96875,1,1,0.073,0.387,0.706,0.033,1.939,127.47006536995585,1934.0450306717646,0.079,0.33,0.725,0.021,1.608,30.99942521759097,1811.3414127940541,0.069,0.332,0.4,0.029,2.089,159.71866535686755,1984.7333852024503,58.75757575757576,76.57142857142857,72.03448275862068,FALSE,342,1.0133333333333332,0,1,1,6,9,FALSE
566,2022-03-21T14:25:34Z,2022-03-21T14:43:41Z,1087,1,2022-03-21T14:43:43Z,0.8999999761581421,Chrome,99.0.4844.74,Windows NT 10.0,1920,1080,"I have no feedback, thank you.",1.7777777777777777,566,67,238,69,26,70,-0.2299958428995323,-0.28102830264718226,-0.6297557367499371,-0.3591021620091827,-0.7154725481090718,-0.32119696725868524,1,1,1,1,1,1,1,2,1,1,1,1,1,1,1,1,1,1,1,1,1.5035046776746235,0,0,4,5,5,1.05,0,1,1,1,1,1,1,1,1,1,1,1,1,1,1,1,1,1,1,1,1,1,1,1,0,2,0,0,0,0,1,1,1,1,1,1,1,1,1,1,1,1,1,1,1,2,1,1,1,1,1,1,1,1,1,1,1,1,1,1,1,1,1,1,1,1,1,1,1,1,1,1.9382354750537296,2.065591117977289,1,0,1,0,1,0,1,0,1.0833333333333333,0,1,0,1,0,1,0,1.027027027027027,0,0,0,0,-1.4190935167452654,-1.5759514355306168,-0.6189692744445258,-1.0974603549875712,1,1,3,1,1,1,1,1,1,1.5735915849388864,1.2857142857142858,0,1,-0.7920494875423887,5,5,5,4,3,3,5,3,3,3,3,1.4960264830861913,3,4.285714285714286,0,-0.3222341343576166,0,0.25914394489227754,2,1,2,2,2,4,4,4,4,4,5,4,5,5,5,5,4,5,4,4,1.52127765851133,1.8,0,4.4,0,4.4,0,4.4,0,4.4,0,1,1,1,1,1,1,1,1,1,1,1,1,1,1,1,1,1,1,1,1,1.231174022502185,1,0,I lived with my mother and father an equal amount of time (joint custody),0,"White, Caucasian, Anglo, European American",0,27,0,1,NA,1,3,6,IT Manager,3,180,76,4,5,2,0,0,1,0,0,TRUE,TRUE,TRUE,TRUE,TRUE,2,0.5890437499955297,0.6522593750208616,0.5766687499955296,0.6378129032081173,0.738475000012666,0.6552781249918044,1,1,1,1,1,1,0.152,0.365,0.761,0.016,1.612,29.884160492740556,1814.0310131703989,0.092,0.391,0.334,0.018,1.492,25.847128652503095,1806.7721279334105,0.164,0.367,0.755,0.037,1.817,53.04665368566176,1833.7204106656263,100.75,82.8888888888889,49.10810810810811,FALSE,292,0.8651851851851852,0,1,1,0,3,FALSE
567,2022-03-21T14:34:29Z,2022-03-21T15:00:16Z,1546,1,2022-03-21T15:00:18Z,0.8999999761581421,Chrome,99.0.4844.51,Windows NT 10.0,1280,720,NA,1.7777777777777777,636,97,404,76,57,202,-0.08606885887040992,-0.1153756320071679,-0.026632986971708298,-0.27277350089790015,-0.07979054060576597,1.1622484113708993,3,2,1,1,3,1,1,2,1,2,2,1,1,1,2,3,1,1,2,2,0.9333020044867296,0,1,1,4,4,1.65,0,2,1,3,2,3,2,3,2,2,1,2,1,3,2,2,2,1,1,1,1,1,1,1,1,2,0,0,0,0,2,3,1,1,1,1,1,1,1,1,1,1,1,1,1,3,1,1,1,1,2,1,1,1,1,2,1,1,2,1,1,1,1,2,1,1,1,1,1,1,1,1.7891900964406218,1.1872336794093274,1.125,0,1,0,2.066666666666667,0,1.3333333333333333,0,1.25,0,1.1666666666666667,0,1.2857142857142858,0,1,0,1.2432432432432432,0,1,0,0,-1.1975793619729533,-0.9612690800557708,-0.39960647100849406,-0.6804377755321325,1,1,2,1,1,2,2,1,1,1.6035674514745464,1.4285714285714286,0,1,-0.7091149005366146,5,5,5,5,4,3,5,7,7,6,5,1.5275252316519468,7,4.571428571428571,0,1.7281822263108981,0,1.6628364028562057,3,3,2,2,2,4,5,4,4,3,5,4,4,4,5,5,5,2,4,4,1.4375905768565218,2.4,0,4,0,4.2,0,4.2,0,4.133333333333334,0,2,2,3,3,1,3,3,2,2,1,3,2,2,3,1,2,1,3,3,2,0.8013147091860318,2.2,0,I lived with my mother and father an equal amount of time (joint custody),0,"White, Caucasian, Anglo, European American",0,30,1,2,NA,1,4,6,Teacher,5,138,62,2,5,2,0,0,1,0,0,TRUE,TRUE,TRUE,TRUE,TRUE,6,0.6616333333492279,0.6318774193333041,0.7777312500104309,0.736496874988079,0.7358437500149012,0.9460000000074505,0.967741935483871,0.96875,1,1,1,1,0.195,0.216,0.35,0.007,1.506,45.02322815049923,1827.3709167311163,0.225,0.275,0.624,0.011,1.378,108.35867030550435,1933.0823148095208,0.08,0.445,0.308,0.104,1.742,116.67375212018959,1945.1606217759256,215.14285714285714,125.27272727272727,16.75,FALSE,347,1.028148148148148,0,1,0,0,3,FALSE
