id,meta_start,meta_captcha,meta_resolution_ratio,meta_resolution_height,dems_edu,dems_class_current,chaos01,chaos02,chaos03,chaos04,chaos05,chaos06,chaos07,chaos08,chaos09,chaos10,chaos11,chaos12,chaos13,chaos14,chaos15,unp01,unp02,unp03,unp04,unp05,unp06,unp07,unp08,unp_moving,unp_other_adults,unp_female_fig_num,unp_female_fig_rom,unp_male_fig_num,unp_male_fig_rom,quic01,quic02,quic03,quic04,quic05,quic06,quic07,quic08,quic09,quic10,quic11,quic12,quic13,quic14,quic15,quic16,quic17,quic18,quic19,quic20,quic21,quic22,quic23,quic24,quic25,quic26,quic27,quic28,quic29,quic30,quic31,quic32,quic33,quic34,quic35,quic36,quic37,change_env01,change_env02,change_env03,change_env04,change_env_mean,change_env_missing,chaos_mean,chaos_missing,quic_monitoring_mean,quic_monitoring_missing,quic_par_predict_mean,quic_par_predict_missing,quic_par_env_mean,quic_par_env_missing,quic_phys_env_mean,quic_phys_env_missing,quic_safety_mean,quic_safety_missing,quic_total_mean,quic_total_missing,unp_moving_binned,unp_male_fig_rom_binned,unp_female_fig_rom_binned,unp_pcunp_quic_comp,unp_subj_comp,unp_obj_comp,unp_comp,violence01,violence02,violence03,violence04,violence05,violence06,violence07,fighting_mean,vio_comp,ses01,ses02,ses03,ses04,ses05,ses06,ses07,ses_subj_comp,ses_subj_missing,ses_obj_comp,ses_obj_missing,ses_comp,impuls01,impuls02,impuls03,impuls04,impuls05,fos01,fos02,fos03,fos04,fos05,fos06,fos07,fos08,fos09,fos10,fos11,fos12,fos13,fos14,fos15,impuls_mean,impuls_missing.x,fos_pa_mean,fos_pa_missing,fos_tp_mean,fos_tp_missing,fos_fc_mean,fos_fc_missing,fos_fo_mean,fos_fo_missing,depression01,depression02,depression03,depression04,depression05,depression06,depression07,depression08,depression09,depression10,depression11,depression12,depression13,depression14,depression15,depression16,depression17,depression18,depression19,depression20,depression_mean,impuls_missing.y,dems_ethnicity,dems_ethnicity_mixed,dems_age,dems_sex,dems_gender,dems_gender_4_text,att_check01,att_check02,att_getup,att_interrupted,att_noise,attention_check_sum,attention_interrupt_sum,ex_narb_NA_selfreport_pass,ex_narb_attention_checks_pass,ex_narb_suspect_responses_pass,ex_narb_resolution_ratio,ex_narb_resolution_height,counterbalance,rt_flanker_congruent_deg,rt_flanker_congruent_enh,rt_flanker_congruent_std,rt_flanker_incongruent_deg,rt_flanker_incongruent_enh,rt_flanker_incongruent_std,acc_flanker_congruent_deg,acc_flanker_congruent_enh,acc_flanker_congruent_std,acc_flanker_incongruent_deg,acc_flanker_incongruent_enh,acc_flanker_incongruent_std,a_flanker_std,t0_flanker_std,p_flanker_std,rd_flanker_std,sda_flanker_std,g2_flanker_std,bbic_flanker_std,a_flanker_enh,t0_flanker_enh,p_flanker_enh,rd_flanker_enh,sda_flanker_enh,g2_flanker_enh,bbic_flanker_enh,a_flanker_deg,t0_flanker_deg,p_flanker_deg,rd_flanker_deg,sda_flanker_deg,g2_flanker_deg,bbic_flanker_deg,interference_flanker_std,interference_flanker_enh,interference_flanker_deg,ssp_refit,final_width_px,scale_factor,no_resize,fullscreenenter,fullscreenexit,blur_event,focus_event,event_during_flanker
2,2022-03-18T14:13:15Z,0.8999999761581421,1.6,800,6,2,2,2,1,1,2,1,1,2,2,2,1,1,1,1,2,1,2,1,1,1,2,1,1,1,2,0,0,0,0,1,1,1,1,1,1,1,1,1,1,1,1,1,2,2,1,2,1,2,3,2,1,1,1,1,1,1,1,3,3,1,1,1,2,1,1,1,1,1,2,2,1.5,0,1.4666666666666666,0,1,0,1.5833333333333333,0,1,0,1.7142857142857142,0,1,0,1.3243243243243243,0,1,0,0,-1.0637935853282892,-1.1332542727810155,-0.22730066264678367,-0.6802774677138996,1,2,4,1,2,2,1,1,-0.4603111395192921,3,4,5,2,2,2,4,3.142857142857143,0,-0.788955151249163,0,-0.6443523350374132,2,2,3,2,2,4,4,4,4,4,4,4,4,3,4,4,4,4,4,2,2.2,0,4,0,4,0,3.4,0,3.8,0,2,1,1,2,1,1,1,2,1,1,1,1,2,2,1,2,1,2,1,1,1.35,0,"Asian or Asian American (e.g., Chinese, Japanese, and others)",0,25,1,2,NA,5,2,0,0,0,0,0,TRUE,TRUE,TRUE,TRUE,TRUE,6,0.5931500000040978,0.5087437500059605,0.5271062499973923,0.6241387096778039,0.5755374999996274,0.594265625,1,1,1,0.96875,1,1,0.114,0.397,0.908,0.013,1.342,64.87877379183134,1849.2253660241956,0.091,0.391,0.806,0.02,1.661,67.06600462929075,1850.288611939237,0.049,0.496,0.534,0.016,1.133,94.96742687708208,1928.8807824221071,103.23076923076924,83.05,70.8125,FALSE,386,1.1437037037037037,0,1,0,0,3,FALSE
3,2022-03-18T14:47:17Z,0.699999988079071,1.7777777777777777,720,6,2,5,2,3,2,3,3,3,3,3,3,4,4,3,4,3,3,5,1,1,2,4,3,3,1,1,0,0,2,0,3,3,3,3,2,2,2,2,2,2,2,3,2,4,2,3,3,3,4,3,4,3,1,1,1,2,1,1,2,2,2,2,3,2,2,4,2,2,1,2,2,1.75,0,3.2,0,2.4444444444444446,0,2.9166666666666665,0,1.5,0,2,0,2.6666666666666665,0,2.3783783783783785,0,1,0,0,0.5942727612842665,0.7386211581611001,-0.14114775846592847,0.2987366998475858,3,3,3,2,2,3,3,1.5,0.2306985064430642,4,3,4,4,2,2,3,3.142857142857143,0,0.6141103876166872,0,0.21024017410123944,2,2,2,2,2,4,3,4,5,3,5,5,3,5,5,4,5,4,4,4,2,0,4.6,0,3.4,0,4.6,0,4.2,0,2,2,2,2,2,2,2,2,1,1,2,2,1,1,1,2,2,2,1,2,1.7,0,"White, Caucasian, Anglo, European American",0,22,3,3,NA,5,2,0,0,1,0,0,TRUE,TRUE,TRUE,TRUE,TRUE,2,0.6485125000000408,0.6517281249999068,0.6326750000000465,0.6969093750001047,0.7547968749999417,0.7537258064517031,1,1,1,1,1,0.96875,0.107,0.392,0.475,0.007,1.341,99.216300561566,1925.4551202257956,0.109,0.387,0.399,0.024,1.642,127.02256250574698,1910.2527187004837,0.08,0.441,0.418,0.014,1.274,90.40062083917068,1874.172610454598,191.57142857142856,68.41666666666666,91,FALSE,304,0.9007407407407407,1,1,0,0,3,FALSE
4,2022-03-18T14:49:21Z,0.8999999761581421,1.6,900,6,3,3,2,1,2,1,2,2,3,1,2,2,3,2,3,4,2,5,5,1,3,4,3,4,4,2,0,0,0,0,2,4,2,4,4,2,2,2,4,1,1,4,1,3,1,1,2,2,4,4,4,5,1,3,2,3,2,1,4,2,1,2,1,2,1,1,3,2,2,2,2,2,0,2.2,0,2.888888888888889,0,2.3333333333333335,0,2.6666666666666665,0,1.8571428571428572,0,1.6666666666666667,0,2.3783783783783785,0,2,0,0,1.0000165101246405,0.5748959746919562,0.16436794915095845,0.3696319619214573,1,1,2,2,1,1,2,2,-0.32231065268119236,5,5,5,4,2,2,5,4,0,0.43348058270556905,0,0.5646365052056546,2,2,2,2,2,4,4,3,4,4,5,4,5,4,3,4,5,4,3,2,2,0,4.4,0,4,0,3.2,0,3.8666666666666667,0,1,1,1,1,3,1,1,2,1,1,2,2,1,1,1,2,1,1,1,2,1.35,0,"White, Caucasian, Anglo, European American",0,24,1,2,NA,5,2,0,0,0,0,0,TRUE,TRUE,TRUE,TRUE,TRUE,3,0.481296875,0.42500312500447035,0.47699999999813736,0.5611500000022351,0.49853125000558796,0.5407687499988824,1,1,1,1,1,1,0.124,0.32,0.784,0.025,1.635,22.80645140136867,1809.304799281526,0.073,0.344,0.883,0.03,1.966,112.48419378573529,1903.515904361382,0.068,0.38,0.705,0.023,1.934,107.08239479974314,1892.0120683469663,65.39999999999999,65.53333333333333,84.08695652173913,FALSE,304,0.9007407407407407,1,1,0,0,3,FALSE
5,2022-03-18T15:09:17Z,1,1.6,900,7,4,4,2,3,1,2,2,3,2,1,1,4,3,3,3,3,3,3,1,1,3,3,2,1,2,1,0,0,1,0,2,4,3,2,3,3,2,2,2,3,2,2,2,2,3,1,4,2,2,3,3,2,1,1,1,4,2,1,2,2,1,2,3,1,1,2,1,2,2,2,2,2,0,2.466666666666667,0,2.5555555555555554,0,2.4166666666666665,0,1.8333333333333333,0,1.7142857142857142,0,1.3333333333333333,0,2.135135135135135,0,1,0,0,0.030617931814124925,0.039372041254744763,-0.05499485428507328,-0.007811406515164258,2,1,4,1,1,2,3,3,0.3962319431973266,3,3,4,4,1,1,1,2.4285714285714284,0,-0.12355533664153649,0,-0.6260776606158913,2,3,2,4,3,4,5,4,4,3,5,4,2,5,3,4,4,4,3,5,2.8,0,4.2,0,3.4,0,4.2,0,3.933333333333333,0,2,1,2,1,3,2,4,1,1,1,3,2,2,1,1,2,1,2,1,2,1.75,0,"White, Caucasian, Anglo, European American",0,28,1,2,NA,5,2,0,0,2,0,0,TRUE,TRUE,TRUE,TRUE,TRUE,2,0.6360624999999945,0.4947499999999982,0.5082499999999973,0.661709677419352,0.5878387096774175,0.5847333333333338,1,1,1,1,0.96875,0.9375,0.056,0.37,0.427,0.007,1.114,111.55544848076272,1979.0028101547368,0.091,0.348,0.628,0.008,1.202,106.93424346382656,1937.635301305813,0.211,0.24,0.562,0.024,1.486,281.46202807874215,2067.5506297452816,159.14285714285717,150.25,61.916666666666664,FALSE,436,1.2918518518518518,0,1,0,0,3,FALSE
6,2022-03-18T15:15:28Z,0.8999999761581421,1.7777777777777777,1080,6,4,4,3,5,3,5,5,4,4,5,3,5,5,2,4,4,3,5,2,3,4,3,4,3,4,1,4,0,4,0,3,5,4,4,4,4,4,3,4,4,4,4,1,4,3,2,4,5,5,4,4,4,3,1,1,4,3,4,4,1,1,4,3,3,4,5,5,3,2,3,4,3,0,4.066666666666666,0,3.888888888888889,0,3.6666666666666665,0,2.6666666666666665,0,2.857142857142857,0,4.666666666666667,0,3.4864864864864864,0,2,0,0,1.719389210771357,1.8736840967703057,0.5089795658743793,1.1913318313223424,3,3,3,2,1,3,2,3,0.6450357042146491,3,3,3,2,1,1,1,2,0,-0.21387023909709557,0,-0.9132955465077466,2,3,2,3,2,4,5,4,5,3,5,4,3,4,5,5,5,4,4,5,2.4,0,4.4,0,4,0,4.6,0,4.333333333333333,0,1,3,1,2,2,1,3,1,1,1,3,2,1,1,1,2,2,2,1,2,1.65,0,"White, Caucasian, Anglo, European American",0,29,1,2,NA,5,2,0,0,0,0,0,TRUE,TRUE,TRUE,TRUE,TRUE,2,0.5484749999940395,0.4858451612880153,0.4961451612864771,0.6250900000135103,0.5335444444373801,0.5646548387081393,1,1,0.96875,0.967741935483871,0.8709677419354839,0.96875,0.073,0.367,0.653,0.02,1.861,265.4918051425363,2134.6472010938955,0.052,0.359,0.48,0.018,1.87,114.82800000065232,2011.6265591861363,0.068,0.407,0.488,0.016,1.619,41.31526248229081,1870.802175442236,93.05,103.8888888888889,101.1875,FALSE,376,1.114074074074074,0,1,0,0,3,FALSE
7,2022-03-18T15:18:14Z,0.8999999761581421,1.6,900,6,4,3,1,2,2,1,2,3,4,2,2,1,3,1,3,4,4,2,5,3,2,2,4,3,7,1,0,0,3,3,2,3,3,2,3,3,4,4,3,3,3,1,1,2,2,4,1,2,3,2,3,5,5,4,1,2,1,1,5,5,1,2,2,2,1,1,1,2,4,4,3,3.25,0,2.2666666666666666,0,3,0,2.25,0,3,0,2.5714285714285716,0,1,0,2.5135135135135136,0,4,3,0,0.9254473887161394,0.5538526177776041,3.1319531112787513,1.8429028645281778,2,2,4,1,1,1,1,1.5,-0.3498436025973552,3,3,5,5,1,2,4,3.2857142857142856,0,0.276774685412584,0,0.0821752099601632,3,4,4,5,4,3,5,3,3,2,2,4,3,4,3,5,4,3,4,3,4,0,3.2,0,3.8,0,3.2,0,3.4,0,3,3,2,2,2,2,1,2,1,2,2,2,2,2,1,2,1,2,1,2,1.85,0,"White, Caucasian, Anglo, European American",0,23,1,2,NA,5,2,0,0,1,0,0,TRUE,TRUE,TRUE,TRUE,TRUE,3,0.5747187500000036,0.5874062500000014,0.5431562499999909,0.6297741935483908,0.6645937499999987,0.6674374999999946,1,1,1,1,1,1,0.207,0.287,0.828,0.013,1.727,80.07507550758066,1862.963606405311,0.086,0.436,0.573,0.024,1.868,37.68298264942327,1820.1346360895252,0.227,0.316,0.925,0.019,1.59,39.86837625844848,1823.9978437052723,132.84615384615387,77.83333333333334,83.6842105263158,TRUE,364,1.0785185185185184,0,1,0,0,3,FALSE
8,2022-03-18T15:18:18Z,0.8999999761581421,1.6,1050,7,2,2,2,3,2,2,2,2,3,2,1,1,2,4,2,1,2,1,1,1,1,1,3,1,1,1,2,0,1,0,1,2,3,2,3,1,2,1,3,2,3,2,1,2,2,2,2,1,1,1,1,2,1,1,1,3,2,1,2,2,1,2,3,2,1,1,1,2,1,1,2,1.5,0,2.066666666666667,0,2,0,1.6666666666666667,0,1.6666666666666667,0,1.8571428571428572,0,1,0,1.7297297297297298,0,1,0,0,-0.7194597011772692,-0.6397187197289838,-0.22730066264678367,-0.43350969118788374,3,3,3,3,2,4,3,1.5,0.39656768045461255,4,4,4,4,2,2,3,3.2857142857142856,0,0.40966740893729353,1,0.1631187745316749,3,3,4,3,4,3,4,3,4,2,4,3,3,4,3,2,4,3,4,3,3.4,0,3.4,0,3,0,3.4,0,3.2666666666666666,0,2,1,1,2,3,1,3,2,1,1,4,2,1,2,2,2,1,1,1,3,1.8,0,"White, Caucasian, Anglo, European American",0,27,1,2,NA,5,2,0,0,0,0,0,TRUE,TRUE,TRUE,TRUE,TRUE,3,0.44164666666785873,0.42568437499925493,0.4837437500003725,0.5775045454475013,0.5394766666710377,0.5831062499955296,0.967741935483871,1,1,0.6875,0.9375,1,0.114,0.303,0.637,0.014,1.675,328.57616834377734,2118.332909825689,0.073,0.322,0.717,0.011,1.54,70.1135822395194,1913.4167353533276,0.052,0.324,0.496,0.009,1.803,170.1925355168348,2120.082091916696,119.64285714285714,140,200.33333333333334,FALSE,317,0.9392592592592592,0,1,0,3,6,FALSE
10,2022-03-18T15:41:04Z,0.8999999761581421,1.7777777777777777,864,5,3,1,1,1,1,2,1,2,1,1,2,1,1,1,1,1,1,1,1,1,1,1,1,1,0,2,0,0,0,0,1,3,1,1,1,1,1,1,1,1,1,1,1,1,1,1,2,1,2,1,2,1,1,1,1,1,1,1,1,1,1,1,1,2,1,1,1,1,1,1,1,1,0,1.2,0,1.2222222222222223,0,1.25,0,1,0,1.1428571428571428,0,1,0,1.162162162162162,0,0,0,0,-1.331365138617617,-1.4296312715654,-0.6189692744445258,-1.0243002730049628,1,1,3,1,1,1,1,1,-0.7920494875423887,5,5,5,5,3,1,4,4,0,-0.23191923190205752,0,0.15934845458074715,3,3,4,2,3,3,4,4,3,3,3,3,4,4,3,4,3,3,4,4,3,0,3,0,3.8,0,3.6,0,3.466666666666667,0,1,1,1,1,1,1,1,1,1,1,1,1,1,1,1,1,1,1,1,2,1.05,0,"White, Caucasian, Anglo, European American",0,30,1,2,NA,5,2,0,0,1,0,0,TRUE,TRUE,TRUE,TRUE,TRUE,1,0.5668406250011175,0.45964516128263166,0.4683437499906868,0.6254571428554399,0.5182931034482758,0.5186933333317438,1,0.96875,1,0.9032258064516129,0.90625,0.9375,0.042,0.397,0.537,0.042,2.032,166.29725251574453,2021.0255605192265,0.046,0.373,0.535,0.012,1.298,174.86888685314483,2100.8823009809785,0.061,0.42,0.482,0.019,1.913,160.0985020305259,2014.874367357599,48.38095238095238,108.16666666666667,100.6842105263158,FALSE,298,0.882962962962963,0,1,0,3,6,FALSE
12,2022-03-18T15:31:48Z,1,1.6,900,6,4,3,2,2,3,2,3,4,3,3,3,4,4,2,4,3,3,4,1,3,3,3,3,3,7,1,1,0,1,1,1,2,3,3,4,1,1,1,1,3,1,2,1,3,2,1,4,3,2,4,4,3,1,1,1,2,5,2,5,1,1,3,4,2,3,5,2,4,3,4,1,3,0,3,0,1.8888888888888888,0,2.5,0,2.1666666666666665,0,2.5714285714285716,0,3.3333333333333335,0,2.3783783783783785,0,4,1,0,0.6754215110523414,0.7058761214672714,1.647070184196927,1.1764731528320993,2,2,4,2,2,3,2,2.5,0.4516335802869379,2,2,3,3,1,1,1,1.8571428571428572,0,-1.3459910705962685,0,-1.6802611503776048,2,2,3,3,3,4,5,4,4,2,3,4,3,4,4,3,2,4,3,4,2.6,0,3.4,0,3.2,0,4,0,3.533333333333333,0,2,3,1,2,3,1,3,1,2,3,1,1,1,1,1,1,2,2,1,1,1.65,0,Black or African American & Middle Eastern,1,23,1,2,NA,5,2,0,0,0,0,0,TRUE,TRUE,TRUE,TRUE,TRUE,3,0.5117937500011176,0.48012812500074503,0.49297741935522327,0.5902406250145287,0.541568750007078,0.5502874999959022,1,1,0.96875,1,1,1,0.059,0.382,0.524,0.02,1.475,112.65284146034622,1941.073989023762,0.069,0.374,0.618,0.036,1.943,22.16691861686127,1803.539998305473,0.192,0.296,0.93,0.015,1.479,67.53561793377496,1853.105480855174,73.75,53.97222222222223,98.60000000000001,FALSE,436,1.2918518518518518,0,1,0,3,6,FALSE
13,2022-03-18T15:36:57Z,0.8999999761581421,1.6,800,4,2,4,3,3,4,3,4,4,5,4,3,5,4,3,4,4,5,5,3,2,4,5,5,5,0,1,1,0,0,0,3,4,2,3,3,2,2,3,3,3,3,4,3,3,3,2,4,5,5,5,5,5,3,4,1,3,1,2,1,2,1,4,4,4,1,1,5,1,4,2,2,2.25,0,3.8,0,2.7777777777777777,0,3.75,0,2.8333333333333335,0,2.5714285714285716,0,2.3333333333333335,0,3.027027027027027,0,0,0,0,1.9891539735138766,1.9386825029403387,-0.1882047535402498,0.8752388747000445,1,1,1,1,1,2,2,4.5,0.56176537995158915,5,5,5,5,3,2,5,4.285714285714286,0,1.475286511749183,0,1.3539949241463662,2,2,3,3,3,4,4,4,4,3,5,4,4,3,5,3,4,4,3,2,2.6,0,4.2,0,3.4,0,3.6,0,3.7333333333333334,0,4,2,2,2,4,2,4,3,3,1,3,3,3,3,1,3,3,3,4,4,2.85,0,"White, Caucasian, Anglo, European American",0,27,1,2,NA,5,2,1,0,1,0,1,TRUE,TRUE,TRUE,TRUE,TRUE,1,0.5449999999850988,0.50209375,0.5567281250208617,0.6401781249940396,0.5971218749582767,0.6460516129309132,1,1,1,1,1,1,0.089,0.419,0.627,0.016,1.564,27.010810554140903,1810.164869644227,0.115,0.323,0.647,0.019,1.85,14.40684935459952,1794.2500137768998,0.093,0.382,0.554,0.016,1.557,49.58704200415695,1836.6416164269908,97.75,97.36842105263159,97.3125,FALSE,390,1.1555555555555557,0,1,0,0,3,FALSE
15,2022-03-18T15:37:41Z,0.8999999761581421,1.7777777777777777,1080,4,2,5,4,4,5,4,4,4,4,3,4,4,4,3,4,4,4,4,5,2,3,3,3,3,6,2,0,0,0,0,1,5,3,4,5,4,4,4,4,4,4,2,1,3,3,3,5,4,2,3,3,3,1,4,1,5,5,1,5,4,1,3,3,3,4,5,3,3,3,3,2,2.75,0,4,0,3.7777777777777777,0,3.0833333333333335,0,3.1666666666666665,0,2.857142857142857,0,4,0,3.2972972972972974,0,3,0,0,1.5965694813926496,1.761977304925893,0.6421894651295558,1.2020833850277244,5,3,5,3,3,5,3,3,1.474381574272391,2,2,2,1,1,1,1,1.4285714285714286,0,-0.24706573651580854,0,-1.2431252769065957,4,4,4,5,4,2,5,3,3,2,3,3,2,2,5,1,3,4,3,2,4.2,0,3,0,2.6,0,3,0,2.8666666666666667,0,3,3,3,4,3,3,3,4,2,3,4,3,4,3,1,3,1,3,3,2,2.9,0,"White, Caucasian, Anglo, European American",0,20,1,2,NA,5,2,0,0,1,0,0,TRUE,TRUE,TRUE,TRUE,TRUE,4,0.6402000000000961,0.5146906249998138,0.5316612903225807,0.6926968749999068,0.577396774193933,0.6151580645177633,1,1,0.96875,1,0.96875,1,0.07,0.405,0.554,0.026,1.901,122.29309207975255,1949.0700997312167,0.123,0.331,0.681,0.015,1.418,152.13524048681438,1975.268000480274,0.099,0.483,0.617,0.04,1.964,35.560221385671134,1817.840284004959,73.11538461538461,94.53333333333333,49.1,FALSE,466,1.3807407407407408,0,1,0,0,3,FALSE
16,2022-03-18T15:47:44Z,1,1.7777777777777777,720,7,3,1,1,2,2,2,2,1,2,2,2,2,4,2,3,2,1,1,1,1,1,1,1,1,1,2,0,0,0,0,2,2,3,2,2,1,1,1,1,2,1,1,1,1,1,1,2,1,1,1,1,1,1,1,1,1,1,1,2,2,1,2,2,1,1,1,1,2,1,2,2,1.75,0,2,0,1.6666666666666667,0,1.1666666666666667,0,1,0,1.5714285714285714,0,1,0,1.3243243243243243,0,1,0,0,-1.2260910848644389,-1.0095508008265515,-0.14114775846592847,-0.5753492796462399,1,1,2,1,1,1,1,1,-0.874984074548163,5,5,5,4,2,3,4,4,0,0.6473058850354002,0,0.6948752549814432,2,1,2,3,2,4,4,4,5,3,5,3,3,4,3,5,3,3,3,3,2,0,3.6,0,3.6,0,3.8,0,3.6666666666666665,0,1,1,1,2,1,1,1,2,1,1,1,2,1,2,1,1,1,1,2,1,1.25,0,"White, Caucasian, Anglo, European American",0,29,1,2,NA,5,2,0,1,1,0,1,TRUE,TRUE,TRUE,TRUE,TRUE,4,0.5512468750020489,0.5671406249981373,0.5194000000011536,0.6749290322613332,0.6196580645192054,0.8277566666712364,1,1,0.96875,1,1,0.9375,0.107,0.325,0.486,0.004,1.307,199.65131239327084,2130.2638343147046,0.098,0.337,0.478,0.023,2.063,109.36808580703726,1894.099361815604,0.187,0.219,0.581,0.009,1.393,96.90534457283412,1880.2759763480296,326.75,89.69565217391305,154.7777777777778,TRUE,258,0.7644444444444445,0,1,1,6,9,FALSE
17,2022-03-18T15:40:54Z,0.800000011920929,1.7777777777777777,1080,6,5,2,1,2,2,2,1,4,1,2,2,1,2,1,2,3,2,1,1,2,1,1,1,1,0,1,1,1,1,1,2,3,2,2,3,2,2,3,2,2,3,1,3,2,3,2,1,1,2,2,4,2,1,1,2,4,1,2,1,2,1,2,1,1,2,1,1,1,2,2,3,2,0,1.8666666666666667,0,2.3333333333333335,0,2.1666666666666665,0,1.8333333333333333,0,1.4285714285714286,0,1.3333333333333333,0,1.945945945945946,0,0,1,1,-0.6602430459411065,-0.687213772951564,1.3311408428585365,0.32196353495348623,2,2,2,1,1,1,1,2.5,-0.12890852875348124,4,5,4,4,5,4,4,4.285714285714286,0,1.514356923981067,0,1.3777923025990628,1,1,2,1,1,5,3,5,4,1,5,4,4,4,4,5,4,3,4,2,1.2,0,4.2,0,3.4,0,3.8,0,3.8,0,1,2,1,3,2,1,1,2,1,1,1,2,1,1,1,2,1,1,1,1,1.35,0,"White, Caucasian, Anglo, European American",0,29,1,2,NA,5,2,0,0,1,0,0,TRUE,TRUE,TRUE,TRUE,TRUE,2,0.58625,0.4976875,0.49634375,0.6283448275862069,0.550304347826087,0.5737931034482758,1,1,1,0.90625,0.7419354838709677,0.90625,0.055,0.373,0.449,0.011,1.321,31.45654598409788,1885.187166084475,0.044,0.379,0.356,0.011,1.443,84.40570113489225,2084.5597013346146,0.071,0.347,0.385,0.01,1.499,173.4949201504493,2034.0118462516027,120.0909090909091,131.1818181818182,149.9,FALSE,316,0.9362962962962963,0,1,1,6,9,FALSE
18,2022-03-18T15:49:21Z,1,1.7777777777777777,1080,6,3,1,1,2,2,1,1,3,1,1,1,1,2,3,3,2,1,2,3,1,1,1,1,1,2,2,0,0,0,0,2,5,4,3,3,3,4,3,3,1,2,2,1,3,1,3,1,1,1,1,3,4,4,5,1,3,1,1,3,1,1,2,1,1,1,1,1,2,2,1,1,1.5,0,1.6666666666666667,0,3.3333333333333335,0,1.6666666666666667,0,3,0,1.4285714285714286,0,1,0,2.189189189189189,0,1,0,0,-0.4211832155432646,-0.6137586906383807,-0.22730066264678367,-0.42052967664258223,1,1,3,1,1,1,1,1,-0.7920494875423887,5,4,5,4,1,1,4,3.4285714285714284,0,0.3670895878681431,0,0.2145877453706641,2,1,2,2,1,5,5,5,5,3,5,5,5,4,4,4,5,4,4,5,1.6,0,4.8,0,4.2,0,4.6,0,4.533333333333333,0,1,1,1,1,2,1,2,2,1,1,3,2,1,1,1,3,1,1,1,1,1.4,0,"White, Caucasian, Anglo, European American",0,25,1,2,NA,5,2,0,0,1,0,0,TRUE,TRUE,TRUE,TRUE,TRUE,2,0.7483593749701977,0.5732718749940395,0.6382375000044703,0.7970483870890833,0.6007064516236705,0.7054225806574668,1,1,1,0.96875,0.96875,0.96875,0.065,0.481,0.402,0.024,1.767,86.08242778946061,1911.6986090252497,0.055,0.457,0.494,0.026,1.384,121.45957789476589,1957.2669945065827,0.083,0.485,0.338,0.023,1.744,55.69694816461729,1884.4706906884185,73.625,53.230769230769226,75.82608695652173,FALSE,348,1.031111111111111,0,1,0,0,3,FALSE
19,2022-03-18T15:55:21Z,1,1.7786458333333333,768,4,3,3,1,2,1,1,1,2,1,1,1,2,2,1,2,2,1,2,1,1,1,2,1,1,3,2,0,0,0,0,1,5,1,2,2,1,1,1,1,1,1,1,1,1,1,1,1,1,1,1,1,2,1,1,1,2,1,1,2,2,1,1,1,2,1,1,1,1,1,1,1,1,0,1.5333333333333334,0,1.6666666666666667,0,1,0,1.3333333333333333,0,1.4285714285714286,0,1,0,1.2972972972972974,0,2,0,0,-1.081339260953819,-1.1159475867206134,-0.18024366757246235,-0.6480956271465379,1,1,3,1,1,1,2,1,-0.7091149005366146,5,5,5,5,4,4,5,4.714285714285714,0,0.7195717946859974,0,1.1259050390736665,2,2,2,2,2,5,4,5,5,4,5,4,5,5,3,5,5,4,4,4,2,0,4.6,0,4.4,0,4.4,0,4.466666666666667,0,2,2,1,1,2,1,2,3,1,3,3,2,3,3,1,3,2,2,2,2,2.05,0,"White, Caucasian, Anglo, European American",0,27,1,2,NA,5,2,0,0,1,0,0,TRUE,TRUE,TRUE,TRUE,TRUE,2,0.4061343750000087,0.38767812499999127,0.45252812500002254,0.484175,0.4627599999999977,0.5232777777777649,1,1,1,0.625,0.625,0.84375,0.057,0.331,0.518,0.019,2.003,76.76246192557933,1939.437208310804,0.038,0.312,0.566,0.014,1.768,78.75561038561035,1983.240369549915,0.047,0.318,0.64,0.011,1.596,119.37865755981616,2030.3002895654752,105.42105263157896,126.28571428571428,145.0909090909091,FALSE,360,1.0666666666666667,0,1,0,0,3,FALSE
20,2022-03-18T15:57:30Z,1,1.7777777777777777,1080,6,2,1,1,1,1,1,1,1,1,1,1,1,2,2,2,3,1,2,2,1,1,1,1,1,2,2,0,0,0,0,1,2,2,2,5,1,4,4,2,1,1,1,1,2,2,1,1,3,1,1,3,2,1,1,1,4,1,2,2,2,1,1,1,1,1,1,1,1,2,2,2,1.75,0,1.3333333333333333,0,2.5555555555555554,0,1.5,0,1.6666666666666667,0,1.4285714285714286,0,1,0,1.7297297297297298,0,1,0,0,-0.8006084509453439,-1.014467473002802,-0.14114775846592847,-0.5778076157343652,1,1,2,1,1,1,1,2,-0.48817982669274074,5,5,5,5,1,1,5,3.857142857142857,0,0.32511668744504807,0,0.4212305175141676,2,2,2,3,3,4,2,4,4,2,1,4,2,4,2,2,3,3,2,4,2.4,0,3,0,2,0,3.6,0,2.8666666666666667,0,1,2,2,3,2,2,1,3,3,3,3,3,2,3,2,3,1,3,1,2,2.25,0,"White, Caucasian, Anglo, European American",0,23,1,2,NA,5,2,0,0,1,0,0,TRUE,TRUE,TRUE,TRUE,TRUE,2,0.4811187500008382,0.4319437499996275,0.4510781249997672,0.5845259259265881,0.47264399999946355,0.5356777777779433,1,1,1,0.84375,0.78125,0.84375,0.056,0.351,0.526,0.022,2.067,56.98339581604526,1959.413656268431,0.038,0.355,0.487,0.013,1.364,109.12004006006124,2082.141159117017,0.057,0.369,0.564,0.009,1.452,128.0507299995129,2032.4519050565143,93.95454545454547,104.92307692307693,161.33333333333334,FALSE,222,0.6577777777777777,0,1,0,0,3,FALSE
21,2022-03-18T15:56:19Z,0.8999999761581421,1.7777777777777777,1080,3,2,2,3,2,3,2,1,2,2,3,1,3,3,1,3,3,2,4,1,1,2,3,2,3,2,2,0,0,0,0,1,2,2,2,2,1,3,2,1,3,1,3,1,3,3,5,4,5,3,5,5,3,1,1,1,2,1,1,2,2,1,3,3,2,1,1,2,2,1,2,1,1.5,0,2.2666666666666666,0,1.7777777777777777,0,3.4166666666666665,0,1.5,0,2,0,1.3333333333333333,0,2.27027027027027,0,1,0,0,0.19949505970984815,0.0656270706759223,-0.22730066264678367,-0.08083679598543068,2,2,3,1,1,2,1,1,-0.5432457265250663,3,3,3,2,1,1,4,2.4285714285714284,0,0.09026996568829465,0,-0.49583891084010284,2,3,2,3,2,4,3,4,4,2,3,3,5,3,3,3,3,4,2,3,2.4,0,3.4,0,3,0,3.4,0,3.2666666666666666,0,2,1,1,4,2,2,2,4,4,2,2,2,2,3,1,2,1,3,2,2,2.2,0,"White, Caucasian, Anglo, European American",0,20,1,2,NA,5,2,0,0,1,0,0,TRUE,TRUE,TRUE,TRUE,TRUE,2,0.45019032258756697,0.4394531250074506,0.4419437499716878,0.5448285714387894,0.5173838709746638,0.5293689655065537,0.96875,1,1,0.875,0.96875,0.90625,0.065,0.352,0.736,0.019,1.851,20.68208436789645,1875.6401259970005,0.057,0.359,0.778,0.018,1.757,192.5865298478083,2028.2090761493537,0.052,0.371,0.673,0.013,1.591,158.36622518436607,2066.556332845357,97.42105263157895,97.61111111111111,122.38461538461539,FALSE,294,0.8711111111111112,0,1,0,0,3,FALSE
22,2022-03-18T15:49:28Z,0.8999999761581421,1.6,900,6,3,3,1,2,1,2,2,2,4,2,3,3,3,2,3,2,1,4,1,1,1,2,2,1,1,2,0,0,0,0,2,1,1,1,1,1,1,1,1,1,1,3,1,2,1,1,1,2,3,2,1,2,1,1,1,2,2,1,2,1,1,1,1,1,1,2,1,2,1,2,1,1.5,0,2.3333333333333335,0,1.1111111111111112,0,1.5833333333333333,0,1.5,0,1.1428571428571428,0,1.3333333333333333,0,1.3513513513513513,0,1,0,0,-0.8028016603985353,-0.5793419854046268,-0.22730066264678367,-0.4033213240257052,1,2,1,1,1,1,1,1,-0.874984074548163,5,5,5,5,3,2,4,4.142857142857143,0,1.384971609293624,0,1.2215823887358657,2,2,2,2,2,4,4,3,4,3,4,4,3,3,4,3,4,5,4,3,2,0,4.2,0,3.4,0,3.4,0,3.6666666666666665,0,2,1,2,4,1,3,1,3,2,1,2,3,2,3,1,3,1,3,2,1,2.05,0,"White, Caucasian, Anglo, European American",0,23,1,2,NA,5,2,0,0,1,0,0,TRUE,TRUE,TRUE,TRUE,TRUE,6,0.5058125000000054,0.4622258064515904,0.47840625,0.5772258064516091,0.5019354838709827,0.5390312499999964,1,0.96875,1,0.96875,0.96875,1,0.104,0.308,0.636,0.013,1.266,71.59549885457737,1858.0619843880295,0.052,0.354,0.471,0.022,1.397,159.77663083090297,2025.5762195635084,0.08,0.364,0.581,0.019,1.724,119.88795950177912,1951.531302904209,97.38461538461539,63.50000000000001,90.73684210526316,FALSE,392,1.1614814814814816,0,1,0,3,6,FALSE
23,2022-03-18T15:58:42Z,0.8999999761581421,1.7777777777777777,1080,3,2,3,1,2,3,1,1,1,2,2,1,1,1,3,2,2,2,4,5,1,2,3,3,2,12,1,0,0,2,2,1,2,5,1,2,1,2,2,2,1,1,3,1,5,1,3,3,4,5,4,4,5,2,2,4,1,1,1,4,4,4,3,3,2,1,1,1,2,2,4,4,3,0,1.7333333333333334,0,2,0,2.9166666666666665,0,2.5,0,3,0,1,0,2.4864864864864864,0,6,2,0,0.6644554637863846,0.14547382681823176,2.785160802519475,1.4653173146688534,1,1,1,1,1,1,1,2,-0.571114413698515,5,5,5,5,2,2,5,4.142857142857143,0,-0.665444751374891,0,-0.027304718746708312,4,3,4,5,3,1,2,2,3,2,3,2,3,2,3,2,3,4,3,1,3.8,0,2.6,0,2.4,0,2.2,0,2.4,0,3,2,3,3,3,2,3,3,4,2,2,3,2,2,1,3,2,3,3,3,2.6,0,"White, Caucasian, Anglo, European American",0,27,1,2,NA,5,2,0,0,1,0,0,TRUE,TRUE,TRUE,TRUE,TRUE,1,0.46869999999552964,0.4836937499977648,0.47240624999999997,0.5709821428571429,0.5520419354823328,0.5468800000111262,1,1,1,0.875,0.96875,0.9375,0.061,0.334,0.467,0.021,1.86,80.68816855839738,1927.4872478422876,0.081,0.318,0.499,0.014,1.463,70.30011352330726,1893.6950112972736,0.067,0.319,0.485,0.011,1.687,48.9512644043132,1907.276022816127,88.57142857142857,104.5,153.36363636363637,FALSE,358,1.0607407407407408,0,1,0,6,9,FALSE
24,2022-03-18T16:05:05Z,0.8999999761581421,1.6,900,4,2,3,3,3,3,2,2,2,2,2,2,2,2,2,2,2,3,2,3,1,1,1,1,1,1,1,0,0,1,1,2,3,1,1,1,1,1,1,1,2,1,1,2,2,2,2,2,2,2,1,3,3,2,3,1,3,2,1,2,1,1,3,2,1,2,4,2,3,4,4,2,3.25,0,2.2666666666666666,0,1.3333333333333333,0,1.8333333333333333,0,2.3333333333333335,0,1.5714285714285714,0,2.6666666666666665,0,1.8108108108108107,0,1,1,0,-0.5045251747645307,-0.4078484598970072,1.075134678069687,0.33364310908634,2,2,5,2,2,2,2,1,-0.1285727914961955,2,3,3,2,1,1,2,2,0,-0.8944165583184731,0,-1.3278091742878089,3,3,3,4,4,2,4,4,3,3,5,3,3,4,3,4,4,4,4,4,3.4,0,3.6,0,3.6,0,3.6,0,3.6,0,2,3,2,3,3,3,1,4,2,2,2,4,2,2,1,4,2,2,1,2,2.35,0,"Hispanic of Latino (e.g., Mexican American, Central American, and others)",0,20,1,2,NA,5,2,0,0,0,0,0,TRUE,TRUE,TRUE,TRUE,TRUE,3,0.5048354838707394,0.4213812500000349,0.45843225806458826,0.5926033333334451,0.5228766666665052,0.5464548387096053,0.96875,1,0.96875,0.967741935483871,0.9375,0.96875,0.064,0.31,0.443,0.014,1.607,166.3985362255837,2042.8361259625503,0.063,0.32,0.632,0.016,1.89,62.02130621395311,1909.7949192429812,0.063,0.359,0.454,0.021,2.002,89.50978984818381,1964.8579101949515,114.78571428571428,118.12499999999999,95.33333333333331,FALSE,432,1.28,0,1,0,0,3,FALSE
25,2022-03-18T15:58:17Z,0.8999999761581421,1.7777777777777777,720,7,2,5,3,4,3,4,3,4,3,3,2,4,4,3,4,4,4,4,4,1,2,4,4,4,6,2,0,0,0,0,4,2,4,3,4,2,3,3,3,4,3,3,1,4,3,4,4,4,4,4,4,5,1,1,1,2,1,1,3,3,1,3,3,3,2,3,2,2,2,2,2,2,0,3.533333333333333,0,3.111111111111111,0,3.5,0,1.8333333333333333,0,2.4285714285714284,0,2.3333333333333335,0,2.8378378378378377,0,3,0,0,1.2982929957586449,1.3576301851510464,0.3837307525869902,0.8706804688690183,4,5,5,5,5,4,4,3,1.8890545093012616,3,3,3,4,1,1,2,2.4285714285714284,0,-0.8792700537047221,0,-1.0863755714106227,2,3,3,3,3,4,4,4,4,2,5,4,4,3,4,5,4,5,4,3,2.8,0,4.4,0,3.8,0,3.6,0,3.933333333333333,0,1,2,2,2,3,1,3,2,1,2,3,2,2,2,2,2,1,2,2,3,2,0,"Hispanic of Latino (e.g., Mexican American, Central American, and others)",0,26,1,2,NA,5,2,0,0,1,0,0,TRUE,TRUE,TRUE,TRUE,TRUE,4,0.5096516129032318,0.5226516129032468,0.48408437499999124,0.5390375000000349,0.5389312500000087,0.5409999999999845,0.96875,0.96875,1,1,1,0.9375,0.076,0.307,0.451,0.014,1.606,80.91447919334884,1923.3886198142425,0.144,0.274,0.583,0.061,1.427,142.3119049264371,1969.3737596930987,0.082,0.328,0.453,0.057,1.981,231.64021289392755,2058.9892723792877,114.71428571428572,23.393442622950822,34.75438596491228,FALSE,382,1.1318518518518519,0,1,0,0,3,FALSE
26,2022-03-18T15:52:31Z,0.800000011920929,1.7777777777777777,900,6,3,1,2,2,2,4,3,4,3,4,3,4,2,5,2,2,4,2,3,4,3,4,4,4,1,1,1,0,1,1,2,2,3,1,3,2,2,2,3,3,3,4,3,3,2,5,2,3,1,2,2,2,2,3,3,3,3,3,4,1,2,4,2,1,1,2,1,4,4,5,2,3.75,0,2.8666666666666667,0,2.2222222222222223,0,2.75,0,2.6666666666666665,0,2.4285714285714284,0,1.3333333333333333,0,2.4324324324324325,0,1,1,0,1.1162566111437744,0.944138055128374,1.2474404864313975,1.0957892707798857,1,2,3,5,4,4,4,2,0.7558389783938718,4,4,4,4,4,4,2,3.7142857142857144,0,-0.20799532428392437,0,0.01911490539693486,1,1,1,1,1,2,4,2,2,4,2,5,3,4,5,5,4,3,5,2,1,0,3.2,0,4.2,0,3,0,3.466666666666667,0,3,1,2,2,3,3,2,1,1,1,1,2,2,2,1,2,1,2,1,2,1.75,0,"White, Caucasian, Anglo, European American",0,27,1,2,NA,5,2,0,0,1,0,0,TRUE,TRUE,TRUE,TRUE,TRUE,6,0.71653125,0.62021875,0.63859375,0.788258064516129,0.69903125,0.74978125,1,1,1,1,1,1,0.204,0.323,0.66,0.013,1.626,19.878847320480528,1800.30972176386,0.233,0.242,0.624,0.02,1.646,18.41124513679298,1799.6187342320447,0.218,0.277,0.502,0.017,1.459,33.42418258009004,1815.0336131129015,125.07692307692308,82.3,85.82352941176471,TRUE,340,1.0074074074074075,0,1,0,0,3,FALSE
27,2022-03-18T16:00:10Z,0.8999999761581421,1.7786458333333333,768,4,3,2,2,2,2,2,3,3,3,2,3,3,3,2,3,2,2,3,1,2,2,2,2,2,1,1,2,1,3,1,2,3,2,2,2,1,1,1,2,1,1,1,2,3,2,2,3,3,3,4,3,3,1,1,1,3,1,3,3,1,1,2,3,1,1,1,1,2,2,2,2,2,0,2.466666666666667,0,1.7777777777777777,0,2.3333333333333335,0,1.6666666666666667,0,2,0,1,0,1.9189189189189189,0,1,1,1,-0.1908962229581874,-0.10960312568564741,1.5505036462945683,0.7204502603044605,3,2,4,2,1,3,3,2,0.34116604336500117,4,4,4,4,3,3,4,3.7142857142857144,0,-0.5931788417242938,0,-0.2154963365799022,2,2,2,3,3,4,4,4,4,3,4,4,2,4,4,3,3,3,3,3,2.4,0,3.6,0,3,0,3.8,0,3.466666666666667,0,2,2,3,2,2,2,2,3,2,2,2,2,2,1,1,3,1,2,2,2,2,0,"White, Caucasian, Anglo, European American",0,25,1,2,NA,5,2,0,0,0,0,0,TRUE,TRUE,TRUE,TRUE,TRUE,5,0.5637124999999069,0.518234374998603,0.56959375,0.6449935483874814,0.55235624999972055,0.5931656249989755,1,1,1,0.96875,1,1,0.072,0.417,0.451,0.095,1.224,54.73763295862984,1835.6408915692657,0.065,0.375,0.488,0.042,1.939,90.53831585536706,1874.9266648081496,0.071,0.381,0.345,0.031,2.058,96.0656088398025,1921.8800096622315,12.884210526315789,46.166666666666664,66.38709677419354,FALSE,368,1.0903703703703704,0,1,0,0,3,FALSE
28,2022-03-18T15:53:32Z,0.8999999761581421,1.6,900,7,2,4,2,3,3,5,3,4,3,2,2,3,3,3,3,3,4,4,5,1,2,3,4,4,5,1,2,0,2,0,1,2,3,3,4,1,3,1,4,3,3,3,3,3,3,1,3,4,4,5,5,5,3,4,3,5,5,2,4,3,2,1,2,2,3,3,3,5,3,3,2,3.25,0,3.066666666666667,0,2.4444444444444446,0,3.3333333333333335,0,4.166666666666667,0,2.2857142857142856,0,3,0,3.027027027027027,0,3,0,0,1.4211127251373528,1.2364833827282329,0.8144952734912662,1.0254893281097495,4,4,3,2,3,3,3,1.5,0.4795022674603866,3,3,3,3,2,2,2,2.5714285714285716,0,-0.7825102850053112,1,-0.9500375355428525,2,2,2,2,2,4,4,5,4,3,5,4,4,4,4,3,5,5,3,3,2,0,4.6,0,3.4,0,4,0,4,0,2,2,1,2,3,1,3,3,2,2,3,2,2,1,2,2,1,1,2,3,2,0,Black or African American & Filipino,1,24,1,2,NA,5,2,0,1,3,0,1,TRUE,TRUE,TRUE,TRUE,TRUE,3,0.5208468750002794,0.48423750000074506,0.5291812500013039,0.6165258064524781,0.5484366666689515,0.6082548387108311,1,1,1,1,0.9375,0.96875,0.082,0.387,0.646,0.016,1.8,109.13449568231933,1932.6572494053132,0.057,0.388,0.556,0.033,2.048,63.16480797240539,1931.2262494237427,0.141,0.368,0.919,0.009,1.151,67.861433469774,1855.9235944355703,112.5,62.06060606060606,127.8888888888889,FALSE,374,1.108148148148148,0,1,0,3,6,FALSE
30,2022-03-18T15:48:45Z,0.8999999761581421,1.7777777777777777,1080,6,6,3,3,2,3,3,3,3,3,3,2,2,3,1,3,2,3,3,1,1,2,2,3,2,4,1,2,0,1,0,2,3,4,3,3,2,3,2,3,2,2,1,1,4,1,1,4,2,2,2,2,2,1,3,2,1,1,1,3,3,1,4,4,3,1,3,3,2,2,2,2,2,0,2.6,0,2.7777777777777777,0,2,0,1.6666666666666667,0,2.7142857142857144,0,2.3333333333333335,0,2.2972972972972974,0,2,0,0,0.13589198556730314,0.1683855191595593,0.16436794915095845,0.1663767341552589,2,2,3,1,1,2,3,6.5,1.7500468106913045,2,3,3,2,1,1,2,2,0,2.089587539198367,1,0.4897164354127068,2,1,2,1,2,5,5,5,5,4,4,5,5,4,5,5,5,4,4,3,1.6,0,4.6,0,4.6,0,4.4,0,4.533333333333333,0,2,1,2,2,1,3,1,4,2,2,2,4,2,2,1,4,1,3,1,2,2.1,0,"White, Caucasian, Anglo, European American",0,29,0,1,NA,5,2,0,0,0,0,0,TRUE,TRUE,TRUE,TRUE,TRUE,1,0.5180156249962747,0.4501903225760306,0.4826781249977648,0.5479714285816465,0.48802903226498634,0.5110344827462887,1,1,1,0.9032258064516129,0.96875,0.9354838709677419,0.042,0.42,0.71,0.056,2.006,51.13123685011743,1895.150939244188,0.054,0.391,0.967,0.053,2.157,179.77174321798435,2017.3843523017456,0.039,0.456,0.646,0.02,1.227,90.57124640951749,2007.7254086912271,35.82142857142857,40.69811320754717,61.35,FALSE,168,0.49777777777777776,0,1,0,3,6,FALSE
31,2022-03-18T16:13:19Z,0.8999999761581421,1.7777777777777777,1080,6,3,3,1,2,2,1,2,3,3,3,2,3,3,3,3,3,2,3,1,1,2,2,1,2,1,2,0,0,0,0,2,3,2,3,3,2,2,2,2,2,2,3,1,2,2,3,3,4,3,3,3,3,1,1,1,3,1,1,2,2,1,2,1,2,1,1,3,1,2,2,2,1.75,0,2.466666666666667,0,2.3333333333333335,0,2.5833333333333335,0,1.6666666666666667,0,1.5714285714285714,0,1.6666666666666667,0,2.108108108108108,0,1,0,0,-0.23037399311562928,-0.13615315543740092,-0.14114775846592847,-0.1386504569516647,1,2,2,2,1,2,2,2.5,0.036960645258067054,5,5,5,5,5,5,5,5,0,0.481822584738033,0,1.13589983848169,2,3,3,2,2,4,4,3,4,3,5,4,3,4,4,4,4,4,3,3,2.4,0,4.2,0,3.4,0,3.6,0,3.7333333333333334,0,2,1,1,4,1,1,1,1,1,1,1,1,1,1,1,1,1,1,1,1,1.2,0,"White, Caucasian, Anglo, European American",0,25,0,1,NA,5,2,0,0,1,0,0,TRUE,TRUE,TRUE,TRUE,TRUE,2,0.7082838709700492,0.5922517241362868,0.5357633333484332,0.7748451612880153,0.6267733333468437,0.638209999994437,1,1,1,0.96875,0.9375,0.9375,0.062,0.375,0.314,0.016,1.253,132.93068633260717,2001.869000013048,0.068,0.363,0.32,0.014,1.208,48.69032952874677,1914.064810343716,0.086,0.332,0.258,0.019,1.967,81.44568220800656,1908.3373576583297,78.31249999999999,86.28571428571428,103.52631578947368,FALSE,362,1.0725925925925925,0,1,0,3,6,FALSE
32,2022-03-18T16:09:59Z,0.8999999761581421,1.6,900,6,2,4,3,1,3,1,1,3,1,1,1,3,4,2,3,3,1,5,1,1,2,3,2,3,3,2,0,0,0,0,2,2,2,2,3,1,1,2,3,2,3,5,1,5,1,4,2,3,5,4,2,4,1,1,2,2,2,1,3,2,3,3,1,1,1,2,3,2,3,1,1,1.75,0,2.2666666666666666,0,2,0,3.0833333333333335,0,2,0,2,0,2,0,2.3513513513513513,0,2,0,0,0.252132086586437,0.1010271103449266,0.07821504497010326,0.08962107765751492,3,2,4,1,1,1,1,1.5,-0.2669090155915809,3,3,4,4,1,1,2,2.5714285714285716,0,0.1928696799855022,1,-0.35594382533822333,3,3,2,3,2,5,3,2,4,2,4,2,2,3,3,2,3,4,3,2,2.6,0,3.6,0,2.4,0,2.8,0,2.933333333333333,0,2,1,1,3,1,1,2,3,1,1,1,2,1,1,1,2,1,2,1,2,1.5,0,"Asian or Asian American (e.g., Chinese, Japanese, and others)",0,25,1,2,NA,5,2,0,0,1,0,0,TRUE,TRUE,TRUE,TRUE,TRUE,2,0.5832250000000495,0.5178999999999796,0.4494812500000262,0.6122031249999854,0.5608133333333457,0.5411937500000058,1,1,1,1,0.967741935483871,1,0.092,0.328,0.735,0.024,2.043,65.67567006907292,1849.920267810942,0.057,0.388,0.465,0.027,1.664,89.2479815389652,1913.6918642080225,0.155,0.347,0.648,0.038,1.288,33.68846986447193,1816.3316062174529,85.125,61.629629629629626,33.89473684210527,FALSE,438,1.2977777777777777,0,1,0,3,6,FALSE
33,2022-03-18T16:04:36Z,0.8999999761581421,1.7777777777777777,864,4,1,5,3,5,4,4,5,5,5,5,5,5,5,1,5,5,5,5,5,4,5,5,5,5,6,1,4,0,NA,NA,5,5,5,5,5,5,5,5,5,4,4,5,4,5,4,3,5,5,5,5,5,5,1,1,1,1,1,4,1,1,1,3,1,2,2,1,5,1,4,1,2,2,0,4.466666666666667,0,5,0,4.5,0,1.6666666666666667,0,1.8571428571428572,0,2.6666666666666665,0,3.5135135135135136,0,3,NA,0,2.7107198836137854,2.7150250395703024,0.5896307986656166,1.6523279191179596,1,1,1,3,1,1,1,7,1.5287759995901447,5,5,5,5,4,3,4,4.428571428571429,0,0.2679972824082019,0,0.6960503877431934,4,4,4,2,3,3,2,2,3,2,5,3,5,2,2,2,4,5,2,3,3.4,0,4,0,2.6,0,2.4,0,3,0,2,2,2,3,2,3,2,4,1,2,1,3,2,1,1,4,2,3,4,3,2.35,0,"White, Caucasian, Anglo, European American",0,24,0,2,NA,5,2,0,0,0,0,0,TRUE,TRUE,TRUE,TRUE,TRUE,3,0.6284366666475931,0.8065031250417233,0.8537343750298023,0.7555037037001716,1.0356031250059605,1.3286551723809077,0.9375,1,1,0.84375,1,0.90625,0.104,0.467,0.216,0.007,2.152,269.72964066996303,2180.4627354767003,0.126,0.356,0.253,0.008,1.564,54.655879994881474,1836.9195698574845,0.061,0.457,0.262,0.011,1.598,200.5652518599215,2227.7136063462244,307.42857142857144,195.5,145.27272727272728,FALSE,304,0.9007407407407407,1,1,0,0,3,FALSE
34,2022-03-18T16:19:49Z,0.8999999761581421,1.7777777777777777,1080,4,4,1,1,2,1,1,1,1,1,1,1,1,1,2,1,2,1,2,1,1,1,1,1,1,1,2,0,0,0,0,1,3,1,2,1,2,1,1,2,2,2,1,2,1,2,1,1,1,2,3,2,1,1,1,1,3,2,1,1,1,1,1,1,1,1,1,1,1,1,1,1,1,0,1.2,0,1.5555555555555556,0,1.6666666666666667,0,1.5,0,1,0,1,0,1.4324324324324325,0,1,0,0,-1.0747596325942455,-1.257056078179005,-0.39960647100849406,-0.8283312745937496,1,1,2,1,1,1,1,2,-0.48817982669274074,5,5,5,5,4,4,4,4.571428571428571,0,1.0808314045082337,0,1.2685418045122843,4,3,3,2,2,4,4,2,4,4,1,4,5,4,4,4,5,4,4,3,2.8,0,3.6,0,4.2,0,3.4,0,3.7333333333333334,0,1,1,1,1,2,1,1,1,1,1,1,2,2,2,1,1,1,1,1,2,1.25,0,"White, Caucasian, Anglo, European American",0,21,0,1,NA,5,2,0,0,1,0,0,TRUE,TRUE,TRUE,TRUE,TRUE,3,0.4041093749997672,0.39789687500009313,0.3858774193544542,0.5227466666661202,0.4398741935479545,0.4879233333339294,1,1,1,0.9375,1,0.9375,0.072,0.261,0.608,0.012,1.684,70.37362142620259,1914.577952216318,0.075,0.278,0.682,0.032,1.825,70.31019331579509,1854.8447609546715,0.078,0.286,0.728,0.011,1.607,121.9219989352809,1976.635294360268,140.33333333333331,57.03125,146.0909090909091,FALSE,434,1.285925925925926,0,1,0,0,3,FALSE
35,2022-03-18T16:18:48Z,0.8999999761581421,2.388888888888889,1440,4,1,5,5,4,5,5,5,5,5,5,5,3,5,2,5,5,3,5,5,2,3,5,5,5,1,1,2,1,0,0,5,5,5,5,5,5,5,5,5,5,5,5,3,5,1,4,5,5,5,5,5,5,4,5,3,5,4,3,1,1,1,5,5,5,1,4,5,1,1,1,3,1.5,0,4.6,0,5,0,4.416666666666667,0,4.333333333333333,0,3,0,3.3333333333333335,0,4.1891891891891895,0,1,0,1,2.6624692756435784,2.740788401773856,0.6788328264823734,1.7098106141281149,2,1,1,1,1,1,1,3.5,0.0920265450903926,1,2,4,2,1,1,1,1.7142857142857142,0,-1.2556761681407096,0,-1.7026539654484583,5,5,5,5,5,2,1,3,3,5,1,1,4,1,1,1,4,4,1,5,5,0,2.4,0,2.4,0,2.6,0,2.466666666666667,0,4,4,1,4,4,4,4,4,4,4,4,4,3,3,4,4,4,4,4,4,3.75,0,"White, Caucasian, Anglo, European American",0,28,0,1,NA,5,2,0,0,1,0,0,TRUE,TRUE,TRUE,TRUE,TRUE,5,0.5655034482807949,0.5675250000022352,0.5994781250059604,0.5825655172405572,0.5952482758637132,0.6641724137807714,0.90625,1,1,0.9354838709677419,0.9354838709677419,0.90625,0.057,0.448,0.383,0.017,1.635,64.82912295918958,1954.008007425507,0.06,0.376,0.354,0.026,1.933,101.53000122482244,1946.702546905205,0.05,0.395,0.31,0.02,1.62,179.9627250408632,2150.630276528859,96.17647058823529,74.34615384615385,81,FALSE,382,1.1318518518518519,0,1,0,3,6,FALSE
36,2022-03-18T16:15:05Z,0.8999999761581421,1.7777777777777777,900,6,4,4,2,1,3,2,1,3,3,1,1,1,3,1,4,1,4,4,5,1,3,4,5,3,0,1,2,2,2,2,1,2,1,3,4,1,1,1,2,1,1,1,1,1,2,3,1,1,3,4,4,5,5,1,1,1,1,2,1,1,1,1,1,3,1,1,1,1,2,1,1,1.25,0,2.066666666666667,0,1.7777777777777777,0,1.9166666666666667,0,2.3333333333333335,0,1.4285714285714286,0,1,0,1.7837837837837838,0,0,2,2,0.776309145899137,0.3662324075318823,2.6781806308956124,1.5222065192137473,1,1,1,1,1,1,2,2,-0.48817982669274074,5,5,5,5,5,5,5,5,0,1.2043418043825058,0,1.5759787198402806,2,4,3,2,4,4,3,3,4,4,3,2,2,5,4,3,4,4,5,1,3,0,3.4,0,3.4,0,3.4,0,3.4,0,2,1,2,1,2,2,3,1,2,1,3,1,1,1,1,1,1,1,1,2,1.5,0,"Asian or Asian American (e.g., Chinese, Japanese, and others)",0,23,0,1,NA,5,2,0,0,2,0,0,TRUE,TRUE,TRUE,TRUE,TRUE,5,0.5453531250022352,0.5642937500048428,0.6520312500000001,0.5845064516144414,0.5262032258010679,0.7032483871021579,1,1,1,0.96875,1,1,0.062,0.484,0.401,0.037,1.808,120.410675355553,1903.6063627008384,0.063,0.362,0.371,0.196,1.331,123.61854571310668,1905.1257533121695,0.074,0.372,0.474,0.028,2.005,82.6455509048921,1908.7467608811864,48.86486486486487,6.790816326530612,71.60714285714285,FALSE,432,1.28,0,1,0,0,3,FALSE
37,2022-03-18T16:17:21Z,0.8999999761581421,1.6,900,7,4,2,2,2,1,2,2,2,2,2,1,1,1,3,1,2,1,1,1,1,1,1,1,1,1,2,0,0,0,0,1,1,1,1,1,1,1,1,1,1,1,1,1,2,1,1,1,1,1,1,1,1,1,1,1,1,1,1,2,1,1,1,1,1,1,1,1,1,1,1,1,1,0,1.7333333333333334,0,1,0,1.0833333333333333,0,1,0,1.1428571428571428,0,1,0,1.054054054054054,0,1,0,0,-1.401547841119736,-1.2439777301901782,-0.39960647100849406,-0.8217921005993362,1,1,2,1,1,1,2,1,-0.7920494875423887,5,5,5,5,4,4,5,4.714285714285714,0,0.9905165020526746,0,1.290934619583138,2,2,2,2,2,4,4,4,5,4,5,5,4,5,4,5,5,4,3,4,2,0,4.6,0,4,0,4.4,0,4.333333333333333,0,1,1,2,1,1,2,2,2,1,1,2,2,1,1,1,1,2,2,1,2,1.45,0,"White, Caucasian, Anglo, European American",0,29,1,2,NA,5,2,0,0,1,0,0,TRUE,TRUE,TRUE,TRUE,TRUE,2,0.5189218750074506,0.4748406250178814,0.5004750000014901,0.6186781249865889,0.5832586206649912,0.5807374999895691,1,1,1,1,0.9354838709677419,1,0.137,0.34,0.895,0.019,1.783,36.555700101145355,1823.479620768119,0.066,0.354,0.534,0.019,1.87,73.5649245875846,1920.188018919643,0.089,0.358,0.543,0.017,1.645,80.72530303601148,1863.9784202375,93.84210526315789,98.42105263157896,96.76470588235294,FALSE,416,1.2325925925925925,0,1,0,0,3,FALSE
38,2022-03-18T15:48:50Z,1,1.7777777777777777,864,7,3,5,1,2,2,2,1,2,2,1,1,1,1,3,1,1,1,1,1,1,1,1,1,1,0,2,0,0,0,0,1,1,1,1,1,1,1,1,1,1,2,1,1,2,1,1,1,1,1,1,1,1,1,1,1,2,1,2,1,1,1,1,1,1,1,1,1,1,1,1,1,1,0,1.7333333333333334,0,1,0,1.1666666666666667,0,1.1666666666666667,0,1.1428571428571428,0,1,0,1.1081081081081081,0,0,0,0,-1.3664564898686766,-1.2203777037441756,-0.6189692744445258,-0.9196734890943508,1,1,2,1,1,1,1,2.5,-0.2947777027650296,5,5,5,5,4,4,5,4.714285714285714,0,0.43348058270556905,0,0.9516498814090404,1,1,1,1,1,4,2,4,4,3,5,4,4,4,4,4,5,4,2,2,1,0,4.4,0,3,0,3.6,0,3.6666666666666665,0,1,1,1,1,1,1,1,1,1,1,2,1,1,1,1,1,1,1,1,1,1.05,0,"Asian or Asian American (e.g., Chinese, Japanese, and others)",0,27,1,2,NA,5,2,0,0,1,0,0,TRUE,TRUE,TRUE,TRUE,TRUE,3,1.00078125,0.8720483870986969,0.8988870967703481,1.045300000000745,0.9342096774155094,0.9707343750037253,1,1,1,1,0.96875,1,0.064,0.775,0.483,0.021,1.427,40.102934991256575,1821.7499041301928,0.064,0.748,0.476,0.036,1.976,138.46310483511692,1969.4602461898507,0.494,0.376,0.788,0.039,1.891,53.9629841944551,1839.098908174802,67.95238095238095,54.88888888888889,48.48717948717949,TRUE,304,0.9007407407407407,1,1,0,3,6,FALSE
39,2022-03-18T16:22:29Z,0.8999999761581421,1.7777777777777777,1080,3,3,2,1,2,2,2,2,2,2,2,2,2,2,3,2,2,2,2,1,1,2,2,2,2,2,2,0,0,0,0,1,2,2,2,2,1,1,2,2,2,4,3,1,2,3,1,2,3,3,3,3,2,1,3,1,3,3,1,3,1,1,2,2,2,1,1,1,2,1,2,1,1.5,0,2,0,1.6666666666666667,0,2.5,0,2.1666666666666665,0,1.7142857142857142,0,1,0,1.972972972972973,0,1,0,0,-0.3181023712432777,-0.39890011653623103,-0.22730066264678367,-0.3131003895915073,1,1,3,1,1,1,1,1,-0.7920494875423887,5,5,5,4,3,3,4,4.142857142857143,0,-1.0267043611971274,0,-0.24734415942600346,2,2,3,2,2,4,3,3,4,2,4,4,4,3,4,4,4,3,4,3,2.2,0,3.8,0,3.4,0,3.4,0,3.533333333333333,0,1,1,1,1,2,1,1,1,1,1,1,2,1,2,1,2,1,2,1,1,1.25,0,"Hispanic of Latino (e.g., Mexican American, Central American, and others)",0,20,0,1,NA,5,2,0,0,1,0,0,TRUE,TRUE,TRUE,TRUE,TRUE,6,0.5693612903225641,0.5043437499999928,0.5339935483870757,0.5920999999999806,0.51095806451612,0.5686838709677329,0.96875,1,1,0.967741935483871,0.96875,0.96875,0.07,0.348,0.39,0.028,1.824,94.42188940266789,1920.1532971280185,0.069,0.305,0.37,0.034,1.718,106.10156755212456,1926.6198737476136,0.065,0.372,0.345,0.019,1.363,165.22043672301393,2037.772117233921,65.14285714285714,50.52941176470588,71.73684210526316,FALSE,304,0.9007407407407407,1,1,0,0,3,FALSE
40,2022-03-18T16:19:29Z,0.8999999761581421,1.6,1120,4,2,3,3,3,4,3,3,3,3,3,2,2,3,2,3,4,3,3,3,1,2,3,3,3,3,2,0,0,0,0,3,3,3,3,3,3,3,3,3,2,3,2,1,3,2,3,3,3,3,3,3,4,1,1,2,3,3,1,3,2,1,3,2,3,3,4,3,2,2,2,2,2,0,2.933333333333333,0,3,0,2.5833333333333335,0,2.3333333333333335,0,2.142857142857143,0,3.3333333333333335,0,2.6216216216216215,0,2,0,0,0.6710350921459582,0.6738194188781177,0.16436794915095845,0.41909368401453806,3,3,4,2,2,3,3,1,0.12023096952112716,2,2,2,2,1,1,2,1.7142857142857142,0,-0.698640248793604,0,-1.3633692272743607,3,3,3,3,3,3,4,2,3,3,5,2,3,3,4,4,4,4,4,3,3,0,3.6,0,3.6,0,3,0,3.4,0,2,2,4,3,4,4,4,3,4,3,4,3,3,4,3,3,4,4,4,4,3.45,0,Black or African American,0,24,1,2,NA,5,2,0,0,1,0,0,TRUE,TRUE,TRUE,TRUE,TRUE,1,0.7777709677426085,0.6299156250003726,0.7652437499989755,0.7912468749997206,0.6580125000011176,0.8894781250013039,1,1,1,1,1,1,0.128,0.321,0.29,0.015,1.873,59.007131277694384,1841.0041802880069,0.204,0.332,0.686,0.061,1.293,73.66926638795044,1861.0729829666643,0.102,0.501,0.405,0.033,1.53,120.76734218967052,1904.753390973684,124.86666666666667,21.196721311475407,46.36363636363636,TRUE,460,1.3629629629629632,0,1,0,0,3,FALSE
42,2022-03-18T16:17:13Z,0.8999999761581421,1.6,900,5,3,4,3,3,3,4,3,4,3,2,4,4,4,2,3,4,2,4,1,1,3,3,3,2,1,2,0,0,0,0,2,4,1,2,3,1,1,1,3,1,1,3,1,2,3,1,2,4,3,4,4,3,1,1,1,1,1,1,1,1,1,2,3,2,1,4,2,1,1,1,1,1,0,3.3333333333333335,0,2,0,2.4166666666666665,0,1.3333333333333333,0,1.5714285714285714,0,2.3333333333333335,0,1.972972972972973,0,1,0,0,0.08764137759709634,0.45610917491374237,-0.39960647100849406,0.028251351952624154,1,1,3,2,1,1,3,3,0.23036276918577817,2,2,2,3,1,1,1,1.7142857142857142,0,-0.4031667131627382,1,-1.1833993946441876,4,4,3,3,4,3,3,2,2,1,5,4,3,3,4,4,5,5,3,4,3.6,0,4.4,0,2.8,0,3,0,3.4,0,2,1,2,4,1,3,3,4,4,1,3,4,2,3,3,4,3,3,1,2,2.65,0,"White, Caucasian, Anglo, European American",0,30,0,1,NA,5,2,0,0,1,0,0,TRUE,TRUE,TRUE,TRUE,TRUE,5,0.5473812499921769,0.4657218749988824,0.5327968750037253,0.5997700000027816,0.5739129032300364,0.6080843749940396,1,1,1,0.9375,0.96875,1,0.245,0.229,0.813,0.018,1.625,53.68516965487087,1839.4974057279717,0.06,0.375,0.621,0.014,1.566,136.4821298041559,1971.3064985881429,0.054,0.418,0.407,0.03,1.88,58.84859285943032,1903.9622447880583,90.27777777777779,111.85714285714286,62.666666666666664,FALSE,438,1.2977777777777777,0,1,0,3,6,FALSE
43,2022-03-18T16:27:40Z,0.8999999761581421,1.7777777777777777,720,6,1,1,1,2,1,2,1,2,2,1,1,1,1,1,1,2,1,1,1,1,1,1,1,1,1,2,0,0,0,0,1,1,1,1,1,1,1,1,1,2,1,1,1,1,2,1,3,1,1,1,1,1,1,2,1,1,1,1,2,2,1,1,1,1,1,1,1,1,1,1,1,1,0,1.3333333333333333,0,1,0,1.3333333333333333,0,1.1666666666666667,0,1.2857142857142858,0,1,0,1.1891891891891893,0,1,0,0,-1.3138194629920872,-1.3596178597755917,-0.39960647100849406,-0.8796121653920429,3,2,3,2,1,3,3,1,-0.1285727914961955,5,5,5,5,5,5,5,5,0,0.5451397626206321,1,1.1744656676745362,2,2,2,2,2,4,4,4,5,3,3,5,4,3,5,4,4,4,3,4,2,0,4,0,3.6,0,4.2,0,3.933333333333333,0,2,1,2,3,2,2,2,3,4,2,1,3,2,3,1,3,1,3,2,3,2.25,0,"Asian or Asian American (e.g., Chinese, Japanese, and others) & Filipino",1,28,1,2,NA,5,2,0,0,1,0,0,TRUE,TRUE,TRUE,TRUE,TRUE,4,0.46940645161223027,0.38555161290543694,0.4652687500002794,0.5346612903221,0.4292586206886275,0.524010000000894,0.96875,1,1,0.96875,0.90625,0.9375,0.055,0.362,0.585,0.021,1.669,21.24721153744618,1864.674843237072,0.044,0.309,0.601,0.022,1.464,56.85588498463746,1945.5218532929944,0.07,0.315,0.458,0.009,1.179,243.565082549341,2117.9642312486676,79.47619047619047,66.54545454545455,131.00000000000003,FALSE,364,1.0785185185185184,0,1,0,0,3,FALSE
45,2022-03-18T16:28:32Z,0.8999999761581421,1.6,900,6,3,2,2,4,2,4,3,2,3,2,2,3,2,3,2,3,2,3,1,1,1,2,2,2,1,2,0,0,0,0,2,2,2,2,3,1,2,3,2,2,2,3,2,2,3,1,3,3,3,4,4,2,1,1,1,3,1,2,1,1,1,2,4,3,1,1,1,2,1,1,1,1.25,0,2.6,0,2.111111111111111,0,2.6666666666666665,0,1.5,0,2,0,1,0,2.081081081081081,0,1,0,0,-0.2479196687411588,-0.08973977009359509,-0.31345356682763886,-0.20159666846061697,1,2,1,1,1,2,2,2,-0.32231065268119236,5,4,4,4,2,2,3,3.4285714285714284,0,0.9182505924020775,0,0.550294134528206,3,3,3,3,3,3,4,3,3,2,5,3,3,2,3,3,3,4,3,3,3,0,3.6,0,3,0,2.8,0,3.1333333333333333,0,3,3,4,2,3,4,4,2,1,3,2,2,3,3,1,2,2,2,2,3,2.55,0,"White, Caucasian, Anglo, European American",0,23,1,2,NA,5,2,0,0,1,0,0,TRUE,TRUE,TRUE,TRUE,TRUE,3,0.5353999999997905,0.5069968749997206,0.5043312500005123,0.629989655172645,0.627171875,0.692066666666915,1,1,1,0.9354838709677419,1,0.9375,0.077,0.368,0.56,0.012,1.975,88.12831083151293,1934.8586960108996,0.216,0.26,0.914,0.018,2.215,72.76190741065113,1855.820352988076,0.066,0.411,0.546,0.012,1.517,64.56580598388162,1913.0710945309445,164.58333333333334,123.05555555555556,126.41666666666666,FALSE,416,1.2325925925925925,0,1,0,0,3,FALSE
46,2022-03-18T16:26:00Z,0.8999999761581421,1.7786458333333333,768,6,3,1,2,1,1,1,1,1,1,1,1,1,1,1,1,2,1,1,1,1,1,1,1,1,2,2,0,0,0,0,1,1,1,1,1,2,2,2,2,1,1,1,1,1,1,1,1,1,1,1,1,1,1,1,1,2,1,1,2,2,1,1,1,1,1,1,1,2,1,2,2,1.75,0,1.1333333333333333,0,1.4444444444444444,0,1,0,1.1666666666666667,0,1.2857142857142858,0,1,0,1.1891891891891893,0,1,0,0,-1.3138194629920872,-1.4469379576258017,-0.14114775846592847,-0.794042858045865,2,1,2,1,1,1,1,1,-0.7920494875423887,5,5,5,5,3,3,5,4.428571428571429,0,0.4002850852868561,0,0.7766255014915452,1,1,1,2,1,4,4,3,4,3,5,4,5,4,4,3,4,1,3,5,1.2,0,3.6,0,3.6,0,4,0,3.7333333333333334,0,1,1,1,1,1,1,1,1,1,1,1,1,1,1,1,1,1,1,1,1,1,0,Black or African American,0,22,1,2,NA,5,2,0,0,1,0,0,TRUE,TRUE,TRUE,TRUE,TRUE,3,0.6880937499701977,0.47356562495976684,0.4993290322519118,0.7439968750327826,0.5911903225760307,0.5985310344860472,1,1,0.96875,1,0.96875,0.9354838709677419,0.055,0.416,0.595,0.017,1.789,101.6985238398854,1990.4769242156424,0.056,0.389,0.579,0.014,1.587,198.84953267745345,2037.445062714228,0.215,0.338,0.641,0.018,1.496,45.73321700205876,1830.487291689092,105.23529411764704,113.35714285714285,83.11111111111111,FALSE,340,1.0074074074074075,0,1,0,0,3,FALSE
47,2022-03-18T16:17:27Z,0.4000000059604645,1.7786458333333333,768,3,2,3,1,4,1,1,2,3,3,1,1,1,3,1,3,1,3,2,1,1,3,4,3,5,5,2,0,0,0,0,1,5,1,1,1,1,1,1,1,1,1,5,1,1,1,1,3,5,5,5,2,2,1,1,1,1,1,1,3,1,1,2,1,1,1,1,1,1,1,2,1,1.25,0,1.9333333333333333,0,1.4444444444444444,0,2.5833333333333335,0,1.1666666666666667,0,1.4285714285714286,0,1,0,1.7297297297297298,0,3,0,0,0.17317654627155374,-0.0976064455755961,0.12527204004442455,0.013832797234414225,1,1,1,1,1,1,1,1,-0.9579186615539372,5,5,5,5,5,4,5,4.857142857142857,0,0.5960613948117253,0,1.1280788247083786,1,2,1,1,1,5,3,5,5,3,5,4,5,3,5,5,5,5,3,5,1.2,0,4.8,0,3.8,0,4.6,0,4.4,0,1,1,1,1,1,1,1,1,1,1,1,1,1,1,1,1,1,1,1,1,1,0,"Hispanic of Latino (e.g., Mexican American, Central American, and others) & White, Caucasian, Anglo, European American",1,29,1,2,NA,5,2,0,0,1,0,0,TRUE,TRUE,TRUE,TRUE,TRUE,3,0.5251129032258666,0.46609062500006987,0.507680645161038,0.610375,0.5389034482759006,0.5958129032257824,0.96875,1,1,1,0.90625,0.96875,0.061,0.403,0.591,0.019,1.813,106.300508712225,1937.240493124913,0.056,0.377,0.678,0.006,0.971,66.71810795154822,1960.590538708513,0.121,0.342,0.686,0.01,1.257,139.52173423772524,1965.856249181748,95.42105263157895,161.83333333333331,125.69999999999999,FALSE,344,1.0192592592592593,0,1,0,0,3,FALSE
48,2022-03-18T16:26:01Z,0.800000011920929,1.7777777777777777,900,6,3,3,4,3,2,3,4,3,3,4,2,4,2,3,5,3,2,3,3,3,2,3,1,2,2,2,0,0,0,0,3,2,2,5,3,3,2,2,3,3,2,3,4,4,5,3,4,3,3,4,3,4,3,3,1,2,3,4,3,4,3,3,3,2,3,3,2,2,3,3,4,3,0,3.2,0,2.7777777777777777,0,3.4166666666666665,0,2.6666666666666665,0,3.142857142857143,0,2.6666666666666665,0,3.027027027027027,0,1,0,0,0.7719227269927544,0.8580962920439889,0.28961676243834755,0.5738565272411682,3,3,3,3,4,4,2,1,0.28610014353267543,3,3,3,3,3,2,3,2.857142857142857,0,0.34904059506318114,0,-0.10601640787303052,1,1,1,1,1,3,4,2,3,1,3,3,2,3,4,3,3,1,4,2,1,0,2.6,0,2.8,0,2.8,0,2.7333333333333334,0,2,3,4,2,2,2,3,3,2,2,3,1,1,1,1,2,1,1,1,1,1.9,0,"White, Caucasian, Anglo, European American",0,30,1,2,NA,5,2,0,0,1,0,0,TRUE,TRUE,TRUE,TRUE,TRUE,5,0.6233225806451613,0.55603125,0.62909375,0.7048387096774194,0.6199032258064516,0.6895666666666667,1,1,1,1,1,1,0.194,0.342,0.672,0.037,1.601,44.06708405324172,1826.2814582706587,0.091,0.396,0.591,0.025,1.866,25.91744849895192,1807.9404218580544,0.085,0.44,0.472,0.015,1.465,32.8965825117567,1813.9118606585507,43.270270270270274,74.64,97.66666666666667,FALSE,328,0.9718518518518519,0,1,0,0,3,FALSE
50,2022-03-18T16:24:10Z,1,1.6,900,8,4,3,2,5,3,4,2,2,2,3,1,2,3,3,3,3,2,1,1,1,2,2,2,1,3,2,0,0,0,0,2,3,2,3,4,1,3,3,1,2,2,2,1,2,2,3,2,2,2,1,3,2,1,3,1,4,3,1,2,1,1,2,3,2,2,3,1,2,1,1,1,1.25,0,2.7333333333333334,0,2.4444444444444446,0,2,0,2.3333333333333335,0,1.7142857142857142,0,2,0,2.108108108108108,0,2,0,0,-0.3926714926517789,-0.1288764806165501,-0.09409076339160714,-0.11148362200407863,2,1,4,2,1,1,2,1.5,-0.2669090155915809,3,3,3,3,2,2,3,2.7142857142857144,0,-0.24706573651580854,0,-0.5465011997405017,2,2,2,2,1,4,5,4,3,3,4,4,3,4,3,4,4,4,4,4,1.8,0,4,0,3.8,0,3.6,0,3.8,0,2,1,2,2,3,1,1,2,1,2,3,3,2,3,1,3,1,2,1,2,1.9,0,"White, Caucasian, Anglo, European American",0,25,1,1,NA,5,2,0,0,0,0,0,TRUE,TRUE,TRUE,TRUE,TRUE,1,0.5367500000000036,0.47984375,0.5463437500000009,0.616031249999989,0.5723870967741916,0.6695937499999982,1,1,1,1,0.96875,1,0.12,0.316,0.499,0.014,1.599,64.40332468759053,1848.6681624534947,0.073,0.336,0.564,0.011,1.494,142.4693596890736,1976.463452782192,0.117,0.368,0.693,0.012,1.166,52.46055418107974,1833.7855326278725,114.21428571428571,135.8181818181818,97.16666666666666,FALSE,420,1.2444444444444445,0,1,0,0,3,FALSE
51,2022-03-18T16:26:37Z,0.8999999761581421,1.7775,1200,6,3,2,2,2,1,4,3,1,2,2,2,2,1,2,2,2,2,2,5,1,1,1,1,2,0,1,0,0,1,0,1,1,1,1,2,2,2,1,1,3,2,1,1,1,3,1,2,1,1,1,1,4,1,1,1,2,1,1,1,1,1,1,2,2,1,1,1,1,1,1,1,1,0,2,0,1.3333333333333333,0,1.5,0,1.6666666666666667,0,1.2857142857142858,0,1,0,1.4054054054054055,0,0,0,0,-0.6054128096113264,-0.5921253330628783,-0.6189692744445258,-0.605547303753702,2,4,3,2,2,2,3,4.5,1.308176663003557,5,5,5,4,2,2,4,3.857142857142857,0,-0.33738063897136766,0,0.0177103420150915,3,3,4,3,4,2,3,3,4,2,1,3,4,3,4,2,3,3,2,2,3.4,0,2.4,0,2.6,0,3.2,0,2.7333333333333334,0,1,1,1,1,3,1,1,1,1,1,2,1,1,1,1,1,1,1,1,2,1.2,0,"Hispanic of Latino (e.g., Mexican American, Central American, and others)",0,27,0,1,NA,5,2,0,0,0,0,0,TRUE,TRUE,TRUE,TRUE,TRUE,3,0.37078125,0.36346875,0.40228125,0.48974074074074075,0.43143478260869567,0.5100416666666666,1,1,1,0.84375,0.71875,0.7741935483870968,0.056,0.291,0.557,0.015,1.984,80.493993465503,1929.6129398054295,0.046,0.266,0.54,0.011,1.566,122.78475643102826,2045.3319635345192,0.06,0.272,0.639,0.015,2.01,85.71783341017517,1997.372408307387,132.26666666666668,142.36363636363637,134,FALSE,325,0.9629629629629629,0,1,0,9,12,FALSE
52,2022-03-18T16:29:37Z,0.8999999761581421,1.7777777777777777,720,6,2,3,2,4,1,4,4,2,4,3,3,4,4,1,3,2,1,4,2,1,1,2,3,2,0,1,1,0,1,0,1,2,4,1,4,1,3,3,2,2,1,2,1,4,3,1,4,2,2,2,2,4,2,1,1,3,2,1,1,1,1,2,2,3,1,1,3,1,1,1,1,1,0,2.933333333333333,0,2.3333333333333335,0,2.1666666666666665,0,2.1666666666666665,0,1.5714285714285714,0,1.6666666666666667,0,2.054054054054054,0,0,0,0,-0.1031678448305387,0.15314383541318272,-0.6189692744445258,-0.23291271951567152,5,4,5,3,3,2,3,3.5,1.5019145241885536,1,5,5,5,5,5,4,4.285714285714286,0,-1.2405296635269585,0,-0.3001802339611151,2,3,3,4,3,3,3,3,3,3,3,3,3,5,5,2,3,3,3,3,3,0,3,0,2.8,0,3.8,0,3.2,0,2,1,4,4,1,4,3,4,4,1,2,4,1,2,1,3,1,4,2,3,2.55,0,"Hispanic of Latino (e.g., Mexican American, Central American, and others)",0,28,0,1,NA,5,2,0,0,1,0,0,TRUE,TRUE,TRUE,TRUE,TRUE,4,0.5358499999940395,0.527921875,0.5470312500223518,0.6036935483947877,0.5487124999985099,0.6203838709785092,1,1,1,0.96875,1,1,0.126,0.339,0.627,0.019,1.704,11.673501110544224,1793.5603968384291,0.102,0.348,0.612,0.05,1.984,126.98299230768646,1911.2445904606184,0.068,0.381,0.455,0.019,1.768,59.294507099954835,1886.827180055221,89.6842105263158,39.68,93.05263157894737,FALSE,356,1.0548148148148149,0,1,0,0,3,FALSE
53,2022-03-18T16:33:04Z,0.8999999761581421,1.7777777777777777,720,3,2,5,3,2,3,1,3,3,3,2,1,3,5,2,5,2,5,5,5,1,5,5,5,5,2,2,0,0,0,0,1,3,1,1,1,3,3,3,5,2,3,5,1,4,1,5,2,5,5,5,5,5,1,1,2,1,1,1,3,1,1,1,1,3,1,1,5,1,2,2,1,1.5,0,2.8666666666666667,0,2.3333333333333335,0,3.5833333333333335,0,1.8333333333333333,0,1.5714285714285714,0,2.3333333333333335,0,2.5135135135135136,0,1,0,0,1.8180836361649624,1.4161385840484282,-0.22730066264678367,0.5944189607008222,1,1,2,1,1,1,1,1,-0.874984074548163,5,5,5,5,5,5,5,5,0,1.475286511749183,0,1.7410083003497518,1,1,1,1,1,5,5,5,5,5,5,5,5,5,5,5,5,5,5,5,1,0,5,0,5,0,5,0,5,0,1,1,1,1,1,1,1,1,1,1,1,1,1,1,1,1,1,1,1,1,1,0,"White, Caucasian, Anglo, European American",0,29,1,2,NA,5,2,0,0,1,0,0,TRUE,TRUE,TRUE,TRUE,TRUE,5,0.438754838689681,0.41692187498509886,0.4017687500119209,0.49001724138753167,0.46270645160828866,0.4871551724096824,0.96875,1,1,0.90625,0.96875,0.90625,0.058,0.315,0.728,0.015,1.668,60.882945411000875,1919.008845836485,0.055,0.335,0.754,0.025,1.663,79.07203633563894,1901.6833890915325,0.051,0.329,0.514,0.019,1.677,141.93673415719965,2038.6133377565136,111.2,66.52,88.26315789473685,FALSE,392,1.1614814814814816,0,1,0,0,3,FALSE
54,2022-03-18T16:34:06Z,0.8999999761581421,1.7777777777777777,720,6,4,2,1,1,1,1,1,2,1,1,1,1,1,3,2,1,1,1,1,1,1,2,1,1,2,2,0,0,0,0,1,4,1,2,1,1,4,3,1,1,1,1,1,3,1,1,2,2,2,2,2,2,1,1,1,1,1,1,2,2,1,1,1,1,1,1,1,2,2,2,2,2,0,1.3333333333333333,0,2,0,1.5833333333333333,0,1.1666666666666667,0,1.2857142857142858,0,1,0,1.5135135135135136,0,1,0,0,-1.0221226057176562,-1.1634426399431943,-0.05499485428507328,-0.6092187471141338,1,1,3,1,1,3,2,1,-0.5432457265250663,5,5,5,5,2,2,3,3.857142857142857,0,-0.698640248793604,0,-0.20232909866420362,2,2,2,3,2,4,5,3,4,3,5,4,5,4,4,5,4,5,4,4,2.2,0,4.4,0,4.4,0,3.8,0,4.2,0,1,1,1,1,2,1,1,1,1,1,3,1,1,1,1,1,2,1,1,2,1.25,0,"White, Caucasian, Anglo, European American",0,30,1,2,NA,5,2,0,0,1,0,0,TRUE,TRUE,TRUE,TRUE,TRUE,1,0.599875,0.54271875,0.5488125,0.7033548387096774,0.6355806451612903,0.6475625,1,1,1,1,1,1,0.121,0.38,0.724,0.011,1.383,88.93005156105896,1873.402605783466,0.137,0.365,0.798,0.019,1.93,76.15205846836517,1861.3565136361667,0.075,0.467,0.557,0.011,1.295,147.61828552418498,1933.1954755093743,125.72727272727273,101.57894736842105,117.72727272727273,FALSE,470,1.3925925925925926,0,1,0,0,3,FALSE
56,2022-03-18T16:32:41Z,0.8999999761581421,1.7777777777777777,864,4,4,3,2,2,2,2,3,3,3,2,2,2,4,2,3,2,2,5,1,1,4,5,4,4,1,2,0,0,0,0,1,5,4,4,5,2,3,1,3,2,1,3,1,4,2,2,2,5,5,5,3,4,1,1,1,2,1,1,2,2,1,3,4,2,1,1,3,2,2,2,2,2,0,2.466666666666667,0,3.111111111111111,0,2.9166666666666665,0,1.6666666666666667,0,2.142857142857143,0,1.6666666666666667,0,2.5135135135135136,0,1,0,0,1.0065961384842141,0.6957477767841955,-0.05499485428507328,0.3203764612495611,1,1,2,1,1,1,1,1.5,-0.6815819506204519,5,5,5,5,5,5,5,5,0,1.0237119994713875,0,1.465958999500633,3,2,3,3,3,3,2,5,4,2,3,3,2,4,4,3,4,3,3,3,2.8,0,3.2,0,2.4,0,4,0,3.2,0,1,1,1,2,2,1,1,2,1,1,2,2,1,1,1,2,1,1,1,1,1.3,0,"White, Caucasian, Anglo, European American",0,22,1,2,NA,5,2,0,0,0,0,0,TRUE,TRUE,TRUE,TRUE,TRUE,1,0.5271258064546893,0.44159375000186263,0.4787249999959022,0.6188633333305518,0.4843766666710377,0.5484531250037253,0.96875,1,1,0.967741935483871,0.967741935483871,1,0.132,0.289,0.716,0.025,1.84,28.827116253437623,1812.9428314814252,0.06,0.33,0.608,0.029,1.807,63.0773412426545,1890.297663626901,0.063,0.337,0.266,0.038,1.939,117.1199828268678,1986.2719020320783,73.6,62.3103448275862,51.026315789473685,FALSE,388,1.1496296296296296,0,1,0,3,6,FALSE
57,2022-03-18T16:35:47Z,0.4000000059604645,1.7786458333333333,768,6,3,4,2,3,3,3,4,3,3,3,4,3,4,3,4,3,4,4,2,1,3,3,3,3,1,2,0,0,0,0,2,3,4,4,4,3,4,4,5,3,3,4,2,3,3,3,4,4,4,4,4,4,3,2,1,3,3,2,2,1,1,4,4,2,1,3,4,1,1,1,1,1,0,3.2666666666666666,0,3.6666666666666665,0,3.4166666666666665,0,2.6666666666666665,0,2.2857142857142856,0,2.6666666666666665,0,3.081081081081081,0,1,0,0,1.1316090773161127,1.1291032623989201,-0.39960647100849406,0.364748395695213,3,3,5,2,2,3,3,2.5,0.7833719283100348,4,4,5,5,1,1,3,3.2857142857142856,0,-0.5751298489193319,0,-0.4367109100209476,2,2,3,2,2,4,3,4,5,3,4,3,4,3,4,4,3,3,3,3,2.2,0,3.4,0,3.4,0,3.8,0,3.533333333333333,0,2,1,2,2,2,3,3,3,1,3,2,3,2,2,1,3,2,3,1,3,2.2,0,"White, Caucasian, Anglo, European American",0,28,1,2,NA,5,2,0,0,1,0,0,TRUE,TRUE,TRUE,TRUE,TRUE,5,0.48913548386866046,0.4435096774216621,0.4946031249994412,0.5206612903216192,0.48580322580664387,0.5713533333301545,1,1,1,1,1,0.967741935483871,0.072,0.348,0.513,0.023,2.067,150.22181488607313,1980.4404661382132,0.08,0.332,0.786,0.008,0.891,55.1345440866733,1838.3111992314248,0.097,0.333,0.615,0.048,1.716,46.71407009190331,1830.9958116432124,89.86956521739131,111.375,35.75,FALSE,244,0.7229629629629629,0,1,0,0,3,FALSE
58,2022-03-18T16:36:09Z,0.8999999761581421,1.6,800,6,2,3,2,2,2,2,2,2,1,2,1,1,1,2,1,1,1,2,1,1,1,2,2,1,0,2,0,0,0,0,1,2,1,1,1,1,1,1,2,1,1,1,1,1,1,1,1,1,1,2,2,1,1,1,1,2,1,1,1,1,1,1,1,1,1,2,1,1,1,1,1,1,0,1.6666666666666667,0,1.2222222222222223,0,1.1666666666666667,0,1.1666666666666667,0,1,0,1.3333333333333333,0,1.162162162162162,0,0,0,0,-1.0879188893133926,-1.0621591931124323,-0.6189692744445258,-0.8405642337784791,2,1,3,1,1,2,1,1,-0.6261803135308405,5,4,4,5,2,3,3,3.7142857142857144,0,-0.665444751374891,0,-0.25951274446873984,2,2,3,3,2,4,3,3,4,2,5,4,4,3,3,5,4,4,3,3,2.4,0,4.2,0,3.4,0,3.2,0,3.6,0,2,2,1,1,2,1,1,2,1,1,2,1,2,1,1,2,1,1,1,1,1.35,0,"White, Caucasian, Anglo, European American",0,29,0,1,NA,5,2,0,0,3,0,0,TRUE,TRUE,TRUE,TRUE,TRUE,6,0.7225593750006519,0.5936968750017695,0.6570125000006519,0.7617843749998138,0.7966750000012107,0.7519838709667805,1,1,1,1,1,1,0.084,0.466,0.436,0.018,1.787,37.10328242712246,1821.9904531019008,0.077,0.428,0.415,0.009,1.336,220.95118562427373,2008.0948502187784,0.208,0.352,0.578,0.028,1.321,33.89997758107681,1815.5354455715576,99.27777777777779,148.44444444444446,47.17857142857142,FALSE,316,0.9362962962962963,0,1,0,0,3,FALSE
60,2022-03-18T16:42:53Z,1,1.6,900,4,3,3,2,3,2,3,3,2,4,3,2,3,2,3,3,3,2,3,1,1,1,2,3,3,4,2,0,0,0,0,2,2,2,2,2,1,1,1,2,1,2,4,1,2,1,2,1,4,4,4,2,3,1,4,1,3,2,1,3,4,3,2,1,2,1,1,1,1,2,2,2,1.75,0,2.7333333333333334,0,1.6666666666666667,0,2.3333333333333335,0,2.3333333333333335,0,2.2857142857142856,0,1,0,2.054054054054054,0,2,0,0,-0.1031678448305387,0.06582373756297237,0.07821504497010326,0.07201939126653781,1,1,1,1,1,1,1,1,-0.9579186615539372,5,5,5,5,2,2,5,4.142857142857143,0,1.2946567068380648,0,1.1665725285660418,4,4,4,3,3,3,5,3,3,4,4,5,3,4,4,4,4,4,3,3,3.6,0,4,0,3.8,0,3.4,0,3.7333333333333334,0,2,2,1,2,3,2,2,2,1,2,2,2,1,2,2,2,2,2,2,1,1.85,0,"Asian or Asian American (e.g., Chinese, Japanese, and others)",0,21,1,2,NA,5,2,0,0,1,0,0,TRUE,TRUE,TRUE,TRUE,TRUE,4,0.4765156250074506,0.4315156249850988,0.48867500000447034,0.5484899999936421,0.4867846154341331,0.5219666666543042,1,1,1,0.9375,0.8125,0.84375,0.05,0.342,0.362,0.029,2.062,103.21016345532982,2008.3160730232896,0.045,0.325,0.424,0.015,1.5,47.940389794357955,1988.2962683103644,0.066,0.335,0.523,0.022,2.118,55.393844560971104,1903.530552977482,71.10344827586206,100,96.27272727272727,FALSE,438,1.2977777777777777,0,1,0,3,6,FALSE
62,2022-03-18T16:39:49Z,0.8999999761581421,1.6,900,6,3,2,2,2,2,2,1,1,2,2,2,1,2,2,2,2,2,2,3,2,2,2,2,2,1,1,1,0,0,0,2,2,1,2,2,2,3,2,2,2,2,1,1,2,4,2,4,2,2,3,4,3,3,3,2,3,3,1,2,2,1,1,1,1,2,2,1,2,2,2,2,2,0,1.8,0,2,0,2.4166666666666665,0,2.8333333333333335,0,1.2857142857142858,0,1.6666666666666667,0,2.108108108108108,0,1,0,0,0.013072256188595128,-0.2634949648022902,-0.05499485428507328,-0.15924490954368173,2,1,3,1,1,1,1,1,-0.7091149005366146,4,4,4,4,3,3,4,3.7142857142857144,0,0.2196552803757379,0,0.2795924049485119,3,3,3,3,3,4,3,3,3,4,3,3,4,3,3,3,3,3,2,3,3,0,3.2,0,3.2,0,3,0,3.1333333333333333,0,2,3,2,3,2,3,3,2,2,2,2,2,3,2,2,3,2,2,2,2,2.3,0,Black or African American,0,21,1,2,NA,5,3,0,0,0,1,0,TRUE,TRUE,TRUE,TRUE,TRUE,1,0.620903225806692,0.6089928571430168,0.5805258064512764,0.7734319999995828,0.7162374999995033,0.6654280000001193,0.96875,0.875,0.96875,0.8333333333333334,0.7741935483870968,0.8064516129032258,0.062,0.308,0.235,0.01,1.524,160.14090576774723,2105.575411134309,0.061,0.292,0.148,0.018,2.106,127.2687781869429,2254.552209630224,0.062,0.32,0.255,0.019,2.067,221.7869858237358,2171.560681586156,152.4,117,108.78947368421053,FALSE,354,1.0488888888888888,0,1,0,0,3,FALSE
63,2022-03-18T16:43:26Z,1,1.6,900,6,3,4,3,3,4,4,3,4,3,2,3,2,3,3,4,4,2,2,1,1,1,1,1,1,0,2,0,0,0,0,3,3,3,3,4,2,2,2,2,2,2,1,1,2,3,1,3,1,1,1,1,2,1,1,1,3,2,2,1,3,1,5,2,3,2,3,1,2,1,3,2,2,0,3.2666666666666666,0,2.6666666666666665,0,1.5833333333333333,0,1.6666666666666667,0,2.4285714285714284,0,2,0,2.054054054054054,0,0,0,0,-0.5900603434389878,-0.028773035108088194,-0.274357657721105,-0.1515653464145966,3,3,4,4,3,3,4,4.5,1.8057841850382017,3,3,5,4,3,2,3,3.2857142857142856,0,-0.12355533664153649,0,-0.1616616091718286,2,1,2,2,2,4,4,4,3,3,4,2,3,3,3,3,4,4,4,3,1.8,0,3.6,0,3.4,0,3.2,0,3.4,0,3,1,2,3,3,2,2,3,1,1,3,2,2,2,1,2,1,1,1,2,1.9,0,"White, Caucasian, Anglo, European American",0,29,0,1,NA,5,2,0,0,1,0,0,TRUE,TRUE,TRUE,TRUE,TRUE,6,0.47419999999552964,0.44308125000819565,0.5306387096758811,0.5533107143087046,0.5337999999893123,0.6440709677357828,1,1,1,0.9032258064516129,0.90625,0.96875,0.073,0.371,0.49,0.013,1.564,50.96834464155519,1878.7162527049827,0.05,0.353,0.544,0.007,1.191,99.14924255637015,1987.7460838145164,0.058,0.364,0.564,0.018,1.816,20.00897985015203,1875.8584837469932,120.30769230769232,170.14285714285714,100.8888888888889,FALSE,358,1.0607407407407408,0,1,1,0,3,FALSE
64,2022-03-18T16:08:51Z,1,1.7777777777777777,1080,2,4,2,2,1,2,1,1,1,1,1,1,1,2,1,1,2,1,1,5,1,1,1,1,1,2,2,0,0,0,0,2,1,1,1,2,2,3,3,3,1,2,1,1,1,1,1,1,2,2,2,1,5,1,1,1,2,1,1,2,1,1,1,1,1,1,1,1,1,1,1,1,1,0,1.3333333333333333,0,2,0,1.3333333333333333,0,1.8333333333333333,0,1.1428571428571428,0,1,0,1.5135135135135136,0,1,0,0,-0.7786763564134319,-0.9997174564740503,-0.39960647100849406,-0.6996619637412722,1,1,3,1,1,1,1,1,-0.7920494875423887,5,4,4,3,3,3,5,3.857142857142857,0,0.18645978295702492,0,0.33677605075304806,3,2,3,3,2,4,2,3,3,3,5,2,5,3,3,3,2,5,3,1,2.6,0,3.6,0,3.2,0,2.6,0,3.1333333333333333,0,1,1,2,3,2,2,2,3,1,2,2,3,2,2,1,3,2,2,1,2,1.95,0,"Asian or Asian American (e.g., Chinese, Japanese, and others)",0,27,1,2,NA,5,2,0,0,1,0,0,TRUE,TRUE,TRUE,TRUE,TRUE,1,0.4587741935483871,0.39126666666666665,0.44593548387096776,0.5558461538461539,0.4573333333333333,0.54964,1,0.967741935483871,0.96875,0.8125,0.84375,0.78125,0.051,0.319,0.412,0.013,1.737,100.3810451880758,1997.9994498632336,0.042,0.319,0.548,0.013,1.337,92.90906150740572,2042.4563514631484,0.052,0.343,0.467,0.013,1.756,96.55538361404348,2016.5843651974133,133.61538461538464,102.84615384615385,135.0769230769231,FALSE,298,0.882962962962963,0,1,0,6,9,FALSE
65,2022-03-18T16:44:18Z,0.8999999761581421,1.6,800,4,4,2,2,2,2,2,2,3,2,2,3,2,3,3,2,3,2,1,1,1,1,1,1,2,0,2,0,0,0,0,2,3,2,2,2,3,4,2,1,1,2,3,1,2,3,3,1,2,1,2,1,1,2,1,1,1,1,2,1,1,1,1,1,2,1,1,1,1,1,1,1,1,0,2.3333333333333335,0,2.3333333333333335,0,1.8333333333333333,0,1.1666666666666667,0,1.2857142857142858,0,1,0,1.6756756756756757,0,0,0,0,-0.8356998021964036,-0.6014670101977543,-0.6189692744445258,-0.61021814232114,1,1,3,1,1,1,1,1,-0.7920494875423887,5,5,5,5,2,3,5,4.285714285714286,0,1.384971609293624,0,1.2989850639765426,4,4,3,3,4,2,3,3,2,2,4,2,3,3,3,1,3,3,3,3,3.6,0,2.8,0,2.4,0,2.8,0,2.6666666666666665,0,1,3,4,4,3,4,2,4,4,1,2,4,2,4,1,4,1,4,4,3,2.95,0,Black or African American,0,25,0,1,NA,5,2,0,0,0,0,0,TRUE,TRUE,TRUE,TRUE,TRUE,3,0.4658935483847895,0.4624533333301544,0.4771968750031665,0.5395806451564835,0.5069466666648785,0.53515,1,1,1,0.96875,0.9375,1,0.089,0.321,0.561,0.017,1.345,43.00615861750992,1825.5300032292057,0.055,0.345,0.553,0.021,1.625,136.14420920941015,1986.3757000099904,0.065,0.362,0.646,0.016,1.637,46.05243658312589,1873.4651717701888,79.11764705882352,77.38095238095238,102.3125,FALSE,380,1.125925925925926,0,1,0,0,3,FALSE
66,2022-03-18T16:42:50Z,1,1.6,900,6,3,3,2,3,2,3,3,2,2,2,2,2,3,2,2,2,2,3,1,1,1,2,1,1,1,1,3,0,2,0,2,2,1,2,2,1,1,1,1,2,2,2,2,2,2,2,3,2,3,4,4,2,1,1,1,3,2,1,1,1,1,1,2,2,1,1,1,2,2,2,2,2,0,2.3333333333333335,0,1.4444444444444444,0,2.5,0,1.6666666666666667,0,1.2857142857142858,0,1,0,1.7567567567567568,0,1,0,0,-0.6207652757836646,-0.4569168482159875,-0.05499485428507328,-0.2559558512505304,2,2,2,4,2,2,2,2,0.17529686935345262,5,5,5,5,3,3,4,4.285714285714286,0,1.475286511749183,0,1.3539949241463662,3,3,3,2,2,3,4,4,4,3,4,3,4,2,4,4,3,4,3,3,2.6,0,3.4,0,3.6,0,3.4,0,3.466666666666667,0,3,1,1,3,3,1,3,3,1,2,1,2,2,2,1,2,1,2,2,2,1.9,0,"Asian or Asian American (e.g., Chinese, Japanese, and others)",0,22,1,2,NA,5,2,0,0,2,0,0,TRUE,TRUE,TRUE,TRUE,TRUE,6,0.674754838689681,0.5193258064254638,0.5191000000046145,0.6442035714217594,0.5996933333396911,0.5849793103645587,1,1,1,0.875,0.9375,0.90625,0.059,0.349,0.356,0.012,1.437,110.78023405723444,1994.7662465354176,0.065,0.334,0.36,0.01,1.196,38.680797662861515,1882.2230488718328,0.067,0.351,0.221,0.023,2.003,158.0356069185571,2062.2872660316903,119.75,119.6,87.08695652173914,FALSE,432,1.28,0,1,0,3,6,FALSE
67,2022-03-18T16:37:09Z,1,1.7786458333333333,768,6,1,3,3,2,2,1,1,3,3,2,1,2,3,2,3,3,4,4,3,1,2,3,3,2,5,2,0,0,0,0,2,3,3,2,2,1,3,2,2,2,2,2,2,3,2,4,3,3,2,3,3,3,2,4,1,4,4,2,5,3,1,2,2,2,3,3,2,2,2,3,2,2.25,0,2.2666666666666666,0,2.2222222222222223,0,2.5833333333333335,0,3,0,2.4285714285714284,0,2.6666666666666665,0,2.5405405405405403,0,3,0,0,0.6995468150374442,0.4019274475314614,0.4698836567678454,0.43590555214965343,2,1,4,2,1,1,1,1,-0.5432457265250663,3,3,3,3,2,2,2,2.5714285714285716,0,-0.8792700537047221,0,-1.0089728961699453,2,2,2,1,1,4,4,4,4,3,4,3,4,4,4,4,3,4,3,3,1.6,0,3.6,0,3.6,0,3.8,0,3.6666666666666665,0,1,2,2,3,3,2,3,3,3,1,2,2,3,3,1,2,1,2,1,1,2.05,0,"White, Caucasian, Anglo, European American",0,29,0,1,NA,5,2,0,0,1,0,0,TRUE,TRUE,TRUE,TRUE,TRUE,4,0.625438709666652,0.6262125000040978,0.748028124999255,0.715453125,0.6122687499970197,0.8122733333329359,1,1,1,1,1,0.967741935483871,0.084,0.399,0.258,0.012,1.375,76.2670527399362,1900.2495964013376,0.084,0.382,0.372,0.154,1.477,65.95829286454523,1851.167943721275,0.225,0.266,0.629,0.014,1.431,33.90021292650282,1817.3838257616333,114.58333333333333,9.590909090909092,102.21428571428572,FALSE,304,0.9007407407407407,1,1,0,0,3,FALSE
68,2022-03-18T16:47:20Z,0.8999999761581421,1.6,900,4,3,4,2,3,2,3,2,2,2,1,1,2,2,2,2,2,2,3,1,1,1,2,2,1,2,2,0,0,0,0,1,1,1,1,1,1,1,1,1,1,1,1,1,1,1,1,2,1,3,2,2,2,1,1,1,3,3,1,3,1,1,1,1,1,1,1,1,1,1,2,1,1.25,0,2.1333333333333333,0,1,0,1.4166666666666667,0,1.8333333333333333,0,1.2857142857142858,0,1,0,1.3243243243243243,0,1,0,0,-0.8203473360240647,-0.6784620964778383,-0.31345356682763886,-0.49595783165273855,2,1,3,1,1,2,1,3,0.14742818218000403,5,5,5,5,2,2,3,3.857142857142857,0,0.6473058850354002,0,0.6174725797407661,2,2,2,2,2,4,4,4,4,3,5,4,5,4,4,5,3,5,4,3,2,0,4.2,0,4.2,0,3.8,0,4.066666666666666,0,1,2,1,1,1,1,2,2,1,1,1,2,1,1,1,2,1,2,1,1,1.3,0,"White, Caucasian, Anglo, European American",0,21,1,3,NA,5,2,0,0,1,0,0,TRUE,TRUE,TRUE,TRUE,TRUE,3,0.526421875,0.5147906250040978,0.5360406250078231,0.6102806451628285,0.5645124999992549,0.6163312500026077,1,1,1,0.96875,1,1,0.201,0.285,0.811,0.018,1.562,18.306645152549216,1801.6325263299811,0.086,0.397,0.72,0.028,1.541,24.6554756918241,1810.567708300113,0.123,0.349,0.799,0.016,1.755,147.8085979563334,1972.6771035738857,86.77777777777779,55.035714285714285,109.68749999999999,FALSE,453,1.3422222222222222,0,1,0,0,3,FALSE
69,2022-03-18T16:43:12Z,0.8999999761581421,1.7777777777777777,864,6,2,2,2,2,2,2,1,2,2,2,2,2,2,3,2,3,2,2,1,1,1,1,1,2,2,2,0,0,0,0,2,3,3,4,4,3,4,3,3,2,3,1,1,3,2,4,3,2,3,1,2,3,3,1,2,2,2,2,1,1,2,2,2,2,2,2,2,2,2,2,2,2,0,2.066666666666667,0,3.2222222222222223,0,2.25,0,2.1666666666666665,0,1.7142857142857142,0,2,0,2.3513513513513513,0,1,0,0,-0.31590916179008643,-0.36831841559995226,-0.05499485428507328,-0.21165663494251277,2,2,4,2,1,2,2,2,0.09236228234767849,3,4,4,3,3,2,3,3.142857142857143,0,-0.698640248793604,0,-0.5893424748675894,2,2,2,2,2,4,3,4,3,2,2,2,3,2,3,4,2,2,3,3,2,0,2.4,0,3,0,3,0,2.8,0,2,2,2,2,2,2,2,3,3,2,2,3,3,2,2,3,1,2,2,3,2.25,0,"White, Caucasian, Anglo, European American",0,28,0,1,NA,5,2,0,0,0,0,0,TRUE,TRUE,TRUE,TRUE,TRUE,5,0.5463516129032379,0.587981250000128,0.6313419354837988,0.6030700000002359,0.6269937499998487,0.690983870967802,1,1,0.96875,0.967741935483871,1,0.96875,0.067,0.364,0.244,0.042,1.699,199.0839177028716,2066.781878741251,0.148,0.318,0.566,0.021,1.247,5.9973052763409695,1787.0146793307724,0.059,0.385,0.413,0.02,1.654,141.82426622221342,1972.3465434046373,40.45238095238095,59.38095238095238,82.69999999999999,FALSE,541,1.6029629629629631,0,1,0,3,6,FALSE
70,2022-03-18T16:45:34Z,0.8999999761581421,1.7777777777777777,864,4,3,2,2,2,1,4,3,1,2,1,1,1,2,2,1,1,2,3,5,1,1,2,1,1,0,2,0,0,0,0,1,1,1,1,1,1,1,1,1,3,1,1,1,1,1,1,1,1,2,2,2,4,1,5,5,2,3,1,1,1,1,1,1,1,1,1,1,2,1,1,1,1.25,0,1.7333333333333334,0,1,0,1.4166666666666667,0,3.3333333333333335,0,1,0,1,0,1.5135135135135136,0,0,0,0,-0.45408135734113264,-0.606777016148105,-0.5328163702636706,-0.5697966932058878,5,5,5,3,5,5,3,2.5,1.6127177983677767,4,4,4,4,1,3,3,3.2857142857142856,0,0.09614488050146584,0,-0.027844510379484363,2,2,2,2,2,4,4,4,5,1,5,3,3,5,3,5,4,4,5,3,2,0,4,0,3.6,0,4,0,3.8666666666666667,0,2,1,1,1,1,1,1,1,1,1,1,1,1,1,1,1,1,1,1,1,1.05,0,"White, Caucasian, Anglo, European American",0,18,1,2,NA,5,2,0,1,0,0,1,TRUE,TRUE,TRUE,TRUE,TRUE,6,0.5177593749761581,0.49789062498509884,0.4808218750357628,0.5965724138227002,0.5481884615237896,0.5881071428741728,1,1,1,0.9354838709677419,0.8387096774193549,0.875,0.058,0.354,0.478,0.006,1.189,65.43733367405785,1963.2355629248032,0.056,0.34,0.474,0.012,1.572,81.40962573341727,1950.5356995845648,0.061,0.375,0.398,0.025,1.959,77.97154554637486,1946.17909201749,198.16666666666669,131,78.36,FALSE,376,1.114074074074074,0,1,0,0,3,FALSE
71,2022-03-18T16:30:29Z,0.8999999761581421,1.7786458333333333,768,4,2,3,1,1,1,1,1,3,2,1,1,2,1,3,2,2,1,3,1,1,2,3,2,2,0,2,0,0,0,0,1,1,3,2,3,1,1,1,1,2,1,2,1,2,3,3,3,2,2,3,2,3,2,1,1,4,1,1,1,4,2,5,2,2,1,1,1,1,2,1,4,2,0,1.6666666666666667,0,1.5555555555555556,0,2.1666666666666665,0,2,0,2.4285714285714284,0,1,0,1.945945945945946,0,0,0,0,-0.2544992971007324,-0.5016585650198677,-0.274357657721105,-0.38800811137048635,1,1,2,1,1,1,1,1.5,-0.6815819506204519,5,5,5,4,3,2,4,4,0,0.6863762972672843,0,0.7186726334341398,2,2,2,3,2,4,4,4,5,3,5,4,3,4,4,5,5,5,4,3,2.2,0,4.6,0,3.8,0,4,0,4.133333333333334,0,1,1,1,1,2,1,4,2,2,2,4,3,1,1,1,3,1,1,1,2,1.75,0,Black or African American,0,24,1,2,NA,5,2,0,0,1,0,0,TRUE,TRUE,TRUE,TRUE,TRUE,5,0.6805874999761582,0.5735781249403954,0.6803562499284744,0.7489290320488714,0.6531156249642373,0.792200000166893,1,1,1,0.96875,1,1,0.124,0.415,0.463,0.008,1.201,78.05135740699745,1860.9715326343976,0.189,0.284,0.643,0.015,1.417,71.410777246156,1855.028559168828,0.072,0.478,0.359,0.015,1.483,67.61117617039122,1894.6444995698996,150.125,94.46666666666667,98.86666666666667,FALSE,344,1.0192592592592593,0,1,0,0,3,FALSE
72,2022-03-18T16:51:35Z,0.8999999761581421,1.6,900,6,3,3,1,4,1,4,2,3,3,1,3,5,3,2,4,2,2,4,1,1,3,4,2,5,4,2,0,0,0,0,2,1,1,1,1,2,5,1,4,4,2,4,1,2,1,1,1,5,5,5,5,1,1,1,1,3,1,1,3,4,1,2,3,1,1,1,3,2,1,2,2,1.75,0,2.7333333333333334,0,2,0,3,0,1.3333333333333333,0,2.142857142857143,0,1.6666666666666667,0,2.2162162162162162,0,2,0,0,0.48899870753108776,0.46407418383926874,0.07821504497010326,0.271144614404686,2,2,3,1,1,2,1,1,-0.5432457265250663,5,5,5,5,5,5,5,5,0,1.384971609293624,0,1.6859984401799282,3,4,3,3,3,2,5,4,4,5,5,5,5,5,5,5,5,5,5,5,3.2,0,4.4,0,5,0,4.6,0,4.666666666666667,0,3,3,3,3,4,3,3,3,3,4,3,1,2,1,1,1,2,3,2,3,2.55,0,"White, Caucasian, Anglo, European American",0,24,1,2,NA,5,2,0,0,1,0,0,TRUE,TRUE,TRUE,TRUE,TRUE,5,0.44041875000018627,0.43377812499925494,0.4494374999953434,0.5404037037006131,0.5231354838696218,0.5365483870967742,1,1,1,0.84375,1,0.96875,0.075,0.343,0.724,0.022,2.005,74.20275687405555,1900.1126209585016,0.066,0.341,0.726,0.014,1.455,148.69457356834602,1937.5291668728903,0.055,0.356,0.658,0.021,2.182,42.46644293038855,1905.7724337070897,91.13636363636364,103.92857142857143,103.9047619047619,FALSE,394,1.1674074074074074,0,1,0,0,3,FALSE
76,2022-03-18T16:53:16Z,0.8999999761581421,1.7777777777777777,1080,4,3,1,1,1,1,1,5,1,1,1,1,3,1,2,1,4,1,1,1,1,1,1,1,1,0,2,0,0,0,0,1,3,2,1,1,1,1,1,1,1,1,1,1,1,1,1,2,1,1,2,1,2,1,1,1,1,1,1,1,1,1,1,1,1,1,1,1,1,1,1,1,1,0,1.6666666666666667,0,1.3333333333333333,0,1.1666666666666667,0,1.1666666666666667,0,1,0,1,0,1.162162162162162,0,0,0,0,-1.331365138617617,-1.2258843765815763,-0.6189692744445258,-0.922426825513051,2,1,4,1,1,1,1,1.5,-0.4327781896031293,4,4,4,4,3,3,5,3.857142857142857,0,-0.3222341343576166,0,0.026935919170246264,1,3,2,1,1,5,1,5,3,3,5,5,5,5,5,5,5,1,5,1,1.6,0,4.2,0,3.8,0,3.8,0,3.933333333333333,0,1,1,1,4,1,2,1,1,2,1,1,2,2,2,1,3,1,2,1,1,1.55,0,"White, Caucasian, Anglo, European American",0,20,0,1,NA,5,2,0,0,1,0,0,TRUE,TRUE,TRUE,TRUE,TRUE,5,0.5975999999995033,0.5145161290332194,0.5506000000005588,0.64732413793124,0.5782733333334327,0.6200633333330353,0.9375,0.96875,1,0.90625,0.9375,0.9375,0.059,0.421,0.446,0.021,1.747,124.9862433918468,1969.0474277493372,0.052,0.414,0.479,0.015,1.348,121.21317385772176,2015.0377696702924,0.047,0.47,0.369,0.023,1.746,144.2436739412969,2089.295921497155,83.19047619047619,89.86666666666667,75.91304347826087,FALSE,304,0.9007407407407407,1,1,0,0,3,FALSE
78,2022-03-18T16:25:53Z,0.8999999761581421,1.6,900,6,3,2,2,2,2,2,1,1,2,2,1,2,2,2,2,2,1,1,1,1,1,1,1,1,0,1,1,0,0,0,1,2,2,2,3,1,1,1,1,2,1,1,1,3,1,2,2,1,1,1,1,1,1,1,1,2,1,1,1,1,1,1,1,1,1,1,1,1,1,1,1,1,0,1.8,0,1.5555555555555556,0,1.4166666666666667,0,1.1666666666666667,0,1,0,1,0,1.2972972972972974,0,0,0,0,-1.2436367604899685,-1.1086709118997626,-0.6189692744445258,-0.8638200931721443,3,3,3,2,3,3,2,1,0.037296382515353055,5,5,5,5,3,3,5,4.428571428571429,0,0.7376207874909593,0,0.9820931408732985,2,2,2,2,2,4,5,4,4,4,4,5,4,3,4,2,4,4,3,2,2,0,4.2,0,3.6,0,3.4,0,3.7333333333333334,0,2,1,1,3,4,2,2,3,3,1,2,3,1,2,1,2,1,2,2,2,2,0,Black or African American,0,30,1,2,NA,5,2,0,0,1,0,0,TRUE,TRUE,TRUE,TRUE,TRUE,6,0.5929375,0.49665625,0.5120333333333333,0.6497,0.5590625,0.5707741935483871,1,1,1,0.967741935483871,1,0.96875,0.056,0.398,0.496,0.024,1.667,173.5878660034323,2005.3841677881016,0.175,0.258,0.767,0.011,1.197,62.731366625436735,1844.3720115663375,0.068,0.44,0.436,0.018,1.485,89.50835214644171,1915.0426077107277,69.45833333333333,108.81818181818183,82.50000000000001,FALSE,490,1.451851851851852,0,1,0,3,6,FALSE
80,2022-03-18T16:51:58Z,0.8999999761581421,1.6,900,4,3,4,1,4,1,5,2,2,2,2,1,1,3,2,3,2,2,4,1,2,1,2,2,3,0,1,1,0,2,0,1,2,1,3,2,1,4,3,2,2,2,4,1,1,2,2,5,4,4,5,5,4,1,1,1,1,1,2,1,3,1,1,3,3,1,1,1,1,1,1,2,1.25,0,2.3333333333333335,0,2.111111111111111,0,3.0833333333333335,0,1.5,0,2,0,1,0,2.2162162162162162,0,0,0,0,0.08325495869071374,0.01655868235694198,-0.5328163702636706,-0.2581288439533643,1,1,1,1,1,1,1,1,-0.9579186615539372,5,5,5,5,3,1,5,4.142857142857143,0,1.6378673238553392,0,1.3756185169643507,4,4,3,2,4,2,4,4,4,3,5,5,4,3,4,1,5,5,3,2,3.4,0,4.4,0,3,0,3.4,0,3.6,0,2,3,3,4,4,2,3,3,4,2,3,2,2,4,1,3,1,3,4,3,2.8,0,"White, Caucasian, Anglo, European American",0,24,1,2,NA,5,2,0,0,1,0,0,TRUE,TRUE,TRUE,TRUE,TRUE,5,0.5270624999925494,0.4617125000022352,0.5015000000074505,0.5934899999976158,0.5380586206871888,0.5812125000022351,1,1,1,0.967741935483871,0.9354838709677419,1,0.126,0.3,0.648,0.01,1.232,88.6815591308823,1873.780165650784,0.065,0.317,0.465,0.018,1.874,77.92480196011309,1921.5278583811112,0.071,0.373,0.48,0.014,1.453,67.40703547501437,1891.2846374084363,123.2,104.11111111111113,103.78571428571429,FALSE,434,1.285925925925926,0,1,0,0,3,FALSE
81,2022-03-18T16:52:07Z,0.8999999761581421,1.6,900,4,3,2,3,3,2,3,1,4,2,2,2,2,2,2,3,2,2,2,1,1,1,1,1,1,0,1,1,0,0,0,2,2,2,2,2,2,3,3,1,3,4,3,3,2,4,3,2,2,3,3,2,2,1,1,1,1,1,2,1,1,1,2,2,2,1,1,1,1,2,2,2,1.75,0,2.3333333333333335,0,2.111111111111111,0,2.8333333333333335,0,1.1666666666666667,0,1.5714285714285714,0,1,0,2,0,0,0,0,-0.6251516946900472,-0.45986685152173795,-0.3605105619019602,-0.41018870671184904,2,2,3,1,1,2,1,1,-0.5432457265250663,5,5,5,5,3,3,5,4.428571428571429,0,0.7044252900722463,0,0.9618741114371575,4,4,4,2,2,2,3,3,2,2,4,3,2,5,3,4,2,4,1,3,3.2,0,3,0,2.4,0,3.2,0,2.8666666666666667,0,4,2,4,3,4,4,3,2,3,3,3,3,2,4,3,3,3,4,3,3,3.15,0,Black or African American,0,19,1,2,NA,5,4,0,0,2,1,0,TRUE,TRUE,TRUE,TRUE,TRUE,3,0.5938548387116002,0.4948124999990687,0.5750343750016764,0.6146593749998137,0.5368966666688522,0.6037548387117924,1,1,1,1,0.967741935483871,0.96875,0.063,0.393,0.354,0.066,1.923,44.758932494292225,1868.919955626468,0.053,0.388,0.491,0.039,1.84,45.82127648288013,1871.775208506884,0.112,0.372,0.512,0.04,1.587,76.56999466016399,1858.43588229249,29.136363636363637,47.17948717948718,39.675,FALSE,442,1.3096296296296297,0,1,0,0,3,FALSE
83,2022-03-18T16:33:39Z,1,1.7777777777777777,864,7,3,2,2,2,1,1,2,2,1,1,1,1,2,2,2,2,1,1,1,1,2,1,2,1,0,2,0,0,0,0,1,1,1,1,1,1,1,1,1,1,1,1,1,1,1,1,1,1,2,1,3,1,1,1,1,1,1,1,1,1,1,1,1,2,1,1,1,1,1,1,1,1,0,1.6,0,1,0,1.25,0,1,0,1.1428571428571428,0,1,0,1.1081081081081081,0,0,0,0,-1.204158990332527,-1.16944097999822,-0.6189692744445258,-0.8942051272213729,1,1,2,1,1,2,1,1,-0.7920494875423887,5,5,5,5,3,2,5,4.285714285714286,0,1.2946567068380648,0,1.2439752038067187,1,3,2,3,2,5,5,4,4,1,5,5,2,5,5,4,5,4,5,5,2.2,0,4.8,0,3.4,0,4.6,0,4.266666666666667,0,2,1,1,2,2,1,3,1,1,3,2,2,1,2,2,2,1,1,2,2,1.7,0,"White, Caucasian, Anglo, European American",0,23,1,2,NA,5,2,0,1,3,0,1,TRUE,TRUE,TRUE,TRUE,TRUE,1,0.5353812500000932,0.4559999999999418,0.45418437499998254,0.5898777777777502,0.5382774193548868,0.5295032258065597,1,1,1,0.8709677419354839,0.96875,0.96875,0.064,0.335,0.506,0.03,2.024,105.49277789258088,1928.8784521024393,0.077,0.288,0.502,0.014,1.652,86.37450143071842,1911.364996800208,0.062,0.346,0.425,0.017,1.859,95.63489482617835,1958.2796030001864,67.46666666666667,117.99999999999999,109.35294117647058,FALSE,788,2.334814814814815,0,1,0,0,3,FALSE
84,2022-03-18T16:52:32Z,0.8999999761581421,1.6,800,3,3,1,1,1,3,1,1,1,1,1,1,1,1,3,1,1,1,2,1,1,1,1,1,1,0,2,0,0,0,0,1,1,1,1,1,1,2,1,1,1,1,1,1,1,1,1,1,1,1,1,3,1,1,1,1,1,1,1,1,1,1,1,1,1,1,1,1,1,1,1,1,1,0,1.2666666666666666,0,1.1111111111111112,0,1.1666666666666667,0,1,0,1,0,1,0,1.0810810810810811,0,0,0,0,-1.3028534157261313,-1.3813495507946194,-0.6189692744445258,-1.0001594126195725,5,5,5,3,4,5,3,3,1.7231853352897135,5,5,5,5,1,1,1,3.2857142857142856,0,-1.6169357779629459,0,-1.0712639784803049,2,2,2,3,2,5,5,5,5,1,5,5,4,5,5,5,4,5,5,5,2.2,0,4.8,0,4,0,5,0,4.6,0,1,1,1,2,1,1,2,1,1,1,1,1,1,2,1,2,1,1,1,2,1.25,0,"White, Caucasian, Anglo, European American",0,27,1,2,NA,5,2,0,0,1,0,0,TRUE,TRUE,TRUE,TRUE,TRUE,1,0.601245161293495,0.47063124999869616,0.5162718750010244,0.687875,0.5403562500006519,0.5939687499990687,1,1,1,1,1,1,0.118,0.322,0.627,0.018,1.789,53.82601074417437,1840.1852256807824,0.088,0.333,0.646,0.012,1.199,48.171023862604684,1830.8579417216408,0.091,0.347,0.41,0.008,1.253,170.85678787633157,1957.137918665436,99.38888888888889,99.91666666666667,156.62499999999997,FALSE,386,1.1437037037037037,0,1,0,0,3,FALSE
85,2022-03-18T16:54:34Z,0.8999999761581421,1.7777777777777777,720,6,3,2,2,2,3,2,2,3,2,2,2,1,2,2,2,2,2,3,3,1,1,2,2,1,1,2,0,0,0,0,2,2,2,2,2,1,1,1,1,1,1,1,1,2,2,3,4,3,1,1,2,2,1,3,2,3,1,1,2,2,2,3,4,3,1,1,1,2,2,2,2,2,0,2.066666666666667,0,1.5555555555555556,0,1.8333333333333333,0,2,0,2.4285714285714284,0,1,0,1.837837837837838,0,1,0,0,-0.3246819996028513,-0.3742184222114529,-0.05499485428507328,-0.2146066382482631,2,2,3,2,2,2,2,1.5,-0.10103984158003264,4,4,4,4,2,2,3,3.2857142857142856,0,-0.5751298489193319,0,-0.4367109100209476,2,2,3,2,2,3,4,3,4,3,2,3,4,3,3,3,3,3,3,3,2.2,0,2.8,0,3.4,0,3.2,0,3.1333333333333333,0,3,1,3,2,3,2,2,3,2,3,2,2,2,2,1,3,3,3,2,2,2.3,0,"White, Caucasian, Anglo, European American",0,23,1,2,NA,5,2,0,0,0,0,0,TRUE,TRUE,TRUE,TRUE,TRUE,4,0.5725406250134111,0.5094781249836087,0.5232593749761582,0.6274999999769272,0.5664124999791383,0.5817250000238419,1,1,1,1,1,1,0.097,0.377,0.692,0.024,1.679,17.393600429661088,1800.9991663549458,0.101,0.307,0.51,0.02,1.66,110.092629782875,1894.43835349021,0.196,0.301,0.707,0.025,1.421,54.31533267872756,1837.853150629852,69.95833333333333,83,56.839999999999996,FALSE,372,1.1022222222222222,0,1,0,0,3,FALSE
86,2022-03-18T16:53:01Z,0.8999999761581421,1.7777777777777777,864,6,2,4,3,2,3,3,3,3,3,2,4,4,3,2,3,3,2,4,1,1,1,2,2,3,0,2,0,0,0,0,2,2,2,2,2,1,1,1,1,2,2,3,3,3,2,2,3,3,5,5,3,4,1,2,1,1,1,1,1,1,1,1,2,2,1,3,3,2,2,1,1,1.5,0,3,0,1.5555555555555556,0,3,0,1.6666666666666667,0,1.2857142857142858,0,2.3333333333333335,0,2.054054054054054,0,0,0,0,-0.1031678448305387,0.18225053469658598,-0.4466634660828154,-0.1322064656931147,1,1,3,2,1,1,1,2.5,-0.12890852875348124,3,3,3,4,2,2,3,2.857142857142857,0,-0.10840883202778547,0,-0.38464405773870514,2,3,2,2,2,4,4,3,4,2,4,3,2,3,4,3,3,3,4,4,2.2,0,3.4,0,3,0,3.6,0,3.3333333333333335,0,1,1,3,4,2,4,3,4,4,4,3,4,2,4,2,3,1,4,4,4,3.05,0,"White, Caucasian, Anglo, European American",0,25,0,1,NA,5,2,0,0,1,0,0,TRUE,TRUE,TRUE,TRUE,TRUE,3,0.5193906249999418,0.49326874999995923,0.5555500000000902,0.6237933333333271,0.5825689655172414,0.6714166666665735,1,1,1,0.9375,0.9354838709677419,0.9375,0.066,0.403,0.407,0.016,1.802,88.35724199069006,1938.333129215005,0.066,0.364,0.511,0.021,1.891,89.60784481747056,1940.1513082077547,0.073,0.361,0.474,0.014,1.681,37.188909869078365,1884.4567080685797,112.625,90.04761904761904,120.07142857142857,FALSE,376,1.114074074074074,0,1,0,3,6,FALSE
88,2022-03-18T16:57:37Z,1,1.7777777777777777,1080,4,3,3,2,3,3,4,4,3,3,3,3,2,3,2,3,4,3,3,3,2,2,2,4,2,1,1,1,0,0,0,2,4,4,2,3,2,3,2,2,2,2,2,2,3,3,2,4,3,2,2,3,3,2,1,2,3,1,1,2,1,1,3,3,4,1,1,1,2,2,2,2,2,0,3,0,2.6666666666666665,0,2.5,0,2,0,2.142857142857143,0,1,0,2.27027027027027,0,1,0,0,0.4429413090140726,0.5495259462625031,-0.05499485428507328,0.2472655459887149,2,2,3,2,1,2,2,1.5,-0.1839744285858068,4,4,4,4,2,2,4,3.4285714285714284,0,0.43348058270556905,0,0.255025804242946,3,3,3,3,3,3,3,2,3,4,4,3,3,3,4,4,4,4,3,3,3,0,3.6,0,3.4,0,3,0,3.3333333333333335,0,1,1,1,2,2,1,2,2,1,1,1,2,2,2,2,2,1,2,2,2,1.6,0,"White, Caucasian, Anglo, European American",0,21,0,1,NA,5,2,0,0,1,0,0,TRUE,TRUE,TRUE,TRUE,TRUE,5,0.5368483870933133,0.5086125000026077,0.5473062500059604,0.6005468749962747,0.5531774193471478,0.6264032258045289,0.96875,1,1,1,0.96875,1,0.071,0.435,0.603,0.017,1.251,38.06410608998551,1819.8230070279303,0.062,0.364,0.399,0.024,1.582,122.37857352273652,1950.2902724714136,0.084,0.393,0.587,0.034,1.923,184.25628818769505,2028.3690551958216,73.58823529411764,65.91666666666667,56.55882352941176,FALSE,276,0.8177777777777777,0,1,0,0,3,FALSE
89,2022-03-18T16:52:39Z,0.8999999761581421,1.6,900,6,3,3,3,2,3,2,2,3,3,2,2,4,3,1,3,2,2,2,2,1,1,2,2,3,4,2,0,0,0,0,2,2,2,1,1,3,2,2,3,2,2,3,2,2,2,1,3,3,2,3,3,2,1,1,1,3,2,1,3,3,1,2,2,2,1,3,3,1,2,2,2,1.75,0,2.533333333333333,0,2,0,2.3333333333333335,0,1.6666666666666667,0,2,0,2.3333333333333335,0,2.081081081081081,0,2,0,0,-0.166770918973084,-0.06427140822061723,0.07821504497010326,0.006971818374743012,2,2,3,1,1,2,1,1,-0.5432457265250663,3,3,3,3,3,3,4,3.142857142857143,0,0.03902547546461973,0,-0.1400380163538443,2,3,3,3,3,4,3,4,4,3,4,3,3,2,4,3,3,5,3,2,2.8,0,3.8,0,3,0,3.2,0,3.3333333333333335,0,1,1,1,3,2,1,2,2,2,2,1,2,2,1,2,2,1,1,3,1,1.65,0,"Black or African American & White, Caucasian, Anglo, European American",1,30,1,3,NA,5,2,0,0,0,0,0,TRUE,TRUE,TRUE,TRUE,TRUE,3,0.6816774193548312,0.7870062499999876,0.5743718749999971,0.7573468749999883,0.8498687499999978,0.6374566666666573,1,1,1,1,1,1,0.195,0.325,0.802,0.025,1.767,38.357514502754505,1820.1426026305908,0.247,0.283,0.482,0.019,1.32,52.58690951227062,1837.3944670922217,0.081,0.381,0.31,0.024,1.773,77.51855840084451,1861.9943670376072,70.67999999999999,69.47368421052632,73.875,FALSE,431,1.2770370370370372,0,1,0,0,3,FALSE
90,2022-03-18T16:55:20Z,1,1.7777777777777777,1440,4,2,3,2,2,3,2,2,3,3,3,2,2,2,3,3,4,2,2,2,1,2,2,3,2,3,1,1,0,2,0,1,2,3,2,3,3,1,2,1,1,2,1,1,3,3,2,2,2,1,1,1,2,1,1,1,3,1,1,3,3,3,2,2,1,2,4,1,2,2,2,2,2,0,2.6,0,2,0,1.6666666666666667,0,1.5,0,2.142857142857143,0,2.3333333333333335,0,1.864864864864865,0,2,0,0,-0.2259875742092467,-0.07498975356484339,0.16436794915095845,0.04468909779305753,4,4,5,4,2,4,5,3,1.5573161612781652,2,3,4,4,1,1,2,2.4285714285714284,0,-0.680591255988642,0,-0.9653623987899889,2,2,3,3,3,4,5,3,5,4,4,4,4,3,5,3,4,4,4,3,2.6,0,4,0,4,0,3.8,0,3.933333333333333,0,2,1,1,2,2,4,2,3,2,1,4,3,1,4,1,3,1,4,2,2,2.25,0,"White, Caucasian, Anglo, European American",0,28,0,1,NA,5,2,0,0,1,0,0,TRUE,TRUE,TRUE,TRUE,TRUE,3,0.626875,0.576375,0.5336875,0.6825517241379311,0.7073666666666667,0.7047741935483871,1,1,1,0.90625,0.967741935483871,0.96875,0.108,0.335,0.578,0.009,1.722,49.36200404625037,1874.5995798305648,0.131,0.226,0.396,0.003,0.935,93.15004558159887,1920.5103835362008,0.059,0.389,0.272,0.02,2.066,77.66745179406291,1934.637023518625,191.33333333333334,311.6666666666667,103.29999999999998,FALSE,226,0.6696296296296296,0,1,0,0,3,FALSE
91,2022-03-18T16:50:55Z,1,1.6,900,4,4,2,1,1,1,1,1,5,1,1,1,1,1,1,5,1,1,1,1,1,1,1,1,1,1,2,0,0,0,0,1,1,2,1,1,1,1,1,1,2,1,1,1,1,1,1,1,1,1,2,2,1,1,1,1,2,2,1,2,2,1,1,1,1,1,1,1,2,1,1,1,1.25,0,1.6,0,1.1111111111111112,0,1.25,0,1.3333333333333333,0,1.2857142857142858,0,1,0,1.2162162162162162,0,1,0,0,-1.2962737873665577,-1.2313910494189768,-0.31345356682763886,-0.7724223081233078,1,1,1,1,1,1,1,2,-0.571114413698515,5,5,5,5,3,3,4,4.285714285714286,0,-0.7557596538304501,0,-0.004911903675855145,2,3,2,1,2,4,4,4,5,1,2,4,4,4,4,3,2,5,2,1,2,0,3.4,0,2.8,0,3.6,0,3.2666666666666666,0,1,1,1,1,2,1,1,2,2,2,2,2,2,2,1,2,2,2,2,1,1.6,0,"Hispanic of Latino (e.g., Mexican American, Central American, and others)",0,23,1,2,NA,5,2,0,0,1,0,0,TRUE,TRUE,TRUE,TRUE,TRUE,2,0.5551968749995576,0.4955531249997439,0.5627437500002561,0.6007500000001165,0.5775548387095332,0.6536406249998836,1,1,1,1,0.96875,1,0.238,0.24,0.743,0.014,1.505,15.663765050630444,1798.073750370217,0.055,0.399,0.577,0.012,1.391,80.92186098595268,1908.3320159330335,0.164,0.304,0.687,0.022,1.571,108.9126320532328,1893.978455636339,107.49999999999999,115.91666666666667,71.4090909090909,FALSE,444,1.3155555555555554,0,1,0,0,3,FALSE
92,2022-03-18T16:54:29Z,1,1.7786458333333333,768,7,3,2,2,1,1,1,1,2,1,1,1,1,2,1,2,2,1,1,1,1,1,1,1,1,0,2,0,0,0,0,1,1,1,1,1,1,1,1,1,1,1,1,1,1,1,1,1,1,1,1,1,1,1,1,1,1,1,1,1,1,1,1,1,1,1,1,1,1,1,1,1,1,0,1.4,0,1,0,1,0,1,0,1,0,1,0,1,0,0,0,0,-1.4366391923707953,-1.413111253053198,-0.6189692744445258,-1.016040263748862,1,1,2,1,1,1,1,1.5,-0.6815819506204519,5,5,5,5,5,5,5,5,0,1.475286511749183,0,1.7410083003497518,2,3,2,2,2,4,4,4,4,2,4,4,4,4,4,4,4,4,4,4,2.2,0,4,0,3.6,0,4,0,3.8666666666666667,0,2,1,1,2,2,2,2,2,1,1,2,2,1,1,1,2,1,1,2,2,1.55,0,"White, Caucasian, Anglo, European American",0,29,1,2,NA,5,2,0,0,1,0,0,TRUE,TRUE,TRUE,TRUE,TRUE,4,0.5560125000015832,0.45362187499925494,0.4688187499991618,0.6622533333331346,0.5542580645156483,0.5569178571429636,1,1,1,0.967741935483871,0.96875,0.875,0.056,0.367,0.525,0.012,1.485,135.162975544424,2070.253029657963,0.087,0.333,0.724,0.02,2.01,81.61906225016722,1914.049886052211,0.079,0.382,0.482,0.009,1.351,82.4117238030742,1913.2243454411953,123.75,100.49999999999999,150.11111111111111,FALSE,346,1.0251851851851852,0,1,0,0,3,FALSE
93,2022-03-18T16:44:45Z,1,1.7786458333333333,768,1,2,3,4,3,1,1,2,4,3,3,1,1,1,4,3,3,1,1,1,1,1,1,1,1,1,2,0,0,0,0,2,2,3,1,2,1,2,3,4,1,1,2,1,4,3,3,5,5,4,5,4,3,5,1,1,2,1,1,1,2,1,5,3,4,1,1,1,2,2,1,2,1.75,0,2.466666666666667,0,2.2222222222222223,0,3.1666666666666665,0,2.1666666666666665,0,2.4285714285714284,0,1,0,2.4594594594594597,0,1,0,0,-0.4891727085921919,-0.3102033504766705,-0.14114775846592847,-0.2256755544712995,2,2,3,1,1,5,3,2.5,0.4516335802869379,4,5,5,5,5,5,3,4.571428571428571,0,-1.2737251609456715,0,-0.16559391291590186,4,4,3,2,3,4,5,4,2,1,4,5,2,3,5,4,5,4,4,1,3.2,0,4.4,0,3.2,0,3,0,3.533333333333333,0,1,2,1,1,3,2,3,1,1,1,1,1,1,2,1,1,1,1,1,1,1.35,0,"Hispanic of Latino (e.g., Mexican American, Central American, and others)",0,21,1,2,NA,5,2,1,0,2,0,1,TRUE,TRUE,TRUE,TRUE,TRUE,6,0.598,0.54646875,0.5670322580645162,0.6860344827586207,0.5861333333333333,0.6082,0.9375,1,1,0.9354838709677419,0.9375,0.9375,0.066,0.351,0.317,0.036,2.116,96.79156069577822,1943.078995227823,0.059,0.397,0.392,0.03,1.674,52.62732874956328,1897.501213972802,0.059,0.43,0.276,0.01,1.149,118.5051056653919,2068.2799413238563,58.777777777777786,55.8,114.9,FALSE,348,1.031111111111111,0,1,0,3,6,FALSE
94,2022-03-18T17:01:09Z,0.8999999761581421,1.6,900,6,4,1,1,3,2,3,1,4,1,1,1,1,3,1,3,3,1,1,5,3,1,1,1,1,1,1,2,2,2,2,2,1,1,2,2,2,4,2,2,2,2,1,1,2,4,1,2,1,1,1,1,4,3,1,1,2,1,1,1,1,1,1,2,2,1,1,1,3,1,1,1,1.5,0,1.9333333333333333,0,2,0,1.5833333333333333,0,2,0,1.2857142857142858,0,1,0,1.6486486486486487,0,1,2,2,-0.5286504787496339,-0.5696069744956507,2.9836963385124995,1.2070446820084244,1,1,1,1,1,1,1,1,-0.9579186615539372,5,5,5,5,2,2,5,4.142857142857143,0,0.5809148901979743,0,0.7318398713498386,3,3,3,3,2,5,3,5,5,4,5,4,5,4,1,5,4,3,4,1,2.8,0,4.2,0,4.2,0,3.2,0,3.8666666666666667,0,1,1,1,4,1,1,1,1,1,1,1,1,1,1,1,1,1,1,2,1,1.2,0,"White, Caucasian, Anglo, European American",0,25,1,2,NA,5,2,0,0,1,0,0,TRUE,TRUE,TRUE,TRUE,TRUE,2,0.4552241379330898,0.48573225806413156,0.5227366666694482,0.5508360000014305,0.464007999997139,0.6326479999923706,1,1,1,0.78125,0.78125,0.78125,0.055,0.343,0.354,0.015,1.992,89.6527050268787,1987.5428380494236,0.045,0.314,0.293,0.039,2.095,196.47537556676997,2160.531497351922,0.057,0.353,0.625,0.015,1.943,57.47199499585069,1913.783049393975,132.8,53.71794871794872,129.53333333333333,FALSE,372,1.1022222222222222,0,1,0,0,3,FALSE
95,2022-03-18T16:57:27Z,1,1.7786458333333333,768,6,2,3,3,4,2,4,2,4,3,2,1,1,5,1,3,3,3,5,5,5,3,5,4,4,3,1,2,2,3,2,4,2,2,3,3,1,1,2,2,3,3,2,3,4,3,4,5,5,5,5,5,3,4,2,3,5,5,3,1,1,1,3,4,4,2,5,2,3,4,4,4,3.75,0,2.7333333333333334,0,2.2222222222222223,0,3.9166666666666665,0,3.6666666666666665,0,2.4285714285714284,0,3,0,3.108108108108108,0,2,2,2,2.0417910003904653,1.5083753540748885,3.978435279576228,2.7434053168255583,3,2,5,1,1,4,2,1,-0.04563820449042111,2,3,2,4,1,1,1,2,0,-0.8944165583184731,0,-1.3278091742878089,1,1,2,2,4,2,2,4,3,4,2,3,2,2,3,2,1,4,3,4,2,0,2.4,0,2.6,0,3.2,0,2.7333333333333334,0,2,1,1,3,2,1,2,3,1,2,2,3,2,2,2,3,3,3,4,4,2.3,0,"White, Caucasian, Anglo, European American",0,23,1,2,NA,5,2,0,0,1,0,0,TRUE,TRUE,TRUE,TRUE,TRUE,5,0.6688812500024215,0.7324193548358255,0.677719354841017,0.6710645161290323,0.7283766666700443,0.6503903225823756,1,0.96875,1,0.96875,0.967741935483871,0.96875,0.08,0.359,0.264,0.108,1.184,119.52701491327215,1945.0895493319551,0.084,0.401,0.26,0.139,1.455,134.0624618887775,2001.4549055423215,0.085,0.36,0.292,0.019,1.589,91.30832100740352,1919.3944109852532,10.962962962962962,10.467625899280575,83.63157894736842,FALSE,304,0.9007407407407407,1,1,0,0,3,FALSE
96,2022-03-18T16:50:16Z,0.8999999761581421,1.6,900,6,1,4,5,5,5,5,5,5,4,5,3,2,5,3,4,5,5,3,1,1,3,2,5,3,2,1,1,0,1,0,5,4,4,4,5,2,3,3,4,2,2,2,1,5,5,2,5,5,3,1,2,2,5,1,1,1,2,1,1,1,1,5,5,5,5,5,3,1,2,2,2,1.75,0,4.333333333333333,0,3.7777777777777777,0,2.9166666666666665,0,2,0,2.7142857142857144,0,4.333333333333333,0,3.054054054054054,0,1,0,0,1.1140634016905835,1.5830104377103722,-0.14114775846592847,0.7209313396222219,4,3,5,4,2,4,3,2.5,1.1151102763331315,1,1,1,1,1,1,1,1,0,-1.3459910705962685,0,-2.1446772018216675,3,4,3,5,3,4,5,3,3,4,3,3,2,3,2,2,4,4,3,4,3.6,0,3.6,0,3.2,0,3,0,3.2666666666666666,0,1,3,1,1,1,1,3,2,1,2,1,3,2,1,1,4,1,1,1,2,1.65,0,Black or African American,0,28,1,2,NA,5,2,0,0,0,0,0,TRUE,TRUE,TRUE,TRUE,TRUE,5,0.5739000000000014,0.4765937499999927,0.5282187500000036,0.6312812500000013,0.5353437500000037,0.5878709677419317,0.967741935483871,1,1,1,1,0.96875,0.071,0.409,0.659,0.03,2.178,65.17447901304783,1891.9917083086305,0.18,0.279,0.887,0.027,1.457,116.27277356930188,1902.664412409528,0.065,0.426,0.418,0.031,1.723,161.74870222741478,1992.5135715651877,72.6,53.96296296296297,55.58064516129033,FALSE,434,1.285925925925926,0,1,0,0,3,FALSE
97,2022-03-18T17:00:28Z,0.8999999761581421,1.6,900,4,4,3,2,3,2,4,1,2,1,1,1,3,1,1,3,2,1,1,1,1,1,3,1,1,1,2,0,0,0,0,2,2,1,1,1,1,1,1,1,3,2,1,1,2,5,1,4,1,1,2,1,1,1,1,1,1,1,1,1,1,1,3,3,1,1,1,1,1,1,1,1,1,0,2,0,1.2222222222222223,0,2,0,1,0,1.5714285714285714,0,1,0,1.4864864864864864,0,1,0,0,-0.9585195315751113,-0.8296005991757807,-0.39960647100849406,-0.6146035350921374,1,1,2,1,1,1,1,1,-0.874984074548163,5,5,5,5,5,5,5,5,0,1.2043418043825058,0,1.5759787198402806,5,2,4,3,3,3,5,2,4,2,4,4,2,3,3,5,4,3,4,4,3.4,0,3.6,0,3.6,0,3.2,0,3.466666666666667,0,1,1,1,4,1,1,1,1,1,1,1,1,1,2,2,1,1,1,1,1,1.25,0,"White, Caucasian, Anglo, European American",0,21,1,2,NA,5,2,0,0,1,0,0,TRUE,TRUE,TRUE,TRUE,TRUE,1,0.47216129032258064,0.46356249999999727,0.4838064516129051,0.5698260869565294,0.5507499999999987,0.6736399999999977,0.96875,1,1,0.71875,0.75,0.78125,0.06,0.343,0.41,0.011,1.753,143.14741634245735,1998.099048088226,0.052,0.352,0.505,0.012,1.692,42.32180075374145,1933.6315265939932,0.05,0.352,0.435,0.01,1.68,149.47251747766504,2123.3760765589345,159.36363636363637,141,168,FALSE,364,1.0785185185185184,0,1,0,0,3,FALSE
98,2022-03-18T17:00:44Z,0.8999999761581421,1.6,900,6,5,4,1,2,2,1,2,3,3,2,3,3,4,3,3,5,2,4,5,1,3,3,4,3,1,1,1,0,0,0,2,5,4,2,2,1,3,2,1,2,5,3,1,4,2,4,4,4,4,3,5,4,2,1,1,3,2,1,1,1,1,2,2,2,1,1,2,1,3,1,1,1.5,0,2.7333333333333334,0,2.4444444444444446,0,3.4166666666666665,0,2.1666666666666665,0,1.4285714285714286,0,1.3333333333333333,0,2.4324324324324325,0,1,0,0,0.87281036183955,0.722199473092423,-0.22730066264678367,0.2474494052228197,1,1,1,2,1,1,2,2,-0.40524523968696646,5,5,5,5,4,3,5,4.571428571428571,0,1.2766077140331027,0,1.3877871020070867,3,4,3,4,2,3,3,2,3,2,4,3,3,4,3,2,4,4,3,3,3.2,0,3.6,0,2.6,0,3,0,3.066666666666667,0,1,2,1,1,2,1,1,1,1,1,2,2,1,1,1,2,1,1,1,2,1.3,0,"White, Caucasian, Anglo, European American",0,28,1,2,NA,5,2,0,0,1,0,0,TRUE,TRUE,TRUE,TRUE,TRUE,4,0.5495645161328777,0.5161218750011176,0.48279687500186264,0.5989193548367869,0.5450354838698142,0.553106249999255,0.96875,1,1,0.96875,0.96875,1,0.094,0.372,0.913,0.016,1.4,19.21447924530021,1803.172596954972,0.062,0.386,0.5,0.024,1.437,52.398949970945814,1878.3969371882856,0.058,0.416,0.464,0.016,1.518,165.76841790504017,2032.943129724984,87.49999999999999,59.875,94.875,FALSE,433,1.282962962962963,0,1,0,0,3,FALSE
100,2022-03-18T16:57:44Z,0.8999999761581421,1.6,900,6,3,5,2,4,4,4,5,5,4,4,5,3,5,1,5,5,2,5,1,3,4,5,5,2,0,2,0,0,0,0,3,4,2,2,3,4,4,4,5,4,2,4,1,5,1,3,4,5,5,5,5,4,1,3,1,5,5,2,1,1,1,3,5,4,1,5,5,2,3,1,1,1.75,0,4.066666666666666,0,3.4444444444444446,0,3.6666666666666665,0,3.1666666666666665,0,2.4285714285714284,0,3.6666666666666665,0,3.2972972972972974,0,0,0,0,1.5965694813926496,1.7910840042092964,-0.3605105619019602,0.7152867211536681,2,3,4,3,2,3,2,4.5,1.391111250009331,1,1,3,3,1,1,2,1.7142857142857142,0,-1.2224806707219966,0,-1.6824349360123172,2,3,2,2,2,4,2,4,4,3,5,4,5,4,4,5,5,4,4,4,2.2,0,4.4,0,3.8,0,4,0,4.066666666666666,0,1,2,1,2,2,1,2,1,1,1,2,3,2,1,1,2,1,1,1,2,1.5,0,"White, Caucasian, Anglo, European American",0,29,1,2,NA,5,2,0,0,1,0,0,TRUE,TRUE,TRUE,TRUE,TRUE,3,0.6693483870967982,0.6295218750000349,0.5549968749999534,0.7022709677418875,0.6165741935484712,0.7027483870968102,0.96875,1,1,0.96875,1,0.96875,0.081,0.412,0.575,0.007,1.384,25.605388680297683,1849.4996303224405,0.092,0.367,0.412,0.027,1.548,204.9049725667689,1996.314743733098,0.068,0.462,0.348,0.018,1.605,219.26603570255705,2087.669953213356,197.7142857142857,57.333333333333336,89.16666666666667,FALSE,442,1.3096296296296297,0,1,0,0,3,FALSE
101,2022-03-18T16:57:08Z,1,1.6,800,6,3,4,3,5,3,3,3,4,4,3,4,4,5,1,4,4,2,3,1,1,2,4,4,3,0,2,0,0,0,0,3,4,3,4,4,2,2,2,4,3,2,4,1,5,1,5,5,4,4,5,5,3,3,1,1,2,5,2,1,1,1,5,5,4,1,3,2,1,1,1,1,1,0,3.6,0,3.111111111111111,0,3.6666666666666665,0,2.5,0,2.7142857142857144,0,2,0,3.027027027027027,0,0,0,0,0.8530714767608292,1.0873115489007907,-0.6189692744445258,0.2341711372281325,2,2,3,1,1,3,2,1.5,-0.1839744285858068,2,3,4,4,1,1,2,2.4285714285714284,0,0.4002850852868561,0,-0.30701195187793484,1,2,1,1,1,5,5,5,5,3,5,5,4,4,5,5,5,5,5,5,1.2,0,5,0,4.4,0,4.8,0,4.733333333333333,0,4,4,4,4,4,4,4,1,3,4,2,4,3,4,4,4,4,4,4,4,3.65,0,Middle Eastern,0,25,1,2,NA,5,2,0,0,1,0,0,TRUE,TRUE,TRUE,TRUE,TRUE,5,0.7668056451615074,0.6913479999995713,0.711545166666959,0.7891898333337546,0.6946745161293449,0.801214354839636,1,0.967741935483871,1,0.9375,0.96875,0.96875,0.081,0.452,0.306,0.009,1.183,76.5281679695288,1902.1167655582665,0.071,0.381,0.287,0.02,1.907,198.04454559152236,2066.3788282598143,0.072,0.508,0.29,0.026,1.543,104.6671922755516,1970.828126101243,131.44444444444446,95.35,59.34615384615385,FALSE,272,0.8059259259259259,0,1,0,6,9,FALSE
102,2022-03-18T16:39:23Z,0.8999999761581421,1.7777777777777777,1080,3,3,5,2,3,2,4,1,2,1,2,1,1,2,2,2,2,1,3,5,1,2,1,3,1,0,2,0,0,0,0,1,2,2,1,1,1,1,1,1,2,2,1,1,3,1,2,2,3,1,1,1,2,1,1,1,2,1,1,1,1,1,3,5,1,1,1,1,1,1,1,1,1,0,2.1333333333333333,0,1.2222222222222223,0,1.6666666666666667,0,1.3333333333333333,0,1.8571428571428572,0,1,0,1.4864864864864864,0,0,0,0,-0.39047828319858763,-0.38936177251430504,-0.6189692744445258,-0.5041655234794153,1,2,2,1,1,2,1,1,-0.7091149005366146,5,5,5,5,2,2,3,3.857142857142857,0,-0.44574453423188864,0,-0.04829297043571845,2,2,2,1,2,5,3,4,5,3,5,4,2,2,4,5,4,5,4,1,1.8,0,4.6,0,3.4,0,3.2,0,3.7333333333333334,0,1,3,3,1,3,2,3,4,2,1,3,3,1,3,1,3,2,2,1,3,2.25,0,"White, Caucasian, Anglo, European American",0,29,1,2,NA,5,2,0,0,1,0,0,TRUE,TRUE,TRUE,TRUE,TRUE,4,0.5875593749992549,0.5433343749828636,0.5074000000039737,0.6267709677488573,0.6210357142771993,0.591556666680177,1,1,1,0.96875,0.9333333333333333,0.9375,0.074,0.36,0.557,0.019,1.978,79.01089438404617,1924.0159595387388,0.067,0.391,0.467,0.015,1.637,121.15538733696332,1971.6679508203165,0.073,0.375,0.362,0.014,1.474,94.91626984756472,1919.4589121386068,104.10526315789474,109.13333333333334,105.28571428571428,FALSE,280,0.8296296296296296,0,1,0,3,6,FALSE
103,2022-03-18T16:47:48Z,1,1.6,900,3,3,2,2,1,2,1,1,3,3,1,2,1,2,2,3,1,3,1,1,1,3,3,3,1,0,1,1,0,0,0,1,1,1,1,1,1,1,1,1,1,1,1,1,1,2,1,1,1,1,1,3,2,2,1,1,3,1,3,1,1,1,1,1,1,1,1,3,2,3,1,1,1.75,0,1.8,0,1,0,1.25,0,1.6666666666666667,0,1.2857142857142858,0,1.6666666666666667,0,1.2972972972972974,0,0,0,0,-0.5944467623453702,-0.6720704226487125,-0.3605105619019602,-0.5162904922753364,3,3,4,2,2,2,2,1,-0.04563820449042111,3,3,4,3,2,2,3,2.857142857142857,0,-0.4848149464637728,0,-0.6139090755731551,2,3,2,3,2,4,3,4,4,3,3,4,4,5,4,3,4,4,3,3,2.4,0,3.8,0,3.2,0,4,0,3.6666666666666665,0,1,2,3,3,3,3,3,2,1,3,4,2,2,3,1,2,3,3,3,3,2.5,0,"White, Caucasian, Anglo, European American",0,30,1,2,NA,5,2,0,0,0,0,0,TRUE,TRUE,TRUE,TRUE,TRUE,2,0.49396875000001456,0.46015625000000365,0.47065625000001093,0.573064516129021,0.5200624999999782,0.5602812499999945,1,1,1,0.96875,1,1,0.08,0.368,0.79,0.018,1.686,43.245460019586034,1826.9870826902984,0.136,0.304,0.864,0.017,1.244,78.65102227620156,1872.55742465236,0.067,0.394,0.67,0.014,1.416,45.05914768308831,1869.184809782292,93.66666666666667,73.17647058823529,101.14285714285714,FALSE,436,1.2918518518518518,0,1,0,0,3,FALSE
104,2022-03-18T16:51:31Z,0.8999999761581421,1.7777777777777777,1080,6,2,2,3,2,3,2,1,2,2,2,2,2,2,3,2,2,1,1,1,2,1,1,1,1,3,1,2,0,2,0,2,3,3,2,4,3,4,4,4,3,4,2,1,4,2,4,1,1,1,1,1,2,1,2,1,4,3,1,3,3,1,1,1,2,1,2,1,2,1,2,2,1.75,0,2.1333333333333333,0,3.2222222222222223,0,2.0833333333333335,0,2.1666666666666665,0,1.7142857142857142,0,1.3333333333333333,0,2.2432432432432434,0,2,0,0,-0.5483893638283547,-0.4955618915213171,0.07821504497010326,-0.2086734232756069,2,2,4,2,2,2,2,1,-0.21150737850196963,2,2,4,1,1,1,1,1.7142857142857142,0,-0.8792700537047221,0,-1.4733889476140083,3,3,4,2,3,2,2,3,3,2,1,2,4,3,3,2,2,2,2,3,3,0,1.8,0,2.4,0,3,0,2.4,0,1,1,1,2,2,1,2,3,2,1,1,3,1,2,2,3,1,2,2,1,1.7,0,"Asian or Asian American (e.g., Chinese, Japanese, and others)",0,25,0,1,NA,5,2,0,0,1,0,0,TRUE,TRUE,TRUE,TRUE,TRUE,3,0.4882968750000073,0.439441935483877,0.41841249999999125,0.5322374999999956,0.49089374999999563,0.47422333333333955,1,0.96875,1,1,1,0.9375,0.053,0.33,0.652,0.026,1.91,120.25059838734816,1964.2355337712204,0.067,0.297,0.465,0.033,1.92,202.41789742083873,2028.1153677689745,0.104,0.308,0.571,0.007,0.829,35.34095113587905,1819.930392571424,73.46153846153847,58.18181818181818,118.42857142857142,FALSE,328,0.9718518518518519,0,1,0,3,6,FALSE
105,2022-03-18T16:59:18Z,0.8999999761581421,1.7777777777777777,1080,6,4,4,2,2,3,2,2,3,3,2,2,3,3,2,3,3,2,3,1,2,2,3,1,3,8,1,1,0,0,0,2,2,4,4,4,2,4,3,3,3,3,2,3,4,4,2,4,4,3,2,3,4,1,2,2,4,2,2,3,3,3,2,1,2,1,3,2,3,3,2,2,2.5,0,2.6,0,3.111111111111111,0,3.0833333333333335,0,2.5,0,2.2857142857142856,0,2,0,2.7567567567567566,0,4,0,0,0.43416847120130736,0.3689857439505827,0.7753993643847322,0.5721925541676575,2,2,3,1,1,2,1,3.5,0.4237648931134893,3,3,4,4,2,2,3,3,0,-0.4848149464637728,0,-0.536506400332478,1,2,1,2,1,5,5,4,5,4,5,5,5,4,5,4,5,5,3,4,1.4,0,5,0,4.2,0,4.4,0,4.533333333333333,0,1,2,1,2,1,1,2,3,2,1,4,3,2,1,3,4,1,1,3,1,1.95,0,"White, Caucasian, Anglo, European American",0,23,1,1,NA,5,2,0,0,1,0,0,TRUE,TRUE,TRUE,TRUE,TRUE,5,0.4692258064525743,0.4145062500024214,0.4398968750024214,0.5409580645109376,0.4829500000009934,0.5446516129057254,0.96875,1,1,0.96875,0.9375,0.96875,0.07,0.324,0.64,0.012,1.619,73.10712371362798,1899.3413752463632,0.058,0.327,0.708,0.016,1.564,58.92365759176166,1904.8262978785217,0.062,0.357,0.583,0.015,1.48,264.8417481247828,2133.0893205511143,134.91666666666666,97.75,98.66666666666667,FALSE,320,0.9481481481481481,0,1,0,0,3,FALSE
106,2022-03-18T17:05:49Z,0.8999999761581421,1.7786458333333333,768,6,3,1,1,3,2,3,3,4,2,1,3,2,3,1,3,3,1,2,1,1,1,1,1,2,1,2,0,0,0,0,2,2,5,2,3,2,3,2,4,1,2,3,1,2,2,2,3,2,2,2,3,1,1,1,1,4,3,1,2,1,1,2,2,2,2,2,1,2,3,1,1,1.75,0,2.3333333333333335,0,2.7777777777777777,0,2.0833333333333335,0,1.8333333333333333,0,1.5714285714285714,0,1.6666666666666667,0,2.081081081081081,0,1,0,0,-0.5725146678134581,-0.42446681185273394,-0.14114775846592847,-0.2828072851593312,2,2,3,3,1,3,2,2,0.17529686935345262,4,4,4,4,3,4,4,3.857142857142857,0,0.1625358753388918,0,0.3222042494555062,2,3,3,2,3,4,4,4,4,3,3,4,5,4,4,3,4,4,4,3,2.6,0,3.8,0,3.8,0,3.8,0,3.8,0,2,1,4,3,4,4,3,3,3,1,3,4,3,4,1,3,2,4,2,3,2.85,0,"White, Caucasian, Anglo, European American",0,22,0,1,NA,5,2,0,0,1,0,0,TRUE,TRUE,TRUE,TRUE,TRUE,2,0.43823125000670554,0.48160624999180435,0.4135343750007451,0.49495862069212154,0.49586250000819565,0.4975071428673608,1,1,1,0.90625,1,0.9032258064516129,0.057,0.33,0.696,0.021,1.848,53.15370796025803,1911.9800100254583,0.137,0.276,0.652,0.219,1.786,73.4046534750205,1854.8406672306512,0.06,0.345,0.681,0.014,1.45,193.0986819464116,2086.981245978103,88,8.155251141552512,103.57142857142857,FALSE,430,1.2740740740740741,0,1,0,0,3,FALSE
108,2022-03-18T17:06:16Z,0.8999999761581421,1.7777777777777777,720,6,4,2,1,2,1,2,1,1,1,1,1,1,1,2,1,1,1,1,1,1,1,2,2,1,0,2,0,0,0,0,1,1,1,1,2,1,1,1,1,1,1,1,1,2,1,1,2,2,1,1,1,3,1,1,1,1,1,1,1,1,1,1,1,1,1,1,1,1,1,1,1,1,0,1.2666666666666666,0,1.1111111111111112,0,1.25,0,1.3333333333333333,0,1,0,1,0,1.162162162162162,0,0,0,0,-1.1690676390814674,-1.291374449969234,-0.6189692744445258,-0.9551718622068799,1,1,3,1,1,1,1,1,-0.7920494875423887,5,5,5,5,3,3,5,4.428571428571429,0,0.5960613948117253,0,0.8958707989863475,2,2,2,3,2,4,3,5,5,3,5,4,4,2,3,3,4,5,3,4,2.2,0,4.4,0,3.2,0,3.8,0,3.8,0,1,1,1,3,1,1,3,3,1,1,2,3,1,3,1,3,1,1,1,3,1.75,0,"White, Caucasian, Anglo, European American",0,29,1,2,NA,5,2,0,0,1,0,0,TRUE,TRUE,TRUE,TRUE,TRUE,2,0.5542906250022351,0.48684375,0.5756437500007451,0.6133375000003726,0.5436687500057742,0.6194343750001863,1,1,1,1,1,1,0.094,0.387,0.492,0.055,1.977,38.16556457232511,1823.1606659064448,0.076,0.359,0.568,0.037,1.86,25.1895603434756,1808.213273511678,0.123,0.334,0.565,0.015,1.272,50.182339185916575,1832.8119711483744,35.945454545454545,50.270270270270274,84.80000000000001,FALSE,292,0.8651851851851852,0,1,0,0,3,FALSE
109,2022-03-18T16:57:44Z,1,1.6,900,6,3,4,2,3,3,5,4,3,4,3,4,4,3,2,3,4,2,3,1,1,2,3,3,2,2,2,0,0,0,0,2,4,1,2,2,2,2,2,1,3,1,3,2,3,2,1,4,3,3,4,2,2,1,1,1,3,1,2,2,2,1,3,3,2,2,4,2,2,1,2,2,1.75,0,3.4,0,2,0,2.5833333333333335,0,1.5,0,2.142857142857143,0,2.6666666666666665,0,2.189189189189189,0,1,0,0,0.06570928306518452,0.47046585766839394,-0.14114775846592847,0.16465904960123273,2,2,3,1,1,2,1,1.5,-0.3498436025973552,3,3,3,2,1,1,2,2.142857142857143,0,-0.12355533664153649,0,-0.7808830110972456,3,2,3,3,4,3,5,3,4,1,5,4,3,4,3,5,3,4,4,4,3,0,3.8,0,3.6,0,3.6,0,3.6666666666666665,0,2,2,1,2,3,1,2,1,1,1,2,1,1,2,1,1,1,1,1,3,1.5,0,"White, Caucasian, Anglo, European American",0,22,1,2,NA,5,2,0,0,1,0,0,TRUE,TRUE,TRUE,TRUE,TRUE,1,0.6563187499998894,0.5772187500000291,0.5949343749998952,0.6826387096773232,0.610649999999965,0.6193838709676638,1,1,1,1,1,1,0.068,0.46,0.521,0.04,1.63,81.59340069960018,1864.742128629588,0.125,0.38,0.654,0.027,1.395,60.010719991942544,1844.1353198359689,0.085,0.467,0.466,0.047,1.786,58.63856013946855,1838.426681220196,40.75,51.66666666666667,38,FALSE,432,1.28,0,1,0,0,3,FALSE
110,2022-03-18T17:05:36Z,1,1.7777777777777777,1080,5,1,3,2,2,2,2,1,2,2,1,1,2,2,2,2,3,5,4,4,2,3,4,3,4,3,2,0,0,0,0,1,2,1,2,3,1,1,1,2,5,2,5,3,1,2,2,2,3,5,4,3,3,2,2,1,4,3,1,2,1,1,2,2,2,1,2,2,1,2,1,1,1.25,0,1.9333333333333333,0,1.5555555555555556,0,3.0833333333333335,0,2.5,0,1.5714285714285714,0,1.6666666666666667,0,2.2162162162162162,0,2,0,0,1.0570399559076114,0.4968192205330974,-0.09409076339160714,0.20136422857074512,2,2,3,1,1,1,1,4,0.5342324300354263,5,5,5,5,3,2,3,4,0,0.9905165020526746,0,0.9039212433797521,2,2,3,2,2,4,4,2,4,3,3,3,4,4,3,2,3,4,3,3,2.2,0,3.4,0,3.2,0,3.2,0,3.2666666666666666,0,1,3,3,3,3,2,3,2,2,2,1,3,1,1,1,3,1,2,2,2,2.05,0,"Hispanic of Latino (e.g., Mexican American, Central American, and others) & White, Caucasian, Anglo, European American",1,23,0,1,NA,5,2,0,0,1,0,0,TRUE,TRUE,TRUE,TRUE,TRUE,3,0.45244193548252504,0.40443125000130387,0.450984374997206,0.5776833333363136,0.49233448275409897,0.5399906250014901,0.96875,1,1,0.9375,0.90625,1,0.11,0.291,0.702,0.022,2.061,21.522796492413804,1804.5197906545457,0.05,0.333,0.684,0.022,1.942,57.828640968115046,1921.4173125412376,0.059,0.351,0.552,0.015,1.951,164.09654807082146,2052.2890177878553,93.68181818181819,88.27272727272728,130.06666666666666,FALSE,284,0.8414814814814815,0,1,0,3,6,FALSE
111,2022-03-18T17:08:42Z,0.8999999761581421,1.7786458333333333,768,3,3,1,1,1,1,1,1,1,1,1,1,1,1,1,1,1,1,1,1,1,1,1,1,1,0,2,0,0,0,0,1,1,1,1,1,1,1,1,1,1,1,1,1,1,1,1,1,1,1,1,1,1,1,1,1,1,1,1,1,1,1,1,1,1,1,1,1,1,1,1,1,1,0,1,0,1,0,1,0,1,0,1,0,1,0,1,0,0,0,0,-1.4366391923707953,-1.587751448753618,-0.6189692744445258,-1.103360361599072,1,1,5,1,1,1,1,1,-0.6261803135308405,5,5,5,5,1,1,5,3.857142857142857,0,-0.23191923190205752,0,0.08194577934007008,1,1,1,1,1,5,5,5,5,5,5,5,5,5,5,5,5,5,5,5,1,0,5,0,5,0,5,0,5,0,1,1,1,1,1,1,1,1,1,1,1,1,1,1,1,1,1,1,1,1,1,0,Black or African American,0,29,0,1,NA,5,2,0,0,1,0,0,TRUE,TRUE,TRUE,TRUE,TRUE,5,0.53703125,0.4908125,0.5074375,0.6039687499999999,0.53575,0.58315625,1,1,1,1,1,1,0.144,0.334,0.844,0.019,1.671,7.449277192256529,1788.4583924948388,0.082,0.355,0.548,0.07,1.984,115.90944972077598,1906.066665339455,0.092,0.421,0.844,0.014,1.369,80.65545171456607,1862.5793467094409,87.94736842105263,28.34285714285714,97.78571428571428,FALSE,334,0.9896296296296296,0,1,0,0,3,FALSE
112,2022-03-18T17:10:01Z,1,1.6,900,6,3,4,1,1,2,1,1,2,2,1,1,1,2,3,2,2,1,1,1,1,1,1,1,1,1,2,0,0,0,0,1,1,1,1,1,1,1,1,1,1,1,1,1,1,1,1,1,1,1,1,1,1,1,1,1,1,1,1,2,1,1,1,1,1,1,1,1,1,1,1,1,1,0,1.7333333333333334,0,1,0,1,0,1,0,1.1428571428571428,0,1,0,1.027027027027027,0,1,0,0,-1.4190935167452654,-1.2557777434131798,-0.39960647100849406,-0.827692107210837,1,1,3,1,1,1,1,1,-0.7920494875423887,5,5,5,4,2,2,5,4,0,-0.19872373448334457,0,0.17956748401688805,1,1,1,1,1,5,4,5,5,2,5,3,5,3,4,5,4,5,3,3,1,0,4.4,0,3.8,0,4,0,4.066666666666666,0,1,2,1,1,1,1,1,1,1,1,2,2,1,1,1,1,2,1,1,1,1.2,0,"White, Caucasian, Anglo, European American",0,22,1,2,NA,5,2,0,0,0,0,0,TRUE,TRUE,TRUE,TRUE,TRUE,1,0.5780468749962747,0.5045843749977649,0.5134875000044703,0.7153064516109805,0.5982466666638852,0.6454107142899718,1,1,1,0.96875,0.967741935483871,0.875,0.082,0.274,0.337,0.01,1.836,117.67529449166052,2021.3176729618183,0.075,0.333,0.451,0.006,1.088,75.41941143776582,1900.396925657523,0.104,0.295,0.395,0.008,1.573,35.8642566833505,1858.3307790941335,183.6,181.33333333333334,196.625,FALSE,431,1.2770370370370372,0,0,0,0,3,FALSE
113,2022-03-18T17:05:44Z,0.8999999761581421,1.6,900,5,2,3,1,1,1,1,2,1,3,1,1,1,2,2,2,3,3,3,3,1,3,3,3,2,2,2,0,0,0,0,3,1,4,1,1,1,1,1,1,1,5,1,1,2,1,1,3,3,3,3,3,3,1,3,2,2,1,1,2,2,2,1,1,1,1,1,1,1,2,2,2,1.75,0,1.6666666666666667,0,1.5555555555555556,0,2.25,0,2,0,1.4285714285714286,0,1,0,1.7837837837837838,0,1,0,0,0.12711914775453853,-0.2450082774195883,-0.14114775846592847,-0.1930780179427584,1,2,2,1,1,1,1,1,-0.7920494875423887,5,5,5,5,4,4,5,4.714285714285714,0,0.6863762972672843,0,1.1056860096375256,3,1,3,3,3,3,4,2,5,2,3,4,3,5,5,2,4,4,4,1,2.6,0,3.6,0,3,0,3.6,0,3.4,0,1,1,1,1,2,1,1,1,1,1,1,1,1,1,1,1,3,2,1,1,1.2,0,"White, Caucasian, Anglo, European American",0,26,1,2,NA,5,2,0,0,1,0,0,TRUE,TRUE,TRUE,TRUE,TRUE,6,0.6774281250024214,0.513422580644969,0.5617812499990686,0.7403258064504593,0.6074580645186286,0.646971875000745,1,1,1,0.96875,0.96875,1,0.198,0.213,0.601,0.012,1.468,24.493261951245636,1806.823418950857,0.085,0.365,0.625,0.012,1.627,34.486643152007126,1858.9489481587896,0.079,0.448,0.361,0.018,1.751,41.4249644334029,1865.2630464799472,122.33333333333333,135.58333333333334,97.27777777777779,FALSE,294,0.8711111111111112,0,1,0,0,3,FALSE
115,2022-03-18T17:05:56Z,0.8999999761581421,1.7777777777777777,1080,3,3,4,2,5,3,5,3,4,4,4,5,4,3,1,3,4,2,4,1,1,3,4,4,3,3,1,3,0,0,0,3,1,1,2,3,1,2,1,5,4,1,3,1,4,3,1,5,5,5,5,5,4,1,1,1,5,5,1,1,1,1,2,2,3,1,3,2,4,4,1,1,2.5,0,3.6,0,2.111111111111111,0,3.5,0,2.8333333333333335,0,1.5714285714285714,0,2,0,2.5675675675675675,0,2,0,0,0.717092490662974,0.99586144642253,0.33667375751266887,0.6662676019675995,1,1,4,1,1,1,1,1,-0.7091149005366146,3,3,4,4,1,2,1,2.5714285714285716,0,-0.13222200579606097,1,-0.5539537626906533,1,2,1,3,1,5,5,4,5,4,5,5,4,4,5,5,5,5,4,3,1.6,0,5,0,4.4,0,4.2,0,4.533333333333333,0,1,3,3,4,2,4,4,2,4,4,3,3,4,2,1,3,3,4,4,4,3.1,0,"White, Caucasian, Anglo, European American",0,21,1,2,NA,5,2,1,0,1,0,1,TRUE,TRUE,TRUE,TRUE,TRUE,4,0.5866187499985098,0.4239031249899417,0.5067218750044703,0.6599258064531511,0.4906321428545884,0.796181249992922,1,1,1,1,0.875,1,0.121,0.263,0.427,0.012,2.113,260.8835921002525,2051.6899799633447,0.055,0.312,0.579,0.019,2.019,140.27214807144637,2006.7612581910269,0.087,0.365,0.387,0.037,2.01,44.82699739600726,1825.1492065232949,176.08333333333334,106.26315789473685,54.32432432432432,FALSE,254,0.7525925925925925,0,1,0,0,3,FALSE
117,2022-03-18T17:04:36Z,1,2.3703703703703702,1080,7,2,2,3,3,3,2,2,2,2,2,3,3,3,2,3,3,2,4,3,3,3,4,3,2,5,2,0,0,0,0,2,3,3,3,3,2,3,2,2,3,1,2,1,2,3,2,3,3,4,2,4,3,2,1,1,2,2,2,3,2,1,2,2,2,4,5,2,1,2,2,1,1.5,0,2.533333333333333,0,2.5555555555555554,0,2.5,0,1.8333333333333333,0,2,0,3.6666666666666665,0,2.4054054054054053,0,3,0,0,0.7741159364459455,0.5685043008628304,0.21142494422527977,0.3899646225440551,2,2,5,2,2,2,2,2.5,0.4516335802869379,3,3,3,3,1,1,2,2.2857142857142856,0,-0.42769554142692673,0,-0.8887289458021808,2,3,3,2,2,4,4,2,3,4,4,4,3,4,3,4,4,4,4,3,2.4,0,4,0,3.8,0,3,0,3.6,0,2,3,2,2,2,2,2,2,1,1,2,2,3,2,2,2,1,1,1,2,1.85,0,"White, Caucasian, Anglo, European American",0,27,0,1,NA,5,2,0,0,0,0,0,TRUE,TRUE,TRUE,TRUE,TRUE,1,0.4895843750005588,0.5381312499996275,0.5009281249998603,0.5539678571429104,0.5553903225809336,0.6217888888898823,1,1,1,0.9032258064516129,1,0.9,0.069,0.331,0.461,0.017,2.009,138.33967971934504,2027.336690809086,0.093,0.307,0.514,0.016,1.381,101.78882681539996,1886.5795958432232,0.054,0.379,0.477,0.025,1.907,37.75828313861087,1893.5888747806423,118.17647058823528,86.3125,76.28,FALSE,326,0.965925925925926,0,1,1,3,6,FALSE
118,2022-03-18T16:59:34Z,0.8999999761581421,1.7777777777777777,1080,6,3,4,4,4,4,5,4,4,4,2,4,2,5,1,4,5,4,4,1,1,4,3,4,3,2,2,0,0,0,0,3,5,5,4,4,3,2,2,4,2,2,4,1,4,3,3,4,4,3,3,2,1,1,1,2,3,1,1,3,3,1,3,4,2,1,1,1,1,1,2,3,1.75,0,3.7333333333333334,0,3.5555555555555554,0,2.9166666666666665,0,1.5,0,2.4285714285714284,0,1,0,2.5945945945945947,0,1,0,0,0.8969356658246534,1.1750249805251005,-0.14114775846592847,0.516938611029586,1,1,2,1,1,1,1,2,-0.48817982669274074,3,5,5,5,4,3,4,4.142857142857143,0,-0.10840883202778547,0,0.31198001942738923,3,1,3,4,4,4,5,2,3,3,1,3,5,4,3,5,3,5,4,3,3,0,3.2,0,4.4,0,3,0,3.533333333333333,0,1,2,2,4,3,1,2,2,2,1,2,1,1,1,1,2,2,2,1,1,1.7,0,"White, Caucasian, Anglo, European American",0,24,1,2,NA,5,2,0,0,1,0,0,TRUE,TRUE,TRUE,TRUE,TRUE,1,0.8339129032266717,0.5479031249997206,0.5797875000005588,0.8877677419363491,0.6838906249990687,0.681425000000745,1,1,1,1,1,1,0.246,0.22,0.685,0.004,0.836,82.28879075254112,1863.4850670819424,0.121,0.325,0.561,0.008,1.427,84.91664981179821,1873.501151667386,0.118,0.377,0.275,0.036,1.787,42.23654738056492,1821.8858863171936,209,178.375,49.63888888888889,FALSE,390,1.1555555555555557,0,1,0,6,9,FALSE
119,2022-03-18T17:01:02Z,0.8999999761581421,1.7786458333333333,768,4,2,4,3,2,3,2,1,4,2,2,2,3,4,2,4,4,2,3,1,1,1,3,3,2,2,2,0,0,0,0,3,3,3,4,4,3,4,4,3,3,4,2,2,4,2,1,3,3,3,2,2,3,3,1,1,1,1,1,5,5,1,2,1,1,1,1,1,1,1,1,1,1,0,2.8,0,3.4444444444444446,0,2.5833333333333335,0,1.6666666666666667,0,2.2857142857142856,0,1,0,2.4594594594594597,0,1,0,0,0.16001728955240654,0.27193063519139654,-0.39960647100849406,-0.06383791790854876,3,3,4,3,3,3,3,2.5,0.8663065153158088,4,4,4,3,3,3,4,3.5714285714285716,0,-0.9124655511234351,0,-0.48737319892134634,1,1,1,1,1,5,5,5,5,1,5,5,5,1,4,5,5,5,5,4,1,0,5,0,4.2,0,3.8,0,4.333333333333333,0,2,1,1,4,1,1,1,4,2,1,2,3,1,3,2,2,2,3,3,2,2.05,0,"Hispanic of Latino (e.g., Mexican American, Central American, and others)",0,22,1,2,NA,5,2,0,0,1,0,0,TRUE,TRUE,TRUE,TRUE,TRUE,2,0.7261937500000931,0.6798437500000583,0.7022281250003143,0.6822687500001048,0.6714758620692481,0.8104774193545623,1,1,1,1,0.9666666666666667,1,0.175,0.32,0.469,0.019,1.723,116.0385436363417,1903.5979066410523,0.075,0.404,0.343,0.013,1.405,140.98688617498823,1971.5186870843595,0.099,0.442,0.376,0.169,0.817,97.71878053563516,1885.885066746201,90.6842105263158,108.07692307692308,4.834319526627218,FALSE,304,0.9007407407407407,1,1,0,0,3,FALSE
120,2022-03-18T17:13:36Z,0.8999999761581421,1.6,900,7,3,3,2,4,3,4,4,3,2,3,2,3,3,2,4,3,2,2,1,1,2,3,3,3,0,2,0,0,0,0,2,2,1,2,1,1,2,1,1,2,2,2,1,2,2,1,3,3,3,3,5,3,1,1,1,1,1,1,1,1,1,3,3,2,1,1,1,1,1,1,1,1,0,3,0,1.4444444444444444,0,2.4166666666666665,0,1.3333333333333333,0,1.7142857142857142,0,1,0,1.7567567567567568,0,0,0,0,-0.21502152694329052,0.10702545039995226,-0.6189692744445258,-0.25597191202228675,1,2,3,1,1,2,2,1,-0.5432457265250663,5,4,4,4,2,3,4,3.7142857142857144,0,0.9573210046339616,0,0.728896863462257,2,2,2,4,3,4,5,4,5,1,5,4,3,4,5,5,4,4,5,4,2.6,0,4.2,0,3.8,0,4.4,0,4.133333333333334,0,2,3,1,3,3,2,4,3,2,3,3,2,1,2,1,2,2,2,2,3,2.3,0,"White, Caucasian, Anglo, European American",0,25,1,2,NA,5,2,0,0,0,0,0,TRUE,TRUE,TRUE,TRUE,TRUE,1,0.5606062499997206,0.4886031250001397,0.5222156249994878,0.6312999999996635,0.5672387096766502,0.584490625000326,1,1,1,0.96875,0.96875,1,0.104,0.328,0.579,0.02,1.765,103.89186905568292,1888.1153111050503,0.063,0.38,0.569,0.019,1.901,122.09899765275142,1954.384242205808,0.065,0.419,0.512,0.022,1.929,50.301277564128675,1875.8928913567945,88.25,100.05263157894737,87.68181818181819,FALSE,428,1.268148148148148,0,1,0,0,3,FALSE
121,2022-03-18T17:08:46Z,0.800000011920929,1.7777777777777777,864,6,4,4,4,1,4,2,3,3,2,2,2,2,2,4,2,3,2,3,4,4,4,4,1,3,1,2,0,0,0,0,3,2,2,3,4,3,4,3,4,3,2,2,2,2,2,3,3,2,3,2,3,2,3,3,4,3,3,3,2,2,2,4,2,2,1,1,1,2,2,2,2,2,0,2.6666666666666665,0,3.111111111111111,0,2.4166666666666665,0,3,0,2.4285714285714284,0,1,0,2.5675675675675675,0,1,0,0,0.9605387399671984,0.7520928399240266,-0.05499485428507328,0.3485489928194767,2,4,2,3,2,2,4,2,0.42410063037077533,3,4,3,3,3,3,2,3,0,0.34904059506318114,0,-0.028613732632353395,3,3,2,3,3,3,3,2,3,4,2,3,2,4,3,2,3,4,2,3,2.8,0,3,0,2.6,0,3,0,2.8666666666666667,0,3,2,3,3,3,2,3,2,2,2,2,1,3,1,1,2,2,2,1,2,2.1,0,"Asian or Asian American (e.g., Chinese, Japanese, and others)",0,22,0,1,NA,5,2,0,0,1,0,0,TRUE,TRUE,TRUE,TRUE,TRUE,4,0.46813437500596045,0.4408500000014901,0.4581096774224312,0.5688549999833107,0.5428576923425381,0.5667040000247955,1,1,0.96875,0.625,0.8387096774193549,0.78125,0.057,0.343,0.636,0.007,1.356,156.31155964046246,2075.658634580295,0.057,0.316,0.472,0.017,2.002,28.457916356136785,1889.930248011089,0.051,0.332,0.401,0.011,1.895,76.84262482602057,2016.738326957204,193.71428571428572,117.76470588235291,172.27272727272728,FALSE,390,1.1555555555555557,0,1,0,15,18,FALSE
122,2022-03-18T17:12:41Z,0.8999999761581421,1.7777777777777777,1080,6,3,1,1,1,1,1,1,1,1,1,1,1,1,1,1,1,1,1,1,1,1,1,1,1,0,2,0,0,0,0,1,1,1,1,1,1,1,1,1,1,1,1,1,1,1,1,1,1,1,1,1,1,1,1,1,1,1,1,1,1,1,1,1,1,1,1,1,1,1,1,1,1,0,1,0,1,0,1,0,1,0,1,0,1,0,1,0,0,0,0,-1.4366391923707953,-1.587751448753618,-0.6189692744445258,-1.103360361599072,2,2,2,2,2,1,2,1,-0.4603111395192921,5,5,5,5,3,3,5,4.428571428571429,0,-0.14160432944649845,0,0.44656634047260246,1,1,2,2,2,5,4,4,5,2,5,5,5,4,5,5,4,4,4,1,1.6,0,4.6,0,4,0,3.8,0,4.133333333333334,0,1,1,1,1,1,1,1,1,1,1,1,1,1,1,1,1,1,1,1,1,1,0,"White, Caucasian, Anglo, European American",0,29,1,2,NA,5,2,0,0,1,0,0,TRUE,TRUE,TRUE,TRUE,TRUE,5,0.4985750000011176,0.4674968749987893,0.5020968750002794,0.5545156249990687,0.5592838709662038,0.5624225806468918,1,1,1,1,0.96875,0.96875,0.066,0.383,0.555,0.014,1.236,21.355038400523693,1845.8375261440056,0.072,0.34,0.561,0.019,1.837,25.17414855384096,1847.697186169079,0.081,0.333,0.496,0.028,1.842,118.13290146544423,1905.0387768194112,88.28571428571428,96.6842105263158,65.78571428571429,FALSE,328,0.9718518518518519,0,1,0,0,3,FALSE
123,2022-03-18T17:05:10Z,0.4000000059604645,1.7777777777777777,720,6,3,2,5,1,5,1,1,2,1,1,1,1,2,1,2,2,1,1,5,1,1,1,1,1,2,2,0,0,0,0,1,2,2,1,1,1,2,2,2,1,1,1,1,2,1,2,1,1,1,1,1,1,1,1,1,1,1,1,2,1,1,5,1,1,1,1,1,1,1,2,1,1.25,0,1.8666666666666667,0,1.5555555555555556,0,1.1666666666666667,0,1,0,1.7142857142857142,0,1,0,1.3243243243243243,0,1,0,0,-0.9014960857921396,-0.849463954767833,-0.31345356682763886,-0.581458760797736,3,3,5,3,3,3,3,2,0.7558389783938718,4,4,4,4,1,1,4,3.142857142857143,0,-0.24706573651580854,0,-0.31429317401847046,1,1,1,1,1,5,5,5,5,5,5,5,5,5,3,5,5,5,3,1,1,0,5,0,4.6,0,3.8,0,4.466666666666667,0,1,1,1,1,1,1,1,1,1,1,1,1,1,1,1,1,1,1,1,1,1,0,Black or African American,0,28,0,1,NA,5,2,0,0,1,0,0,TRUE,TRUE,TRUE,TRUE,TRUE,1,0.5889187500000116,0.46575312500004656,0.5304843750000582,0.6902999999999884,0.5362448275863225,0.6037687500002212,1,1,1,1,0.9354838709677419,1,0.093,0.363,0.555,0.023,1.701,71.80454513843043,1861.4239598347024,0.061,0.37,0.688,0.018,1.711,50.127788693579305,1897.5829417921984,0.192,0.26,0.593,0.014,1.573,16.797720426960577,1798.3644363838437,73.95652173913044,95.05555555555557,112.35714285714285,FALSE,352,1.0429629629629629,0,1,0,3,6,FALSE
125,2022-03-18T17:13:49Z,0.8999999761581421,1.7777777777777777,720,3,2,4,4,2,4,3,1,4,1,2,NA,1,4,1,3,5,1,3,1,1,1,2,1,3,0,2,0,0,0,0,1,1,1,3,3,3,3,3,3,1,2,2,1,4,1,4,2,2,2,2,3,4,1,4,1,4,5,2,1,1,1,5,5,4,1,3,3,1,1,1,1,1,0,2.7857142857142856,1,2.3333333333333335,0,2.1666666666666665,0,3.1666666666666665,0,2.7142857142857144,0,2.3333333333333335,0,2.4864864864864864,0,0,0,0,-0.06588328412628867,0.11376831509881036,-0.6189692744445258,-0.2526004796728577,4,3,5,1,1,2,2,1,-0.04563820449042111,5,2,2,5,1,1,3,2.7142857142857144,0,-1.0930953560345533,0,-1.0618089707050569,3,3,4,5,2,2,3,2,3,3,2,4,2,4,3,3,4,2,4,2,3.4,0,2.8,0,3,0,2.8,0,2.8666666666666667,0,1,1,1,4,1,1,4,4,1,1,1,4,1,2,1,4,1,1,1,1,1.8,0,"Asian or Asian American (e.g., Chinese, Japanese, and others)",0,22,1,2,NA,5,2,0,0,1,0,0,TRUE,TRUE,TRUE,TRUE,TRUE,2,0.47923437508940697,0.42599062505364416,0.4281281251013279,0.5412933334032695,0.5243708333969116,0.49176538471075204,1,1,1,0.9375,0.75,0.8125,0.046,0.344,0.566,0.02,1.751,42.57144361291845,1940.00135539978,0.048,0.336,0.553,0.01,1.496,56.8052519391667,1950.8775470876976,0.07,0.327,0.494,0.016,1.71,72.67396797838974,1916.8982613787869,87.55,149.6,106.875,FALSE,304,0.9007407407407407,1,1,0,0,3,FALSE
126,2022-03-18T16:54:52Z,1,1.7777777777777777,900,6,3,5,2,3,3,2,4,4,5,2,3,4,4,1,5,3,3,5,1,1,3,4,4,3,1,2,0,0,0,0,1,4,2,1,2,3,2,2,1,2,2,5,1,2,1,1,4,5,4,5,5,3,4,1,1,2,3,1,1,3,2,4,5,4,1,3,2,2,3,1,2,2,0,3.3333333333333335,0,2,0,3.0833333333333335,0,2.3333333333333335,0,2.857142857142857,0,2,0,2.5675675675675675,0,1,0,0,0.8793899901991236,0.9885847716016792,-0.05499485428507328,0.466794958658303,1,1,2,2,1,2,1,2,-0.32231065268119236,5,4,5,3,2,2,5,3.7142857142857144,0,1.330900395513221,1,0.9564401536153769,3,2,4,5,4,2,3,1,3,1,3,2,2,3,4,3,3,2,2,4,3.6,0,2.4,0,2.2,0,3,0,2.533333333333333,0,2,4,3,3,4,4,3,3,3,3,1,3,4,4,2,3,1,3,4,3,3,0,"Asian or Asian American (e.g., Chinese, Japanese, and others)",0,22,0,1,NA,5,2,0,0,1,0,0,TRUE,TRUE,TRUE,TRUE,TRUE,6,0.5308935483732531,0.4727062499858439,0.5056968750059605,0.5800187499970197,0.558780000003179,0.7133999999894036,0.96875,1,1,1,0.9375,0.84375,0.069,0.353,0.37,0.007,1.638,198.5166088706305,2136.98838026513,0.058,0.379,0.646,0.017,1.697,39.44150006537313,1884.3569288414135,0.059,0.406,0.47,0.025,1.583,122.39152586296326,1951.339152196431,233.99999999999997,99.8235294117647,63.31999999999999,FALSE,322,0.9540740740740741,0,1,0,0,3,FALSE
128,2022-03-18T17:07:43Z,1,1.7777777777777777,1440,8,4,2,2,3,2,3,1,2,2,3,4,2,2,3,3,2,1,1,1,1,1,1,1,1,2,1,2,1,1,1,2,3,3,3,3,2,2,2,2,2,2,4,4,2,3,2,2,2,2,2,2,2,1,1,1,3,1,2,3,2,1,3,2,3,1,1,1,3,3,3,3,3,0,2.4,0,2.4444444444444446,0,2.4166666666666665,0,1.5,0,2.2857142857142856,0,1,0,2.135135135135135,0,1,1,1,-0.6997208160985483,-0.4809102084360904,1.895115263017989,0.7071025272909494,2,2,2,2,2,2,4,1,-0.21150737850196963,4,4,4,4,3,3,5,3.857142857142857,0,0.6473058850354002,0,0.6174725797407661,3,3,3,3,3,3,3,3,4,3,4,3,3,3,3,4,4,4,3,3,3,0,3.6,0,3.2,0,3.2,0,3.3333333333333335,0,3,2,3,3,2,3,3,3,3,2,3,3,2,3,3,3,1,3,3,3,2.7,0,"Asian or Asian American (e.g., Chinese, Japanese, and others)",0,28,0,1,NA,5,2,0,0,0,0,0,TRUE,TRUE,TRUE,TRUE,TRUE,4,0.5848937500000029,0.9469093749999739,0.5377806451613264,0.6794566666666418,0.8127645161290984,0.6470000000000621,1,1,1,1,0.96875,0.967741935483871,0.068,0.38,0.444,0.017,1.862,149.28917503648705,1974.924416484638,0.11,0.255,0.186,0.171,2.033,176.26171999953272,2001.5184400863968,0.185,0.238,0.57,0.008,1.272,99.61920432855123,1882.105844885766,109.52941176470588,11.888888888888888,159,FALSE,328,0.9718518518518519,0,1,1,3,6,FALSE
129,2022-03-18T16:25:33Z,0.8999999761581421,1.7777777777777777,1080,3,2,1,1,2,1,1,1,1,1,1,1,1,1,1,1,3,1,1,1,1,1,1,1,1,5,2,0,0,0,0,2,1,1,1,1,1,1,1,1,1,1,1,1,1,1,1,1,1,1,1,1,1,1,1,1,3,1,1,4,4,2,1,1,1,1,1,1,2,1,3,3,2.25,0,1.2,0,1.1111111111111112,0,1,0,1.3333333333333333,0,2,0,1,0,1.2702702702702702,0,3,0,0,-1.2611824361154984,-1.3824312186733945,0.4698836567678454,-0.45627378095277454,1,1,2,1,1,1,2,1,-0.7920494875423887,5,5,5,5,3,3,5,4.428571428571429,0,0.4002850852868561,0,0.7766255014915452,2,2,2,2,2,4,5,4,4,1,5,3,3,4,3,4,3,3,2,2,2,0,3.6,0,3,0,3.4,0,3.3333333333333335,0,1,1,1,1,1,1,1,1,1,1,1,1,1,1,1,1,1,1,1,1,1,0,"White, Caucasian, Anglo, European American",0,22,0,1,NA,5,2,0,0,1,0,0,TRUE,TRUE,TRUE,TRUE,TRUE,5,0.6859838709687033,0.6435999999998603,0.6086656249999068,0.6100482758625314,0.6576166666664183,0.6845518518520726,1,1,1,0.90625,0.9375,0.8709677419354839,0.067,0.372,0.303,0.013,1.666,138.30915274750558,2070.764242133799,0.072,0.359,0.274,0.035,1.769,53.66767701135669,1918.73097391602,0.064,0.354,0.229,0.183,1.64,168.8472404127088,2053.7683481977147,128.15384615384616,50.54285714285714,8.96174863387978,FALSE,472,1.3985185185185185,0,1,1,24,27,FALSE
130,2022-03-18T16:57:54Z,0.8999999761581421,1.6,800,8,3,2,2,1,2,2,1,3,1,1,2,3,3,2,3,2,1,3,1,1,1,2,1,2,0,2,0,0,0,0,1,1,1,1,1,1,3,1,1,2,2,1,1,2,1,1,2,1,1,1,1,2,1,1,1,3,1,1,1,1,1,1,1,1,1,1,1,2,1,1,1,1.25,0,2,0,1.2222222222222223,0,1.3333333333333333,0,1.5,0,1,0,1,0,1.2432432432432432,0,0,0,0,-0.954133112668729,-0.8266505958700302,-0.5328163702636706,-0.6797334830668504,1,1,2,1,1,1,1,1,-0.874984074548163,4,4,5,3,1,1,4,3.142857142857143,0,0.13872270157061628,1,-0.07931348121847359,2,4,2,3,2,5,3,4,4,3,5,4,4,3,3,3,4,4,3,3,2.6,0,4.4,0,3.2,0,3.4,0,3.6666666666666665,0,2,2,3,4,2,3,3,4,2,2,1,3,1,2,1,3,2,3,2,1,2.3,0,"White, Caucasian, Anglo, European American",0,30,1,2,NA,5,2,1,1,0,0,2,TRUE,TRUE,TRUE,TRUE,TRUE,5,0.5813419355730857,0.5158312499970198,0.5789875000268221,0.6271218750625849,0.5749937500357628,0.6352156251370906,1,1,1,1,1,1,0.115,0.419,0.729,0.029,1.731,65.25076369874425,1847.519737558033,0.081,0.403,0.754,0.022,1.661,27.506808782545885,1813.5075151212116,0.086,0.46,0.702,0.031,1.646,78.59857310718064,1864.8775468953277,59.689655172413794,75.5,53.096774193548384,FALSE,388,1.1496296296296296,0,1,0,0,3,FALSE
131,2022-03-18T17:08:40Z,0.8999999761581421,1.7777777777777777,1080,6,2,4,4,3,3,2,1,3,4,2,3,3,4,3,4,3,2,1,1,1,2,1,1,1,2,2,0,0,0,0,3,3,2,2,3,3,2,3,4,4,3,2,4,3,3,2,2,3,2,3,3,1,1,1,1,3,1,1,3,3,1,2,2,3,1,2,1,2,2,3,4,2.75,0,3.066666666666667,0,2.7777777777777777,0,2.8333333333333335,0,1.3333333333333333,0,2.142857142857143,0,1.3333333333333333,0,2.324324324324324,0,1,0,0,-0.414603587183691,0.0019069992717150306,0.20346385825749233,0.10268542876460368,2,2,2,2,2,2,2,1,-0.3773765525135179,4,3,3,3,3,2,4,3.142857142857143,0,0.43348058270556905,0,0.1002204537615918,3,4,2,3,3,3,2,4,3,3,4,3,4,3,3,3,3,3,4,3,3,0,3.2,0,3.2,0,3.2,0,3.2,0,2,3,3,3,2,2,2,3,3,3,2,3,2,2,2,2,2,3,2,2,2.4,0,"White, Caucasian, Anglo, European American",0,23,0,1,NA,5,2,0,0,0,0,0,TRUE,TRUE,TRUE,TRUE,TRUE,2,0.6041806451612858,0.5383187499999876,0.6395937499999982,0.6673062500000014,0.5884468750000015,0.6995531249999949,1,1,1,1,1,1,0.092,0.404,0.368,0.041,1.314,8.383415261267775,1788.8385852507413,0.07,0.406,0.493,0.037,1.682,29.33250264795917,1813.6660113819048,0.087,0.398,0.394,0.025,1.494,66.06937402387423,1850.052885714039,32.048780487804876,45.45945945945946,59.76,FALSE,304,0.9007407407407407,1,1,0,0,3,FALSE
132,2022-03-18T16:54:40Z,0.8999999761581421,1.7786458333333333,768,3,2,3,3,3,3,2,2,4,3,2,3,3,3,3,4,3,2,3,3,1,2,2,3,2,1,2,0,0,0,0,3,4,3,3,5,3,3,3,3,4,3,3,3,3,2,3,3,1,2,3,2,3,2,3,4,3,2,2,2,1,1,3,3,4,3,3,2,4,3,3,3,3.25,0,2.933333333333333,0,3.3333333333333335,0,2.6666666666666665,0,2.8333333333333335,0,2.2857142857142856,0,2.6666666666666665,0,2.7837837837837838,0,1,0,0,0.5328628965949126,0.5808943147469818,0.37576966661920275,0.4783319906830923,3,2,5,2,1,3,2,2.5,0.5345681672927123,4,4,5,4,3,3,4,3.857142857142857,0,-0.8792700537047221,0,-0.31234881900385125,3,3,3,3,3,3,3,4,4,3,3,3,4,3,3,3,3,3,3,3,3,0,3,0,3.2,0,3.4,0,3.2,0,3,2,2,2,2,2,2,3,3,1,2,2,2,2,1,3,1,1,1,2,1.95,0,"Hispanic of Latino (e.g., Mexican American, Central American, and others)",0,30,1,2,NA,5,2,0,0,0,0,0,TRUE,TRUE,TRUE,TRUE,TRUE,3,0.56353125,0.4767903225921815,0.4975093749947846,0.5723937500007451,0.5029516129186077,0.5517499999957425,1,0.96875,1,1,0.96875,0.875,0.051,0.384,0.505,0.015,1.553,78.809318371654,1937.228220139729,0.049,0.37,0.506,0.025,1.48,109.6383127627037,1978.8688943399009,0.125,0.343,0.577,0.1,1.944,42.669347118217424,1825.1668109217771,103.53333333333333,59.199999999999996,19.439999999999998,FALSE,522,1.5466666666666666,0,1,0,0,3,FALSE
133,2022-03-18T17:18:17Z,0.8999999761581421,1.6,900,7,3,1,1,2,1,1,1,2,1,1,1,1,2,2,1,1,5,2,1,1,1,1,1,1,1,2,0,0,0,0,1,1,1,1,1,1,1,1,1,1,1,1,1,1,1,1,1,1,1,1,2,1,1,1,1,1,1,1,1,1,1,1,1,1,1,1,1,1,1,1,1,1,0,1.2666666666666666,0,1,0,1.0833333333333333,0,1,0,1,0,1,0,1.027027027027027,0,1,0,0,-1.0133497679048913,-1.1866493326150969,-0.39960647100849406,-0.7931279018117955,1,1,2,1,1,5,2,1,-0.4603111395192921,5,5,5,5,2,3,5,4.285714285714286,0,0.43348058270556905,0,0.7194418556870088,2,2,3,3,2,5,3,3,4,2,5,2,3,4,5,3,3,4,5,2,2.4,0,3.8,0,3.2,0,3.6,0,3.533333333333333,0,1,1,1,1,1,1,1,1,1,1,1,1,1,1,1,1,1,1,1,1,1,0,"White, Caucasian, Anglo, European American",0,30,1,2,NA,5,2,0,0,1,0,0,TRUE,TRUE,TRUE,TRUE,TRUE,2,0.5140250000022352,0.4583375000031665,0.5102531249988824,0.5722741935464644,0.5352933333347241,0.5870774193531082,1,1,1,0.96875,0.9375,0.96875,0.069,0.363,0.466,0.02,1.796,37.75362469812185,1859.3577757100447,0.072,0.331,0.608,0.017,1.834,106.00314262747254,1947.9267408167057,0.095,0.301,0.491,0.01,1.343,125.75166390303716,1952.7230778784815,89.8,107.88235294117646,134.29999999999998,FALSE,416,1.2325925925925925,0,1,0,0,3,FALSE
134,2022-03-18T17:20:15Z,1,1.7777777777777777,864,7,3,3,1,2,2,1,1,5,3,2,1,1,3,3,2,2,2,3,1,1,3,2,3,2,3,2,0,0,0,0,1,3,5,1,1,3,4,4,2,3,4,1,4,4,4,4,5,5,4,4,2,3,1,1,1,5,5,1,3,3,1,1,1,1,3,3,2,4,2,2,2,2.5,0,2.1333333333333333,0,2.6666666666666665,0,3.6666666666666665,0,2.6666666666666665,0,1.5714285714285714,0,2.6666666666666665,0,2.7837837837837838,0,2,0,0,0.45171414682683775,0.1770388621897606,0.33667375751266887,0.2568563098512147,2,2,5,2,1,2,2,1.5,-0.01810525457425849,4,4,4,4,1,1,1,2.7142857142857144,0,-0.27098964413394167,0,-0.5610730010380436,2,3,2,3,3,3,5,3,4,5,5,2,5,4,4,4,5,5,4,5,2.6,0,4,0,4.6,0,4,0,4.2,0,1,1,1,4,1,1,1,2,1,1,1,2,1,2,1,2,1,1,1,1,1.35,0,"White, Caucasian, Anglo, European American",0,28,1,2,NA,5,2,0,0,1,0,0,TRUE,TRUE,TRUE,TRUE,TRUE,2,0.57003125,0.54678125,0.5622258064516129,0.67046875,0.6150645161290322,0.6289677419354839,1,1,1,1,1,0.96875,0.071,0.394,0.44,0.018,1.632,68.42877709809554,1893.8146847198252,0.073,0.383,0.442,0.025,1.712,82.32698968477875,1866.2606111526477,0.197,0.25,0.621,0.019,1.742,48.60262009738282,1831.1081477042712,90.66666666666667,68.47999999999999,91.6842105263158,FALSE,360,1.0666666666666667,0,1,0,0,3,FALSE
135,2022-03-18T17:22:55Z,0.8999999761581421,1.7777777777777777,720,6,4,4,4,4,3,4,4,2,4,2,2,3,3,1,3,3,3,3,1,1,4,3,4,2,1,2,0,0,0,0,1,1,1,1,2,1,1,1,1,1,1,2,1,1,1,1,4,1,1,2,3,2,1,1,1,1,1,1,1,1,1,3,3,2,1,2,2,2,2,1,1,1.5,0,3.066666666666667,0,1.1111111111111112,0,1.5833333333333333,0,1.1666666666666667,0,1.7142857142857142,0,1.6666666666666667,0,1.4324324324324325,0,1,0,0,-0.10097463537734769,0.21283223563286444,-0.22730066264678367,-0.007234213506959616,2,2,3,3,1,2,2,3.5,0.6725686541308118,4,4,5,4,3,3,3,3.7142857142857144,0,-0.17479982686521142,0,0.03933393483307579,1,2,1,1,2,4,3,4,5,4,5,5,5,5,5,1,5,5,3,4,1.4,0,4.8,0,3.2,0,4.6,0,4.2,0,3,1,2,3,4,2,3,4,2,1,1,2,2,2,1,2,2,2,1,3,2.15,0,"White, Caucasian, Anglo, European American",0,27,1,1,NA,5,2,0,0,1,0,0,TRUE,TRUE,TRUE,TRUE,TRUE,5,0.4700062500005588,0.39989687499962745,0.4389499999973923,0.5343793103427722,0.4784733333339294,0.5376321428567171,1,1,1,0.90625,0.9375,0.875,0.059,0.328,0.63,0.01,1.614,131.39975812670724,2000.9559557573116,0.059,0.308,0.612,0.025,1.975,81.56031452945408,1935.4927678472309,0.058,0.358,0.533,0.024,1.938,77.05774046883027,1935.0825325020396,161.4,79,80.75,FALSE,318,0.9422222222222223,0,1,0,0,3,FALSE
136,2022-03-18T17:03:56Z,1,1.7777777777777777,864,6,2,3,2,2,2,4,1,4,3,2,3,4,3,3,3,2,3,4,2,1,3,3,3,3,2,2,0,0,0,0,2,3,1,2,2,1,2,2,3,2,3,3,2,2,3,2,4,4,3,5,4,3,1,2,1,3,3,1,2,2,1,2,3,3,2,2,2,3,2,2,2,2.25,0,2.7333333333333334,0,2,0,3.0833333333333335,0,2.1666666666666665,0,2,0,2,0,2.3783783783783785,0,1,0,0,0.5942727612842665,0.5348742631772767,0.031158049895781924,0.28301615653652934,2,2,4,3,2,3,2,3,0.7279702912204233,4,4,5,4,1,1,3,3.142857142857143,0,-0.30418514155265464,0,-0.3490840047521533,2,2,2,2,2,4,4,4,4,4,5,4,1,3,4,5,4,4,4,2,2,0,4.2,0,3.6,0,3.4,0,3.7333333333333334,0,3,2,2,4,2,3,1,3,2,1,3,3,3,3,2,4,1,3,3,1,2.45,0,"White, Caucasian, Anglo, European American",0,30,0,1,NA,5,2,0,0,0,0,0,TRUE,TRUE,TRUE,TRUE,TRUE,1,0.592441935479641,0.43120999999841053,0.42648387096966467,0.585890322583337,0.5124967742004702,0.5159799999992053,1,0.9375,0.96875,0.96875,0.96875,0.967741935483871,0.064,0.314,0.626,0.009,1.261,150.70215488266317,2032.036523057459,0.05,0.339,0.457,0.021,1.665,204.8185996887259,2101.04632234507,0.065,0.375,0.335,0.039,1.821,128.46180395061327,1953.4260254731655,140.11111111111111,79.28571428571428,46.69230769230769,FALSE,400,1.1851851851851851,0,1,0,3,6,FALSE
137,2022-03-18T17:07:17Z,0.8999999761581421,1.4995014955134596,1003,7,3,3,4,3,3,3,4,3,3,4,3,3,4,2,4,3,2,1,1,1,1,1,3,1,2,2,0,0,0,0,3,2,3,2,3,2,3,3,3,4,3,4,2,3,3,3,2,3,2,2,4,2,1,2,1,1,2,3,2,1,1,3,2,3,2,2,2,2,1,1,1,1.25,0,3.2666666666666666,0,2.6666666666666665,0,2.9166666666666665,0,1.5,0,2.142857142857143,0,2,0,2.4054054054054053,0,1,0,0,-0.2808178105390271,0.17920219794731077,-0.31345356682763886,-0.06712568444016405,3,3,4,3,2,3,3,2,0.5899698043823236,3,2,4,4,2,2,4,3,0,-1.2405296635269585,0,-0.9968043111272092,3,2,3,4,3,3,2,3,3,3,3,4,3,3,3,2,2,3,2,3,3,0,3,0,2.4,0,3,0,2.8,0,2,1,1,3,2,1,1,2,2,1,1,2,2,1,1,2,2,1,1,2,1.55,0,"Asian or Asian American (e.g., Chinese, Japanese, and others)",0,26,1,2,NA,5,2,0,0,0,0,0,TRUE,TRUE,TRUE,TRUE,TRUE,2,0.4636218750000116,0.40673749999993014,0.43298387096774194,0.5178555555556107,0.4704399999999131,0.5040160000001639,1,1,0.96875,0.9,0.9375,0.78125,0.046,0.348,0.592,0.01,1.38,164.33422819557313,2151.5650388012264,0.052,0.326,0.598,0.013,1.226,180.20320444452992,2053.9250948988533,0.051,0.363,0.551,0.022,1.774,100.71990032901178,1997.723118399389,138,94.3076923076923,80.63636363636364,FALSE,428,1.268148148148148,0,1,0,0,3,FALSE
138,2022-03-18T17:21:18Z,0.8999999761581421,1.7777777777777777,864,6,2,3,1,3,2,4,3,1,3,1,1,1,1,3,2,1,1,4,1,1,1,1,3,1,0,2,0,0,0,0,1,1,1,1,1,1,1,1,1,1,1,1,1,2,1,4,5,3,2,3,4,3,1,1,1,5,5,1,1,2,1,2,5,2,1,1,1,2,1,1,2,1.5,0,2,0,1,0,2.3333333333333335,0,2.6666666666666665,0,2,0,1,0,1.8918918918918919,0,0,0,0,-0.45188814788794135,-0.48887521736161643,-0.4466634660828154,-0.4677693417222159,1,1,3,1,1,1,1,1,-0.7920494875423887,5,5,5,5,1,1,2,3.4285714285714284,0,-0.15675083406024948,0,-0.10447796336729244,1,2,1,1,1,5,4,5,5,4,5,4,3,4,3,4,3,5,3,3,1.2,0,4.4,0,3.6,0,4,0,4,0,1,1,1,1,2,1,2,1,1,1,3,1,1,1,1,1,1,1,1,2,1.25,0,"White, Caucasian, Anglo, European American",0,25,1,2,NA,5,2,0,0,1,0,0,TRUE,TRUE,TRUE,TRUE,TRUE,3,0.47141562500223516,0.4302843749895692,0.4242750000208616,0.5654999999884636,0.49868387096543465,0.5144812500067055,1,1,1,0.96875,1,1,0.104,0.29,0.737,0.027,2.066,86.67086261608631,1873.648069319832,0.082,0.32,0.823,0.017,1.588,49.098425569391786,1833.613758369476,0.07,0.342,0.561,0.013,1.552,51.27717161704209,1875.712908771227,76.51851851851852,93.41176470588235,119.38461538461539,FALSE,384,1.1377777777777778,0,1,0,0,3,FALSE
139,2022-03-18T17:26:39Z,0.8999999761581421,1.7777777777777777,864,6,3,5,2,1,2,1,3,3,3,3,1,3,4,1,4,4,1,3,1,1,1,2,2,1,1,2,0,0,0,0,2,2,3,3,3,2,3,2,3,1,2,1,2,4,2,3,3,1,1,1,1,3,2,1,1,1,1,1,2,2,2,3,3,2,1,1,1,1,1,2,2,1.5,0,2.6666666666666665,0,2.5555555555555554,0,1.8333333333333333,0,1.5,0,2.142857142857143,0,1,0,1.945945945945946,0,1,0,0,-0.4979455464049568,-0.2287832592379614,-0.22730066264678367,-0.22804196094237253,3,1,3,1,1,1,1,1,-0.6261803135308405,4,4,4,4,1,1,4,3.142857142857143,0,-0.41254903681317573,0,-0.4150873172029633,1,1,1,1,1,5,4,5,5,1,5,4,5,3,3,5,4,5,4,4,1,0,4.6,0,3.8,0,4,0,4.133333333333334,0,1,1,1,3,1,1,1,3,2,1,2,3,1,2,1,3,1,1,1,2,1.6,0,"White, Caucasian, Anglo, European American",0,23,2,2,NA,5,2,0,0,1,0,0,TRUE,TRUE,TRUE,TRUE,TRUE,2,0.509728125013411,0.4292709677411664,0.46788750000298024,0.6181965517298929,0.5208225806374703,0.6305344827462886,1,1,1,0.9354838709677419,0.96875,0.90625,0.074,0.323,0.498,0.011,1.791,63.22254546807301,1918.8765734083584,0.075,0.317,0.685,0.02,1.893,30.156690736642744,1852.249222303386,0.064,0.352,0.438,0.009,1.434,104.31399419212568,1945.736352841868,162.8181818181818,94.65,159.33333333333334,FALSE,422,1.2503703703703704,0,1,0,0,3,FALSE
142,2022-03-18T17:24:43Z,1,1.7777777777777777,864,5,1,5,3,3,5,1,5,5,4,4,4,3,5,2,5,5,5,5,1,1,5,5,5,1,0,2,0,0,0,0,2,5,5,4,5,2,3,3,3,4,2,5,1,4,1,2,5,5,5,5,5,4,1,1,1,2,1,1,1,1,1,5,5,4,1,4,5,1,1,1,1,1,0,3.933333333333333,0,3.5555555555555554,0,3.6666666666666665,0,1.6666666666666667,0,2.5714285714285716,0,3.3333333333333335,0,3.081081081081081,0,0,0,0,1.5373528261564866,1.6930455610148598,-0.6189692744445258,0.537038143285167,1,2,3,1,1,2,1,1,-0.6261803135308405,5,3,5,2,1,2,3,3,0,-0.788955151249163,0,-0.7217550102780903,1,3,1,4,1,5,4,5,5,3,5,5,4,2,5,1,5,5,4,3,2,0,5,0,3.2,0,4,0,4.066666666666666,0,3,1,2,4,2,3,2,4,3,4,2,3,2,4,1,4,1,3,3,3,2.7,0,"White, Caucasian, Anglo, European American",0,29,1,4,Genderqueer,4,2,0,0,1,1,0,TRUE,TRUE,TRUE,TRUE,TRUE,4,0.5629516129003417,0.5026774193558001,0.5301374999983236,0.6677781250020489,0.5903933333347241,0.638374999997206,1,1,1,1,0.9375,1,0.163,0.268,0.609,0.016,1.758,55.7799832353791,1839.9132376364391,0.058,0.389,0.511,0.014,1.463,17.047984604060833,1861.9966902179317,0.145,0.32,0.609,0.013,1.625,87.11282323041186,1870.0251785648427,109.875,104.5,125,FALSE,304,0.9007407407407407,1,0,0,0,3,FALSE
143,2022-03-18T17:22:41Z,0.8999999761581421,1.6,800,6,4,1,1,2,1,2,1,1,1,1,1,1,1,1,1,2,1,1,1,1,1,1,1,1,1,2,0,0,0,0,1,1,1,1,1,1,1,1,1,1,1,1,1,1,1,1,1,1,1,1,1,1,1,1,1,2,1,1,1,1,1,1,1,1,1,1,1,1,1,1,1,1,0,1.2,0,1,0,1,0,1.1666666666666667,0,1,0,1,0,1.027027027027027,0,1,0,0,-1.4190935167452654,-1.4886313376804068,-0.39960647100849406,-0.9441189043444504,1,1,1,1,1,1,2,1,-0.874984074548163,5,5,5,5,4,3,5,4.571428571428571,0,0.9002015995971155,0,1.158522084172637,1,2,2,3,2,4,3,3,5,1,5,4,4,3,4,5,4,5,4,3,2,0,4.4,0,3.4,0,3.6,0,3.8,0,1,1,1,4,1,1,1,1,1,1,1,1,1,1,1,1,1,1,1,1,1.15,0,"Asian or Asian American (e.g., Chinese, Japanese, and others)",0,22,1,2,NA,5,2,0,0,1,0,0,TRUE,TRUE,TRUE,TRUE,TRUE,6,0.6643500000014901,0.48912812500074504,0.5473531249994412,0.660531249997206,0.577406250002794,0.6821586206894497,1,1,1,1,1,0.90625,0.08,0.415,0.662,0.012,1.875,17.003292732922684,1872.1908611486783,0.113,0.36,0.855,0.013,1.37,38.25317854055454,1819.936754829577,0.232,0.28,0.624,0.169,1.24,303.92918248043185,2091.054309674945,156.25,105.3846153846154,7.337278106508875,FALSE,388,1.1496296296296296,0,1,0,0,3,FALSE
144,2022-03-18T17:17:52Z,0.8999999761581421,1.6,900,6,4,1,1,1,1,1,1,1,1,1,1,1,1,2,1,1,1,2,1,1,1,1,1,1,1,2,0,0,0,0,1,1,1,1,1,1,1,1,1,1,1,1,1,1,1,1,1,1,1,1,1,1,1,1,1,2,1,1,1,1,1,1,1,1,1,1,1,1,1,1,1,1,0,1.0666666666666667,0,1,0,1,0,1.1666666666666667,0,1,0,1,0,1.027027027027027,0,1,0,0,-1.3379447669771907,-1.4922696750908322,-0.39960647100849406,-0.9459380730496632,1,1,2,1,1,1,1,1,-0.874984074548163,5,5,5,5,3,3,5,4.428571428571429,0,1.384971609293624,0,1.3763877392172197,1,1,1,2,2,5,4,5,5,1,5,3,5,4,5,5,5,5,5,3,1.4,0,4.6,0,4,0,4.4,0,4.333333333333333,0,1,1,1,1,1,1,1,1,1,1,1,1,1,1,1,1,1,1,1,1,1,0,"Asian or Asian American (e.g., Chinese, Japanese, and others)",0,26,1,2,NA,5,2,0,0,1,0,0,TRUE,TRUE,TRUE,TRUE,TRUE,3,0.613815625000163,0.5221437500003958,0.5538124999996508,0.7462999999996973,0.5947967741937648,0.6714903225806211,1,1,1,1,1,0.96875,0.104,0.335,0.503,0.015,1.949,43.41438990100045,1865.9846179855992,0.12,0.341,0.665,0.009,1.078,19.91218578251396,1801.9179395431916,0.122,0.361,0.495,0.013,1.73,71.95895036947302,1854.531102511561,129.93333333333334,119.7777777777778,133.0769230769231,FALSE,436,1.2918518518518518,0,1,0,0,3,FALSE
145,2022-03-18T17:25:45Z,0.8999999761581421,1.7777777777777777,1080,4,4,3,3,2,2,2,3,4,3,2,2,5,5,1,4,4,3,2,1,1,4,4,3,5,5,1,1,0,1,0,2,2,4,2,2,2,1,1,1,3,3,5,3,3,3,2,2,3,5,5,5,2,1,1,1,3,1,1,3,3,3,3,3,3,1,1,5,2,1,2,2,1.75,0,3,0,1.8888888888888888,0,3.5,0,1.5,0,2.7142857142857144,0,2.3333333333333335,0,2.5405405405405403,0,3,0,0,0.780695564805519,0.7766762008052794,0.297577848406135,0.5371270246057072,2,2,2,3,1,1,3,4.5,0.9764383149804601,5,5,5,5,2,2,4,4,0,1.351776111874911,0,1.1239606840590473,2,2,2,1,3,3,5,4,4,3,4,4,4,4,4,5,4,5,4,3,2,0,4,0,4.2,0,3.8,0,4,0,4,4,4,2,4,4,4,2,3,2,4,2,3,3,3,2,1,4,3,4,3.1,0,"Asian or Asian American (e.g., Chinese, Japanese, and others)",0,27,0,1,NA,5,2,0,0,1,0,0,TRUE,TRUE,TRUE,TRUE,TRUE,3,0.4898937499932945,0.4533437499962747,0.5061593749858438,0.5930093749985099,0.5326066666762034,0.5726437500268221,1,1,1,1,0.9375,1,0.074,0.387,0.673,0.017,1.53,74.36761665022404,1855.094440834441,0.053,0.38,0.748,0.019,1.704,61.08723187664557,1910.8274489311696,0.102,0.366,0.837,0.016,1.771,32.7110220475876,1812.5110458413253,90,89.6842105263158,110.68749999999999,FALSE,322,0.9540740740740741,0,1,0,0,3,FALSE
146,2022-03-18T17:28:09Z,0.8999999761581421,1.6,900,6,4,1,1,1,1,1,1,1,1,1,1,1,1,1,1,1,1,1,1,1,1,1,1,1,0,2,0,0,0,0,1,1,1,1,1,1,1,1,1,1,1,1,1,1,1,1,1,1,1,1,2,1,1,1,1,3,1,1,1,1,1,1,2,1,1,1,1,1,1,1,1,1,0,1,0,1,0,1.0833333333333333,0,1.3333333333333333,0,1.1428571428571428,0,1,0,1.1081081081081081,0,0,0,0,-1.3664564898686766,-1.5405513958616124,-0.6189692744445258,-1.0797603351530691,1,1,1,1,1,1,1,1,-0.9579186615539372,5,5,5,5,4,3,5,4.571428571428571,0,1.1711463069637928,0,1.3235516646821082,1,2,1,1,1,5,5,4,4,2,5,5,4,5,4,4,5,5,4,5,1.2,0,5,0,3.8,0,4.4,0,4.4,0,2,1,3,3,1,4,2,4,2,3,4,3,1,2,1,2,1,2,1,3,2.25,0,"White, Caucasian, Anglo, European American",0,28,1,2,NA,5,2,0,0,0,0,0,TRUE,TRUE,TRUE,TRUE,TRUE,4,0.478858064516117,0.4338781250000029,0.46277187500000583,0.5670799999999969,0.5363333333333411,0.5801499999999875,0.96875,1,1,0.9375,0.9375,0.8387096774193549,0.058,0.365,0.605,0.011,1.515,99.18851593457585,1962.2066122731765,0.063,0.36,0.848,0.02,2.024,88.84101542745776,1943.22756328152,0.074,0.363,0.748,0.015,1.848,207.6552698634449,2107.453928997632,137.72727272727272,101.2,123.20000000000002,FALSE,436,1.2918518518518518,0,1,0,3,6,FALSE
147,2022-03-18T17:18:31Z,1,1.7777777777777777,864,4,2,1,1,1,1,1,1,1,1,2,1,1,1,1,1,2,1,1,5,1,1,1,1,1,2,2,0,0,0,0,1,4,1,1,1,4,2,2,3,2,1,2,1,3,2,1,1,1,1,2,2,3,1,1,3,1,1,2,2,2,1,1,1,2,1,1,1,2,2,2,2,2,0,1.1333333333333333,0,2.111111111111111,0,1.5833333333333333,0,1.6666666666666667,0,1.5714285714285714,0,1,0,1.6756756756756757,0,1,0,0,-0.6734023026602539,-1.0162374749862522,-0.05499485428507328,-0.5356161646356628,1,1,2,2,1,1,1,2,-0.40524523968696646,5,5,5,5,2,2,5,4.142857142857143,0,0.03902547546461973,0,0.40178071033089585,3,1,3,2,3,3,3,2,4,1,5,3,3,5,5,4,5,4,3,1,2.4,0,4,0,2.8,0,3.4,0,3.4,0,1,1,1,1,1,1,1,1,1,1,1,1,1,1,1,1,1,1,1,1,1,0,"White, Caucasian, Anglo, European American",0,27,0,1,NA,5,2,0,0,1,0,0,TRUE,TRUE,TRUE,TRUE,TRUE,6,0.6797096774193548,0.541,0.6417419354838709,0.7123125,0.6019375,0.768625,1,1,1,1,1,1,0.115,0.29,0.339,0.018,1.817,43.95690246001431,1826.2279139651123,0.146,0.279,0.578,0.022,1.88,38.90216460754887,1822.4455592188056,0.192,0.282,0.506,0.029,1.369,118.4166101427298,1898.896153077147,100.94444444444444,85.45454545454545,47.206896551724135,FALSE,393,1.1644444444444444,0,1,0,0,3,FALSE
148,2022-03-18T17:13:12Z,1,1.7777777777777777,1206,3,2,5,5,5,4,3,4,5,4,3,3,4,5,3,5,3,3,3,1,2,2,3,3,2,2,2,0,0,0,0,3,5,3,5,5,4,3,4,4,3,3,3,1,3,3,3,5,3,2,2,3,3,2,2,1,3,2,2,3,2,1,4,2,2,2,3,2,3,3,4,4,3.5,0,4.066666666666666,0,4,0,2.8333333333333335,0,2.1666666666666665,0,2.2857142857142856,0,2.3333333333333335,0,2.864864864864865,0,1,0,0,0.6666486732395762,1.1656833033902243,0.46192257080005794,0.8138029370951412,3,3,5,3,2,3,2,1.5,0.39656768045461255,2,3,2,1,1,1,2,1.7142857142857142,0,-1.2737251609456715,0,-1.7136474177294443,3,2,3,3,3,4,1,4,5,1,4,2,3,3,3,5,3,5,4,4,2.8,0,3.6,0,2.8,0,3.8,0,3.4,0,2,1,1,1,2,1,1,2,1,1,2,2,1,1,1,1,1,1,1,1,1.25,0,Prefer not to say,0,29,0,1,NA,5,2,0,0,3,0,0,TRUE,TRUE,TRUE,TRUE,TRUE,3,0.6332258064516129,0.4738125,0.541125,0.62103125,0.5006333333333334,0.6092333333333333,1,1,1,1,0.9375,0.9375,0.076,0.317,0.36,0.009,1.286,118.01520136504394,1981.5113971883168,0.043,0.389,0.494,0.056,1.756,69.83448618597885,1920.656511564814,0.099,0.356,0.414,0.048,1.551,12.160300571333687,1792.131226026309,142.88888888888891,31.357142857142858,32.3125,FALSE,546,1.6177777777777778,0,1,0,0,3,FALSE
149,2022-03-18T17:27:54Z,0.8999999761581421,1.7777777777777777,1080,6,4,4,2,3,2,3,2,3,3,3,4,3,4,3,4,2,2,2,1,1,1,3,3,2,0,2,0,0,0,0,3,2,2,2,2,1,2,2,2,1,4,4,1,5,2,3,1,1,2,5,5,4,1,1,1,1,1,1,1,3,1,2,1,2,1,1,1,1,1,1,2,1.25,0,3,0,2,0,2.8333333333333335,0,1.5,0,1.5714285714285714,0,1,0,2.027027027027027,0,0,0,0,-0.2018622702241433,0.11587546031720362,-0.5328163702636706,-0.20847045497323347,3,2,3,3,2,4,3,4,1.280643713087394,4,5,5,4,3,3,5,4.142857142857143,0,1.2614612094193518,0,1.146353499129901,4,4,4,3,4,2,2,3,2,3,2,2,4,1,2,4,1,3,4,3,3.8,0,2,0,3.4,0,2.2,0,2.533333333333333,0,2,1,2,3,2,3,4,3,2,1,3,4,2,3,1,4,1,1,1,3,2.3,0,Filipino & Middle Eastern,1,30,0,1,NA,5,2,0,0,1,0,0,TRUE,TRUE,TRUE,TRUE,TRUE,2,0.5941812500059604,0.5362437499947846,0.5492937499955296,0.6790031250044704,0.6329781249985099,0.6626838709731255,1,1,1,1,1,0.96875,0.085,0.41,0.599,0.006,1.111,112.3408736537208,1946.0555808768936,0.107,0.4,0.777,0.02,1.866,62.09586808505439,1844.7210862459929,0.327,0.244,0.935,0.015,1.475,32.25537484917892,1817.2841988279667,185.16666666666666,93.3,98.33333333333334,FALSE,440,1.3037037037037038,0,1,0,3,6,FALSE
150,2022-03-18T17:28:46Z,0.8999999761581421,1.6,900,6,3,4,3,3,2,3,4,2,3,3,4,5,2,3,3,2,1,2,2,1,1,1,1,1,1,2,0,0,0,0,2,3,2,2,3,3,2,3,3,4,3,3,4,2,3,3,2,4,3,3,3,2,4,4,3,3,3,3,4,2,3,4,3,2,2,2,2,3,3,3,3,3,0,3.066666666666667,0,2.5555555555555554,0,3.0833333333333335,0,3.1666666666666665,0,3,0,2,0,2.864864864864865,0,1,0,0,-0.06369007467309709,0.23790726373174273,0.28961676243834755,0.26376201308504515,2,2,2,4,4,4,4,6,2.2201213828097868,3,3,3,4,3,3,3,3.142857142857143,0,0.5960613948117253,0,0.1992467218202532,3,3,3,3,3,2,3,3,3,3,3,4,3,2,3,2,3,2,3,2,3,0,2.8,0,2.8,0,2.6,0,2.7333333333333334,0,3,4,3,3,3,3,3,3,2,3,3,3,2,2,3,2,2,2,2,2,2.65,0,"White, Caucasian, Anglo, European American",0,29,0,1,NA,5,2,0,0,2,0,0,TRUE,TRUE,TRUE,TRUE,TRUE,4,0.7700645161280709,0.8369749999996274,0.8194620689672643,0.8549482758605275,0.7947379310346883,0.98972857142772,1,1,1,0.90625,0.9666666666666667,0.9655172413793104,0.093,0.326,0.185,0.139,1.329,320.1540002473963,2158.7933892100705,0.08,0.299,0.193,0.095,1.023,588.062272198809,2419.1017738479677,0.07,0.373,0.213,0.013,1.68,243.56127238045875,2132.5184770051524,9.561151079136689,10.768421052631577,129.23076923076923,FALSE,304,0.9007407407407407,1,1,0,0,3,FALSE
151,2022-03-18T17:24:40Z,0.8999999761581421,1.7777777777777777,900,8,3,4,3,3,4,3,2,4,3,3,2,3,5,1,4,3,3,3,1,1,3,3,2,3,0,2,0,0,0,0,3,5,4,4,4,4,4,4,4,1,3,3,1,4,3,4,3,3,3,3,3,4,1,1,1,3,2,1,1,2,1,4,3,3,1,3,2,2,2,1,2,1.75,0,3.1333333333333333,0,4,0,2.8333333333333335,0,2,0,2.142857142857143,0,2,0,2.7837837837837838,0,0,0,0,0.6140116463629873,0.7227894737535733,-0.3605105619019602,0.18113945592580655,2,1,4,1,1,1,1,1,-0.6261803135308405,3,3,3,3,1,1,3,2.4285714285714284,0,-0.698640248793604,0,-0.9763558510709751,2,2,2,2,2,4,4,4,4,3,4,4,4,4,4,4,4,4,4,3,2,0,4,0,3.8,0,3.8,0,3.8666666666666667,0,2,2,2,3,3,2,3,3,2,1,2,3,3,3,1,3,1,2,2,3,2.3,0,"White, Caucasian, Anglo, European American",0,27,1,2,NA,5,2,0,0,1,0,0,TRUE,TRUE,TRUE,TRUE,TRUE,4,0.5177374999994645,0.4862593750002561,0.4846593749995809,0.5535843749997439,0.5234354838713283,0.551510000000149,1,1,1,1,0.96875,0.967741935483871,0.068,0.341,0.526,0.024,2.088,46.9486988296072,1873.7981625987,0.063,0.352,0.505,0.012,1.154,35.88254786149561,1860.9952841421225,0.107,0.353,0.686,0.04,1.831,25.648999701674185,1807.708037891452,87,96.16666666666666,45.775,FALSE,323,0.9570370370370371,0,1,0,9,12,FALSE
152,2022-03-18T17:22:01Z,0.8999999761581421,1.7777777777777777,1440,5,3,1,1,1,1,1,1,1,1,1,1,1,1,1,1,5,1,1,1,1,1,1,1,1,1,2,0,0,0,0,2,3,1,1,1,1,1,1,1,1,1,1,1,1,1,1,1,1,1,1,1,1,1,1,1,1,2,1,3,2,1,1,1,1,1,1,1,2,1,1,1,1.25,0,1.2666666666666666,0,1.3333333333333333,0,1,0,1.1666666666666667,0,1.4285714285714286,0,1,0,1.1891891891891893,0,1,0,0,-1.3138194629920872,-1.3887245590589952,-0.31345356682763886,-0.851089062943317,1,1,3,1,1,1,1,1,-0.7920494875423887,4,5,5,5,1,1,4,3.5714285714285716,0,-0.3222341343576166,0,-0.12786943131110795,1,1,1,1,1,5,3,5,5,2,5,1,5,3,3,3,5,4,2,4,1,0,4,0,3,0,4,0,3.6666666666666665,0,1,1,1,1,1,1,1,1,1,1,1,1,1,1,1,1,1,1,1,1,1,0,"White, Caucasian, Anglo, European American",0,29,0,1,NA,5,2,0,0,1,0,0,TRUE,TRUE,TRUE,TRUE,TRUE,1,0.5175354838709652,0.440593548387105,0.48853750000000035,0.6418741935483901,0.4964343750000062,0.5650374999999994,0.96875,0.96875,1,0.96875,1,1,0.086,0.316,0.509,0.028,1.917,32.98622885680016,1814.959852539998,0.05,0.352,0.59,0.026,1.708,153.2429742455407,1993.2247143230525,0.099,0.32,0.519,0.014,1.932,185.18033428147984,2046.85957508513,68.46428571428571,65.6923076923077,138,FALSE,304,0.9007407407407407,1,1,0,0,3,FALSE
153,2022-03-18T17:28:58Z,1,1.6,900,6,4,1,1,2,1,2,1,1,1,1,1,1,2,1,2,1,1,1,1,1,1,1,1,1,2,2,0,0,0,0,1,1,1,1,3,1,1,1,1,2,1,1,1,1,1,1,2,1,1,1,1,1,1,1,1,2,1,1,2,2,1,1,1,1,1,1,1,1,1,2,2,1.5,0,1.2666666666666666,0,1.2222222222222223,0,1.1666666666666667,0,1.1666666666666667,0,1.2857142857142858,0,1,0,1.1891891891891893,0,1,0,0,-1.3138194629920872,-1.3887245590589952,-0.22730066264678367,-0.8080126108528894,2,2,3,1,1,2,1,1,-0.5432457265250663,5,5,5,5,2,2,4,4,0,1.475286511749183,0,1.199189573665012,2,3,2,4,2,4,4,4,4,3,5,4,4,4,4,4,4,4,3,3,2.6,0,4.2,0,3.6,0,3.8,0,3.8666666666666667,0,1,1,1,1,2,1,2,2,1,1,3,2,1,1,1,2,1,1,1,2,1.4,0,"White, Caucasian, Anglo, European American",0,26,1,2,NA,5,2,0,0,1,0,0,TRUE,TRUE,TRUE,TRUE,TRUE,4,0.6068187500163913,0.5599612903210425,0.5722468750104308,0.8312366666555404,0.6034928571156093,0.6699499999920527,1,0.96875,1,0.9375,0.9333333333333333,0.967741935483871,0.076,0.395,0.472,0.016,1.848,54.577482521537846,1879.6265801005688,0.052,0.433,0.447,0.027,1.979,149.77423430581075,2049.5390864411975,0.092,0.38,0.406,0.009,1.82,155.5012259490936,2026.790354564145,115.5,73.2962962962963,202.22222222222226,TRUE,438,1.2977777777777777,0,1,0,0,3,FALSE
154,2022-03-18T17:20:34Z,0.8999999761581421,1.7777777777777777,864,6,2,4,2,2,2,2,1,3,1,2,1,1,1,1,2,4,2,1,2,1,1,2,2,1,2,2,0,0,0,0,4,3,1,2,2,1,1,1,1,1,1,2,1,2,3,2,4,2,2,2,3,2,1,1,1,1,1,1,2,1,1,2,3,2,1,1,2,2,2,2,1,1.75,0,1.9333333333333333,0,1.7777777777777777,0,2.0833333333333335,0,1.1666666666666667,0,1.7142857142857142,0,1.3333333333333333,0,1.7297297297297298,0,1,0,0,-0.6383109514091944,-0.6433570571394092,-0.14114775846592847,-0.3922524078026688,1,2,3,1,1,1,1,1,-0.7091149005366146,5,5,5,5,3,2,5,4.285714285714286,0,0.03902547546461973,0,0.47918338557157275,2,3,2,1,2,4,5,5,5,3,5,5,5,3,5,4,5,5,4,3,2,0,4.8,0,4.2,0,4.2,0,4.4,0,3,4,2,3,2,2,4,3,2,2,4,2,3,2,1,2,2,2,1,2,2.4,0,"White, Caucasian, Anglo, European American",0,28,1,3,NA,5,2,1,0,1,0,1,TRUE,TRUE,TRUE,TRUE,TRUE,6,0.5445624999925495,0.4924593749940395,0.4994937499910593,0.588790000017484,0.5455062500014901,0.5642499999920527,1,1,1,0.9375,1,0.9375,0.067,0.367,0.528,0.015,1.537,65.951653654513,1910.4763774252851,0.069,0.372,0.575,0.041,1.812,81.92619934288982,1876.6626004542716,0.07,0.344,0.392,0.019,1.84,98.64427957923488,1942.3614526884612,102.46666666666667,44.19512195121951,96.8421052631579,FALSE,220,0.6518518518518519,0,1,0,3,6,FALSE
155,2022-03-18T17:24:24Z,0.8999999761581421,1.539714867617108,982,4,4,1,1,3,2,2,2,1,2,2,1,1,3,2,2,2,2,1,1,1,1,2,1,1,1,2,0,0,0,0,2,1,1,1,1,1,1,1,1,1,2,1,1,3,1,1,1,1,1,1,2,1,1,1,1,2,1,1,2,2,1,1,1,1,1,1,1,2,2,2,2,2,0,1.8,0,1.1111111111111112,0,1.3333333333333333,0,1.1666666666666667,0,1.2857142857142858,0,1,0,1.2162162162162162,0,1,0,0,-1.133976287830408,-1.0349208292560044,-0.05499485428507328,-0.5449578417705389,1,1,1,1,1,1,2,1,-0.874984074548163,4,5,5,4,2,2,5,3.857142857142857,0,0.5237954851611282,0,0.5422436901348013,1,1,1,1,1,5,4,5,5,3,5,5,5,3,5,5,5,5,2,5,1,0,5,0,3.8,0,4.6,0,4.466666666666667,0,1,2,2,4,1,2,3,4,2,1,3,2,1,3,1,4,1,2,2,2,2.15,0,"Asian or Asian American (e.g., Chinese, Japanese, and others) & White, Caucasian, Anglo, European American",1,19,1,2,NA,5,2,0,0,1,0,0,TRUE,TRUE,TRUE,TRUE,TRUE,3,0.5367374999970198,0.5312499999990686,0.5357750000013038,0.6118870967741935,0.6016343750003725,0.669045161285708,1,1,1,0.96875,1,0.96875,0.079,0.358,0.463,0.01,1.522,68.14977605858495,1891.5505631490344,0.105,0.323,0.521,0.025,1.868,42.00205023666617,1826.548470233463,0.082,0.337,0.427,0.019,1.916,26.686507127454576,1849.1778783012037,152.2,74.72,100.84210526315789,FALSE,436,1.2918518518518518,0,1,0,0,3,FALSE
156,2022-03-18T17:32:46Z,0.8999999761581421,1.6,900,6,3,3,3,4,3,3,3,3,3,3,3,3,3,4,3,3,2,1,1,1,1,1,2,1,0,2,0,0,0,0,3,3,3,3,4,2,3,3,3,4,2,1,1,2,1,2,2,1,1,1,2,2,1,1,1,1,1,1,1,1,1,2,1,2,2,3,1,1,1,2,2,1.5,0,3.1333333333333333,0,3,0,1.6666666666666667,0,1.1666666666666667,0,1.2857142857142858,0,2,0,1.864864864864865,0,0,0,0,-0.7128800728176956,-0.16958652623590453,-0.4466634660828154,-0.30812499615935995,2,2,4,3,2,3,3,2.5,0.6175027542984864,3,3,3,3,2,2,3,2.7142857142857144,0,-0.14160432944649845,0,-0.48226576241552316,2,3,3,2,2,4,3,3,4,3,4,3,3,3,3,3,3,3,3,3,2.4,0,3.4,0,3,0,3.2,0,3.2,0,2,1,2,3,2,1,2,2,2,1,1,2,3,1,1,2,1,2,1,3,1.75,0,"White, Caucasian, Anglo, European American",0,30,0,1,NA,5,2,0,0,1,0,0,TRUE,TRUE,TRUE,TRUE,TRUE,5,0.6422903225806454,0.4211612903225769,0.46550000000000363,0.6453000000000018,0.5329677419354858,0.5595555555555501,1,1,1,0.9375,0.96875,0.84375,0.05,0.389,0.73,0.009,1.314,49.948157068464425,1925.0115979910745,0.061,0.357,0.876,0.012,1.465,121.30089553006752,1957.413877869932,0.068,0.354,0.244,0.026,1.834,160.82929362099682,2023.3519727562543,146.00000000000003,122.08333333333334,70.53846153846155,FALSE,304,0.9007407407407407,1,1,0,0,3,FALSE
157,2022-03-18T17:15:16Z,1,1.7777777777777777,1080,7,3,1,2,4,1,5,4,1,3,2,1,1,1,2,3,1,1,2,1,1,1,1,3,1,1,2,0,0,0,0,1,1,1,1,1,1,1,1,1,2,1,1,1,1,2,1,3,1,1,2,3,1,1,1,1,2,1,1,2,1,1,2,3,3,1,1,1,1,1,1,1,1,0,2.1333333333333333,0,1,0,1.5833333333333333,0,1.1666666666666667,0,1.8571428571428572,0,1,0,1.3783783783783783,0,1,0,0,-0.9475534843091554,-0.764012192344598,-0.39960647100849406,-0.581809331676546,1,1,1,1,1,1,1,1,-0.9579186615539372,5,5,5,5,4,5,5,4.857142857142857,0,1.384971609293624,0,1.6085957649392508,2,2,3,4,3,4,4,4,4,3,5,4,4,4,4,3,5,4,4,4,2.8,0,4.4,0,3.6,0,4,0,4,0,1,2,1,3,3,1,2,2,2,1,2,2,2,3,1,2,2,2,2,3,1.95,0,"White, Caucasian, Anglo, European American",0,28,1,2,NA,5,2,0,0,1,0,0,TRUE,TRUE,TRUE,TRUE,TRUE,1,0.6332874999344349,0.5187750000208616,0.5839781249761581,0.66891612908148,0.5865406250208616,0.6865624999701977,1,1,1,0.96875,1,1,0.146,0.36,0.648,0.01,1.313,13.645321705772025,1796.2418285236165,0.09,0.329,0.539,0.019,1.946,105.37117112442152,1889.448827212887,0.065,0.433,0.337,0.027,1.79,127.7944393228552,1951.3903339113997,131.29999999999998,102.42105263157895,66.2962962962963,FALSE,302,0.8948148148148148,0,1,0,0,3,FALSE
158,2022-03-18T17:31:36Z,1,1.6,900,6,3,2,2,2,2,2,2,2,3,2,2,2,2,2,2,2,2,4,1,1,1,1,2,2,1,2,0,0,0,0,2,2,2,2,2,2,3,2,1,2,2,2,1,2,2,2,1,3,3,3,3,4,1,1,1,1,1,1,1,1,1,1,1,1,1,3,1,1,2,1,1,1.25,0,2.066666666666667,0,2,0,2.1666666666666665,0,1.5,0,1,0,1.6666666666666667,0,1.7567567567567568,0,1,0,0,-0.45846777624751495,-0.4641935230368383,-0.31345356682763886,-0.3888235449322386,1,1,2,1,1,2,2,1.5,-0.5157127766089035,5,4,5,4,2,2,4,3.7142857142857144,0,0.5057464923561662,0,0.453847562613138,2,2,2,3,2,4,4,4,4,5,4,4,4,4,4,4,5,4,4,3,2.2,0,4.2,0,4.2,0,3.8,0,4.066666666666666,0,2,1,1,1,1,1,2,2,1,1,2,2,1,1,1,2,1,1,1,2,1.35,0,"Asian or Asian American (e.g., Chinese, Japanese, and others) & White, Caucasian, Anglo, European American",1,28,1,2,NA,5,2,0,0,1,0,0,TRUE,TRUE,TRUE,TRUE,TRUE,5,0.6413656249949709,0.5587625000001862,0.5938781250026077,0.7347838709652423,0.6619500000009935,0.721323333332936,1,1,1,0.96875,0.9375,0.9375,0.08,0.406,0.462,0.007,1.454,51.45871475213074,1894.5299998194823,0.075,0.417,0.565,0.011,1.538,31.163761759453948,1877.611526114039,0.099,0.38,0.411,0.013,1.672,59.64842379482416,1884.3663330678428,207.7142857142857,139.81818181818184,128.6153846153846,FALSE,424,1.2562962962962962,0,1,0,0,3,FALSE
159,2022-03-18T17:36:37Z,1,1.4995014955134596,1003,4,4,4,2,4,3,2,3,4,4,2,3,3,5,2,4,2,2,4,1,1,2,4,4,3,2,2,0,0,0,0,2,2,2,2,4,2,2,2,2,3,2,5,2,2,4,3,4,4,5,5,5,4,1,3,1,1,1,2,3,3,1,2,1,2,2,3,4,2,2,2,2,2,0,3.1333333333333333,0,2.2222222222222223,0,3.6666666666666665,0,1.8333333333333333,0,2,0,3,0,2.6486486486486487,0,1,0,0,0.6885807677714886,0.7729395299513293,-0.05499485428507328,0.358972337833128,2,2,3,1,1,2,2,8,2.2473185954686636,4,4,4,4,2,2,3,3.2857142857142856,0,0.8279356899465183,0,0.417881599117705,2,2,3,2,3,4,4,4,5,4,5,5,4,4,5,4,4,2,4,1,2.4,0,4,0,4,0,3.8,0,3.933333333333333,0,1,1,4,4,2,4,2,3,1,1,3,4,1,4,2,4,1,4,3,2,2.55,0,"Asian or Asian American (e.g., Chinese, Japanese, and others)",0,20,1,2,NA,5,2,0,0,1,0,0,TRUE,TRUE,TRUE,TRUE,TRUE,1,0.565654838710062,0.5084593749986962,0.5783903225809336,0.6890310344824503,0.5805464285723865,0.6306000000010245,0.96875,1,1,0.9354838709677419,0.9032258064516129,1,0.228,0.235,0.677,0.013,1.219,40.69257823588633,1822.220493551956,0.058,0.371,0.465,0.015,1.72,121.6097167308306,1977.456651025362,0.066,0.43,0.509,0.014,1.852,124.50918244729928,2020.940450362141,93.76923076923077,114.66666666666667,132.28571428571428,FALSE,476,1.4103703703703703,0,1,0,0,3,FALSE
160,2022-03-18T17:30:13Z,1,1.7777777777777777,1080,4,2,2,2,2,2,2,2,2,1,2,1,1,2,4,2,2,1,1,1,1,2,2,2,3,0,2,0,0,0,0,1,3,4,2,2,1,1,1,2,1,1,1,1,3,4,1,1,1,1,1,2,1,1,1,1,3,2,2,1,1,1,1,1,1,3,4,1,2,1,1,1,1.25,0,1.9333333333333333,0,1.8888888888888888,0,1.5,0,1.5,0,1.1428571428571428,0,2.6666666666666665,0,1.6216216216216217,0,0,0,0,-0.6273449041432382,-0.6359820488750333,-0.5328163702636706,-0.584399209569352,1,1,4,1,1,1,1,1,-0.7091149005366146,4,4,3,3,1,1,3,2.7142857142857144,0,-1.0930953560345533,0,-1.0618089707050569,1,3,1,3,1,5,4,5,5,3,5,4,3,2,5,1,5,5,3,4,1.8,0,4.8,0,2.8,0,4.2,0,3.933333333333333,0,1,1,3,2,2,1,2,4,3,3,3,2,2,2,2,2,1,2,2,3,2.15,0,"White, Caucasian, Anglo, European American",0,26,1,2,NA,5,2,0,0,1,0,0,TRUE,TRUE,TRUE,TRUE,TRUE,6,0.5644968749955297,0.47886562503129243,0.4926531250104308,0.6495548387342883,0.5863562499880791,0.5875516129232222,1,1,1,0.96875,1,1,0.191,0.249,0.805,0.019,1.995,161.9036558344985,1945.299125649582,0.087,0.327,0.606,0.013,1.674,106.15118063960304,1889.1774928811192,0.088,0.371,0.458,0.007,1.077,91.96231985099476,1919.5931321926876,105.00000000000001,128.76923076923077,153.85714285714286,FALSE,422,1.2503703703703704,0,1,0,0,3,FALSE
161,2022-03-18T17:33:37Z,1,1.7786458333333333,768,6,3,2,1,2,1,2,2,1,2,2,1,1,1,2,1,2,1,1,1,1,1,1,2,1,0,2,0,0,0,0,1,1,2,1,1,1,1,1,1,1,1,1,1,1,1,1,1,1,1,1,3,1,1,1,1,2,1,1,1,1,1,2,1,2,1,1,1,1,1,1,1,1,0,1.5333333333333334,0,1.1111111111111112,0,1.1666666666666667,0,1.1666666666666667,0,1.2857142857142858,0,1,0,1.162162162162162,0,0,0,0,-1.2502163888495421,-1.2295227139920017,-0.6189692744445258,-0.9242459942182637,1,1,3,1,1,2,2,1,-0.6261803135308405,5,4,4,5,3,3,4,4,0,-0.23191923190205752,0,0.15934845458074715,2,2,2,2,2,4,5,4,5,3,5,3,4,3,4,2,4,3,4,3,2,0,3.8,0,3.6,0,3.8,0,3.7333333333333334,0,3,3,1,3,2,1,1,1,1,2,2,2,3,1,2,1,2,2,2,2,1.85,0,"White, Caucasian, Anglo, European American",0,28,1,2,NA,5,2,0,0,2,0,0,TRUE,TRUE,TRUE,TRUE,TRUE,4,0.5211812500022351,0.4593500000014901,0.45197812499850987,0.5798866666674614,0.5623733333329359,0.5830666666686535,1,1,1,0.9375,0.9375,0.9375,0.08,0.32,0.632,0.015,2.075,112.6873225121467,1957.5230179213577,0.069,0.33,0.585,0.015,1.808,20.49828823329181,1864.0732759743537,0.056,0.391,0.503,0.012,1.43,113.47077245394952,1959.9763908004077,138.33333333333334,120.53333333333335,119.16666666666666,FALSE,390,1.1555555555555557,0,1,0,0,3,FALSE
162,2022-03-18T17:36:29Z,1,1.6,800,6,2,2,2,2,2,2,2,3,2,2,2,2,3,2,3,3,2,2,1,1,1,2,1,1,1,2,0,0,0,0,3,3,3,3,3,3,3,3,3,2,3,3,2,4,2,3,2,3,4,4,4,3,1,1,1,3,2,1,3,3,1,2,2,2,1,2,2,2,2,2,2,2,0,2.2666666666666666,0,3,0,3,0,1.8333333333333333,0,2,0,1.6666666666666667,0,2.5135135135135136,0,1,0,0,-0.21063510803690821,-0.2101982384117342,-0.05499485428507328,-0.13259654634840373,2,2,3,2,2,2,2,1,-0.29444196550774376,4,4,4,2,1,1,3,2.7142857142857144,0,0.2196552803757379,0,-0.262226321736228,4,4,4,4,4,2,4,2,2,4,4,3,4,3,3,3,3,3,3,3,4,0,3,0,3.6,0,2.6,0,3.066666666666667,0,2,1,2,3,2,2,2,3,2,2,2,3,2,2,1,3,1,2,2,2,2.05,0,"White, Caucasian, Anglo, European American",0,28,0,1,NA,5,2,0,0,1,0,0,TRUE,TRUE,TRUE,TRUE,TRUE,6,0.4990322580645161,0.491,0.5640000000000001,0.5579642857142857,0.5514,0.6276774193548387,0.96875,1,1,0.875,0.967741935483871,0.96875,0.082,0.357,0.441,0.014,1.588,94.70906906416567,1918.2665045445744,0.066,0.355,0.528,0.027,1.945,60.348821648785375,1887.146057701193,0.05,0.375,0.435,0.016,1.769,89.87397908952533,1996.8923874559955,113.42857142857143,72.03703703703704,110.56249999999999,FALSE,387,1.1466666666666667,0,1,0,3,6,FALSE
164,2022-03-18T17:37:22Z,0.8999999761581421,1.6,960,6,3,2,2,2,2,2,2,2,1,2,2,4,3,3,3,2,2,3,1,1,2,3,3,1,0,2,0,0,0,0,2,2,1,1,2,1,1,1,2,2,4,1,1,1,1,3,2,1,1,2,4,2,1,1,1,2,1,1,1,3,1,2,2,2,1,1,1,2,1,1,2,1.5,0,2.2666666666666666,0,1.4444444444444444,0,1.9166666666666667,0,1.3333333333333333,0,1.7142857142857142,0,1,0,1.5945945945945945,0,0,0,0,-0.40144433046454353,-0.33852338221187406,-0.4466634660828154,-0.3925934241473447,1,1,3,1,1,2,1,1,-0.7091149005366146,5,5,5,5,3,3,4,4.285714285714286,0,1.384971609293624,0,1.2989850639765426,1,2,2,3,1,5,5,5,5,2,5,5,3,4,5,5,5,4,5,4,1.8,0,4.8,0,4,0,4.6,0,4.466666666666667,0,1,1,2,3,3,4,4,3,1,1,4,3,1,2,1,3,3,3,3,2,2.4,0,"White, Caucasian, Anglo, European American",0,23,1,2,NA,5,2,0,0,1,0,0,TRUE,TRUE,TRUE,TRUE,TRUE,3,0.5615031249988824,0.5062531249991152,0.514625,0.6522281250006053,0.5560250000006054,0.5880000000004967,1,1,1,1,1,0.9375,0.067,0.407,0.677,0.022,2.015,99.87009141876152,1948.1782146352648,0.154,0.292,0.724,0.026,1.555,45.499696218591886,1827.861640285447,0.101,0.417,0.735,0.014,1.6,46.545263811451605,1831.6215938332457,91.59090909090911,59.80769230769231,114.28571428571429,FALSE,384,1.1377777777777778,0,1,0,0,3,FALSE
165,2022-03-18T17:34:34Z,0.8999999761581421,1.6,900,4,3,4,1,3,3,3,3,2,3,3,2,4,2,2,2,3,4,3,5,4,3,3,4,3,8,1,1,0,1,0,1,2,1,1,1,1,2,1,1,3,1,2,1,2,2,1,2,2,3,3,3,4,2,2,5,3,2,3,5,1,1,2,3,2,2,2,1,2,3,4,2,2.75,0,2.6666666666666665,0,1.2222222222222223,0,2.0833333333333335,0,3,0,2.4285714285714284,0,1.6666666666666667,0,2.054054054054054,0,4,0,0,0.9517659021544338,0.7461928333125257,0.8615522685655875,0.8038725509390566,2,2,2,2,2,2,4,2.5,0.36869899328116373,4,5,5,5,4,4,4,4.428571428571429,0,0.309970182831297,0,0.7216156413217214,2,3,3,3,3,4,4,4,3,3,4,4,3,4,4,4,3,3,4,3,2.8,0,3.6,0,3.6,0,3.6,0,3.6,0,2,2,2,1,2,1,2,2,1,1,3,2,2,2,1,1,1,2,1,3,1.7,0,"White, Caucasian, Anglo, European American",0,21,1,2,NA,5,2,0,0,1,0,0,TRUE,TRUE,TRUE,TRUE,TRUE,3,0.544212499992922,0.44487500000558794,0.4761562500093132,0.6008827586132904,0.5233187500033527,0.5506625000014901,1,1,1,0.9354838709677419,1,1,0.109,0.328,0.751,0.015,1.392,26.241006291566812,1807.8623458576803,0.068,0.355,0.738,0.019,1.581,120.61081309123966,1910.8886229304264,0.065,0.37,0.41,0.017,1.982,118.73319168369368,1968.01112082334,92.8,83.21052631578948,116.58823529411764,FALSE,430,1.2740740740740741,0,1,0,0,3,FALSE
166,2022-03-18T17:25:45Z,0.8999999761581421,1.6,900,6,3,2,2,1,2,2,1,2,2,1,1,1,2,2,1,1,1,2,1,1,1,2,1,1,1,2,0,0,0,0,1,1,1,1,1,1,1,1,1,1,1,1,1,1,1,2,1,1,1,1,1,2,3,1,1,1,1,1,1,1,1,1,1,2,1,1,1,1,1,1,1,1,0,1.5333333333333334,0,1,0,1.0833333333333333,0,1.5,0,1.1428571428571428,0,1,0,1.135135135135135,0,1,0,0,-1.1866133147069973,-1.1867476660586218,-0.39960647100849406,-0.793177068533558,1,1,2,1,1,1,1,1,-0.874984074548163,5,5,5,5,3,4,4,4.428571428571429,0,1.2946567068380648,0,1.3213778790473958,2,2,2,2,2,4,4,4,5,2,3,2,4,4,4,3,3,4,3,2,2,0,3.2,0,3.2,0,3.8,0,3.4,0,1,2,1,2,1,1,2,2,1,2,4,4,2,2,1,1,2,2,1,3,1.85,0,"White, Caucasian, Anglo, European American",0,29,1,2,NA,5,2,0,0,1,0,0,TRUE,TRUE,TRUE,TRUE,TRUE,3,0.7481709677480882,0.643974193530698,0.5853968749940396,0.8139281249903142,0.7013749999888241,0.6873709677342446,1,1,1,1,1,1,0.088,0.436,0.534,0.02,1.688,69.49166710459677,1855.5116694725348,0.16,0.331,0.516,0.028,1.531,69.3401301952072,1855.7274140395016,0.118,0.367,0.308,0.083,1.592,80.06281598080116,1862.2125033946024,84.39999999999999,54.67857142857142,19.180722891566266,FALSE,380,1.125925925925926,0,1,0,0,3,FALSE
167,2022-03-18T17:37:10Z,0.8999999761581421,1.4991694352159468,1204,6,3,2,2,2,1,2,1,2,3,3,2,3,3,2,3,2,2,2,1,1,1,3,2,3,0,2,0,0,0,0,1,2,1,1,1,1,4,1,2,3,1,3,1,2,4,4,2,3,4,4,4,1,1,1,1,1,1,1,1,3,1,1,1,2,1,1,3,2,2,2,4,2.5,0,2.2,0,1.5555555555555556,0,2.9166666666666665,0,1,0,1.4285714285714286,0,1.6666666666666667,0,1.8918918918918919,0,0,0,0,-0.2895906483517917,-0.2924049971986436,-0.10205184935939461,-0.1972284232790191,3,3,3,2,2,5,4,3.5,1.253110763171231,5,5,5,5,3,3,5,4.428571428571429,0,1.2946567068380648,0,1.3213778790473958,3,3,3,3,3,2,4,2,3,4,1,2,4,3,3,4,2,3,4,3,3,0,2,0,4,0,2.8,0,2.933333333333333,0,1,1,3,3,3,4,4,3,3,3,2,4,2,4,2,3,2,4,3,2,2.8,0,"Hispanic of Latino (e.g., Mexican American, Central American, and others) & White, Caucasian, Anglo, European American",1,23,1,2,NA,4,2,0,0,0,1,0,TRUE,TRUE,TRUE,TRUE,TRUE,5,0.6915093749947846,0.5344999999962747,0.6089499999992549,0.7591218750011176,0.6294874999914318,0.682590624993667,1,1,1,1,1,1,0.193,0.313,0.656,0.015,1.406,25.34200239786975,1807.216793907388,0.097,0.384,0.638,0.015,1.589,44.344873084195555,1826.8042165626305,0.204,0.368,0.645,0.018,1.595,44.82675372163593,1826.3030313232412,93.73333333333333,105.93333333333334,88.61111111111111,FALSE,450,1.3333333333333335,0,1,0,0,3,FALSE
168,2022-03-18T17:28:44Z,1,1.7777777777777777,900,6,4,4,1,3,3,2,2,4,3,1,2,2,3,2,3,3,1,3,3,1,1,2,3,1,1,1,0,0,1,0,2,1,1,1,1,1,2,1,3,1,1,1,1,2,1,1,3,1,2,3,3,3,1,1,2,5,1,1,2,1,1,2,3,2,1,1,1,2,2,1,1,1.5,0,2.533333333333333,0,1.4444444444444444,0,1.6666666666666667,0,2.1666666666666665,0,1.7142857142857142,0,1,0,1.6486486486486487,0,1,0,0,-0.44750172898155904,-0.2530716197886394,-0.22730066264678367,-0.24018614121771154,1,1,2,1,1,1,3,1,-0.7091149005366146,5,5,5,5,4,3,5,4.571428571428571,0,0.072220972883332707,0,0.6542077654890679,1,2,2,2,2,4,5,4,4,5,5,5,4,5,5,5,5,5,5,3,1.8,0,4.8,0,4.8,0,4.2,0,4.6,0,1,1,1,1,1,1,1,1,1,1,2,1,1,1,1,1,1,2,1,2,1.15,0,"White, Caucasian, Anglo, European American",0,27,1,2,NA,5,2,0,0,1,0,0,TRUE,TRUE,TRUE,TRUE,TRUE,5,0.4941812500022352,0.4844781249947846,0.4677375000026077,0.5705875000078231,0.5707562499959021,0.6079343750085682,1,1,1,1,1,1,0.115,0.287,0.645,0.009,1.521,82.52459633890152,1865.5480275745244,0.084,0.314,0.539,0.011,1.424,85.5567310780801,1869.191177992567,0.092,0.351,0.694,0.019,1.797,170.83562254437777,1966.390706443377,169,129.45454545454547,94.57894736842105,FALSE,364,1.0785185185185184,0,1,0,0,3,FALSE
169,2022-03-18T17:35:31Z,NA,1.7786458333333333,768,3,2,2,1,1,2,1,2,2,1,1,1,1,1,1,3,1,2,1,1,4,2,2,2,1,3,1,1,0,3,0,1,2,1,1,1,1,1,1,1,2,1,1,1,2,1,3,1,1,1,1,1,1,1,1,1,1,1,3,3,2,2,1,1,1,1,1,1,1,2,2,2,1.75,0,1.4,0,1.1111111111111112,0,1.3333333333333333,0,1,0,1.8571428571428572,0,1,0,1.2972972972972974,0,2,0,0,-0.6755955121134449,-0.901285679505514,0.07821504497010326,-0.41153531726770537,1,1,3,1,1,2,2,1,-0.6261803135308405,5,5,5,5,2,2,5,4.142857142857143,0,0.020976482659657802,0,0.39078725804990966,3,3,3,4,2,4,5,5,4,2,5,2,5,5,5,1,5,5,3,4,3,0,4.2,0,3.2,0,4.6,0,4,0,2,1,1,4,2,2,3,3,3,2,4,3,1,1,1,2,2,2,2,3,2.2,0,"Hispanic of Latino (e.g., Mexican American, Central American, and others)",0,25,1,2,NA,5,2,0,0,1,0,0,TRUE,TRUE,TRUE,TRUE,TRUE,1,0.4751374999992549,0.4811187499985099,0.5204375000037252,0.5843433333317439,0.5772900000055631,0.5849758620755425,1,1,1,0.967741935483871,0.967741935483871,0.90625,0.062,0.365,0.423,0.025,2.039,59.24154373423173,1916.6154778231169,0.075,0.371,0.723,0.02,1.989,27.939890227588,1852.8775719078224,0.071,0.335,0.503,0.013,1.538,12.782926178586145,1836.533337266691,81.56,99.45,118.30769230769232,FALSE,328,0.9718518518518519,0,1,0,3,6,FALSE
170,2022-03-18T17:26:08Z,1,1.7777777777777777,864,3,3,4,1,2,2,1,1,1,1,2,1,2,2,1,2,1,1,3,1,1,1,3,2,1,0,1,2,0,2,0,1,1,1,1,1,1,1,1,1,2,1,3,1,3,2,4,2,2,3,3,3,3,1,1,1,4,1,1,1,1,1,1,1,1,1,2,2,1,1,1,1,1,0,1.6,0,1,0,2.4166666666666665,0,1.8333333333333333,0,1,0,1.6666666666666667,0,1.6486486486486487,0,0,0,0,-0.6097992285177086,-0.7697155320690485,-0.6189692744445258,-0.6943424032567871,1,1,3,1,1,1,1,1,-0.7920494875423887,5,5,5,5,2,2,5,4.142857142857143,0,0.309970182831297,0,0.5668102908403673,2,3,2,2,1,4,4,5,5,3,4,4,3,3,4,3,3,4,3,3,2,0,3.8,0,3.2,0,4,0,3.6666666666666665,0,3,2,3,2,3,2,2,3,1,1,3,2,1,2,1,3,1,1,1,1,1.9,0,"Asian or Asian American (e.g., Chinese, Japanese, and others)",0,22,1,2,NA,5,2,0,0,1,0,0,TRUE,TRUE,TRUE,TRUE,TRUE,1,0.5061468750238418,0.4648937500119209,0.5160999999940395,0.5675250000442777,0.561564516144414,0.5853148148324755,1,1,1,0.875,0.96875,0.84375,0.053,0.392,0.502,0.015,1.785,95.45348721546468,1959.9798676156536,0.068,0.338,0.55,0.014,1.546,110.49491980158538,1938.8173351607688,0.058,0.364,0.473,0.02,2.046,69.73957584369857,1932.510486171796,119,110.42857142857143,102.29999999999998,FALSE,356,1.0548148148148149,0,1,0,0,3,FALSE
171,2022-03-18T16:42:40Z,0.8999999761581421,1.6,900,8,4,2,1,1,1,1,1,2,2,2,2,2,2,3,2,1,1,3,2,2,2,3,2,2,0,2,0,0,0,0,1,1,3,1,1,1,2,1,3,1,1,3,1,4,1,5,1,3,3,3,3,4,1,3,1,1,1,1,1,3,1,1,1,1,1,1,1,1,2,1,2,1.5,0,1.6666666666666667,0,1.5555555555555556,0,2.4166666666666665,0,1.8333333333333333,0,1.2857142857142858,0,1,0,1.7837837837837838,0,0,0,0,-0.197475851317761,-0.4633085220451133,-0.4466634660828154,-0.45498599406396434,1,1,1,1,1,1,3,1.5,-0.5986473636146776,5,5,5,5,3,3,5,4.428571428571429,0,1.0808314045082337,0,1.1911391292716074,3,2,4,3,3,3,5,3,4,3,4,3,3,5,3,5,3,3,4,3,3,0,3.2,0,4,0,3.6,0,3.6,0,1,2,4,3,3,4,4,3,4,2,2,3,1,4,1,3,4,4,2,3,2.85,0,"White, Caucasian, Anglo, European American",0,27,1,2,NA,5,2,1,0,1,0,1,TRUE,TRUE,TRUE,TRUE,TRUE,4,0.4925031250002794,0.455568749998929,0.4798343749998603,0.5601580645158406,0.5164387096784288,0.5830290322575358,1,1,1,0.96875,0.96875,0.96875,0.068,0.365,0.657,0.018,2.035,107.14878895032447,1938.4006970757216,0.088,0.332,0.797,0.025,1.907,223.61115008400563,2048.883350577297,0.066,0.366,0.591,0.014,1.593,167.61384364606576,1991.9852668877943,113.05555555555557,76.28,113.78571428571428,FALSE,404,1.1970370370370371,0,1,0,0,3,FALSE
172,2022-03-18T17:31:12Z,1,1.7786458333333333,768,4,3,5,2,5,3,4,5,1,5,5,5,5,5,1,5,5,5,5,1,2,5,5,5,5,1,1,2,0,2,0,3,5,3,4,5,4,5,4,4,1,2,5,1,4,3,3,4,5,4,5,5,5,1,1,3,2,1,2,3,3,3,2,1,1,1,1,5,1,5,1,2,2.25,0,4.066666666666666,0,4.111111111111111,0,3.5,0,2.1666666666666665,0,2.142857142857143,0,2.3333333333333335,0,3.081081081081081,0,1,0,0,1.9430965749968607,2.024134265363573,0.031158049895781924,1.0276461576296774,2,2,5,2,2,2,2,6.5,1.998850571708627,4,4,5,4,1,1,4,3.2857142857142856,0,-0.9695849561602813,0,-0.6769693801363836,2,3,3,1,3,3,3,2,4,3,3,3,3,3,4,3,5,5,3,2,2.4,0,3.8,0,3,0,3,0,3.2666666666666666,0,1,4,1,1,3,1,2,1,2,2,3,3,1,2,2,2,1,2,1,2,1.85,0,"White, Caucasian, Anglo, European American",0,25,0,1,NA,5,2,0,0,1,0,0,TRUE,TRUE,TRUE,TRUE,TRUE,4,0.7122133333305518,0.6882290322559496,0.8320656249960885,0.8774468750040978,0.7995406250003725,1.2237343750037253,0.9375,1,1,1,1,1,0.182,0.159,0.234,0.004,1.288,85.9335766356198,1869.0223114683408,0.217,0.132,0.389,0.014,1.625,143.41760270438002,1928.8766949181925,0.097,0.399,0.299,0.012,1.801,151.7803696919658,2024.1557742691011,322,116.07142857142857,150.08333333333331,TRUE,362,1.0725925925925925,0,1,0,0,3,FALSE
173,2022-03-18T17:27:30Z,1,1.6,900,1,2,3,2,1,5,3,5,5,4,4,3,1,4,1,4,5,5,3,5,1,3,5,5,5,2,1,1,0,1,0,5,5,5,1,5,5,5,5,5,1,1,5,1,4,3,4,5,5,5,5,5,4,3,2,1,2,1,1,2,1,1,5,5,5,1,1,4,2,3,2,1,2,0,3.3333333333333335,0,4.555555555555555,0,3.6666666666666665,0,2.1666666666666665,0,2.857142857142857,0,2,0,3.3513513513513513,0,1,0,0,2.0374045814840827,1.7673856443197686,-0.05499485428507328,0.8561953950173476,5,5,3,3,1,5,1,1.5,0.5624368544661608,5,5,5,3,1,1,2,3.142857142857143,0,-0.7825102850053112,1,-0.640426834580144,2,4,2,1,1,5,5,5,5,2,5,5,4,5,5,1,5,5,3,1,2,0,5,0,3,0,4.2,0,4.066666666666666,0,4,2,3,1,4,2,4,1,1,4,3,2,3,1,1,2,3,3,1,3,2.4,0,"White, Caucasian, Anglo, European American",0,22,0,2,NA,5,2,0,0,0,0,0,TRUE,TRUE,TRUE,TRUE,TRUE,3,0.4927187499999964,0.44381249999999817,0.4396562499999982,0.5573333333333256,0.5186451612903207,0.5099000000000078,1,1,1,0.9375,0.96875,0.9375,0.056,0.358,0.696,0.024,1.886,89.57540870169143,1936.993958197959,0.067,0.351,0.781,0.021,1.753,49.21423805454744,1875.7919000292036,0.057,0.378,0.525,0.021,1.811,37.88131016549701,1882.487248945086,78.58333333333333,83.47619047619047,86.23809523809523,FALSE,360,1.0666666666666667,0,1,0,0,3,FALSE
174,2022-03-18T17:21:20Z,1,1.6,1200,5,2,1,2,2,2,2,1,3,2,2,1,2,2,2,2,2,1,1,1,1,1,1,1,1,1,1,2,0,0,0,1,1,1,1,1,1,1,1,1,1,1,1,1,2,1,2,2,1,1,1,1,1,1,1,1,2,1,1,1,1,1,1,1,1,1,2,1,2,1,1,1,1.25,0,1.8666666666666667,0,1,0,1.25,0,1.1666666666666667,0,1,0,1.3333333333333333,0,1.135135135135135,0,1,0,0,-1.3489108142431467,-1.1503642919543675,-0.31345356682763886,-0.7319089293910032,2,1,3,2,1,2,3,1,-0.3773765525135179,4,4,4,4,2,2,3,3.2857142857142856,0,-0.30418514155265464,0,-0.27168132951147617,3,3,3,3,3,3,4,4,4,3,5,4,3,3,3,5,4,5,4,3,3,0,4.2,0,3.8,0,3.4,0,3.8,0,1,2,2,1,3,2,2,2,2,1,3,2,2,2,1,2,1,2,1,2,1.8,0,"White, Caucasian, Anglo, European American",0,23,1,2,NA,5,2,0,0,1,0,0,TRUE,TRUE,TRUE,TRUE,TRUE,3,0.4885437499973923,0.510999999997206,0.4635218750019558,0.5596300000006954,0.5375562499989756,0.5616718750009313,1,1,1,0.967741935483871,1,1,0.085,0.324,0.595,0.017,1.636,23.165596473206772,1802.7941920017377,0.141,0.295,0.678,0.043,1.663,55.59666905274923,1841.0099664484464,0.072,0.354,0.57,0.021,1.812,23.034388585794645,1849.881075903391,96.23529411764704,38.674418604651166,86.28571428571428,FALSE,323,0.9570370370370371,0,1,0,6,9,FALSE
175,2022-03-18T17:14:09Z,1,1.6,900,4,4,2,2,3,2,3,1,1,2,2,1,1,2,1,2,2,1,1,1,1,1,1,1,3,1,2,0,0,0,0,1,2,1,3,3,1,3,3,2,2,1,3,1,2,1,2,1,3,3,4,1,1,1,1,1,1,1,1,1,1,1,1,1,1,1,1,1,1,1,1,1,1,0,1.8,0,2.111111111111111,0,2,0,1,0,1,0,1,0,1.5945945945945945,0,1,0,0,-0.8883368290729924,-0.8697206441339852,-0.39960647100849406,-0.6346635575712396,1,1,2,1,1,2,2,1,-0.7091149005366146,5,5,5,5,3,3,5,4.428571428571429,0,1.351776111874911,0,1.3561687097810788,2,2,2,2,2,4,3,3,4,3,5,4,5,3,4,3,3,5,3,5,2,0,4.2,0,3.4,0,3.8,0,3.8,0,2,1,3,4,3,4,4,4,4,1,1,3,1,3,2,4,1,3,4,4,2.8,0,"Asian or Asian American (e.g., Chinese, Japanese, and others)",0,20,1,2,NA,5,2,0,0,1,0,0,TRUE,TRUE,TRUE,TRUE,TRUE,2,0.4814999999999964,0.9029687499999963,0.4890000000000019,0.5750967741935474,0.9097586206896572,0.5388387096774184,1,1,1,0.96875,0.90625,1,0.242,0.194,0.841,0.006,0.787,34.90740090876157,1819.2043028905784,0.099,0.26,0.15,0.218,1.344,232.2452665223227,2113.0629553925437,0.072,0.336,0.571,0.015,1.744,76.66951798522837,1903.2263788703856,131.16666666666666,6.165137614678899,116.26666666666667,FALSE,416,1.2325925925925925,0,1,0,0,3,FALSE
177,2022-03-18T17:42:25Z,0.800000011920929,1.7777777777777777,864,6,2,1,1,1,1,2,1,1,1,1,1,1,1,1,1,1,1,1,4,1,1,1,1,1,5,2,0,0,0,0,2,1,1,1,2,1,1,1,1,2,1,1,1,1,1,1,1,1,1,1,1,1,1,1,1,2,1,1,3,2,2,1,1,1,1,1,1,1,1,1,1,1,0,1.0666666666666667,0,1.2222222222222223,0,1.0833333333333333,0,1.1666666666666667,0,1.5714285714285714,0,1,0,1.2162162162162162,0,3,0,0,-1.0528275380623333,-1.3005194602170598,0.03911913586356937,-0.6307001621767452,1,1,2,1,1,1,1,1,-0.874984074548163,5,5,5,5,1,1,5,3.857142857142857,0,0.6141103876166872,0,0.5972535503046252,3,3,2,2,2,3,4,2,3,3,5,3,4,5,4,4,4,5,2,1,2.4,0,4,0,3.4,0,3,0,3.466666666666667,0,1,2,2,1,2,3,3,2,1,1,2,1,2,2,1,2,1,2,1,3,1.75,0,"White, Caucasian, Anglo, European American",0,30,0,1,NA,5,2,0,0,1,0,0,TRUE,TRUE,TRUE,TRUE,TRUE,6,0.5852812499981374,0.5471593749988825,0.5870468750037253,0.6923250000048429,0.5970633333365123,0.655319354841786,1,1,1,1,1,1,0.097,0.375,0.495,0.019,1.771,35.3913776676267,1817.1601111343036,0.095,0.383,0.598,0.017,1.294,32.75037076743974,1814.1165337061875,0.166,0.329,0.673,0.012,1.527,30.26735915918329,1812.3182558515032,93.21052631578947,76.11764705882352,127.24999999999999,FALSE,388,1.1496296296296296,0,1,0,0,3,FALSE
178,2022-03-18T17:45:53Z,0.800000011920929,1.7777777777777777,1080,4,2,4,2,3,3,2,3,2,3,3,1,4,4,3,3,3,3,5,5,3,3,4,4,4,5,1,0,0,1,1,1,2,1,2,4,1,2,1,1,2,2,3,3,3,2,1,5,5,5,4,4,4,4,5,5,5,5,3,5,1,1,2,2,4,1,1,1,3,3,3,1,2.5,0,2.8666666666666667,0,1.6666666666666667,0,3.25,0,4.666666666666667,0,2.5714285714285716,0,1,0,2.7837837837837838,0,3,1,0,1.5877966435798851,1.2612634104965352,1.255401572399185,1.25833249144786,2,1,5,1,1,1,1,1,-0.5432457265250663,5,4,5,3,1,1,4,3.2857142857142856,0,-0.8792700537047221,0,-0.62195951996656,3,3,3,3,3,4,5,4,4,2,3,3,4,3,5,5,3,5,3,3,3,0,3.6,0,3.8,0,3.8,0,3.7333333333333334,0,2,2,1,3,3,2,2,4,4,1,1,3,3,4,1,4,1,3,3,3,2.5,0,"White, Caucasian, Anglo, European American",0,22,0,1,NA,5,2,0,0,1,0,0,TRUE,TRUE,TRUE,TRUE,TRUE,4,0.41057499999995345,0.3671843749997206,0.3868000000003958,0.47911666666666664,0.42699032258074127,0.43744285714346914,1,1,1,0.967741935483871,0.96875,0.9032258064516129,0.045,0.318,0.687,0.023,1.542,75.97475188344342,1960.4476899369488,0.051,0.305,0.811,0.016,1.356,136.20918621372843,1971.8892675371712,0.063,0.318,0.758,0.021,1.836,110.19760996860067,1935.8005175725864,67.04347826086956,84.75,87.42857142857143,FALSE,304,0.9007407407407407,1,1,0,3,6,FALSE
179,2022-03-18T17:42:48Z,1,1.7777777777777777,720,7,4,1,1,1,2,1,1,1,1,1,1,1,1,1,1,1,1,3,4,1,1,1,1,1,1,2,0,0,0,0,1,2,2,1,1,1,1,1,1,2,2,1,1,2,3,2,4,4,1,3,3,5,5,1,1,2,1,1,2,1,1,1,1,1,1,3,1,1,1,1,1,1,0,1.0666666666666667,0,1.2222222222222223,0,2.3333333333333335,0,2.5,0,1.1428571428571428,0,1.6666666666666667,0,1.8108108108108107,0,1,0,0,-0.5045251747645307,-0.9317690469982675,-0.39960647100849406,-0.6656877590033807,1,1,2,2,1,1,3,1,-0.6261803135308405,4,3,4,4,2,2,2,3,0,0.13872270157061628,1,-0.15671615645915069,1,1,1,3,2,5,3,4,4,1,5,5,3,4,5,3,5,3,1,2,1.6,0,4.6,0,2.2,0,3.8,0,3.533333333333333,0,2,1,1,1,1,2,2,4,1,1,2,2,1,2,1,1,1,1,1,1,1.45,0,"White, Caucasian, Anglo, European American",0,30,1,2,NA,5,2,0,0,1,0,0,TRUE,TRUE,TRUE,TRUE,TRUE,5,0.5062064516082887,0.4311312500014901,0.5516937499716877,0.5651241379524099,0.4917689655402611,0.5905033332904179,1,1,1,0.90625,0.9354838709677419,0.967741935483871,0.086,0.319,0.423,0.02,1.953,134.59837732721277,1956.9159797799427,0.058,0.31,0.418,0.031,1.672,162.65603356864253,2006.7190205377235,0.06,0.376,0.564,0.021,2.011,107.09971172662652,1967.2671885253285,97.65,53.93548387096774,95.76190476190476,FALSE,364,1.0785185185185184,0,1,0,0,3,FALSE
180,2022-03-18T17:17:16Z,0.8999999761581421,1.7786458333333333,768,6,4,5,3,3,4,3,2,2,5,3,4,5,5,1,4,3,4,4,1,1,3,3,3,4,2,2,0,0,0,0,2,5,5,5,5,3,3,1,5,3,1,1,1,4,2,5,5,3,4,4,4,4,1,1,1,1,2,1,2,2,1,4,5,4,1,1,3,2,4,1,1,2,0,3.466666666666667,0,3.7777777777777777,0,3.0833333333333335,0,1.6666666666666667,0,2.7142857142857144,0,1.6666666666666667,0,2.8378378378378377,0,1,0,0,0.9736979966863456,1.1102232412421182,-0.05499485428507328,0.5276141934785225,2,2,4,3,2,2,1,6,1.7225138607751418,2,5,5,5,3,2,5,3.857142857142857,0,0.34316568025000993,0,0.43222396979515376,1,3,2,2,2,4,5,4,4,4,5,4,5,4,4,5,5,5,5,2,2,0,4.6,0,4.8,0,3.6,0,4.333333333333333,0,1,3,3,1,3,3,3,1,1,1,2,2,1,2,2,2,2,2,1,2,1.9,0,"Asian or Asian American (e.g., Chinese, Japanese, and others)",0,28,1,2,NA,5,2,0,0,1,0,0,TRUE,TRUE,TRUE,TRUE,TRUE,3,0.5695562499995577,0.5281718750003492,0.549950000000419,0.6938516129030575,0.6257354838708716,0.6190906249999535,1,1,1,1,1,1,0.136,0.372,0.782,0.011,1.177,49.24605428300168,1833.979326703734,0.092,0.362,0.534,0.027,2.035,97.06046925848833,1875.3896947800592,0.105,0.362,0.525,0.013,1.736,34.243069291349926,1816.1126717473253,107.00000000000001,75.37037037037038,133.53846153846155,FALSE,398,1.1792592592592592,0,1,0,0,3,FALSE
181,2022-03-18T17:42:38Z,0.8999999761581421,1.7777777777777777,900,4,1,1,1,1,1,5,1,1,1,1,1,1,1,1,1,1,1,1,1,1,1,1,1,1,0,2,0,0,0,0,1,1,1,1,1,1,1,1,1,1,1,1,1,1,1,1,1,1,1,1,1,1,1,1,1,3,3,1,1,2,1,1,5,1,1,1,1,1,1,1,1,1,0,1.2666666666666666,0,1,0,1,0,1.6666666666666667,0,1.7142857142857142,0,1,0,1.2432432432432432,0,0,0,0,-1.2787281117410283,-1.3651245326129924,-0.6189692744445258,-0.9920469035287591,1,1,1,1,1,1,1,1,-0.9579186615539372,5,5,5,5,3,3,5,4.428571428571429,0,0.03902547546461973,0,0.55658606081225,2,3,2,3,2,5,3,3,4,2,5,1,5,3,3,3,3,5,3,3,2.4,0,3.8,0,3.2,0,3.2,0,3.4,0,3,4,2,3,2,2,2,3,2,1,1,3,2,2,2,3,1,2,2,2,2.2,0,"White, Caucasian, Anglo, European American",0,29,1,2,NA,5,2,0,0,1,0,0,TRUE,TRUE,TRUE,TRUE,TRUE,4,0.6922774193594533,0.6763218749910593,0.6842406250014901,0.7084379310443484,0.77673793102955,0.7767500000085149,0.96875,1,1,0.9354838709677419,0.90625,0.9032258064516129,0.066,0.413,0.255,0.02,1.737,73.84365754905184,1959.161955016221,0.061,0.418,0.222,0.026,1.888,226.41076637704543,2114.9275210929504,0.076,0.36,0.212,0.027,1.76,319.4010399606595,2212.2259923806077,86.85000000000001,72.61538461538461,65.18518518518519,FALSE,400,1.1851851851851851,0,1,0,6,9,FALSE
182,2022-03-18T17:07:47Z,0.8999999761581421,1.7786458333333333,768,6,3,1,1,4,1,2,1,2,2,3,1,3,2,1,2,2,2,3,1,1,2,2,2,3,0,2,0,0,0,0,2,3,2,2,3,2,3,3,3,3,2,3,2,3,4,2,3,2,4,5,5,2,4,5,1,1,1,1,1,1,1,1,1,2,2,2,2,1,2,3,2,2,0,1.8666666666666667,0,2.5555555555555554,0,3.1666666666666665,0,2.3333333333333335,0,1.1428571428571428,0,2,0,2.4054054054054053,0,0,0,0,0.12492593830134693,-0.1591631812222532,-0.274357657721105,-0.2167604194716791,1,2,3,1,1,2,1,3.5,0.34083030610771514,5,4,5,5,2,2,1,3.4285714285714284,0,0.5569909825798411,0,0.33025469384891076,3,4,4,3,4,3,5,4,3,4,5,4,4,3,3,3,3,3,3,3,3.6,0,3.6,0,3.8,0,3.2,0,3.533333333333333,0,4,2,4,3,4,4,3,1,3,4,4,4,2,1,1,4,4,4,3,4,3.15,0,"Asian or Asian American (e.g., Chinese, Japanese, and others) & Black or African American",1,23,1,2,NA,5,2,0,0,1,0,0,TRUE,TRUE,TRUE,TRUE,TRUE,2,0.5221451612888806,0.44805312499823047,0.4835718749994412,0.6131437499998137,0.4849903225797799,0.5471166666636864,0.96875,1,1,1,0.96875,0.9375,0.063,0.336,0.477,0.012,1.429,86.5801055658078,1932.7404539689476,0.044,0.364,0.562,0.039,1.921,105.44946966652552,1929.598368445869,0.068,0.342,0.339,0.02,1.781,115.07408335349008,1941.0435444034604,119.08333333333333,49.256410256410255,89.05,FALSE,374,1.108148148148148,0,1,0,0,3,FALSE
183,2022-03-18T17:47:41Z,0.8999999761581421,1.7777777777777777,1080,7,4,3,2,2,3,2,3,4,4,4,4,4,4,2,3,3,3,4,1,1,2,3,3,2,2,2,0,0,0,0,2,2,2,2,2,2,2,2,2,2,2,2,2,2,2,2,3,3,3,3,3,3,1,1,1,3,3,1,3,3,1,3,1,1,1,1,1,2,2,2,2,2,0,3.1333333333333333,0,2,0,2.4166666666666665,0,2,0,1.8571428571428572,0,1,0,2.027027027027027,0,1,0,0,0.12273272884815593,0.3923891035095351,-0.05499485428507328,0.1686971246122309,2,2,2,2,1,2,1,2.5,0.036960645258067054,4,4,4,4,2,2,4,3.4285714285714284,0,0.2196552803757379,0,0.12478705446715747,2,2,2,2,2,4,4,4,4,3,4,4,4,4,4,5,5,4,3,2,2,0,4.2,0,3.8,0,3.6,0,3.8666666666666667,0,1,1,1,1,1,1,1,1,1,1,2,1,1,1,1,1,1,2,1,1,1.1,0,"White, Caucasian, Anglo, European American",0,29,0,1,NA,5,2,0,0,1,0,0,TRUE,TRUE,TRUE,TRUE,TRUE,2,0.4723843750003725,0.4509343750048429,0.47243437500484287,0.5333774193544542,0.4784031250067055,0.5119766666710377,1,1,1,1,1,0.967741935483871,0.056,0.369,0.492,0.063,1.92,98.37933572405944,1926.5903622212172,0.066,0.351,0.731,0.018,1.116,52.04737268628307,1839.5133493261765,0.129,0.313,0.835,0.028,1.772,23.597957260173832,1805.1241726392575,30.476190476190474,62.00000000000001,63.285714285714285,FALSE,352,1.0429629629629629,0,1,0,0,3,FALSE
184,2022-03-18T17:47:23Z,1,1.5997794928335172,907,6,3,5,2,2,2,2,1,3,2,1,2,3,2,1,3,3,2,3,1,1,2,2,2,3,0,1,1,0,1,0,2,1,4,2,3,2,4,4,4,1,1,1,1,4,1,2,1,1,2,1,1,4,1,1,1,1,1,1,1,1,1,1,1,1,1,1,1,1,2,1,1,1.25,0,2.2666666666666666,0,2.888888888888889,0,1.4166666666666667,0,1.5,0,1,0,1,0,1.6756756756756757,0,0,0,0,-0.3488073035879547,-0.30312334254287004,-0.5328163702636706,-0.41796985640327033,2,1,2,1,1,1,1,1,-0.7920494875423887,4,4,4,4,3,3,5,3.857142857142857,0,-0.4696684418500219,0,-0.06286477173326038,2,2,2,3,2,4,5,4,4,3,5,4,3,3,4,5,4,4,3,5,2.2,0,4.2,0,3.8,0,4,0,4,0,1,1,1,2,1,1,2,2,1,1,1,2,1,1,1,2,1,1,1,1,1.25,0,"Asian or Asian American (e.g., Chinese, Japanese, and others)",0,27,1,2,NA,5,2,0,0,1,0,0,TRUE,TRUE,TRUE,TRUE,TRUE,4,0.5164193548387097,0.414875,0.48046875,0.5784838709677419,0.4924,0.5650999999999999,0.96875,1,1,0.96875,0.9375,0.9375,0.066,0.378,0.71,0.009,1.264,26.255080568647656,1872.9397892506272,0.064,0.33,0.77,0.015,1.529,74.81559325848778,1925.5282898095231,0.06,0.378,0.481,0.018,1.661,86.62498206442942,1950.3601091947896,140.44444444444446,101.93333333333334,92.27777777777779,FALSE,423,1.2533333333333332,0,1,0,0,3,FALSE
185,2022-03-18T17:46:06Z,1,1.7777777777777777,1080,6,2,3,3,2,3,2,1,2,2,1,1,2,2,1,3,3,2,3,1,1,1,1,1,1,0,2,0,0,0,0,2,2,2,2,5,1,1,1,3,2,2,1,4,3,3,3,2,2,1,1,1,3,1,1,1,1,1,1,1,1,1,2,4,3,1,1,1,1,1,1,1,1,0,2.066666666666667,0,2.111111111111111,0,2.0833333333333335,0,1.3333333333333333,0,1.8571428571428572,0,1,0,1.837837837837838,0,0,0,0,-0.6492769986751505,-0.5925186668369782,-0.6189692744445258,-0.6057439706407519,1,1,3,1,1,2,1,1,-0.7091149005366146,4,4,4,3,3,3,4,3.5714285714285716,0,-1.0930953560345533,0,-0.597392919260994,1,1,1,2,2,4,5,5,5,2,5,4,4,3,4,4,4,5,4,4,1.4,0,4.4,0,3.8,0,4.2,0,4.133333333333334,0,1,1,1,3,1,2,1,2,2,2,1,2,1,2,1,1,1,2,2,3,1.6,0,"Hispanic of Latino (e.g., Mexican American, Central American, and others)",0,24,1,2,NA,5,2,0,0,1,0,0,TRUE,TRUE,TRUE,TRUE,TRUE,4,0.482625,0.4211875,0.46884375,0.5298666666666667,0.4595666666666667,0.5182413793103449,1,1,1,0.9375,0.9375,0.90625,0.058,0.326,0.472,0.016,1.767,165.26540301790112,2024.762386339959,0.047,0.332,0.544,0.032,1.71,96.30642161057304,1969.890781526423,0.058,0.359,0.514,0.031,2.02,76.72295437893044,1923.9391639700543,110.43749999999999,53.4375,65.16129032258064,FALSE,478,1.4162962962962962,0,1,0,0,3,FALSE
186,2022-03-18T17:42:01Z,0.8999999761581421,1.7777777777777777,1080,4,2,1,1,2,1,1,1,1,1,1,1,1,1,2,1,2,1,1,1,1,1,1,1,1,0,2,0,0,0,0,1,1,1,1,1,1,1,1,1,1,1,1,1,1,1,2,1,1,1,1,1,1,1,1,1,3,1,1,1,1,1,1,1,1,1,1,1,1,2,2,1,1.5,0,1.2,0,1,0,1.0833333333333333,0,1.3333333333333333,0,1,0,1,0,1.0810810810810811,0,0,0,0,-1.384002165494206,-1.465031311234404,-0.4466634660828154,-0.9558473886586096,3,2,4,2,2,2,2,2.5,0.4516335802869379,2,2,2,4,1,2,3,2.2857142857142856,0,-1.797565582874064,0,-1.7231024255046925,2,1,1,1,1,3,2,3,4,2,3,3,5,3,4,1,4,4,1,1,1.2,0,3.4,0,2.2,0,3,0,2.8666666666666667,0,1,1,1,2,1,1,1,2,1,1,1,1,1,1,1,1,1,1,1,1,1.1,0,"Hispanic of Latino (e.g., Mexican American, Central American, and others)",0,21,0,1,NA,5,2,0,0,1,0,0,TRUE,TRUE,TRUE,TRUE,TRUE,2,0.49159687499993016,0.4398741935483751,0.453918749999837,0.5649379310343928,0.5109966666669274,0.534932142857196,1,1,1,0.90625,0.9375,0.875,0.057,0.337,0.514,0.02,2.066,110.11475844258422,1971.2527111708785,0.061,0.33,0.649,0.015,1.653,95.79522120796166,1942.4836038307917,0.063,0.351,0.49,0.014,1.675,91.7259624138517,1948.467070408754,103.29999999999998,110.2,119.64285714285714,FALSE,324,0.96,0,1,0,6,9,FALSE
187,2022-03-18T17:49:18Z,0.8999999761581421,1.7777777777777777,900,4,2,3,2,1,1,1,1,1,1,1,1,3,2,1,2,2,3,2,1,1,2,3,2,5,1,2,0,0,0,0,1,4,2,3,5,3,3,4,5,2,2,5,1,4,1,1,1,1,3,5,5,1,1,1,1,2,1,1,2,1,1,2,2,1,1,1,1,1,3,1,1,1.5,0,1.5333333333333334,0,3.3333333333333335,0,2.5833333333333335,0,1.1666666666666667,0,1.4285714285714286,0,1,0,2.189189189189189,0,1,0,0,0.22800678260133414,-0.23537159995413726,-0.22730066264678367,-0.23133613130046046,1,1,3,1,1,1,1,2,-0.40524523968696646,3,2,3,2,1,1,4,2.2857142857142856,0,-0.8792700537047221,0,-1.1637782466512998,1,1,1,1,1,5,5,5,5,3,5,4,5,5,5,5,5,5,2,3,1,0,4.8,0,4,0,4.6,0,4.466666666666667,0,1,1,2,4,2,2,1,4,4,1,2,3,1,4,1,3,1,1,1,1,2,0,"Asian or Asian American (e.g., Chinese, Japanese, and others)",0,21,0,1,NA,5,2,0,0,1,0,0,TRUE,TRUE,TRUE,TRUE,TRUE,2,0.5382812500093133,0.538371874999255,0.5027593750059605,0.5823419354923309,0.5931968750059604,0.5919862069035399,1,1,1,1,1,0.90625,0.062,0.368,0.45,0.018,1.976,43.38192521104981,1898.336222620228,0.084,0.383,0.55,0.018,1.359,64.90749288054941,1847.5471891591797,0.071,0.395,0.517,0.028,1.776,78.83438641194995,1860.430312451325,109.77777777777779,75.5,63.42857142857143,FALSE,324,0.96,0,1,0,3,6,FALSE
188,2022-03-18T17:49:20Z,1,1.7777777777777777,720,4,3,2,1,2,1,3,2,1,2,2,1,1,1,3,1,1,2,2,1,1,2,4,3,3,0,2,0,0,0,0,1,1,1,1,1,1,1,1,1,1,1,1,1,1,2,1,2,1,1,1,3,1,1,1,1,1,1,2,1,2,1,1,2,2,1,1,1,1,2,1,2,1.5,0,1.6,0,1,0,1.3333333333333333,0,1,0,1.5714285714285714,0,1,0,1.2162162162162162,0,0,0,0,-0.4847862896858096,-0.685640437855164,-0.4466634660828154,-0.5661519519689897,1,1,1,1,1,2,1,1.5,-0.6815819506204519,5,5,5,5,4,2,5,4.428571428571429,0,1.0417609922763496,0,1.1673417508189108,3,4,3,2,2,1,5,3,4,4,5,5,3,4,5,3,5,4,4,2,2.8,0,4,0,3.8,0,3.6,0,3.8,0,3,2,3,3,4,3,3,1,3,3,2,2,1,2,1,1,3,3,3,3,2.45,0,"White, Caucasian, Anglo, European American",0,26,1,2,NA,5,2,0,1,1,0,1,TRUE,TRUE,TRUE,TRUE,TRUE,3,0.6573875000029802,0.5926499999966472,0.6057843750007451,0.7290031250026077,0.6581468749959022,0.7228354838759669,1,1,1,1,1,1,0.131,0.396,0.609,0.01,1.367,27.4683070693028,1811.388243238814,0.129,0.371,0.575,0.024,1.545,83.51403026563915,1870.819901463976,0.126,0.38,0.491,0.014,1.535,49.00174764472846,1832.1402235608969,136.7,64.375,109.64285714285714,FALSE,358,1.0607407407407408,0,1,0,0,3,FALSE
190,2022-03-18T17:50:46Z,0.8999999761581421,1.6,900,6,3,4,1,1,1,1,2,1,2,1,1,2,3,3,2,3,1,1,1,1,1,2,1,1,0,2,0,0,0,0,2,2,1,1,1,1,1,1,1,1,1,1,1,2,1,1,1,1,1,1,2,1,1,1,1,1,1,1,1,1,1,1,1,1,1,1,1,1,1,1,1,1,0,1.8666666666666667,0,1.2222222222222223,0,1.1666666666666667,0,1,0,1,0,1,0,1.1081081081081081,0,0,0,0,-1.285307740100602,-1.1075892440209876,-0.6189692744445258,-0.8632792592327567,1,1,1,2,1,1,1,1,-0.874984074548163,5,5,5,5,4,4,5,4.714285714285714,0,1.475286511749183,0,1.5862029498683978,2,3,3,2,3,4,3,4,5,3,4,2,3,3,3,3,3,4,2,4,2.6,0,3.4,0,2.8,0,3.8,0,3.3333333333333335,0,1,1,2,2,2,1,2,2,1,2,2,3,1,2,1,3,1,2,3,2,1.8,0,"White, Caucasian, Anglo, European American",0,30,0,1,NA,5,2,0,0,1,0,0,TRUE,TRUE,TRUE,TRUE,TRUE,4,0.6609531249998836,0.6364531249996508,0.6071375000001863,0.7704466666668653,0.6298781249996973,0.7117656249997671,1,1,1,0.9375,1,1,0.13,0.275,0.413,0.02,1.843,74.09062406541318,1857.531322118081,0.187,0.231,0.475,0.152,1.884,79.98624414550298,1863.0203360665016,0.107,0.267,0.297,0.009,1.919,170.38894761747855,2019.821949754513,92.14999999999999,12.394736842105262,213.22222222222223,FALSE,325,0.9629629629629629,0,1,0,3,6,FALSE
192,2022-03-18T17:47:46Z,1,1.7786458333333333,768,3,2,2,2,4,2,3,3,1,2,3,2,1,2,3,2,2,1,3,1,2,2,2,2,2,6,1,1,0,0,0,1,2,5,2,3,1,3,4,3,2,2,2,1,3,3,3,3,2,1,4,3,2,3,5,1,1,1,1,5,5,5,2,3,2,2,2,2,1,4,4,4,3.25,0,2.2666666666666666,0,2.6666666666666665,0,2.4166666666666665,0,2.1666666666666665,0,3.2857142857142856,0,2,0,2.5675675675675675,0,3,0,0,0.14905124228645034,0.031702032659793815,0.8144952734912662,0.42309865307552996,2,2,3,2,2,2,3,3.5,0.755503241136586,4,4,4,3,1,1,3,2.857142857142857,0,0.40966740893729353,1,-0.06908925119035642,3,3,3,4,3,1,3,2,3,3,3,3,2,4,5,4,3,3,4,1,3.2,0,2.6,0,3.2,0,3,0,2.933333333333333,0,1,4,4,3,4,4,4,3,3,1,2,3,3,4,1,3,1,4,2,4,2.9,0,"Black or African American & White, Caucasian, Anglo, European American",1,25,0,1,NA,5,2,0,0,1,0,0,TRUE,TRUE,TRUE,TRUE,TRUE,1,0.5108125,0.4778125,0.4888064516129032,0.5875555555555556,0.5435714285714286,0.5771785714285714,1,1,0.96875,0.84375,0.875,0.875,0.05,0.403,0.613,0.006,1.115,104.3491035910486,2051.823637795181,0.057,0.365,0.564,0.02,1.809,50.923004486053635,1916.5046108518984,0.055,0.393,0.535,0.013,1.602,102.17666993543676,1963.651787050173,185.83333333333331,90.44999999999999,123.23076923076924,FALSE,282,0.8355555555555556,0,1,0,0,3,FALSE
193,2022-03-18T17:57:24Z,0.8999999761581421,1.7777777777777777,1080,5,3,5,3,4,2,5,1,5,4,5,4,2,2,2,4,3,5,4,1,1,5,5,5,5,1,2,0,0,0,0,2,3,3,2,2,3,2,2,3,4,3,3,5,3,5,3,3,4,5,3,5,2,1,1,1,1,1,1,3,1,1,1,1,1,1,1,4,1,5,3,4,3.25,0,3.4,0,2.4444444444444446,0,3.8333333333333335,0,1.1666666666666667,0,1.2857142857142858,0,2,0,2.4324324324324325,0,1,0,0,1.3597028604479988,1.3407168328647445,0.37576966661920275,0.8582432497419736,1,1,2,1,1,1,1,2.5,-0.2947777027650296,5,5,5,5,5,5,5,5,0,1.333727119069949,0,1.654785958462801,3,2,4,5,5,3,4,1,3,4,3,2,2,3,5,1,3,2,2,4,3.8,0,2.6,0,2.6,0,3.2,0,2.8,0,3,2,3,3,3,1,3,4,2,2,2,2,1,2,3,2,2,2,3,2,2.35,0,"White, Caucasian, Anglo, European American",0,25,1,2,NA,5,2,0,0,1,0,0,TRUE,TRUE,TRUE,TRUE,TRUE,6,0.471762499999988,0.41039354838711406,0.4614312500000051,0.5078483870967607,0.49318076923078086,0.5640107142857056,1,1,1,0.96875,0.8125,0.9032258064516129,0.063,0.341,0.51,0.012,1.534,34.07526608873931,1890.834981548631,0.048,0.288,0.37,0.014,1.656,69.62871997063569,1988.7458811226843,0.076,0.3,0.55,0.025,1.957,65.77201675134614,1889.306750444817,127.83333333333333,118.28571428571428,78.28,FALSE,305,0.9037037037037037,0,1,0,6,9,FALSE
194,2022-03-18T17:33:19Z,0.8999999761581421,1.7777777777777777,720,6,2,2,2,4,2,3,3,3,4,3,3,5,3,2,3,4,2,2,1,1,2,1,1,1,5,2,0,0,0,0,3,5,5,2,3,4,3,3,4,5,3,3,2,3,3,3,4,3,3,3,3,1,1,1,1,5,2,2,3,3,1,1,1,1,1,5,1,2,2,2,3,2.25,0,3.066666666666667,0,3.5555555555555554,0,3.1666666666666665,0,1.8333333333333333,0,1.7142857142857142,0,2.3333333333333335,0,2.7027027027027026,0,3,0,0,-0.08781537865820048,0.22168224555011581,0.4698836567678454,0.3457829511589806,1,1,2,1,1,1,1,3.5,0.0920265450903926,5,5,5,5,2,3,4,4.142857142857143,0,-0.3222341343576166,0,0.18174126965160067,2,2,2,3,3,3,2,4,5,3,5,3,4,5,5,2,4,4,3,2,2.4,0,3.8,0,2.8,0,4.2,0,3.6,0,2,3,4,2,4,4,4,2,1,1,1,3,2,1,2,3,1,2,2,4,2.4,0,"White, Caucasian, Anglo, European American",0,26,1,1,NA,5,2,0,0,1,0,0,TRUE,TRUE,TRUE,TRUE,TRUE,6,0.5778593750093133,0.5368599999984105,0.686024999992922,0.6544548387046784,0.5803034482762731,0.7041033333341281,1,1,1,1,0.90625,0.967741935483871,0.089,0.375,0.274,0.029,1.839,138.09003189122086,1963.1848636072075,0.067,0.348,0.494,0.01,1.497,97.97197969962404,1951.2168634844268,0.176,0.317,0.755,0.017,1.516,75.00593862153448,1863.7428589502613,63.41379310344827,149.70000000000002,89.17647058823529,FALSE,382,1.1318518518518519,0,1,0,0,3,FALSE
195,2022-03-18T17:29:07Z,0.8999999761581421,1.7777777777777777,864,4,3,5,2,3,3,1,1,5,5,1,2,5,5,1,3,3,3,5,1,1,5,5,5,5,1,2,0,0,0,0,3,3,2,3,3,3,1,1,3,1,2,5,1,2,1,1,5,5,5,5,5,4,1,2,1,1,1,1,1,3,1,1,1,1,2,1,5,1,5,1,3,2.5,0,3,0,2.4444444444444446,0,3.1666666666666665,0,1.6666666666666667,0,1.2857142857142858,0,2.6666666666666665,0,2.3513513513513513,0,1,0,0,1.2259170838033346,1.076101536338939,0.11731095407663712,0.596706245207788,1,1,1,1,1,1,1,2,-0.571114413698515,5,5,5,5,4,3,4,4.428571428571429,0,1.0476359070895207,0,1.1709200998354665,2,2,2,2,2,4,5,5,5,5,3,5,5,5,5,5,5,5,5,5,2,0,4.4,0,5,0,5,0,4.8,0,2,4,4,4,4,4,4,3,3,2,1,3,3,4,1,4,2,4,3,1,3,0,"White, Caucasian, Anglo, European American",0,20,1,2,NA,5,2,0,0,1,0,0,TRUE,TRUE,TRUE,TRUE,TRUE,4,0.5312193548393346,0.459996666666617,0.5026666666664183,0.6204807692301961,0.4833892857144986,0.5339137931029344,0.96875,0.9375,0.967741935483871,0.8125,0.9032258064516129,0.90625,0.046,0.393,0.36,0.074,1.728,168.1074536878107,2102.021687220908,0.036,0.369,0.417,0.027,1.553,184.93833848942705,2131.8138575985186,0.057,0.361,0.279,0.011,1.533,165.6776358265255,2173.6824779193576,23.35135135135135,57.51851851851852,139.36363636363637,FALSE,386,1.1437037037037037,0,1,0,0,3,FALSE
196,2022-03-18T17:59:32Z,0.8999999761581421,1.6,800,8,3,3,1,2,1,3,3,2,4,4,2,3,3,4,2,2,3,3,2,2,2,2,3,1,5,1,2,0,0,0,2,2,2,2,2,1,1,1,1,2,2,4,2,2,3,2,2,4,2,4,4,3,1,1,1,1,1,1,4,4,4,1,1,1,1,1,1,2,2,2,2,2,0,2.6,0,1.5555555555555556,0,2.75,0,1.3333333333333333,0,2.2857142857142856,0,1,0,2,0,3,0,0,0.024038303454551324,0.09316043486292559,0.3837307525869902,0.23844559372495788,1,2,2,2,2,2,2,1,-0.4603111395192921,5,5,5,5,3,3,4,4.285714285714286,0,0.49059998774241514,0,0.7542326864206916,2,2,2,2,2,4,4,4,4,4,4,2,4,4,4,5,4,4,4,2,2,0,3.6,0,4.2,0,3.6,0,3.8,0,2,1,1,3,2,2,1,2,1,1,1,1,2,1,2,1,2,1,1,1,1.45,0,"Asian or Asian American (e.g., Chinese, Japanese, and others)",0,22,1,2,NA,5,2,0,0,1,0,0,TRUE,TRUE,TRUE,TRUE,TRUE,3,0.4996451612903226,0.3927064516111728,0.41350312500074504,0.5792555555579839,0.4794799999988079,0.4793391304353009,1,1,1,0.84375,0.78125,0.7419354838709677,0.047,0.311,0.481,0.01,1.404,112.19654700910354,2088.8023400271168,0.057,0.295,0.623,0.013,1.7,92.76870066621892,1998.2359924008904,0.057,0.351,0.44,0.012,1.622,67.44044353661474,1929.024729815317,140.39999999999998,130.76923076923077,135.16666666666669,FALSE,390,1.1555555555555557,0,1,0,3,6,FALSE
197,2022-03-18T17:00:24Z,0.8999999761581421,1.7777777777777777,1080,2,2,4,3,5,2,5,3,5,4,4,4,2,4,1,5,5,4,4,3,1,3,4,4,4,4,2,0,0,0,0,4,3,2,4,2,2,2,2,4,1,2,4,2,4,3,2,4,5,5,5,5,5,4,4,2,3,3,1,3,1,1,3,4,2,1,1,3,3,3,2,1,2.25,0,3.7333333333333334,0,2.7777777777777777,0,3.5,0,3.5,0,2.142857142857143,0,1.6666666666666667,0,2.918918918918919,0,2,0,0,1.3509300226352343,1.4803503226702603,0.2505208533318137,0.865435588001037,4,2,4,2,1,4,4,1,0.20316555652690138,2,3,5,3,1,3,3,2.857142857142857,0,-0.8792700537047221,0,-0.8541675456885912,1,2,1,2,1,5,3,5,5,3,5,4,5,3,4,2,4,3,3,2,1.4,0,4.2,0,3.2,0,3.8,0,3.7333333333333334,0,3,2,3,4,4,3,4,3,3,1,4,4,2,1,2,3,2,2,2,3,2.75,0,"Hispanic of Latino (e.g., Mexican American, Central American, and others) & White, Caucasian, Anglo, European American",1,30,1,2,NA,5,2,1,0,1,0,1,TRUE,TRUE,TRUE,TRUE,TRUE,6,0.5806354838667377,0.5534968749973923,0.5037874999959022,0.5778124999888241,0.5602741935387734,0.5568781249970197,1,1,1,1,1,1,0.19,0.219,0.688,0.014,1.248,102.13252583673224,1884.2814681229584,0.119,0.332,0.559,0.091,1.736,98.09239848924064,1886.6282845187409,0.154,0.275,0.51,0.228,1.825,190.92989738974984,1972.3065696427673,89.14285714285714,19.076923076923077,8.00438596491228,FALSE,304,0.9007407407407407,1,1,0,3,6,FALSE
198,2022-03-18T17:38:20Z,0.8999999761581421,1.7777777777777777,1080,6,2,3,1,1,3,4,3,3,2,2,3,1,3,2,3,5,2,3,5,1,2,2,2,2,2,1,0,0,1,1,3,3,1,1,2,1,2,2,1,2,2,1,1,2,2,4,3,1,1,1,4,4,2,1,2,4,3,2,2,1,1,1,1,1,1,2,1,1,2,1,1,1.25,0,2.6,0,1.7777777777777777,0,2,0,2.6666666666666665,0,1.2857142857142858,0,1.3333333333333333,0,1.864864864864865,0,1,1,0,0.017458675094977723,0.08873542990430049,0.3859114446228456,0.23732343726357305,1,2,3,1,1,2,2,1,-0.5432457265250663,5,4,4,4,2,2,3,3.4285714285714284,0,-0.8792700537047221,0,-0.5445568447258828,3,3,3,2,2,4,4,4,4,3,4,4,4,3,3,4,3,4,3,3,2.6,0,3.8,0,3.6,0,3.4,0,3.6,0,2,2,3,3,4,3,3,3,2,1,2,3,1,2,1,3,2,3,2,3,2.4,0,"White, Caucasian, Anglo, European American",0,27,1,2,NA,5,2,0,0,1,0,0,TRUE,TRUE,TRUE,TRUE,TRUE,5,0.6310100000063579,0.5084483871075415,0.5679718750007451,0.6625312500037253,0.5503281250111759,0.6201312499940396,0.967741935483871,1,1,1,1,1,0.103,0.402,0.654,0.033,2.004,22.589466232469707,1804.387852473959,0.079,0.396,0.743,0.039,1.858,22.45273215528336,1805.9895232287056,0.207,0.321,0.69,0.028,1.395,154.89599622345833,1980.438806674525,60.72727272727273,47.64102564102564,49.82142857142857,FALSE,342,1.0133333333333332,0,0,0,0,3,FALSE
199,2022-03-18T17:57:01Z,0.8999999761581421,1.7786458333333333,768,5,2,3,2,4,2,2,1,5,1,1,1,1,5,1,4,1,2,1,5,1,1,3,1,3,4,2,0,0,0,0,1,2,4,1,1,1,1,1,1,2,5,4,1,4,2,2,1,3,5,4,2,5,1,1,2,1,1,1,1,2,1,1,1,1,1,2,2,2,2,1,1,1.5,0,2.2666666666666666,0,1.4444444444444444,0,2.9166666666666665,0,1.8333333333333333,0,1.1428571428571428,0,1.6666666666666667,0,1.945945945945946,0,2,0,0,-0.09220179756458308,-0.13054814915647484,-0.007937859210751935,-0.06924300418361339,3,3,3,2,1,2,1,1,-0.29444196550774376,2,5,5,5,1,1,2,3,0,-0.665444751374891,0,-0.6465261206721256,2,2,2,2,2,4,2,4,4,2,4,4,4,5,4,4,4,4,3,4,2,0,4,0,3,0,4.2,0,3.7333333333333334,0,2,2,1,2,3,1,1,2,1,1,2,2,2,1,1,2,1,1,1,1,1.5,0,"White, Caucasian, Anglo, European American",0,27,1,2,NA,5,2,0,0,2,0,0,TRUE,TRUE,TRUE,TRUE,TRUE,5,0.5177064516044432,0.4761562500037253,0.50196875,0.5942799999992053,0.5667906249761582,0.5707566666642825,1,1,1,0.9375,1,0.9375,0.058,0.362,0.381,0.021,1.601,220.9435651819865,2089.769049519468,0.117,0.337,0.889,0.015,1.618,48.26368911974838,1836.4735176895872,0.064,0.37,0.403,0.026,1.953,66.68586312917924,1910.135896116187,76.23809523809523,107.86666666666667,75.11538461538463,FALSE,412,1.2207407407407407,0,0,0,0,3,FALSE
200,2022-03-18T17:57:14Z,1,1.6,900,6,2,2,3,4,2,3,3,3,3,4,3,3,3,2,4,3,2,4,1,1,2,3,3,3,7,2,0,0,0,0,3,4,4,2,3,2,4,3,3,2,2,4,1,3,4,4,4,3,4,4,4,3,1,1,1,1,2,1,4,3,3,3,4,3,1,2,2,3,2,3,3,2.75,0,3,0,3.111111111111111,0,3.25,0,1.5,0,3,0,1.6666666666666667,0,2.7567567567567566,0,4,0,0,0.596465970737457,0.6527760619637649,0.8615522685655875,0.7571641652646762,1,1,3,1,1,2,1,2.5,-0.12890852875348124,4,3,5,4,2,1,3,3.142857142857143,0,0.1625358753388918,0,-0.06480912674787956,2,2,2,3,2,4,4,4,4,3,4,4,3,3,5,2,3,4,3,4,2.2,0,3.8,0,3,0,4,0,3.6,0,2,3,4,3,4,4,4,3,2,3,3,3,2,4,2,2,2,2,4,4,3,0,"White, Caucasian, Anglo, European American",0,24,1,2,NA,5,2,0,0,1,0,0,TRUE,TRUE,TRUE,TRUE,TRUE,3,0.48695806451382173,0.4061906249914318,0.4454187500011176,0.5676571428711925,0.509751851843463,0.5541434782665708,0.96875,1,1,0.875,0.84375,0.71875,0.053,0.349,0.538,0.013,1.947,126.64510405309836,2057.625578167522,0.055,0.307,0.59,0.01,1.441,112.96330496939012,1987.6396299859016,0.058,0.347,0.468,0.014,1.939,108.2632140002406,2015.8361339383264,149.76923076923077,144.1,138.5,FALSE,412,1.2207407407407407,0,1,0,3,6,FALSE
201,2022-03-18T17:52:05Z,0.8999999761581421,1.6,900,6,4,2,2,3,2,3,2,3,2,2,2,2,2,3,3,3,1,1,1,1,1,1,1,1,1,2,0,0,0,0,2,2,2,2,2,1,1,1,1,2,2,2,1,2,2,1,2,2,2,2,2,2,1,1,1,1,1,2,2,2,1,2,2,2,1,1,1,2,2,2,2,2,0,2.4,0,1.5555555555555556,0,1.8333333333333333,0,1.1666666666666667,0,1.8571428571428572,0,1,0,1.5945945945945945,0,1,0,0,-1.050634328609142,-0.7169104728961178,-0.05499485428507328,-0.38595266359059555,1,2,2,2,2,1,1,1,-0.6261803135308405,4,4,4,4,4,3,4,3.857142857142857,0,0.8430821945602693,0,0.7367178772355684,2,3,3,3,3,3,3,3,3,3,4,3,4,3,3,4,3,4,3,3,2.8,0,3.4,0,3.4,0,3,0,3.2666666666666666,0,1,1,1,2,2,1,1,2,1,1,1,2,1,1,1,2,1,1,1,1,1.25,0,"White, Caucasian, Anglo, European American",0,25,1,2,NA,5,2,0,0,1,0,0,TRUE,TRUE,TRUE,TRUE,TRUE,6,0.5807129032265755,0.4897937500048429,0.648390625005588,0.612983870967742,0.5688193548379405,0.7722633333305517,0.96875,1,1,0.96875,1,0.9375,0.07,0.41,0.289,0.024,2.072,102.14937985814046,1945.9947891596355,0.091,0.325,0.578,0.021,1.855,77.95467832029351,1866.7079861501245,0.058,0.38,0.303,0.019,1.53,85.24946548422798,1949.516353643192,86.33333333333333,88.33333333333333,80.52631578947368,FALSE,424,1.2562962962962962,0,1,0,3,6,FALSE
202,2022-03-18T17:55:05Z,0.8999999761581421,1.6,900,3,4,2,1,2,1,2,1,1,1,1,1,1,1,1,1,1,1,1,1,1,1,1,1,1,0,2,0,0,0,0,1,1,1,1,1,1,1,1,1,1,1,2,1,1,1,1,1,1,1,1,3,1,1,1,1,1,1,1,1,1,1,1,1,1,1,1,1,2,1,1,1,1.25,0,1.2,0,1,0,1.25,0,1,0,1,0,1,0,1.0810810810810811,0,0,0,0,-1.384002165494206,-1.465031311234404,-0.5328163702636706,-0.9989238407490373,1,1,3,1,1,1,1,1.5,-0.5986473636146776,5,5,5,5,3,2,5,4.285714285714286,0,0.3192417726318768,0,0.6498601942196431,1,2,2,2,2,4,3,3,4,4,4,2,5,4,4,4,4,2,4,2,1.8,0,3.2,0,4,0,3.4,0,3.533333333333333,0,1,1,1,1,2,1,1,1,1,1,2,1,1,1,1,1,1,1,1,1,1.1,0,"White, Caucasian, Anglo, European American",0,20,0,1,NA,5,2,0,0,1,0,0,TRUE,TRUE,TRUE,TRUE,TRUE,3,0.5488937500016764,0.567890625005588,0.5285906249983237,0.705625806448921,0.7097656249990687,0.644628125003539,1,1,1,0.96875,1,1,0.102,0.304,0.47,0.017,2.01,35.55460344680299,1820.278200123844,0.107,0.31,0.404,0.012,1.745,41.96204445753849,1824.456212405289,0.087,0.384,0.555,0.007,1.398,34.01998413461976,1862.884346304036,118.23529411764704,145.41666666666669,199.7142857142857,FALSE,436,1.2918518518518518,0,1,0,0,3,FALSE
203,2022-03-18T17:52:39Z,1,1.7777777777777777,1080,3,3,3,1,2,2,1,2,1,3,2,1,2,2,1,2,2,2,2,1,1,1,1,2,2,0,2,0,0,0,0,1,1,2,1,1,1,1,1,1,1,1,2,1,1,2,1,1,2,1,3,3,1,1,1,1,1,1,1,1,1,1,1,1,1,1,1,1,1,1,1,1,1,0,1.8,0,1.1111111111111112,0,1.5833333333333333,0,1,0,1,0,1,0,1.2162162162162162,0,0,0,0,-0.9716787882942585,-0.9257707069432418,-0.6189692744445258,-0.7723699906938838,1,1,3,1,1,1,1,1,-0.7920494875423887,5,5,5,5,3,3,5,4.428571428571429,0,0.4002850852868561,0,0.7766255014915452,2,3,3,1,2,4,5,5,4,3,5,3,5,3,3,5,4,4,5,4,2.2,0,4,0,4.6,0,3.8,0,4.133333333333334,0,2,1,2,4,1,2,1,4,4,2,1,3,1,4,1,3,1,4,4,1,2.3,0,"Hispanic of Latino (e.g., Mexican American, Central American, and others) & White, Caucasian, Anglo, European American",1,25,0,1,NA,5,2,0,0,1,0,0,TRUE,TRUE,TRUE,TRUE,TRUE,1,0.64540625,0.5456875,0.5535,0.6669677419354839,0.6049,0.6010322580645161,1,1,1,1,0.967741935483871,1,0.081,0.417,0.66,0.023,1.63,51.60105627531341,1833.2692427163083,0.069,0.377,0.422,0.028,2.065,91.8029521528512,1920.0252908232508,0.086,0.4,0.392,0.047,2.044,136.4780289604191,1921.4792595099505,70.8695652173913,73.75,43.48936170212766,FALSE,398,1.1792592592592592,0,1,0,0,3,FALSE
205,2022-03-18T18:01:15Z,0.8999999761581421,1.6,900,4,4,1,1,1,1,1,1,1,1,1,1,1,1,1,1,1,1,1,1,1,1,1,1,1,0,2,0,0,0,0,1,1,1,1,1,1,1,1,1,1,1,1,1,1,1,1,1,1,1,1,1,1,1,1,1,1,1,1,1,1,1,1,1,1,1,1,1,1,1,1,1,1,0,1,0,1,0,1,0,1,0,1,0,1,0,1,0,0,0,0,-1.4366391923707953,-1.587751448753618,-0.6189692744445258,-1.103360361599072,1,1,1,1,1,1,1,1,-0.9579186615539372,5,5,5,5,3,3,5,4.428571428571429,0,1.2043418043825058,0,1.2663680188775723,2,2,3,3,2,4,4,4,4,4,5,4,3,5,4,5,4,5,4,3,2.4,0,4.4,0,4,0,4,0,4.133333333333334,0,1,1,1,1,2,1,1,2,1,1,1,1,2,1,1,1,1,1,1,1,1.15,0,"White, Caucasian, Anglo, European American",0,19,1,2,NA,5,2,0,0,1,0,0,TRUE,TRUE,TRUE,TRUE,TRUE,6,0.531528124999255,0.4479580645164655,0.5222000000000961,0.6125785714276135,0.5228193548386616,0.5684032258062113,1,0.96875,1,0.875,0.96875,0.96875,0.064,0.375,0.425,0.051,2.071,101.1013332884216,1929.3802498192024,0.068,0.3,0.479,0.02,1.714,217.35195072945444,2087.1460781593114,0.062,0.349,0.367,0.013,1.681,50.230660179452606,1910.0970212716716,40.60784313725491,85.7,129.30769230769232,FALSE,438,1.2977777777777777,0,1,0,0,3,FALSE
206,2022-03-18T18:00:38Z,0.8999999761581421,1.7777777777777777,1080,6,3,5,2,3,4,3,3,3,4,2,1,4,3,1,3,5,4,5,1,1,4,4,4,5,0,2,0,0,0,0,3,2,3,1,1,1,1,1,1,1,1,3,1,2,2,1,5,5,4,4,5,5,1,1,1,5,4,2,1,1,1,2,2,2,1,3,1,2,1,1,1,1.25,0,3.066666666666667,0,1.5555555555555556,0,2.8333333333333335,0,2.8333333333333335,0,1.5714285714285714,0,1.6666666666666667,0,2.189189189189189,0,0,0,0,0.9583455305140074,0.9252580339715715,-0.5328163702636706,0.19622083185395045,1,1,3,1,1,1,1,1.5,-0.5986473636146776,2,2,5,2,1,1,1,2,0,-1.4363059730518277,0,-1.6578683353067516,2,2,2,3,2,4,3,3,5,3,5,4,2,5,5,4,3,3,3,2,2.2,0,3.8,0,3,0,4,0,3.6,0,1,1,1,1,1,1,1,1,1,1,3,1,1,2,1,1,1,1,1,1,1.15,0,"Hispanic of Latino (e.g., Mexican American, Central American, and others)",0,26,0,1,NA,5,2,0,0,1,0,0,TRUE,TRUE,TRUE,TRUE,TRUE,5,0.51721875,0.4770343750044703,0.5274218750037253,0.5932419354896392,0.5188699999948343,0.6053031250014901,1,1,1,0.96875,0.967741935483871,1,0.164,0.253,0.624,0.025,2.037,17.212180306901093,1799.8020668544043,0.062,0.33,0.481,0.03,1.841,310.5425787688696,2142.3754564903375,0.081,0.338,0.464,0.011,1.321,80.52187439100639,1906.306746666217,81.47999999999999,61.36666666666667,120.0909090909091,FALSE,298,0.882962962962963,0,1,0,0,3,FALSE
207,2022-03-18T17:59:12Z,0.8999999761581421,1.7777777777777777,864,4,2,4,2,3,3,2,1,2,3,3,1,3,3,1,3,4,1,3,1,1,2,5,4,3,0,2,0,0,0,0,2,2,3,3,3,1,1,2,4,3,3,4,2,3,3,3,4,4,4,4,4,3,1,1,1,1,1,1,1,3,1,3,4,3,1,1,3,1,2,1,2,1.5,0,2.533333333333333,0,2.3333333333333335,0,3.4166666666666665,0,1.3333333333333333,0,2.2857142857142856,0,1.6666666666666667,0,2.4594594594594597,0,0,0,0,0.4846122886247058,0.37380408268330795,-0.4466634660828154,-0.036429691699753713,2,2,3,1,1,2,2,1,-0.4603111395192921,5,3,5,5,3,3,3,3.857142857142857,0,0.13872270157061628,1,0.3076998949849121,2,2,2,3,2,3,5,4,4,3,2,3,3,5,5,5,3,3,5,5,2.2,0,2.8,0,4.2,0,4.6,0,3.8666666666666667,0,1,1,4,3,4,4,4,4,4,3,4,4,2,4,2,3,1,4,3,4,3.15,0,"White, Caucasian, Anglo, European American",0,27,1,2,NA,5,2,0,0,1,0,0,TRUE,TRUE,TRUE,TRUE,TRUE,2,0.6234468750022352,0.4529843750018626,0.48370000000111757,0.6954064516155951,0.5379812500048429,0.5568437500037253,1,1,1,0.96875,1,1,0.073,0.375,0.684,0.015,1.366,96.6029050363674,1878.534970730728,0.065,0.359,0.67,0.009,1.055,44.53612409069618,1827.7503021483449,0.085,0.403,0.446,0.012,1.536,98.49706336280748,1931.9480628152064,91.06666666666668,117.22222222222223,128,FALSE,384,1.1377777777777778,0,1,0,0,3,FALSE
208,2022-03-18T17:56:55Z,1,1.6,900,6,3,4,3,4,4,3,4,4,3,3,3,4,4,2,4,4,2,3,1,1,2,3,4,3,6,2,0,0,0,0,2,2,3,4,3,2,3,3,4,1,2,3,1,3,3,4,2,3,4,3,3,4,1,1,1,2,1,1,3,1,1,4,3,3,2,2,2,2,2,3,1,2,0,3.533333333333333,0,2.888888888888889,0,2.6666666666666665,0,1.6666666666666667,0,2.2857142857142856,0,2,0,2.4324324324324325,0,3,0,0,0.38591786323110117,0.7440294975549755,0.3837307525869902,0.5638801250709828,3,2,3,2,1,2,1,1,-0.3773765525135179,4,3,3,4,2,3,4,3.2857142857142856,0,-0.05128942699093936,0,-0.117645201282991,2,3,2,3,3,4,4,4,4,3,5,4,3,3,3,1,4,5,2,3,2.6,0,4.4,0,2.6,0,3.4,0,3.466666666666667,0,1,2,2,3,2,2,2,2,1,1,2,3,2,3,1,3,2,2,2,2,2,0,"White, Caucasian, Anglo, European American",0,22,1,2,NA,5,2,0,0,0,0,0,TRUE,TRUE,TRUE,TRUE,TRUE,2,0.5145161290322562,0.4465937500000109,0.4933225806451622,0.6332666666666686,0.5612999999999922,0.5892000000000029,0.96875,1,0.96875,0.9375,0.9375,0.9375,0.077,0.341,0.587,0.013,1.856,285.58672372758116,2175.689567172471,0.072,0.337,0.711,0.008,1.249,82.83629692468878,1968.411416303458,0.069,0.354,0.471,0.012,1.803,181.4579732762626,2077.417786069916,142.76923076923077,156.125,150.25,FALSE,432,1.28,0,1,0,0,3,FALSE
210,2022-03-18T18:04:39Z,0.8999999761581421,1.6,900,4,3,5,5,4,5,3,5,5,5,3,5,5,5,1,5,5,5,5,5,5,5,5,5,5,5,2,0,0,0,0,3,4,4,4,4,4,4,4,4,4,3,3,3,5,1,4,1,5,5,5,5,5,5,5,5,5,3,5,5,5,3,3,3,3,4,4,5,3,3,3,3,3,0,4.4,0,3.888888888888889,0,3.6666666666666665,0,4.666666666666667,0,3.857142857142857,0,4.333333333333333,0,3.972972972972973,0,3,0,0,3.0901451190158635,2.941093626234304,0.728342369310411,1.8347179977723576,3,3,4,3,2,3,3,2.5,0.7833719283100348,3,2,2,2,1,1,2,1.8571428571428572,0,-0.3554296317763296,0,-1.0769205636353747,2,2,2,2,2,4,2,4,4,2,4,2,4,2,2,4,2,4,2,4,2,0,3.2,0,2.8,0,3.2,0,3.066666666666667,0,1,1,1,3,1,1,1,2,1,1,1,4,1,1,2,2,1,2,2,2,1.55,0,"Hispanic of Latino (e.g., Mexican American, Central American, and others)",0,22,1,2,NA,5,2,0,0,0,0,0,TRUE,TRUE,TRUE,TRUE,TRUE,1,0.48540625,0.4638281250001164,0.5045281249997207,0.591090322580489,0.5314225806452695,0.604174193548279,1,1,1,0.96875,1,0.96875,0.081,0.391,0.752,0.017,1.867,40.07426729645231,1870.9366438375391,0.074,0.341,0.62,0.029,2.024,108.66349640768422,1899.538068224154,0.077,0.362,0.682,0.016,1.962,47.75152924189,1868.3402729586785,109.8235294117647,69.79310344827586,122.625,FALSE,424,1.2562962962962962,0,1,0,3,6,FALSE
212,2022-03-18T17:40:38Z,0.800000011920929,1.25,1024,6,3,1,1,1,2,1,1,1,1,1,1,1,1,1,1,2,1,1,1,1,1,1,1,1,0,2,0,0,0,0,2,2,1,1,1,1,1,1,1,1,1,1,1,1,1,1,1,1,1,1,1,1,1,1,1,1,1,1,1,1,1,1,1,1,1,1,1,1,1,1,1,1,0,1.1333333333333333,0,1.2222222222222223,0,1,0,1,0,1,0,1,0,1.054054054054054,0,0,0,0,-1.401547841119736,-1.5059380237408087,-0.6189692744445258,-1.0624536490926673,1,1,3,1,1,1,1,1,-0.7920494875423887,5,5,5,5,3,3,5,4.428571428571429,0,0.6473058850354002,0,0.9270832807034747,1,1,1,1,1,5,4,5,5,5,5,4,4,4,5,4,5,5,4,4,1,0,4.8,0,4.2,0,4.6,0,4.533333333333333,0,1,1,1,1,1,1,1,1,1,1,1,1,1,1,1,1,1,1,1,1,1,0,"White, Caucasian, Anglo, European American",0,24,0,1,NA,5,2,0,0,1,0,0,TRUE,TRUE,TRUE,TRUE,TRUE,3,0.7039419354892547,0.5964290322680628,0.621877419340995,0.7098781250044703,0.6155906249955296,0.6585843749903142,1,1,1,1,1,1,0.087,0.513,0.862,0.031,1.483,95.99245345782975,1883.3641547152224,0.069,0.46,0.557,0.059,1.872,37.8199329400864,1819.9443919139003,0.066,0.591,0.664,0.056,1.259,43.44721423032387,1825.61576101836,47.83870967741936,31.728813559322038,22.482142857142854,TRUE,276,0.8177777777777777,0,1,0,0,3,FALSE
213,2022-03-18T18:04:01Z,0.8999999761581421,1.7777777777777777,720,6,4,1,1,2,1,1,1,1,1,1,1,1,1,1,1,1,1,1,1,1,1,1,1,1,2,2,0,0,0,0,1,1,2,1,1,1,1,1,1,1,1,1,1,2,1,1,1,1,1,1,1,1,1,1,1,1,1,1,2,2,2,5,1,1,1,1,1,1,1,1,2,1.25,0,1.0666666666666667,0,1.1111111111111112,0,1.0833333333333333,0,1,0,2,0,1,0,1.2432432432432432,0,1,0,0,-1.2787281117410283,-1.4524446304632024,-0.31345356682763886,-0.8829490986454206,1,1,1,1,1,1,1,1.5,-0.7645165376262261,5,5,5,5,5,5,5,5,0,1.6378673238553392,0,1.8400345684084134,2,1,2,1,2,4,4,3,5,4,4,4,5,4,5,5,5,5,4,2,1.6,0,4.4,0,4.4,0,3.8,0,4.2,0,2,1,1,1,3,1,1,2,1,1,1,2,1,1,1,2,1,1,1,2,1.35,0,"White, Caucasian, Anglo, European American",0,25,0,1,NA,5,2,0,0,0,0,0,TRUE,TRUE,TRUE,TRUE,TRUE,3,0.4363281250037253,0.39055312500149014,0.4335187500044703,0.49840333333611486,0.46787999999920526,0.529419999998808,1,1,1,0.9375,0.9375,0.9375,0.073,0.323,0.725,0.016,1.953,68.83837799738966,1919.5394696151072,0.061,0.255,0.49,0.014,1.645,101.80528433876776,1946.4817536898995,0.077,0.317,0.716,0.022,1.949,113.21124283617488,1968.139087425588,122.0625,117.5,88.5909090909091,FALSE,358,1.0607407407407408,0,1,0,0,3,FALSE
214,2022-03-18T17:58:38Z,1,1.7777777777777777,1080,6,3,1,1,3,1,3,2,1,2,2,1,1,1,2,1,1,1,1,1,1,1,1,1,1,0,2,0,0,0,0,1,2,1,1,2,2,2,2,2,2,1,2,1,2,2,1,2,1,1,1,2,1,5,1,1,2,1,2,1,1,1,1,2,2,1,1,1,1,2,1,1,1.25,0,1.5333333333333334,0,1.6666666666666667,0,1.5,0,1.8333333333333333,0,1.4285714285714286,0,1,0,1.5405405405405406,0,0,0,0,-1.0857256798602015,-1.118897590026364,-0.5328163702636706,-0.8258569801450173,1,1,1,1,1,1,1,1,-0.9579186615539372,5,5,5,5,2,2,4,4,0,0.2196552803757379,0,0.4343977554298661,2,2,2,2,2,4,5,3,4,2,5,4,4,3,4,3,4,4,4,3,2,0,4.2,0,3.6,0,3.4,0,3.7333333333333334,0,3,2,3,3,3,3,3,3,3,2,2,3,3,4,2,2,2,3,3,3,2.75,0,"White, Caucasian, Anglo, European American",0,27,0,1,NA,5,2,0,0,1,0,0,TRUE,TRUE,TRUE,TRUE,TRUE,5,0.46573225806124746,0.4098718750001863,0.4327812499990687,0.5027838709681265,0.47284062500018625,0.4845290322553727,0.96875,1,1,0.96875,1,0.96875,0.062,0.339,0.723,0.02,1.534,152.17910177521395,1999.3133120538473,0.11,0.28,0.865,0.035,2.074,25.24045443522762,1812.6195303208383,0.045,0.372,0.491,0.033,1.695,151.4983823943426,2027.9915393750607,76.7,59.257142857142846,51.36363636363636,FALSE,304,0.9007407407407407,1,1,0,3,6,FALSE
215,2022-03-18T17:54:39Z,0.8999999761581421,1.7777777777777777,1080,6,1,3,3,3,3,3,2,3,2,2,2,3,4,3,3,3,2,1,1,1,2,1,1,3,1,1,4,0,4,0,1,1,1,1,1,3,1,1,1,2,2,4,2,5,1,1,1,3,3,3,3,2,1,5,3,1,1,2,2,1,1,1,1,3,1,1,1,3,3,3,4,3.25,0,2.8,0,1.2222222222222223,0,2.5,0,2.1666666666666665,0,1.5714285714285714,0,1,0,1.837837837837838,0,1,0,0,-0.5681282489070757,-0.21776991356315983,0.37576966661920275,0.07899987652802146,3,2,4,3,1,3,2,3.5,0.9213724151481345,4,4,4,4,3,3,4,3.7142857142857144,0,-1.2405296635269585,0,-0.6097909349238235,2,2,2,1,1,5,5,5,5,3,2,2,5,1,4,2,3,4,1,5,1.6,0,3.2,0,3.2,0,4,0,3.466666666666667,0,4,1,3,4,1,4,1,4,4,3,3,4,3,1,1,4,4,4,4,4,3.05,0,"Asian or Asian American (e.g., Chinese, Japanese, and others)",0,24,1,2,NA,5,2,0,0,1,0,0,TRUE,TRUE,TRUE,TRUE,TRUE,3,0.5026322580644891,0.40191249999996215,0.4557874999999767,0.5935718749999651,0.4599482758621011,0.5094699999999721,1,1,1,1,0.90625,0.967741935483871,0.077,0.345,0.606,0.062,1.92,613.9847503531968,2849.9867484394863,0.047,0.342,0.606,0.041,1.991,455.6475605760464,2397.5692500265914,0.077,0.326,0.432,0.018,1.698,340.1024936136002,2126.9965893295966,30.96774193548387,48.5609756097561,94.33333333333334,FALSE,328,0.9718518518518519,0,1,0,0,3,FALSE
216,2022-03-18T17:57:49Z,0.8999999761581421,1.7777777777777777,1080,6,4,2,1,2,2,2,1,2,2,1,1,1,1,2,3,2,2,1,1,2,1,1,1,1,0,2,0,0,0,0,1,1,1,1,2,1,2,2,1,1,2,1,1,1,1,1,1,1,1,3,3,1,1,1,1,2,1,1,1,2,1,2,1,2,1,1,1,2,1,1,1,1.25,0,1.6666666666666667,0,1.3333333333333333,0,1.4166666666666667,0,1.1666666666666667,0,1.4285714285714286,0,1,0,1.3243243243243243,0,0,0,0,-1.0637935853282892,-1.0459341749308055,-0.5328163702636706,-0.789375272597238,1,2,2,2,1,2,2,1,-0.5432457265250663,4,5,4,5,2,2,4,3.7142857142857144,0,0.8160844699873094,1,0.6428711710179135,2,3,2,4,2,4,5,2,4,2,5,4,3,4,4,4,5,1,5,3,2.6,0,3.8,0,3.8,0,3.4,0,3.6666666666666665,0,1,1,1,1,1,1,3,2,1,1,1,2,2,1,1,1,1,1,1,1,1.25,0,"White, Caucasian, Anglo, European American",0,23,0,1,NA,5,2,0,0,0,0,0,TRUE,TRUE,TRUE,TRUE,TRUE,5,0.5580812499999883,0.49208749999993595,0.5629483870966661,0.6174624999999941,0.5688124999999563,0.6055516129031687,1,1,1,1,1,1,0.133,0.343,0.643,0.02,1.47,62.43409651280077,1846.4128458997716,0.115,0.349,0.851,0.01,1.204,58.373598215211494,1840.7448437671844,0.116,0.356,0.606,0.026,1.846,47.905568097512024,1830.8974850674736,73.5,120.39999999999999,71,FALSE,304,0.9007407407407407,1,1,0,3,6,FALSE
217,2022-03-18T17:55:43Z,0.8999999761581421,1.7777777777777777,1080,1,1,4,3,3,5,3,4,4,5,5,4,5,5,1,5,5,5,5,4,3,5,5,5,5,3,1,1,0,1,0,3,5,5,4,5,3,4,5,4,5,4,5,2,5,5,5,5,5,5,5,5,5,2,4,3,4,4,5,2,1,1,5,3,3,5,5,5,2,2,1,1,1.5,0,4.066666666666666,0,4.222222222222222,0,4.666666666666667,0,3.6666666666666665,0,2.857142857142857,0,5,0,4.081081081081081,0,2,0,0,2.9168815722137587,2.6790349992401485,-0.007937859210751935,1.3355485700146983,5,5,5,5,4,5,4,4.5,2.5521954680901695,1,2,2,1,1,1,1,1.2857142857142858,0,-1.5266208755073867,0,-2.0998915716799607,1,1,1,2,2,5,4,4,5,4,5,5,4,5,5,5,5,4,4,5,1.4,0,4.8,0,4.2,0,4.8,0,4.6,0,2,2,2,4,3,4,4,4,4,2,2,4,1,2,3,4,1,4,2,4,2.9,0,"White, Caucasian, Anglo, European American",0,26,0,1,NA,5,2,0,0,0,0,0,TRUE,TRUE,TRUE,TRUE,TRUE,2,0.46929062500968577,0.4113843750096858,0.48893437499925496,0.5994700000007948,0.523858620676501,0.5773206896535281,1,1,1,0.9375,0.90625,0.90625,0.074,0.314,0.455,0.012,1.74,112.93782404929397,1970.5484470433175,0.06,0.322,0.619,0.017,1.799,82.5229021063693,1938.8851382022951,0.082,0.333,0.662,0.013,1.949,66.27631950245454,1913.0645300338044,145,105.8235294117647,149.92307692307693,FALSE,272,0.8059259259259259,0,1,0,3,6,FALSE
218,2022-03-18T18:08:08Z,1,1.7786458333333333,768,5,1,3,2,3,3,2,2,3,3,2,2,2,3,2,3,3,2,2,1,1,3,2,2,2,0,2,0,0,0,0,2,3,3,2,2,1,2,2,3,1,2,2,1,3,1,1,2,2,2,3,3,2,1,1,1,3,1,1,1,1,1,2,2,2,3,3,2,2,2,1,3,2,0,2.533333333333333,0,2.2222222222222223,0,1.9166666666666667,0,1.5,0,1.4285714285714286,0,2.6666666666666665,0,1.8918918918918919,0,0,0,0,-0.2895906483517917,-0.14687150078162708,-0.274357657721105,-0.21061457925136604,2,2,3,2,1,2,2,2,0.009427695341904336,4,3,2,3,2,2,3,2.7142857142857144,0,-1.4543549658567896,0,-1.281848411384352,2,3,2,1,2,5,4,4,4,3,4,3,3,3,3,3,3,4,3,4,2,0,3.8,0,3.2,0,3.6,0,3.533333333333333,0,2,1,2,4,2,3,3,4,2,1,2,3,1,2,2,4,3,3,2,3,2.45,0,"White, Caucasian, Anglo, European American",0,27,1,2,NA,5,2,0,0,0,0,0,TRUE,TRUE,TRUE,TRUE,TRUE,3,0.6321906250000138,0.5846562499999995,0.6132812499999982,0.7076064516129141,0.6484250000000047,0.7630483870967761,1,1,1,1,1,0.96875,0.083,0.365,0.347,0.012,1.55,48.29665848569649,1871.6335628789016,0.089,0.393,0.472,0.023,1.738,36.82399196723125,1821.2294612780672,0.117,0.285,0.331,0.06,1.733,73.2220124547706,1858.188473124135,129.16666666666666,75.56521739130434,28.883333333333336,FALSE,334,0.9896296296296296,0,1,0,0,3,FALSE
219,2022-03-18T18:07:05Z,0.8999999761581421,1.7777777777777777,1080,6,4,3,2,1,2,1,1,2,1,1,1,1,2,1,2,3,2,2,1,1,1,2,1,1,1,2,0,0,0,0,2,3,3,2,4,3,2,2,2,2,4,1,1,3,1,4,1,1,1,2,2,2,1,1,1,2,2,1,2,2,1,1,1,1,1,1,1,2,2,2,2,2,0,1.6,0,2.5555555555555554,0,1.9166666666666667,0,1.5,0,1.2857142857142858,0,1,0,1.8108108108108107,0,1,0,0,-0.6668226743006803,-0.808065575043803,-0.05499485428507328,-0.4315302146644382,2,2,3,1,1,1,1,1.5,-0.4327781896031293,4,4,4,4,3,3,5,3.857142857142857,0,0.7766911997228434,0,0.6962798183632866,1,2,2,2,2,5,1,5,5,1,5,4,5,1,3,3,3,3,3,3,1.8,0,4,0,2.6,0,3.4,0,3.3333333333333335,0,1,2,1,1,1,1,2,1,1,1,1,1,3,1,1,1,1,1,1,1,1.2,0,"Asian or Asian American (e.g., Chinese, Japanese, and others) & Filipino",1,22,0,1,NA,5,2,0,0,1,0,0,TRUE,TRUE,TRUE,TRUE,TRUE,2,0.4708687500283122,0.4580531250163913,0.4383718750178814,0.549496774173552,0.5305677419324075,0.5194499999920527,1,1,1,0.96875,1,0.967741935483871,0.063,0.34,0.685,0.023,1.881,51.61580845020024,1881.0811041339484,0.185,0.201,0.736,0.022,1.767,22.64938135793193,1802.7422191248488,0.073,0.331,0.531,0.022,1.957,57.26091042010121,1880.9820784736503,81.78260869565217,80.31818181818181,88.95454545454547,FALSE,472,1.3985185185185185,0,1,0,0,3,FALSE
220,2022-03-18T17:51:26Z,0.800000011920929,1.7786458333333333,768,7,3,5,3,2,2,1,1,5,1,1,1,1,3,2,3,2,2,1,1,2,1,1,1,1,0,2,0,0,0,0,3,3,3,3,3,3,3,3,3,2,3,1,2,3,1,3,1,1,1,1,1,2,4,1,1,1,1,1,1,1,1,2,1,1,1,2,1,3,2,2,1,2,0,2.2,0,3,0,1.6666666666666667,0,1.6666666666666667,0,1.1428571428571428,0,1.3333333333333333,0,1.864864864864865,0,0,0,0,-0.7128800728176956,-0.5770803162035515,-0.274357657721105,-0.42571898696232824,2,4,3,3,3,3,3,1,0.20316555652690138,3,3,3,3,2,3,3,2.857142857142857,0,0.34904059506318114,0,-0.10601640787303052,1,1,1,1,1,5,2,5,5,1,5,4,4,4,4,4,4,4,2,2,1,0,4.4,0,2.6,0,4,0,3.6666666666666665,0,1,1,1,3,1,1,1,2,1,1,1,2,2,1,1,2,1,1,1,1,1.3,0,Black or African American,0,27,1,2,NA,3,2,0,0,1,1,0,TRUE,TRUE,TRUE,TRUE,TRUE,3,0.5718967741843193,0.48523124999552963,0.5723968750201166,0.6472548387281356,0.5318266666769982,0.6325266666611036,1,1,1,0.96875,0.9375,0.9375,0.055,0.468,0.531,0.028,1.954,53.50867425701129,1923.853954249888,0.052,0.383,0.543,0.027,1.654,117.450899069844,1969.0971721981796,0.065,0.438,0.523,0.011,1.404,109.1643472309338,1933.176706061946,69.78571428571428,61.25925925925926,127.63636363636364,FALSE,342,1.0133333333333332,0,0,0,0,3,FALSE
221,2022-03-18T17:49:52Z,1,1.7777777777777777,720,4,4,4,3,4,3,5,4,4,3,2,2,4,3,2,3,3,2,3,1,1,2,2,3,3,0,2,0,0,0,0,1,2,2,2,2,1,2,2,2,4,1,4,2,2,3,1,5,4,4,5,5,2,1,1,1,1,1,1,1,1,1,4,4,4,1,3,2,1,3,3,2,2.25,0,3.2666666666666666,0,1.7777777777777777,0,3.3333333333333335,0,1.1666666666666667,0,2.2857142857142856,0,2,0,2.2972972972972974,0,0,0,0,0.13589198556730314,0.459452511993593,-0.1882047535402498,0.1356238792266716,1,2,2,2,1,4,4,2.5,0.36869899328116373,4,4,4,5,3,3,4,3.857142857142857,0,0.7376207874909593,0,0.6724824399105899,2,2,3,3,2,4,5,4,4,4,4,4,3,5,5,4,5,3,5,2,2.4,0,4,0,4.2,0,4,0,4.066666666666666,0,3,4,3,2,4,2,3,2,1,1,3,2,2,3,1,2,3,3,4,3,2.55,0,"White, Caucasian, Anglo, European American",0,21,1,2,NA,5,2,0,0,1,0,0,TRUE,TRUE,TRUE,TRUE,TRUE,3,0.5036156250014902,0.47796774192010205,0.5007677419262547,0.5752218750119209,0.5708906249962747,0.5575566666563352,1,0.96875,0.96875,1,1,0.967741935483871,0.05,0.394,0.443,0.026,1.607,120.8548705382473,1991.1335671306883,0.068,0.337,0.453,0.031,2.102,128.77307228366695,1951.667650251401,0.146,0.277,0.679,0.007,0.98,25.65631686529951,1809.6462113272353,61.80769230769231,67.80645161290322,140,FALSE,339,1.0044444444444445,0,1,0,6,9,FALSE
223,2022-03-18T17:46:30Z,1,1.782258064516129,992,3,1,4,5,3,4,3,5,5,4,3,2,2,4,1,5,5,5,5,5,3,4,4,5,5,4,1,2,0,2,1,2,3,3,3,5,3,5,4,4,2,3,3,1,4,1,3,5,4,4,4,3,5,3,5,3,4,4,3,4,1,1,3,3,3,2,1,3,1,3,3,1,2,0,3.6666666666666665,0,3.5555555555555554,0,3.0833333333333335,0,4,0,2.5714285714285716,0,2,0,3.1621621621621623,0,2,1,0,2.2391798511776746,2.048619292801301,0.8637329606014429,1.456176126701372,5,4,5,3,5,5,5,3,1.8890545093012616,2,3,3,4,1,1,1,2.142857142857143,0,-1.5266208755073867,0,-1.6354755202358982,3,4,3,2,3,4,5,3,3,3,5,3,4,4,3,5,4,2,5,4,3,0,3.6,0,4.4,0,3.4,0,3.8,0,1,1,1,1,3,1,2,1,1,1,2,2,1,2,2,1,1,1,1,1,1.35,0,"White, Caucasian, Anglo, European American",0,18,0,1,NA,5,2,0,0,1,0,0,TRUE,TRUE,TRUE,TRUE,TRUE,4,0.6468406250000044,0.6076124999999738,0.5357749999999942,0.7693150000000489,0.7240709677419339,0.7744772727273045,1,1,1,0.625,0.96875,0.6875,0.066,0.375,0.344,0.007,1.985,145.09474179780142,2102.3050659071596,0.083,0.383,0.356,0.015,1.783,43.84066328599004,1867.4913980735448,0.058,0.414,0.191,0.008,1.814,159.51547977924994,2198.255391922915,283.57142857142856,118.86666666666666,226.75,FALSE,304,0.9007407407407407,1,1,0,0,3,FALSE
224,2022-03-18T18:01:59Z,1,1.6,900,7,3,3,3,1,3,1,1,2,2,1,1,2,3,1,3,3,4,1,1,1,3,1,1,3,1,2,0,0,0,0,1,3,2,2,2,1,1,1,1,3,2,3,1,4,1,5,1,1,2,2,2,4,4,3,3,3,3,1,3,1,1,3,3,1,1,3,1,3,3,1,3,2.5,0,2,0,1.5555555555555556,0,2.25,0,3.3333333333333335,0,1.8571428571428572,0,1.6666666666666667,0,2.135135135135135,0,1,0,0,-0.1316795677220247,-0.27352497604184134,0.11731095407663712,-0.07810701098260212,2,3,4,1,1,1,2,2,0.009427695341904336,3,2,3,5,1,1,3,2.5714285714285716,0,-0.9515359633553193,0,-1.052989304058783,1,1,1,1,1,5,5,5,5,3,5,5,4,5,3,4,5,5,4,5,1,0,5,0,4,0,4.6,0,4.533333333333333,0,2,1,1,1,2,2,2,2,1,1,3,2,2,2,2,1,1,1,1,2,1.6,0,Black or African American,0,28,1,2,NA,5,2,0,0,1,0,0,TRUE,TRUE,TRUE,TRUE,TRUE,6,0.5193093750067055,0.49386129032027337,0.5139718749932944,0.5972156250104308,0.5393193548398634,0.5739874999932945,1,1,1,1,0.96875,1,0.088,0.382,0.645,0.032,1.94,93.013396283364,1894.445119407961,0.122,0.309,0.759,0.016,1.328,168.19718907980615,1996.7847760173067,0.139,0.33,0.765,0.019,1.821,21.797877664046464,1803.623441441724,60.625,83,95.84210526315789,FALSE,438,1.2977777777777777,0,1,0,0,3,FALSE
225,2022-03-18T17:40:33Z,1,1.7786458333333333,768,2,2,2,1,1,3,1,2,4,3,2,1,2,3,3,3,3,3,4,3,2,2,3,4,2,2,2,0,0,0,0,2,3,2,3,4,3,1,1,1,1,3,2,2,2,2,1,5,5,3,1,1,4,1,1,1,3,3,1,2,2,1,2,2,2,1,1,1,2,2,2,2,2,0,2.2666666666666666,0,2.2222222222222223,0,2.3333333333333335,0,2.1666666666666665,0,1.7142857142857142,0,1,0,2.054054054054054,0,1,0,0,0.46487340354598494,0.24410227067381787,-0.05499485428507328,0.0945537081943723,1,2,2,1,1,2,2,1,-0.6261803135308405,2,1,1,1,2,1,4,1.7142857142857142,0,-0.17479982686521142,0,-1.0443035185364042,3,3,4,3,3,3,4,3,3,2,4,2,3,3,3,4,4,4,2,4,3.2,0,3.4,0,3,0,3.2,0,3.2,0,2,3,2,3,2,3,2,3,2,3,3,1,2,2,2,1,2,3,3,3,2.35,0,"White, Caucasian, Anglo, European American",0,24,0,1,NA,5,2,0,0,0,0,0,TRUE,TRUE,TRUE,TRUE,TRUE,6,0.5859968750000698,0.7918419354842795,0.4879312500002561,0.6284548387094852,0.963596666666617,0.5450482758620175,1,1,1,0.96875,1,0.90625,0.055,0.35,0.429,0.023,1.937,73.87599958615219,1933.338969028734,0.123,0.169,0.181,0.263,1.849,347.04439783802934,2134.4120071584275,0.061,0.408,0.372,0.03,1.892,110.36967188839348,1934.6838151332352,84.21739130434783,7.03041825095057,63.06666666666666,FALSE,402,1.1911111111111112,0,1,0,0,3,FALSE
226,2022-03-18T17:48:40Z,0.800000011920929,1.6,800,6,2,2,3,2,3,3,2,2,2,2,1,1,3,2,2,2,2,2,3,2,2,2,2,2,2,2,0,0,0,0,2,2,3,2,3,1,1,1,3,2,3,1,3,3,2,3,3,2,1,1,1,3,3,5,1,3,1,2,3,3,3,3,3,3,2,3,3,2,2,2,2,2,0,2.1333333333333333,0,2,0,2.0833333333333335,0,2.6666666666666665,0,2.857142857142857,0,2.6666666666666665,0,2.3513513513513513,0,1,0,0,0.17098333681836214,-0.011761349378261576,-0.05499485428507328,-0.03337810183166743,4,4,5,3,3,4,3,2.5,1.1980448633389056,1,3,3,4,1,1,3,2.2857142857142856,0,-0.10514851658861807,1,-0.6922689347505284,2,2,2,3,2,4,2,5,5,3,2,3,4,3,3,1,3,3,2,5,2.2,0,3,0,2.4,0,4.2,0,3.2,0,2,1,4,4,2,4,4,4,3,2,1,4,2,3,2,4,1,4,1,3,2.75,0,Black or African American,0,28,1,2,NA,5,2,0,0,1,0,0,TRUE,TRUE,TRUE,TRUE,TRUE,3,0.7886156249921769,0.6448437499906867,0.6869937500003725,0.8731593750044704,0.6925709677396282,0.7437580645180518,1,1,1,1,1,1,0.11,0.417,0.435,0.01,1.264,176.16954212103266,1965.7256257470683,0.104,0.455,0.567,0.024,1.522,47.05665463807074,1830.987560250839,0.224,0.393,0.583,0.018,1.524,76.59142673502875,1860.5586655351728,126.4,63.416666666666664,84.66666666666667,FALSE,253,0.7496296296296296,0,1,0,0,3,FALSE
227,2022-03-18T18:15:19Z,0.8999999761581421,1.7777777777777777,864,5,3,5,1,2,2,2,2,4,4,3,3,5,5,3,4,4,2,4,4,1,1,5,3,3,6,2,0,0,0,0,1,1,4,3,3,1,2,2,5,1,2,4,1,5,5,5,3,5,5,5,5,5,3,4,3,2,1,1,2,1,1,1,1,1,1,4,1,2,2,2,2,2,0,3.2666666666666666,0,2.4444444444444446,0,3.8333333333333335,0,3,0,1.1428571428571428,0,2,0,2.7027027027027026,0,3,0,0,0.8859696185586973,0.963903077276901,0.3837307525869902,0.6738169149319456,1,1,3,1,1,1,1,1.5,-0.5986473636146776,5,5,5,5,3,3,5,4.428571428571429,0,0.18645978295702492,0,0.6463867517157567,2,3,2,1,2,4,5,5,5,5,5,4,5,5,5,5,5,5,4,3,2,0,4.6,0,4.8,0,4.6,0,4.666666666666667,0,2,2,4,4,3,2,2,4,4,1,4,3,2,4,4,3,2,3,4,2,2.95,0,"Asian or Asian American (e.g., Chinese, Japanese, and others)",0,22,1,2,NA,5,2,0,0,1,0,0,TRUE,TRUE,TRUE,TRUE,TRUE,4,0.4384437500005588,0.40048333333333336,0.44068387096543465,0.5384692307733573,0.4583384615377738,0.4610740740740741,1,0.9375,0.96875,0.8125,0.8125,0.84375,0.038,0.343,0.399,0.04,1.875,70.47692303949962,2016.9917317894085,0.041,0.316,0.456,0.009,1.205,165.03148688469614,2170.6976725204786,0.052,0.343,0.533,0.013,1.756,45.20247849539644,1948.9289725463743,46.875,133.88888888888891,135.0769230769231,FALSE,432,1.28,0,1,0,0,3,FALSE
228,2022-03-18T18:14:12Z,0.8999999761581421,1.6,900,4,4,4,3,3,2,3,3,4,3,2,3,3,3,2,4,3,2,3,1,1,2,2,3,2,1,2,0,0,0,0,1,4,1,2,2,2,2,1,2,3,2,3,1,2,2,1,4,2,3,3,4,3,1,1,1,2,1,2,1,1,1,4,4,4,1,3,1,2,2,1,1,1.5,0,3,0,1.8888888888888888,0,2.5,0,1.5,0,2.4285714285714284,0,1.6666666666666667,0,2.108108108108108,0,1,0,0,-0.06807649357947967,0.20585056114258846,-0.22730066264678367,-0.010725050752097606,2,3,1,1,1,1,1,2,-0.32231065268119236,4,4,5,5,2,1,2,3.2857142857142856,0,0.6141103876166872,0,0.28764284934191653,4,3,4,4,4,2,5,1,2,2,4,3,3,2,3,3,4,4,3,2,3.8,0,3.4,0,3.2,0,2,0,2.8666666666666667,0,1,3,3,3,4,3,4,3,1,1,3,3,2,3,1,3,2,3,2,4,2.6,0,"White, Caucasian, Anglo, European American",0,21,1,2,NA,5,2,0,0,0,0,0,TRUE,TRUE,TRUE,TRUE,TRUE,6,0.5122718750000932,0.4889593749996275,0.5428156249995809,0.6120366666649779,0.5727806451613865,0.6299903225800203,1,1,1,0.9375,0.96875,0.96875,0.072,0.398,0.524,0.015,1.747,63.45075926720345,1886.2592161594896,0.08,0.347,0.614,0.02,2.039,87.24062635355745,1914.8341188520503,0.08,0.334,0.515,0.014,1.918,71.41249453647843,1914.8523535031572,116.46666666666668,101.95,137,FALSE,438,1.2977777777777777,0,1,0,0,3,FALSE
229,2022-03-18T18:13:06Z,0.8999999761581421,1.7777777777777777,1080,7,2,3,2,3,3,4,4,4,3,2,3,2,3,2,3,3,2,2,1,1,2,2,2,2,0,2,0,0,0,0,1,2,1,2,2,2,1,1,3,2,2,3,1,1,2,1,2,3,3,4,3,3,1,1,1,1,1,1,1,1,1,1,2,2,1,1,2,1,1,1,1,1,0,2.933333333333333,0,1.6666666666666667,0,2.25,0,1.3333333333333333,0,1.2857142857142858,0,1.3333333333333333,0,1.7027027027027026,0,0,0,0,-0.4935591274985745,-0.10940645879859792,-0.6189692744445258,-0.36418786662156183,1,1,1,1,1,1,1,1,-0.9579186615539372,5,5,5,5,2,2,5,4.142857142857143,0,1.2043418043825058,0,1.111562668396218,2,3,2,2,2,4,5,4,5,3,5,5,4,3,5,5,5,5,4,5,2.2,0,4.8,0,4.2,0,4.4,0,4.466666666666667,0,1,1,2,2,2,1,2,3,3,1,1,2,1,2,1,3,1,1,2,2,1.7,0,"White, Caucasian, Anglo, European American & Middle Eastern",1,25,1,3,NA,5,2,0,0,1,0,0,TRUE,TRUE,TRUE,TRUE,TRUE,5,0.5300193548387577,0.48188749999878927,0.5136468750007916,0.59721666666617,0.5413062499994412,0.6086718750002328,0.96875,1,1,0.967741935483871,1,1,0.132,0.305,0.65,0.019,1.905,70.0512247042601,1855.559632572621,0.126,0.305,0.774,0.007,0.974,69.30139073352257,1849.7561224968572,0.065,0.397,0.546,0.013,1.518,222.75848635637172,2091.270277339417,100.26315789473685,139.14285714285714,116.76923076923077,FALSE,316,0.9362962962962963,0,1,0,0,3,FALSE
230,2022-03-18T18:01:39Z,0.8999999761581421,1.6,900,4,3,3,2,3,3,5,3,2,3,1,2,2,2,1,3,3,3,2,1,2,1,1,2,1,5,1,1,0,1,0,3,4,2,2,3,2,3,4,1,4,2,2,1,2,1,2,4,4,3,2,1,1,1,1,1,2,1,2,4,4,2,3,3,2,2,3,1,2,2,3,3,2.5,0,2.533333333333333,0,2.6666666666666665,0,2.3333333333333335,0,1.1666666666666667,0,2.857142857142857,0,2,0,2.2972972972972974,0,3,0,0,-0.1887030135049961,-0.07902142474936893,0.5560365609487006,0.23850756809966583,2,1,3,1,1,1,1,1,-0.7091149005366146,5,4,4,4,2,2,3,3.4285714285714284,0,-0.3760932239552953,1,-0.23807711333458287,2,3,2,2,2,4,4,4,4,2,4,4,4,4,4,3,4,4,3,1,2.2,0,4,0,3.2,0,3.4,0,3.533333333333333,0,1,1,1,1,2,1,1,2,1,1,1,2,1,1,1,1,1,1,1,1,1.15,0,"White, Caucasian, Anglo, European American",0,19,1,2,NA,5,2,0,0,0,0,0,TRUE,TRUE,TRUE,TRUE,TRUE,4,0.6040406250002561,0.5845129032258786,0.5562806451615067,0.6710531250004423,0.6069838709682226,0.6614966666664929,1,1,1,1,1,0.9375,0.074,0.378,0.447,0.01,1.525,56.06149796192951,1900.9247185661443,0.091,0.39,0.487,0.02,1.301,59.00802493959249,1838.7366324257468,0.077,0.407,0.402,0.02,1.626,171.91390475925002,1956.210266407307,152.5,65.05,81.3,FALSE,420,1.2444444444444445,0,1,0,0,3,FALSE
231,2022-03-18T18:10:36Z,0.8999999761581421,1.7777777777777777,864,3,3,2,2,2,2,1,1,3,2,4,1,3,3,2,3,5,2,3,1,1,1,3,2,1,2,2,0,0,0,0,5,3,5,3,5,1,2,2,5,1,2,2,1,5,3,2,3,1,2,3,4,3,2,3,1,3,1,1,2,1,1,3,2,2,2,3,1,2,1,1,1,1.25,0,2.4,0,3.4444444444444446,0,2.4166666666666665,0,2.1666666666666665,0,1.7142857142857142,0,2,0,2.4594594594594597,0,1,0,0,-0.0022802099837430836,-0.01185968282178632,-0.31345356682763886,-0.1626566248247126,1,1,3,1,1,1,1,1,-0.7920494875423887,4,3,3,2,1,1,2,2.2857142857142856,0,-1.1502147610713993,0,-1.328807827160771,1,1,1,1,1,5,4,5,5,3,5,5,5,4,4,5,5,4,4,4,1,0,4.8,0,4.2,0,4.4,0,4.466666666666667,0,1,1,1,1,2,1,1,1,1,2,1,2,2,1,1,2,1,1,1,2,1.3,0,"White, Caucasian, Anglo, European American",0,23,1,2,NA,5,2,0,0,0,0,0,TRUE,TRUE,TRUE,TRUE,TRUE,5,0.6139750000005588,0.5069250000016764,0.6019937499994412,0.6804161290372571,0.6010937499981374,0.7247562500005588,1,1,1,1,1,1,0.094,0.408,0.501,0.012,1.606,63.50088262026125,1846.2429280720185,0.106,0.348,0.694,0.016,1.796,50.973101160733925,1835.3850834438872,0.125,0.345,0.478,0.017,1.478,23.0818027769376,1804.3781763041736,133.83333333333334,112.25,86.94117647058823,FALSE,360,1.0666666666666667,0,1,0,3,6,FALSE
232,2022-03-18T17:59:28Z,1,1.6,1050,4,3,4,2,3,2,3,2,3,3,1,3,3,4,1,4,3,1,3,2,1,3,4,4,3,1,2,0,0,0,0,1,4,4,2,4,1,2,1,2,5,3,2,1,4,3,1,3,5,5,5,5,5,5,1,1,1,1,1,1,1,1,2,1,1,1,1,1,1,1,1,1,1,0,2.7333333333333334,0,2.3333333333333335,0,3.5,0,2.3333333333333335,0,1.1428571428571428,0,1,0,2.3783783783783785,0,1,0,0,0.5131240115161918,0.48029920202089565,-0.39960647100849406,0.0403463655062008,2,1,2,1,1,2,1,2,-0.32231065268119236,5,5,5,5,3,3,5,4.428571428571429,0,0.1293403779201788,0,0.6115959209820738,1,1,1,2,2,5,4,5,5,2,5,5,3,3,4,3,5,5,3,2,1.4,0,5,0,3,0,3.8,0,3.933333333333333,0,1,1,1,1,1,1,1,3,1,1,1,2,1,1,1,3,1,1,1,1,1.25,0,Black or African American,0,21,1,2,NA,5,2,1,1,1,0,2,TRUE,TRUE,TRUE,TRUE,TRUE,3,0.521599999997885,0.4346968750022352,0.46584062499925494,0.6274600000003974,0.4883645161294168,0.5412000000005768,0.96875,1,1,0.967741935483871,0.96875,0.96875,0.068,0.362,0.672,0.019,1.723,63.64365129884743,1892.0989311526855,0.058,0.344,0.659,0.025,1.671,27.535106757256287,1856.2073063576809,0.065,0.387,0.461,0.008,1.265,104.81860593161558,1976.1115324184568,90.6842105263158,66.84,158.12499999999997,FALSE,392,1.1614814814814816,0,1,0,0,3,FALSE
233,2022-03-18T17:41:47Z,0.699999988079071,1.3333333333333333,768,1,2,5,1,4,2,4,2,5,5,5,4,5,4,3,4,1,4,5,3,1,4,5,5,4,3,2,0,0,0,0,1,2,3,2,1,1,1,1,3,3,2,5,2,2,5,1,5,5,5,5,5,4,1,1,1,1,1,1,3,3,1,2,2,1,1,1,5,1,1,1,1,1,0,3.6,0,1.6666666666666667,0,3.75,0,1.5,0,1.8571428571428572,0,2.3333333333333335,0,2.4054054054054053,0,2,0,0,1.3421571848224692,1.4162369174919531,-0.18024366757246235,0.6179966249597454,2,2,3,2,1,1,1,1,-0.5432457265250663,5,5,5,5,4,4,5,4.714285714285714,0,-0.4789400316506016,0,0.39590405157220343,3,3,3,2,3,4,4,4,4,2,5,4,3,5,4,4,4,4,4,2,2.8,0,4.2,0,3.4,0,3.8,0,3.8,0,1,2,1,1,2,2,1,1,1,2,1,2,1,3,3,2,1,2,2,1,1.6,0,"White, Caucasian, Anglo, European American",0,21,0,1,NA,5,2,1,1,4,0,2,TRUE,TRUE,TRUE,TRUE,TRUE,4,0.7828451612889766,0.9047935483840204,0.9911562499981373,0.8053343750000932,0.7395906249987892,1.131796875001397,1,1,1,1,1,1,0.132,0.254,0.178,0.061,1.998,136.16003001064087,1918.404968362306,0.112,0.346,0.251,0.259,1.267,162.91677968694822,1948.873537481044,0.095,0.464,0.293,0.155,1.521,44.08565546685093,1826.7055040247535,32.75409836065574,4.891891891891891,9.812903225806451,FALSE,338,1.0014814814814814,0,1,0,6,9,FALSE
234,2022-03-18T18:05:24Z,1,1.7777777777777777,1080,6,2,1,2,3,2,3,2,1,2,1,2,1,1,2,2,2,2,1,2,1,1,1,1,1,0,2,0,0,0,0,1,1,1,1,1,1,1,1,1,1,2,1,1,1,2,1,2,1,1,1,1,2,1,1,1,2,1,1,1,1,1,1,1,2,1,1,1,1,1,1,1,1,0,1.8,0,1,0,1.25,0,1.3333333333333333,0,1.1428571428571428,0,1,0,1.162162162162162,0,0,0,0,-1.1690676390814674,-1.058520855702007,-0.6189692744445258,-0.8387450650732664,1,1,3,2,1,1,1,2,-0.32231065268119236,5,5,5,5,3,4,5,4.571428571428571,0,0.5809148901979743,0,0.9640478970718698,2,2,2,2,2,4,4,4,4,3,4,4,3,4,4,5,5,4,4,3,2,0,4.2,0,3.8,0,3.8,0,3.933333333333333,0,1,1,3,2,2,3,3,3,1,2,3,3,3,1,1,3,1,2,1,4,2.15,0,"White, Caucasian, Anglo, European American",0,27,0,1,NA,5,2,0,1,1,0,1,TRUE,TRUE,TRUE,TRUE,TRUE,4,0.8129451612964753,0.5690156250447035,0.6407781249880791,0.8954333333333333,0.6502466666698455,0.8051406249850989,0.96875,1,1,0.967741935483871,0.9375,1,0.131,0.389,0.499,0.013,1.831,51.85835946598483,1836.715440670561,0.06,0.431,0.422,0.01,1.365,120.15952732543224,1964.7236660369233,0.094,0.53,0.328,0.019,1.678,66.84846163602103,1849.2637208435472,140.84615384615384,136.5,88.3157894736842,TRUE,343,1.0162962962962963,0,1,0,0,3,FALSE
236,2022-03-18T18:09:48Z,1,1.6,900,6,3,1,1,2,1,2,1,1,1,1,1,1,2,1,1,2,1,2,1,1,1,2,1,1,4,1,1,0,0,0,1,2,1,2,3,1,4,1,2,1,1,1,1,2,1,1,1,1,2,2,1,1,1,1,1,1,1,1,4,4,1,1,1,1,1,2,1,2,1,2,2,1.75,0,1.2666666666666666,0,1.8888888888888888,0,1.25,0,1,0,1.8571428571428572,0,1.3333333333333333,0,1.4864864864864864,0,2,0,0,-0.9585195315751113,-1.1497742912932176,0.07821504497010326,-0.5357796231615571,1,1,2,1,1,2,1,1,-0.7920494875423887,4,4,4,4,3,3,5,3.857142857142857,0,0.5451397626206321,1,0.5552442657491192,2,2,3,3,3,3,3,4,4,4,5,2,3,4,4,2,3,4,2,1,2.6,0,3.4,0,2.8,0,3.4,0,3.2,0,2,1,2,2,3,1,2,2,1,1,2,2,1,2,1,2,2,2,1,2,1.7,0,"Asian or Asian American (e.g., Chinese, Japanese, and others)",0,24,1,2,NA,5,2,0,0,1,0,0,TRUE,TRUE,TRUE,TRUE,TRUE,5,0.500109677416663,0.45821562498807905,0.4688249999973923,0.5663999999995742,0.531364516135185,0.5532607142903975,0.96875,1,1,0.875,0.96875,0.9032258064516129,0.055,0.353,0.52,0.015,1.708,56.72173051086478,1914.8882817300805,0.072,0.308,0.503,0.016,1.605,49.47656235266607,1873.8563256983623,0.055,0.343,0.371,0.015,1.706,67.4869280841304,1970.985352095465,113.86666666666667,100.3125,113.73333333333333,FALSE,436,1.2918518518518518,0,1,0,3,6,FALSE
237,2022-03-18T17:45:56Z,0.8999999761581421,1.7786458333333333,768,4,2,4,2,3,3,4,3,2,3,4,3,4,3,4,3,3,3,3,1,2,3,3,3,3,5,1,1,0,0,0,3,3,3,3,3,2,2,2,2,3,3,3,3,4,3,4,4,4,3,5,5,3,1,1,1,4,2,3,4,4,2,3,3,3,2,3,2,3,1,2,3,2.25,0,3.2,0,2.5555555555555554,0,3.6666666666666665,0,2,0,3.142857142857143,0,2.3333333333333335,0,2.918918918918919,0,3,0,0,0.8640375240267854,0.920046361464746,0.4698836567678454,0.6949650091162958,2,2,3,2,1,2,2,2.5,0.20282981926961546,4,4,4,4,3,3,4,3.7142857142857144,0,0.9905165020526746,0,0.749115892898398,3,2,3,2,3,3,4,4,4,3,4,4,4,3,3,4,4,5,4,4,2.6,0,4,0,3.8,0,3.6,0,3.8,0,3,2,3,3,2,3,4,3,3,3,2,3,3,4,3,3,3,4,3,4,3.05,0,"White, Caucasian, Anglo, European American",0,21,0,1,NA,5,2,1,1,1,0,2,TRUE,TRUE,TRUE,TRUE,TRUE,5,0.47573750000447035,0.4177343749925494,0.4709406249932945,0.5258851851931324,0.49093000000317893,0.5675677419247166,1,1,1,0.84375,0.9375,0.96875,0.078,0.307,0.512,0.014,1.709,152.1571892961877,1991.6090714830973,0.061,0.311,0.601,0.023,1.915,61.904389346460256,1906.6213764134473,0.049,0.336,0.379,0.018,1.635,149.24622102972273,2053.9145922889657,122.07142857142857,83.26086956521739,90.83333333333334,FALSE,358,1.0607407407407408,0,1,0,0,3,FALSE
238,2022-03-18T18:17:21Z,0.8999999761581421,1.7777777777777777,1080,6,3,2,2,1,1,1,1,2,2,1,1,1,2,1,2,2,1,1,1,1,1,1,1,1,1,2,0,0,0,0,2,3,2,2,2,1,2,1,3,2,2,1,1,3,1,3,1,1,1,1,1,2,1,1,1,1,1,1,2,2,2,1,1,2,1,1,1,1,2,2,2,1.75,0,1.4666666666666666,0,2,0,1.5,0,1.1666666666666667,0,1.5714285714285714,0,1,0,1.5405405405405406,0,1,0,0,-1.0857256798602015,-1.1480042893097673,-0.14114775846592847,-0.6445760238878478,2,2,3,1,2,3,2,1,-0.29444196550774376,5,4,5,5,1,1,5,3.7142857142857144,0,0.18645978295702492,0,0.25937337551237094,2,2,1,2,1,4,3,3,5,2,5,3,5,1,1,4,4,5,2,3,1.6,0,4.2,0,3.2,0,2.6,0,3.3333333333333335,0,1,1,1,2,1,1,1,4,1,1,2,1,1,1,1,2,1,1,1,1,1.3,0,"Asian or Asian American (e.g., Chinese, Japanese, and others)",0,26,0,1,NA,5,2,0,0,1,0,0,TRUE,TRUE,TRUE,TRUE,TRUE,6,0.5616875,0.4625,0.5656875,0.5814516129032258,0.5767931034482758,0.5856774193548387,1,1,1,0.96875,0.9354838709677419,1,0.103,0.376,0.594,0.028,1.112,36.12358461493156,1819.0606417241888,0.06,0.349,0.459,0.014,1.451,123.56789164794132,1993.39505867906,0.061,0.413,0.454,0.033,1.675,162.42710383272257,1985.6714164129528,39.714285714285715,103.64285714285714,50.75757575757576,FALSE,355,1.0518518518518518,0,1,0,3,9,FALSE
239,2022-03-18T18:15:26Z,0.8999999761581421,1.7777777777777777,1080,5,2,1,1,1,2,1,1,4,1,1,1,1,1,1,3,4,5,1,1,1,1,3,1,3,3,2,0,0,0,0,3,4,1,4,5,3,3,1,5,2,1,1,1,1,1,1,2,3,4,1,5,1,1,3,1,3,1,1,2,2,1,1,1,1,1,1,3,1,2,1,3,1.75,0,1.6,0,3.2222222222222223,0,1.9166666666666667,0,1.6666666666666667,0,1.2857142857142858,0,1.6666666666666667,0,2.054054054054054,0,2,0,0,-0.1031678448305387,-0.42899015025488435,0.07821504497010326,-0.17538755264239053,1,1,1,1,1,1,1,2,-0.571114413698515,5,5,5,5,5,5,5,5,0,1.2946567068380648,0,1.6309885800101043,2,1,2,2,2,4,5,3,3,3,4,3,4,5,5,3,4,5,3,1,1.8,0,4,0,3.6,0,3.4,0,3.6666666666666665,0,3,1,3,3,4,3,4,3,2,4,1,3,2,1,2,3,1,2,1,4,2.5,0,"White, Caucasian, Anglo, European American",0,26,1,3,NA,5,2,0,0,1,0,0,TRUE,TRUE,TRUE,TRUE,TRUE,4,0.591309374999255,0.52665625,0.5771687500011176,0.6447870967791927,0.5600593750011176,0.6344843749962747,1,1,1,1,1,1,0.214,0.328,0.859,0.024,1.57,59.48831633133919,1842.364942679408,0.229,0.216,0.733,0.034,1.546,163.60987470474953,1954.2062960280864,0.261,0.29,0.873,0.012,1.005,19.94792317360668,1800.0112884752211,65.41666666666667,45.470588235294116,83.74999999999999,FALSE,530,1.5703703703703704,0,1,0,0,3,FALSE
240,2022-03-18T18:18:40Z,0.800000011920929,1.7777777777777777,1080,4,3,1,1,2,2,1,1,3,1,2,1,1,1,1,2,1,1,2,1,1,1,1,1,1,3,2,0,0,0,0,1,1,1,1,1,1,1,1,1,2,1,1,1,1,1,1,1,1,1,1,2,1,1,1,1,3,2,1,3,2,1,1,2,2,1,2,1,2,1,2,2,1.75,0,1.4,0,1,0,1.1666666666666667,0,1.5,0,1.7142857142857142,0,1.3333333333333333,0,1.2972972972972974,0,2,0,0,-1.1624880107218938,-1.2287360464438017,0.07821504497010326,-0.5752605007368492,3,2,5,2,1,3,3,3.5,1.0043070021539087,3,3,5,2,1,1,2,2.4285714285714284,0,-0.8612210608997602,0,-1.0753821191296364,2,2,2,3,3,2,3,2,3,4,3,2,4,5,4,5,3,3,3,1,2.4,0,2.6,0,3.8,0,3,0,3.1333333333333333,0,1,1,3,3,2,4,3,3,4,1,1,3,1,3,1,3,1,3,3,3,2.35,0,Black or African American,0,30,0,1,NA,5,2,0,0,1,0,0,TRUE,TRUE,TRUE,TRUE,TRUE,5,0.5012806451628286,0.4382656249944121,0.4702312499955297,0.526643750006333,0.49264193548310187,0.526503125011921,1,1,1,1,1,1,0.1,0.344,0.824,0.029,1.949,28.210273579453315,1809.4279482072827,0.116,0.281,0.773,0.014,1.178,66.09276559117295,1852.44669973417,0.091,0.379,0.758,0.021,1.071,127.30543940244692,1919.7311527248112,67.20689655172414,84.14285714285714,50.99999999999999,FALSE,304,0.9007407407407407,1,1,0,0,3,FALSE
241,2022-03-18T18:15:59Z,1,1.7777777777777777,864,4,3,3,3,2,2,4,4,2,3,1,3,4,3,2,4,3,3,1,1,1,2,2,4,2,2,1,1,0,1,0,1,2,2,3,4,1,2,3,1,2,2,1,1,2,1,1,4,2,1,1,2,1,1,3,1,5,4,1,4,4,4,4,4,4,1,3,1,4,1,1,1,1.75,0,2.8666666666666667,0,2.111111111111111,0,1.6666666666666667,0,2.5,0,3.5714285714285716,0,1.6666666666666667,0,2.27027027027027,0,1,0,0,0.037197560173698525,0.21843724191378996,-0.14114775846592847,0.038644741723930745,2,2,2,1,1,2,1,1,-0.6261803135308405,4,3,5,3,1,1,1,2.5714285714285716,0,-0.698640248793604,0,-0.8989531758302978,2,2,1,1,2,5,4,5,5,3,5,5,5,4,4,5,5,5,3,5,1.6,0,5,0,4,0,4.6,0,4.533333333333333,0,2,3,1,2,2,1,4,2,1,1,2,2,2,2,1,2,2,1,1,2,1.8,0,"White, Caucasian, Anglo, European American",0,22,1,2,NA,5,2,0,0,0,0,0,TRUE,TRUE,TRUE,TRUE,TRUE,2,0.4866875,0.42170967741935483,0.4893125,0.5468666666666666,0.50521875,0.5334193548387097,1,0.96875,1,0.9375,1,0.96875,0.061,0.368,0.483,0.04,1.87,79.08891964445708,1901.0847196400832,0.062,0.333,0.579,0.031,1.868,132.22979040311728,1972.5175829598252,0.056,0.374,0.57,0.012,1.323,117.93481184466184,1966.5900177692945,46.75,60.25806451612904,110.25,FALSE,391,1.1585185185185185,0,1,0,0,3,FALSE
242,2022-03-18T18:21:08Z,0.8999999761581421,1.7777777777777777,1080,5,3,2,2,3,2,2,2,1,2,3,1,5,2,1,2,2,5,4,4,1,1,3,3,2,5,2,0,0,0,0,1,2,2,4,2,1,5,5,4,2,1,1,1,2,2,1,2,1,1,1,2,5,1,5,4,3,1,1,5,4,1,2,2,2,1,1,1,3,3,3,4,3.25,0,2.1333333333333333,0,2.888888888888889,0,1.4166666666666667,0,3.1666666666666665,0,2.4285714285714284,0,1,0,2.2162162162162162,0,3,0,0,0.5701474572991626,0.2566889514450194,0.8144952734912662,0.5355921124681428,2,1,3,1,1,2,1,2,-0.23937606567541822,2,4,2,2,1,1,2,2,0,-1.2224806707219966,0,-1.527629585530963,2,1,1,3,2,5,5,4,5,3,5,4,2,3,4,2,5,4,2,5,1.8,0,4.6,0,2.8,0,4.2,0,3.8666666666666667,0,1,1,3,4,3,2,2,4,2,2,1,2,3,2,1,2,1,2,1,3,2.1,0,"White, Caucasian, Anglo, European American",0,22,0,1,NA,5,2,1,0,1,0,1,TRUE,TRUE,TRUE,TRUE,TRUE,3,0.616516129032258,0.58021875,0.63990625,0.71071875,0.6875333333333333,0.7731333333333333,0.96875,1,1,1,0.9375,0.9375,0.089,0.455,0.508,0.014,2.087,57.140195961208434,1902.9777097581775,0.074,0.432,0.547,0.012,1.802,109.57051751257048,1956.9836591032783,0.15,0.407,0.714,0.013,1.419,145.93096071661304,1971.3375329447483,149.07142857142858,150.16666666666666,109.15384615384616,FALSE,345,1.0222222222222224,0,1,0,3,6,FALSE
243,2022-03-18T18:28:26Z,0.8999999761581421,1.7777777777777777,720,3,4,3,2,4,3,3,3,4,4,3,3,2,3,4,2,2,2,3,1,1,1,1,1,1,0,2,0,0,0,0,2,3,2,2,2,1,3,2,2,2,2,2,3,3,3,4,4,3,2,4,4,2,1,1,1,3,1,1,1,1,1,2,1,1,1,1,1,2,2,2,1,1.75,0,3,0,2.111111111111111,0,3,0,1.5,0,1.1428571428571428,0,1,0,2.027027027027027,0,0,0,0,-0.5264572692964425,-0.10242478430832193,-0.3605105619019602,-0.23146767310514105,3,4,3,3,4,3,4,1,0.45196931754422376,3,4,4,4,3,3,4,3.5714285714285716,0,1.475286511749183,0,0.9669815479429806,3,2,2,2,2,3,2,2,3,3,3,4,3,2,3,3,4,3,4,2,2.2,0,3.4,0,3,0,2.4,0,2.933333333333333,0,3,2,2,2,2,3,3,4,1,1,3,3,2,2,2,3,1,2,1,1,2.15,0,"Asian or Asian American (e.g., Chinese, Japanese, and others)",0,22,0,1,NA,5,2,0,0,1,0,0,TRUE,TRUE,TRUE,TRUE,TRUE,3,1.0674250000072643,0.5069032258054903,0.613674999997951,1.3250137931087922,0.5942333333273728,0.7985346153859909,1,1,1,0.90625,0.9375,0.8387096774193549,0.069,0.357,0.315,0.007,1.59,269.786223581951,2182.8080428453422,0.071,0.33,0.476,0.01,1.579,66.46799251377148,1910.028490232864,0.122,0.247,0.121,0.007,1.353,120.18724075057008,2004.5133610326168,227.14285714285714,157.9,193.28571428571428,FALSE,356,1.0548148148148149,0,1,0,0,3,FALSE
244,2022-03-18T18:14:32Z,0.8999999761581421,1.7777777777777777,864,6,3,3,2,2,2,1,1,3,2,2,1,2,3,4,3,2,2,4,1,1,2,3,2,2,3,2,0,0,0,0,1,2,1,1,2,2,3,3,2,2,2,1,1,2,2,1,2,2,1,1,3,3,1,1,1,2,2,1,3,3,2,1,1,2,1,1,1,1,2,2,2,1.75,0,2.2,0,1.8888888888888888,0,1.6666666666666667,0,1.6666666666666667,0,1.8571428571428572,0,1,0,1.7027027027027026,0,2,0,0,-0.25011287819435013,-0.2658549674468904,0.07821504497010326,-0.09381996123839358,1,1,1,1,1,1,1,2,-0.571114413698515,4,4,4,5,2,3,5,3.857142857142857,0,0.9905165020526746,0,0.8265185681390751,2,3,2,4,2,4,4,4,4,3,4,3,3,4,4,3,3,5,4,2,2.6,0,3.8,0,3.4,0,3.6,0,3.6,0,2,2,1,2,2,2,3,2,1,1,3,2,2,2,1,3,1,2,2,3,1.95,0,"White, Caucasian, Anglo, European American",0,29,1,2,NA,5,2,0,0,0,0,0,TRUE,TRUE,TRUE,TRUE,TRUE,5,0.515356249997858,0.4846500000008382,0.4533124999995343,0.593939285716308,0.5885161290312967,0.5949333333328918,1,1,1,0.9032258064516129,0.96875,0.8709677419354839,0.065,0.335,0.606,0.009,1.58,176.15386912524278,2041.8275466590912,0.066,0.348,0.536,0.011,1.412,149.0797995962609,1978.990700093757,0.064,0.356,0.462,0.018,2.004,165.1911995495747,2021.9968452784285,175.55555555555557,128.36363636363637,111.33333333333334,FALSE,430,1.2740740740740741,0,1,1,15,18,FALSE
245,2022-03-18T18:10:42Z,1,1.6,900,3,2,2,2,2,3,1,2,2,2,1,2,1,2,2,1,1,3,2,1,1,2,1,2,1,4,1,2,0,2,0,1,1,1,1,2,1,1,1,1,2,2,1,2,1,2,1,3,3,2,2,3,1,1,1,1,3,2,1,3,3,2,1,1,2,1,1,1,2,2,2,2,2,0,1.7333333333333334,0,1.1111111111111112,0,2,0,1.5,0,1.8571428571428572,0,1,0,1.5945945945945945,0,2,0,0,-0.644890579768768,-0.7351021599482448,0.16436794915095845,-0.2853671053986432,1,2,3,1,1,1,1,1.5,-0.5157127766089035,4,3,4,3,2,2,4,3.142857142857143,0,-0.7825102850053112,1,-0.640426834580144,3,3,4,2,3,3,4,4,4,3,5,3,1,5,4,4,2,5,3,1,3,0,3.6,0,3,0,3.6,0,3.4,0,1,2,1,2,2,2,2,1,1,1,2,2,2,1,4,1,2,1,1,1,1.6,0,"Hispanic of Latino (e.g., Mexican American, Central American, and others)",0,19,1,2,NA,5,2,0,1,1,0,1,TRUE,TRUE,TRUE,TRUE,TRUE,5,0.6652187499999991,0.5874193548387097,0.6415483870967742,0.7904516129032183,0.6513124999999891,0.7675333333333392,1,1,0.96875,0.96875,1,0.967741935483871,0.081,0.407,0.322,0.011,1.454,88.15392104344163,1952.910278432996,0.081,0.4,0.412,0.077,1.832,115.14133076679882,1900.1053865376011,0.179,0.266,0.436,0.007,1.135,159.09501028620525,1980.3638794979852,132.1818181818182,23.792207792207794,162.14285714285714,FALSE,436,1.2918518518518518,0,1,0,0,3,FALSE
246,2022-03-18T18:23:58Z,0.8999999761581421,1.6,900,4,3,4,2,3,3,4,3,3,4,2,3,4,4,1,4,3,1,3,1,1,1,2,3,2,0,2,0,0,0,0,2,2,1,2,1,1,3,4,3,1,1,3,1,3,3,1,2,2,3,5,5,2,1,1,1,1,1,1,1,2,1,3,3,2,1,1,2,2,1,1,1,1.25,0,3.1333333333333333,0,2.111111111111111,0,2.5,0,1.1666666666666667,0,1.8571428571428572,0,1.3333333333333333,0,1.972972972972973,0,0,0,0,-0.3181023712432777,0.09591377128162597,-0.5328163702636706,-0.2184512994910223,3,3,2,2,3,4,2,2,0.42410063037077533,5,4,4,3,1,1,2,2.857142857142857,0,-0.665444751374891,0,-0.7239287959128027,4,4,4,5,3,3,5,3,3,2,4,3,1,3,3,5,4,3,4,4,4,0,3.4,0,3.4,0,3.2,0,3.3333333333333335,0,1,2,1,2,2,2,2,2,1,2,2,3,3,3,2,3,3,3,1,2,2.1,0,"White, Caucasian, Anglo, European American",0,21,1,2,NA,5,2,0,0,0,0,0,TRUE,TRUE,TRUE,TRUE,TRUE,4,0.5932903225806508,0.47329032258064563,0.49840625000000366,0.6683124999999909,0.5016874999999995,0.5882000000000001,0.96875,1,1,1,1,0.9375,0.06,0.405,0.682,0.012,1.456,43.51346076747828,1887.9350317227295,0.201,0.187,0.712,0.027,1.311,88.60301430449331,1872.509433568022,0.084,0.38,0.394,0.016,1.557,114.06160005557612,1950.9644797210249,121.33333333333333,48.55555555555556,97.3125,TRUE,426,1.2622222222222224,0,1,0,0,3,FALSE
247,2022-03-18T18:17:01Z,0.8999999761581421,1.7777777777777777,864,3,2,2,2,1,3,2,1,3,1,2,1,1,2,2,3,4,2,2,1,1,1,1,1,1,2,2,0,0,0,0,2,3,2,1,1,1,2,2,1,1,1,1,1,2,2,1,2,1,1,1,1,1,1,1,1,2,1,1,2,2,1,2,2,1,1,2,1,2,1,2,2,1.75,0,2,0,1.6666666666666667,0,1.25,0,1.1666666666666667,0,1.5714285714285714,0,1.3333333333333333,0,1.4054054054054055,0,1,0,0,-1.0111565584517004,-0.8650006388447846,-0.14114775846592847,-0.5030741986553565,3,2,4,1,1,1,1,1,-0.4603111395192921,3,3,3,3,1,1,3,2.4285714285714284,0,-1.0930953560345533,0,-1.216614321186411,2,1,3,1,2,4,1,4,5,1,2,3,5,4,5,1,3,3,1,1,1.8,0,3,0,1.8,0,3.8,0,2.8666666666666667,0,1,1,1,1,1,1,2,1,1,1,1,1,1,1,1,1,1,1,1,1,1.05,0,"White, Caucasian, Anglo, European American",0,29,0,1,NA,5,2,0,0,1,0,0,TRUE,TRUE,TRUE,TRUE,TRUE,1,0.6003187499996274,0.4828000000016764,0.5317999999998138,0.6314999999980773,0.5562066666657726,0.5707032258073168,1,1,1,1,0.9375,0.96875,0.069,0.382,0.543,0.025,2.041,92.79307962784031,1918.6889382367092,0.054,0.392,0.624,0.015,1.526,38.120956368300966,1882.245062486057,0.085,0.474,0.709,0.027,1.407,24.576191908489907,1806.5279826602705,81.63999999999999,101.73333333333333,52.111111111111114,FALSE,346,1.0251851851851852,0,1,0,0,3,FALSE
248,2022-03-18T18:20:39Z,0.8999999761581421,1.7777777777777777,1080,4,3,2,1,1,1,2,1,1,1,1,1,1,2,2,1,2,1,1,1,1,1,1,1,2,0,2,0,0,0,0,2,1,1,1,1,1,1,1,1,1,1,1,1,2,1,1,2,1,1,1,1,1,1,1,1,2,1,1,2,1,1,1,1,1,1,1,1,1,1,2,2,1.5,0,1.3333333333333333,0,1.1111111111111112,0,1.1666666666666667,0,1.1666666666666667,0,1.1428571428571428,0,1,0,1.135135135135135,0,0,0,0,-1.267762064475072,-1.3286428250652134,-0.4466634660828154,-0.8876531455740144,2,3,4,2,1,2,3,1.5,0.06482933243151565,4,5,5,5,3,3,4,4.142857142857143,0,-0.3222341343576166,0,0.18174126965160067,1,2,3,3,2,4,5,4,5,3,5,4,4,4,5,4,4,4,5,2,2.2,0,4.2,0,4.2,0,4,0,4.133333333333334,0,1,1,1,3,2,1,2,1,1,2,2,1,2,1,1,2,1,1,1,2,1.45,0,"White, Caucasian, Anglo, European American",0,29,0,1,NA,5,2,0,0,2,0,0,TRUE,TRUE,TRUE,TRUE,TRUE,6,0.503625,0.4788125,0.54259375,0.6315,0.5966,0.67425,1,1,1,1,0.9375,1,0.112,0.314,0.475,0.014,1.596,65.99300295074127,1851.352969802885,0.063,0.357,0.482,0.014,1.613,69.23602283532492,1916.5842004548756,0.088,0.339,0.496,0.016,1.755,58.98477718135189,1839.927299588624,114,115.21428571428571,109.68749999999999,FALSE,400,1.1851851851851851,0,1,0,6,9,FALSE
249,2022-03-18T18:29:03Z,0.8999999761581421,2.388888888888889,1440,3,1,2,1,1,2,1,3,2,2,1,1,1,3,1,3,3,1,2,1,1,1,1,2,1,0,2,0,0,0,0,1,2,1,2,5,2,3,1,2,1,1,1,1,3,1,1,3,2,1,2,2,1,1,1,1,1,1,1,1,1,1,1,2,1,4,4,1,2,2,1,1,1.5,0,1.8,0,2.111111111111111,0,1.5833333333333333,0,1,0,1.1428571428571428,0,3,0,1.6486486486486487,0,0,0,0,-0.853245477821933,-0.8461206176879824,-0.4466634660828154,-0.6463920418853989,5,5,5,4,5,5,4,2.5,1.7785869723793248,3,4,2,4,2,2,2,2.7142857142857144,0,-1.4363059730518277,0,-1.2708549591033658,3,2,2,2,3,3,2,2,4,3,2,4,4,2,4,3,4,3,2,2,2.4,0,3.2,0,2.8,0,2.8,0,2.933333333333333,0,3,2,3,1,2,4,3,1,3,2,2,2,2,4,2,3,2,2,3,2,2.4,0,"White, Caucasian, Anglo, European American",0,20,0,1,NA,5,2,0,0,1,0,0,TRUE,TRUE,TRUE,TRUE,TRUE,2,0.57803125,0.49059375,0.507625,0.65,0.5418275862068965,0.584,1,1,1,1,0.90625,1,0.194,0.256,0.78,0.032,2.11,61.17005197578892,1849.145817948374,0.055,0.363,0.497,0.014,1.489,93.767259772034,1946.201980797384,0.119,0.303,0.421,0.016,1.325,71.68743338770065,1855.6714604008012,65.9375,106.35714285714286,82.8125,FALSE,448,1.3274074074074074,0,1,0,0,3,FALSE
251,2022-03-18T18:16:20Z,0.8999999761581421,1.6,900,3,2,1,1,1,1,2,1,1,1,1,1,1,2,1,1,3,3,1,1,1,1,1,1,1,0,1,1,0,0,0,2,2,4,2,5,2,5,4,2,3,2,1,1,3,2,2,3,1,1,1,1,1,1,1,1,1,1,1,1,1,1,2,2,2,1,1,1,1,1,1,1,1,0,1.2666666666666666,0,3.111111111111111,0,1.75,0,1,0,1.4285714285714286,0,1,0,1.837837837837838,0,0,0,0,-0.7304257484432254,-0.9963741193941997,-0.6189692744445258,-0.8076716969193627,1,1,2,1,1,1,1,1,-0.874984074548163,5,5,5,5,3,2,5,4.285714285714286,0,-1.0267043611971274,0,-0.16994148418532656,4,2,4,5,4,2,4,3,3,3,5,3,3,4,4,1,5,5,3,2,3.8,0,4,0,2.8,0,3.2,0,3.3333333333333335,0,1,1,1,2,3,2,3,4,2,1,1,3,1,1,1,3,2,2,1,3,1.9,0,"Hispanic of Latino (e.g., Mexican American, Central American, and others)",0,19,1,2,NA,5,2,0,0,0,0,0,TRUE,TRUE,TRUE,TRUE,TRUE,4,1.1090354838710157,0.8791718750000582,1.0813781250001049,1.2043999999998318,0.8841387096776236,1.2771193548385655,0.96875,1,1,1,1,0.96875,0.096,0.737,0.228,0.017,1.463,119.59619564778473,1946.339648903331,0.183,0.237,0.301,0.034,1.679,41.78473216250459,1823.9099103456176,0.129,0.515,0.213,0.109,1.379,127.82037881845174,1959.0705054518824,86.05882352941177,49.38235294117647,12.65137614678899,TRUE,304,0.9007407407407407,1,1,0,0,3,FALSE
252,2022-03-18T18:27:24Z,0.8999999761581421,1.6,900,7,3,4,3,4,3,3,3,4,3,3,3,4,4,3,4,3,2,4,1,1,2,3,3,4,0,2,0,0,0,0,2,3,3,3,3,1,3,3,3,1,2,3,1,4,2,3,5,5,5,5,5,5,1,1,1,1,2,1,1,1,1,3,3,3,2,3,1,2,2,1,1,1.5,0,3.4,0,2.6666666666666665,0,3.4166666666666665,0,1.8333333333333333,0,1.8571428571428572,0,2,0,2.5675675675675675,0,0,0,0,0.5547949911268244,0.7993912262595569,-0.4466634660828154,0.17636388008837078,2,2,3,1,1,2,2,2,-0.07350689166386981,3,4,3,4,2,2,3,3,0,0.072220972883332707,0,-0.19722166215838044,2,2,3,2,2,4,2,3,4,2,5,4,4,4,4,3,3,4,3,2,2.2,0,4,0,2.8,0,3.4,0,3.4,0,2,2,2,3,3,3,3,3,3,3,3,2,1,1,1,2,1,2,1,3,2.2,0,"White, Caucasian, Anglo, European American",0,23,1,4,genderqueer,5,2,0,0,1,0,0,TRUE,TRUE,TRUE,TRUE,TRUE,3,0.5818375000013039,0.4986906249998137,0.5461499999985099,0.6666781250005588,0.5471312500042841,0.5956156249977649,1,1,1,1,1,1,0.09,0.372,0.528,0.034,1.949,79.18523474822753,1865.763704697276,0.175,0.253,0.726,0.015,1.22,34.853754640686816,1817.0821127975837,0.134,0.332,0.542,0.014,1.471,84.04498860453327,1867.354674472002,57.3235294117647,81.33333333333333,105.07142857142857,FALSE,434,1.285925925925926,0,1,0,0,3,FALSE
253,2022-03-18T18:32:02Z,0.8999999761581421,1.7777777777777777,1080,6,2,1,1,1,1,1,1,1,1,1,1,1,1,1,1,3,1,1,1,1,1,1,1,1,2,2,0,0,0,0,3,4,2,4,5,2,4,2,3,1,2,1,1,3,1,2,1,1,1,1,1,1,1,1,1,3,2,1,2,1,1,1,1,1,1,1,1,1,1,2,2,1.5,0,1.1333333333333333,0,3.2222222222222223,0,1.3333333333333333,0,1.5,0,1.1428571428571428,0,1,0,1.7567567567567568,0,1,0,0,-0.9453602748559637,-1.1991376799427733,-0.22730066264678367,-0.7132191712947785,1,1,2,1,1,1,1,2.5,-0.2947777027650296,5,5,5,5,4,3,5,4.571428571428571,0,1.0808314045082337,0,1.2685418045122843,2,1,2,3,3,5,3,3,5,4,4,3,4,4,2,4,4,4,3,4,2.2,0,4,0,3.6,0,3.6,0,3.7333333333333334,0,2,2,3,3,3,3,3,4,2,1,3,3,2,3,2,3,1,3,3,3,2.6,0,"White, Caucasian, Anglo, European American",0,26,0,1,NA,5,2,0,0,1,0,0,TRUE,TRUE,TRUE,TRUE,TRUE,3,0.53758064516105,0.5186000000002096,0.501203125,0.5991566666665797,0.5650838709678501,0.5679129032257103,0.96875,1,1,0.9375,0.96875,0.96875,0.065,0.366,0.5,0.015,1.396,151.25202922299567,1979.4092702935277,0.071,0.338,0.405,0.03,1.965,97.61230967307804,1927.4860195663723,0.054,0.411,0.414,0.016,1.555,81.26459234777577,1968.2781767934073,93.06666666666666,65.5,97.1875,FALSE,346,1.0251851851851852,0,1,0,0,3,FALSE
254,2022-03-18T18:35:43Z,0.8999999761581421,1.778125,960,6,3,2,1,1,1,1,1,1,1,1,1,1,1,1,1,1,1,1,1,1,1,1,1,1,0,2,0,0,0,0,1,1,1,1,1,1,1,1,1,1,1,1,1,1,1,1,1,1,1,1,1,1,1,1,1,1,1,1,1,1,1,1,1,1,1,1,1,1,1,1,1,1,0,1.0666666666666667,0,1,0,1,0,1,0,1,0,1,0,1,0,0,0,0,-1.4366391923707953,-1.5586447494702147,-0.6189692744445258,-1.0888070119573703,1,1,2,1,1,1,1,1,-0.874984074548163,5,5,5,5,3,2,5,4.285714285714286,0,-0.3222341343576166,0,0.25914394489227754,1,1,1,1,1,5,5,5,5,5,5,5,5,5,5,5,5,5,5,5,1,0,5,0,5,0,5,0,5,0,1,1,1,1,1,1,1,1,1,1,1,1,1,1,1,1,1,1,1,1,1,0,"Hispanic of Latino (e.g., Mexican American, Central American, and others)",0,26,0,3,NA,5,2,0,0,1,0,0,TRUE,TRUE,TRUE,TRUE,TRUE,3,0.45190625,0.37374999999999997,0.42546875,0.5147419354838709,0.4318214285714286,0.4973666666666667,1,1,1,0.96875,0.9032258064516129,0.9375,0.06,0.342,0.764,0.021,1.738,19.1509580514795,1864.619816865034,0.062,0.293,0.837,0.023,1.767,152.60920027448606,2019.8120560552895,0.061,0.33,0.558,0.018,1.68,100.8281667233606,1928.3711215196552,82.76190476190476,76.82608695652173,93.33333333333334,FALSE,247,0.7318518518518519,0,1,0,3,6,FALSE
255,2022-03-18T18:27:20Z,0.8999999761581421,1.7777777777777777,864,5,3,2,2,2,3,2,2,2,2,2,1,1,2,2,2,3,2,2,1,2,2,2,2,2,1,2,0,0,0,0,1,3,3,2,2,3,3,3,3,2,3,2,1,3,3,3,3,2,3,3,4,3,3,1,2,3,1,2,3,3,1,2,2,2,1,1,1,2,2,2,2,2,0,2,0,2.5555555555555554,0,2.6666666666666665,0,2.1666666666666665,0,2.142857142857143,0,1,0,2.324324324324324,0,1,0,0,-0.008859838343316686,-0.19092488348083209,-0.05499485428507328,-0.12295986888295268,2,1,3,1,1,2,1,1,-0.6261803135308405,5,5,5,4,3,3,4,4.142857142857143,0,-0.018093929572226358,0,0.366989879597213,3,2,2,3,2,4,3,3,4,2,4,3,3,3,3,2,3,4,2,4,2.4,0,3.6,0,2.4,0,3.4,0,3.1333333333333333,0,1,1,1,2,2,1,2,3,2,1,1,2,2,1,2,3,1,1,1,2,1.6,0,"White, Caucasian, Anglo, European American",0,22,1,2,NA,5,2,0,0,1,0,0,TRUE,TRUE,TRUE,TRUE,TRUE,2,0.457453125,0.4252612903204656,0.42237812499981375,0.5227935483897886,0.47961290322484507,0.5167310344813199,1,0.96875,1,1,0.96875,0.9354838709677419,0.072,0.302,0.622,0.017,1.892,56.93875867264653,1901.7345386193956,0.05,0.318,0.473,0.017,1.437,120.80138495045776,1987.1052907961505,0.091,0.331,0.768,0.014,1.337,70.20949970670648,1852.3426104401808,111.29411764705881,84.52941176470588,95.5,FALSE,382,1.1318518518518519,0,1,0,0,3,FALSE
256,2022-03-18T18:32:07Z,0.800000011920929,1.7777777777777777,864,6,4,2,1,1,1,1,1,1,1,1,1,1,2,2,1,2,1,2,1,1,1,1,2,1,0,2,0,0,0,0,1,1,1,1,1,1,1,1,1,1,1,1,1,2,1,1,1,1,1,1,1,1,1,1,1,1,1,1,1,1,1,1,1,1,1,1,1,1,1,1,1,1,0,1.2666666666666666,0,1,0,1.0833333333333333,0,1,0,1,0,1,0,1.027027027027027,0,0,0,0,-1.2567960172091157,-1.3503745160842406,-0.6189692744445258,-0.9846718952643831,1,1,2,1,1,2,1,1,-0.7920494875423887,5,5,5,5,4,4,5,4.714285714285714,0,1.384971609293624,0,1.531193089698574,2,2,2,1,2,5,3,4,5,3,5,4,5,4,3,5,5,5,3,4,1.8,0,4.8,0,3.8,0,4,0,4.2,0,1,1,1,1,1,1,1,1,1,1,1,1,1,1,1,1,1,1,1,1,1,0,"White, Caucasian, Anglo, European American",0,30,0,1,NA,5,2,0,0,1,0,0,TRUE,TRUE,TRUE,TRUE,TRUE,6,0.4698419354884855,0.4259249999932945,0.44881874998658894,0.5426806451582139,0.49210333331823347,0.5389133333206176,0.96875,1,1,0.96875,0.9375,0.9375,0.064,0.363,0.743,0.015,1.634,23.850062402305547,1868.542256624449,0.055,0.348,0.702,0.028,1.989,62.153312908853295,1906.441768692442,0.053,0.362,0.478,0.014,1.418,152.08341141595335,2020.0287573437008,108.93333333333334,71.03571428571429,101.28571428571428,FALSE,388,1.1496296296296296,0,1,0,0,3,FALSE
257,2022-03-18T17:29:23Z,0.8999999761581421,1.7777777777777777,1080,6,3,1,2,2,1,2,2,1,2,1,1,2,2,1,2,2,1,1,1,1,1,1,1,1,0,2,0,0,0,0,2,3,3,2,1,1,2,1,1,3,1,1,1,2,2,1,3,1,1,1,1,1,1,1,1,3,1,1,1,1,1,2,2,2,1,1,1,2,1,1,2,1.5,0,1.6,0,1.7777777777777777,0,1.5,0,1.3333333333333333,0,1.4285714285714286,0,1,0,1.4864864864864864,0,0,0,0,-1.1208170311112609,-1.1133909171889633,-0.4466634660828154,-0.7800271916358894,1,1,2,1,1,2,1,1,-0.7920494875423887,5,5,5,5,4,4,5,4.714285714285714,0,1.384971609293624,0,1.531193089698574,2,2,2,2,2,5,5,4,5,3,4,2,4,4,4,4,5,4,4,3,2,0,4,0,4,0,4,0,4,0,1,1,1,1,1,1,1,1,1,2,2,2,1,1,1,1,1,1,1,1,1.15,0,"White, Caucasian, Anglo, European American",0,21,1,2,NA,5,2,0,0,0,0,0,TRUE,TRUE,TRUE,TRUE,TRUE,6,0.5659531249995343,0.5213032258064035,0.5163096774201239,0.5976531249997206,0.5639000000001922,0.583153333333383,1,1,0.96875,1,0.96875,0.967741935483871,0.058,0.382,0.414,0.027,2.029,151.11330628145296,2022.0195131092803,0.065,0.373,0.439,0.03,1.771,36.9249007622703,1861.736080195414,0.071,0.402,0.437,0.038,1.679,82.60307353088476,1863.00141669608,75.14814814814815,59.03333333333333,44.184210526315795,FALSE,447,1.3244444444444445,0,1,0,0,3,FALSE
258,2022-03-18T18:02:02Z,0.800000011920929,1.7777777777777777,1080,6,3,2,2,1,1,1,1,1,1,1,1,2,2,2,1,2,2,2,1,1,1,1,2,1,1,2,0,0,0,0,1,1,1,1,2,1,1,1,1,2,1,2,2,1,2,2,1,1,3,2,3,1,5,1,1,2,1,2,2,2,2,1,2,2,1,1,1,4,2,2,2,2.5,0,1.4,0,1.1111111111111112,0,1.8333333333333333,0,1.8333333333333333,0,1.8571428571428572,0,1,0,1.5945945945945945,0,1,0,0,-0.8071880793049175,-0.9897857786780242,0.11731095407663712,-0.4362374123006935,1,1,3,1,2,1,3,1.5,-0.3498436025973552,5,5,5,4,4,4,4,4.428571428571429,0,1.0808314045082337,0,1.1911391292716074,1,1,2,2,2,5,5,5,4,5,5,5,5,4,5,4,5,5,4,4,1.6,0,5,0,4.6,0,4.4,0,4.666666666666667,0,1,1,1,1,1,1,2,2,1,1,2,1,1,1,1,2,1,1,2,2,1.3,0,"White, Caucasian, Anglo, European American",0,26,0,1,NA,5,2,0,0,1,0,0,TRUE,TRUE,TRUE,TRUE,TRUE,5,0.5127374999932944,0.5088843750003725,0.5422437500059605,0.5994433333257834,0.5622096774155094,0.567153124999255,1,1,1,0.9375,1,1,0.176,0.3,0.735,0.037,1.52,156.85994518982042,1942.374503746549,0.133,0.321,0.724,0.025,1.613,55.40915582662867,1842.9935337362824,0.068,0.364,0.497,0.012,1.502,119.64548084383996,1989.1855962579864,41.08108108108108,64.52,125.16666666666666,FALSE,436,1.2918518518518518,0,1,0,0,3,FALSE
259,2022-03-18T18:07:18Z,0.8999999761581421,1.6,900,6,3,2,1,1,1,1,1,1,1,3,1,1,2,1,2,1,1,1,1,1,1,2,2,3,0,2,0,0,0,0,1,1,1,1,1,1,1,1,1,1,1,1,1,1,3,3,1,1,1,1,1,1,1,1,1,2,1,1,1,1,1,1,1,1,1,1,1,1,1,1,1,1,0,1.3333333333333333,0,1,0,1.3333333333333333,0,1.1666666666666667,0,1,0,1,0,1.135135135135135,0,0,0,0,-1.0243158151708476,-1.1649176415960694,-0.6189692744445258,-0.8919434580202976,1,1,3,1,1,1,1,1,-0.7920494875423887,5,5,5,5,1,1,5,3.857142857142857,0,0.13872270157061628,1,0.3076998949849121,1,1,1,3,1,5,5,5,5,2,5,5,2,4,5,5,5,5,5,3,1.4,0,5,0,3.8,0,4.4,0,4.4,0,1,1,1,1,2,1,1,1,1,1,1,1,1,2,1,1,1,1,1,1,1.1,0,"White, Caucasian, Anglo, European American",0,23,1,2,NA,5,2,0,0,1,0,0,TRUE,TRUE,TRUE,TRUE,TRUE,4,0.5988225806466033,0.4737709677406857,0.5466451612912839,0.6547032258063554,0.5434785714282521,0.6354419354839671,0.96875,0.96875,1,0.96875,0.875,0.96875,0.075,0.379,0.477,0.02,2.076,274.47748086275044,2098.6626527218673,0.054,0.357,0.456,0.02,1.956,188.775004140434,2098.3325958696714,0.061,0.401,0.375,0.022,1.995,176.10393730302715,2050.1984305339333,103.8,97.8,90.68181818181819,FALSE,434,1.285925925925926,0,1,0,0,3,FALSE
260,2022-03-18T18:30:48Z,0.8999999761581421,1.7777777777777777,864,7,3,4,2,2,2,2,2,4,3,2,1,2,4,1,3,4,2,2,1,1,1,1,2,2,2,2,0,0,0,0,2,3,4,3,4,1,2,2,2,1,3,1,2,2,4,3,2,2,3,1,2,1,1,1,1,3,1,1,2,2,1,2,1,2,1,1,1,1,1,1,2,1.25,0,2.533333333333333,0,2.5555555555555554,0,2.1666666666666665,0,1.3333333333333333,0,1.5714285714285714,0,1,0,1.9189189189189189,0,1,0,0,-0.5154912220304866,-0.2987966710277694,-0.31345356682763886,-0.3061251189277041,1,1,1,1,1,2,2,1,-0.7920494875423887,4,4,4,5,3,3,5,4,0,1.384971609293624,0,1.1441797134951883,2,2,3,1,2,4,2,3,3,2,5,5,4,3,3,3,5,4,3,2,2,0,4.6,0,2.8,0,2.8,0,3.4,0,1,1,1,1,3,1,1,3,1,1,3,1,1,1,1,1,1,1,1,2,1.35,0,Middle Eastern,0,28,0,1,NA,5,2,1,0,0,0,1,TRUE,TRUE,TRUE,TRUE,TRUE,2,0.5312033333381017,0.48760625000484287,0.55009375,0.5804249999932944,0.5760656250007451,0.5935031249970197,1,1,1,1,1,1,0.092,0.361,0.536,0.026,1.869,149.1107159559569,1935.1389769317432,0.134,0.282,0.643,0.009,1.057,97.55681711839686,1883.9913510847584,0.145,0.337,0.766,0.027,1.671,63.28509710668092,1845.0413812643471,71.88461538461539,117.44444444444444,61.88888888888889,FALSE,346,1.0251851851851852,0,1,1,12,15,FALSE
261,2022-03-18T18:33:47Z,0.8999999761581421,1.7777777777777777,864,4,3,3,1,2,2,5,2,2,2,2,2,2,2,2,2,1,2,4,5,1,1,2,2,1,1,2,0,0,0,0,1,1,1,1,2,1,1,1,1,4,1,1,1,2,1,1,4,4,5,5,5,3,1,5,3,1,1,1,2,3,1,1,2,2,1,1,1,2,3,2,2,2.25,0,2.1333333333333333,0,1.1111111111111112,0,2.8333333333333335,0,2.3333333333333335,0,1.7142857142857142,0,1,0,1.972972972972973,0,1,0,0,0.006492627829021527,-0.122386473343899,0.031158049895781924,-0.04561421172405854,2,3,3,1,1,4,2,1,-0.21150737850196963,4,5,5,4,2,2,4,3.7142857142857144,0,-0.13222200579606097,1,0.06526763923476366,3,3,3,3,3,3,5,5,4,3,3,4,3,3,4,3,4,3,2,3,3,0,3.4,0,3.2,0,3.8,0,3.466666666666667,0,3,2,3,3,3,3,2,2,2,1,3,3,2,3,1,2,2,3,3,2,2.4,0,"White, Caucasian, Anglo, European American",0,30,1,2,NA,5,2,0,0,0,0,0,TRUE,TRUE,TRUE,TRUE,TRUE,6,0.7283874999880791,0.5631437500044704,0.6148062500208616,0.8664774193609914,0.7056466666777929,0.7949499999920527,1,1,1,1,1,0.967741935483871,0.065,0.46,0.426,0.005,1.253,88.38439596718493,1912.6726211477664,0.084,0.378,0.423,0.024,1.89,117.61293898838592,1898.5297222710835,0.144,0.285,0.329,0.007,1.352,54.40316098968526,1836.8522461546777,250.59999999999997,78.75,193.14285714285714,FALSE,350,1.0370370370370372,0,1,0,0,3,FALSE
262,2022-03-18T18:36:17Z,0.8999999761581421,1.7777777777777777,1080,6,1,1,1,1,1,2,1,1,1,2,1,1,2,1,1,1,1,2,1,1,1,1,1,1,1,2,0,0,0,0,1,1,1,1,3,1,1,1,1,1,1,1,1,3,2,1,3,1,1,2,1,2,1,1,1,1,1,1,2,2,1,1,1,1,1,1,1,1,1,2,2,1.5,0,1.2,0,1.2222222222222223,0,1.5,0,1.1666666666666667,0,1.2857142857142858,0,1,0,1.2972972972972974,0,1,0,0,-1.1624880107218938,-1.3160561442940117,-0.22730066264678367,-0.7716784034703977,1,1,3,1,1,1,1,1,-0.7920494875423887,5,5,5,5,3,2,5,4.285714285714286,0,0.43348058270556905,0,0.7194418556870088,1,1,2,2,2,5,4,4,5,4,5,5,5,3,4,4,5,5,3,4,1.6,0,5,0,4,0,4,0,4.333333333333333,0,2,1,4,4,4,4,4,3,4,1,2,3,3,4,1,3,1,4,1,4,2.85,0,"Asian or Asian American (e.g., Chinese, Japanese, and others)",0,26,0,1,NA,5,2,0,0,1,0,0,TRUE,TRUE,TRUE,TRUE,TRUE,4,0.553199999999255,0.45119374999403955,0.47482187499850986,0.6312749999836087,0.49880000001384367,0.5380718750022352,1,1,1,1,1,1,0.145,0.293,0.807,0.024,1.709,39.068917379222256,1823.122294456797,0.091,0.323,0.706,0.01,0.93,73.74449033386632,1854.0155503749704,0.091,0.389,0.528,0.022,1.714,112.96387053728094,1901.6733846481195,71.20833333333333,93,77.9090909090909,FALSE,298,0.882962962962963,0,1,0,3,6,FALSE
263,2022-03-18T18:42:55Z,1,1.7777777777777777,720,6,4,1,1,2,1,1,1,5,1,1,1,1,1,1,5,2,1,1,1,1,1,1,1,1,0,2,0,0,0,0,1,1,1,1,1,1,1,1,1,1,1,1,1,2,1,1,1,1,1,1,1,1,1,1,1,1,1,1,1,1,1,1,1,1,1,1,1,1,1,1,1,1,0,1.6666666666666667,0,1,0,1.0833333333333333,0,1,0,1,0,1,0,1.027027027027027,0,0,0,0,-1.4190935167452654,-1.284884442696583,-0.6189692744445258,-0.9519268585705545,1,1,1,1,1,2,1,1,-0.874984074548163,5,5,5,5,5,5,5,5,0,1.2043418043825058,0,1.5759787198402806,1,1,1,1,1,5,3,5,5,1,5,5,5,4,3,5,5,5,4,5,1,0,5,0,3.6,0,4.4,0,4.333333333333333,0,1,1,1,1,1,1,1,1,1,1,1,1,1,1,1,1,1,1,1,1,1,0,"White, Caucasian, Anglo, European American",0,25,1,2,NA,5,2,0,0,1,0,0,TRUE,TRUE,TRUE,TRUE,TRUE,6,0.4855806451535994,0.5540187499895692,0.5204354838594314,0.5339607142891203,0.5736896551724138,0.5948862069146387,1,1,1,0.9032258064516129,0.9354838709677419,0.90625,0.07,0.33,0.386,0.014,1.682,56.50348745497716,1939.9748232495683,0.067,0.309,0.317,0.026,1.969,217.5428823132222,2066.357746039568,0.058,0.337,0.43,0.022,1.921,56.16972224535566,1911.0676713408811,120.14285714285714,75.73076923076924,87.31818181818183,FALSE,304,0.9007407407407407,1,1,0,0,3,FALSE
264,2022-03-18T17:55:56Z,0.8999999761581421,1.7786458333333333,768,4,3,2,2,3,3,4,2,3,2,2,2,3,2,2,3,3,2,2,2,2,1,2,3,2,5,1,1,0,3,0,2,1,3,2,2,1,2,2,2,2,2,1,1,2,3,2,3,1,1,2,3,2,1,3,1,4,4,3,4,4,5,2,2,2,1,1,1,3,4,4,5,4,0,2.533333333333333,0,1.8888888888888888,0,1.9166666666666667,0,2.5,0,3.142857142857143,0,1,0,2.1621621621621623,0,3,0,0,-0.032985142328420085,0.02570369260476816,1.0729539860338317,0.5493288393193,2,1,3,1,1,1,1,4.5,0.6446999669573633,5,5,4,4,3,2,3,3.7142857142857144,0,-0.15675083406024948,0,0.05032738711406198,2,3,3,3,3,3,5,4,4,5,4,4,4,4,5,5,5,5,3,4,2.8,0,4.2,0,4.4,0,4.2,0,4.266666666666667,0,2,3,3,3,3,4,3,3,3,2,3,4,2,4,2,3,1,4,4,3,2.95,0,"Hispanic of Latino (e.g., Mexican American, Central American, and others)",0,19,0,1,NA,5,2,0,0,0,0,0,TRUE,TRUE,TRUE,TRUE,TRUE,6,0.5340906250476837,0.4356900000413259,0.43142187501490115,0.6523999999523162,0.5176933333237966,0.5209074073897468,1,1,1,0.9375,0.967741935483871,0.8709677419354839,0.056,0.322,0.508,0.009,1.352,34.526341593849445,1930.7768868346816,0.071,0.306,0.568,0.022,1.998,41.35269565084051,1866.7045925470677,0.076,0.344,0.428,0.015,1.975,15.658389018482325,1859.3640414315544,150.22222222222226,90.81818181818183,131.66666666666669,FALSE,342,1.0133333333333332,0,1,1,30,33,FALSE
266,2022-03-18T18:37:22Z,0.8999999761581421,1.7786458333333333,768,7,4,2,1,3,1,2,2,3,3,2,2,2,3,1,2,2,3,1,3,3,2,2,2,2,0,1,0,0,1,1,2,4,1,1,3,1,1,1,1,2,1,1,1,1,2,1,1,3,3,3,3,3,3,1,1,3,2,3,1,1,1,1,2,2,1,3,1,2,3,1,1,1.75,0,2.066666666666667,0,1.6666666666666667,0,1.8333333333333333,0,2.1666666666666665,0,1.5714285714285714,0,1.6666666666666667,0,1.7837837837837838,0,0,1,0,-0.1163271015496859,-0.23409326518831208,0.33885444954852423,0.05238059218010607,1,1,1,1,1,1,1,1,-0.9579186615539372,5,5,5,5,2,2,3,3.857142857142857,0,0.40966740893729353,1,0.47272947549438354,4,2,3,4,3,3,5,4,3,2,4,3,2,3,5,4,4,3,4,5,3.2,0,3.4,0,3.4,0,4,0,3.6,0,3,2,3,2,1,2,2,2,1,1,2,2,1,3,1,3,1,2,2,3,1.95,0,"White, Caucasian, Anglo, European American",0,23,1,2,NA,5,2,0,0,1,0,0,TRUE,TRUE,TRUE,TRUE,TRUE,5,0.5466312499940396,0.44835937495529654,0.43328749997913835,0.6326156249940396,0.5515517241461524,0.5434733333428701,1,1,1,1,0.90625,0.9375,0.072,0.302,0.606,0.007,1.344,162.92084980303255,2010.1485657987373,0.074,0.321,0.625,0.013,1.742,39.03174367037486,1895.2490647135849,0.169,0.234,0.561,0.015,1.619,13.934995378305803,1793.9588435042226,192,134,107.93333333333334,FALSE,382,1.1318518518518519,0,1,0,0,3,FALSE
267,2022-03-18T18:21:08Z,0.8999999761581421,1.7777777777777777,864,7,2,3,2,3,2,1,1,3,2,2,2,2,3,1,3,3,1,2,1,1,2,2,1,3,1,2,0,0,0,0,1,2,4,1,2,1,1,1,1,2,2,3,1,3,3,3,2,3,3,3,3,2,1,1,1,3,1,1,2,1,1,2,1,1,1,3,3,1,1,2,1,1.25,0,2.2,0,1.5555555555555556,0,2.5833333333333335,0,1.5,0,1.2857142857142858,0,2.3333333333333335,0,1.8918918918918919,0,1,0,0,-0.45188814788794135,-0.4015551195114061,-0.31345356682763886,-0.3575043431695225,1,1,3,1,1,2,3,1.5,-0.3498436025973552,4,4,4,3,1,1,3,2.857142857142857,0,-0.8792700537047221,0,-0.8541675456885912,3,2,3,2,3,3,3,3,3,3,4,3,3,3,4,3,4,4,3,3,2.6,0,3.6,0,3,0,3.2,0,3.2666666666666666,0,1,1,1,1,1,1,1,3,1,2,1,2,1,1,2,3,1,1,2,1,1.4,0,"Asian or Asian American (e.g., Chinese, Japanese, and others)",0,28,1,2,NA,5,2,0,0,0,0,0,TRUE,TRUE,TRUE,TRUE,TRUE,1,0.531483870967742,0.46325,0.52696875,0.61809375,0.5195161290322581,0.5650937500000001,1,1,1,1,1,1,0.093,0.381,0.678,0.028,1.669,113.9151695074271,1901.3747495600796,0.192,0.271,0.994,0.036,1.905,10.808637054729934,1791.1306739757829,0.118,0.349,0.722,0.005,0.975,74.49094702036943,1860.8641627230425,59.607142857142854,52.91666666666667,195,FALSE,386,1.1437037037037037,0,1,0,0,3,FALSE
268,2022-03-18T18:34:16Z,0.8999999761581421,1.7777777777777777,1080,4,2,5,3,4,4,2,1,4,3,3,2,5,3,1,3,3,3,5,4,2,3,4,4,2,1,2,0,0,0,0,3,5,3,3,5,5,3,2,5,2,2,3,3,3,4,2,3,2,4,5,3,4,3,1,1,3,4,1,1,1,1,2,2,3,1,1,2,2,1,4,4,2.75,0,3.066666666666667,0,3.7777777777777777,0,3,0,2.6666666666666665,0,1.5714285714285714,0,1.3333333333333333,0,2.72972972972973,0,1,0,0,1.2281102932565262,1.1066832372752176,0.20346385825749233,0.655073547766355,4,4,4,3,2,3,4,3.5,1.4189799371827794,5,4,4,3,1,1,3,3,0,-1.3699149782144018,0,-1.0756115497497296,1,4,2,1,2,2,5,5,3,4,5,4,5,3,5,5,4,5,5,3,2,0,4,0,4.8,0,3.8,0,4.2,0,1,3,4,4,2,4,3,3,3,4,4,3,3,4,1,2,4,3,4,4,3.15,0,"Hispanic of Latino (e.g., Mexican American, Central American, and others)",0,22,0,1,NA,5,2,0,0,0,0,0,TRUE,TRUE,TRUE,TRUE,TRUE,2,0.5499451612897458,0.4854968749992549,0.5236187499985099,0.6435137931005708,0.5635258064500747,0.5844129032271523,1,1,1,0.9354838709677419,0.96875,0.96875,0.056,0.405,0.43,0.021,1.464,111.17496512602946,1935.8924603574196,0.07,0.356,0.55,0.017,1.53,54.89326349950027,1884.191702474798,0.071,0.381,0.43,0.012,1.57,106.18733937907596,1955.9914340035189,69.71428571428571,90,130.83333333333334,FALSE,282,0.8355555555555556,0,0,0,3,6,FALSE
269,2022-03-18T18:44:06Z,0.8999999761581421,1.7777777777777777,1080,6,2,2,2,2,4,1,1,1,1,1,1,1,2,2,1,2,2,1,1,1,1,1,1,2,1,2,0,0,0,0,2,1,2,1,2,2,1,1,1,1,3,1,1,2,1,1,1,1,1,1,1,1,1,1,1,1,1,1,2,2,1,1,1,1,1,1,1,1,1,1,1,1,0,1.6,0,1.4444444444444444,0,1.25,0,1,0,1.2857142857142858,0,1,0,1.2432432432432432,0,1,0,0,-1.1164306122048786,-1.110440913883213,-0.39960647100849406,-0.7550236924458535,2,2,3,1,1,2,3,1,-0.3773765525135179,4,4,5,4,2,2,4,3.5714285714285716,0,-1.2737251609456715,0,-0.7074126396006416,3,3,3,3,3,5,4,3,3,4,5,5,2,3,4,5,3,5,4,2,3,0,4.6,0,3.8,0,3,0,3.8,0,1,2,2,1,2,2,2,2,1,1,2,3,1,2,1,2,2,2,2,2,1.75,0,"Hispanic of Latino (e.g., Mexican American, Central American, and others) & White, Caucasian, Anglo, European American",1,29,0,1,NA,5,2,0,0,1,0,0,TRUE,TRUE,TRUE,TRUE,TRUE,5,0.4839290322574877,0.46126562500279394,0.48352187500149013,0.5639590909115293,0.5815666666689018,0.5915481481474859,0.96875,1,1,0.6875,0.75,0.84375,0.058,0.351,0.426,0.012,1.686,56.35282340896784,1958.1939923355444,0.046,0.375,0.475,0.006,1.442,236.04546429367497,2233.513162094935,0.042,0.379,0.372,0.012,1.649,101.55718595702584,2104.370944120387,140.5,240.33333333333331,137.41666666666666,TRUE,278,0.8237037037037037,0,1,0,0,3,FALSE
270,2022-03-18T18:39:28Z,0.8999999761581421,1.6,900,6,2,4,3,3,3,3,3,4,4,3,2,4,4,3,5,3,2,4,1,1,3,3,2,3,1,2,0,0,0,0,3,4,3,3,3,2,2,2,3,3,2,3,2,3,3,2,4,4,4,5,5,3,1,2,1,5,5,3,2,1,1,4,5,4,3,3,3,2,2,1,1,1.5,0,3.4,0,2.7777777777777777,0,3.3333333333333335,0,2.8333333333333335,0,2.857142857142857,0,3,0,3,0,1,0,0,0.7543770513672245,0.9336163766711973,-0.22730066264678367,0.3531578570122068,1,1,4,2,1,1,2,2,-0.15644147866964409,3,3,3,2,1,1,2,2.142857142857143,0,-0.27098964413394167,0,-0.8706837020007523,2,3,3,4,3,3,5,4,4,3,4,5,3,5,5,5,4,4,5,5,3,0,4,0,4.2,0,4.6,0,4.266666666666667,0,3,3,4,3,4,4,3,4,3,4,2,3,2,3,2,3,3,3,3,3,3.1,0,"White, Caucasian, Anglo, European American",0,25,1,2,NA,5,2,1,0,1,0,1,TRUE,TRUE,TRUE,TRUE,TRUE,2,0.5827531250002794,0.47529677419316385,0.6261031249994412,0.6975645161280709,0.5386843749983237,0.657483870967742,1,0.96875,1,1,1,1,0.084,0.414,0.404,0.04,1.721,60.38635231807514,1846.7330501733588,0.076,0.341,0.56,0.028,1.73,222.71129733287736,2050.112633598556,0.309,0.175,0.764,0.013,1.612,52.21021363393815,1837.0592006687932,43.025,61.785714285714285,124.00000000000001,FALSE,444,1.3155555555555554,0,1,0,0,3,FALSE
271,2022-03-18T18:42:46Z,1,1.7777777777777777,1080,6,4,1,1,1,1,1,1,2,1,1,1,1,2,1,2,1,2,4,5,1,1,3,1,1,2,2,0,0,0,0,1,4,3,1,1,4,5,2,4,2,3,2,1,2,2,1,1,2,2,1,1,3,1,1,1,3,1,2,3,1,1,1,1,1,1,2,1,2,4,2,1,2.25,0,1.2,0,2.7777777777777777,0,1.6666666666666667,0,1.6666666666666667,0,1.4285714285714286,0,1.3333333333333333,0,1.864864864864865,0,1,0,0,-0.06369007467309709,-0.5770803162035515,0.031158049895781924,-0.27296113315388476,3,3,5,4,2,1,2,2.5,0.7004373413042606,5,5,5,5,1,1,3,3.5714285714285716,0,1.2225015310373253,1,0.8130128665414434,2,2,2,2,3,4,5,4,4,4,5,5,5,3,5,3,5,4,5,1,2.2,0,4.6,0,4.4,0,3.4,0,4.133333333333334,0,2,2,4,1,1,4,4,4,1,2,3,3,2,2,1,3,1,4,2,2,2.4,0,Prefer not to say,0,23,3,5,NA,5,2,0,0,1,0,0,TRUE,TRUE,TRUE,TRUE,TRUE,1,0.6593064516109804,0.5663999999975786,0.5925187499998137,0.7243700000007948,0.653151851851631,0.6809814814803777,0.96875,1,1,0.9375,0.84375,0.9,0.074,0.401,0.425,0.012,1.921,141.76484409213808,2038.5721112690728,0.06,0.399,0.356,0.017,2.026,145.41149666982656,2094.2255843972425,0.062,0.446,0.285,0.024,2.207,197.10128893333857,2106.633821529689,160.08333333333334,119.17647058823528,91.95833333333333,FALSE,431,1.2770370370370372,0,1,1,21,24,FALSE
272,2022-03-18T18:27:07Z,0.8999999761581421,1.6,900,6,3,4,2,3,3,4,2,3,5,2,1,5,3,1,3,3,4,5,1,1,1,5,3,3,1,2,0,0,0,0,1,1,2,1,3,3,1,1,2,2,2,5,1,3,1,1,2,5,5,4,4,3,1,1,1,1,1,1,2,2,1,4,4,3,1,1,2,2,2,1,1,1.5,0,2.933333333333333,0,1.6666666666666667,0,2.9166666666666665,0,1.3333333333333333,0,2.4285714285714284,0,1.3333333333333333,0,2.135135135135135,0,1,0,0,0.5175104304225738,0.5705693031768558,-0.22730066264678367,0.17163432026503608,1,1,5,1,1,3,1,1.5,-0.2669090155915809,3,4,4,4,3,3,4,3.5714285714285716,0,-0.3760932239552953,1,-0.16067443809390553,2,3,2,5,2,4,3,3,4,2,4,5,3,3,3,3,4,5,2,3,2.8,0,4.4,0,2.6,0,3.2,0,3.4,0,1,3,1,3,3,1,4,3,1,1,2,2,1,1,1,2,1,1,2,3,1.85,0,"Asian or Asian American (e.g., Chinese, Japanese, and others)",0,22,1,2,NA,5,2,0,0,3,0,0,TRUE,TRUE,TRUE,TRUE,TRUE,1,0.5794580645164655,0.4729548387097255,0.4869312499992084,0.5882187499997672,0.5181625000007917,0.5845250000001397,1,1,1,1,1,1,0.117,0.328,0.728,0.011,1.332,18.43346574459196,1799.5322628865429,0.111,0.318,0.732,0.019,1.313,21.7597980442544,1803.953884422772,0.084,0.361,0.434,0.033,1.766,53.70048618228854,1835.549652690919,121.09090909090911,69.10526315789474,53.515151515151516,FALSE,424,1.2562962962962962,0,1,0,0,3,FALSE
273,2022-03-18T18:43:59Z,1,1.6,800,6,2,4,2,5,2,3,3,3,5,5,2,4,4,2,4,4,1,3,1,1,4,5,5,4,4,1,2,0,1,0,1,3,1,3,4,2,2,2,4,4,2,5,1,3,3,1,3,3,5,5,4,3,1,1,1,3,3,1,3,3,3,3,4,3,1,4,4,2,1,2,2,1.75,0,3.466666666666667,0,2.4444444444444446,0,3.25,0,2,0,2.857142857142857,0,3,0,2.7567567567567566,0,2,0,0,1.002209719577831,1.129398262729495,0.07821504497010326,0.6038066538497991,3,4,5,3,2,3,3,3.5,1.336045350177005,4,3,3,2,1,1,2,2.2857142857142856,0,-0.30418514155265464,0,-0.813500056196216,3,2,3,3,3,4,5,4,4,3,5,5,3,2,5,5,5,5,5,5,2.8,0,4.8,0,4.2,0,4,0,4.333333333333333,0,2,1,3,2,4,3,4,2,3,3,4,2,1,1,1,2,1,3,2,3,2.35,0,"Asian or Asian American (e.g., Chinese, Japanese, and others)",0,29,1,2,NA,5,2,0,0,1,0,0,TRUE,TRUE,TRUE,TRUE,TRUE,5,0.5011333333333333,0.44865625,0.47346875,0.585625,0.543125,0.5788125,1,1,1,1,1,1,0.116,0.305,0.719,0.01,1.482,133.84396318992992,1924.4318489698712,0.096,0.312,0.805,0.023,2.297,68.26538966223893,1851.9729859727715,0.115,0.325,0.677,0.013,1.466,60.45874506269841,1843.131579768002,148.2,99.86956521739131,112.76923076923077,FALSE,388,1.1496296296296296,0,1,0,0,3,FALSE
274,2022-03-18T18:26:50Z,0.8999999761581421,1.6,900,6,4,1,1,3,1,3,1,3,2,2,1,1,2,1,3,4,1,1,1,1,1,1,1,1,4,2,0,0,0,0,3,3,3,3,3,3,5,4,5,2,2,1,1,1,1,3,3,2,4,2,2,4,3,1,2,1,1,2,4,2,1,3,3,1,1,1,1,2,2,2,2,2,0,1.9333333333333333,0,3.5555555555555554,0,2,0,2,0,2.2857142857142856,0,1,0,2.3513513513513513,0,2,0,0,-0.5593554110943109,-0.590256997635903,0.16436794915095845,-0.2129445242424723,1,1,1,1,1,1,1,1,-0.9579186615539372,5,5,5,5,5,5,1,4.428571428571429,0,0.5180662734131892,1,0.8483647882903484,3,3,3,3,3,3,3,3,3,3,3,3,3,3,3,3,3,3,3,3,3,0,3,0,3,0,3,0,3,0,2,2,2,3,2,2,2,3,2,2,2,3,2,2,2,3,2,2,2,2,2.2,0,"Asian or Asian American (e.g., Chinese, Japanese, and others)",0,25,1,2,NA,5,2,0,0,1,0,0,TRUE,TRUE,TRUE,TRUE,TRUE,6,0.5817249999996275,0.5608687500003725,0.6565156249972061,0.6062,0.6211399999976158,0.6716379310355104,1,1,1,0.967741935483871,0.967741935483871,0.9666666666666667,0.062,0.454,0.343,0.02,1.552,190.21848675568023,2017.1829042751112,0.07,0.396,0.442,0.028,1.923,59.49392588359736,1883.8439073587604,0.065,0.416,0.462,0.01,1.163,190.08252535466573,2022.0901335444817,77.6,68.67857142857143,116.3,FALSE,436,1.2918518518518518,0,1,1,18,21,FALSE
276,2022-03-18T18:43:42Z,0.8999999761581421,1.6,900,6,3,2,1,1,2,1,1,1,1,1,1,1,1,2,2,2,1,1,1,1,1,1,1,1,1,2,0,0,0,0,1,1,1,1,1,1,1,1,1,1,1,1,1,1,1,1,2,1,1,1,2,1,1,1,1,2,2,1,2,1,1,1,1,1,1,1,1,1,1,1,1,1,0,1.3333333333333333,0,1,0,1.1666666666666667,0,1.3333333333333333,0,1.1428571428571428,0,1,0,1.135135135135135,0,1,0,0,-1.3489108142431467,-1.3832178862215945,-0.39960647100849406,-0.8914121786150443,1,1,2,1,1,2,1,1,-0.7920494875423887,5,5,5,5,3,3,5,4.428571428571429,0,1.1140269019269466,0,1.2113581587077484,2,2,2,3,2,4,2,3,4,3,5,3,4,4,3,5,3,4,1,3,2.2,0,3.8,0,3,0,3.4,0,3.4,0,1,1,1,1,1,1,1,4,1,1,2,1,1,2,1,2,1,1,1,1,1.3,0,"White, Caucasian, Anglo, European American",0,27,1,2,NA,5,2,0,0,1,0,0,TRUE,TRUE,TRUE,TRUE,TRUE,5,0.5445437500048429,0.5049625000022352,0.5330843749977648,0.5923250000011175,0.5679516128993803,0.5936437499988824,1,1,1,1,1,1,0.127,0.34,0.676,0.019,1.605,104.58792023175,1890.2579423082784,0.126,0.344,0.763,0.035,1.984,159.09277838572712,1946.508455142952,0.122,0.352,0.656,0.019,1.343,56.24011721208095,1839.2000630556377,84.47368421052632,56.68571428571428,70.6842105263158,FALSE,435,1.2888888888888888,0,1,0,3,6,FALSE
277,2022-03-18T18:48:39Z,0.8999999761581421,1.7777777777777777,864,5,1,3,3,3,3,4,1,4,4,3,3,2,4,2,4,3,4,4,1,1,1,4,4,1,0,2,0,0,0,0,3,2,2,2,2,2,2,2,2,2,2,2,2,4,3,3,3,3,3,3,3,4,2,1,1,1,1,3,1,1,1,1,1,1,1,1,1,1,1,1,1,1,0,3.066666666666667,0,2.111111111111111,0,2.75,0,1.6666666666666667,0,1.2857142857142858,0,1,0,2,0,0,0,0,0.18633580299070093,0.4060574521595117,-0.6189692744445258,-0.10645591114250702,2,2,3,1,1,1,1,1,-0.6261803135308405,3,3,3,3,2,2,3,2.7142857142857144,0,-0.14160432944649845,0,-0.48226576241552316,3,3,3,3,3,3,3,4,3,3,5,3,4,3,3,5,3,4,3,3,3,0,3.6,0,3.6,0,3.2,0,3.466666666666667,0,2,2,2,2,2,2,3,2,1,2,2,2,1,2,2,2,2,2,2,2,1.95,0,Middle Eastern,0,24,1,2,NA,5,2,0,0,1,0,0,TRUE,TRUE,TRUE,TRUE,TRUE,1,0.700271875000035,0.5045531249998894,0.5609093750000466,0.6978387096773893,0.5603451612903887,0.5925870967742597,1,1,1,0.96875,0.96875,0.96875,0.071,0.369,0.335,0.041,1.483,99.17176765960188,1926.3326091666515,0.082,0.336,0.507,0.022,1.784,101.0764880966508,1925.287725459286,0.285,0.201,0.594,0.281,1.453,218.70151768019053,2043.6246032011848,36.170731707317074,81.0909090909091,5.170818505338078,FALSE,382,1.1318518518518519,0,1,0,0,3,FALSE
278,2022-03-18T18:38:49Z,0.8999999761581421,1.7777777777777777,1440,6,2,3,2,3,2,3,2,2,2,2,1,1,2,4,2,4,3,3,1,1,3,2,2,4,1,2,0,0,0,0,1,2,1,1,1,1,3,2,2,3,2,4,1,4,2,1,5,4,4,5,5,2,1,1,1,2,1,2,2,1,1,1,1,2,2,3,3,1,1,2,1,1.25,0,2.3333333333333335,0,1.5555555555555556,0,3.3333333333333335,0,1.3333333333333333,0,1.4285714285714286,0,2.6666666666666665,0,2.1621621621621623,0,1,0,0,0.21046110697580434,0.1021087782237017,-0.31345356682763886,-0.10567239430196859,2,1,5,1,1,1,2,4,0.7001016040469747,3,3,3,4,1,1,2,2.4285714285714284,0,-0.822150648667876,0,-1.0515847406769399,1,1,2,3,2,3,5,1,5,2,5,4,2,5,5,5,5,5,5,4,1.8,0,4.4,0,3.8,0,4,0,4.066666666666666,0,2,2,1,1,2,1,2,1,4,2,2,2,1,1,1,2,1,2,1,2,1.65,0,"White, Caucasian, Anglo, European American",0,23,0,1,NA,5,2,1,0,1,0,1,TRUE,TRUE,TRUE,TRUE,TRUE,3,0.6131161290320658,0.43330624999944123,0.5408031250000931,0.7571766666655739,0.4864999999994481,0.5594068965505937,0.96875,1,1,0.967741935483871,0.84375,0.9354838709677419,0.07,0.307,0.386,0.017,1.851,46.75300202583635,1891.233074864004,0.057,0.286,0.455,0.019,2.022,185.0366767369329,2087.961383030711,0.081,0.3,0.216,0.014,1.446,277.2350763712481,2150.958897395993,108.88235294117646,106.42105263157895,103.28571428571428,FALSE,304,0.9007407407407407,1,1,0,0,3,FALSE
279,2022-03-18T18:53:11Z,0.8999999761581421,1.6,900,4,2,4,1,5,3,4,3,3,4,3,2,4,4,4,3,1,4,5,5,3,1,4,3,3,3,1,0,0,1,1,1,4,4,2,1,1,1,1,2,2,1,4,1,3,2,1,4,4,4,5,5,5,4,4,5,1,1,1,4,1,1,1,1,1,3,3,2,2,3,2,1,2,0,3.2,0,1.8888888888888888,0,3,0,3.3333333333333335,0,1.4285714285714286,0,2.6666666666666665,0,2.4594594594594597,0,2,1,0,1.1338022867693043,1.1014715647683921,0.8637329606014429,0.9826022626849176,1,1,2,1,1,1,1,2,-0.48817982669274074,3,3,3,3,2,1,3,2.5714285714285716,0,0.466676080124282,0,-0.18917121776497564,1,1,1,1,1,5,5,5,5,3,4,5,4,4,4,5,5,5,4,5,1,0,4.8,0,4.2,0,4.6,0,4.533333333333333,0,1,2,2,2,2,2,2,3,3,3,4,3,3,3,1,3,1,3,3,2,2.4,0,"Black or African American & White, Caucasian, Anglo, European American",1,22,1,2,NA,5,2,0,0,1,0,0,TRUE,TRUE,TRUE,TRUE,TRUE,3,0.4585312499983702,0.4213281250002328,0.4419838709670209,0.5713275862076673,0.49918928571497756,0.5522759999987483,1,1,0.96875,0.90625,0.875,0.8064516129032258,0.052,0.332,0.415,0.017,2.044,81.21381741459459,2027.5231871955216,0.058,0.323,0.635,0.015,1.605,149.6620978373203,2023.7713950566297,0.064,0.341,0.628,0.009,1.422,20.460835288064292,1877.027734275278,120.23529411764706,107,158,FALSE,412,1.2207407407407407,0,1,0,3,6,FALSE
280,2022-03-18T18:29:01Z,0.800000011920929,1.7777777777777777,1080,3,1,4,2,2,2,1,3,3,3,3,2,3,3,2,3,3,3,3,5,1,3,3,3,2,1,2,0,0,0,0,2,2,2,1,3,1,1,1,1,1,1,1,2,2,3,2,3,2,3,2,2,3,1,4,3,2,4,1,2,2,2,2,2,2,1,1,3,2,2,2,2,2,0,2.6,0,1.5555555555555556,0,2,0,2.8333333333333335,0,1.8571428571428572,0,1.6666666666666667,0,1.972972972972973,0,1,0,0,0.41223637666939555,0.354235727421831,-0.05499485428507328,0.14962043656837887,1,1,2,1,1,1,1,2.5,-0.2947777027650296,5,5,5,5,2,2,4,4,0,-0.23191923190205752,0,0.15934845458074715,2,2,2,2,2,4,5,4,4,3,5,4,5,3,4,5,4,4,4,4,2,0,4.2,0,4.4,0,3.8,0,4.133333333333334,0,2,1,2,3,2,2,2,3,3,1,1,2,1,1,1,2,1,2,2,2,1.8,0,"White, Caucasian, Anglo, European American",0,28,1,2,NA,5,2,0,0,1,0,0,TRUE,TRUE,TRUE,TRUE,TRUE,6,0.5445322580645161,0.44582580645622744,0.45606562500447034,0.5682906250059605,0.4778812500052154,0.5408677419231784,0.96875,1,1,1,1,0.96875,0.071,0.333,0.639,0.017,1.77,92.1480435945437,1914.399929516592,0.056,0.36,0.721,0.048,2.017,103.29474528819104,1884.7594725057552,0.058,0.396,0.4,0.028,1.154,154.05990870730685,1981.9601786848064,104.11764705882352,42.02083333333333,41.21428571428571,FALSE,352,1.0429629629629629,0,1,0,0,3,FALSE
281,2022-03-18T18:44:26Z,0.8999999761581421,1.7777777777777777,720,6,2,4,2,4,3,3,5,4,4,4,3,2,5,2,5,5,4,3,2,4,2,1,3,2,4,2,0,0,0,0,4,4,3,5,5,4,5,5,5,1,3,1,1,4,3,3,4,1,1,1,1,4,1,1,2,3,3,1,3,3,3,4,4,3,2,2,1,2,2,2,2,2,0,3.6666666666666665,0,4.444444444444445,0,2,0,2.3333333333333335,0,3,0,1.6666666666666667,0,2.810810810810811,0,2,0,0,0.7938548215246662,1.076593203556564,0.16436794915095845,0.6204805763537612,3,1,5,3,1,3,1,2,0.2582314563592268,2,3,4,3,1,1,3,2.4285714285714284,0,-0.8792700537047221,0,-1.0863755714106227,4,3,4,3,3,3,3,3,3,3,3,3,2,4,2,3,4,3,3,3,3.4,0,3.2,0,2.8,0,3,0,3,0,3,2,3,3,2,4,3,4,4,2,4,3,3,3,1,3,1,3,3,3,2.85,0,"White, Caucasian, Anglo, European American",0,29,0,1,NA,5,2,0,1,1,0,1,TRUE,TRUE,TRUE,TRUE,TRUE,4,0.5272566666655243,0.5026843750004191,0.7278593750004657,0.5306483870961013,0.5316967741928754,0.845306666666766,1,1,1,0.96875,0.96875,0.967741935483871,0.074,0.323,0.273,0.018,1.858,259.52453376800935,2087.26133592611,0.059,0.372,0.521,0.033,1.953,41.69198390058627,1865.9484695076824,0.059,0.363,0.421,0.029,1.619,82.58232191711491,1906.4917504505884,103.22222222222223,59.18181818181818,55.82758620689655,FALSE,304,0.9007407407407407,1,1,0,0,3,FALSE
282,2022-03-18T18:53:54Z,0.8999999761581421,1.7777777777777777,864,6,3,1,1,2,1,2,1,1,1,1,1,1,2,2,2,3,1,1,1,1,1,1,1,1,1,2,0,0,0,0,1,3,2,1,2,2,1,2,1,2,1,1,1,2,2,2,2,1,1,1,1,1,1,1,1,2,1,1,2,1,1,1,1,1,1,1,1,1,1,1,1,1,0,1.4666666666666666,0,1.6666666666666667,0,1.4166666666666667,0,1.1666666666666667,0,1.1428571428571428,0,1,0,1.3513513513513513,0,1,0,0,-1.2085454092389094,-1.2306043818707768,-0.39960647100849406,-0.8151054264396355,1,1,1,1,1,1,1,1,-0.9579186615539372,5,5,5,5,4,4,5,4.714285714285714,0,0.7527672921047103,0,1.1461240685098075,2,2,2,2,2,4,5,4,4,4,5,4,4,5,5,4,5,5,4,3,2,0,4.6,0,4.2,0,4.2,0,4.333333333333333,0,1,2,1,1,1,1,1,1,1,2,2,1,2,1,1,1,1,1,1,2,1.25,0,"White, Caucasian, Anglo, European American",0,25,0,1,NA,5,2,0,0,0,0,0,TRUE,TRUE,TRUE,TRUE,TRUE,5,0.5057312500048429,0.4007687499951571,0.4681374999973923,0.5381709677403973,0.45139062500186267,0.5591187500003725,1,1,1,0.96875,1,1,0.137,0.243,0.613,0.017,1.818,23.08915903332022,1805.6219335248709,0.084,0.269,0.633,0.028,1.595,33.12242613253226,1817.9848372652853,0.075,0.333,0.459,0.017,1.407,135.31295543282354,1963.633686493769,106.94117647058823,56.964285714285715,82.76470588235294,FALSE,414,1.2266666666666668,0,1,0,0,3,FALSE
283,2022-03-18T18:53:14Z,1,1.7777777777777777,1080,3,3,3,3,2,2,4,3,4,4,2,1,1,2,2,3,4,2,1,3,1,1,1,2,1,1,2,0,0,0,0,3,1,1,1,2,1,2,2,1,3,1,4,3,1,2,1,5,3,3,3,2,3,1,1,1,3,1,1,2,1,1,1,1,2,1,2,1,2,2,2,1,1.75,0,2.6666666666666665,0,1.5555555555555556,0,2.5833333333333335,0,1.6666666666666667,0,1.2857142857142858,0,1.3333333333333333,0,1.837837837837838,0,1,0,0,-0.5681282489070757,-0.2759833121299669,-0.14114775846592847,-0.2085655352979477,1,1,3,2,1,1,1,2,-0.32231065268119236,3,4,4,4,2,2,3,3.142857142857143,0,-0.13222200579606097,1,-0.24434306172794495,2,2,2,2,2,4,5,4,4,3,5,4,4,3,5,3,4,4,3,5,2,0,4.2,0,3.6,0,4.2,0,4,0,2,1,1,4,3,3,2,4,4,2,1,2,2,3,1,2,1,2,3,3,2.3,0,"Asian or Asian American (e.g., Chinese, Japanese, and others)",0,27,1,2,NA,5,2,1,0,1,0,1,TRUE,TRUE,TRUE,TRUE,TRUE,6,0.5179677419354839,0.483875,0.47803125,0.5613333333333334,0.52134375,0.5471935483870968,1,1,1,0.9375,1,1,0.106,0.336,0.775,0.018,1.476,25.193591290341175,1809.110565991469,0.059,0.363,0.545,0.025,1.618,136.19881448823065,1920.6328776635617,0.059,0.37,0.415,0.022,1.715,50.317294311998985,1896.6222955314863,82,64.72,77.95454545454547,FALSE,348,1.031111111111111,0,1,0,3,6,FALSE
284,2022-03-18T18:54:04Z,1,1.6,900,5,2,3,2,4,1,3,1,2,3,1,1,2,2,1,2,4,1,3,1,1,1,1,1,1,0,2,0,0,0,0,2,4,3,2,2,2,3,5,3,3,1,1,1,4,3,1,3,1,1,2,1,1,1,1,1,1,1,1,1,1,1,2,2,2,1,1,1,1,2,2,1,1.5,0,2.1333333333333333,0,2.888888888888889,0,1.8333333333333333,0,1,0,1.4285714285714286,0,1,0,1.8108108108108107,0,0,0,0,-0.7479714240687552,-0.6297870419329575,-0.4466634660828154,-0.5382252540078865,1,1,2,1,1,1,3,2.5,-0.12890852875348124,5,4,4,5,2,2,5,3.857142857142857,0,0.7615446951090925,0,0.6870542412081319,1,1,3,1,1,5,5,5,5,3,5,5,5,5,5,5,5,5,4,3,1.4,0,5,0,4.4,0,4.6,0,4.666666666666667,0,1,1,1,4,1,1,1,1,1,1,1,1,3,1,1,1,1,1,1,1,1.25,0,"Asian or Asian American (e.g., Chinese, Japanese, and others)",0,19,0,1,NA,5,2,0,0,1,0,0,TRUE,TRUE,TRUE,TRUE,TRUE,3,0.5637999999979811,0.5699687500009313,0.5929625000013039,0.6612935483864238,0.6230062500019558,0.6033937500012108,0.96875,1,1,1,1,1,0.183,0.317,0.69,0.063,1.373,95.58893079314208,1882.4960936060172,0.112,0.382,0.634,0.023,1.499,29.797134170140453,1813.4990189715693,0.085,0.409,0.554,0.019,1.896,132.82007233520156,1981.525746628101,21.793650793650794,65.17391304347827,99.78947368421052,FALSE,374,1.108148148148148,0,1,0,0,3,FALSE
285,2022-03-18T18:42:38Z,0.8999999761581421,1.7777777777777777,1080,4,3,2,1,2,2,2,2,2,3,4,3,2,2,4,3,2,2,1,1,1,1,1,2,1,2,2,0,0,0,0,2,2,2,3,2,1,2,1,2,3,2,4,4,3,2,3,2,2,2,2,2,5,1,1,1,3,2,2,3,3,1,2,2,2,1,1,1,2,1,2,2,1.75,0,2.4,0,1.8888888888888888,0,2.5833333333333335,0,2.1666666666666665,0,2.142857142857143,0,1,0,2.135135135135135,0,1,0,0,-0.5374233165623987,-0.3717600861233279,-0.14114775846592847,-0.25645392229462816,2,2,2,2,1,2,2,1,-0.4603111395192921,3,4,4,4,3,3,3,3.4285714285714284,0,0.43348058270556905,0,0.255025804242946,3,4,3,3,3,3,4,3,3,4,3,2,3,4,3,3,4,2,3,2,3.2,0,2.8,0,3.4,0,3,0,3.066666666666667,0,2,3,2,1,2,1,2,2,1,1,1,1,2,1,2,1,1,1,1,1,1.45,0,"White, Caucasian, Anglo, European American",0,22,0,1,NA,5,2,0,0,0,0,0,TRUE,TRUE,TRUE,TRUE,TRUE,3,0.5793343750005588,0.505125,0.5180875000013039,0.5855187499998137,0.5387064516121342,0.5899187499983236,1,1,1,1,0.96875,1,0.068,0.335,0.353,0.019,1.281,112.21904649853644,1898.6020302105787,0.07,0.309,0.346,0.038,1.725,89.14066870501334,1911.4855868470995,0.126,0.276,0.422,0.108,1.819,47.2802323089672,1829.3371670518873,67.42105263157895,45.39473684210527,16.84259259259259,FALSE,257,0.7614814814814815,0,1,1,6,9,FALSE
286,2022-03-18T18:39:05Z,0.8999999761581421,1.7777777777777777,864,4,2,5,3,2,3,2,3,4,4,3,4,2,5,3,5,5,3,4,5,3,4,5,5,5,3,1,1,0,1,1,2,5,4,4,3,2,3,3,4,1,2,1,1,2,3,1,4,4,4,5,5,4,2,3,1,4,3,3,3,3,3,2,1,1,1,3,4,2,3,2,2,2.25,0,3.533333333333333,0,3.3333333333333335,0,2.75,0,2.8333333333333335,0,2.2857142857142856,0,2.6666666666666665,0,2.810810810810811,0,2,1,0,1.8487885685096388,1.727855600022714,0.9498858647822981,1.3388707324025062,2,2,4,2,1,2,2,2.5,0.2857644062753896,3,4,5,5,2,1,3,3.2857142857142856,0,-0.05128942699093936,0,-0.117645201282991,2,4,3,4,3,3,3,3,4,2,5,4,2,3,3,5,4,4,3,2,3.2,0,4,0,3,0,3,0,3.3333333333333335,0,3,2,4,2,4,4,3,4,1,2,2,3,4,3,2,3,1,4,3,4,2.9,0,"White, Caucasian, Anglo, European American",0,25,1,2,NA,5,2,1,0,0,0,1,TRUE,TRUE,TRUE,TRUE,TRUE,6,0.7256032258072688,0.6663999999999068,0.5877312500008848,0.6815281250008848,0.6265562499996741,0.6568937500009779,1,1,1,1,1,1,0.12,0.389,0.627,0.01,1.211,95.5880170620088,1882.546399043065,0.078,0.464,0.43,0.226,1.58,131.6250081773687,1910.7525085790348,0.168,0.41,0.574,0.277,1.367,138.5753345477002,1924.1263579300123,121.10000000000001,6.991150442477876,4.935018050541516,FALSE,393,1.1644444444444444,0,1,0,0,3,FALSE
287,2022-03-18T18:28:08Z,1,1.6,800,4,4,3,2,3,3,3,2,3,2,2,2,3,3,2,4,4,2,1,1,1,1,2,2,1,0,2,0,0,0,0,2,2,2,2,2,2,2,2,2,3,2,3,1,3,2,2,3,3,3,3,3,2,3,3,1,4,3,2,1,3,2,3,3,3,2,3,2,2,2,2,3,2.25,0,2.7333333333333334,0,2,0,2.5833333333333335,0,2.6666666666666665,0,2.4285714285714284,0,2.3333333333333335,0,2.4054054054054053,0,0,0,0,-0.2808178105390271,-0.05365139631991641,-0.1882047535402498,-0.1209280749300831,4,3,4,2,3,4,2,2.5,0.8663065153158088,4,4,4,4,4,5,4,4.142857142857143,0,-0.5360594366874477,0,0.05150251987581217,2,3,3,3,3,3,4,3,4,2,5,3,4,4,3,5,4,4,3,4,2.8,0,3.8,0,3.6,0,3.6,0,3.6666666666666665,0,2,2,3,3,2,3,3,2,2,2,2,2,2,3,2,2,2,2,2,2,2.25,0,"White, Caucasian, Anglo, European American",0,29,1,2,NA,5,2,0,0,1,0,0,TRUE,TRUE,TRUE,TRUE,TRUE,1,0.6105406249910593,0.5779937499798834,0.5977156249955297,0.6617935483801749,0.6331483870860068,0.6429677419277929,1,1,1,1,0.96875,1,0.145,0.346,0.641,0.015,1.298,52.511303934901775,1835.274783306133,0.067,0.42,0.466,0.015,1.451,88.78663779764507,1914.5527720697228,0.08,0.431,0.449,0.051,1.658,108.86468139857696,1894.0947954177343,86.53333333333335,96.73333333333335,32.509803921568626,FALSE,384,1.1377777777777778,0,1,0,0,3,FALSE
288,2022-03-18T17:11:00Z,0.800000011920929,1.5,912,6,3,3,1,4,2,3,1,4,3,1,2,3,3,1,2,1,1,4,1,1,2,2,4,2,3,1,0,0,1,0,1,1,1,1,1,3,1,1,1,5,1,4,1,1,4,2,2,1,4,5,4,2,1,1,1,1,1,4,4,4,1,1,2,4,1,1,1,2,2,2,1,1.75,0,2.2666666666666666,0,1.2222222222222223,0,2.8333333333333335,0,1.1666666666666667,0,2.857142857142857,0,1,0,2.027027027027027,0,2,0,0,-0.03956477068799369,-0.09514810948747111,0.07821504497010326,-0.008466532258683927,2,3,1,1,1,2,1,2.5,-0.04597394174770708,5,5,5,5,4,4,5,4.714285714285714,0,0.9514460898207904,0,1.2671372411304413,3,4,4,2,3,2,3,3,3,4,2,3,2,3,4,3,3,3,4,3,3.2,0,2.6,0,3.2,0,3.2,0,3,0,3,2,2,2,2,3,2,1,3,2,2,2,3,4,3,2,2,3,4,3,2.5,0,"Asian or Asian American (e.g., Chinese, Japanese, and others)",0,21,1,2,NA,5,2,1,0,1,0,1,TRUE,TRUE,TRUE,TRUE,TRUE,4,0.5435593750001863,0.5360562499994412,0.5333281250009313,0.6420566666682561,0.5892062499979511,0.5715031250016763,1,1,1,0.9375,1,1,0.103,0.384,0.759,0.02,1.358,81.54479720859932,1871.1262228910791,0.161,0.307,0.734,0.017,1.419,40.57076526858554,1826.7854211958804,0.08,0.382,0.531,0.006,1.154,61.25607071895592,1904.0682584697329,67.9,83.47058823529412,192.33333333333331,FALSE,460,1.3629629629629632,0,1,1,6,9,FALSE
289,2022-03-18T18:54:41Z,1,1.7786458333333333,768,4,3,3,1,2,2,1,1,2,3,1,1,2,2,2,3,2,2,2,1,1,2,2,1,2,3,2,0,0,0,0,1,1,1,2,3,1,2,1,1,2,2,2,1,3,2,4,3,2,4,3,2,2,1,1,1,4,2,1,3,2,1,2,3,2,1,2,1,1,2,2,2,1.75,0,1.8666666666666667,0,1.4444444444444444,0,2.5,0,1.8333333333333333,0,2,0,1.3333333333333333,0,1.945945945945946,0,2,0,0,-0.416796796636882,-0.5234885894824202,0.07821504497010326,-0.22263677225615847,2,2,3,1,1,3,2,1.5,-0.1839744285858068,4,4,5,3,3,4,4,3.857142857142857,0,0.4002850852868561,0,0.4670148005288366,2,2,2,3,1,5,2,5,5,2,2,3,4,3,2,1,2,4,3,2,2,0,3.2,0,2.4,0,3.4,0,3,0,1,1,1,2,2,2,2,3,1,3,1,4,2,1,1,3,1,2,1,3,1.85,0,"Asian or Asian American (e.g., Chinese, Japanese, and others)",0,24,0,1,NA,5,2,0,0,1,0,0,TRUE,TRUE,TRUE,TRUE,TRUE,1,0.48629032258064514,0.43146875,0.45659375,0.6414074074074074,0.5248461538461539,0.55068965517241375,0.96875,1,1,0.84375,0.8125,0.90625,0.059,0.353,0.618,0.013,1.613,63.39615708844861,1920.996720465909,0.048,0.345,0.491,0.014,1.508,158.9501528832421,2102.974269354234,0.055,0.36,0.365,0.007,1.406,159.9292742041559,2136.867397138841,124.07692307692308,107.71428571428571,200.85714285714283,FALSE,340,1.0074074074074075,0,1,0,0,3,FALSE
290,2022-03-18T18:59:16Z,1,1.7777777777777777,864,6,2,2,2,2,2,1,2,3,3,2,3,2,2,4,3,2,2,2,2,2,2,2,1,2,1,2,0,0,0,0,2,4,4,2,2,2,2,2,2,4,3,3,4,2,3,2,2,2,3,4,3,4,2,2,3,4,1,1,2,1,1,2,1,3,1,1,1,2,3,3,3,2.75,0,2.3333333333333335,0,2.4444444444444446,0,2.9166666666666665,0,2.6666666666666665,0,1.5714285714285714,0,1,0,2.3513513513513513,0,1,0,0,0.008685837282212535,-0.033591373840814016,0.20346385825749233,0.08493624220833916,2,1,3,3,1,2,3,1.5,-0.10103984158003264,4,3,4,4,2,2,4,3.2857142857142856,0,0.03315056065144856,0,-0.06621369012972289,4,3,3,3,4,2,1,2,3,2,2,4,5,3,4,3,4,3,3,3,3.4,0,3,0,2.8,0,3,0,2.933333333333333,0,1,2,1,3,3,1,1,2,2,3,2,2,2,2,1,3,1,1,1,2,1.8,0,"White, Caucasian, Anglo, European American",0,24,0,1,NA,5,2,0,0,1,0,0,TRUE,TRUE,TRUE,TRUE,TRUE,5,0.5860666666666666,0.4855625,0.48746875,0.6417692307692308,0.5563333333333333,0.5983,0.9375,1,1,0.8387096774193549,0.967741935483871,0.967741935483871,0.079,0.339,0.505,0.019,2.03,29.913095386117853,1852.2238366992644,0.064,0.347,0.479,0.026,1.877,31.281364340506823,1856.63005852242,0.05,0.43,0.319,0.008,1.146,118.29696374369104,2084.898755593455,106.84210526315789,72.1923076923077,143.24999999999997,FALSE,357,1.0577777777777777,0,1,0,0,3,FALSE
292,2022-03-18T18:49:16Z,NA,1.7786458333333333,768,5,2,5,3,5,3,1,5,1,3,2,1,5,5,1,5,3,1,5,5,1,5,5,5,5,6,1,2,1,1,1,1,3,1,1,5,1,5,3,3,3,3,5,1,5,3,3,1,3,5,5,5,4,3,1,5,3,2,3,3,2,2,1,1,3,1,3,5,1,5,5,5,4,0,3.2,0,2.5555555555555554,0,3.5,0,3,0,2.142857142857143,0,3,0,2.891891891891892,0,3,1,1,1.7391280958500785,1.5085720209619393,2.678452486613473,2.093512253787706,3,2,3,3,1,1,5,2.5,0.5345681672927123,3,3,3,5,3,1,3,3,0,-0.17479982686521142,0,-0.3476794413703099,3,3,5,1,2,3,5,3,3,3,3,3,4,3,3,3,5,3,3,3,2.8,0,3.4,0,3.6,0,3,0,3.3333333333333335,0,2,1,1,4,2,2,4,3,2,4,1,4,1,2,3,4,4,4,1,2,2.55,0,"White, Caucasian, Anglo, European American",0,21,0,1,NA,5,2,0,1,0,0,1,TRUE,TRUE,TRUE,TRUE,TRUE,3,0.5831968750357628,0.5014781250059605,0.5375903226175616,0.761862499922514,0.5933586207093864,0.6816692308279184,1,1,0.96875,1,0.9354838709677419,0.8666666666666667,0.071,0.327,0.342,0.013,2.159,87.87497261186503,1993.0332172667863,0.065,0.349,0.45,0.016,1.724,47.37091929210387,1891.5604610502164,0.147,0.284,0.486,0.007,1.399,36.44361427841146,1820.9686630515591,166.07692307692307,107.75,199.85714285714286,FALSE,304,0.9007407407407407,1,0,0,0,3,FALSE
293,2022-03-18T18:55:47Z,0.8999999761581421,1.7777777777777777,1080,3,3,2,2,2,1,1,1,1,2,1,1,1,2,2,1,1,1,1,1,1,1,2,1,1,0,2,0,0,0,0,2,1,1,2,2,1,2,2,4,1,1,2,1,3,1,1,1,1,2,1,3,2,1,1,1,1,1,1,1,1,1,1,1,2,1,1,1,1,1,2,2,1.5,0,1.4,0,1.8888888888888888,0,1.5,0,1.1666666666666667,0,1.1428571428571428,0,1,0,1.4324324324324325,0,0,0,0,-1.0747596325942455,-1.169735980328795,-0.4466634660828154,-0.8081997232058051,1,1,3,2,1,1,1,1.5,-0.5157127766089035,5,5,5,5,3,3,5,4.428571428571429,0,0.003250347887277641,1,0.5347958056928851,2,3,3,2,2,4,2,3,4,2,2,4,3,3,4,4,5,5,2,3,2.4,0,4,0,2.6,0,3.4,0,3.3333333333333335,0,1,1,1,2,3,1,2,4,2,1,1,2,1,2,1,3,1,2,1,2,1.7,0,"White, Caucasian, Anglo, European American",0,27,0,1,NA,5,2,0,0,1,0,0,TRUE,TRUE,TRUE,TRUE,TRUE,6,0.4314218750046566,0.40602187499869613,0.4065124999983236,0.5112218749960884,0.48259354838440494,0.5136906249998138,1,1,1,1,0.96875,1,0.114,0.285,0.961,0.012,1.491,31.002999874357023,1816.0492740831164,0.061,0.328,0.894,0.018,1.767,215.98946748402824,2045.6296678904985,0.081,0.337,0.853,0.02,1.75,69.27989715956731,1860.1737453558076,124.25,98.16666666666667,87.5,FALSE,312,0.9244444444444444,0,1,0,0,3,FALSE
294,2022-03-18T18:47:27Z,0.8999999761581421,1.7776427703523694,823,6,2,5,4,5,4,5,4,4,5,5,5,5,5,1,5,3,3,5,1,1,3,5,5,4,0,2,0,0,0,0,1,4,5,3,3,1,2,2,5,1,1,3,1,3,2,1,5,5,5,5,5,4,1,1,1,2,1,1,1,1,1,4,5,4,2,3,4,1,1,1,1,1,0,4.333333333333333,0,2.888888888888889,0,3.0833333333333335,0,1.6666666666666667,0,2.4285714285714284,0,3,0,2.675675675675676,0,0,0,0,1.1930189420054667,1.6361104972138785,-0.6189692744445258,0.5085706113846764,2,2,3,2,2,3,2,1,-0.21150737850196963,1,4,4,1,1,1,2,2,0,-0.698640248793604,0,-1.2085638767930065,3,3,5,5,5,2,5,5,3,4,4,3,1,5,3,5,3,4,5,3,4.2,0,3.2,0,4,0,3.8,0,3.6666666666666665,0,3,3,4,3,3,4,4,3,3,3,3,3,4,4,2,3,2,4,4,3,3.25,0,"White, Caucasian, Anglo, European American",0,24,1,3,NA,5,2,0,0,3,0,0,TRUE,TRUE,TRUE,TRUE,TRUE,2,0.556421875,0.4654781250022352,0.5379593750033528,0.6739800000091394,0.5602483870944669,0.6156655172315137,1,1,1,0.967741935483871,0.96875,0.9354838709677419,0.058,0.388,0.462,0.014,1.622,75.15597574028963,1925.3502016814928,0.072,0.363,0.731,0.02,2.032,53.86182491789344,1876.1704661062556,0.069,0.374,0.425,0.012,1.688,110.77904033242444,1935.5839655384416,115.85714285714286,101.6,140.66666666666666,FALSE,368,1.0903703703703704,0,1,0,0,3,FALSE
295,2022-03-18T18:43:48Z,1,1.6,1120,6,3,2,1,2,1,2,1,3,1,1,1,2,2,3,2,3,1,1,1,1,1,1,1,1,0,2,0,0,0,0,1,1,1,1,1,3,2,1,2,2,3,2,3,3,2,3,3,2,3,3,2,1,1,1,1,1,1,1,1,1,1,2,1,2,1,1,1,1,1,1,1,1,0,1.8,0,1.4444444444444444,0,2.5833333333333335,0,1,0,1.2857142857142858,0,1,0,1.6756756756756757,0,0,0,0,-0.9979973017325532,-0.9434707267777437,-0.6189692744445258,-0.7812200006111347,1,1,1,1,1,1,1,1,-0.9579186615539372,5,5,5,5,4,4,5,4.714285714285714,0,1.7281822263108981,0,1.740239078096883,2,2,2,2,2,4,4,3,4,4,5,2,5,4,4,4,4,4,3,3,2,0,3.8,0,4,0,3.6,0,3.8,0,1,1,2,1,2,2,2,2,1,2,1,3,1,2,1,2,1,2,1,2,1.6,0,"White, Caucasian, Anglo, European American",0,28,1,2,NA,5,2,0,0,1,0,0,TRUE,TRUE,TRUE,TRUE,TRUE,1,0.45230937500298024,0.467484375,0.528470000076294,0.5619100000063578,0.5553874999880791,0.6128156250268221,1,1,1,0.9375,1,1,0.214,0.277,0.893,0.021,1.865,31.649426847477027,1812.113161126613,0.088,0.345,0.754,0.015,1.676,58.15978540776762,1842.4375913012816,0.055,0.364,0.595,0.013,1.682,175.2657287268363,2038.5250329582896,88.80952380952381,111.73333333333333,129.3846153846154,FALSE,400,1.1851851851851851,0,1,0,21,24,FALSE
296,2022-03-18T18:50:12Z,0.8999999761581421,1.7777777777777777,864,6,2,5,4,3,3,2,2,5,5,5,3,4,5,1,5,4,4,5,5,1,4,5,5,4,4,1,2,1,0,0,2,5,4,5,5,4,3,3,4,2,4,5,4,5,4,5,4,5,5,5,3,5,2,4,5,4,1,1,3,1,1,2,2,3,1,1,5,2,4,2,1,2.25,0,3.7333333333333334,0,3.888888888888889,0,4.25,0,3.5,0,1.8571428571428572,0,2.3333333333333335,0,3.4324324324324325,0,2,0,1,2.171190358128747,2.032000940845574,1.1566543424609708,1.5943276416532723,1,1,4,1,1,1,1,2,-0.32231065268119236,3,3,3,2,1,1,3,2.2857142857142856,0,-0.24706573651580854,0,-0.7787092254625332,3,3,4,2,3,3,2,4,4,1,5,4,5,3,5,1,3,5,2,2,3,0,4,0,2.2,0,3.6,0,3.2666666666666666,0,1,2,1,1,2,1,3,3,1,1,2,1,1,1,1,2,1,1,1,2,1.45,0,"White, Caucasian, Anglo, European American",0,24,1,1,NA,5,2,0,0,1,0,0,TRUE,TRUE,TRUE,TRUE,TRUE,6,0.4942666666666667,0.42071875,0.52859375,0.53753125,0.47433333333333333,0.5758214285714286,0.967741935483871,1,1,1,0.9375,0.875,0.064,0.287,0.364,0.006,1.168,148.08081640094818,2044.7900883261775,0.062,0.287,0.499,0.023,1.897,89.20544896704753,1936.4246434476088,0.072,0.328,0.393,0.053,2.008,122.6653331338681,1955.5465582066197,194.66666666666666,82.47826086956522,37.88679245283019,FALSE,386,1.1437037037037037,0,1,0,0,3,FALSE
297,2022-03-18T18:57:21Z,0.8999999761581421,1.6,750,6,3,3,2,2,3,2,2,3,3,2,2,3,3,2,3,4,3,4,1,1,4,4,4,3,1,2,0,0,0,0,2,4,4,3,3,2,3,3,3,2,2,2,2,3,2,3,2,3,4,4,3,3,1,1,1,1,1,1,2,3,1,2,1,1,1,1,2,1,3,1,1,1.5,0,2.6,0,3,0,2.6666666666666665,0,1.3333333333333333,0,1.5714285714285714,0,1.3333333333333333,0,2.2162162162162162,0,1,0,0,0.6512962070672375,0.5150109075852244,-0.22730066264678367,0.14385512246922036,1,1,3,1,1,2,1,1,-0.7091149005366146,5,5,5,5,3,3,5,4.428571428571429,0,0.9333970970158285,0,1.1013384383681009,4,4,4,4,4,3,3,3,2,3,4,3,4,3,3,3,4,3,3,3,4,0,3.4,0,3.2,0,2.8,0,3.1333333333333333,0,2,2,3,3,3,3,3,3,2,2,3,3,2,3,2,4,1,3,2,2,2.55,0,"White, Caucasian, Anglo, European American",0,26,1,2,NA,5,2,0,0,1,0,0,TRUE,TRUE,TRUE,TRUE,TRUE,4,0.47767499999987195,0.41910624999995344,0.4565374999999767,0.5482906249997904,0.5187535714286247,0.5477516129032498,1,1,1,1,0.875,0.96875,0.079,0.292,0.48,0.018,1.697,91.89089021281968,1917.124551651636,0.054,0.308,0.434,0.015,1.632,96.8040056138982,1994.3656713365608,0.078,0.327,0.551,0.018,1.649,51.55534943422073,1836.7045289326763,94.27777777777779,108.8,91.61111111111111,TRUE,403,1.194074074074074,0,1,0,0,3,FALSE
298,2022-03-18T18:31:14Z,0.8999999761581421,1.7777777777777777,1440,6,3,1,2,2,2,2,1,3,2,1,1,1,2,2,1,1,2,2,1,1,1,1,1,2,0,2,0,0,0,0,1,1,3,1,2,1,1,1,1,2,2,1,1,3,2,2,1,1,1,1,1,1,1,1,1,2,1,1,1,3,1,2,1,1,1,1,1,2,1,2,2,1.75,0,1.6,0,1.3333333333333333,0,1.5,0,1.1666666666666667,0,1.4285714285714286,0,1,0,1.3513513513513513,0,0,0,0,-0.9650991599346849,-1.008665799834826,-0.3605105619019602,-0.6845881808683931,2,2,3,1,2,3,2,1.5,-0.10103984158003264,5,5,5,4,2,3,4,4,0,1.0808314045082337,0,0.958931103549576,2,2,1,3,2,4,4,5,5,5,5,4,5,3,4,5,5,5,4,5,2,0,4.6,0,4.6,0,4.4,0,4.533333333333333,0,3,1,2,4,4,4,3,4,3,2,4,3,3,2,1,3,1,4,1,3,2.75,0,Black or African American,0,29,1,2,NA,5,2,0,0,1,0,0,TRUE,TRUE,TRUE,TRUE,TRUE,3,0.5332612903228691,0.481593749998603,0.5017687499998137,0.5931290322566225,0.5192896551726194,0.5668066666662693,1,1,1,0.96875,0.90625,0.967741935483871,0.064,0.347,0.464,0.017,1.714,136.1448088011982,1960.2474715294932,0.05,0.361,0.47,0.024,1.688,79.08647172977095,1935.53427388407,0.057,0.393,0.437,0.019,1.492,90.64703618945,1917.7641524496091,100.8235294117647,70.33333333333333,78.52631578947368,FALSE,365,1.0814814814814815,0,1,0,3,6,FALSE
299,2022-03-18T19:02:39Z,1,1.6,900,3,4,2,2,2,2,2,2,2,2,2,2,2,2,2,2,2,2,1,3,1,1,2,2,1,2,1,1,0,1,0,2,2,2,1,1,1,1,1,1,2,2,1,1,2,2,2,2,2,1,1,2,3,1,4,1,3,1,1,2,1,1,1,1,1,1,1,1,1,2,2,2,1.75,0,2,0,1.3333333333333333,0,1.6666666666666667,0,2.1666666666666665,0,1.1428571428571428,0,1,0,1.5135135135135136,0,1,0,0,-0.6975276066453571,-0.6540754024836353,-0.14114775846592847,-0.39761158047478184,2,2,3,2,1,3,3,1.5,-0.01810525457425849,4,4,4,4,3,3,4,3.7142857142857144,0,0.5809148901979743,0,0.4996318456278071,3,3,3,3,3,3,2,3,3,4,2,2,3,3,2,2,2,4,2,2,3,0,2.6,0,2.6,0,2.6,0,2.6,0,1,1,1,3,2,1,2,3,1,1,2,3,1,1,1,3,1,2,1,2,1.65,0,"Asian or Asian American (e.g., Chinese, Japanese, and others)",0,20,1,2,NA,5,2,0,0,1,0,0,TRUE,TRUE,TRUE,TRUE,TRUE,3,0.6875281249955296,0.6253749999850988,0.5836161290599454,0.770459374986589,0.6747124999985099,0.7101000000163913,1,1,1,1,1,1,0.124,0.408,0.681,0.012,1.573,96.98797736286944,1880.966521801336,0.124,0.389,0.501,0.033,1.176,53.454476200642155,1834.4410426701036,0.107,0.422,0.416,0.016,1.556,37.81271785058971,1822.3570543890328,131.08333333333331,35.63636363636363,97.25,FALSE,432,1.28,0,1,0,0,3,FALSE
300,2022-03-18T18:53:00Z,0.800000011920929,1.6,900,4,1,4,3,4,4,4,5,4,3,3,3,4,4,3,3,4,4,4,3,2,4,3,5,4,1,2,0,0,0,0,3,4,2,5,5,5,4,5,5,4,4,4,3,4,3,1,5,5,5,3,5,3,2,3,2,4,5,4,2,1,1,4,5,4,4,4,4,2,3,1,1,1.75,0,3.6666666666666665,0,4.222222222222222,0,3.8333333333333335,0,3.1666666666666665,0,3,0,4,0,3.675675675675676,0,1,0,0,2.0045064396862147,1.890794115943658,-0.14114775846592847,0.8748231787388648,3,2,3,2,2,2,2,3.5,0.755503241136586,2,2,2,2,1,1,2,1.7142857142857142,0,-1.1321657682664374,0,-1.6274250758424933,3,2,2,4,3,3,5,4,4,3,5,3,3,5,4,2,4,5,5,3,2.8,0,4,0,3.6,0,4,0,3.8666666666666667,0,2,3,3,3,4,3,3,3,3,1,4,3,2,3,1,3,1,2,4,3,2.7,0,"White, Caucasian, Anglo, European American",0,29,1,2,NA,5,2,1,0,0,0,1,TRUE,TRUE,TRUE,TRUE,TRUE,5,0.4429062500018626,0.41756129031892747,0.4424906249977648,0.5235333333335541,0.5157777777777778,0.5091071428635291,1,0.96875,1,0.84375,0.84375,0.875,0.049,0.347,0.429,0.032,2.019,118.44253866491972,2044.0598836479687,0.045,0.325,0.455,0.019,1.955,97.96861576088388,2001.0871674688556,0.053,0.349,0.592,0.016,1.743,24.176736521452018,1885.178550672652,63.09375,102.89473684210527,108.9375,FALSE,328,0.9718518518518519,0,1,0,0,3,FALSE
302,2022-03-18T19:06:16Z,0.8999999761581421,1.7777777777777777,864,3,3,2,2,2,2,2,1,3,2,3,1,1,2,2,2,2,1,1,1,1,1,1,1,1,0,2,0,0,0,0,1,2,1,1,1,2,2,2,2,2,2,2,1,3,1,2,2,2,2,1,3,2,1,1,1,2,1,1,1,1,1,2,2,1,1,1,1,1,1,1,1,1,0,1.9333333333333333,0,1.5555555555555556,0,1.9166666666666667,0,1.3333333333333333,0,1.2857142857142858,0,1,0,1.5405405405405406,0,0,0,0,-1.0857256798602015,-0.9442573943259439,-0.6189692744445258,-0.7816133343852348,2,1,3,1,1,2,2,1,-0.5432457265250663,5,5,5,5,2,2,5,4.142857142857143,0,0.5451397626206321,1,0.7100496162304737,3,3,2,3,2,3,3,3,3,2,3,2,3,2,3,3,2,4,3,3,2.6,0,2.8,0,2.8,0,2.8,0,2.8,0,2,2,1,4,1,1,1,3,1,2,2,1,2,2,2,1,1,2,2,1,1.7,0,"White, Caucasian, Anglo, European American",0,19,1,2,NA,5,2,0,0,0,0,0,TRUE,TRUE,TRUE,TRUE,TRUE,6,0.5438774193794497,0.43875312501192093,0.4697677418801092,0.6175599999427795,0.5232066665967305,0.583278125077486,0.96875,1,0.96875,0.967741935483871,0.967741935483871,1,0.094,0.315,0.617,0.013,1.736,146.73134844656732,1970.1228268424595,0.062,0.342,0.669,0.019,1.767,103.94321284261189,1944.213234669664,0.057,0.403,0.397,0.016,1.454,148.94595750880072,2018.8592513890408,133.53846153846155,93,90.875,FALSE,304,0.9007407407407407,1,1,0,0,3,FALSE
303,2022-03-18T19:09:06Z,0.8999999761581421,1.7777777777777777,1440,4,3,2,2,3,2,3,2,4,2,2,2,2,2,2,2,3,2,2,1,1,2,2,2,2,2,2,0,0,0,0,2,2,3,2,3,1,1,1,1,2,1,2,1,2,1,2,1,1,2,3,2,2,1,1,1,2,1,1,3,3,1,1,1,1,1,1,1,1,1,2,2,1.5,0,2.3333333333333335,0,1.7777777777777777,0,1.6666666666666667,0,1.3333333333333333,0,1.5714285714285714,0,1,0,1.5675675675675675,0,1,0,0,-0.5812875056262229,-0.4303668184642345,-0.22730066264678367,-0.32883374055550907,3,3,3,3,3,4,4,2,0.7558389783938718,5,5,5,5,2,2,5,4.142857142857143,0,0.1625358753388918,0,0.4770095999368606,3,2,3,2,3,4,3,4,4,4,4,4,3,4,4,3,3,4,2,2,2.6,0,3.8,0,3,0,3.6,0,3.466666666666667,0,1,1,1,4,1,1,1,2,1,1,1,2,1,3,1,3,2,2,1,1,1.55,0,"White, Caucasian, Anglo, European American",0,21,0,2,NA,5,2,0,0,1,0,0,TRUE,TRUE,TRUE,TRUE,TRUE,5,0.5209281250014901,0.4428354838740441,0.46337500000186266,0.5653781249988824,0.5264032258083744,0.5530593750085682,1,1,1,1,1,1,0.118,0.29,0.688,0.01,1.203,53.9187263086425,1839.4552776150224,0.104,0.322,0.84,0.018,1.593,39.12321060261995,1820.7117157018597,0.076,0.39,0.598,0.038,1.958,56.57069439855261,1839.4098872141624,120.30000000000001,88.5,51.526315789473685,FALSE,372,1.1022222222222222,0,1,0,3,6,FALSE
305,2022-03-18T18:37:50Z,0.8999999761581421,1.7777777777777777,1080,6,5,4,2,1,4,1,1,4,1,1,2,1,2,1,2,3,1,2,2,1,2,1,1,1,2,2,0,0,0,0,2,3,2,2,3,3,2,2,2,1,2,1,1,2,3,2,1,2,2,1,3,2,2,1,1,3,1,1,1,2,1,2,1,2,1,1,1,2,1,2,2,1.75,0,2,0,2.3333333333333335,0,1.75,0,1.6666666666666667,0,1.4285714285714286,0,1,0,1.7567567567567568,0,1,0,0,-0.7019140255517393,-0.6570254057893857,-0.14114775846592847,-0.39908658212765713,2,1,3,1,2,1,1,1.5,-0.4327781896031293,4,4,5,4,4,4,4,4.142857142857143,0,1.7281822263108981,0,1.4306283771341746,1,1,2,1,2,5,3,5,5,3,5,4,4,3,4,5,4,3,4,2,1.4,0,4.2,0,3.8,0,3.8,0,3.933333333333333,0,1,2,1,4,2,2,1,2,1,1,1,2,2,1,1,2,1,2,1,1,1.55,0,"White, Caucasian, Anglo, European American",0,29,1,2,NA,5,2,0,0,1,0,0,TRUE,TRUE,TRUE,TRUE,TRUE,4,0.5295161290322581,0.48453125,0.49235483870967744,0.6156774193548387,0.5700714285714286,0.5527777777777778,0.96875,1,0.96875,0.96875,0.875,0.84375,0.048,0.377,0.44,0.005,1.021,167.8229599462823,2117.8087018399624,0.052,0.382,0.526,0.007,1.154,54.89578686215596,1952.0326125125464,0.059,0.413,0.488,0.024,1.888,162.54957287031934,2029.880480035274,204.2,164.85714285714283,78.66666666666666,FALSE,320,0.9481481481481481,0,1,0,0,3,FALSE
306,2022-03-18T19:04:27Z,0.8999999761581421,1.7777777777777777,1080,2,2,4,3,3,4,3,2,4,4,5,4,3,4,2,3,5,3,4,1,2,3,4,4,4,0,1,0,0,1,0,3,3,4,3,3,3,5,5,5,2,4,3,1,3,5,3,4,4,4,4,4,3,1,1,1,3,2,3,1,2,1,3,1,2,2,3,3,2,2,1,3,2,0,3.533333333333333,0,3.7777777777777777,0,3.4166666666666665,0,1.8333333333333333,0,1.8571428571428572,0,2.6666666666666665,0,2.891891891891892,0,0,0,0,1.1710868474735547,1.2720800892842867,-0.274357657721105,0.49886121578159087,2,3,5,2,1,2,2,1,-0.1285727914961955,2,2,3,2,1,1,2,1.8571428571428572,0,-0.8792700537047221,0,-1.3959862723733312,3,3,4,2,3,3,2,2,3,3,4,3,4,4,3,3,4,5,3,2,3,0,3.8,0,3,0,2.8,0,3.2,0,1,1,2,3,3,3,3,3,2,2,2,2,1,2,1,3,1,2,2,4,2.15,0,"White, Caucasian, Anglo, European American",0,25,0,3,NA,5,2,0,0,0,0,0,TRUE,TRUE,TRUE,TRUE,TRUE,5,0.48307419355838527,0.3985031250044703,0.4356031249947846,0.5289965517233158,0.5157071428639548,0.5036548387081392,0.96875,1,1,0.90625,0.875,0.96875,0.058,0.336,0.675,0.022,1.941,96.19545371497884,1923.594260131759,0.061,0.296,0.614,0.015,1.908,34.67537085112686,1898.432012643045,0.046,0.382,0.545,0.021,1.808,161.44168626372544,2063.275159340038,88.22727272727273,127.2,86.09523809523809,FALSE,282,0.8355555555555556,0,1,0,3,6,FALSE
307,2022-03-18T19:16:03Z,0.8999999761581421,1.6,800,6,3,2,2,2,2,2,2,2,2,2,2,2,2,2,2,2,2,2,1,1,2,2,2,2,3,2,0,0,0,0,1,1,2,2,2,2,2,2,2,2,4,2,2,2,2,2,2,2,2,2,2,3,2,1,1,3,2,2,2,2,1,2,2,2,2,2,1,2,2,2,2,2,0,2,0,1.7777777777777777,0,2.1666666666666665,0,2,0,1.8571428571428572,0,1.6666666666666667,0,1.945945945945946,0,2,0,0,-0.3356480468688072,-0.4107001297592323,0.16436794915095845,-0.12316609030413693,2,2,3,2,2,2,2,1,-0.29444196550774376,4,4,4,4,2,2,3,3.2857142857142856,0,-0.17479982686521142,0,-0.19287409088895574,2,2,2,2,2,4,4,4,4,4,4,4,4,4,3,4,4,3,3,2,2,0,3.8,0,3.8,0,3.4,0,3.6666666666666665,0,1,2,1,4,1,1,2,4,1,1,1,2,1,1,1,2,1,1,1,1,1.5,0,"White, Caucasian, Anglo, European American",0,24,1,2,NA,5,2,0,0,1,0,0,TRUE,TRUE,TRUE,TRUE,TRUE,3,0.6745032257956843,0.5562218749858439,0.6554124999903143,0.7346562499813736,0.6244967742043157,0.7302531249932945,0.96875,1,1,1,0.96875,1,0.161,0.446,0.755,0.012,1.156,41.83201017479568,1825.056045630995,0.106,0.42,0.772,0.014,1.317,150.65154955107997,1983.4780677210483,0.067,0.535,0.455,0.028,1.669,103.92385012057962,1931.7505644778053,96.33333333333333,94.07142857142857,59.607142857142854,FALSE,361,1.0696296296296297,0,1,1,3,6,FALSE
309,2022-03-18T19:13:55Z,1,1.7777777777777777,1080,4,1,1,3,1,2,1,1,1,1,1,1,1,1,1,1,5,1,1,1,1,1,1,1,1,1,2,0,0,0,0,2,5,5,3,4,2,5,3,5,1,1,1,1,5,1,5,3,1,1,1,1,5,1,5,1,1,1,1,1,1,1,2,2,2,3,4,1,1,1,2,1,1.25,0,1.4666666666666666,0,3.7777777777777777,0,1.8333333333333333,0,2.3333333333333335,0,1.4285714285714286,0,2.6666666666666665,0,2.3783783783783785,0,1,0,0,-0.5418097354687811,-0.7822038793967251,-0.31345356682763886,-0.547828723112182,1,1,5,1,1,1,1,1,-0.6261803135308405,2,2,2,5,1,1,1,2,0,-0.804101655862914,0,-1.272799314117985,1,1,1,1,1,5,3,2,5,3,2,3,4,2,4,4,3,4,1,2,1,0,3.4,0,3,0,3,0,3.1333333333333333,0,1,1,1,1,1,1,1,3,1,1,1,2,1,2,1,1,1,1,1,1,1.2,0,"White, Caucasian, Anglo, European American",0,20,0,1,NA,5,2,0,0,1,0,0,TRUE,TRUE,TRUE,TRUE,TRUE,4,0.417625,0.337,0.422875,0.4835625,0.41510714285714284,0.47238709677419355,1,1,1,1,0.9032258064516129,0.96875,0.058,0.325,0.605,0.018,1.37,108.96587005387002,1935.6235523555663,0.05,0.278,0.882,0.022,1.803,27.031806400430323,1884.1808294319371,0.085,0.309,0.835,0.031,1.99,39.4257559417793,1823.111422337421,76.11111111111113,81.95454545454545,64.19354838709677,FALSE,320,0.9481481481481481,0,1,0,3,6,FALSE
310,2022-03-18T19:06:14Z,0.8999999761581421,1.6,800,3,3,4,3,4,2,3,3,3,3,2,3,3,3,4,3,2,3,3,1,3,3,3,3,3,3,1,2,0,4,0,2,3,2,2,3,2,2,3,2,1,3,2,1,3,4,2,2,2,4,3,3,2,1,1,1,2,2,2,3,3,3,2,2,2,2,4,1,2,3,3,3,2.75,0,3,0,2.3333333333333335,0,2.5,0,1.5,0,2.4285714285714284,0,2.3333333333333335,0,2.27027027027027,0,2,0,0,0.5240900587821474,0.6041010074188848,0.42282666169352406,0.5134638345562045,3,3,4,2,3,3,4,3,1.05970863924352,4,4,4,3,3,3,3,3.4285714285714284,0,-0.10840883202778547,0,-0.07503335677599673,3,2,3,4,3,3,4,3,3,3,4,3,4,3,3,5,3,3,3,3,3,0,3.2,0,3.8,0,3,0,3.3333333333333335,0,2,3,2,2,2,1,2,2,1,1,2,2,2,2,1,3,1,2,1,1,1.75,0,"Hispanic of Latino (e.g., Mexican American, Central American, and others)",0,29,0,1,NA,5,2,0,0,1,0,0,TRUE,TRUE,TRUE,TRUE,TRUE,3,0.6002612903291179,0.6436749999951571,0.597009374992922,0.686400000001703,0.7170322580664389,0.6891600000123183,1,1,1,0.875,1,0.967741935483871,0.088,0.448,0.658,0.015,1.754,90.58926010633438,1918.8889831871184,0.081,0.457,0.406,0.028,1.791,60.37604125311207,1842.251610312115,0.061,0.464,0.478,0.016,1.925,48.116216146973294,1910.6654501021349,116.93333333333334,63.96428571428571,120.3125,FALSE,514,1.522962962962963,0,1,0,3,6,FALSE
311,2022-03-18T19:11:52Z,0.8999999761581421,1.7777777777777777,1080,3,4,5,2,2,1,1,1,2,1,3,1,1,2,1,1,2,2,2,1,1,1,1,3,1,1,2,0,0,0,0,1,1,1,1,1,2,1,2,2,1,1,1,1,2,1,1,1,1,1,1,1,1,1,1,1,1,1,1,3,3,3,1,1,1,1,1,1,1,1,1,1,1,0,1.7333333333333334,0,1.3333333333333333,0,1.0833333333333333,0,1,0,1.8571428571428572,0,1,0,1.2702702702702702,0,1,0,0,-0.9365874370431991,-0.9312773797806423,-0.39960647100849406,-0.6654419253945681,2,1,3,1,1,4,3,1,-0.29444196550774376,5,5,5,5,4,4,5,4.714285714285714,0,1.8727898102465754,1,1.8283180413190596,3,3,3,1,3,4,2,4,5,2,4,2,2,2,4,4,2,1,1,3,2.6,0,2.6,0,2.2,0,3.6,0,2.8,0,1,4,2,2,1,2,3,4,3,2,4,4,3,2,1,3,3,2,4,3,2.65,0,Prefer not to say,0,21,3,5,NA,5,2,0,0,1,0,0,TRUE,TRUE,TRUE,TRUE,TRUE,6,0.5680677419247165,0.5313531249687076,0.6060387096481938,0.6394218750223517,0.6205781249850988,0.6102032257818406,1,1,1,1,1,0.96875,0.067,0.37,0.357,0.025,1.957,124.38498993295384,1950.382241716611,0.088,0.312,0.415,0.023,1.879,50.33097449111316,1835.0180771658072,0.097,0.337,0.406,0.028,1.637,31.764148978265737,1812.6236120538372,78.28,81.69565217391305,58.464285714285715,FALSE,304,0.9007407407407407,1,1,0,0,3,FALSE
312,2022-03-18T19:03:33Z,1,1.6,900,6,4,2,2,2,2,3,1,2,2,2,1,3,2,1,2,2,2,2,1,1,1,2,1,1,2,2,0,0,0,0,2,4,1,2,3,2,2,3,2,1,3,1,1,1,2,2,2,2,3,1,3,2,1,1,1,1,1,1,2,1,1,1,2,2,1,2,1,1,1,2,2,1.5,0,1.9333333333333333,0,2.3333333333333335,0,1.8333333333333333,0,1.1666666666666667,0,1.4285714285714286,0,1.3333333333333333,0,1.7297297297297298,0,1,0,0,-0.7194597011772692,-0.6979321182957905,-0.22730066264678367,-0.4626163904712871,1,2,2,1,1,1,1,1,-0.7920494875423887,5,5,5,5,3,3,4,4.285714285714286,0,1.475286511749183,0,1.3539949241463662,2,3,3,1,2,4,4,4,4,3,4,4,4,4,4,3,4,4,3,3,2.2,0,4,0,3.4,0,3.8,0,3.7333333333333334,0,2,1,2,2,2,2,2,3,1,2,2,2,2,3,1,2,1,2,1,2,1.85,0,"White, Caucasian, Anglo, European American",0,23,0,1,NA,5,2,0,0,0,0,0,TRUE,TRUE,TRUE,TRUE,TRUE,3,0.5938968749493361,0.4969625000208616,0.5823937499821186,0.6537000000317892,0.5670562499314546,0.6204687499701976,1,1,1,0.9375,1,1,0.085,0.372,0.44,0.02,1.49,84.01635531013955,1865.9010391096667,0.079,0.346,0.551,0.016,1.272,163.95859072303938,1955.328525480283,0.063,0.399,0.302,0.02,1.593,72.17746191541261,1940.041490177404,74.5,79.5,79.64999999999999,FALSE,516,1.528888888888889,0,1,0,0,3,FALSE
313,2022-03-18T19:15:14Z,0.8999999761581421,1.7777777777777777,864,6,2,3,3,5,3,5,1,5,3,3,4,3,4,2,4,5,2,4,1,1,3,3,3,4,1,2,0,0,0,0,4,5,5,5,5,2,5,5,4,2,2,2,1,3,3,4,5,3,3,3,3,5,1,5,1,4,3,1,2,1,1,2,5,4,1,3,2,2,2,1,1,1.5,0,3.533333333333333,0,4.444444444444445,0,2.8333333333333335,0,3.1666666666666665,0,2.2857142857142856,0,2,0,3.108108108108108,0,1,0,0,0.9868572534054928,1.148179950442772,-0.22730066264678367,0.4604396438979942,4,4,5,3,2,3,2,3,1.142643226249294,3,3,5,4,1,1,2,2.7142857142857144,0,-0.511565577638634,1,-0.707605279792704,3,3,3,2,3,3,1,2,4,1,3,3,4,3,3,5,3,4,1,3,2.8,0,3.2,0,2.4,0,3,0,2.8666666666666667,0,1,1,1,1,2,1,2,4,1,1,3,2,1,1,1,1,1,1,1,2,1.45,0,"White, Caucasian, Anglo, European American",0,30,1,3,NA,5,2,1,0,1,0,1,TRUE,TRUE,TRUE,TRUE,TRUE,2,0.506362500000745,0.5187281250022352,0.47487187499552963,0.5830199999968211,0.5816400000055632,0.5831807692326032,1,1,1,0.9375,0.967741935483871,0.8125,0.062,0.359,0.597,0.014,1.987,109.53165358132102,1967.5263009177147,0.062,0.401,0.547,0.026,1.796,36.58969076380355,1863.0807023160985,0.066,0.367,0.534,0.015,1.755,128.2492594269969,1973.7707352773011,141.92857142857144,69.07692307692308,117,FALSE,396,1.1733333333333333,0,1,0,0,3,FALSE
314,2022-03-18T19:09:16Z,0.8999999761581421,1.7777777777777777,1080,3,3,1,1,3,1,2,3,3,3,1,1,1,2,1,2,2,2,1,2,1,1,3,1,3,2,2,0,0,0,0,1,3,4,1,2,2,1,1,3,3,2,2,1,2,1,1,4,1,3,1,1,2,2,1,2,4,2,1,2,1,1,4,4,3,2,2,1,2,2,1,1,1.5,0,1.8,0,2,0,1.8333333333333333,0,2.1666666666666665,0,2.2857142857142856,0,1.6666666666666667,0,2,0,1,0,0,-0.3005566956177479,-0.4744202011634396,-0.22730066264678367,-0.3508604319051116,1,1,4,1,1,3,1,1.5,-0.3498436025973552,4,4,4,4,3,2,3,3.4285714285714284,0,0.25285077779445086,0,0.14500608390329842,4,1,2,5,3,3,5,4,3,5,3,3,1,3,5,5,2,3,4,3,3,0,2.8,0,4,0,3.6,0,3.466666666666667,0,1,1,4,3,3,4,4,3,3,1,1,3,1,4,4,4,1,3,4,2,2.7,0,"White, Caucasian, Anglo, European American",0,21,0,1,NA,5,2,0,0,1,0,0,TRUE,TRUE,TRUE,TRUE,TRUE,2,0.6768709677457809,0.6697281250134111,0.6329499999992549,0.8342000000067056,0.680800000000745,0.7377718750052153,1,1,1,1,1,1,0.108,0.36,0.374,0.031,2.002,117.97277214891469,1904.167109168779,0.129,0.333,0.402,0.053,1.409,49.35500365643067,1832.2754653851064,0.123,0.387,0.402,0.015,1.644,67.88828724835507,1850.3744367686063,64.58064516129032,26.58490566037736,109.6,FALSE,328,0.9718518518518519,0,0,0,3,6,FALSE
315,2022-03-18T19:24:22Z,1,1.7777777777777777,1080,4,2,4,2,4,3,3,3,3,2,2,2,1,2,1,2,2,4,3,4,1,1,3,2,1,2,1,1,1,2,2,1,2,1,1,1,1,1,1,1,2,2,2,1,1,2,1,1,1,2,3,2,4,4,1,2,2,2,2,2,1,1,1,1,2,1,2,2,2,2,1,1,1.5,0,2.4,0,1.1111111111111112,0,1.6666666666666667,0,2.5,0,1.4285714285714286,0,1.6666666666666667,0,1.6216216216216217,0,1,2,1,-0.1404524055347893,-0.10478478695292218,2.0775628493833422,0.98638903121521,2,2,4,1,1,2,1,2,-0.07350689166386981,4,4,4,4,1,1,3,3,0,-1.2405296635269585,0,-0.9968043111272092,2,3,2,2,2,4,4,4,4,1,5,5,4,4,5,3,5,5,2,2,2.2,0,4.8,0,2.8,0,3.8,0,3.8,0,1,2,2,2,2,1,3,1,1,2,2,1,2,2,1,2,1,2,2,2,1.7,0,"Hispanic of Latino (e.g., Mexican American, Central American, and others)",0,19,0,1,NA,5,2,0,0,1,0,0,TRUE,TRUE,TRUE,TRUE,TRUE,1,0.54265625,0.45428125,0.4852666666666667,0.57284375,0.49989655172413794,0.5268387096774194,1,1,0.9375,1,0.90625,0.96875,0.054,0.329,0.297,0.027,1.869,230.89375007764457,2145.5693428862132,0.054,0.342,0.548,0.025,1.961,78.87442635395323,1935.4518813234783,0.219,0.214,0.682,0.035,1.836,92.6110450595517,1876.6329909290184,69.22222222222223,78.44,52.457142857142856,FALSE,488,1.4459259259259258,0,1,0,3,6,FALSE
316,2022-03-18T19:00:42Z,0.8999999761581421,1.7777777777777777,1080,6,3,4,1,2,2,1,2,2,1,1,1,1,1,2,2,2,5,1,1,2,1,1,1,1,2,2,0,0,0,0,2,1,1,1,1,1,1,1,1,2,1,1,2,2,2,1,3,2,2,2,2,1,1,1,1,3,2,2,2,2,2,2,1,1,2,2,1,2,2,2,2,2,0,1.6666666666666667,0,1.1111111111111112,0,1.8333333333333333,0,1.5,0,1.7142857142857142,0,1.6666666666666667,0,1.5675675675675675,0,1,0,0,-0.6624362553942977,-0.7760088724546493,-0.05499485428507328,-0.4155018633698613,1,1,3,1,1,1,2,1.5,-0.5157127766089035,5,5,5,5,3,4,4,4.428571428571429,0,0.6473058850354002,0,0.9270832807034747,1,1,2,2,1,5,5,5,5,4,4,4,4,4,5,5,4,4,5,3,1.4,0,4.2,0,4.6,0,4.4,0,4.4,0,1,1,1,2,1,2,1,1,1,1,2,1,2,1,1,2,1,2,1,1,1.3,0,"White, Caucasian, Anglo, European American",0,26,0,1,NA,5,2,0,0,1,0,0,TRUE,TRUE,TRUE,TRUE,TRUE,5,0.610653124999255,0.5126156249959022,0.5970156250055879,0.6235666666785876,0.5825137931067368,0.6719741935480026,1,1,1,0.967741935483871,0.9666666666666667,1,0.082,0.394,0.419,0.012,1.214,80.26852391671294,1861.899975791754,0.083,0.363,0.581,0.017,1.498,147.32678973279224,1977.5870584016589,0.067,0.418,0.392,0.019,1.326,87.8766692808758,1914.8597455628585,101.16666666666666,88.11764705882352,69.78947368421053,FALSE,438,1.2977777777777777,0,1,0,0,3,FALSE
317,2022-03-18T19:22:26Z,0.8999999761581421,1.6,800,6,4,5,1,2,2,1,1,1,1,1,2,1,1,1,1,2,1,1,1,2,1,1,1,1,1,2,0,0,0,0,2,1,2,1,1,2,1,2,1,1,3,4,1,2,1,1,1,4,3,2,3,1,1,2,1,2,1,1,2,3,1,1,1,1,1,1,1,4,2,2,2,2.5,0,1.5333333333333334,0,1.4444444444444444,0,2.1666666666666665,0,1.3333333333333333,0,1.4285714285714286,0,1,0,1.6216216216216217,0,1,0,0,-0.9519399032155373,-1.0289224892009785,0.11731095407663712,-0.45580576756217067,1,1,2,1,1,1,1,1.5,-0.6815819506204519,5,4,4,5,4,3,5,4.285714285714286,0,0.005829978045906746,0,0.4589643561354318,1,1,1,1,1,4,3,1,5,1,5,5,5,3,4,3,5,5,3,1,1,0,4.8,0,3,0,2.8,0,3.533333333333333,0,1,1,1,1,1,1,4,1,1,2,1,1,2,1,1,1,1,1,1,1,1.25,0,"White, Caucasian, Anglo, European American",0,27,0,1,NA,5,2,0,0,1,0,0,TRUE,TRUE,TRUE,TRUE,TRUE,1,0.8568333333333333,0.6058064516129033,0.6137096774193549,0.8770645161290322,0.6008709677419355,0.6408,0.9375,0.96875,0.96875,0.96875,1,0.967741935483871,0.061,0.446,0.367,0.025,1.79,195.48906473905973,2061.0336265173723,0.071,0.398,0.34,0.252,1.614,73.4610600676985,1900.7501096906988,0.076,0.533,0.202,0.275,1.849,89.3002913953145,1977.3383486156256,71.6,6.404761904761905,6.723636363636363,FALSE,338,1.0014814814814814,0,1,0,0,3,FALSE
318,2022-03-18T19:32:13Z,0.8999999761581421,1.7777777777777777,1080,4,2,3,3,4,3,5,4,2,3,3,2,4,3,2,3,5,3,2,3,4,3,4,4,4,2,1,2,2,1,1,2,2,2,2,2,2,2,2,2,2,3,1,2,3,3,2,5,4,4,2,3,3,4,2,3,3,3,2,2,2,1,2,2,3,1,1,2,2,2,2,3,2.25,0,3.2666666666666666,0,2,0,2.8333333333333335,0,3,0,2,0,1.3333333333333333,0,2.3783783783783785,0,1,1,2,1.0000165101246405,1.0406031632264099,2.5427900396045806,1.7916966014154951,3,2,3,1,1,1,1,1,-0.5432457265250663,4,4,4,4,2,2,4,3.4285714285714284,0,-0.33738063897136766,0,-0.21449768370694006,4,4,4,4,4,2,4,1,2,2,2,2,4,3,4,1,2,3,4,5,4,0,2.2,0,3,0,3,0,2.7333333333333334,0,2,3,3,4,4,4,3,3,4,4,4,4,2,3,1,4,2,4,3,3,3.2,0,"White, Caucasian, Anglo, European American",0,20,0,1,NA,5,2,0,0,0,0,0,TRUE,TRUE,TRUE,TRUE,TRUE,4,0.4406250000074506,0.3630062500089407,0.3903593749850988,0.5540375000052155,0.4446100000063578,0.5532137930968712,1,1,1,1,0.9375,0.90625,0.085,0.276,0.757,0.012,1.904,70.84060957508711,1934.1287215702357,0.052,0.289,0.741,0.013,1.501,103.3218224574208,1958.898059967524,0.106,0.295,0.716,0.02,1.898,219.0095802098594,2007.9106274716607,158.66666666666666,115.46153846153845,94.89999999999999,FALSE,348,1.031111111111111,0,1,0,3,6,FALSE
319,2022-03-18T19:19:30Z,0.8999999761581421,1.7777777777777777,720,4,3,4,3,1,2,2,1,3,2,1,1,1,1,1,2,4,1,3,4,1,1,1,1,1,2,2,0,0,0,0,1,4,5,3,4,4,5,2,5,2,1,3,1,4,1,4,1,1,1,1,1,3,3,4,2,5,2,1,2,1,1,1,2,1,2,3,1,2,2,2,1,1.75,0,1.9333333333333333,0,3.6666666666666665,0,1.75,0,3.1666666666666665,0,1.2857142857142858,0,2,0,2.3783783783783785,0,1,0,0,-0.13606598662840672,-0.30558167863099506,-0.14114775846592847,-0.22336471854846177,3,3,5,4,3,1,2,3.5,1.170176176165457,2,5,5,3,3,4,2,3.4285714285714284,0,-0.6415208437567579,0,-0.3997462936525523,2,2,3,4,4,5,4,4,4,1,3,4,2,2,3,3,2,2,3,3,3,0,3.2,0,2.6,0,3.2,0,3,0,1,2,2,4,1,1,2,4,1,2,3,3,2,1,1,1,1,1,2,2,1.85,0,Black or African American,0,20,0,1,NA,5,2,0,0,0,0,0,TRUE,TRUE,TRUE,TRUE,TRUE,6,0.5874483870940823,0.5753906250018627,0.5650906249983236,0.6205812499979511,0.5914322580656698,0.5967187499981373,1,1,1,1,1,1,0.113,0.389,0.679,0.029,1.454,72.71927996677445,1859.2907564936263,0.09,0.374,0.532,0.019,1.313,72.8873144351077,1854.4638508224791,0.101,0.408,0.567,0.034,1.369,61.27471442352384,1845.162409647892,50.137931034482754,69.10526315789474,40.264705882352935,FALSE,354,1.0488888888888888,0,1,0,0,3,FALSE
320,2022-03-18T19:27:19Z,1,1.7777777777777777,864,3,4,2,1,3,2,3,3,2,2,2,2,2,2,2,3,3,1,1,1,1,1,2,3,1,1,2,0,0,0,0,1,1,1,1,1,1,1,1,1,1,1,1,1,2,1,1,3,1,2,2,2,1,1,1,1,1,1,1,2,2,1,2,2,2,1,1,1,1,2,1,2,1.5,0,2.2666666666666666,0,1,0,1.5,0,1,0,1.7142857142857142,0,1,0,1.2972972972972974,0,1,0,0,-1.000190511185744,-0.7411988334467955,-0.22730066264678367,-0.48424974804678955,1,1,1,1,1,2,1,1,-0.874984074548163,5,5,5,5,3,3,5,4.428571428571429,0,1.351776111874911,0,1.3561687097810788,1,2,2,2,2,4,3,3,4,3,5,4,4,4,4,3,4,4,3,2,1.8,0,4.2,0,3.2,0,3.4,0,3.6,0,1,1,1,1,2,1,2,1,1,1,1,1,1,2,1,1,1,1,1,1,1.15,0,"White, Caucasian, Anglo, European American",0,19,1,2,NA,5,2,0,0,1,0,0,TRUE,TRUE,TRUE,TRUE,TRUE,1,0.6223718750104308,0.5138062499985099,0.649800000000745,0.768465624999255,0.592584375012666,0.7210406250096858,1,1,1,1,1,1,0.169,0.276,0.458,0.02,1.687,61.37494503658391,1843.7262688447245,0.093,0.333,0.541,0.017,1.698,82.63384651442843,1865.6732942007875,0.154,0.281,0.44,0.011,1.597,26.79972150311478,1809.1243003973332,84.35,99.88235294117646,145.1818181818182,FALSE,336,0.9955555555555555,0,1,0,0,3,FALSE
321,2022-03-18T19:32:24Z,0.699999988079071,1.6,900,4,2,3,3,3,3,3,3,4,3,3,2,2,4,3,3,4,4,1,1,1,3,2,2,2,12,2,0,0,0,0,4,3,4,3,2,3,3,4,3,2,3,2,2,4,3,4,2,2,3,3,3,4,3,3,2,3,3,2,3,3,3,2,2,3,3,2,3,4,3,3,3,3.25,0,3.066666666666667,0,3.2222222222222223,0,2.75,0,3,0,2.5714285714285716,0,2.6666666666666665,0,2.864864864864865,0,6,0,0,0.4232024239353518,0.5653576306700305,1.4725836837993613,1.018970657234696,3,3,5,2,3,3,3,2.5,0.8663065153158088,1,2,2,2,1,1,1,1.4285714285714286,0,-0.822150648667876,0,-1.5934034673616795,3,3,3,3,4,3,4,4,3,2,2,2,3,3,3,2,4,4,4,3,3.2,0,3,0,3,0,3.2,0,3.066666666666667,0,2,3,2,3,4,4,4,2,4,3,2,2,3,4,4,1,4,3,4,4,3.1,0,"Black or African American & White, Caucasian, Anglo, European American",1,20,1,2,NA,5,2,0,0,1,0,0,TRUE,TRUE,TRUE,TRUE,TRUE,1,0.5229062500000091,0.48471874999999726,0.5629375000000009,0.6371249999999982,0.5505000000000009,0.6485806451612908,1,1,1,1,1,1,0.089,0.415,0.585,0.009,1.034,37.679055759091746,1819.708712776644,0.088,0.362,0.763,0.019,1.589,109.45936373070909,1890.1233269472784,0.093,0.374,0.675,0.006,1.202,50.70901063169486,1837.814361646538,114.8888888888889,83.63157894736842,200.33333333333331,FALSE,368,1.0903703703703704,0,1,0,0,3,FALSE
322,2022-03-18T19:24:55Z,1,1.7784290738569755,853,3,2,3,3,4,3,5,3,4,3,5,3,3,4,2,3,3,2,3,1,1,2,3,2,5,0,2,0,0,0,0,2,4,3,4,3,4,3,2,4,1,3,5,2,4,3,3,4,4,5,5,5,3,1,3,1,2,1,1,1,1,1,4,5,5,1,2,5,1,2,1,2,1.5,0,3.4,0,3.2222222222222223,0,3.6666666666666665,0,1.8333333333333333,0,2.5714285714285716,0,2.6666666666666665,0,2.972972972972973,0,0,0,0,0.7368313757416948,0.9218163634481962,-0.4466634660828154,0.2375764486826904,3,1,4,1,1,3,2,4,0.865970778058523,5,3,3,3,1,1,4,2.857142857142857,0,0.14738937072514077,0,-0.22884005438438854,2,3,2,2,2,4,5,4,3,3,3,4,4,3,4,3,5,4,4,4,2.2,0,4,0,3.8,0,3.6,0,3.8,0,3,3,3,4,4,3,4,3,4,3,4,3,3,3,1,3,2,2,4,4,3.15,0,"White, Caucasian, Anglo, European American",0,19,1,1,NA,5,2,0,0,1,0,0,TRUE,TRUE,TRUE,TRUE,TRUE,3,0.6047531249942258,0.47854193548233276,0.4887531249970198,0.6611354838696218,0.5061645161230718,0.5380033333351215,1,1,1,0.96875,0.96875,0.9375,0.068,0.321,0.426,0.019,1.709,148.2416296085854,1996.8258168700213,0.066,0.309,0.427,0.022,1.551,67.1941721110605,1892.3610683086245,0.075,0.361,0.364,0.01,1.45,70.66355987311967,1894.8789587799,89.94736842105264,70.5,145,FALSE,506,1.4992592592592593,0,1,0,0,3,FALSE
323,2022-03-18T19:34:24Z,0.8999999761581421,2.3703703703703702,1080,6,2,3,2,2,3,1,4,4,3,3,3,4,3,3,3,4,2,3,1,1,3,3,3,3,0,2,0,0,0,0,3,2,3,2,1,3,3,2,2,1,2,3,1,3,2,2,3,3,5,5,5,2,1,1,1,2,1,1,1,1,1,1,2,2,1,2,2,1,1,2,2,1.5,0,3,0,2.3333333333333335,0,2.9166666666666665,0,1.3333333333333333,0,1.2857142857142858,0,1.6666666666666667,0,2.108108108108108,0,0,0,0,0.17536975572474475,0.3695757446117323,-0.4466634660828154,-0.03854386073554153,1,2,4,2,2,2,2,1.5,-0.10103984158003264,4,4,4,3,1,1,4,3,0,0.1625358753388918,0,-0.14221180198855665,2,3,2,2,3,4,5,5,4,3,2,4,3,3,5,5,4,3,4,4,2.4,0,3.4,0,4,0,4.2,0,3.8666666666666667,0,2,1,2,4,4,4,4,4,2,2,4,4,1,2,1,3,1,2,2,4,2.65,0,"White, Caucasian, Anglo, European American",0,30,0,1,NA,5,2,0,0,1,0,0,TRUE,TRUE,TRUE,TRUE,TRUE,4,0.4621187500007218,0.4204750000006752,0.44403437500097787,0.5656937500006752,0.48795806451670587,0.5053200000007947,1,1,1,1,1,0.967741935483871,0.061,0.369,0.853,0.028,1.93,24.81231453057325,1852.3569642669056,0.073,0.334,0.828,0.035,1.981,86.93543279355762,1871.6977553538743,0.129,0.295,0.788,0.015,1.681,23.15508408828966,1808.4366956309188,68.92857142857143,56.599999999999994,112.06666666666668,FALSE,406,1.202962962962963,0,1,0,0,3,FALSE
324,2022-03-18T19:05:36Z,0.8999999761581421,1.7777777777777777,1080,3,3,4,2,3,3,1,2,2,2,1,1,1,2,1,3,2,1,1,1,1,1,1,2,1,0,2,0,0,0,0,1,2,5,2,2,2,2,2,3,1,2,1,1,4,1,2,2,1,2,3,2,5,1,1,1,1,1,1,1,1,1,2,1,2,1,1,2,1,1,1,1,1,0,2,0,2.3333333333333335,0,1.8333333333333333,0,1.6666666666666667,0,1.2857142857142858,0,1.3333333333333333,0,1.7837837837837838,0,0,0,0,-0.8466658494623595,-0.754375514879147,-0.6189692744445258,-0.6866723946618364,2,1,3,1,1,1,2,1,-0.6261803135308405,1,1,1,1,3,3,5,2.142857142857143,0,0.6473058850354002,0,-0.3113595231473596,3,2,1,3,1,4,3,2,3,4,3,3,4,2,2,2,3,4,2,2,2,0,3.4,0,3,0,2.2,0,2.8666666666666667,0,1,3,1,4,3,2,3,4,3,1,1,3,1,2,1,4,1,1,1,3,2.15,0,Black or African American & Native American/Alaskan Native/indigenous,1,23,1,2,NA,5,2,0,0,0,0,0,TRUE,TRUE,TRUE,TRUE,TRUE,4,0.5822937499973923,0.49818437500298024,0.5686548386985256,0.6074451612868617,0.5581625000033528,0.616862500000745,1,1,1,0.96875,1,1,0.096,0.393,0.602,0.022,1.596,71.64890339515057,1856.4047347516669,0.143,0.308,0.734,0.04,2.069,43.235877625495,1824.5893086448896,0.06,0.456,0.502,0.035,1.803,135.56994627447574,1965.1132720258709,72.54545454545455,51.724999999999994,51.514285714285705,FALSE,476,1.4103703703703703,0,1,0,0,3,FALSE
325,2022-03-18T19:07:05Z,0.8999999761581421,1.5,730,4,3,5,3,5,5,5,4,5,5,4,5,5,5,2,5,5,5,5,5,4,5,5,5,5,3,1,4,0,2,0,4,4,5,4,4,4,4,4,5,5,5,5,4,5,5,4,5,5,5,5,4,5,4,4,4,3,5,4,4,4,3,4,4,4,2,4,5,2,2,3,3,2.5,0,4.533333333333333,0,4.222222222222222,0,4.75,0,4.166666666666667,0,3.857142857142857,0,3.6666666666666665,0,4.27027027027027,0,2,0,0,3.201998801128616,3.0745321090977438,0.33667375751266887,1.7056029333052063,2,2,4,2,1,3,2,5.5,1.5291117368474307,3,2,3,3,1,1,2,2.142857142857143,0,-1.4543549658567896,0,-1.5914591123470605,5,5,5,5,5,1,5,3,1,3,2,2,2,3,3,3,3,3,3,5,5,0,2.2,0,3.2,0,3,0,2.8,0,4,4,4,4,4,4,4,4,4,4,4,4,4,4,4,4,4,4,4,4,4,0,"Asian or Asian American (e.g., Chinese, Japanese, and others)",0,18,3,2,NA,5,2,1,1,1,0,2,TRUE,TRUE,TRUE,TRUE,TRUE,4,0.5324718749998137,0.4796161290324263,0.5036562499997672,0.5918387096769386,0.5555225806446565,0.5711129032256863,1,1,1,1,1,1,0.155,0.285,0.752,0.009,1.171,155.2239109370159,1948.4992231448512,0.115,0.315,0.735,0.025,2.082,42.153796079941394,1827.328058859971,0.137,0.304,0.626,0.01,1.119,67.49439986811349,1850.79433055772,130.11111111111111,83.27999999999999,111.89999999999999,FALSE,304,0.9007407407407407,1,1,1,15,18,FALSE
328,2022-03-18T19:31:08Z,0.800000011920929,2.388888888888889,1440,5,3,5,2,1,3,1,2,5,3,3,3,2,4,1,5,2,5,5,1,1,1,3,5,2,1,2,0,0,0,0,1,3,3,3,3,1,3,2,2,1,1,2,1,4,3,2,4,4,3,5,5,5,2,1,1,2,1,1,1,1,1,3,3,2,1,1,1,2,1,1,1,1.25,0,2.8,0,2.3333333333333335,0,2.9166666666666665,0,2,0,1.7142857142857142,0,1,0,2.2432432432432434,0,1,0,0,0.5876931329246929,0.5595559575020543,-0.31345356682763886,0.12305119533720774,1,1,3,1,1,1,1,2,-0.40524523968696646,5,4,4,3,3,3,5,3.857142857142857,0,-0.23191923190205752,0,0.08194577934007008,1,1,2,3,2,4,4,5,5,5,4,3,2,5,4,5,3,4,4,4,1.8,0,3.6,0,4,0,4.6,0,4.066666666666666,0,1,2,2,4,4,1,1,4,2,1,4,4,1,2,1,4,1,2,1,2,2.2,0,"Hispanic of Latino (e.g., Mexican American, Central American, and others)",0,23,1,2,NA,5,2,0,0,2,0,0,TRUE,TRUE,TRUE,TRUE,TRUE,6,0.45522187500074507,0.48646562499180435,0.4668656250145286,0.5004281250014901,0.5011875000037253,0.5623700000007947,1,1,1,1,1,0.967741935483871,0.078,0.33,0.614,0.018,1.962,100.45586618550878,1932.9129234747668,0.087,0.342,0.649,0.047,1.89,172.72471717639158,1957.536998728932,0.101,0.275,0.617,0.024,1.694,79.76814848987979,1863.4705320518412,109,40.212765957446805,70.58333333333333,FALSE,364,1.0785185185185184,0,1,0,9,12,FALSE
329,2022-03-18T18:38:28Z,0.8999999761581421,1.7786458333333333,768,6,2,5,5,1,5,3,1,5,3,5,3,3,5,1,4,5,1,5,1,1,1,3,1,1,3,1,5,0,3,3,3,5,5,5,5,5,5,5,5,5,4,1,4,5,1,5,5,1,1,4,4,5,1,5,2,3,1,2,2,2,1,5,5,5,4,5,4,5,2,1,1,2.25,0,3.6,0,4.777777777777778,0,3.3333333333333335,0,2.8333333333333335,0,3.142857142857143,0,4.333333333333333,0,3.6486486486486487,0,2,3,0,0.7697295175395634,1.0312614860915337,2.3486158876832675,1.6899386868874005,2,1,2,1,1,1,3,2,-0.23937606567541822,1,1,1,1,1,1,1,1,0,-1.7072506804185048,0,-2.3647166425009627,4,4,3,3,3,3,5,5,4,3,4,1,4,3,3,3,3,4,3,3,3.4,0,3,0,3.6,0,3.6,0,3.4,0,3,1,3,4,3,3,3,3,2,2,2,3,2,2,1,3,2,2,1,2,2.35,0,"Hispanic of Latino (e.g., Mexican American, Central American, and others) & White, Caucasian, Anglo, European American",1,28,1,2,NA,5,2,0,0,1,0,0,TRUE,TRUE,TRUE,TRUE,TRUE,3,0.5434187499997206,0.534078124998603,0.5716875,0.6070774193545503,0.5874344827584151,0.6196566666672627,1,1,1,0.96875,0.90625,0.967741935483871,0.078,0.4,0.468,0.019,1.591,125.76453772348232,1955.0656661049477,0.05,0.407,0.357,0.027,1.827,81.45904022122811,1984.8827795273944,0.074,0.368,0.479,0.012,1.489,120.34350965239716,1942.4562877417552,83.73684210526316,67.66666666666667,124.08333333333334,FALSE,638,1.8903703703703705,0,1,0,6,9,FALSE
330,2022-03-18T19:31:25Z,1,1.7786458333333333,768,4,1,4,4,4,5,4,1,4,3,4,4,4,5,1,4,5,4,1,1,1,2,2,2,3,5,2,0,0,0,0,3,5,5,4,4,4,5,5,5,3,4,2,4,5,2,4,3,5,2,1,3,2,1,1,1,4,3,3,4,2,2,4,4,3,4,5,2,2,3,3,2,2.5,0,3.7333333333333334,0,4.444444444444445,0,3.1666666666666665,0,2,0,3.142857142857143,0,3.6666666666666665,0,3.324324324324324,0,3,0,0,0.7214789095693566,1.057024848295087,0.5560365609487006,0.8065307046218938,4,4,5,2,2,4,4,2,0.9217081524054204,1,1,2,1,1,1,1,1.1428571428571428,0,-0.9515359633553193,0,-1.8270160564655544,2,3,2,3,3,4,4,4,4,1,3,3,4,4,5,5,5,4,4,2,2.6,0,3.8,0,3.6,0,3.8,0,3.7333333333333334,0,3,2,3,4,2,3,3,4,3,1,3,3,3,3,3,3,1,3,2,3,2.75,0,"White, Caucasian, Anglo, European American",0,26,0,1,NA,5,2,0,0,1,0,0,TRUE,TRUE,TRUE,TRUE,TRUE,3,0.5911499999761581,0.466515624910593,0.4776516128970731,0.6344516130262805,0.5120129032750284,0.5214580646022674,1,1,1,0.96875,0.96875,0.96875,0.062,0.351,0.544,0.027,1.879,34.21218037644641,1856.7541534604527,0.061,0.356,0.63,0.024,1.766,100.82180224336004,1927.4815779843373,0.063,0.437,0.408,0.029,1.744,89.5125825495108,1915.52100110682,69.5925925925926,73.58333333333333,60.137931034482754,FALSE,370,1.0962962962962963,0,1,0,0,3,FALSE
331,2022-03-18T19:37:13Z,1,1.7777777777777777,1080,7,3,2,2,3,2,3,2,2,3,2,1,1,2,1,2,2,2,2,4,1,1,2,2,1,0,2,0,0,0,0,1,2,1,1,1,1,1,1,1,2,1,1,1,2,1,1,2,1,1,2,2,3,1,1,1,1,1,1,1,1,1,2,1,1,1,1,1,1,2,1,1,1.25,0,2,0,1.1111111111111112,0,1.4166666666666667,0,1.3333333333333333,0,1.1428571428571428,0,1,0,1.2432432432432432,0,0,0,0,-0.7106868633645046,-0.6629254124008863,-0.5328163702636706,-0.5978708913322784,1,1,2,1,1,1,1,1,-0.874984074548163,5,5,5,5,3,3,4,4.285714285714286,0,0.309970182831297,0,0.6442129660810442,2,2,2,2,2,4,3,4,4,4,4,4,4,2,4,4,4,4,3,3,2,0,4,0,3.6,0,3.4,0,3.6666666666666665,0,2,2,1,1,1,1,2,2,1,1,2,1,3,2,1,1,1,2,1,2,1.5,0,"White, Caucasian, Anglo, European American",0,27,0,1,NA,5,2,0,0,1,0,0,TRUE,TRUE,TRUE,TRUE,TRUE,2,0.487090624993667,0.4400843750014901,0.48552500000596044,0.588689285710454,0.5385064516048278,0.5812566666642824,1,1,1,0.9032258064516129,0.96875,0.9375,0.069,0.345,0.522,0.015,1.937,94.45743968301606,1943.5067454770335,0.066,0.323,0.538,0.016,1.641,82.70240546004955,1912.8402892753136,0.069,0.338,0.545,0.013,1.77,71.73457522930963,1930.7785034365277,129.13333333333335,102.5625,136.15384615384616,FALSE,352,1.0429629629629629,0,1,0,9,12,FALSE
332,2022-03-18T19:36:00Z,0.8999999761581421,1.7777777777777777,1080,3,2,4,4,3,4,2,2,5,3,2,3,3,5,2,5,5,4,3,1,1,3,3,3,3,1,2,0,0,0,0,4,5,5,4,4,3,4,3,5,2,5,4,2,4,2,5,2,4,4,4,3,3,1,2,1,4,3,1,2,1,2,3,1,3,3,4,3,3,2,2,4,2.75,0,3.466666666666667,0,4.111111111111111,0,3.4166666666666665,0,2.3333333333333335,0,1.8571428571428572,0,3.3333333333333335,0,3.108108108108108,0,1,0,0,0.9868572534054928,1.119073251159369,0.20346385825749233,0.6612685547084307,3,3,5,2,2,1,2,4.5,1.308176663003557,2,2,2,2,1,1,3,1.8571428571428572,0,-0.665444751374891,0,-1.2657475225975428,2,2,2,2,2,4,4,4,5,2,5,4,5,3,4,1,4,4,3,5,2,0,4.2,0,3,0,4.2,0,3.8,0,2,2,4,4,4,4,4,1,4,2,4,4,2,4,2,4,2,4,3,4,3.2,0,"White, Caucasian, Anglo, European American",0,29,0,1,NA,5,2,0,0,1,0,0,TRUE,TRUE,TRUE,TRUE,TRUE,1,0.5298312499970198,0.4612343750167638,0.5038093749992549,0.5784645161186495,0.5316714285782406,0.5789620689729165,1,1,1,0.96875,0.875,0.90625,0.058,0.37,0.438,0.007,1.066,60.79087634049731,1946.9602413306209,0.049,0.364,0.512,0.017,1.605,42.146019128522475,1902.5403969207025,0.058,0.424,0.558,0.024,1.49,77.3338484323052,1903.1807164759475,152.28571428571428,94.41176470588235,62.08333333333333,FALSE,274,0.8118518518518519,0,1,0,3,6,FALSE
333,2022-03-18T19:44:54Z,0.8999999761581421,1.7777777777777777,864,6,3,2,2,4,2,4,4,2,4,4,3,3,3,3,3,3,3,3,3,3,3,3,3,3,0,2,0,0,0,0,3,3,3,3,3,3,3,3,3,3,3,3,3,3,3,3,3,3,3,3,3,2,2,3,3,3,3,3,3,3,3,3,3,3,3,3,3,2,2,2,2,2,0,3.066666666666667,0,3,0,3,0,2.6666666666666665,0,3,0,3,0,2.945945945945946,0,0,0,0,1.1250294489565391,1.0373581595900847,-0.274357657721105,0.38150025093448986,3,3,3,3,3,3,3,1,0.20316555652690138,3,3,3,3,3,3,3,3,0,1.0808314045082337,0,0.41711237686483604,3,3,3,3,3,3,3,3,3,3,3,3,3,3,3,3,3,3,3,3,3,0,3,0,3,0,3,0,3,0,2,2,2,3,2,2,2,3,2,2,2,3,2,2,2,3,2,2,2,2,2.2,0,"White, Caucasian, Anglo, European American",0,25,0,1,NA,5,2,0,0,1,0,0,TRUE,TRUE,TRUE,TRUE,TRUE,4,0.5625096774178167,0.44167096773655184,0.5068093749992549,0.6728655172360355,0.5024800000150998,0.6166000000032885,1,1,1,0.90625,0.9375,0.90625,0.058,0.361,0.381,0.009,1.359,80.81342056144015,1938.2413968996557,0.054,0.344,0.554,0.025,1.702,82.40212500009257,1933.5751873655904,0.06,0.401,0.399,0.019,1.837,86.04452104258777,1974.107792291402,151,68.08,96.6842105263158,FALSE,360,1.0666666666666667,0,1,0,0,3,FALSE
334,2022-03-18T19:39:51Z,0.8999999761581421,1.7777777777777777,720,8,4,2,1,4,3,3,1,4,1,2,3,3,3,3,3,2,4,3,1,1,1,1,1,1,1,2,0,0,0,0,2,2,1,2,2,2,2,2,1,4,3,3,1,3,2,3,3,3,3,4,4,2,5,4,5,4,3,3,2,2,2,2,2,3,1,1,1,4,2,2,3,2.75,0,2.533333333333333,0,1.7777777777777777,0,3,0,3.8333333333333335,0,2.2857142857142856,0,1,0,2.5405405405405403,0,1,0,0,-0.030791932875229078,0.027178694257642806,0.20346385825749233,0.11532127625756756,2,2,3,2,2,5,4,1,0.12023096952112716,3,2,3,3,2,3,3,2.7142857142857144,0,-0.788955151249163,0,-0.8765603607594444,5,4,4,3,2,1,3,4,4,2,4,4,3,2,2,4,2,3,3,1,3.6,0,2.8,0,3,0,2.6,0,2.8,0,3,1,1,4,1,1,1,2,1,1,1,3,2,1,1,4,1,1,1,3,1.7,0,"Asian or Asian American (e.g., Chinese, Japanese, and others)",0,24,1,2,NA,5,2,0,0,0,0,0,TRUE,TRUE,TRUE,TRUE,TRUE,2,0.5685806451574449,0.5160344827586207,0.527949999999255,0.6344370370418937,0.569280645166674,0.6208799999976158,0.96875,0.9666666666666667,1,0.8709677419354839,0.96875,0.8064516129032258,0.062,0.391,0.469,0.015,2.051,64.24121989052614,1923.5834288822543,0.05,0.409,0.417,0.024,1.495,177.9399595816108,2056.782637217937,0.055,0.444,0.502,0.019,2.001,143.98168800788264,2048.441097606319,136.73333333333335,62.29166666666667,105.3157894736842,FALSE,291,0.8622222222222223,0,1,0,0,3,FALSE
336,2022-03-18T19:11:05Z,0.8999999761581421,1.7786458333333333,768,4,3,4,3,3,3,4,3,4,3,2,2,4,3,2,3,3,2,3,1,1,1,3,2,3,3,1,2,0,0,0,3,3,4,4,3,3,3,3,3,2,3,4,2,3,2,3,3,4,4,5,5,3,1,1,1,3,2,1,3,3,3,4,4,4,1,1,2,1,1,2,2,1.5,0,3.066666666666667,0,3.2222222222222223,0,3.3333333333333335,0,1.8333333333333333,0,3.142857142857143,0,1.3333333333333333,0,2.864864864864865,0,2,0,0,0.4232024239353518,0.5653576306700305,-0.007937859210751935,0.2787098857296393,1,2,2,2,2,3,1,2,-0.07350689166386981,5,5,5,5,5,5,5,5,0,1.384971609293624,0,1.6859984401799282,4,4,3,3,2,3,5,1,4,3,4,3,3,5,2,5,5,4,5,5,3.2,0,3.8,0,4.2,0,3.4,0,3.8,0,3,2,4,4,4,4,4,4,4,4,3,4,2,2,3,3,3,4,4,4,3.45,0,"White, Caucasian, Anglo, European American",0,22,1,2,NA,5,2,0,0,1,0,0,TRUE,TRUE,TRUE,TRUE,TRUE,1,0.6311612903225806,0.5335333333333333,0.5419375,0.7514666666666666,0.598375,0.6263461538461539,0.96875,0.967741935483871,1,0.9375,1,0.8125,0.054,0.412,0.436,0.013,1.9,73.12055611908583,1934.759352987252,0.16,0.304,0.718,0.013,1.193,219.0156811995977,2045.4558671510952,0.071,0.42,0.328,0.013,1.754,116.2402932929873,2024.3122094708608,146.15384615384616,91.76923076923077,134.92307692307693,FALSE,357,1.0577777777777777,0,1,0,0,3,FALSE
337,2022-03-18T19:36:01Z,0.8999999761581421,1.6,900,6,2,3,2,3,3,4,3,3,3,3,2,2,3,2,3,4,3,3,5,2,2,3,3,2,1,1,1,0,1,0,3,4,2,3,3,2,1,1,2,2,3,2,3,3,3,2,4,4,3,3,3,4,4,5,3,3,4,2,2,3,1,2,2,2,2,2,2,2,2,1,2,1.75,0,2.8666666666666667,0,2.3333333333333335,0,2.9166666666666665,0,3.8333333333333335,0,2,0,2,0,2.675675675675676,0,1,0,0,0.8684239429331674,0.7774628683534798,-0.14114775846592847,0.3181575549437756,1,2,3,1,2,2,1,1.5,-0.3498436025973552,5,4,5,4,1,1,3,3.2857142857142856,0,-0.5180104438824858,0,-0.40192007928726475,3,2,3,3,3,3,4,3,4,4,4,4,3,3,4,4,3,4,4,3,2.8,0,3.6,0,3.8,0,3.4,0,3.6,0,2,3,2,3,2,2,3,2,1,2,2,2,2,3,3,2,1,3,2,3,2.25,0,"White, Caucasian, Anglo, European American",0,23,0,1,NA,5,2,0,0,2,0,0,TRUE,TRUE,TRUE,TRUE,TRUE,2,0.4893437500447035,0.4201656249910593,0.4321749999821186,0.5868000000098655,0.5304275862430704,0.5443249999455043,1,1,1,0.90625,0.90625,0.875,0.066,0.348,0.836,0.017,1.993,34.186813777419175,1901.8238318507647,0.079,0.32,0.872,0.012,1.722,25.48054343592986,1881.1565022580296,0.061,0.351,0.489,0.015,1.866,76.49560359687548,1936.1889561446185,117.23529411764706,143.5,124.4,FALSE,438,1.2977777777777777,0,1,0,0,3,FALSE
338,2022-03-18T19:42:09Z,0.8999999761581421,1.7777777777777777,1080,4,2,1,1,4,2,5,2,2,2,2,3,1,3,2,3,2,2,4,1,1,2,3,3,2,1,1,1,0,0,0,1,1,1,1,3,1,2,2,2,3,1,1,1,3,1,2,4,3,4,4,4,3,1,1,1,2,1,1,2,1,1,3,3,2,1,5,3,1,3,3,2,2.25,0,2.3333333333333335,0,1.5555555555555556,0,2.5833333333333335,0,1.5,0,1.8571428571428572,0,3,0,2.054054054054054,0,1,0,0,0.05912965470561092,3.336641753150592e-4,0.031158049895781924,0.015745857035548493,2,2,5,1,1,2,2,1,-0.29444196550774376,4,4,4,2,1,1,5,3,0,-0.5180104438824858,0,-0.5567254297686189,2,2,1,2,2,5,5,4,5,3,5,4,3,4,5,3,5,5,3,1,1.8,0,4.8,0,3.4,0,3.8,0,4,0,1,1,1,1,1,1,1,1,1,1,1,2,3,1,1,1,1,1,1,1,1.15,0,"Asian or Asian American (e.g., Chinese, Japanese, and others)",0,27,0,1,NA,5,2,0,0,1,0,0,TRUE,TRUE,TRUE,TRUE,TRUE,2,0.44789375000074505,0.37739375000819564,0.4230937500074506,0.539696428575686,0.47291481482982634,0.4963033333222071,1,1,1,0.875,0.8709677419354839,0.9375,0.05,0.349,0.653,0.023,1.819,90.7778034256135,1941.1630539300536,0.054,0.307,0.739,0.025,2.097,70.90868277410937,1935.4108745271944,0.054,0.342,0.569,0.015,1.715,57.97542915311968,1921.7797986839323,79.08695652173913,83.88,114.33333333333334,FALSE,428,1.268148148148148,0,1,0,0,3,FALSE
339,2022-03-18T19:48:31Z,1,1.6,900,4,3,2,3,4,3,2,1,4,2,2,2,2,3,2,2,3,2,1,1,1,1,2,1,1,4,2,0,0,0,0,2,3,4,2,3,3,4,3,4,3,4,2,2,4,2,3,2,2,3,2,2,2,2,3,2,3,3,2,2,3,1,2,3,2,2,2,2,2,2,2,2,2,0,2.466666666666667,0,3.111111111111111,0,2.5833333333333335,0,2.5,0,2.142857142857143,0,2,0,2.5675675675675675,0,2,0,0,-0.2566925065539237,-0.1538531752719025,0.16436794915095845,0.005257386939527972,3,2,4,3,3,3,3,1.5,0.39656768045461255,4,4,4,4,3,2,3,3.4285714285714284,0,-0.6083253463380449,0,-0.37952726421641136,3,2,3,2,3,4,3,4,3,2,4,3,4,3,2,4,3,4,3,3,2.6,0,3.6,0,3.2,0,3,0,3.2666666666666666,0,3,2,2,2,2,1,2,2,3,2,2,2,3,2,2,2,2,2,3,2,2.15,0,"Asian or Asian American (e.g., Chinese, Japanese, and others)",0,20,1,2,NA,5,2,0,0,1,0,0,TRUE,TRUE,TRUE,TRUE,TRUE,6,0.6608374999947846,0.5040250000022352,0.5850562500096858,0.6959843749813736,0.5493499999977648,0.5958999999992309,1,1,1,1,1,1,0.138,0.312,0.514,0.044,0.875,54.28713552204971,1837.5765244062673,0.197,0.25,0.781,0.033,1.654,37.46210597341251,1820.0372650635577,0.215,0.217,0.514,0.012,1.186,51.70263402570076,1835.3975054515008,19.886363636363637,50.12121212121212,98.83333333333333,FALSE,430,1.2740740740740741,0,1,0,0,3,FALSE
341,2022-03-18T19:37:03Z,0.8999999761581421,1.6,900,4,2,4,3,2,4,1,1,3,3,3,2,4,4,1,4,5,5,2,3,1,5,4,5,4,12,1,1,0,1,1,4,3,3,2,4,4,3,3,4,3,5,2,5,4,3,3,5,5,4,2,3,4,2,5,1,4,1,3,5,5,1,3,3,3,5,5,4,1,3,5,3,3,0,2.933333333333333,0,3.3333333333333335,0,3.6666666666666665,0,2.8333333333333335,0,3.2857142857142856,0,4.666666666666667,0,3.4594594594594597,0,6,1,0,1.8641410346819776,1.4762203180422102,2.085795791068991,1.7810080545556004,3,1,4,1,1,2,1,2,-0.07350689166386981,2,2,2,1,2,3,1,1.8571428571428572,0,-1.1321657682664374,0,-1.5500224006018164,2,3,3,5,3,4,4,4,5,4,3,3,4,5,4,2,3,4,5,2,3.2,0,3.4,0,3.8,0,4,0,3.7333333333333334,0,2,3,2,3,3,3,3,3,1,3,4,3,3,2,1,2,3,3,2,3,2.6,0,"White, Caucasian, Anglo, European American",0,22,1,2,NA,5,2,0,0,0,0,0,TRUE,TRUE,TRUE,TRUE,TRUE,5,0.5303903225814143,0.4594437499968335,0.47393437499925495,0.5768125000004657,0.533403448275451,0.5438483870981201,0.96875,1,1,1,0.90625,0.96875,0.06,0.364,0.564,0.018,1.575,38.85459017631302,1865.3397406701556,0.053,0.372,0.58,0.018,1.623,35.65591041619875,1889.7080756597843,0.115,0.32,0.569,0.026,1.687,212.5492693036692,2043.6575923397615,87.5,90.16666666666667,64.88461538461539,FALSE,436,1.2918518518518518,0,1,0,0,3,FALSE
342,2022-03-18T19:44:48Z,0.8999999761581421,1.7786458333333333,768,3,1,5,4,4,4,4,5,5,5,5,4,5,4,2,5,5,5,5,5,3,4,5,5,5,4,2,0,0,0,0,5,5,5,5,5,5,5,5,5,3,2,2,3,4,4,5,5,5,4,4,4,4,2,5,5,5,5,4,4,4,4,4,5,5,4,5,3,2,3,2,2,2.25,0,4.4,0,5,0,3.75,0,4.333333333333333,0,4.285714285714286,0,4,0,4.27027027027027,0,2,0,0,3.0397013015924665,2.907168588218175,0.2505208533318137,1.5788447207749943,5,5,5,5,3,4,4,4.5,2.3863262940786214,1,1,2,1,1,1,1,1.1428571428571428,0,-1.4031104756331148,0,-2.1020653573146735,2,2,2,1,2,3,5,5,4,4,5,4,5,5,5,5,4,4,5,5,1.8,0,4,0,4.8,0,4.8,0,4.533333333333333,0,2,2,3,4,2,3,4,3,2,1,2,3,1,2,1,3,1,2,3,4,2.4,0,"White, Caucasian, Anglo, European American",0,20,1,2,NA,5,2,0,0,0,0,0,TRUE,TRUE,TRUE,TRUE,TRUE,2,0.4965437499843538,0.4154937499910593,0.4599562500119209,0.5865379310476369,0.4811172413784882,0.532752000002861,1,1,1,0.90625,0.90625,0.78125,0.053,0.344,0.5,0.016,1.845,116.44936769605629,2016.9549147219432,0.052,0.324,0.601,0.013,1.284,80.81429549046689,1974.9423350875195,0.059,0.361,0.443,0.016,1.657,114.30775812821328,1970.5279222922425,115.3125,98.76923076923077,103.5625,FALSE,390,1.1555555555555557,0,1,0,0,3,FALSE
343,2022-03-18T19:53:00Z,0.8999999761581421,1.7786458333333333,768,5,2,2,1,2,1,2,1,2,2,2,1,2,2,2,2,3,1,1,1,1,1,3,1,2,1,2,0,0,0,0,3,1,1,1,1,1,1,1,1,1,1,2,1,1,2,1,1,2,3,2,2,1,1,1,1,1,1,1,2,1,1,1,1,2,1,1,1,2,1,1,1,1.25,0,1.8,0,1.2222222222222223,0,1.5833333333333333,0,1,0,1.2857142857142858,0,1,0,1.2972972972972974,0,1,0,0,-1.000190511185744,-0.9449457284306189,-0.31345356682763886,-0.6291996476291288,2,2,2,1,1,2,1,1,-0.6261803135308405,5,5,5,5,2,2,5,4.142857142857143,0,-0.33738063897136766,0,0.1725156924964459,2,2,2,2,2,4,4,3,4,3,5,4,4,3,3,2,4,4,3,3,2,0,4.2,0,3.2,0,3.2,0,3.533333333333333,0,1,1,1,1,3,1,1,2,1,1,1,1,1,1,1,1,1,1,1,1,1.15,0,"White, Caucasian, Anglo, European American",0,26,0,1,NA,5,2,0,0,1,0,0,TRUE,TRUE,TRUE,TRUE,TRUE,4,0.5031156249940395,0.46040312499925495,0.4783999999910593,0.5655843749977648,0.5210937499962747,0.579735483873275,1,1,1,1,1,0.96875,0.088,0.313,0.589,0.017,1.987,105.52164363396643,1933.2546152630969,0.105,0.265,0.537,0.016,1.319,41.621918800441826,1825.7791369884928,0.093,0.355,0.657,0.012,1.173,25.849454883000544,1808.7958268706675,116.88235294117646,82.4375,97.75,FALSE,279,0.8266666666666667,0,1,0,3,6,FALSE
344,2022-03-18T19:36:35Z,0.8999999761581421,1.776536312849162,716,5,2,5,3,5,4,5,5,3,5,5,3,5,4,1,4,5,3,5,1,1,3,5,5,4,5,2,0,0,0,0,2,4,3,4,5,3,3,2,5,2,2,2,2,3,2,4,5,4,5,3,5,5,1,1,1,3,1,1,5,3,1,3,5,3,2,4,3,3,3,3,2,2.75,0,4.133333333333334,0,3.4444444444444446,0,3.25,0,2,0,3,0,3,0,3.027027027027027,0,3,0,0,1.4211127251373528,1.7021905712626866,0.6421894651295558,1.1721900181961211,2,1,3,1,1,2,1,2,-0.23937606567541822,3,3,4,4,1,1,1,2.4285714285714284,0,0.072220972883332707,0,-0.506832363121089,2,2,2,4,2,3,5,1,5,1,5,5,3,4,5,5,4,4,5,3,2.4,0,4.2,0,3.8,0,3.6,0,3.8666666666666667,0,1,2,3,4,2,4,2,2,3,1,3,2,2,3,2,2,3,3,3,2,2.45,0,"Hispanic of Latino (e.g., Mexican American, Central American, and others) & White, Caucasian, Anglo, European American",1,26,1,2,NA,5,2,0,0,1,0,0,TRUE,TRUE,TRUE,TRUE,TRUE,1,0.48573870968241845,0.47464062499254944,0.5585374999959022,0.5292516128997649,0.537146874986589,0.6001312500033528,1,1,1,1,1,1,0.169,0.262,0.574,0.032,1.647,45.33192381345083,1827.2353581192797,0.116,0.285,0.63,0.03,2.064,47.44621287356618,1834.9221542793412,0.078,0.342,0.573,0.011,1.144,82.95231275501976,1866.9849526943503,51.46875,68.80000000000001,104,FALSE,310,0.9185185185185185,0,1,0,0,3,FALSE
346,2022-03-18T20:03:16Z,0.8999999761581421,1.7777777777777777,720,4,3,1,1,2,2,2,1,1,2,2,1,1,1,1,1,1,1,1,2,1,1,1,1,1,0,2,0,0,0,0,1,1,2,1,3,1,1,1,1,1,1,1,1,2,1,1,2,1,1,1,1,4,1,1,2,2,1,1,1,1,1,1,1,1,1,1,1,1,1,1,1,1,0,1.3333333333333333,0,1.3333333333333333,0,1.1666666666666667,0,1.8333333333333333,0,1,0,1,0,1.2702702702702702,0,0,0,0,-1.1800336863474237,-1.2696427589502066,-0.6189692744445258,-0.9443060166973662,1,1,2,1,1,1,1,1,-0.874984074548163,5,5,5,5,3,3,4,4.285714285714286,0,0.2196552803757379,0,0.5892031059112204,2,2,3,3,3,4,3,3,4,4,4,3,4,3,4,4,4,3,3,3,2.6,0,3.6,0,3.6,0,3.4,0,3.533333333333333,0,1,1,1,1,1,1,1,1,1,1,1,1,1,1,1,1,1,1,1,1,1,0,"White, Caucasian, Anglo, European American",0,28,0,1,NA,5,2,0,0,1,0,0,TRUE,TRUE,TRUE,TRUE,TRUE,1,0.5057937499918044,0.4855156250055879,0.48301249999739226,0.5909531249981373,0.5781225806436231,0.5972062499988824,1,1,1,1,1,1,0.08,0.367,0.669,0.006,1.073,47.408165730435535,1830.03542520451,0.16,0.313,0.908,0.016,1.547,122.84030897861513,1912.5877289916664,0.154,0.314,0.848,0.009,1.228,84.07244424098589,1866.5283056803355,178.83333333333331,96.6875,136.44444444444446,FALSE,295,0.874074074074074,0,1,1,3,6,FALSE
347,2022-03-18T20:03:55Z,0.8999999761581421,1.7777777777777777,1440,3,2,2,2,1,2,1,2,1,2,1,1,1,2,2,1,3,1,2,1,1,1,1,3,1,1,2,0,0,0,0,1,2,3,2,2,1,2,1,3,1,1,4,1,3,1,1,3,2,2,3,3,2,1,1,1,3,1,1,2,2,2,3,3,2,1,2,1,2,1,2,2,1.75,0,1.6,0,1.8888888888888888,0,2.0833333333333335,0,1.5,0,2.142857142857143,0,1.3333333333333333,0,1.8918918918918919,0,1,0,0,-0.614185647424091,-0.772665535374799,-0.14114775846592847,-0.45690664692036376,3,3,4,3,2,2,1,1,-0.04563820449042111,4,3,4,3,1,1,1,2.4285714285714284,0,-0.45161944904505985,0,-0.8258980718590456,3,2,2,2,2,2,5,4,4,4,5,4,3,4,4,4,2,4,3,2,2.2,0,3.4,0,3.8,0,3.6,0,3.6,0,1,2,1,2,2,2,2,2,2,2,1,2,1,2,1,2,1,2,2,2,1.7,0,"White, Caucasian, Anglo, European American",0,27,1,2,NA,5,2,0,0,1,0,0,TRUE,TRUE,TRUE,TRUE,TRUE,4,0.4936218749769032,0.4602468750104308,0.45231874998286364,0.5834857142737934,0.5532032258202952,0.5862481481278384,1,1,1,0.9032258064516129,0.96875,0.84375,0.06,0.333,0.543,0.006,1.329,74.11092436038642,1933.913135352229,0.079,0.303,0.498,0.015,1.688,76.73860646260125,1907.0653226135637,0.068,0.331,0.462,0.009,1.459,115.22282696305312,1972.7503693507736,221.5,112.53333333333333,162.11111111111114,FALSE,368,1.0903703703703704,0,1,0,6,9,FALSE
348,2022-03-18T20:08:57Z,0.8999999761581421,1.7777777777777777,864,5,4,1,1,1,1,1,1,1,1,1,1,1,1,1,1,1,1,2,1,1,1,1,1,1,1,2,0,0,0,0,1,2,2,2,2,1,2,1,2,1,1,1,1,1,1,1,1,1,1,1,1,1,1,1,1,3,1,1,2,2,1,2,1,1,1,1,1,2,1,2,1,1.5,0,1,0,1.6666666666666667,0,1,0,1.3333333333333333,0,1.4285714285714286,0,1,0,1.2972972972972974,0,1,0,0,-1.1624880107218938,-1.4033762421442217,-0.22730066264678367,-0.8153384523955027,1,1,1,1,1,1,1,1,-0.9579186615539372,5,5,5,5,3,3,5,4.428571428571429,0,0.8611311873652313,0,1.0573220304792632,3,4,4,2,3,4,4,3,4,3,4,3,4,3,2,4,4,4,1,1,3.2,0,3.8,0,3.2,0,2.6,0,3.2,0,1,1,1,1,1,1,1,1,1,1,2,2,1,2,1,1,1,1,1,1,1.15,0,"White, Caucasian, Anglo, European American",0,22,0,1,NA,5,2,0,0,1,0,0,TRUE,TRUE,TRUE,TRUE,TRUE,4,0.559406249997206,0.4603875000011176,0.48421562499925497,0.6163593750009313,0.532079999996225,0.5651258064518052,1,1,1,1,0.967741935483871,0.96875,0.067,0.361,0.582,0.013,1.494,55.65216963468651,1884.9628124320225,0.049,0.369,0.511,0.007,1.049,140.42767464590872,1967.0341432226553,0.147,0.332,0.668,0.022,1.593,48.16654678697904,1831.6113231073543,114.92307692307693,149.85714285714283,72.4090909090909,FALSE,386,1.1437037037037037,0,1,1,0,3,FALSE
349,2022-03-18T19:51:04Z,0.800000011920929,1.7708333333333333,768,3,2,4,4,4,4,4,3,3,3,3,3,4,4,3,3,3,1,2,3,2,2,3,3,3,0,1,0,0,1,1,3,2,4,1,2,2,2,1,2,2,3,1,1,3,3,1,2,3,3,3,4,2,3,1,2,3,1,2,2,2,1,3,3,3,3,3,3,1,2,2,2,1.75,0,3.466666666666667,0,2.111111111111111,0,2.4166666666666665,0,2,0,2.2857142857142856,0,3,0,2.2972972972972974,0,0,1,0,0.2981894851034528,0.6559227321565655,0.33885444954852423,0.49738859085254483,3,3,4,3,3,3,3,4.5,1.6399150110266534,3,4,5,3,1,1,1,2.5714285714285716,0,-0.42769554142692673,0,-0.7339235953208264,3,2,2,3,2,4,4,4,4,3,5,5,5,4,4,3,5,4,4,1,2.4,0,4.6,0,3.8,0,3.4,0,3.933333333333333,0,2,1,1,2,2,2,3,2,2,3,1,2,2,1,1,1,1,1,2,3,1.75,0,"White, Caucasian, Anglo, European American",0,22,0,1,NA,5,2,1,0,1,0,1,TRUE,TRUE,TRUE,TRUE,TRUE,1,0.6166812500001397,0.4906483870969424,0.5690562499997904,0.6828249999996042,0.5493656250000931,0.5847875000002095,1,1,1,1,1,1,0.164,0.332,0.7,0.097,1.545,104.2270454478966,1887.6895725788831,0.141,0.295,0.735,0.03,1.82,9.953244361278006,1789.852156497258,0.114,0.325,0.394,0.037,1.955,20.371976415095137,1802.3264652561268,15.92783505154639,60.66666666666667,52.837837837837846,FALSE,138,0.40888888888888886,0,1,0,0,3,FALSE
350,2022-03-18T20:10:51Z,0.8999999761581421,1.6,900,6,2,5,3,4,4,4,4,4,4,5,3,4,5,4,5,5,4,5,5,2,4,5,5,5,6,1,1,0,0,0,2,3,3,4,4,3,4,4,5,3,2,4,4,5,3,4,5,5,5,5,5,5,3,5,4,5,5,2,5,1,1,2,2,1,3,5,3,1,2,3,1,1.75,0,4.2,0,3.5555555555555554,0,4.166666666666667,0,4.5,0,2,0,3.6666666666666665,0,3.6216216216216215,0,3,0,0,2.456307587043604,2.42749805070317,0.297577848406135,1.3625379495546526,3,3,5,3,3,4,3,2,0.838773565399646,1,2,3,3,1,1,1,1.7142857142857142,0,-1.5266208755073867,0,-1.8676835459579295,3,3,3,4,3,3,5,4,4,3,5,3,4,3,3,4,4,5,4,4,3.2,0,4,0,4,0,3.6,0,3.8666666666666667,0,3,2,4,4,4,4,4,4,4,4,4,4,4,4,4,4,4,4,4,4,3.85,0,"Hispanic of Latino (e.g., Mexican American, Central American, and others) & White, Caucasian, Anglo, European American",1,26,1,3,NA,5,2,0,0,0,0,0,TRUE,TRUE,TRUE,TRUE,TRUE,6,0.46820000004023316,0.40844999998807907,0.4508935483963259,0.5725444444727015,0.5082724137881707,0.5439000000158946,1,1,0.96875,0.8709677419354839,0.90625,0.84375,0.051,0.327,0.376,0.008,1.322,148.04612899156197,2105.7490711575324,0.057,0.317,0.608,0.008,1.271,91.48938566068216,1978.9970406415136,0.066,0.334,0.521,0.013,1.845,47.48013428036351,1912.760111578776,165.25,158.87499999999997,141.92307692307693,FALSE,430,1.2740740740740741,0,1,0,3,6,FALSE
351,2022-03-18T20:08:26Z,0.8999999761581421,1.6,900,7,2,2,3,3,1,2,2,4,2,2,3,3,2,2,2,1,2,3,1,1,2,3,2,2,0,2,0,0,0,0,1,2,1,2,1,1,4,3,2,2,2,2,1,2,2,1,4,2,4,3,3,2,1,1,1,4,1,2,1,1,1,4,5,5,1,3,1,2,1,1,1,1.25,0,2.2666666666666666,0,1.8888888888888888,0,2.3333333333333335,0,1.6666666666666667,0,2.7142857142857144,0,1.6666666666666667,0,2.135135135135135,0,0,0,0,-0.05053081795394988,-0.10252311775184667,-0.5328163702636706,-0.3176697440077586,2,2,4,2,2,2,2,2,0.17529686935345262,4,5,5,4,2,4,4,4,0,0.2196552803757379,0,0.4343977554298661,2,3,3,4,3,4,4,4,4,3,3,3,3,3,3,4,4,4,2,4,3,0,3.6,0,3.2,0,3.6,0,3.466666666666667,0,2,3,2,2,3,2,3,4,2,1,2,2,3,4,2,2,1,3,2,4,2.45,0,"White, Caucasian, Anglo, European American",0,29,1,2,NA,5,2,0,0,1,0,0,TRUE,TRUE,TRUE,TRUE,TRUE,5,0.49105312500015136,0.44508749999979047,0.4632812499995925,0.5816733333334326,0.520514285714299,0.5946655172415335,1,1,1,0.9375,0.875,0.90625,0.074,0.33,0.56,0.009,1.546,26.68576454797772,1883.389000264684,0.048,0.364,0.565,0.024,1.844,103.5051712580809,2000.698672993756,0.067,0.359,0.538,0.018,2.014,29.01191675028379,1872.5604007604932,171.7777777777778,76.83333333333333,111.88888888888889,FALSE,424,1.2562962962962962,0,1,0,0,3,FALSE
353,2022-03-18T20:03:24Z,0.8999999761581421,1.7777777777777777,1080,3,1,2,2,2,2,2,1,2,2,1,1,1,1,3,1,4,1,1,1,1,1,1,2,1,4,2,0,0,0,0,3,2,1,2,4,1,2,3,3,2,1,1,2,1,1,4,1,1,1,3,4,1,1,1,1,1,1,1,3,1,1,2,2,2,1,2,1,1,2,1,1,1.25,0,1.8,0,2.3333333333333335,0,1.8333333333333333,0,1,0,1.7142857142857142,0,1.3333333333333333,0,1.7567567567567568,0,2,0,0,-0.864211525087889,-0.8534956259523583,-0.09409076339160714,-0.4737931946719827,1,1,1,1,1,2,1,2,-0.48817982669274074,5,5,5,5,3,3,4,4.285714285714286,0,0.003250347887277641,1,0.45739313045220775,3,3,3,4,3,3,5,2,2,2,5,3,1,3,2,5,5,4,4,2,3.2,0,4,0,3.4,0,2.2,0,3.2,0,2,1,4,4,3,4,4,4,4,4,3,4,1,4,1,4,4,4,4,2,3.25,0,"White, Caucasian, Anglo, European American",0,26,0,1,NA,5,2,1,0,0,0,1,TRUE,TRUE,TRUE,TRUE,TRUE,6,0.5351406250009313,0.4339031249999534,0.4808187499982305,0.5840733333346745,0.5018096774203643,0.5254999999977924,1,1,1,0.967741935483871,0.96875,0.8709677419354839,0.052,0.349,0.447,0.011,1.177,147.15472710616322,2026.152086795407,0.073,0.324,0.652,0.024,1.778,33.46825220710793,1857.6167073084007,0.063,0.365,0.405,0.024,1.919,101.96416688278528,1927.335378543479,107.00000000000001,74.08333333333333,79.95833333333333,FALSE,307,0.9096296296296296,0,1,0,33,36,FALSE
354,2022-03-18T20:10:44Z,0.8999999761581421,1.6,900,4,1,4,3,2,3,2,4,3,3,2,3,4,4,1,4,5,3,4,5,3,3,5,4,3,3,1,1,1,0,0,4,5,4,5,5,3,4,4,3,2,2,2,3,3,2,4,5,5,4,3,5,5,3,5,2,4,4,2,1,1,1,5,5,4,2,5,3,1,3,1,1,1.5,0,3.1333333333333333,0,4.111111111111111,0,3.3333333333333335,0,3.8333333333333335,0,2.7142857142857144,0,3.3333333333333335,0,3.4864864864864864,0,2,0,1,1.9628354600755815,1.629915490271803,0.8981956299184052,1.264055560095104,4,3,5,2,2,3,2,2,0.5899698043823236,2,2,4,3,1,1,1,2,0,-0.731835746212317,0,-1.2287829062291473,2,2,2,3,2,4,5,5,5,2,4,5,4,3,4,4,5,3,3,5,2.2,0,4.2,0,3.6,0,4.4,0,4.066666666666666,0,4,1,3,4,3,4,4,4,4,3,4,2,2,3,2,3,2,4,4,4,3.2,0,"White, Caucasian, Anglo, European American",0,29,1,2,NA,5,2,0,0,1,0,0,TRUE,TRUE,TRUE,TRUE,TRUE,4,0.47050000000000003,0.41978125,0.4626875,0.5501290322580645,0.48789655172413793,0.5605,1,1,1,0.96875,0.9354838709677419,0.967741935483871,0.068,0.372,0.772,0.006,1.046,38.56053444073532,1865.4941408267468,0.039,0.373,0.849,0.004,0.782,114.01525033189952,1983.299984386215,0.068,0.343,0.594,0.014,1.639,92.70655398923004,1919.998991946694,174.33333333333334,195.5,117.07142857142857,FALSE,434,1.285925925925926,0,1,0,0,3,FALSE
355,2022-03-18T20:10:22Z,0.800000011920929,1.6,960,5,2,4,3,2,4,3,1,3,1,1,2,1,3,1,3,4,3,1,1,1,1,2,2,2,1,2,0,0,0,0,2,4,4,3,5,3,5,5,4,2,3,3,3,4,2,2,3,3,2,3,3,3,1,5,1,3,3,2,2,1,1,3,2,2,1,2,1,2,2,1,2,1.75,0,2.4,0,3.888888888888889,0,2.75,0,2.6666666666666665,0,1.8571428571428572,0,1.3333333333333333,0,2.72972972972973,0,1,0,0,0.09202779650347893,0.051565388251846145,-0.14114775846592847,-0.044791185107041165,3,2,5,1,2,2,2,1,-0.1285727914961955,2,3,3,2,1,1,4,2.2857142857142856,0,-0.33738063897136766,0,-0.8337190856323571,2,2,3,3,2,4,4,3,4,3,4,3,4,4,5,1,3,5,2,3,2.4,0,3.8,0,2.8,0,3.8,0,3.466666666666667,0,1,2,1,3,2,1,2,4,1,1,2,2,3,3,1,2,1,1,2,2,1.85,0,"Hispanic of Latino (e.g., Mexican American, Central American, and others)",0,23,0,1,NA,5,2,0,0,0,0,0,TRUE,TRUE,TRUE,TRUE,TRUE,6,0.588118749999965,0.5219562499999884,0.5494874999998137,0.6526125000000466,0.617425000000163,0.6563375000000233,1,1,1,1,1,1,0.188,0.27,0.661,0.015,1.706,48.46106069400924,1831.3697631249825,0.323,0.19,0.978,0.01,1.344,44.710714844409814,1828.2890455435331,0.153,0.375,0.743,0.02,1.621,204.5478982788437,1997.431731986176,113.73333333333333,134.4,81.05,FALSE,398,1.1792592592592592,0,1,0,0,3,FALSE
356,2022-03-18T19:59:34Z,0.8999999761581421,1.7777777777777777,1080,7,2,2,1,2,2,2,1,1,2,1,1,1,2,2,1,2,1,2,1,1,1,1,1,1,1,2,0,0,0,0,2,1,1,1,1,1,1,1,1,2,1,3,1,1,2,4,1,3,3,4,3,1,1,1,1,1,1,1,2,2,1,1,1,3,1,1,1,2,1,2,2,1.75,0,1.5333333333333334,0,1.1111111111111112,0,2.3333333333333335,0,1,0,1.5714285714285714,0,1,0,1.5675675675675675,0,1,0,0,-0.987031254466597,-1.0525225156469813,-0.14114775846592847,-0.5968351370564549,2,2,3,2,1,1,2,1,-0.4603111395192921,4,4,4,4,2,2,3,3.2857142857142856,0,-0.5751298489193319,0,-0.4367109100209476,2,2,3,3,3,4,4,3,4,3,3,3,3,3,3,3,3,3,3,3,2.6,0,3.2,0,3.2,0,3.2,0,3.2,0,1,1,1,3,3,1,1,3,1,1,1,3,2,1,2,3,1,1,1,2,1.65,0,"Asian or Asian American (e.g., Chinese, Japanese, and others) & White, Caucasian, Anglo, European American",1,26,1,2,NA,5,2,0,0,1,0,0,TRUE,TRUE,TRUE,TRUE,TRUE,2,0.5762218750007451,0.6263781249895691,0.5053096774162784,0.6827354838655841,0.6861656250022352,0.6216366666674614,1,1,1,0.96875,1,0.967741935483871,0.085,0.336,0.548,0.015,1.964,32.53901029275052,1857.7532088436255,0.097,0.279,0.266,0.125,1.517,121.13143139111176,1905.8940425778917,0.082,0.324,0.354,0.014,1.92,66.62989375315398,1891.1826037584456,130.93333333333334,12.136,137.14285714285714,FALSE,304,0.9007407407407407,1,1,0,3,6,FALSE
357,2022-03-18T20:23:08Z,1,1.7777777777777777,1152,5,2,1,3,3,3,4,5,2,2,4,2,2,3,2,3,2,2,4,3,1,3,5,2,3,3,2,0,0,0,0,1,3,1,2,2,1,1,1,1,1,1,2,1,2,2,2,2,2,3,4,4,2,1,1,1,2,2,1,3,1,1,2,1,3,1,1,1,2,2,3,1,2,0,2.7333333333333334,0,1.4444444444444444,0,2.1666666666666665,0,1.5,0,1.7142857142857142,0,1,0,1.7027027027027026,0,2,0,0,0.23677962041409875,0.29444899375862393,0.16436794915095845,0.2294084714547912,2,1,3,1,1,1,1,3,0.06449359517422987,5,5,5,4,3,1,4,3.857142857142857,0,0.25285077779445086,0,0.37721410962533,3,2,2,3,2,5,5,5,5,3,5,5,3,4,4,2,5,4,4,5,2.4,0,4.8,0,3.4,0,4.6,0,4.266666666666667,0,3,2,3,2,4,2,2,3,1,1,1,2,3,1,1,2,1,3,1,2,2,0,"White, Caucasian, Anglo, European American",0,25,1,3,NA,5,2,0,0,1,0,0,TRUE,TRUE,TRUE,TRUE,TRUE,1,0.5364193548387097,0.4596875,0.49325,0.606875,0.5299354838709678,0.5511785714285714,0.96875,1,1,1,0.96875,0.9032258064516129,0.051,0.366,0.451,0.013,1.525,194.13662804735787,2074.215162475707,0.064,0.348,0.636,0.009,1.186,188.0501865199918,2015.5050012561107,0.131,0.29,0.536,0.014,1.371,174.72680480206574,2000.399745485215,117.3076923076923,131.77777777777777,97.92857142857143,FALSE,304,0.9007407407407407,1,1,0,3,6,FALSE
358,2022-03-18T20:05:18Z,0.8999999761581421,1.7786458333333333,768,7,4,3,2,1,3,1,1,3,2,1,1,1,1,3,2,3,1,2,1,3,4,1,2,1,2,1,4,2,3,2,2,3,2,2,3,2,3,2,3,1,2,2,2,2,2,2,1,1,3,4,3,2,3,1,3,4,1,2,3,2,1,1,2,1,1,1,1,4,3,4,4,3.75,0,1.8666666666666667,0,2.4444444444444446,0,2.0833333333333335,0,2.3333333333333335,0,1.7142857142857142,0,1,0,2.054054054054054,0,1,2,2,-0.1843165945986138,-0.3671384142776524,3.7590724761401964,1.695967030931272,2,1,3,1,1,1,1,3.5,0.257895719101941,3,4,4,4,3,3,5,3.7142857142857144,0,0.4002850852868561,0,0.38961212528815947,1,1,2,3,2,5,3,5,5,4,4,4,4,3,3,4,4,4,3,2,1.8,0,4.2,0,3.6,0,3.6,0,3.8,0,2,2,1,1,3,2,3,3,1,3,1,2,2,2,1,1,1,2,1,2,1.8,0,"White, Caucasian, Anglo, European American",0,28,0,1,NA,5,2,0,0,1,0,0,TRUE,TRUE,TRUE,TRUE,TRUE,3,0.73071875,0.71840625,0.6441875,0.7649032258064516,0.7699032258064517,0.71665625,1,1,1,1,1,1,0.188,0.371,0.697,0.018,1.479,43.35186884621791,1828.4354376318768,0.109,0.526,0.537,0.05,1.69,21.532954942473772,1802.396555412324,0.154,0.469,0.557,0.113,1.317,101.98850255317232,1894.3090050223905,82.16666666666667,33.8,11.654867256637168,FALSE,380,1.125925925925926,0,1,0,0,3,FALSE
359,2022-03-18T20:25:41Z,1,1.7777777777777777,1080,6,2,1,1,2,1,1,1,2,1,1,1,1,2,3,2,5,1,3,1,1,1,1,1,1,0,2,0,0,0,0,5,5,1,3,3,1,2,1,1,1,1,1,1,2,1,1,1,1,1,3,1,2,1,1,1,1,1,1,1,1,1,2,3,1,1,1,1,1,1,1,1,1,0,1.6666666666666667,0,2.4444444444444446,0,1.25,0,1.1666666666666667,0,1.4285714285714286,0,1,0,1.5405405405405406,0,0,0,0,-0.9234281803240519,-0.9515340691467947,-0.6189692744445258,-0.7852516717956602,3,3,3,3,3,3,2,2,0.5070352173765494,5,5,5,5,4,4,5,4.714285714285714,0,-0.10840883202778547,0,0.6215907203900977,2,1,2,2,1,4,5,5,5,3,5,4,4,4,3,5,5,3,4,5,1.6,0,4.2,0,4.2,0,4.4,0,4.266666666666667,0,1,1,1,3,2,1,1,2,1,2,1,1,1,1,1,3,1,1,1,1,1.35,0,"White, Caucasian, Anglo, European American",0,27,1,2,NA,5,2,0,0,1,0,0,TRUE,TRUE,TRUE,TRUE,TRUE,1,0.4309218748807907,0.40365937507152555,0.43359375005960465,0.5291516127740183,0.46853703707235833,0.49266428569384985,1,1,1,0.96875,0.8709677419354839,0.875,0.045,0.36,0.645,0.021,1.674,29.483778316363484,1891.2541745710391,0.05,0.343,0.848,0.025,1.942,91.63519745967892,1959.5014367701312,0.085,0.315,0.798,0.015,1.835,124.10491950015997,1946.60944273295,79.71428571428571,77.67999999999999,122.33333333333333,FALSE,317,0.9392592592592592,0,1,0,3,6,FALSE
360,2022-03-18T20:17:52Z,0.8999999761581421,1.6,1050,7,2,3,4,1,4,5,2,4,1,4,2,4,2,5,4,3,3,2,2,1,3,2,4,4,1,2,0,0,0,0,2,2,4,5,3,4,4,5,2,2,4,1,4,3,3,4,5,4,2,3,1,2,5,2,2,1,4,3,2,4,4,1,2,3,2,2,1,3,4,2,2,2.75,0,3.2,0,3.4444444444444446,0,3,0,2.6666666666666665,0,2.7142857142857144,0,1.6666666666666667,0,2.891891891891892,0,1,0,0,0.8464918484012556,0.9082463482417449,0.20346385825749233,0.5558551032496186,4,2,5,3,3,2,3,2.5,0.8663065153158088,2,4,3,3,2,1,4,2.7142857142857144,0,-0.3705761363900806,0,-0.6217300893464665,4,4,5,3,4,4,3,5,5,4,4,3,1,4,3,5,2,4,4,5,4,0,3.4,0,3.4,0,4.4,0,3.7333333333333334,0,2,2,4,2,4,4,2,3,2,1,3,3,4,3,3,1,3,3,2,3,2.7,0,Black or African American,0,24,0,1,NA,5,2,0,0,1,0,0,TRUE,TRUE,TRUE,TRUE,TRUE,5,0.5497677419355079,0.49233437499997673,0.5355838709679102,0.6386615384615815,0.5672593749998487,0.5885483870967141,0.96875,1,1,0.8125,1,0.96875,0.047,0.468,0.708,0.033,1.865,70.67233035677378,1897.222957110493,0.136,0.314,0.726,0.019,1.399,105.84136714867384,1889.8460123088555,0.053,0.406,0.375,0.012,1.758,109.25023820680128,2057.264643132895,56.515151515151516,73.63157894736842,146.5,FALSE,392,1.1614814814814816,0,1,0,0,3,FALSE
362,2022-03-18T20:09:34Z,1,1.7786458333333333,768,4,3,1,1,2,1,2,1,1,1,2,1,1,2,1,1,2,3,2,5,1,2,2,2,1,4,2,0,0,0,0,1,1,1,1,1,1,2,1,1,2,1,1,1,2,1,2,1,1,1,2,1,3,1,1,2,3,3,1,5,1,1,1,1,1,1,2,1,2,2,2,1,1.75,0,1.3333333333333333,0,1.1111111111111112,0,1.3333333333333333,0,2.1666666666666665,0,1.5714285714285714,0,1.3333333333333333,0,1.4594594594594594,0,2,0,0,-0.32687520905604234,-0.6958671159817653,0.07821504497010326,-0.30882603550583104,1,1,3,1,1,2,1,1.5,-0.5157127766089035,4,5,5,5,1,1,3,3.4285714285714284,0,-1.0027804535789941,0,-0.6197857343318475,1,2,2,2,2,4,5,3,5,2,4,4,4,4,5,3,4,4,3,1,1.8,0,4,0,3.4,0,3.6,0,3.6666666666666665,0,1,1,1,1,2,1,2,1,1,1,1,1,1,1,1,1,1,1,1,1,1.1,0,"White, Caucasian, Anglo, European American",0,24,0,1,NA,5,2,0,0,1,0,0,TRUE,TRUE,TRUE,TRUE,TRUE,1,0.6572032258064305,0.563050000000032,0.6275906250000407,0.7556625000000349,0.6482399999999752,0.6956812500000232,0.96875,1,1,1,0.9375,1,0.115,0.427,0.586,0.01,1.041,152.62223893443348,1935.331568203247,0.078,0.393,0.501,0.016,1.985,106.13719603641312,1951.1681098096803,0.197,0.285,0.537,0.01,1.332,110.89666889229986,1933.615082799695,104.1,124.0625,133.20000000000002,FALSE,338,1.0014814814814814,0,1,0,0,3,FALSE
363,2022-03-18T20:34:24Z,1,1.7777777777777777,1080,5,4,3,2,1,3,1,1,3,1,1,1,1,3,1,3,5,1,3,1,1,1,2,2,1,0,2,0,0,0,0,2,3,4,3,3,2,1,1,2,1,1,1,1,4,1,5,1,1,2,3,1,3,1,1,2,1,1,1,1,1,1,2,1,1,1,2,1,2,1,1,1,1.25,0,2,0,2.3333333333333335,0,1.8333333333333333,0,1.5,0,1.1428571428571428,0,1.3333333333333333,0,1.7297297297297298,0,0,0,0,-0.6383109514091944,-0.6142503578560059,-0.5328163702636706,-0.5735333640598382,1,1,5,1,1,1,1,2.5,-0.04597394174770708,4,5,5,4,1,1,4,3.4285714285714284,0,-0.8792700537047221,0,-0.5445568447258828,1,2,1,2,2,4,3,4,5,3,3,2,5,3,3,4,1,5,3,4,1.6,0,3,0,3.6,0,3.8,0,3.466666666666667,0,1,1,1,3,1,2,2,2,1,1,2,2,4,2,1,2,1,1,1,1,1.6,0,"White, Caucasian, Anglo, European American",0,27,0,1,NA,5,2,0,0,1,0,0,TRUE,TRUE,TRUE,TRUE,TRUE,2,0.5642838710661857,0.5030031249523162,0.5646687501370907,0.7263656248748303,0.641406249910593,0.6819299999554952,0.96875,1,1,1,1,1,0.141,0.328,0.6,0.012,1.549,26.47821779864742,1807.6407745394372,0.165,0.254,0.666,0.014,1.896,39.272815882501355,1824.0411939804976,0.157,0.302,0.597,0.009,1.597,132.88847516109126,1956.7253123502471,129.08333333333331,135.42857142857142,177.44444444444446,FALSE,288,0.8533333333333333,0,1,0,6,9,FALSE
367,2022-03-18T20:40:44Z,0.8999999761581421,1.7777777777777777,1080,7,4,2,2,2,2,1,1,2,2,1,2,1,2,2,2,3,1,1,1,1,1,1,1,1,0,2,0,0,0,0,1,2,2,1,2,1,1,1,1,2,1,1,1,3,2,2,1,1,1,1,1,1,1,1,1,1,1,1,1,1,1,1,1,1,1,1,1,2,1,1,1,1.25,0,1.8,0,1.3333333333333333,0,1.4166666666666667,0,1,0,1,0,1,0,1.2162162162162162,0,0,0,0,-1.2962737873665577,-1.1440709515687668,-0.5328163702636706,-0.8384436609162187,2,1,4,1,1,3,2,1,-0.3773765525135179,2,2,4,3,2,1,4,2.5714285714285716,0,-1.2405296635269585,0,-1.2290123368492405,2,1,1,2,1,4,4,5,5,2,4,4,5,5,3,4,1,5,4,4,1.4,0,3.6,0,3.8,0,4.4,0,3.933333333333333,0,1,1,1,2,2,1,2,2,1,1,1,2,2,1,1,1,1,2,1,2,1.4,0,"Asian or Asian American (e.g., Chinese, Japanese, and others)",0,27,0,1,NA,5,2,0,0,1,0,0,TRUE,TRUE,TRUE,TRUE,TRUE,1,0.49182187499757857,0.48150312499981374,0.5134781250013039,0.5812714285733445,0.5244406249979511,0.5588249999945983,1,1,1,0.9032258064516129,1,1,0.156,0.3,0.748,0.019,1.411,140.26596659222105,1927.282200116987,0.107,0.352,0.877,0.042,2.017,15.508413748263164,1797.135916542358,0.065,0.372,0.579,0.017,1.978,84.72934317855118,1941.670241889824,74.26315789473685,48.02380952380952,116.35294117647058,FALSE,314,0.9303703703703704,0,1,0,3,6,FALSE
368,2022-03-18T20:51:13Z,0.8999999761581421,1.7777777777777777,864,3,2,3,4,4,3,3,2,3,5,5,3,3,4,3,3,2,3,3,5,1,3,1,3,2,2,1,1,0,0,0,4,3,1,3,4,2,2,3,3,3,4,3,4,2,2,2,3,2,4,2,4,3,3,2,3,3,4,2,2,4,3,3,2,3,3,3,3,1,2,1,2,1.5,0,3.3333333333333335,0,2.7777777777777777,0,2.9166666666666665,0,3,0,2.7142857142857144,0,3,0,2.864864864864865,0,1,0,0,0.8289461727757258,0.9546597335855501,-0.22730066264678367,0.36367953546938325,3,4,3,2,3,3,2,2.5,0.7004373413042606,1,1,3,3,1,2,4,2.142857142857143,0,-1.1834102584901123,0,-1.4264295318375892,3,3,2,2,3,3,1,4,2,3,3,4,4,2,4,4,3,5,2,3,2.6,0,3.6,0,2.8,0,3,0,3.1333333333333333,0,2,2,1,3,3,2,2,2,2,2,1,2,2,3,2,3,3,2,4,3,2.3,0,"Hispanic of Latino (e.g., Mexican American, Central American, and others)",0,19,0,1,NA,5,2,0,0,1,0,0,TRUE,TRUE,TRUE,TRUE,TRUE,1,0.4551096774147403,0.40423437500186266,0.5398687500003725,0.5322874999977648,0.445587096773809,0.5612724137922813,1,1,1,1,0.96875,0.9666666666666667,0.071,0.318,0.37,0.02,1.707,115.01872015517412,1940.4277575921408,0.062,0.266,0.443,0.038,1.839,85.82626890565392,1911.1010320742007,0.086,0.283,0.496,0.016,1.58,72.13972967401016,1854.65641529112,85.35000000000001,48.39473684210526,98.75,FALSE,343,1.0162962962962963,0,1,0,3,6,FALSE
369,2022-03-18T20:52:19Z,0.8999999761581421,1.6,800,6,5,3,1,2,2,1,1,1,1,1,1,1,1,1,1,2,1,1,1,3,1,1,1,1,0,2,0,0,0,0,2,2,1,1,2,1,2,1,2,1,2,3,1,2,1,1,1,4,3,2,3,1,1,1,1,1,1,2,1,2,1,1,1,1,1,2,1,3,2,3,2,2.5,0,1.3333333333333333,0,1.5555555555555556,0,2,0,1,0,1.2857142857142858,0,1.3333333333333333,0,1.5405405405405406,0,0,0,0,-0.9234281803240519,-1.0970675655638116,-0.10205184935939461,-0.5995597074616031,1,1,2,2,1,1,1,2,-0.40524523968696646,5,5,5,5,4,3,5,4.571428571428571,0,0.2196552803757379,0,0.7440084563925745,1,2,2,1,1,5,1,5,4,1,5,4,5,3,4,4,5,5,2,2,1.4,0,4.8,0,2.6,0,3.6,0,3.6666666666666665,0,1,1,1,1,1,1,3,1,1,1,2,1,3,1,1,1,1,2,1,1,1.3,0,"White, Caucasian, Anglo, European American",0,26,0,1,NA,5,2,0,0,1,0,0,TRUE,TRUE,TRUE,TRUE,TRUE,2,0.7547666666666667,0.6614193548387097,0.6357741935483872,0.7745806451612903,0.6693548387096774,0.6675806451612903,0.9375,0.96875,0.96875,0.96875,0.96875,1,0.078,0.349,0.274,0.037,1.382,97.53146941748264,1920.9398218939943,0.065,0.431,0.28,0.255,1.774,75.85597282495213,1941.5097172697735,0.074,0.439,0.214,0.256,1.717,114.89937091478188,2022.5372874074856,37.35135135135135,6.956862745098039,6.70703125,FALSE,336,0.9955555555555555,0,1,0,0,3,FALSE
370,2022-03-18T20:36:35Z,0.8999999761581421,1.7786458333333333,768,4,3,3,3,2,3,2,1,2,2,2,2,2,3,3,2,2,2,3,1,1,1,1,2,1,1,1,2,0,0,0,2,2,3,2,2,1,1,1,1,1,1,3,1,3,1,1,2,2,2,2,2,3,1,1,1,3,1,1,1,1,1,2,3,3,1,1,1,1,1,2,2,1.5,0,2.2666666666666666,0,1.6666666666666667,0,1.75,0,1.6666666666666667,0,1.7142857142857142,0,1,0,1.6486486486486487,0,1,0,0,-0.6909479782857835,-0.5332236003913966,-0.22730066264678367,-0.38026213151909016,3,2,4,2,1,3,2,1.5,0.06482933243151565,3,3,4,4,2,2,4,3.142857142857143,0,-1.0534549923719885,1,-0.8054564150896155,2,2,2,2,2,4,3,4,4,4,5,3,5,3,4,3,3,4,3,3,2,0,3.8,0,3.6,0,3.6,0,3.6666666666666665,0,2,1,2,2,2,2,3,2,2,1,2,2,4,2,2,2,1,1,1,3,1.95,0,Black or African American,0,28,0,1,NA,5,2,0,0,2,0,0,TRUE,TRUE,TRUE,TRUE,TRUE,3,0.6309656249992549,0.5355656249932945,0.5425468750074506,0.6879281249940395,0.610449999988079,0.6598709677496264,1,1,1,1,1,1,0.217,0.271,0.794,0.008,1.237,29.67239725363008,1814.2723485459687,0.145,0.267,0.567,0.018,1.906,42.23655831485796,1823.800746784815,0.096,0.376,0.412,0.027,1.777,54.804829700661415,1838.4388106995468,154.625,105.88888888888889,65.81481481481481,FALSE,449,1.3303703703703704,0,1,0,0,3,FALSE
371,2022-03-18T20:55:27Z,1,1.7786458333333333,768,4,3,2,2,3,2,2,2,3,3,3,2,3,3,3,3,2,2,3,3,2,2,2,2,2,0,1,1,0,0,0,1,1,2,1,1,1,1,1,1,1,1,5,1,2,2,1,2,2,3,3,3,3,2,2,2,3,2,2,1,1,1,2,2,2,1,2,2,2,2,1,1,1.5,0,2.533333333333333,0,1.1111111111111112,0,2.1666666666666665,0,2.3333333333333335,0,1.5714285714285714,0,1.6666666666666667,0,1.7837837837837838,0,0,0,0,-0.1163271015496859,-0.030346370204488746,-0.4466634660828154,-0.23850491814365207,4,4,4,3,3,4,5,4.5,2.0545879460555243,4,4,4,4,2,2,3,3.2857142857142856,0,-0.8792700537047221,0,-0.62195951996656,3,4,3,2,3,4,4,3,3,4,4,3,4,4,4,4,4,4,3,3,3,0,3.8,0,3.8,0,3.4,0,3.6666666666666665,0,1,1,2,2,2,2,2,2,2,2,2,2,2,2,2,2,2,2,2,3,1.95,0,"White, Caucasian, Anglo, European American",0,27,1,2,NA,5,2,0,0,1,0,0,TRUE,TRUE,TRUE,TRUE,TRUE,6,0.546875,0.482,0.54740625,0.6145625,0.5585625,0.68275,1,1,1,1,1,1,0.1,0.381,0.595,0.015,1.85,52.670358790899485,1837.2540070521163,0.092,0.373,0.895,0.012,1.319,46.22242391603809,1835.603279186508,0.123,0.357,0.656,0.026,1.818,29.87103636071133,1810.237466084213,123.33333333333334,109.91666666666666,69.92307692307693,FALSE,338,1.0014814814814814,0,1,0,3,6,FALSE
372,2022-03-18T20:52:51Z,0.800000011920929,1.7777777777777777,1080,6,3,1,1,1,2,2,2,1,1,2,1,1,1,1,1,1,1,1,1,1,1,1,1,1,0,2,0,0,0,0,1,1,2,1,2,2,2,2,3,1,2,1,1,4,1,4,3,2,1,1,2,2,1,1,1,1,1,1,1,1,1,2,1,1,1,1,1,1,2,4,4,2.75,0,1.2666666666666666,0,1.7777777777777777,0,1.9166666666666667,0,1.1666666666666667,0,1.1428571428571428,0,1,0,1.5405405405405406,0,0,0,0,-1.0857256798602015,-1.2353243871599773,-0.01589894517853939,-0.6256116661692583,4,4,4,3,3,3,4,3,1.3085124002608426,5,5,5,5,1,1,5,3.857142857142857,0,-0.23191923190205752,0,0.08194577934007008,2,3,3,2,2,4,4,4,4,3,4,3,5,3,4,3,5,4,2,3,2.4,0,4,0,3.4,0,3.6,0,3.6666666666666665,0,1,1,1,3,2,1,1,2,1,1,2,2,1,1,1,2,1,1,1,1,1.35,0,"Hispanic of Latino (e.g., Mexican American, Central American, and others) & White, Caucasian, Anglo, European American",1,30,0,4,they,5,2,0,0,0,0,0,TRUE,TRUE,TRUE,TRUE,TRUE,1,0.5427312499999826,0.46425161290320477,0.5122968750000109,0.5924580645161275,0.5113966666666403,0.5814322580645169,1,1,1,1,0.9375,1,0.079,0.371,0.553,0.017,1.327,13.32462245944159,1794.016760415982,0.054,0.367,0.558,0.011,1.083,156.18099619998964,2003.820286121805,0.121,0.37,0.733,0.036,1.879,73.81678517889729,1857.073319652097,78.05882352941175,98.45454545454545,52.19444444444445,FALSE,279,0.8266666666666667,0,1,0,9,12,FALSE
373,2022-03-18T20:58:03Z,0.8999999761581421,1.7777777777777777,1080,6,2,4,1,3,3,3,1,5,3,3,1,3,5,2,5,5,3,1,2,1,1,2,3,2,0,2,0,0,0,0,1,5,4,1,5,5,3,3,5,1,1,5,5,5,2,1,1,5,5,4,4,5,1,1,1,1,1,1,1,1,1,1,1,1,1,1,2,4,4,3,3,3.5,0,3.1333333333333333,0,3.5555555555555554,0,3.25,0,1.6666666666666667,0,1,0,1.3333333333333333,0,2.4864864864864864,0,0,0,0,0.09641421540986095,0.37468908367503295,0.24255976736402618,0.30862442551952957,4,5,3,3,3,5,5,2.5,1.3639140373504541,5,3,3,3,1,1,3,2.7142857142857144,0,0.1928696799855022,1,-0.2785411500975462,3,3,3,1,3,3,5,5,5,5,1,5,3,1,5,3,3,1,3,2,2.6,0,2.6,0,3.8,0,3.6,0,3.3333333333333335,0,4,2,4,4,4,4,1,4,4,2,2,4,4,2,1,3,4,4,4,4,3.25,0,"Asian or Asian American (e.g., Chinese, Japanese, and others)",0,24,0,1,NA,5,2,0,0,1,0,0,TRUE,TRUE,TRUE,TRUE,TRUE,6,0.5834218750074506,0.46096874998509885,0.5601343750003726,0.6107827586264446,0.5171064516036741,0.6468133333345254,1,1,1,0.90625,0.96875,0.9375,0.074,0.29,0.305,0.012,1.528,169.2914284548985,2035.7298768361889,0.06,0.334,0.513,0.015,1.269,52.11895976501883,1879.116190977611,0.058,0.398,0.383,0.024,2.023,99.68843071629186,1954.4968439502788,127.33333333333333,84.6,84.29166666666667,FALSE,312,0.9244444444444444,0,1,0,0,3,FALSE
374,2022-03-18T20:58:05Z,1,1.6,900,4,2,5,5,5,4,5,5,5,5,5,5,5,5,2,5,5,4,5,5,4,4,5,5,5,2,1,1,0,2,0,5,5,5,5,5,5,5,5,5,4,4,5,4,5,3,2,5,5,5,5,5,5,3,5,5,5,3,4,2,2,2,4,5,5,5,5,5,2,4,3,2,2.75,0,4.733333333333333,0,5,0,4.333333333333333,0,4.333333333333333,0,3.4285714285714284,0,5,0,4.378378378378378,0,1,0,0,3.1098840040945857,3.099902137527198,0.20346385825749233,1.651682997892345,5,4,5,4,3,5,5,8,3.740141161572599,2,2,2,1,1,1,1,1.4285714285714286,0,-0.9179826386886498,1,-1.6517737277230051,3,4,4,5,4,4,5,4,4,4,5,5,1,3,5,5,5,4,5,5,4,0,4.6,0,4,0,4.2,0,4.266666666666667,0,2,4,4,3,4,4,4,3,1,3,4,3,1,2,1,2,3,4,2,4,2.9,0,"Hispanic of Latino (e.g., Mexican American, Central American, and others)",0,21,1,2,NA,5,2,1,1,1,0,2,TRUE,TRUE,TRUE,TRUE,TRUE,2,0.6968093750006519,0.5699999999990386,0.5346562500004657,0.7774064516127109,0.667087096773809,0.679659374999348,1,1,1,0.96875,1,1,0.101,0.348,0.54,0.014,1.962,49.417443770010415,1835.0571325563644,0.168,0.283,0.596,0.007,1.107,38.43061996379507,1822.5645815244363,0.254,0.138,0.492,0.014,1.798,161.0249010178807,1988.8242519112805,140.14285714285714,158.14285714285714,128.42857142857142,FALSE,434,1.285925925925926,0,1,0,0,3,FALSE
375,2022-03-18T20:54:57Z,0.8999999761581421,2.3703703703703702,1080,5,4,2,1,2,2,1,1,2,2,1,1,1,1,2,2,3,2,3,1,1,1,2,3,2,3,2,0,0,0,0,1,2,1,2,3,3,4,4,3,2,2,3,1,1,3,1,3,2,3,1,2,2,1,1,1,3,2,2,5,4,1,1,1,1,1,2,1,2,1,2,3,2,0,1.6,0,2.5555555555555554,0,2,0,1.6666666666666667,0,2.142857142857143,0,1.3333333333333333,0,2.054054054054054,0,2,0,0,-0.1843165945986138,-0.48356521141126574,0.16436794915095845,-0.15959863113015366,1,2,3,2,1,2,2,3,0.3132973561915524,4,3,3,4,5,4,4,3.857142857142857,0,0.9002015995971155,0,0.7715087079692513,2,3,3,4,3,2,3,3,4,3,4,3,2,4,3,5,3,4,3,3,3,0,3.2,0,3.2,0,3.4,0,3.2666666666666666,0,1,1,1,1,2,1,3,2,1,1,2,1,2,1,1,1,1,1,1,1,1.3,0,"White, Caucasian, Anglo, European American",0,21,0,1,NA,5,2,0,0,1,0,0,TRUE,TRUE,TRUE,TRUE,TRUE,5,0.463906249998603,0.37327419354886776,0.41295312500093134,0.5333551724131765,0.4560875000022352,0.4929107142841177,1,1,1,0.90625,0.75,0.875,0.066,0.277,0.538,0.018,2.014,93.66622948238825,1961.453530159552,0.051,0.28,0.608,0.017,2.055,37.5643107407313,1931.0580111982129,0.06,0.319,0.469,0.02,2.016,32.42160752520742,1886.148365331706,111.88888888888889,120.88235294117648,100.8,FALSE,322,0.9540740740740741,0,1,0,15,18,FALSE
376,2022-03-18T21:09:02Z,0.8999999761581421,1.7777777777777777,720,6,2,1,1,2,2,2,2,2,2,2,1,1,2,1,2,2,2,1,1,1,1,2,1,1,1,2,0,0,0,0,1,2,1,2,2,1,2,2,2,2,1,1,1,2,2,1,2,2,2,1,2,1,1,1,1,1,1,2,2,1,1,2,2,2,1,1,1,1,1,1,1,1,0,1.6666666666666667,0,1.6666666666666667,0,1.5833333333333333,0,1,0,1.7142857142857142,0,1,0,1.4864864864864864,0,1,0,0,-0.9585195315751113,-0.9751340955927975,-0.39960647100849406,-0.6873702833006458,1,2,1,1,1,2,2,1,-0.7091149005366146,4,5,5,5,2,2,4,3.857142857142857,0,0.7947401925278054,0,0.7072732706442727,4,3,2,2,2,3,4,4,4,4,5,5,4,3,5,3,4,4,4,4,2.6,0,4.2,0,3.8,0,4,0,4,0,2,1,3,4,2,2,2,4,3,2,2,3,2,2,2,3,1,3,4,2,2.45,0,"Asian or Asian American (e.g., Chinese, Japanese, and others) & White, Caucasian, Anglo, European American",1,25,1,2,NA,5,2,0,0,1,0,0,TRUE,TRUE,TRUE,TRUE,TRUE,5,0.44159375,0.42116129032258065,0.4721875,0.5201153846153846,0.5255333333333333,0.5902068965517241,1,0.96875,1,0.8125,0.9375,0.90625,0.069,0.334,0.513,0.009,1.496,54.21456936987422,1909.205686567085,0.051,0.338,0.555,0.018,1.855,116.12888164422472,2003.175439929503,0.05,0.343,0.551,0.016,1.9,79.14517579793655,1937.411350314403,166.22222222222223,103.05555555555556,118.74999999999999,FALSE,366,1.0844444444444443,0,1,0,0,3,FALSE
377,2022-03-18T20:59:20Z,0.8999999761581421,1.7786458333333333,768,2,2,1,3,4,4,3,2,3,2,2,2,4,3,2,4,4,4,4,5,2,3,4,3,5,7,1,0,0,1,1,3,4,3,4,4,4,5,5,4,4,3,4,3,4,2,4,2,4,4,4,4,5,2,4,3,4,3,2,4,3,2,2,1,2,4,4,3,3,3,4,4,3.5,0,2.8666666666666667,0,4,0,3.5,0,3.5,0,2.2857142857142856,0,3.6666666666666665,0,3.4054054054054053,0,4,1,0,1.9101984331989927,1.4780886534691855,1.8193759925586375,1.6487323230139115,3,2,4,1,1,2,1,2,0.009427695341904336,3,2,3,3,2,2,3,2.5714285714285716,0,-1.0534549923719885,1,-1.115067116052324,3,2,3,2,3,4,4,3,4,2,5,4,1,3,3,3,4,4,3,3,2.6,0,4.2,0,2.6,0,3.2,0,3.3333333333333335,0,2,1,2,3,3,2,2,3,3,3,3,3,2,1,2,3,1,3,3,3,2.4,0,"Hispanic of Latino (e.g., Mexican American, Central American, and others) & White, Caucasian, Anglo, European American",1,25,1,2,NA,5,2,0,0,0,0,0,TRUE,TRUE,TRUE,TRUE,TRUE,2,0.7582966666678588,0.5900250000040979,0.7228874999955297,0.8682566666642825,0.7655062499996275,1.0448062499966473,0.9375,1,1,0.967741935483871,1,1,0.198,0.15,0.328,0.008,1.899,46.24391417205798,1827.9046488643253,0.326,0.135,0.712,0.002,0.837,13.360590556742563,1815.8955951187345,0.08,0.423,0.204,0.015,1.648,115.89854435197644,2025.4517307498943,237.375,418.5,109.86666666666666,FALSE,340,1.0074074074074075,0,1,0,0,3,FALSE
378,2022-03-18T21:06:23Z,0.8999999761581421,1.6,900,6,2,2,1,3,2,3,1,2,2,2,1,1,1,3,1,2,1,1,3,1,1,1,2,1,0,1,2,0,2,0,1,1,1,1,1,1,1,1,1,2,1,1,1,2,1,1,2,1,1,1,1,3,1,2,1,3,2,1,1,1,1,1,3,1,1,1,1,2,2,2,1,1.75,0,1.8,0,1,0,1.25,0,2,0,1.2857142857142858,0,1,0,1.2972972972972974,0,0,0,0,-1.000190511185744,-0.9449457284306189,-0.3605105619019602,-0.6527281451662895,3,3,5,2,2,4,4,2,0.7558389783938718,4,4,4,4,1,1,3,3,0,-1.2224806707219966,0,-0.9858108588462231,3,3,2,3,3,4,5,3,5,3,5,5,4,5,3,5,5,4,3,4,2.8,0,4.6,0,4,0,4,0,4.2,0,1,1,1,2,1,1,2,1,2,1,2,1,1,2,1,2,1,2,1,2,1.4,0,"Hispanic of Latino (e.g., Mexican American, Central American, and others) & Filipino",1,27,1,2,NA,5,2,0,1,2,0,1,TRUE,TRUE,TRUE,TRUE,TRUE,5,0.6663843749947846,0.6061419354831019,0.608106249999255,0.7282838709710105,0.6690999999940396,0.7083781250026077,1,1,1,1,1,1,0.155,0.326,0.558,0.012,1.402,19.993586291027057,1801.836912473237,0.185,0.299,0.637,0.018,1.683,74.18169876319938,1859.9914818761583,0.152,0.356,0.5,0.01,1.106,91.99029285016267,1878.339437592536,116.83333333333333,93.50000000000001,110.60000000000001,FALSE,440,1.3037037037037038,0,1,0,0,3,FALSE
379,2022-03-18T21:11:41Z,1,1.6,800,4,1,5,3,5,4,5,4,4,5,4,3,5,5,4,5,3,5,5,1,1,5,5,5,5,2,2,0,0,0,0,3,3,3,3,3,3,5,4,4,5,2,5,4,3,5,3,5,5,5,5,5,5,2,1,1,1,1,2,2,2,1,2,3,4,3,1,5,1,5,4,5,3.75,0,4.266666666666667,0,3.4444444444444446,0,4.333333333333333,0,1.8333333333333333,0,2.2857142857142856,0,3,0,3.2162162162162162,0,1,0,0,1.9496762033564343,2.115879368172409,0.5480754749809131,1.331977421576661,2,2,1,1,1,2,2,7.5,1.888047297529404,5,5,5,5,2,3,5,4.285714285714286,0,1.384971609293624,0,1.2989850639765426,3,3,3,3,3,3,3,4,3,2,5,5,2,3,4,2,2,3,3,3,3,0,3.6,0,2.4,0,3.4,0,3.1333333333333333,0,2,2,2,3,3,2,4,2,2,3,3,3,4,1,2,2,2,2,4,3,2.55,0,"White, Caucasian, Anglo, European American",0,28,1,2,NA,5,2,0,0,1,0,0,TRUE,TRUE,TRUE,TRUE,TRUE,4,0.6201875000037252,0.5660968749970198,0.5777562500014901,0.6759312500022352,0.6469580645368945,0.6294548386989102,1,1,1,1,1,1,0.119,0.387,0.63,0.02,1.415,177.1401934084297,1966.550406665099,0.109,0.405,0.677,0.017,1.545,33.747784708275375,1816.2715412044904,0.103,0.423,0.551,0.016,1.418,68.86362723191017,1855.5461241152027,70.75,90.88235294117646,88.625,FALSE,354,1.0488888888888888,0,1,0,0,3,FALSE
380,2022-03-18T20:58:29Z,0.8999999761581421,1.7777777777777777,1080,3,4,3,2,2,2,1,1,2,1,1,1,1,2,1,2,3,2,3,2,2,3,2,3,3,0,1,1,0,2,1,2,1,2,1,1,2,3,2,2,1,2,1,2,2,1,2,1,4,1,1,1,4,2,4,4,3,3,1,1,2,2,2,1,1,1,1,1,2,2,2,2,2,0,1.6666666666666667,0,1.7777777777777777,0,1.5833333333333333,0,3.3333333333333335,0,1.4285714285714286,0,1,0,1.837837837837838,0,0,1,0,0.08106174923752274,-0.2759833121299669,0.4250073537293794,0.07451202079970626,1,1,2,1,1,1,2,1,-0.7920494875423887,4,5,5,5,2,2,5,4,0,0.8098866971415565,0,0.7939015230401045,3,2,2,2,2,5,3,5,5,1,5,3,5,3,4,2,4,4,3,1,2.2,0,4.2,0,2.8,0,3.6,0,3.533333333333333,0,2,2,2,2,3,2,1,2,1,1,3,2,1,2,1,3,3,2,2,1,1.9,0,"White, Caucasian, Anglo, European American",0,22,0,1,NA,5,2,1,0,0,0,1,TRUE,TRUE,TRUE,TRUE,TRUE,5,0.5508999999843794,0.4490968750156462,0.435234375,0.6049607142720904,0.5295812499932945,0.5281290322465282,0.9354838709677419,1,1,0.875,1,0.96875,0.065,0.338,0.677,0.015,1.592,86.23713233882445,1916.6400797794263,0.156,0.248,0.79,0.012,1.343,29.68934454462706,1816.2311110882208,0.051,0.377,0.289,0.016,1.642,118.55184291189062,2065.9282585032997,106.13333333333334,111.91666666666666,102.62499999999999,FALSE,326,0.965925925925926,0,1,0,3,6,FALSE
381,2022-03-18T21:19:05Z,0.8999999761581421,1.7777777777777777,864,3,2,2,1,2,2,2,1,1,2,2,2,2,2,2,2,2,1,1,1,1,2,2,2,1,0,2,0,0,0,0,1,1,1,1,3,2,2,2,2,2,2,3,2,3,2,2,3,4,4,3,3,2,1,1,1,3,4,1,1,3,3,2,2,2,1,1,1,2,2,2,2,2,0,1.8,0,1.6666666666666667,0,2.75,0,2,0,2,0,1,0,2.081081081081081,0,0,0,0,-0.4913659180453832,-0.6027453449635795,-0.274357657721105,-0.4385515013423422,2,1,4,2,1,2,3,3,0.47916653020310074,4,4,5,4,3,3,5,4,0,-0.3222341343576166,0,0.10433859441092333,3,3,3,3,3,4,3,5,3,1,2,2,5,4,5,2,2,3,4,2,3,0,2.6,0,3,0,3.8,0,3.1333333333333333,0,2,3,3,2,1,3,3,4,2,2,3,3,2,3,2,3,1,3,2,2,2.45,0,"White, Caucasian, Anglo, European American",0,27,0,1,NA,5,2,0,0,0,0,0,TRUE,TRUE,TRUE,TRUE,TRUE,5,0.5652312500327825,0.4101281249076128,0.46843437503278257,0.619222580709765,0.44261999991734824,0.5148812500685453,1,1,1,0.96875,0.9375,1,0.07,0.34,0.54,0.04,1.85,96.0134403441342,1882.627849035469,0.045,0.341,0.741,0.034,1.731,79.65671575002841,1937.5906687434976,0.071,0.41,0.447,0.026,1.569,64.47358161966481,1889.799096142568,46.25,50.911764705882355,60.34615384615385,FALSE,420,1.2444444444444445,0,1,0,3,6,FALSE
382,2022-03-18T21:12:34Z,0.8999999761581421,1.7777777777777777,864,4,2,4,3,4,3,3,2,4,3,3,4,3,4,2,4,3,2,3,1,1,2,4,2,3,0,2,0,0,0,0,2,1,2,2,4,2,1,1,3,2,2,3,1,4,2,4,3,2,3,3,3,3,1,1,1,3,3,1,1,1,1,2,2,2,3,4,3,2,2,1,2,1.75,0,3.2666666666666666,0,2,0,2.6666666666666665,0,2,0,1.4285714285714286,0,3.3333333333333335,0,2.2162162162162162,0,0,0,0,0.16440370845878854,0.47862753348097037,-0.3605105619019602,0.059058485789505094,3,2,4,1,1,2,2,1,-0.29444196550774376,2,3,3,2,1,1,2,2,0,-0.788955151249163,0,-1.2635737369628302,2,3,2,2,2,4,4,4,4,3,5,3,4,3,3,4,3,4,3,4,2.2,0,3.8,0,3.6,0,3.6,0,3.6666666666666665,0,2,1,3,4,2,4,4,4,3,2,3,3,2,4,2,4,1,4,4,3,2.95,0,"Hispanic of Latino (e.g., Mexican American, Central American, and others) & White, Caucasian, Anglo, European American",1,21,0,1,NA,5,2,0,0,2,0,0,TRUE,TRUE,TRUE,TRUE,TRUE,6,0.6429562499999738,0.6802375000000029,0.5439093749999884,0.6941499999999869,0.7275709677419641,0.5897062499999957,1,1,1,1,1,1,0.16,0.306,0.678,0.032,1.715,56.468710279493195,1842.5585847499744,0.095,0.32,0.297,0.207,1.815,73.76415411020709,1856.8797510554384,0.21,0.31,0.636,0.018,1.358,21.30638267721544,1803.666693610241,53.59375,8.768115942028986,75.44444444444446,FALSE,376,1.114074074074074,0,1,0,3,6,FALSE
383,2022-03-18T21:11:11Z,1,1.6,900,3,3,4,3,2,4,2,1,3,1,2,1,1,5,1,4,4,2,1,3,1,1,2,3,2,1,2,0,0,0,0,2,4,4,5,4,3,2,2,3,1,2,2,3,4,1,3,2,3,2,3,2,5,1,1,2,2,2,1,2,1,1,3,2,1,1,1,1,2,2,3,2,2.25,0,2.533333333333333,0,3.2222222222222223,0,2.3333333333333335,0,2.1666666666666665,0,1.5714285714285714,0,1,0,2.27027027027027,0,1,0,0,-0.04395118959437628,0.01832868434039202,0.031158049895781924,0.024743367118086973,2,1,4,1,1,2,2,3,0.3132973561915524,2,4,3,3,1,1,4,2.5714285714285716,0,-0.9124655511234351,0,-1.0291919256060862,1,1,2,2,2,5,3,2,5,4,5,4,4,4,4,5,4,4,4,3,1.6,0,4.4,0,4,0,3.6,0,4,0,2,1,1,3,1,2,2,2,1,1,2,3,1,2,1,3,1,1,1,2,1.65,0,Black or African American,0,21,0,1,NA,5,2,0,0,1,0,0,TRUE,TRUE,TRUE,TRUE,TRUE,4,0.4816451612903169,0.4295312499999955,0.5149374999999909,0.5097419354838691,0.5007333333333353,0.5926000000000117,0.96875,1,1,0.96875,0.9375,0.9375,0.067,0.349,0.429,0.021,2.064,41.24843894913052,1884.244775902078,0.058,0.337,0.654,0.02,1.811,71.12370354341506,1920.4029696025632,0.047,0.394,0.51,0.049,1.761,158.29321088523864,2027.499802514892,98.28571428571428,90.55,35.93877551020408,FALSE,436,1.2918518518518518,0,1,0,0,3,FALSE
384,2022-03-18T21:26:59Z,0.8999999761581421,1.6,900,4,3,4,3,1,2,2,2,3,4,2,2,3,3,4,3,4,2,3,1,1,1,1,2,1,0,2,0,0,0,0,2,4,3,2,2,1,2,2,2,1,2,4,1,3,2,2,3,1,3,2,2,2,1,1,1,3,2,1,1,1,1,2,3,1,1,1,2,2,2,1,1,1.5,0,2.8,0,2.2222222222222223,0,2.1666666666666665,0,1.6666666666666667,0,1.4285714285714286,0,1.3333333333333333,0,1.8918918918918919,0,0,0,0,-0.5330368976560161,-0.19416988711715735,-0.4466634660828154,-0.32041667659998635,2,1,3,1,1,2,2,1.5,-0.3498436025973552,4,5,4,4,2,2,5,3.7142857142857144,0,0.03902547546461973,0,0.16957268460886432,3,2,3,2,2,3,3,2,4,3,5,4,5,3,2,3,3,5,4,3,2.4,0,4,0,3.6,0,2.8,0,3.466666666666667,0,1,2,1,1,1,1,2,1,1,1,2,2,2,1,1,2,1,1,1,1,1.3,0,"White, Caucasian, Anglo, European American",0,20,1,2,NA,5,2,0,0,1,0,0,TRUE,TRUE,TRUE,TRUE,TRUE,5,0.5219516129041871,0.43554193548521686,0.4543968749996275,0.5888645161265327,0.4793499999980132,0.5471935483890195,1,0.96875,1,0.96875,0.967741935483871,0.96875,0.073,0.312,0.513,0.018,1.831,62.88911624906869,1887.6368722631005,0.054,0.307,0.412,0.037,2.154,119.52921596055344,1988.5590788630564,0.068,0.386,0.552,0.02,1.759,80.1009334256796,1900.7933195352755,101.72222222222223,58.21621621621622,87.94999999999999,FALSE,386,1.1437037037037037,0,1,0,0,3,FALSE
385,2022-03-18T21:24:24Z,0.8999999761581421,1.7777777777777777,864,6,4,1,1,1,1,1,1,1,1,1,1,1,1,1,1,1,1,1,1,1,1,1,1,1,0,2,0,0,0,0,1,1,1,1,1,1,1,1,1,1,1,1,1,1,1,1,1,1,1,1,1,1,1,1,1,1,1,1,1,1,1,1,1,1,1,1,1,1,1,1,1,1,0,1,0,1,0,1,0,1,0,1,0,1,0,1,0,0,0,0,-1.4366391923707953,-1.587751448753618,-0.6189692744445258,-1.103360361599072,1,1,1,1,1,1,1,1.5,-0.7645165376262261,5,5,5,5,3,3,5,4.428571428571429,0,1.2043418043825058,0,1.2663680188775723,1,1,1,1,1,4,4,4,4,4,3,5,5,4,2,3,4,4,5,4,1,0,4,0,4.2,0,3.6,0,3.933333333333333,0,2,2,1,2,3,2,2,1,1,1,2,2,2,2,1,2,1,2,2,2,1.75,0,"White, Caucasian, Anglo, European American",0,29,0,1,NA,5,2,0,0,1,0,0,TRUE,TRUE,TRUE,TRUE,TRUE,3,0.457712499987334,0.3648656250052154,0.3756593749932945,0.507828571417502,0.4052518518500858,0.4459466666976611,1,1,1,0.9032258064516129,0.84375,0.9375,0.056,0.284,0.628,0.018,1.57,61.56690949260089,1905.7088516802248,0.034,0.301,0.399,0.041,1.33,117.67601666989242,2087.2325889814133,0.057,0.348,0.592,0.019,1.682,137.7442244317538,2038.274211083108,87.22222222222223,32.4390243902439,88.52631578947368,FALSE,304,0.9007407407407407,1,1,0,0,3,FALSE
386,2022-03-18T21:06:16Z,1,1.6,900,6,2,4,2,4,4,5,2,4,4,3,3,1,4,4,4,4,3,4,5,1,2,4,4,3,2,1,1,0,1,0,3,5,5,5,5,5,5,5,5,5,5,1,4,4,3,4,5,3,3,2,2,4,1,1,1,3,1,1,5,5,1,4,4,1,3,1,1,2,2,2,1,1.75,0,3.466666666666667,0,4.777777777777778,0,3.4166666666666665,0,1.8333333333333333,0,3,0,1.6666666666666667,0,3.27027027027027,0,1,0,0,1.497875055999045,1.4627486362792836,-0.14114775846592847,0.6608004389066776,2,1,2,3,1,1,1,1,-0.6261803135308405,4,5,4,3,1,1,3,3,0,-0.4848149464637728,0,-0.536506400332478,1,3,2,1,2,4,4,4,5,1,5,5,5,4,4,4,4,5,4,2,1.8,0,4.6,0,3.6,0,3.8,0,4,0,1,1,1,1,2,2,2,2,1,1,2,2,1,1,1,1,1,1,1,1,1.3,0,"Asian or Asian American (e.g., Chinese, Japanese, and others)",0,26,1,2,NA,5,2,0,0,1,0,0,TRUE,TRUE,TRUE,TRUE,TRUE,5,0.5594516129032258,0.5176774193548387,0.5286129032258065,0.58821875,0.6062580645161291,0.646896551724138,1,1,1,1,1,0.90625,0.061,0.391,0.375,0.015,1.605,112.03258671352312,2022.527336299888,0.071,0.349,0.411,0.046,1.879,66.49284189018475,1846.9991851209895,0.09,0.329,0.443,0.031,1.957,121.38933478851504,1902.8215506952192,107,40.84782608695652,63.12903225806452,FALSE,446,1.3214814814814815,0,1,0,0,3,FALSE
388,2022-03-18T21:32:38Z,0.8999999761581421,1.6,800,6,3,1,1,2,2,1,1,2,1,1,1,1,2,2,2,2,1,2,1,1,1,1,1,1,0,2,0,0,0,0,1,4,3,4,3,2,2,1,1,1,1,2,1,3,1,1,2,1,1,2,2,2,1,1,1,2,1,2,1,1,1,1,1,1,1,2,1,2,1,1,1,1.25,0,1.4666666666666666,0,2.3333333333333335,0,1.5,0,1.3333333333333333,0,1.1428571428571428,0,1.3333333333333333,0,1.5945945945945945,0,0,0,0,-0.9694855788410672,-1.0698292017073834,-0.5328163702636706,-0.801322785985527,1,2,3,1,1,1,1,1,-0.7091149005366146,3,3,5,5,1,1,1,2.7142857142857144,0,-0.5180104438824858,0,-0.7115307802499731,3,4,3,5,3,3,5,2,3,4,5,3,2,3,4,5,3,4,4,4,3.6,0,3.6,0,4,0,3.2,0,3.6,0,2,1,1,3,2,1,2,3,1,2,2,2,2,1,1,3,1,1,1,2,1.7,0,"White, Caucasian, Anglo, European American",0,24,1,2,NA,5,2,0,0,0,0,0,TRUE,TRUE,TRUE,TRUE,TRUE,1,0.6261687499999534,0.568890625,0.6264968750000116,0.7336812499997905,0.6482906250000233,0.7323156249999302,1,1,1,1,1,1,0.195,0.378,0.797,0.007,1.239,92.57038129224186,1878.2864410824748,0.148,0.405,0.865,0.013,1.238,124.80547668874954,1909.853195533727,0.092,0.506,0.75,0.011,1.414,15.631813304330924,1796.706526610273,177,95.23076923076924,128.54545454545453,FALSE,432,1.28,0,1,0,0,3,FALSE
389,2022-03-18T21:40:46Z,0.8999999761581421,1.5989071038251366,915,6,4,5,4,3,3,3,3,4,3,3,4,4,5,1,4,5,4,4,1,1,4,4,4,4,1,2,0,0,0,0,3,3,4,3,5,3,2,2,5,1,5,4,3,4,3,2,5,5,5,5,2,3,1,1,1,3,1,1,2,1,1,2,2,3,1,1,3,1,4,2,1,2,0,3.6,0,3.3333333333333335,0,3.6666666666666665,0,1.6666666666666667,0,1.7142857142857142,0,1.6666666666666667,0,2.72972972972973,0,1,0,0,1.1469615434884515,1.284961770386063,-0.05499485428507328,0.6149834580504948,2,1,3,1,1,1,1,2,-0.32231065268119236,5,5,5,5,3,3,5,4.428571428571429,0,-0.10840883202778547,0,0.4667853699087434,4,4,4,2,4,2,2,2,3,2,2,2,4,3,3,3,2,2,2,1,3.6,0,2,0,2.6,0,2.4,0,2.3333333333333335,0,1,1,1,4,1,1,1,4,1,1,1,1,1,1,1,2,1,1,1,1,1.35,0,"Asian or Asian American (e.g., Chinese, Japanese, and others)",0,25,0,1,NA,5,2,0,0,1,0,0,TRUE,TRUE,TRUE,TRUE,TRUE,2,0.5089156249947846,0.4218218749947846,0.44425806451612904,0.530653333334128,0.4881000000025545,0.5170535714264427,1,1,1,0.9375,0.875,0.9032258064516129,0.062,0.323,0.595,0.019,1.949,107.67275882113282,1961.6776100663023,0.05,0.329,0.573,0.017,1.56,128.5503414576631,2031.4855759898423,0.053,0.37,0.42,0.034,1.924,79.9815636160111,1924.3102814448505,102.57894736842105,91.76470588235294,56.58823529411764,FALSE,440,1.3037037037037038,0,1,0,3,6,FALSE
390,2022-03-18T21:38:25Z,0.8999999761581421,1.7777777777777777,720,4,4,3,3,3,2,3,2,3,3,3,1,3,3,3,3,3,3,3,1,2,2,2,3,2,0,2,0,0,0,0,1,2,3,1,1,1,2,1,1,2,1,1,1,3,3,3,4,4,3,5,5,2,1,2,1,2,1,2,1,1,1,1,1,1,1,1,1,1,1,1,1,1,0,2.7333333333333334,0,1.4444444444444444,0,2.9166666666666665,0,1.5,0,1.1428571428571428,0,1,0,1.837837837837838,0,0,0,0,-0.08123575029862688,0.08057375409172465,-0.6189692744445258,-0.26919776017640057,1,1,2,1,1,1,1,2,-0.48817982669274074,5,5,5,5,3,2,5,4.285714285714286,0,0.7766911997228434,0,0.9284878440853178,1,1,1,3,1,5,5,5,5,3,5,5,3,5,5,5,5,5,5,4,1.4,0,5,0,4.2,0,4.8,0,4.666666666666667,0,1,2,1,2,3,1,2,2,2,2,3,2,1,2,1,2,2,2,1,1,1.75,0,"White, Caucasian, Anglo, European American",0,20,1,2,NA,5,2,0,0,1,0,0,TRUE,TRUE,TRUE,TRUE,TRUE,1,0.6526343749891966,0.5469548387104465,0.5921125000081956,0.7037249999940396,0.5941000000033527,0.7267906250040979,1,1,1,1,1,1,0.139,0.319,0.493,0.016,1.86,43.22170367091414,1826.053502550967,0.077,0.411,0.594,0.037,1.777,48.56009568843734,1835.3283029391228,0.143,0.301,0.404,0.057,1.863,37.749225410810574,1820.1312041122148,116.25,48.027027027027025,32.68421052631579,FALSE,374,1.108148148148148,0,1,0,0,3,FALSE
391,2022-03-18T21:44:59Z,1,1.7777777777777777,864,4,2,1,1,1,1,2,2,2,1,2,2,1,1,1,2,1,2,1,1,1,1,1,2,2,0,1,2,0,1,0,2,4,1,1,1,1,1,1,1,1,1,3,2,1,2,1,2,2,3,2,2,2,1,1,1,1,1,1,1,1,1,2,3,2,1,2,1,2,1,1,1,1.25,0,1.4,0,1.4444444444444444,0,1.8333333333333333,0,1.1666666666666667,0,1.5714285714285714,0,1.3333333333333333,0,1.5405405405405406,0,0,0,0,-0.8422794305559772,-1.013385805124027,-0.5328163702636706,-0.7731010876938488,1,1,2,1,1,1,1,1,-0.874984074548163,5,5,5,4,2,2,4,3.857142857142857,0,0.40966740893729353,1,0.47272947549438354,2,2,2,2,2,3,4,5,5,3,3,2,4,3,5,1,4,4,4,3,2,0,3.2,0,3.2,0,4.2,0,3.533333333333333,0,1,2,1,2,3,2,2,4,1,1,3,1,1,2,1,2,1,3,1,1,1.75,0,"White, Caucasian, Anglo, European American",0,18,1,3,NA,5,2,0,0,0,0,0,TRUE,TRUE,TRUE,TRUE,TRUE,5,0.42678749999590215,0.4212000000034609,0.42399032257641517,0.5494793103501714,0.44925312500633297,0.4657516128997649,1,1,1,0.9354838709677419,1,0.96875,0.056,0.336,0.691,0.04,2.1,167.12822470957568,2002.4635354583763,0.07,0.333,0.826,0.014,0.858,16.449895481304868,1799.5355492068772,0.07,0.32,0.663,0.016,1.98,127.20468558535646,1976.7259190949464,52.5,61.285714285714285,123.75,FALSE,388,1.1496296296296296,0,1,0,0,3,FALSE
392,2022-03-18T21:41:47Z,1,1.7777777777777777,864,4,2,2,3,2,3,1,1,2,2,2,2,2,2,2,2,1,2,2,3,1,2,2,3,2,3,2,0,0,0,0,1,1,1,1,1,1,1,1,1,2,1,1,1,1,2,1,3,2,1,1,1,4,2,2,1,5,2,1,3,2,1,2,3,3,2,3,1,2,2,2,2,2,0,1.9333333333333333,0,1,0,1.4166666666666667,0,2.6666666666666665,0,2.142857142857143,0,2,0,1.7027027027027026,0,2,0,0,-0.25011287819435013,-0.382281764580504,0.16436794915095845,-0.10895690771477277,3,2,3,2,1,2,2,1.5,-0.10103984158003264,3,4,4,3,1,2,3,2.857142857142857,0,0.4367408981447365,1,-0.0525990727688771,3,2,2,3,2,4,4,3,5,2,5,3,2,3,4,5,4,4,3,4,2.4,0,4,0,3.2,0,3.8,0,3.6666666666666665,0,1,1,2,2,3,4,2,2,2,2,3,2,1,4,2,2,2,3,2,2,2.2,0,"White, Caucasian, Anglo, European American",0,29,1,3,NA,5,2,0,0,0,0,0,TRUE,TRUE,TRUE,TRUE,TRUE,3,0.5832343749850989,0.5153906249701977,0.5386437500268221,0.639865625038743,0.5819258063993147,0.6417718750536442,1,1,1,1,1,1,0.146,0.37,0.895,0.008,1.199,107.12978279774124,1888.8521558940083,0.141,0.327,0.724,0.027,1.685,73.67701484579118,1856.152445875837,0.201,0.277,0.666,0.015,1.264,48.97864310910833,1831.994548533525,149.875,62.40740740740741,84.26666666666667,FALSE,382,1.1318518518518519,0,1,0,0,3,FALSE
393,2022-03-18T21:52:57Z,0.8999999761581421,1.7777777777777777,1080,5,3,4,3,4,4,4,4,4,2,4,2,1,5,1,4,5,3,4,1,1,2,4,3,3,0,2,0,0,0,0,4,3,4,4,4,3,5,4,4,3,2,4,1,4,3,3,3,4,4,5,3,3,2,1,1,2,1,1,1,1,1,4,3,3,1,1,3,1,2,1,1,1.25,0,3.4,0,3.888888888888889,0,3.25,0,1.6666666666666667,0,2,0,1.6666666666666667,0,2.7837837837837838,0,0,0,0,0.776309145899137,0.9483663931999491,-0.5328163702636706,0.20777501146813926,2,2,3,2,1,2,2,1.5,-0.1839744285858068,4,4,4,4,3,3,4,3.7142857142857144,0,0.2196552803757379,0,0.2795924049485119,4,2,4,3,4,2,3,4,4,2,4,4,5,3,3,2,3,4,2,3,3.4,0,3.4,0,2.8,0,3.4,0,3.2,0,2,1,1,4,2,2,3,4,3,2,3,4,4,1,1,4,1,3,2,4,2.55,0,"Hispanic of Latino (e.g., Mexican American, Central American, and others) & Filipino",1,27,0,1,NA,5,2,0,0,0,0,0,TRUE,TRUE,TRUE,TRUE,TRUE,2,0.423,0.405875,0.414125,0.527125,0.488125,0.4667,1,1,1,1,1,0.9375,0.058,0.303,0.523,0.028,1.933,160.02381565008673,2009.7230879568915,0.081,0.303,0.796,0.024,1.843,21.669532187428185,1804.974443493119,0.188,0.232,0.967,0.016,1.778,98.16173616943908,1888.7288537268464,69.03571428571429,76.79166666666666,111.125,FALSE,310,0.9185185185185185,0,1,0,3,6,FALSE
394,2022-03-18T21:30:39Z,1,1.7777777777777777,1080,6,2,2,1,3,2,2,1,1,1,2,1,1,2,1,3,2,2,1,1,2,1,3,1,3,7,1,1,0,1,0,1,3,3,2,2,4,2,1,2,3,3,4,1,2,2,1,1,3,4,3,1,2,1,1,1,3,1,1,3,3,3,1,1,1,3,3,2,4,4,4,4,4,0,1.6666666666666667,0,2.2222222222222223,0,2.3333333333333335,0,1.5,0,1.8571428571428572,0,2.6666666666666665,0,2.108108108108108,0,4,0,0,-0.23037399311562928,-0.48543354683824114,1.2923167894698635,0.4034416213158112,4,4,4,5,3,5,5,8,3.6572065745668247,2,3,3,2,1,1,2,2,0,-0.06643593160469037,0,-0.8234948556042399,2,2,2,2,2,4,4,4,4,4,5,5,4,4,4,4,5,5,4,3,2,0,4.8,0,4,0,3.8,0,4.2,0,2,2,3,1,2,3,2,3,1,2,3,3,1,3,2,3,1,3,2,2,2.2,0,"White, Caucasian, Anglo, European American",0,27,0,1,NA,5,2,0,0,1,0,0,TRUE,TRUE,TRUE,TRUE,TRUE,5,0.5452499999962747,0.5011624999996275,0.545409375006333,0.6556612903206579,0.5481874999925495,0.6525387096789576,1,1,1,1,1,1,0.131,0.343,0.631,0.018,1.837,49.10557878876497,1836.4292186393404,0.062,0.387,0.537,0.041,1.572,53.08380543603817,1836.319839647337,0.099,0.394,0.611,0.008,1.175,68.33579094222073,1856.398281648408,102.05555555555556,38.34146341463415,146.875,FALSE,430,1.2740740740740741,0,1,0,6,9,FALSE
395,2022-03-18T21:58:10Z,0.8999999761581421,1.5,912,6,3,2,2,2,2,2,2,2,2,2,2,2,2,2,2,2,2,2,2,2,1,1,2,1,2,2,0,0,0,0,1,1,2,2,2,1,2,2,2,1,5,1,1,2,3,2,2,2,3,3,3,2,4,1,1,2,1,1,3,1,1,2,2,1,1,3,1,2,2,2,2,2,0,2,0,1.6666666666666667,0,2.3333333333333335,0,1.8333333333333333,0,1.5714285714285714,0,1.6666666666666667,0,1.8918918918918919,0,1,0,0,-0.45188814788794135,-0.48887521736161643,-0.05499485428507328,-0.2719350358233449,1,2,3,1,1,2,2,1.5,-0.3498436025973552,4,5,4,4,3,4,4,4,0,-0.23191923190205752,0,0.15934845458074715,2,2,2,2,2,4,5,4,4,3,4,3,2,4,4,5,4,4,3,4,2,0,3.8,0,3.6,0,4,0,3.8,0,2,1,2,3,2,2,4,2,2,2,3,2,2,2,1,2,1,3,1,4,2.15,0,"Hispanic of Latino (e.g., Mexican American, Central American, and others)",0,29,1,2,NA,5,2,0,0,1,0,0,TRUE,TRUE,TRUE,TRUE,TRUE,2,0.6721937500238419,0.5240937501192093,0.5896968749761582,0.7109468749761582,0.5717375000715256,0.6425437500476837,1,1,1,1,1,1,0.295,0.18,0.713,0.036,1.812,49.726508073642975,1832.4966590931597,0.128,0.319,0.629,0.017,1.318,70.14774296833428,1855.821036094941,0.245,0.258,0.603,0.03,1.429,48.65120610527465,1830.8134250327375,50.333333333333336,77.52941176470588,47.63333333333334,TRUE,396,1.1733333333333333,0,1,0,0,3,FALSE
396,2022-03-18T21:46:15Z,0.8999999761581421,1.7777777777777777,1080,6,2,4,3,5,5,5,3,5,5,4,5,5,5,1,5,5,4,4,1,1,3,5,5,5,3,2,0,0,0,0,1,3,5,5,4,3,2,1,4,5,4,5,4,4,3,1,5,5,5,5,5,4,1,1,1,1,4,1,2,3,1,4,4,5,3,2,3,4,5,2,2,3.25,0,4.333333333333333,0,3.111111111111111,0,4.25,0,2,0,2.857142857142857,0,2.6666666666666665,0,3.2162162162162162,0,2,0,0,1.6250812042841352,1.9266858228302868,0.5951324700552345,1.2609091464427606,3,3,4,3,1,2,1,1,-0.1285727914961955,4,4,5,4,2,3,4,3.7142857142857144,0,0.8670061021784026,0,0.6738870032924332,5,5,5,5,5,1,5,1,1,5,1,4,3,5,5,5,4,4,4,1,5,0,2.8,0,4.4,0,2.6,0,3.2666666666666666,0,4,4,4,4,4,4,3,4,3,3,4,4,3,4,1,4,3,4,4,4,3.6,0,"Hispanic of Latino (e.g., Mexican American, Central American, and others)",0,26,1,2,NA,5,2,1,0,1,0,1,TRUE,TRUE,TRUE,TRUE,TRUE,3,0.6077548387435174,0.5444406249970197,0.5771838709615892,0.6332806451705194,0.583313793108381,0.6264806451566758,0.96875,1,0.96875,0.96875,0.9354838709677419,0.96875,0.061,0.402,0.381,0.011,1.374,125.7934966320878,1994.8887089736013,0.063,0.384,0.446,0.018,1.666,67.78977417175405,1913.8902025878872,0.06,0.431,0.349,0.034,1.792,129.26949377522794,1994.912285791083,124.90909090909092,92.55555555555556,52.705882352941174,FALSE,324,0.96,0,1,0,0,3,FALSE
397,2022-03-18T22:00:05Z,0.8999999761581421,1.7777777777777777,1080,4,1,5,1,2,3,1,4,4,4,1,4,1,5,1,5,5,3,5,5,2,2,5,5,4,1,2,0,0,0,0,1,5,5,4,5,2,4,2,5,2,1,5,4,3,2,1,5,5,5,5,5,5,5,5,2,2,1,1,1,1,1,1,1,1,1,1,5,1,5,1,1,2,0,3.066666666666667,0,3.6666666666666665,0,3.5833333333333335,0,3.3333333333333335,0,1,0,2.3333333333333335,0,2.972972972972973,0,1,0,0,1.7106163729585926,1.4311836009077548,-0.05499485428507328,0.6880943733113407,1,1,2,1,1,1,3,5,0.8381020908850744,5,5,5,5,1,1,5,3.857142857142857,0,0.10541647030204569,0,0.28741341872182335,3,1,3,4,3,3,4,3,3,1,1,4,2,5,2,2,3,4,1,1,2.8,0,3,0,2,0,2.8,0,2.6,0,2,2,2,1,4,1,2,4,2,2,3,2,1,2,4,2,1,2,1,2,2.1,0,"White, Caucasian, Anglo, European American",0,22,0,1,NA,5,2,0,0,1,0,0,TRUE,TRUE,TRUE,TRUE,TRUE,2,0.47891874999552964,0.4801593749988824,0.479003125006333,0.5729233333230018,0.5556033333301544,0.5935000000041106,1,1,1,0.967741935483871,0.9375,0.90625,0.06,0.354,0.46,0.011,1.484,69.2627331714444,1925.0024884407308,0.062,0.342,0.446,0.021,1.753,39.61139381605195,1880.9482230749545,0.08,0.353,0.673,0.018,1.805,89.82533622691368,1915.6047633425096,134.9090909090909,83.47619047619047,100.27777777777779,FALSE,304,0.9007407407407407,1,1,0,0,3,FALSE
398,2022-03-18T22:09:00Z,1,1.7777777777777777,1080,6,2,2,2,2,2,3,2,2,2,2,2,2,2,2,3,4,2,2,1,1,2,2,1,3,1,1,1,0,0,0,2,2,2,2,3,2,2,2,3,1,2,2,1,3,2,3,2,2,2,1,2,2,1,1,1,2,1,1,2,2,1,2,2,2,1,1,1,2,2,1,2,1.75,0,2.2666666666666666,0,2.2222222222222223,0,1.9166666666666667,0,1.3333333333333333,0,1.7142857142857142,0,1,0,1.7837837837837838,0,1,0,0,-0.44092210062198545,-0.365073411963627,-0.14114775846592847,-0.25311058521477775,2,2,4,1,1,1,2,2.5,0.11989523226384131,4,4,4,4,2,2,4,3.4285714285714284,0,-0.8792700537047221,0,-0.5445568447258828,2,3,3,3,2,4,4,4,4,3,3,4,3,4,4,4,4,4,3,2,2.6,0,3.8,0,3.4,0,3.6,0,3.6,0,1,1,1,1,2,1,1,2,1,1,2,1,1,2,2,2,1,1,2,1,1.35,0,"Hispanic of Latino (e.g., Mexican American, Central American, and others)",0,25,0,1,NA,5,2,0,0,1,0,0,TRUE,TRUE,TRUE,TRUE,TRUE,3,0.54809375,0.4954375,0.53434375,0.5833,0.5582,0.6335666666666666,1,1,1,0.9375,0.9375,0.9375,0.062,0.41,0.476,0.007,1.154,87.90296669233435,1932.069939518061,0.065,0.361,0.542,0.017,1.781,139.1967116196127,1986.1671872577651,0.058,0.414,0.48,0.026,1.96,97.57630481431136,1945.9719199933631,164.85714285714283,104.76470588235293,75.38461538461539,FALSE,436,1.2918518518518518,0,1,0,0,3,FALSE
399,2022-03-18T21:13:42Z,0.8999999761581421,1.7777777777777777,1080,5,1,3,3,4,4,3,3,5,3,4,3,3,4,2,3,4,2,3,4,1,3,4,3,3,2,2,0,0,0,0,3,2,3,2,4,2,2,2,3,1,2,3,2,3,3,2,4,3,3,3,4,4,3,3,2,3,2,1,3,1,1,2,2,3,1,2,2,3,2,2,2,2.25,0,3.4,0,2.5555555555555554,0,2.75,0,2.8333333333333335,0,1.8571428571428572,0,1.6666666666666667,0,2.4594594594594597,0,1,0,0,0.7280585379289302,0.9159163568366958,0.031158049895781924,0.4735372033662389,3,3,4,3,3,3,2,3.5,1.170176176165457,4,4,5,2,1,1,3,2.857142857142857,0,-0.6083253463380449,0,-0.6891379651791198,2,2,2,3,2,4,3,3,4,3,5,3,4,4,4,4,4,4,3,3,2.2,0,4,0,3.4,0,3.6,0,3.6666666666666665,0,3,2,2,2,4,3,4,2,2,2,2,2,2,3,2,3,1,4,2,4,2.55,0,"White, Caucasian, Anglo, European American & Native American/Alaskan Native/indigenous",1,30,0,3,NA,5,2,0,0,0,0,0,TRUE,TRUE,TRUE,TRUE,TRUE,3,0.5257093750052154,0.5173593749962747,0.5340812499895692,0.6229633333325386,0.5841199999968211,0.6266033333142599,1,1,1,0.967741935483871,0.9375,0.9375,0.061,0.422,0.568,0.01,1.434,105.82124914233783,1973.2411690872943,0.062,0.403,0.543,0.022,1.818,33.55593712323031,1877.0617476266584,0.083,0.357,0.529,0.013,1.703,82.00526039034388,1906.4281633993191,143.39999999999998,82.63636363636364,131,FALSE,322,0.9540740740740741,0,1,0,0,3,FALSE
400,2022-03-18T22:11:09Z,1,1.7786458333333333,768,3,3,2,3,2,3,2,1,3,2,2,1,2,2,2,3,3,1,1,1,1,1,1,1,1,2,2,0,0,0,0,1,3,2,2,2,2,2,2,2,1,2,2,1,1,2,2,3,1,1,2,2,2,1,4,1,3,1,1,3,3,2,3,4,2,1,1,1,1,1,2,2,1.5,0,2.2,0,2,0,1.6666666666666667,0,2,0,2.5714285714285716,0,1,0,1.9189189189189189,0,1,0,0,-0.8400862211027859,-0.6626304120703113,-0.22730066264678367,-0.4449655373585475,2,2,3,2,1,1,2,1,-0.4603111395192921,4,4,4,4,4,4,4,4,0,-0.3760932239552953,1,0.07153358762812576,2,2,3,3,2,3,3,4,5,2,5,3,5,3,4,4,4,4,3,3,2.4,0,3.8,0,3.4,0,3.8,0,3.6666666666666665,0,1,1,1,3,1,1,3,2,1,1,2,2,2,2,2,2,1,1,1,1,1.55,0,"White, Caucasian, Anglo, European American",0,22,0,1,NA,5,2,0,0,1,0,0,TRUE,TRUE,TRUE,TRUE,TRUE,5,0.4917250000000058,0.45495625000003204,0.5156406250000145,0.5496896551724941,0.5511466666667412,0.5803931034482566,1,1,1,0.90625,0.9375,0.90625,0.057,0.373,0.433,0.021,1.949,44.765921244600776,1898.9253054352143,0.06,0.335,0.499,0.009,1.25,84.27627647598113,1930.9781055387327,0.065,0.336,0.481,0.021,2.117,69.08677443858217,1926.0155794366567,92.80952380952381,138.88888888888889,100.8095238095238,FALSE,400,1.1851851851851851,0,1,0,0,3,FALSE
401,2022-03-18T22:02:59Z,1,1.7786458333333333,768,3,3,2,2,1,1,2,2,1,2,1,1,1,2,1,3,3,2,3,1,2,1,1,2,2,1,1,3,0,0,0,1,2,4,2,3,3,3,3,3,2,2,1,1,3,3,1,2,1,1,3,3,3,3,1,1,1,1,1,2,1,1,2,2,2,1,1,1,1,1,1,1,1,0,1.6666666666666667,0,2.6666666666666665,0,1.9166666666666667,0,1.6666666666666667,0,1.5714285714285714,0,1,0,1.9189189189189189,0,1,0,0,-0.353193722494337,-0.5680336393992503,-0.39960647100849406,-0.48382005520387217,2,2,3,1,1,2,2,3.5,0.5066994801192636,4,5,5,5,2,2,5,4,0,0.6535386270965279,1,0.6986715528230527,1,2,2,1,1,4,3,5,5,3,5,1,4,3,4,4,4,4,3,2,1.4,0,3.6,0,3.4,0,3.8,0,3.6,0,1,1,2,1,1,3,3,4,1,1,2,2,3,1,1,3,1,2,1,2,1.8,0,Black or African American,0,19,1,2,NA,5,2,0,0,1,0,0,TRUE,TRUE,TRUE,TRUE,TRUE,5,0.5021468749998603,0.45552499999955764,0.4800096774197394,0.5890133333329112,0.5118612903229172,0.5563000000008614,1,1,1,0.9375,1,1,0.085,0.364,0.739,0.022,1.695,25.44971755782012,1806.9811796792717,0.164,0.254,0.792,0.018,1.232,115.9826018016411,1903.5607833480396,0.072,0.351,0.513,0.017,1.976,55.070208219952974,1898.0477848947692,77.04545454545455,68.44444444444444,116.23529411764704,FALSE,460,1.3629629629629632,0,1,0,0,3,FALSE
402,2022-03-18T22:01:56Z,1,1.7777777777777777,1080,5,2,3,1,2,1,2,2,2,2,1,1,1,2,1,2,2,2,4,5,1,1,2,2,1,6,2,0,0,0,0,1,5,3,5,2,2,2,3,1,1,1,1,1,2,1,2,1,1,1,4,1,3,4,1,1,1,1,1,4,4,2,2,2,2,1,1,1,2,2,2,2,2,0,1.6666666666666667,0,2.6666666666666665,0,1.4166666666666667,0,1.8333333333333333,0,2.4285714285714284,0,1,0,1.945945945945946,0,3,0,0,-0.01105304779650827,-0.3379333815507239,0.3837307525869902,0.02289868551813315,2,1,4,2,1,3,1,1,-0.3773765525135179,5,5,5,5,1,1,4,3.7142857142857144,0,-0.8792700537047221,0,-0.3897514942445284,5,5,5,5,5,2,3,2,2,3,5,3,2,2,4,1,4,5,3,4,5,0,3.8,0,2.4,0,2.8,0,3,0,1,3,2,2,3,2,4,2,1,2,4,3,1,1,1,3,1,2,1,3,2.1,0,"White, Caucasian, Anglo, European American",0,24,1,2,NA,5,2,0,0,1,0,0,TRUE,TRUE,TRUE,TRUE,TRUE,1,0.5010645161213413,0.517765625,0.5387124999966473,0.6248758620722541,0.6394964285684483,0.7063387096774194,1,1,1,0.90625,0.875,0.96875,0.114,0.305,0.537,0.008,1.784,74.808921560096593,1903.6941170684352,0.06,0.393,0.471,0.014,1.912,143.275251695861,2014.9295802725733,0.08,0.318,0.513,0.009,1.611,53.894030611942114,1909.565220859186,223,136.57142857142856,179,FALSE,278,0.8237037037037037,0,1,0,3,6,FALSE
403,2022-03-18T22:13:55Z,0.8999999761581421,1.7777777777777777,720,3,3,4,4,3,3,3,2,5,4,4,3,3,4,1,3,5,3,4,3,1,4,4,2,4,0,2,0,0,0,0,3,4,4,3,4,5,4,2,5,3,2,3,2,4,3,1,4,4,5,3,4,4,3,1,1,4,5,1,1,1,1,2,1,3,1,3,2,3,4,1,1,2.25,0,3.4,0,3.7777777777777777,0,3.1666666666666665,0,3,0,1.4285714285714286,0,2,0,2.864864864864865,0,0,0,0,1.153541171848025,1.2020666774944784,-0.1882047535402498,0.5069309619771143,2,2,4,1,1,2,1,2,-0.07350689166386981,3,3,4,4,1,1,3,2.7142857142857144,0,-0.788955151249163,0,-0.8765603607594444,3,4,3,3,3,4,5,4,3,2,2,2,4,4,3,1,1,3,3,5,3.2,0,2.4,0,3,0,3.8,0,3.066666666666667,0,2,4,4,4,4,4,4,4,4,3,4,4,2,4,1,4,1,4,4,4,3.45,0,"White, Caucasian, Anglo, European American & Native American/Alaskan Native/indigenous",1,20,1,2,NA,5,2,0,0,0,0,0,TRUE,TRUE,TRUE,TRUE,TRUE,1,0.4873875000048429,0.4047218750007451,0.46387812500074505,0.5596766666611036,0.4862366666595141,0.5291566666642825,1,1,1,0.9375,0.9375,0.9375,0.062,0.307,0.418,0.012,1.395,30.45881827722831,1875.3336195330735,0.053,0.325,0.684,0.019,1.685,27.658532293929856,1876.116420895167,0.062,0.363,0.495,0.02,1.66,111.41150981983918,1987.3361119625383,116.25,88.6842105263158,83,FALSE,362,1.0725925925925925,0,1,0,0,3,FALSE
404,2022-03-18T22:12:59Z,0.8999999761581421,1.7777777777777777,720,4,2,1,1,1,1,1,1,1,1,1,1,1,1,1,1,1,2,1,1,1,1,1,1,1,5,2,0,0,0,0,1,1,2,1,1,1,1,1,1,1,1,1,1,1,1,1,1,1,1,1,1,1,1,2,1,1,1,1,3,3,3,1,1,1,1,1,1,2,1,3,3,2.25,0,1,0,1.1111111111111112,0,1,0,1.1666666666666667,0,1.8571428571428572,0,1,0,1.2162162162162162,0,3,0,0,-1.215125037598483,-1.438776281813226,0.4698836567678454,-0.48444631252269027,1,1,3,1,1,1,1,1,-0.7920494875423887,5,5,5,5,3,3,4,4.285714285714286,0,0.40966740893729353,1,0.7049375012164149,1,1,1,3,1,5,4,2,5,2,5,5,3,4,5,5,5,5,4,5,1.4,0,5,0,3.6,0,4.2,0,4.266666666666667,0,1,2,1,1,1,1,2,2,2,1,1,1,1,1,1,1,1,1,1,2,1.25,0,"White, Caucasian, Anglo, European American",0,27,1,2,NA,5,2,0,0,0,0,0,TRUE,TRUE,TRUE,TRUE,TRUE,2,0.5675531249865889,0.5143937500119209,0.5916290322273008,0.6303096773855148,0.5657312500029802,0.6471281249895692,1,1,1,0.96875,1,1,0.086,0.364,0.397,0.032,1.819,53.79370678140194,1835.6736452921984,0.122,0.304,0.631,0.022,1.639,52.83340103265547,1835.656085665804,0.069,0.403,0.429,0.025,1.825,78.41567827121605,1905.8927705748267,56.84375,74.5,73,FALSE,382,1.1318518518518519,0,1,0,0,3,FALSE
406,2022-03-18T22:10:26Z,0.8999999761581421,1.6,900,6,2,2,1,1,1,1,1,1,2,2,1,3,1,2,2,2,2,3,1,1,1,2,1,1,0,2,0,0,0,0,1,2,1,2,3,2,3,1,3,1,1,1,1,1,1,1,1,1,2,2,2,2,1,1,1,1,1,1,1,1,1,1,1,1,1,1,1,1,1,1,1,1,0,1.5333333333333334,0,2,0,1.25,0,1.1666666666666667,0,1,0,1,0,1.3513513513513513,0,0,0,0,-0.88395041016661,-0.9831974379618483,-0.6189692744445258,-0.801083356203187,2,2,3,2,2,2,3,2,0.17529686935345262,5,5,5,5,3,3,5,4.428571428571429,0,0.25285077779445086,0,0.6868248105880386,4,3,3,4,3,4,4,5,4,3,2,3,2,4,4,5,5,4,4,4,3.4,0,3.6,0,3.6,0,4.2,0,3.8,0,1,3,2,3,2,2,3,2,1,1,4,3,2,2,1,2,1,2,2,3,2.1,0,"White, Caucasian, Anglo, European American",0,29,1,2,NA,5,2,0,0,1,0,0,TRUE,TRUE,TRUE,TRUE,TRUE,1,0.57609062500298025,0.5275218749567866,0.5849187499955296,0.6215387096558848,0.5551965517093396,0.6256387096681902,1,1,1,0.96875,0.9354838709677419,0.96875,0.095,0.395,0.528,0.016,1.505,152.37678850687385,1987.3043863653857,0.054,0.409,0.542,0.029,1.797,77.52816420814132,1947.2766597788416,0.058,0.457,0.57,0.018,1.533,56.41527348355437,1877.475638933784,94.06249999999999,61.9655172413793,85.16666666666667,FALSE,325,0.9629629629629629,0,1,0,0,3,FALSE
407,2022-03-18T22:16:52Z,NA,1.7786458333333333,768,4,2,2,3,1,2,1,1,5,3,3,2,2,3,3,3,3,3,5,5,1,1,3,2,3,5,2,0,0,0,0,2,5,5,3,5,2,5,5,5,3,2,5,1,5,1,3,4,4,4,3,3,5,4,3,3,3,4,1,3,1,1,2,2,3,3,3,3,3,3,2,1,2.25,0,2.466666666666667,0,4.111111111111111,0,3.1666666666666665,0,3.6666666666666665,0,1.8571428571428572,0,3,0,3.2162162162162162,0,3,0,0,1.219337455443761,0.8388229371130868,0.4698836567678454,0.6543532969404661,3,2,5,3,1,2,2,3.5,0.9213724151481345,3,4,4,3,1,1,3,2.7142857142857144,0,-0.8792700537047221,0,-0.9315702209292682,3,3,4,4,3,3,4,3,4,4,4,3,3,3,3,4,3,5,3,3,3.4,0,3.6,0,3.6,0,3.2,0,3.466666666666667,0,1,2,1,2,2,1,2,2,1,1,4,2,2,1,1,3,1,1,1,2,1.65,0,Black or African American,0,21,1,2,NA,5,2,0,0,0,0,0,TRUE,TRUE,TRUE,TRUE,TRUE,1,0.6812275861953867,0.5351624999940395,0.5849906249977648,0.8754115384725424,0.5881838709731255,0.6125428571317877,0.9354838709677419,1,1,0.8387096774193549,0.96875,0.875,0.056,0.417,0.383,0.022,1.935,79.6079628396012,1941.757698263611,0.079,0.312,0.377,0.013,1.617,166.7621854309687,1995.7276290868404,0.069,0.422,0.196,0.013,1.791,168.97083967257873,2133.52364231678,87.95454545454547,124.38461538461539,137.76923076923077,FALSE,446,1.3214814814814815,0,1,0,0,3,FALSE
408,2022-03-18T22:12:07Z,1,1.7777777777777777,864,5,3,4,2,2,2,2,3,4,4,2,3,4,3,3,4,3,2,3,1,1,3,3,3,4,0,2,0,0,0,0,1,1,4,2,5,1,4,4,3,2,1,4,4,1,4,2,4,4,4,4,4,4,1,1,1,1,1,1,1,1,1,3,3,3,1,1,3,1,1,1,1,1,0,3,0,2.7777777777777777,0,3.1666666666666665,0,1.5,0,1.8571428571428572,0,1.6666666666666667,0,2.4324324324324325,0,0,0,0,0.46706661299917596,0.56575096444413,-0.6189692744445258,-0.026609155000197893,1,1,2,1,1,1,1,2.5,-0.2947777027650296,5,5,5,5,2,2,4,4,0,0.03902547546461973,0,0.3243780350902185,1,1,3,2,2,4,3,4,4,2,4,2,4,3,2,3,3,3,2,4,1.8,0,3.2,0,2.8,0,3.4,0,3.1333333333333333,0,1,1,2,4,1,2,1,4,1,1,1,2,1,1,1,2,1,1,1,1,1.5,0,Black or African American,0,28,0,1,NA,5,2,0,0,1,0,0,TRUE,TRUE,TRUE,TRUE,TRUE,6,0.5109483871075414,0.46388064515975214,0.4708812499903142,0.604440625000745,0.5461593749970197,0.5472516128978422,1,1,1,1,1,0.96875,0.065,0.376,0.762,0.019,1.751,39.52296331022844,1861.2044283002913,0.127,0.314,0.838,0.02,1.783,38.887396011843485,1821.9445153411336,0.092,0.378,0.708,0.02,1.898,76.90134874908372,1856.3087071942705,92.1578947368421,89.14999999999999,94.89999999999999,FALSE,396,1.1733333333333333,0,1,0,0,3,FALSE
409,2022-03-18T22:24:30Z,0.8999999761581421,1.7777777777777777,1152,6,3,4,2,5,3,3,3,3,2,2,2,3,2,3,3,5,3,3,1,1,2,2,2,3,2,2,0,0,0,0,2,4,3,4,2,1,4,2,3,2,4,1,1,2,3,1,4,3,2,3,3,2,1,1,1,2,2,1,2,1,1,4,4,4,1,3,3,3,2,1,1,1.75,0,3,0,2.7777777777777777,0,2.4166666666666665,0,1.5,0,2.4285714285714284,0,2.3333333333333335,0,2.3513513513513513,0,1,0,0,0.17098333681836214,0.36662574130598247,-0.14114775846592847,0.112738991420027,1,2,3,2,1,2,2,4,0.7001016040469747,2,3,5,3,1,1,4,2.7142857142857144,0,0.21378036556256672,0,-0.2658046707527837,3,4,3,4,3,3,3,3,4,4,2,3,3,3,2,1,3,3,2,4,3.4,0,2.8,0,2.6,0,3.2,0,2.8666666666666667,0,2,2,3,2,3,3,4,4,3,1,3,4,2,3,3,4,2,3,3,3,2.85,0,"White, Caucasian, Anglo, European American & Native American/Alaskan Native/indigenous",1,27,1,2,NA,5,2,0,0,0,0,0,TRUE,TRUE,TRUE,TRUE,TRUE,6,0.5693562499987893,0.5535709677420316,0.5927531250012107,0.6036968749989755,0.6700718749999068,0.7369531250006984,1,1,1,1,1,1,0.13,0.359,0.609,0.014,1.886,192.22239388267064,1984.3363451959476,0.075,0.414,0.531,0.011,1.251,103.50747042837872,1886.8204602938356,0.107,0.391,0.6,0.037,1.515,23.61992262815234,1806.6726455856335,134.7142857142857,113.72727272727272,40.945945945945944,FALSE,242,0.7170370370370371,0,1,0,0,3,FALSE
410,2022-03-18T22:37:06Z,0.800000011920929,3.555285540704739,823,4,3,2,1,2,1,3,2,2,2,3,1,2,2,2,2,1,1,1,2,2,2,1,1,2,2,2,0,0,0,0,2,1,1,2,2,2,2,2,1,2,1,2,2,1,1,2,1,2,1,4,3,2,1,1,1,2,1,2,3,3,2,2,2,2,2,2,2,2,2,3,2,2.25,0,1.8666666666666667,0,1.6666666666666667,0,1.8333333333333333,0,1.3333333333333333,0,2.2857142857142856,0,2,0,1.8108108108108107,0,1,0,0,-0.5856739245326056,-0.6370637167538084,0.031158049895781924,-0.3029528334290132,2,1,3,1,1,2,2,3,0.23036276918577817,3,4,4,3,1,1,3,2.7142857142857144,0,-0.4848149464637728,0,-0.6913117508138321,4,5,4,5,5,2,1,2,2,1,2,2,2,1,1,1,3,1,2,1,4.6,0,2,0,1.4,0,1.4,0,1.6,0,3,3,2,4,3,3,3,3,3,4,3,4,3,3,3,4,3,3,4,3,3.2,0,"Asian or Asian American (e.g., Chinese, Japanese, and others)",0,19,0,1,NA,5,2,0,0,1,0,0,TRUE,TRUE,TRUE,TRUE,TRUE,1,0.452028124999968,0.4355281250000699,0.424109375,0.5169483870967863,0.48630322580641855,0.4902548387096594,1,1,1,0.96875,1,0.96875,0.061,0.32,0.581,0.018,1.399,74.88550865467705,1900.2370965009611,0.065,0.307,0.555,0.033,1.652,99.74902295696144,1885.3446412143835,0.066,0.346,0.659,0.027,2.086,50.49750939684488,1874.387357382171,77.72222222222223,50.060606060606055,77.25925925925925,FALSE,406,1.202962962962963,0,1,0,0,3,FALSE
411,2022-03-18T22:28:50Z,0.8999999761581421,1.7777777777777777,1440,6,2,1,1,1,1,1,1,2,1,2,1,1,1,2,1,2,2,2,5,2,1,1,1,1,1,2,0,0,0,0,1,2,4,2,2,1,3,2,1,1,2,1,1,4,1,2,3,3,1,3,2,1,1,1,1,1,1,1,1,1,1,1,1,1,1,1,1,1,1,1,1,1,0,1.2666666666666666,0,2,0,2,0,1,0,1,0,1,0,1.5675675675675675,0,1,0,0,-0.5001387558581482,-0.8414989458423069,-0.39960647100849406,-0.6205527084254004,1,1,3,1,1,1,1,1.5,-0.5986473636146776,4,5,5,5,3,3,5,4.285714285714286,0,-0.3222341343576166,0,0.25914394489227754,2,1,2,2,2,4,4,4,5,3,5,5,5,5,5,4,5,5,3,4,1.8,0,4.8,0,3.8,0,4.6,0,4.4,0,1,1,1,3,1,1,1,2,1,1,1,1,1,1,1,1,1,1,1,1,1.15,0,"White, Caucasian, Anglo, European American",0,29,0,1,NA,5,2,0,0,1,0,0,TRUE,TRUE,TRUE,TRUE,TRUE,5,0.49162999999920526,0.5340343749988824,0.5243687500013039,0.5644343749955296,0.6484766666650772,0.5793281250037253,0.967741935483871,1,1,1,0.9375,1,0.087,0.375,0.597,0.034,1.797,60.88481906039556,1846.4587415482508,0.063,0.384,0.384,0.017,1.69,73.51043070857898,1939.8613995924984,0.12,0.316,0.684,0.021,1.721,163.3061443202603,1988.0506538338077,52.85294117647058,99.41176470588235,81.95238095238095,FALSE,304,0.9007407407407407,1,1,0,0,3,FALSE
412,2022-03-18T22:27:21Z,0.8999999761581421,1.7777777777777777,1080,3,1,4,4,5,5,5,4,4,4,5,3,3,4,3,4,5,4,5,4,2,3,4,3,3,10,2,0,0,0,0,3,5,5,5,5,3,5,5,5,4,4,3,3,4,3,3,5,4,4,3,4,5,4,3,3,5,5,3,5,4,2,5,5,5,2,4,3,2,3,3,3,2.75,0,4.133333333333334,0,4.555555555555555,0,3.6666666666666665,0,4.166666666666667,0,4.142857142857143,0,3,0,4,0,5,0,0,2.133905797424496,2.1815661084471163,1.0809150720016192,1.6312405902243676,4,4,5,3,2,4,3,2.5,1.1151102763331315,2,3,4,1,1,1,1,1.8571428571428572,0,-1.2224806707219966,0,-1.6050322607716403,1,1,1,1,1,5,4,5,5,4,5,5,5,4,5,5,5,5,4,5,1,0,5,0,4.4,0,4.8,0,4.733333333333333,0,2,3,4,4,4,4,4,3,3,3,3,3,4,4,2,2,2,3,2,4,3.15,0,"White, Caucasian, Anglo, European American",0,28,1,2,NA,5,2,0,0,1,0,0,TRUE,TRUE,TRUE,TRUE,TRUE,6,0.5951593749932945,0.5006656250096857,0.5837093749903143,0.6303266666571299,0.5579758620755426,0.6523500000039737,1,1,1,0.9375,0.9354838709677419,0.967741935483871,0.075,0.388,0.438,0.012,1.527,57.891480854900685,1884.9143574412367,0.059,0.379,0.548,0.023,1.959,55.03959895520847,1901.0020970882215,0.069,0.393,0.371,0.013,1.434,108.24233686278664,1949.4843513370256,127.24999999999999,85.17391304347827,110.3076923076923,FALSE,426,1.2622222222222224,0,1,0,0,3,FALSE
413,2022-03-18T22:28:52Z,0.8999999761581421,1.7777777777777777,864,4,2,2,2,2,2,2,2,2,3,1,1,4,2,4,2,2,2,1,1,1,1,1,2,2,0,1,2,0,2,0,1,1,1,1,1,1,4,3,1,1,1,1,1,1,1,2,1,1,4,3,2,1,1,1,1,2,1,2,1,2,1,1,3,2,1,1,2,2,2,2,2,2,0,2.2,0,1.5555555555555556,0,1.5833333333333333,0,1.1666666666666667,0,1.7142857142857142,0,1.3333333333333333,0,1.5135135135135136,0,0,0,0,-0.8598251061815066,-0.6759054269461877,-0.274357657721105,-0.47513154233364635,1,1,2,1,1,2,2,3,0.06449359517422987,4,4,4,4,2,2,5,3.5714285714285716,0,-0.46089103884563964,0,-0.21232389807222737,5,5,5,5,5,1,1,1,5,3,5,3,2,2,3,4,5,5,5,1,5,0,3.8,0,3,0,2.4,0,3.066666666666667,0,3,1,1,2,2,2,3,2,1,1,4,3,1,2,2,3,1,2,1,2,1.95,0,"Asian or Asian American (e.g., Chinese, Japanese, and others)",0,27,0,1,NA,5,2,0,0,0,0,0,TRUE,TRUE,TRUE,TRUE,TRUE,4,0.4227124999994412,0.3841812500000233,0.43276129032250854,0.5048137931033712,0.46680333333338303,0.5090580645161531,1,1,1,0.90625,0.967741935483871,0.96875,0.068,0.321,0.663,0.017,1.65,86.60596688262426,1912.780789991818,0.065,0.299,0.801,0.014,1.488,22.729375274251662,1849.6384345002623,0.052,0.343,0.695,0.023,1.96,54.9902955684145,1909.54413726044,97.05882352941175,106.28571428571428,85.21739130434783,FALSE,506,1.4992592592592593,0,1,0,0,3,FALSE
414,2022-03-18T22:36:38Z,1,1.7777777777777777,864,6,3,2,2,2,3,2,2,2,2,2,2,1,2,1,2,3,4,2,1,1,2,1,2,2,0,2,0,0,0,0,1,1,4,2,3,2,3,3,2,1,2,1,1,4,1,3,2,1,1,1,1,2,1,1,1,3,1,1,1,3,1,2,2,2,1,3,1,1,1,1,1,1,0,2,0,2.3333333333333335,0,1.5833333333333333,0,1.5,0,1.7142857142857142,0,1.6666666666666667,0,1.7837837837837838,0,0,0,0,-0.3597733508539106,-0.42692514794085923,-0.6189692744445258,-0.5229472111926925,3,3,5,2,1,2,2,1,-0.04563820449042111,2,3,4,2,1,1,3,2.2857142857142856,0,0.20450877576198692,0,-0.5036599246134142,2,2,2,2,2,4,3,4,4,4,3,3,5,3,3,4,3,4,2,3,2,0,3.4,0,3.6,0,3.4,0,3.466666666666667,0,3,2,2,2,1,2,2,2,2,2,1,4,3,3,1,4,2,1,2,2,2.15,0,"Hispanic of Latino (e.g., Mexican American, Central American, and others)",0,23,1,2,NA,5,2,0,0,0,0,0,TRUE,TRUE,TRUE,TRUE,TRUE,3,0.53559375,0.46719354838709676,0.5245625,0.57946875,0.54190625,0.61275,1,1,1,1,1,1,0.143,0.339,0.811,0.014,1.516,37.453568732353986,1820.1553711971924,0.1,0.32,0.687,0.025,1.954,21.599557144031618,1803.0451325510428,0.141,0.316,0.667,0.025,1.702,91.97277709480676,1876.299728618885,108.28571428571428,78.16,68.08,FALSE,435,1.2888888888888888,0,1,0,0,3,FALSE
415,2022-03-18T22:44:56Z,0.8999999761581421,1.6,800,6,4,1,1,1,2,1,1,1,1,1,1,1,1,1,1,3,1,1,1,1,1,1,1,1,3,2,0,0,0,0,2,1,1,1,1,1,2,1,1,2,1,1,1,1,2,5,2,1,1,2,3,1,1,1,1,1,1,1,2,2,1,1,1,1,1,1,1,1,1,1,1,1,0,1.2,0,1.2222222222222223,0,1.8333333333333333,0,1,0,1.2857142857142858,0,1,0,1.3783783783783783,0,2,0,0,-1.1909997336133797,-1.335231165781389,-0.18024366757246235,-0.7577374166769256,1,1,1,1,1,1,3,1,-0.7920494875423887,4,5,5,5,5,5,5,4.857142857142857,0,1.565601414204742,0,1.7186154852788984,2,2,2,2,2,4,5,4,5,4,5,4,5,4,4,4,4,5,4,3,2,0,4.4,0,4.4,0,4,0,4.266666666666667,0,2,2,1,4,3,2,2,3,3,2,2,4,2,3,1,3,1,3,1,2,2.3,0,Native American/Alaskan Native/indigenous,0,24,0,1,NA,5,2,0,0,1,0,0,TRUE,TRUE,TRUE,TRUE,TRUE,2,0.6151718750004657,0.5773656250000931,0.6358354838716407,0.663906249998603,0.6390593749997207,0.7024656249992549,1,1,1,1,1,1,0.152,0.436,0.771,0.025,1.846,33.97320035242262,1817.5206667101952,0.069,0.486,0.741,0.024,1.644,113.25316751165316,1895.1920489196173,0.1,0.51,0.975,0.014,1.152,34.98233435606136,1819.2678307330343,73.84,68.5,82.28571428571428,FALSE,469,1.3896296296296295,0,1,0,0,3,FALSE
416,2022-03-18T22:38:03Z,0.8999999761581421,1.7777777777777777,1440,5,2,4,2,4,2,3,3,3,3,2,2,2,2,2,3,3,3,2,4,1,2,2,3,2,0,1,0,0,0,0,3,2,5,2,2,2,2,2,2,3,2,2,1,3,2,5,3,2,2,2,2,2,1,1,1,3,2,1,1,1,1,1,2,2,1,2,1,2,2,1,1,1.5,0,2.6666666666666665,0,2.4444444444444446,0,2.4166666666666665,0,1.6666666666666667,0,1.2857142857142858,0,1.3333333333333333,0,2,0,0,0,0,0.10518705322262613,0.1768421953027105,-0.4466634660828154,-0.13491063539005244,4,3,4,2,2,3,3,2,0.5899698043823236,4,3,4,3,2,2,3,3,0,-1.2224806707219966,0,-0.9858108588462231,2,3,2,2,3,4,4,4,4,2,3,4,4,4,4,4,4,4,4,2,2.4,0,3.8,0,3.6,0,3.6,0,3.6666666666666665,0,2,2,1,2,3,1,2,2,1,1,2,2,2,1,1,2,2,2,1,1,1.65,0,"White, Caucasian, Anglo, European American",0,20,0,1,NA,5,2,0,0,2,0,0,TRUE,TRUE,TRUE,TRUE,TRUE,3,0.48295483871044653,0.40847187500167637,0.45374062500242146,0.5653172413788993,0.48873571428975887,0.5595900000025829,0.96875,1,1,0.90625,0.875,0.9375,0.07,0.359,0.8,0.014,1.733,82.62653503024879,1929.8695993073636,0.058,0.337,0.873,0.015,1.557,110.71250437771998,1977.381943557166,0.055,0.38,0.549,0.011,1.428,250.9975294032789,2162.851205379201,123.78571428571429,103.8,129.8181818181818,FALSE,362,1.0725925925925925,0,0,0,3,6,FALSE
417,2022-03-18T22:49:15Z,1,1.7777777777777777,720,6,2,4,5,5,4,5,2,4,2,2,2,4,3,3,3,4,1,4,1,3,1,3,2,3,1,1,1,0,1,0,2,5,5,4,5,3,4,4,4,4,2,1,1,2,3,2,5,1,3,5,3,4,4,1,1,2,2,4,2,1,1,2,1,1,4,4,2,1,1,1,1,1,0,3.466666666666667,0,4,0,2.6666666666666665,0,2.3333333333333335,0,1.7142857142857142,0,3.3333333333333335,0,2.810810810810811,0,1,0,0,0.5504085722204418,0.8255479222372103,-0.39960647100849406,0.21297072561435812,3,3,4,3,1,2,1,1,-0.1285727914961955,4,4,3,3,1,1,1,2.4285714285714284,0,-1.5266208755073867,0,-1.480670169754544,2,2,2,5,4,4,5,5,5,4,3,5,3,4,5,5,5,4,5,5,3,0,4.2,0,4.4,0,4.8,0,4.466666666666667,0,3,1,2,3,2,2,2,3,1,1,3,3,2,3,1,3,3,2,3,3,2.3,0,"Hispanic of Latino (e.g., Mexican American, Central American, and others) & White, Caucasian, Anglo, European American",1,23,1,2,NA,5,2,0,0,1,0,0,TRUE,TRUE,TRUE,TRUE,TRUE,1,0.76903125,0.5841612903225807,0.56796875,0.9158620689655173,0.617875,0.6635,1,1,1,0.9354838709677419,1,1,0.084,0.385,0.432,0.021,1.803,76.33959182931969,1863.0205899947305,0.104,0.386,0.549,0.031,1.668,96.9877837962424,1879.1957680062703,0.089,0.346,0.218,0.009,1.6,87.81159526489148,1933.2742082696889,85.85714285714285,53.806451612903224,177.7777777777778,FALSE,356,1.0548148148148149,0,1,0,0,3,FALSE
418,2022-03-18T22:48:46Z,0.8999999761581421,1.7777777777777777,864,3,3,2,1,1,2,1,1,1,1,1,1,1,1,2,2,2,1,1,1,1,1,1,1,1,0,2,0,0,0,0,2,3,2,1,2,1,3,3,2,1,1,1,1,2,1,1,1,1,1,1,1,1,1,1,1,2,1,1,1,1,1,1,1,1,1,1,1,2,1,1,2,1.5,0,1.3333333333333333,0,2.111111111111111,0,1.0833333333333333,0,1.1666666666666667,0,1,0,1,0,1.3243243243243243,0,0,0,0,-1.2260910848644389,-1.300617793660585,-0.4466634660828154,-0.8736406298717001,1,1,2,1,1,1,1,1,-0.874984074548163,5,5,5,4,3,3,4,4.142857142857143,0,-0.5360594366874477,0,0.05150251987581217,1,2,2,1,2,4,3,3,5,3,5,4,4,4,3,4,4,4,3,3,1.6,0,4.2,0,3.4,0,3.6,0,3.7333333333333334,0,1,1,1,1,1,1,1,1,1,1,1,1,1,1,1,1,1,1,1,1,1,0,"White, Caucasian, Anglo, European American",0,26,0,1,NA,5,2,0,0,1,0,0,TRUE,TRUE,TRUE,TRUE,TRUE,2,0.5720937500037253,0.5597593749947846,0.5181749999895692,0.6834312499910593,0.6322806451551376,0.641212500013411,1,1,1,1,1,1,0.112,0.369,0.781,0.016,1.955,63.34990334462208,1843.1253415778503,0.111,0.39,0.666,0.008,1.078,64.5599517710416,1851.535978394588,0.192,0.3,0.732,0.012,1.624,55.936997766474704,1840.278696780515,122.1875,134.75,135.33333333333334,FALSE,390,1.1555555555555557,0,1,0,0,3,FALSE
419,2022-03-18T22:55:18Z,1,1.5,800,6,3,1,1,1,1,1,1,1,1,1,1,1,1,2,1,1,1,1,1,1,1,1,1,1,0,2,0,0,0,0,1,3,4,2,2,1,3,1,1,1,1,1,1,2,1,1,2,1,1,1,1,2,1,1,1,1,1,1,1,1,1,2,1,1,1,1,1,1,1,1,1,1,0,1.0666666666666667,0,2,0,1.1666666666666667,0,1.1666666666666667,0,1.1428571428571428,0,1,0,1.3513513513513513,0,0,0,0,-1.2085454092389094,-1.4052445775711968,-0.6189692744445258,-1.0121069260078612,1,1,2,2,1,1,2,2.5,-0.12890852875348124,5,5,5,5,4,4,5,4.714285714285714,0,0.8279356899465183,0,1.1919083515244764,2,2,1,1,2,4,4,4,4,5,5,5,5,5,5,3,4,4,3,2,1.6,0,4.4,0,4,0,4,0,4.133333333333334,0,1,1,1,1,1,1,1,1,1,1,1,1,1,2,2,1,2,2,1,1,1.2,0,"White, Caucasian, Anglo, European American",0,25,0,1,NA,5,2,0,0,1,0,0,TRUE,TRUE,TRUE,TRUE,TRUE,4,0.49263749999948775,0.4727187499993015,0.48409687500074505,0.6289833333333333,0.5608354838706794,0.6229655172411224,1,1,1,0.9375,0.96875,0.90625,0.067,0.376,0.609,0.007,1.446,202.44683169891877,2095.481843610152,0.068,0.357,0.599,0.02,1.868,53.06507191930663,1882.768440262799,0.068,0.367,0.593,0.006,1.296,170.9043972205359,2016.6829686230676,206.57142857142856,93.4,216,FALSE,404,1.1970370370370371,0,1,0,0,3,FALSE
421,2022-03-18T23:09:53Z,0.8999999761581421,1.7777777777777777,864,6,1,2,2,5,3,2,2,5,3,2,1,1,5,3,4,3,2,3,1,1,1,4,2,3,0,2,0,0,0,0,1,5,2,2,3,3,5,3,2,1,2,2,1,3,2,1,5,2,2,2,2,4,1,1,1,1,1,1,1,1,1,5,5,5,2,4,3,1,1,1,1,1,0,2.8666666666666667,0,2.888888888888889,0,2.0833333333333335,0,1.5,0,2.7142857142857144,0,3,0,2.3783783783783785,0,0,0,0,0.18852901244389253,0.3202123559621772,-0.6189692744445258,-0.1493784592411743,3,3,5,2,2,3,2,2.5,0.7004373413042606,2,2,2,2,1,1,2,1.7142857142857142,0,-1.4363059730518277,0,-1.8126736857881058,1,1,1,1,1,5,5,5,5,2,2,5,5,5,5,4,5,4,5,3,1,0,4.2,0,4.2,0,4.6,0,4.333333333333333,0,2,4,4,3,2,4,4,4,4,4,4,3,3,3,2,4,2,3,2,3,3.2,0,"White, Caucasian, Anglo, European American",0,27,0,3,NA,5,2,0,0,1,0,0,TRUE,TRUE,TRUE,TRUE,TRUE,5,0.5673656249999695,0.47267812499999856,0.5092093750000131,0.6377937499999825,0.5549656249999898,0.5811968750000015,1,1,1,1,1,1,0.1,0.33,0.561,0.002,0.564,59.624806452568905,1842.5800325539583,0.091,0.303,0.508,0.029,1.929,74.05424281976649,1856.382856293057,0.126,0.308,0.519,0.022,2.031,97.72411877727951,1882.4124238986567,281.99999999999994,66.51724137931035,92.31818181818183,FALSE,387,1.1466666666666667,0,1,0,0,3,FALSE
422,2022-03-18T23:12:12Z,1,1.7777777777777777,1080,5,3,2,3,3,2,3,2,4,2,1,1,2,2,3,3,2,2,3,1,1,1,3,2,2,1,2,0,0,0,0,1,1,1,2,2,2,2,2,2,2,2,2,1,2,3,2,3,3,3,3,3,4,2,1,1,2,1,1,1,1,1,1,1,2,1,1,1,2,2,1,1,1.5,0,2.3333333333333335,0,1.6666666666666667,0,2.4166666666666665,0,1.8333333333333333,0,1.1428571428571428,0,1,0,1.7837837837837838,0,1,0,0,-0.3597733508539106,-0.2813916515238424,-0.22730066264678367,-0.25434615708531305,2,2,3,1,2,2,2,2,0.009427695341904336,4,4,4,4,2,2,3,3.2857142857142856,0,-0.7557596538304501,0,-0.5467306303605951,2,3,3,2,3,3,3,3,4,3,3,4,4,4,3,3,4,4,3,3,2.6,0,3.6,0,3.2,0,3.4,0,3.4,0,3,2,2,1,3,2,2,2,1,2,2,2,2,2,3,2,1,2,2,3,2.05,0,"White, Caucasian, Anglo, European American",0,18,0,1,NA,5,2,0,0,2,0,0,TRUE,TRUE,TRUE,TRUE,TRUE,4,0.576125,0.56984375,0.5881724137931035,0.6496774193548387,0.6637037037037037,0.775,1,1,0.9666666666666667,0.96875,0.8709677419354839,0.9375,0.064,0.405,0.298,0.018,1.757,225.96507691771464,2118.3789223154913,0.059,0.395,0.351,0.007,1.251,112.78293098572648,2017.296605556042,0.079,0.406,0.52,0.02,2.06,64.33038500204978,1885.9517318968396,97.61111111111111,178.7142857142857,103,FALSE,476,1.4103703703703703,0,1,0,0,3,FALSE
424,2022-03-18T23:23:10Z,0.8999999761581421,1.6,900,4,2,4,2,2,3,2,3,4,4,3,3,3,5,1,4,2,3,5,1,1,3,4,4,4,1,2,0,0,0,0,2,4,3,2,2,3,3,3,4,3,3,5,4,3,4,1,4,4,4,4,4,4,4,1,2,2,1,1,3,3,1,3,3,2,3,2,4,2,2,2,2,2,0,3,0,2.888888888888889,0,3.5833333333333335,0,2.3333333333333335,0,2.2857142857142856,0,3,0,2.918918918918919,0,1,0,0,1.1886325230990846,1.0510265082400614,-0.05499485428507328,0.498015826977494,1,2,3,1,1,3,1,3,0.23036276918577817,5,5,5,5,2,2,4,4,0,0.8160844699873094,1,0.7976765214992676,3,3,3,3,3,3,5,4,3,3,4,3,3,3,5,3,4,2,4,5,3,0,3.2,0,3.6,0,4,0,3.6,0,2,3,2,2,3,4,3,3,2,3,4,3,2,3,2,3,3,3,2,2,2.7,0,"White, Caucasian, Anglo, European American",0,20,1,3,NA,5,2,0,0,1,0,0,TRUE,TRUE,TRUE,TRUE,TRUE,2,0.5667258064516129,0.5019064515982905,0.5378806451712885,0.647235483865584,0.6226999999960263,0.6618633333444596,1,0.96875,1,0.96875,0.967741935483871,0.9375,0.072,0.402,0.582,0.008,1.414,56.77726777534214,1901.0102201847144,0.062,0.376,0.504,0.015,1.835,122.29996269385184,1993.0779758162787,0.061,0.412,0.4,0.013,1.393,80.68661411467566,1903.1200957065485,176.75,122.33333333333333,107.15384615384616,FALSE,432,1.28,0,1,0,0,3,FALSE
425,2022-03-18T23:28:22Z,0.8999999761581421,1.6,900,3,2,4,3,3,4,3,3,4,3,4,3,3,5,3,4,5,3,3,1,1,4,4,3,3,0,2,0,0,0,0,2,5,5,5,5,4,5,5,5,2,4,2,1,4,3,4,5,3,3,4,2,5,1,1,1,2,1,1,1,1,1,4,4,3,1,3,1,3,3,2,2,2.5,0,3.6,0,4.555555555555555,0,3.0833333333333335,0,1.8333333333333333,0,2.142857142857143,0,1.6666666666666667,0,2.945945945945946,0,0,0,0,0.9627319494203894,1.1610616315445492,-0.10205184935939461,0.5295048910925773,3,2,5,2,2,1,1,1.5,-0.01810525457425849,3,3,3,2,2,2,3,2.5714285714285716,0,-0.4848149464637728,0,-0.7687144260545092,2,2,3,3,2,3,4,4,5,2,5,4,4,3,4,3,3,4,3,5,2.4,0,3.8,0,3.2,0,4.2,0,3.7333333333333334,0,3,3,3,4,3,3,2,2,3,3,3,3,3,3,2,3,2,3,4,3,2.9,0,"White, Caucasian, Anglo, European American",0,21,1,2,NA,5,2,0,0,3,0,0,TRUE,TRUE,TRUE,TRUE,TRUE,4,0.4744187500048429,0.4436838709673574,0.46875624999962745,0.55819285714307,0.5176896551724138,0.5760699999998014,1,0.96875,1,0.875,0.90625,0.9375,0.063,0.364,0.628,0.011,1.464,66.03976974331098,1915.9515803347183,0.053,0.344,0.495,0.018,1.762,115.159562267981,2016.9508705843737,0.057,0.372,0.602,0.017,1.891,51.422244178757914,1912.7838768639408,133.0909090909091,97.8888888888889,111.23529411764706,FALSE,438,1.2977777777777777,0,1,0,0,3,FALSE
426,2022-03-18T23:37:19Z,1,1.7777777777777777,1080,3,2,4,3,1,4,1,2,2,3,3,1,3,3,1,4,5,4,4,5,3,4,4,3,3,3,1,1,0,0,0,5,3,4,4,4,2,3,3,3,1,4,1,4,4,3,2,5,4,2,2,3,4,1,3,3,2,5,2,4,3,1,3,3,2,2,1,1,4,4,2,2,3,0,2.6666666666666665,0,3.4444444444444446,0,2.9166666666666665,0,3,0,2.5714285714285716,0,1.3333333333333333,0,2.864864864864865,0,2,0,0,1.5592849206883992,1.154768291158948,0.5089795658743793,0.8318739285166636,1,1,3,1,1,1,1,1,-0.7920494875423887,3,3,3,2,1,1,3,2.2857142857142856,0,-1.1834102584901123,0,-1.349026856596912,4,5,4,1,3,2,2,3,2,3,4,2,5,4,4,1,3,1,3,2,3.4,0,2.4,0,2.8,0,3,0,2.7333333333333334,0,1,3,1,3,3,2,3,3,1,1,3,2,2,2,1,2,1,2,2,1,1.95,0,"White, Caucasian, Anglo, European American",0,19,0,3,NA,5,2,0,0,1,0,0,TRUE,TRUE,TRUE,TRUE,TRUE,6,0.5420344827586207,0.45503225806451614,0.4549375,0.5166451612903226,0.4983548387096774,0.5686129032258065,0.90625,1,1,1,0.96875,0.96875,0.066,0.343,0.51,0.017,1.622,83.04346764019034,1904.1240790418465,0.061,0.326,0.485,0.041,2.123,66.79158528478311,1892.502910324288,0.048,0.393,0.326,0.201,1.722,270.05507149034594,2161.7051598025746,95.41176470588235,51.78048780487805,8.567164179104477,FALSE,304,0.9007407407407407,1,1,0,0,3,FALSE
427,2022-03-18T23:18:01Z,0.8999999761581421,1.7777777777777777,864,6,3,3,4,3,4,4,2,5,3,3,2,2,5,2,4,5,2,1,1,1,1,3,2,3,2,1,1,0,1,0,3,4,5,3,3,3,4,3,4,2,3,4,1,4,3,3,4,3,4,5,3,4,1,3,3,3,1,2,2,2,2,3,3,3,1,1,1,1,2,2,2,1.75,0,3.4,0,3.5555555555555554,0,3.25,0,2.5,0,2.4285714285714284,0,1,0,2.864864864864865,0,1,0,0,0.26090492439920215,0.6017410047742845,-0.14114775846592847,0.230296623154178,3,2,4,3,1,3,3,1.5,0.2306985064430642,3,3,3,2,1,1,3,2.2857142857142856,0,2.089587539198367,1,0.6445217858940611,3,3,3,3,3,3,3,3,3,2,3,2,3,2,1,3,5,4,1,5,3,0,3.4,0,2.4,0,2.8,0,2.8666666666666667,0,2,1,3,4,4,3,2,3,4,2,1,3,1,3,2,3,1,3,3,2,2.5,0,"Hispanic of Latino (e.g., Mexican American, Central American, and others) & Filipino",1,27,1,2,NA,5,2,0,0,1,0,0,TRUE,TRUE,TRUE,TRUE,TRUE,2,0.4945562500059605,0.41629374998435376,0.45082812499254943,0.538931250013411,0.4656566666563352,0.5060193548356333,1,1,1,1,0.967741935483871,0.96875,0.057,0.346,0.661,0.022,1.816,209.24201009710836,2043.6952801926916,0.058,0.325,0.654,0.031,1.762,42.086674955793825,1867.4834409204757,0.103,0.285,0.505,0.019,1.458,152.3010313994696,1937.0567029972565,82.54545454545455,56.83870967741935,76.73684210526316,FALSE,388,1.1496296296296296,0,1,0,0,3,FALSE
429,2022-03-18T23:29:47Z,0.8999999761581421,1.7786458333333333,768,5,2,2,2,2,2,1,1,2,2,2,1,1,3,2,3,2,2,4,1,1,1,3,1,1,10,2,0,0,0,0,1,2,2,3,2,1,2,2,2,2,2,2,1,3,2,1,1,3,4,4,3,4,2,3,1,4,1,1,5,2,1,2,1,1,1,3,2,2,1,3,1,1.75,0,1.8666666666666667,0,1.8888888888888888,0,2.3333333333333335,0,2.5,0,1.8571428571428572,0,2,0,2.135135135135135,0,5,0,0,-0.2128283174900995,-0.3863134357650295,0.7363034552781984,0.17499500975658444,3,1,4,1,1,1,1,1.5,-0.3498436025973552,3,3,5,2,2,1,4,2.857142857142857,0,-0.7825102850053112,1,-0.7952321850614983,1,2,2,2,2,4,5,4,4,2,5,4,4,4,3,5,4,5,4,3,1.8,0,4.4,0,4,0,3.6,0,4,0,1,3,1,1,1,1,3,1,1,1,3,1,2,1,1,2,1,1,1,2,1.45,0,"White, Caucasian, Anglo, European American & Native American/Alaskan Native/indigenous",1,26,1,2,NA,5,1,0,0,0,1,0,TRUE,TRUE,TRUE,TRUE,TRUE,3,0.5666468750014901,0.5438093749973923,0.5212906250022351,0.6323225806441999,0.5710096774178166,0.6069718749998138,1,1,1,0.96875,1,1,0.072,0.425,0.775,0.013,1.454,39.81738538873488,1825.0318715031624,0.085,0.412,0.646,0.029,1.166,45.583989528105526,1826.4991278034809,0.064,0.427,0.498,0.023,1.952,65.40366787307282,1891.776884161682,111.84615384615385,40.206896551724135,84.8695652173913,FALSE,374,1.108148148148148,0,1,0,0,3,FALSE
430,2022-03-18T23:07:41Z,0.8999999761581421,1.6,900,3,2,3,4,3,4,3,3,4,3,4,3,3,3,3,5,5,4,4,4,1,4,4,4,4,4,1,1,0,1,0,3,4,5,2,5,3,4,4,3,2,3,2,2,4,3,5,4,4,2,3,2,5,3,2,2,1,1,1,2,1,1,4,2,2,1,2,3,2,2,2,2,2,0,3.533333333333333,0,3.6666666666666665,0,3,0,2.3333333333333335,0,1.8571428571428572,0,2,0,2.7567567567567566,0,2,0,0,1.4079534684182051,1.4313802677948049,0.16436794915095845,0.7978741084728816,3,3,4,2,1,4,3,1.5,0.3136330934488383,3,3,3,3,1,1,3,2.4285714285714284,0,-0.009316526567844171,0,-0.5564959991485257,2,1,1,4,2,3,3,3,4,4,2,4,2,4,4,5,5,5,4,3,2,0,3.8,0,3.6,0,3.6,0,3.6666666666666665,0,4,1,2,3,2,3,2,3,2,2,3,3,1,4,3,3,3,4,4,4,2.8,0,"Hispanic of Latino (e.g., Mexican American, Central American, and others)",0,22,1,2,NA,5,2,0,0,0,0,0,TRUE,TRUE,TRUE,TRUE,TRUE,2,0.56125,0.44460322580678807,0.47159354838656803,0.610218750001397,0.5037933333329856,0.535240625000326,1,1,1,1,0.967741935483871,1,0.135,0.293,0.778,0.021,1.709,85.2886148568855,1866.7609595234576,0.06,0.335,0.62,0.015,1.55,104.50555323448448,1928.94002188574,0.184,0.245,0.587,0.026,1.482,115.57297554864203,1898.758760825996,81.38095238095238,103.33333333333334,57,FALSE,304,0.9007407407407407,1,1,0,12,15,FALSE
431,2022-03-18T23:47:09Z,0.8999999761581421,1.25,1024,4,1,5,3,4,5,3,5,4,3,5,3,5,5,5,5,5,5,5,4,1,5,5,5,5,4,2,0,0,0,0,3,4,5,5,5,4,5,5,5,1,4,5,5,5,3,3,5,5,5,5,5,5,5,4,1,4,3,2,4,4,3,4,3,3,3,5,5,3,1,2,2,2,0,4.333333333333333,0,4.555555555555555,0,4.25,0,3.6666666666666665,0,3.2857142857142856,0,4.333333333333333,0,4.054054054054054,0,2,0,0,2.7370383970520797,2.674511660837999,0.16436794915095845,1.4194398049944787,5,5,5,5,5,5,5,5.5,3.10486888995714,3,2,4,2,1,1,2,2.142857142857143,0,-0.698640248793604,0,-1.1311612015523294,3,3,3,3,3,4,3,3,4,3,5,4,3,3,5,3,4,1,4,4,3,0,3.6,0,3.2,0,3.8,0,3.533333333333333,0,3,1,2,3,3,2,3,2,2,3,4,3,1,2,2,3,3,3,3,4,2.6,0,"Black or African American & Hispanic of Latino (e.g., Mexican American, Central American, and others) & Native American/Alaskan Native/indigenous",1,25,1,3,NA,5,2,0,0,0,0,0,TRUE,TRUE,TRUE,TRUE,TRUE,6,0.5663031249046325,0.490971874922514,0.493890625,0.6817931035140465,0.5398032258249098,0.6111333333969116,1,1,1,0.90625,0.96875,0.967741935483871,0.073,0.337,0.505,0.009,1.362,35.29226931459814,1860.7156580331416,0.072,0.322,0.464,0.022,1.881,76.2036371107483,1902.4853355081823,0.069,0.336,0.272,0.014,1.817,153.27777656790255,2042.1490029443223,151.33333333333334,85.5,129.78571428571428,FALSE,472,1.3985185185185185,0,1,0,0,3,FALSE
432,2022-03-18T23:48:33Z,0.8999999761581421,1.6,900,4,3,2,2,2,2,3,2,3,2,2,2,1,2,2,2,2,2,1,3,1,1,1,2,1,3,2,0,0,0,0,2,3,4,4,3,2,2,2,4,3,3,2,1,2,2,1,2,1,1,1,3,3,3,1,2,3,2,1,3,1,1,2,2,2,1,1,1,1,2,1,1,1.25,0,2.066666666666667,0,2.888888888888889,0,1.8333333333333333,0,2.3333333333333335,0,1.7142857142857142,0,1,0,2.081081081081081,0,2,0,0,-0.4102171682773084,-0.43174348667358475,-0.09409076339160714,-0.26291712503259596,2,2,3,2,2,2,1,1,-0.3773765525135179,4,4,4,4,2,2,3,3.2857142857142856,0,0.18645978295702492,0,0.027165349790339424,1,2,2,2,2,4,4,4,4,3,5,4,4,3,3,3,4,4,3,3,1.8,0,4.2,0,3.4,0,3.4,0,3.6666666666666665,0,2,3,3,4,2,2,2,3,2,2,2,3,2,3,1,3,3,3,2,2,2.45,0,"White, Caucasian, Anglo, European American",0,21,1,2,NA,5,2,0,1,0,0,1,TRUE,TRUE,TRUE,TRUE,TRUE,3,0.7143749999999963,0.5685937499999987,0.5740625000000072,0.7728709677419392,0.6267187500000032,0.6267666666666638,1,1,1,0.96875,1,0.967741935483871,0.072,0.407,0.475,0.017,1.731,151.71287944027142,1978.1771299183065,0.126,0.319,0.518,0.012,1.171,73.8448559263002,1856.824592624784,0.083,0.467,0.316,0.011,1.087,81.36720261264101,1905.972744340316,101.82352941176471,97.58333333333333,98.81818181818183,FALSE,358,1.0607407407407408,0,1,0,0,3,FALSE
433,2022-03-18T23:47:01Z,0.8999999761581421,1.6,1050,7,2,3,2,3,3,3,3,4,3,2,3,4,3,2,3,3,2,3,2,1,1,2,3,1,4,1,1,0,0,0,2,4,2,2,2,1,1,1,2,2,2,1,1,2,2,1,3,2,2,3,3,2,4,1,1,3,1,1,3,1,1,2,2,1,2,4,1,2,1,1,1,1.25,0,2.933333333333333,0,1.8888888888888888,0,2,0,2,0,1.5714285714285714,0,2.3333333333333335,0,1.9189189189189189,0,2,0,0,-0.2720449727262622,0.03956870814179425,-0.09409076339160714,-0.027261027624906446,1,2,2,3,2,2,2,2,0.009427695341904336,4,4,4,5,2,2,2,3.2857142857142856,0,0.05707446826958167,0,-0.051641888832181,2,2,3,5,3,4,5,3,4,3,5,4,2,3,4,5,4,4,4,5,3,0,4.2,0,3.8,0,3.8,0,3.933333333333333,0,1,1,2,2,2,3,3,2,2,1,3,2,1,3,1,2,3,3,4,3,2.2,0,Black or African American,0,26,1,2,NA,5,2,0,0,1,0,0,TRUE,TRUE,TRUE,TRUE,TRUE,4,0.5626354838686605,0.45753749999962745,0.502934374993667,0.6418451612880153,0.5151258064431529,0.6042137931009819,0.96875,1,1,0.96875,0.96875,0.90625,0.064,0.405,0.698,0.009,1.351,38.646941038009174,1892.6484956093452,0.048,0.387,0.63,0.03,1.558,70.46039293684622,1894.399207422774,0.063,0.441,0.49,0.022,1.902,184.11127267686737,2047.9092391416991,150.11111111111111,51.93333333333334,86.45454545454545,FALSE,434,1.285925925925926,0,1,0,0,3,FALSE
434,2022-03-18T23:53:56Z,0.8999999761581421,1.7786458333333333,768,6,2,4,3,3,4,2,2,3,3,3,2,1,4,1,3,3,2,3,1,1,2,3,3,2,1,2,0,0,0,0,2,3,1,3,4,3,4,4,4,2,3,2,1,4,4,2,2,2,2,4,4,4,1,1,1,4,4,1,2,3,2,4,3,2,2,3,1,2,1,2,2,1.75,0,2.7333333333333334,0,3.111111111111111,0,2.6666666666666665,0,2.5,0,2.4285714285714284,0,2,0,2.6486486486486487,0,1,0,0,0.36398576869918936,0.37999908962538365,-0.14114775846592847,0.11942566557972759,3,3,5,2,2,3,2,2,0.5070352173765494,1,2,3,3,1,1,2,1.8571428571428572,0,-0.713786753407355,0,-1.2951921291888384,3,2,2,3,2,3,2,3,3,2,2,2,3,2,2,4,3,4,2,2,2.4,0,2.8,0,2.6,0,2.4,0,2.6,0,1,1,1,2,2,1,3,3,1,1,4,3,2,1,1,2,1,1,1,2,1.7,0,"Asian or Asian American (e.g., Chinese, Japanese, and others)",0,24,0,1,NA,5,2,0,0,0,0,0,TRUE,TRUE,TRUE,TRUE,TRUE,5,0.6184375,0.4782258064516129,0.5634838709677419,0.71553125,0.5701379310344827,0.5923870967741935,1,0.96875,0.96875,1,0.90625,0.96875,0.07,0.341,0.319,0.016,1.384,210.25069568313305,2085.4053265267617,0.055,0.36,0.406,0.015,1.622,128.48199363359112,2055.6814683634125,0.235,0.23,0.636,0.012,1.558,23.199898958274456,1804.8492338902363,86.49999999999999,108.13333333333334,129.83333333333334,FALSE,384,1.1377777777777778,0,1,0,0,3,FALSE
436,2022-03-18T23:41:46Z,0.800000011920929,1.5,1024,4,1,5,3,3,3,4,3,3,3,4,2,2,3,1,3,4,3,5,5,5,5,4,4,5,3,1,0,0,5,0,3,2,2,2,5,3,4,4,5,2,2,3,3,5,5,3,5,5,5,5,5,5,1,1,2,1,1,4,2,5,5,1,1,5,1,5,2,3,4,5,5,4.25,0,3.066666666666667,0,3.3333333333333335,0,4,0,1.8333333333333333,0,3.2857142857142856,0,2.6666666666666665,0,3.2432432432432434,0,2,0,0,2.291816878054264,1.822059038919675,0.9397440867786553,1.3809015628491652,4,3,3,5,3,4,4,8,3.3254682265437276,3,3,3,3,2,2,2,2.5714285714285716,0,-0.665444751374891,0,-0.8787341463941569,4,4,4,2,4,2,2,2,2,2,5,3,5,4,3,1,2,2,3,2,3.6,0,2.8,0,2.6,0,2.6,0,2.6666666666666665,0,2,4,4,3,4,4,4,3,4,4,4,3,3,4,1,3,3,3,3,3,3.3,0,"Asian or Asian American (e.g., Chinese, Japanese, and others)",0,24,1,3,NA,5,2,0,1,1,0,1,TRUE,TRUE,TRUE,TRUE,TRUE,6,0.41795312499720605,0.40303437499981376,0.4366218750001863,0.5142037037025999,0.45513571428507565,0.4880466666628917,1,1,1,0.84375,0.875,0.9375,0.055,0.351,0.758,0.025,1.872,74.97766681181282,1923.8062372833872,0.052,0.334,0.864,0.024,1.816,112.62899319978062,1977.422887530143,0.054,0.35,0.842,0.02,2.036,86.80582943726999,1962.98957741576,74.88,75.66666666666667,101.8,FALSE,434,1.285925925925926,0,1,0,3,6,FALSE
437,2022-03-18T23:57:27Z,0.8999999761581421,1.6,1050,4,3,1,1,1,1,1,1,2,2,1,1,1,2,1,2,2,1,1,1,1,1,1,1,1,0,2,0,0,0,0,2,2,1,1,1,1,1,1,1,1,1,1,1,2,1,1,2,1,1,1,1,1,1,1,1,1,1,1,1,1,1,2,2,1,1,1,1,2,1,1,2,1.5,0,1.3333333333333333,0,1.2222222222222223,0,1.1666666666666667,0,1,0,1.2857142857142858,0,1,0,1.162162162162162,0,0,0,0,-1.331365138617617,-1.371417872998593,-0.4466634660828154,-0.9090406695407043,1,1,3,1,1,1,1,1,-0.7920494875423887,4,4,3,4,3,3,4,3.5714285714285716,0,0.40966740893729353,1,0.31792412501302936,1,1,1,2,1,5,4,4,5,3,5,1,4,4,4,4,4,4,3,4,1.2,0,3.8,0,3.6,0,4.2,0,3.8666666666666667,0,1,3,3,4,3,4,4,3,1,2,3,3,4,4,1,3,3,4,3,3,2.95,0,"White, Caucasian, Anglo, European American",0,28,1,2,NA,5,2,0,0,1,0,0,TRUE,TRUE,TRUE,TRUE,TRUE,5,0.6802903225806456,0.49812903225806265,0.5253749999999981,0.7657666666666653,0.5849199999999977,0.6388620689655192,0.96875,0.96875,1,0.9375,0.8064516129032258,0.9354838709677419,0.069,0.364,0.432,0.015,1.955,99.67380679604916,1971.8791285727705,0.048,0.384,0.413,0.02,2.016,76.47396362499455,1975.3266711606095,0.065,0.428,0.305,0.012,1.454,193.27736835671425,2101.7011879782526,130.33333333333334,100.8,121.16666666666666,FALSE,420,1.2444444444444445,0,1,0,0,3,FALSE
438,2022-03-18T23:59:40Z,0.8999999761581421,1.7777777777777777,900,4,2,5,2,2,3,1,2,2,2,3,3,2,5,4,5,4,2,3,1,2,4,1,3,2,4,1,1,0,3,0,2,2,3,2,2,1,1,1,2,1,1,3,2,3,3,3,1,1,1,2,2,3,1,3,1,3,2,2,4,4,2,1,1,1,1,3,3,3,3,1,1,2,0,3,0,1.7777777777777777,0,1.9166666666666667,0,2.1666666666666665,0,2.142857142857143,0,2.3333333333333335,0,2,0,2,0,0,0.024038303454551324,0.2678006305633457,0.16436794915095845,0.21608428985715206,1,2,5,2,1,3,1,2,0.09236228234767849,5,4,4,3,2,1,4,3.2857142857142856,0,-0.23191923190205752,0,-0.22766492162263857,3,2,3,2,2,5,4,5,5,5,5,3,5,4,4,4,5,5,2,5,2.4,0,4.6,0,4,0,4.6,0,4.4,0,2,2,1,3,3,1,1,4,2,2,2,4,3,2,2,2,1,1,1,2,2.05,0,Black or African American,0,25,0,1,NA,5,2,0,0,0,0,0,TRUE,TRUE,TRUE,TRUE,TRUE,6,0.3963531250013039,0.36529687499813734,0.40708749999757854,0.4661960000002384,0.44005333333214125,0.47799285714434725,1,1,1,0.78125,0.9375,0.875,0.051,0.325,0.67,0.022,2.026,61.40657352092784,1922.398737107933,0.057,0.282,0.742,0.016,1.615,103.52780700439313,1955.813681459545,0.037,0.345,0.76,0.014,1.457,32.912830867551286,1933.513401274307,92.0909090909091,100.9375,104.07142857142857,FALSE,320,0.9481481481481481,0,1,0,0,3,FALSE
439,2022-03-19T00:07:28Z,0.8999999761581421,1.7777777777777777,864,6,4,2,1,4,1,3,1,1,3,1,2,3,1,1,3,3,3,2,1,1,1,2,3,1,1,2,0,0,0,0,1,1,2,1,1,1,1,1,1,1,1,1,1,1,2,1,4,3,1,1,1,2,1,1,1,1,1,1,2,1,1,2,3,2,1,1,1,1,1,1,1,1,0,2,0,1.1111111111111112,0,1.5,0,1.1666666666666667,0,1.7142857142857142,0,1,0,1.3513513513513513,0,1,0,0,-0.7216529106304604,-0.6703004206652622,-0.39960647100849406,-0.5349534458368781,1,1,1,1,1,1,1,1,-0.9579186615539372,5,5,5,5,4,4,5,4.714285714285714,0,0.8098866971415565,0,1.1809148992434904,3,3,4,3,2,2,5,3,4,3,5,4,3,4,5,5,4,4,5,3,3,0,3.8,0,4.2,0,3.8,0,3.933333333333333,0,2,1,1,4,1,2,3,2,1,1,2,1,1,2,1,2,1,1,1,2,1.6,0,"White, Caucasian, Anglo, European American",0,23,0,1,NA,5,2,0,0,1,0,0,TRUE,TRUE,TRUE,TRUE,TRUE,5,0.6150677419343302,0.48297187500353905,0.5296593749951571,0.6393750000021288,0.5983862068940853,0.8025888888913172,1,1,1,0.9032258064516129,0.90625,0.84375,0.089,0.296,0.414,0.006,1.667,120.23861808672804,1996.8285931014748,0.082,0.268,0.421,0.008,1.643,190.8300298455295,2054.8389994059694,0.073,0.339,0.352,0.017,2.013,118.94527390920364,1975.024622099376,277.8333333333333,205.375,118.41176470588233,FALSE,338,1.0014814814814814,0,1,0,0,3,FALSE
440,2022-03-18T23:42:35Z,0.8999999761581421,1.7777777777777777,864,6,2,5,5,5,5,5,5,5,5,5,5,5,5,1,5,5,5,5,2,3,5,5,5,5,8,1,2,0,6,0,5,5,5,5,5,5,5,5,5,4,5,5,1,5,5,5,5,5,5,5,5,5,1,3,4,3,4,5,4,3,3,4,5,5,5,5,5,1,5,2,2,2.5,0,4.733333333333333,0,5,0,4.583333333333333,0,3.3333333333333335,0,4.142857142857143,0,5,0,4.4324324324324325,0,4,0,0,2.9826778558094946,3.014352041660438,0.7753993643847322,1.8948757030225851,5,5,5,5,3,5,5,5.5,2.9389997159455916,2,1,2,1,1,1,1,1.2857142857142858,0,-1.797565582874064,0,-2.2649211521894324,1,1,1,1,1,5,5,5,5,1,5,5,3,5,5,5,5,5,5,5,1,0,5,0,3.8,0,5,0,4.6,0,4,4,4,4,4,4,4,4,4,4,4,4,4,4,2,4,3,4,4,4,3.85,0,"White, Caucasian, Anglo, European American",0,26,1,2,NA,5,2,0,0,0,0,0,TRUE,TRUE,TRUE,TRUE,TRUE,3,0.6930225806447767,0.49794062500074504,0.589003125000745,0.7498281249972061,0.6110300000011921,0.6848733333344261,1,1,1,1,0.967741935483871,0.9375,0.065,0.414,0.399,0.012,1.549,28.736315870932117,1869.528992415204,0.073,0.362,0.513,0.013,1.509,67.6819204371305,1893.8441312498776,0.201,0.314,0.547,0.02,1.72,36.58500101590286,1819.4274143978296,129.08333333333331,116.07692307692308,86,FALSE,390,1.1555555555555557,0,1,0,0,3,FALSE
441,2022-03-18T23:59:40Z,0.8999999761581421,1.5,1000,6,3,3,3,4,4,4,3,4,3,2,2,2,3,1,4,5,2,5,1,3,2,2,3,2,6,1,1,0,3,1,4,5,4,5,4,2,5,5,5,3,4,1,1,4,2,2,4,3,4,1,3,5,1,4,3,5,2,3,5,5,5,3,4,3,2,4,1,3,1,3,3,2.5,0,3.1333333333333333,0,4.333333333333333,0,2.6666666666666665,0,3.3333333333333335,0,4,0,2.3333333333333335,0,3.4054054054054053,0,3,1,0,1.0987109355182447,1.0487648390389859,1.255401572399185,1.1520832057190855,1,1,2,2,2,3,3,4,0.7830361910527488,3,4,4,1,1,1,1,2.142857142857143,0,-1.3127955731775556,0,-1.5052367704601095,2,3,3,5,3,2,3,1,4,2,4,4,2,5,4,3,3,2,2,1,3.2,0,3,0,2.4,0,3,0,2.8,0,1,1,1,2,4,2,2,3,1,1,4,1,1,1,1,1,1,2,2,3,1.75,0,"White, Caucasian, Anglo, European American",0,29,0,1,NA,5,2,0,0,1,0,0,TRUE,TRUE,TRUE,TRUE,TRUE,3,0.604546875,0.5365812500026077,0.5577000000067055,0.6523437500037252,0.6107593750003725,0.6697718750014902,1,1,1,1,1,1,0.15,0.312,0.587,0.013,1.57,183.63422077183031,1980.3676235346609,0.076,0.425,0.695,0.015,1.315,49.4463215250393,1836.459151760645,0.26,0.3,0.846,0.013,1.076,68.22062014719816,1851.641529973764,120.76923076923077,87.66666666666667,82.76923076923077,TRUE,450,1.3333333333333335,0,1,0,0,3,FALSE
443,2022-03-18T23:58:06Z,0.8999999761581421,1.6,900,3,3,2,2,3,2,1,1,5,2,2,2,3,3,5,3,4,1,1,1,1,2,2,1,2,4,2,0,0,0,0,1,3,4,3,5,2,3,1,5,3,2,5,1,4,1,2,1,1,1,3,1,5,1,1,1,1,1,1,4,4,3,2,1,2,1,1,2,2,3,2,3,2.5,0,2.6666666666666665,0,3,0,2.0833333333333335,0,1.6666666666666667,0,2.4285714285714284,0,1.3333333333333333,0,2.2432432432432434,0,2,0,0,-0.38609186429220504,-0.15355817494132767,0.33667375751266887,0.0915577912856706,3,4,4,2,1,3,4,4,1.363578300093168,5,5,5,5,1,2,4,3.857142857142857,0,0.11419387330642776,0,0.29275964286421047,2,2,2,2,2,4,5,4,5,2,5,4,5,3,5,4,4,5,5,2,2,0,4.4,0,4.2,0,3.8,0,4.133333333333334,0,2,2,4,2,1,4,4,2,1,1,2,3,3,3,1,3,2,3,3,4,2.5,0,Black or African American,0,21,1,2,NA,5,2,0,0,1,0,0,TRUE,TRUE,TRUE,TRUE,TRUE,6,0.6069677419354811,0.5408749999999982,0.4999687500000036,0.6387187499999996,0.5702500000000018,0.53209375,1,1,1,1,1,1,0.074,0.364,0.591,0.043,1.991,108.99231687773904,1900.6442197732224,0.151,0.302,0.621,0.067,1.633,21.53076478996741,1803.662420247055,0.108,0.404,0.547,0.035,1.489,9.408672211055988,1789.6938208045417,46.30232558139536,24.37313432835821,42.542857142857144,FALSE,438,1.2977777777777777,0,1,0,0,3,FALSE
445,2022-03-19T00:12:44Z,0.8999999761581421,1.6,900,4,3,4,4,3,3,3,3,5,4,2,2,3,2,2,3,3,3,2,1,1,2,2,2,1,0,2,0,0,0,0,1,2,3,4,4,2,4,3,3,4,4,1,2,2,3,3,3,2,4,4,4,2,1,1,1,1,1,1,1,1,1,3,3,3,2,3,2,1,1,1,1,1,0,3.066666666666667,0,2.888888888888889,0,3,0,1.1666666666666667,0,1.8571428571428572,0,2.3333333333333335,0,2.4054054054054053,0,0,0,0,-0.03737156123480268,0.2556072835662443,-0.6189692744445258,-0.18168099543914074,4,4,3,3,3,5,4,2,1.0046427394111945,4,3,3,4,2,2,4,3.142857142857143,0,0.7376207874909593,0,0.28546906370720415,3,3,3,3,3,4,2,4,4,1,5,3,4,2,3,3,4,4,3,3,3,0,4,0,2.6,0,3.2,0,3.2666666666666666,0,2,1,1,4,2,1,2,3,3,3,2,3,1,2,1,3,1,1,2,1,1.95,0,Filipino,0,20,0,1,NA,5,2,0,0,3,0,0,TRUE,TRUE,TRUE,TRUE,TRUE,6,0.4237999999998137,0.39223548386750684,0.4215812499998137,0.4890851851845229,0.46551666666766006,0.5105214285722801,1,1,1,0.8709677419354839,0.9375,0.875,0.051,0.349,0.709,0.012,1.42,53.30665854259437,1926.7400665808295,0.052,0.323,0.742,0.011,1.167,105.04121767123604,1951.1760348434295,0.047,0.327,0.494,0.017,1.675,173.0728108513194,2071.379776883833,118.33333333333333,106.0909090909091,98.52941176470588,FALSE,438,1.2977777777777777,0,1,0,3,6,FALSE
446,2022-03-19T00:17:06Z,0.8999999761581421,1.7777777777777777,864,5,3,4,4,3,4,3,2,5,2,2,5,5,5,1,4,4,2,3,1,1,1,2,2,1,1,2,0,0,0,0,1,1,1,1,1,1,1,1,1,1,1,1,1,1,2,1,2,1,1,1,3,2,1,1,1,3,1,1,5,5,1,3,3,2,1,1,1,1,1,2,2,1.5,0,3.533333333333333,0,1,0,1.3333333333333333,0,1.5,0,2.857142857142857,0,1,0,1.5405405405405406,0,1,0,0,-0.6799819310198275,0.02717869425764339,-0.22730066264678367,-0.10006098419457014,1,1,1,1,1,1,1,1,-0.9579186615539372,5,5,5,5,4,4,5,4.714285714285714,0,0.309970182831297,0,0.8764209918030756,3,3,3,1,3,3,5,5,5,5,1,4,5,4,2,5,3,5,5,4,2.6,0,3.2,0,5,0,4,0,4.066666666666666,0,4,4,4,1,4,4,4,2,2,2,4,3,1,2,3,3,1,3,1,4,2.8,0,"White, Caucasian, Anglo, European American",0,26,0,1,NA,5,2,0,0,1,0,0,TRUE,TRUE,TRUE,TRUE,TRUE,1,0.5877968750037253,0.5464406249970197,0.584393750000745,0.7196925925965663,0.6944733333329359,0.8027700000067551,1,1,1,0.8709677419354839,0.9375,0.967741935483871,0.096,0.391,0.486,0.006,1.354,20.456061428860313,1844.2392438144352,0.094,0.362,0.542,0.008,1.485,44.60333540392592,1888.9727852159897,0.075,0.402,0.419,0.012,2.041,116.02385564944392,2020.2425235145931,225.66666666666669,185.625,170.08333333333331,FALSE,385,1.1407407407407408,0,1,0,0,3,FALSE
447,2022-03-19T00:15:38Z,0.8999999761581421,1.6,900,6,2,3,2,3,3,3,2,3,3,2,2,3,3,2,3,2,1,2,2,1,1,3,3,2,2,2,0,0,0,0,1,2,3,2,3,2,2,1,3,2,2,2,1,3,2,3,4,4,1,3,3,4,1,3,1,1,1,1,1,1,1,2,3,2,1,1,1,2,2,1,1,1.5,0,2.6,0,2.111111111111111,0,2.5,0,1.8333333333333333,0,1.5714285714285714,0,1,0,2,0,1,0,0,-0.2194079458496731,-0.07056474860621828,-0.22730066264678367,-0.14893270562650096,2,3,3,2,2,2,2,2,0.17529686935345262,4,4,4,4,3,2,4,3.5714285714285716,0,0.466676080124282,0,0.35264750891976426,3,1,1,4,2,3,5,3,4,2,5,4,3,4,4,4,3,2,2,2,2.2,0,3.4,0,3.2,0,3.4,0,3.3333333333333335,0,2,2,1,1,2,1,1,1,1,1,2,1,2,2,1,1,1,1,2,1,1.35,0,"White, Caucasian, Anglo, European American",0,27,1,2,NA,5,2,0,0,1,0,0,TRUE,TRUE,TRUE,TRUE,TRUE,5,0.44894062500260773,0.41851874999981376,0.45918750000279396,0.5300821428575686,0.4919142857119441,0.5707838709671651,1,1,1,0.875,0.875,0.96875,0.084,0.328,0.708,0.016,2.009,127.2506131213098,1961.8118882931165,0.055,0.33,0.75,0.021,1.953,118.01370779745604,1987.1822826234488,0.058,0.321,0.522,0.014,1.807,77.87586077110662,1940.0918697190589,125.56249999999999,93,129.07142857142856,FALSE,434,1.285925925925926,0,1,0,0,3,FALSE
448,2022-03-19T00:07:23Z,0.8999999761581421,1.6,900,4,3,2,2,2,2,2,2,3,3,2,3,4,4,2,3,2,1,5,1,1,2,4,2,3,1,1,1,0,1,0,1,2,1,1,2,1,2,1,4,2,1,2,1,2,2,2,2,2,5,5,2,4,1,1,1,3,1,2,2,2,1,1,2,2,3,4,4,2,2,2,2,2,0,2.533333333333333,0,1.6666666666666667,0,2.3333333333333335,0,1.8333333333333333,0,1.7142857142857142,0,3.6666666666666665,0,2.081081081081081,0,1,0,0,0.15782408009921495,0.15402883640490772,-0.05499485428507328,0.04951699105991722,2,2,3,2,2,3,2,2,0.17529686935345262,3,3,3,3,1,1,4,2.5714285714285716,0,0.6473058850354002,0,-0.07915149742532807,2,5,3,3,4,3,5,3,3,4,3,3,3,5,4,4,4,3,4,2,3.4,0,3.2,0,4,0,3.4,0,3.533333333333333,0,3,2,3,1,3,3,3,2,3,3,3,3,3,3,2,3,3,3,3,3,2.75,0,"Hispanic of Latino (e.g., Mexican American, Central American, and others) & White, Caucasian, Anglo, European American",1,19,1,2,NA,5,2,0,0,1,0,0,TRUE,TRUE,TRUE,TRUE,TRUE,2,0.4578312500000066,0.47601562500001093,0.4875218750000004,0.5484379310344771,0.49592758620690136,0.5560419354838725,1,1,1,0.9354838709677419,0.9354838709677419,0.96875,0.061,0.385,0.568,0.026,1.688,40.2579931270761,1862.5618151095507,0.057,0.345,0.493,0.038,2.063,155.26482151055777,2002.1572678987225,0.061,0.35,0.557,0.018,1.738,63.915692577121106,1911.83470653273,64.92307692307692,54.289473684210535,96.55555555555556,FALSE,468,1.3866666666666665,0,1,0,0,3,FALSE
449,2022-03-19T00:18:53Z,0.800000011920929,1.6,800,4,2,4,3,3,3,3,4,2,4,3,3,4,3,3,4,4,3,4,1,1,3,4,4,3,4,1,0,0,1,0,2,4,3,3,3,3,2,2,3,2,2,3,2,3,3,2,4,4,3,4,4,4,1,1,1,3,2,1,3,3,3,4,5,4,3,5,3,2,2,2,2,2,0,3.3333333333333335,0,2.7777777777777777,0,3,0,2,0,3.2857142857142856,0,3.6666666666666665,0,2.891891891891892,0,2,0,0,1.0087893479374053,1.075609869121314,0.16436794915095845,0.6199889091361362,2,2,3,2,1,2,2,2.5,0.20282981926961546,3,3,3,3,1,1,1,2.142857142857143,0,-0.511565577638634,1,-1.0172159807554126,3,3,3,5,3,4,5,4,4,2,5,5,1,3,4,2,5,4,3,5,3.4,0,4.6,0,2.6,0,4,0,3.7333333333333334,0,1,1,1,2,1,2,2,2,2,1,2,1,1,2,1,2,2,2,2,2,1.6,0,"White, Caucasian, Anglo, European American",0,26,1,2,NA,5,2,0,0,0,0,0,TRUE,TRUE,TRUE,TRUE,TRUE,1,0.6069562500012107,0.48723124999925493,0.5151625000003259,0.7404656249999534,0.5446968750001397,0.5760125000004191,1,1,1,1,1,1,0.113,0.315,0.575,0.028,1.896,40.21991791266455,1821.4922742083652,0.09,0.35,0.655,0.03,1.839,6.975606579401835,1787.2329149692669,0.135,0.334,0.498,0.006,1.164,32.08852245450169,1815.3241541704776,67.71428571428571,61.300000000000004,193.99999999999997,FALSE,324,0.96,0,1,0,0,3,FALSE
450,2022-03-19T00:24:55Z,0.8999999761581421,1.7777777777777777,864,6,1,5,3,3,3,2,3,3,4,3,3,4,5,1,5,4,2,3,1,1,2,3,3,3,1,2,0,0,0,0,3,1,1,2,3,1,1,1,1,2,2,5,1,3,2,3,3,5,5,5,5,3,1,2,2,2,2,2,2,2,1,1,2,2,1,3,2,1,2,2,2,1.75,0,3.4,0,1.5555555555555556,0,3.4166666666666665,0,2,0,1.7142857142857142,0,2,0,2.2972972972972974,0,1,0,0,0.21704073533537793,0.5722409717167811,-0.14114775846592847,0.21554660662542632,2,2,3,1,1,2,4,1.5,-0.10103984158003264,3,3,4,4,1,1,3,2.7142857142857144,0,-0.4848149464637728,0,-0.6913117508138321,3,2,3,3,2,3,2,3,3,2,5,3,4,3,3,1,3,3,2,2,2.6,0,3.4,0,2.2,0,2.8,0,2.8,0,1,1,2,4,2,2,3,4,3,2,2,3,2,3,3,3,1,2,3,2,2.4,0,"White, Caucasian, Anglo, European American",0,26,1,2,NA,5,2,0,0,1,0,0,TRUE,TRUE,TRUE,TRUE,TRUE,4,0.4304375,0.39515625,0.43524999999999997,0.5136551724137931,0.4765666666666667,0.49825,1,1,1,0.90625,0.9375,1,0.098,0.308,0.764,0.031,1.886,33.66346848708619,1818.454658663915,0.06,0.315,0.773,0.026,2.121,69.15312153853961,1915.9886210634552,0.056,0.339,0.655,0.019,1.892,133.03889874202164,1988.0946342684747,60.83870967741935,81.57692307692308,99.57894736842105,FALSE,303,0.8977777777777777,0,1,0,3,6,FALSE
451,2022-03-19T00:02:44Z,1,1.7777777777777777,864,4,1,3,2,1,2,1,2,1,2,1,1,1,3,2,3,4,2,1,2,1,1,1,1,1,4,2,0,0,0,0,1,2,1,3,5,2,4,2,3,2,1,1,1,3,1,1,1,1,1,1,1,3,4,1,1,4,1,1,3,2,1,1,1,1,1,2,2,1,2,2,2,1.75,0,1.9333333333333333,0,2.5555555555555554,0,1.25,0,2.3333333333333335,0,1.4285714285714286,0,1.6666666666666667,0,1.8108108108108107,0,2,0,0,-0.7479714240687552,-0.7171071397831675,0.07821504497010326,-0.31944604740653215,1,2,4,1,1,2,1,1,-0.5432457265250663,2,4,4,4,1,2,3,2.857142857142857,0,-0.6470379313219725,1,-0.7127173948067627,2,4,2,2,1,5,3,4,4,2,5,3,3,3,2,2,4,5,2,3,2.2,0,4.4,0,2.4,0,3.2,0,3.3333333333333335,0,1,1,1,3,1,1,1,3,2,1,2,2,1,1,1,2,1,2,1,1,1.45,0,"White, Caucasian, Anglo, European American",0,29,1,2,NA,5,2,0,0,0,0,0,TRUE,TRUE,TRUE,TRUE,TRUE,3,0.7480125000011176,0.5582161290299508,0.6385000000074506,0.7816500000003725,0.6908967741900874,0.7082937500029802,1,1,1,1,0.96875,1,0.099,0.381,0.411,0.015,1.674,82.32953830744277,1864.3207371009755,0.084,0.401,0.544,0.011,1.639,55.43557075428763,1880.6010970460156,0.151,0.34,0.404,0.011,1.192,87.45220623351726,1871.5917838990383,111.6,149,108.36363636363636,FALSE,338,1.0014814814814814,0,1,0,0,3,FALSE
452,2022-03-19T00:18:58Z,0.8999999761581421,1.7786458333333333,768,6,4,1,1,2,1,2,1,1,1,1,1,1,1,2,1,1,1,1,1,1,1,1,1,1,2,2,0,0,0,0,1,1,1,1,1,1,1,1,1,1,1,1,1,2,1,1,1,1,1,1,1,1,1,2,1,2,1,1,2,2,1,1,1,1,1,1,1,1,1,1,1,1,0,1.2,0,1,0,1.0833333333333333,0,1.3333333333333333,0,1.2857142857142858,0,1,0,1.135135135135135,0,1,0,0,-1.3489108142431467,-1.4414312847884012,-0.39960647100849406,-0.9205188778984477,1,1,1,1,1,1,1,1,-0.9579186615539372,5,5,5,5,3,4,5,4.571428571428571,0,0.09614488050146584,0,0.6687795667866098,2,2,2,2,2,4,5,4,4,3,4,4,1,5,4,3,5,5,5,4,2,0,4.4,0,3.4,0,4.2,0,4,0,1,1,2,3,2,2,2,4,2,1,4,3,3,2,2,3,1,1,1,1,2.05,0,Black or African American,0,30,0,1,NA,5,2,0,0,1,0,0,TRUE,TRUE,TRUE,TRUE,TRUE,3,0.5612875000024214,0.4610500000007451,0.4825656249979511,0.7088066666632891,0.5496562500009313,0.5680125000039116,1,1,1,0.9375,1,1,0.082,0.359,0.69,0.017,1.692,53.06494769366332,1836.176591524184,0.127,0.298,0.789,0.011,1.288,20.70805398854864,1802.07196276339,0.069,0.416,0.472,0.012,1.708,46.238270050982194,1894.6807133398552,99.52941176470587,117.09090909090911,142.33333333333331,FALSE,352,1.0429629629629629,0,1,0,0,3,FALSE
453,2022-03-19T00:03:37Z,0.8999999761581421,1.7786458333333333,768,4,1,3,1,2,2,3,5,3,3,2,3,2,3,3,3,2,3,3,4,3,2,3,2,4,0,1,0,0,1,1,1,1,2,2,3,1,3,1,2,1,2,4,2,4,2,1,2,3,5,4,4,5,2,5,2,4,3,2,1,1,1,4,4,2,2,3,3,1,3,2,2,2,0,2.6666666666666665,0,1.7777777777777777,0,2.8333333333333335,0,3.5,0,2.142857142857143,0,2.6666666666666665,0,2.5405405405405403,0,0,1,0,0.8618443145735938,0.6857177655446437,0.4250073537293794,0.5553625596370115,2,2,4,3,1,2,2,1,-0.21150737850196963,4,5,4,5,2,2,3,3.5714285714285716,0,-0.3760932239552953,1,-0.16067443809390553,3,4,3,2,3,3,4,4,4,4,4,4,4,5,5,4,5,4,4,3,3,0,4,0,4,0,4.2,0,4.066666666666666,0,2,1,3,3,2,3,3,3,3,3,2,2,2,3,2,2,2,2,1,2,2.3,0,"White, Caucasian, Anglo, European American",0,28,1,2,NA,5,2,0,0,0,0,0,TRUE,TRUE,TRUE,TRUE,TRUE,6,0.7124937499761581,0.6599906250014901,0.6658468749970198,0.7425062500014902,0.71462903226191,0.7399781249910593,1,1,1,1,1,1,0.121,0.472,0.638,0.015,1.438,6.257055174556915,1786.5973671151355,0.106,0.496,0.697,0.025,1.798,51.959576780409215,1836.969402570324,0.224,0.374,0.638,0.061,1.22,115.33541062494308,1901.49029059302,95.86666666666666,71.92,20,TRUE,344,1.0192592592592593,0,0,0,0,3,FALSE
454,2022-03-19T00:28:05Z,0.8999999761581421,1.7777777777777777,1080,6,2,2,2,3,2,2,1,2,3,2,1,2,2,2,2,3,1,3,5,1,2,2,3,1,2,2,0,0,0,0,2,3,4,2,2,3,4,2,2,1,2,1,1,2,2,1,3,1,1,2,2,3,4,1,2,3,1,1,2,1,1,1,2,1,1,1,1,2,2,2,1,1.75,0,2.066666666666667,0,2.6666666666666665,0,1.5833333333333333,0,2.3333333333333335,0,1.2857142857142858,0,1,0,1.864864864864865,0,1,0,0,-0.06369007467309709,-0.1986932255193078,-0.14114775846592847,-0.16992049199261813,1,1,2,1,1,1,1,1,-0.874984074548163,4,4,5,5,3,4,5,4.285714285714286,0,0.6141103876166872,0,0.8294615760266565,3,3,3,5,4,3,4,4,3,3,5,4,2,4,4,5,4,5,4,3,3.6,0,4.2,0,3.6,0,3.6,0,3.8,0,1,1,1,3,1,1,3,2,1,1,3,1,1,2,2,1,1,1,1,2,1.5,0,"White, Caucasian, Anglo, European American",0,29,1,2,NA,5,2,0,0,0,0,0,TRUE,TRUE,TRUE,TRUE,TRUE,1,0.5713433333307505,0.500159374997951,0.5028937499979511,0.6063612903173893,0.5574258064454601,0.607093333329757,0.967741935483871,1,1,0.96875,0.96875,0.967741935483871,0.1,0.353,0.661,0.012,1.449,115.74526458777292,1938.357504877839,0.073,0.353,0.582,0.012,1.401,124.57932650169838,1952.2381701905183,0.052,0.448,0.407,0.029,1.575,108.94487633531394,1980.655614532095,120.75,116.75,54.3103448275862,FALSE,236,0.6992592592592592,0,1,0,0,3,FALSE
456,2022-03-19T00:38:44Z,0.8999999761581421,1.6,900,3,3,1,1,2,1,1,1,2,2,1,1,1,2,4,2,1,1,1,1,1,1,1,1,1,0,2,0,0,0,0,1,1,4,2,1,1,2,1,2,1,1,1,1,2,4,2,1,1,1,1,1,1,1,1,1,1,1,1,1,1,1,5,1,1,1,1,1,1,1,1,1,1,0,1.5333333333333334,0,1.6666666666666667,0,1.4166666666666667,0,1,0,1.5714285714285714,0,1,0,1.4054054054054055,0,0,0,0,-1.17345405798785,-1.1778976561413708,-0.6189692744445258,-0.8984334652929482,2,1,4,2,1,1,2,1,-0.4603111395192921,3,3,3,3,1,1,5,2.7142857142857144,0,-1.0930953560345533,0,-1.0618089707050569,1,1,1,2,2,4,4,4,2,4,4,4,5,4,5,5,5,5,4,1,1.4,0,4.4,0,4.4,0,3.2,0,4,0,1,1,1,1,1,1,2,1,1,1,1,2,1,1,1,3,1,1,1,1,1.2,0,"White, Caucasian, Anglo, European American",0,18,0,1,NA,5,2,0,0,1,0,0,TRUE,TRUE,TRUE,TRUE,TRUE,6,0.5283062500003726,0.6433933333362143,0.5061096774185857,0.6082838709666845,0.8036250000004657,0.5948433333342273,1,0.967741935483871,1,1,1,0.9375,0.063,0.383,0.483,0.025,1.87,89.37220140638533,1961.5284437281557,0.081,0.325,0.241,0.013,1.243,92.89247474306887,1918.5433744340123,0.083,0.347,0.467,0.025,1.944,99.61286439331523,1882.8969789683456,74.8,95.61538461538463,77.75999999999999,FALSE,446,1.3214814814814815,0,1,0,3,6,FALSE
458,2022-03-19T00:36:04Z,1,1.7777777777777777,1080,1,2,5,4,3,4,4,5,5,5,4,3,4,5,1,5,5,5,5,1,1,5,5,5,4,10,2,0,0,0,0,3,1,5,2,5,1,4,1,2,2,2,5,3,1,2,5,2,5,5,5,5,5,1,1,1,5,5,1,5,5,5,3,3,4,3,5,5,5,5,5,5,5,0,4.133333333333334,0,2.6666666666666665,0,3.5,0,3,0,3.7142857142857144,0,4.333333333333333,0,3.324324324324324,0,5,0,0,1.9387101560904787,2.0502909613412266,1.856291209629316,1.9532910854852714,5,5,5,5,5,5,4,4.5,2.635130055095943,2,2,2,2,1,1,1,1.5714285714285714,0,-1.8392156252645773,1,-2.135484405843999,2,2,2,3,3,4,4,4,4,2,5,3,5,4,5,3,3,4,4,4,2.4,0,3.8,0,3.6,0,4.2,0,3.8666666666666667,0,3,4,4,3,3,4,2,4,4,4,4,4,4,4,2,4,4,4,4,4,3.65,0,"Hispanic of Latino (e.g., Mexican American, Central American, and others) & White, Caucasian, Anglo, European American",1,19,1,2,NA,5,2,0,0,0,0,0,TRUE,TRUE,TRUE,TRUE,TRUE,3,0.4229781249985099,0.40920000000484286,0.41734838709523603,0.5397499999920528,0.4969437499959022,0.5022258064496902,1,1,0.96875,0.9375,1,0.96875,0.056,0.314,0.521,0.021,1.715,142.5304734803329,2014.4011226790255,0.093,0.264,0.639,0.022,1.993,36.811495458132526,1823.312969678645,0.065,0.307,0.585,0.013,1.782,107.44651161297406,1962.8856778795448,81.66666666666667,90.59090909090911,137.0769230769231,FALSE,449,1.3303703703703704,0,1,0,0,3,FALSE
459,2022-03-19T00:42:29Z,0.8999999761581421,1.7777777777777777,1080,4,3,4,2,3,3,3,3,3,3,3,3,3,3,3,3,3,4,4,4,2,3,3,3,4,1,2,0,0,0,0,4,4,4,4,4,2,4,4,4,3,4,3,2,4,2,3,3,3,4,3,4,4,4,4,4,3,2,2,2,1,1,2,3,3,2,2,3,2,3,2,3,2.5,0,3,0,3.7777777777777777,0,3.1666666666666665,0,3.5,0,2,0,2.3333333333333335,0,3.081081081081081,0,1,0,0,1.4562040763884119,1.2309767098908322,0.11731095407663712,0.6741438319837346,2,2,3,2,1,2,2,3,0.3962319431973266,4,4,4,4,3,3,5,3.857142857142857,0,-0.13222200579606097,1,0.14267031447544076,3,3,3,3,3,3,3,3,3,2,2,3,3,3,4,3,3,4,2,3,3,0,3,0,2.6,0,3.2,0,2.933333333333333,0,1,1,2,2,2,2,2,3,2,2,2,3,2,2,1,3,1,2,2,2,1.95,0,"White, Caucasian, Anglo, European American",0,19,0,1,NA,5,2,0,0,0,0,0,TRUE,TRUE,TRUE,TRUE,TRUE,1,0.4837968750006985,0.45688750000006983,0.455109375,0.5742103448280229,0.5250533333335072,0.5743586206899891,1,1,1,0.90625,0.967741935483871,0.90625,0.062,0.35,0.597,0.012,1.753,114.61575878477689,1970.8365676061435,0.064,0.322,0.518,0.013,1.412,33.85608656642906,1858.0650783702492,0.068,0.336,0.521,0.015,2.04,152.86776875905556,2011.071378267604,146.08333333333331,108.61538461538461,136,FALSE,318,0.9422222222222223,0,1,0,0,3,FALSE
460,2022-03-19T00:44:55Z,0.8999999761581421,1.7777777777777777,864,6,3,4,2,1,2,1,1,2,2,1,1,2,2,3,2,3,2,3,1,1,1,2,2,1,1,2,0,0,0,0,2,3,2,2,4,2,4,4,3,2,2,4,1,2,1,3,2,2,2,2,2,2,1,1,1,3,1,2,3,3,1,1,1,2,1,1,1,2,1,2,2,1.75,0,1.9333333333333333,0,2.888888888888889,0,2.0833333333333335,0,1.5,0,1.8571428571428572,0,1,0,2.054054054054054,0,1,0,0,-0.3466140941347634,-0.44718183730701166,-0.14114775846592847,-0.2941647978864701,2,2,3,2,1,2,2,3.5,0.5896340671250377,4,4,4,4,3,3,5,3.857142857142857,0,-0.43024020237018124,1,-0.038849444455509974,2,2,3,3,2,4,4,2,4,3,3,4,4,4,4,3,5,4,3,2,2.4,0,4,0,3.4,0,3.2,0,3.533333333333333,0,2,2,2,1,2,2,3,3,2,2,2,3,3,3,2,3,1,2,1,2,2.15,0,"White, Caucasian, Anglo, European American",0,27,0,1,NA,5,2,0,0,1,0,0,TRUE,TRUE,TRUE,TRUE,TRUE,1,0.5806437499932945,0.4933625000193715,0.5491218750029803,0.641568965533684,0.5723281250149012,0.6260437500029803,1,1,1,0.9354838709677419,1,1,0.088,0.394,0.553,0.022,1.699,90.47438107150091,1874.5481099507083,0.131,0.331,0.807,0.013,1.322,85.14715105291553,1878.68269359008,0.056,0.454,0.486,0.014,1.479,100.89377106723944,1947.517420322819,77.22727272727273,101.69230769230771,105.64285714285715,FALSE,320,0.9481481481481481,0,1,0,0,3,FALSE
461,2022-03-19T00:53:14Z,0.800000011920929,1.7777777777777777,1440,6,3,4,4,4,3,4,4,4,4,4,4,3,4,1,4,2,2,3,1,1,2,2,4,2,0,2,0,0,0,0,2,4,2,2,3,1,2,1,1,3,3,2,1,2,3,1,5,4,3,3,3,3,2,2,1,1,1,1,1,1,1,2,2,4,1,1,1,2,2,3,2,2.25,0,3.533333333333333,0,2,0,2.75,0,1.6666666666666667,0,1.7142857142857142,0,1,0,2.054054054054054,0,0,0,0,-0.02201909506246389,0.4696791901201942,-0.1882047535402498,0.1407372182899722,2,2,4,2,2,2,2,1.5,-0.01810525457425849,5,4,5,3,1,1,3,3.142857142857143,0,-1.4543549658567896,0,-1.0496403856623207,2,2,2,2,2,4,4,4,4,4,4,4,5,4,3,2,4,3,4,3,2,0,3.8,0,3.8,0,3.6,0,3.7333333333333334,0,2,2,2,1,2,3,1,2,1,2,1,2,2,2,1,1,1,3,1,1,1.65,0,"White, Caucasian, Anglo, European American",0,25,0,1,NA,5,2,0,1,0,0,1,TRUE,TRUE,TRUE,TRUE,TRUE,6,0.6437419354838709,0.60071875,0.65640625,0.7383870967741936,0.7133870967741935,0.924125,1,1,1,0.96875,0.96875,1,0.191,0.21,0.425,0.006,1.689,27.952722826047175,1810.039171534698,0.104,0.33,0.369,0.015,1.725,84.2147762623215,1910.2062538355765,0.086,0.392,0.329,0.018,1.87,72.52749059601767,1897.410884020644,281.5,115.00000000000001,103.8888888888889,TRUE,172,0.5096296296296297,0,1,0,0,3,FALSE
462,2022-03-19T00:51:18Z,1,1.7777777777777777,900,6,2,3,4,3,3,4,2,4,3,3,3,4,3,1,3,3,3,3,1,2,3,3,4,3,1,1,2,0,0,0,3,3,2,3,3,2,3,3,3,3,2,2,2,4,4,2,4,3,3,4,4,5,1,1,1,1,2,2,1,1,1,3,4,4,2,3,3,2,2,3,2,2.25,0,3.066666666666667,0,2.7777777777777777,0,3.0833333333333335,0,1.8333333333333333,0,2.2857142857142856,0,2.6666666666666665,0,2.6216216216216215,0,1,0,0,0.752183841914033,0.7866078786013059,0.031158049895781924,0.4088829642485439,4,3,4,3,1,3,3,2,0.5899698043823236,2,3,3,2,1,2,3,2.2857142857142856,0,-0.15675083406024948,0,-0.7236993652927095,2,2,1,2,2,4,4,4,5,3,4,4,4,5,4,4,4,5,3,3,1.8,0,4.2,0,3.6,0,4.2,0,4,0,1,1,2,1,1,2,2,2,1,1,2,1,2,2,1,2,2,2,1,2,1.55,0,Native American/Alaskan Native/indigenous,0,28,1,2,NA,5,2,0,0,1,0,0,TRUE,TRUE,TRUE,TRUE,TRUE,6,0.6143406249992549,0.5523718749843538,0.5395875000096857,0.6981032258041443,0.5969468749985098,0.7192093750014901,1,1,1,1,1,1,0.11,0.318,0.408,0.018,1.964,178.183068431486,1964.768066481921,0.182,0.253,0.638,0.018,1.375,39.95539390940345,1821.568416460475,0.088,0.393,0.419,0.015,1.659,72.41127027872486,1854.5907812241528,109.11111111111111,76.3888888888889,110.60000000000001,FALSE,364,1.0785185185185184,0,1,0,0,3,FALSE
463,2022-03-19T00:47:46Z,0.8999999761581421,1.7777777777777777,1080,4,2,3,2,3,3,3,3,4,4,3,3,2,3,1,3,3,3,1,1,1,3,3,3,3,0,2,0,0,0,0,2,2,2,2,2,2,2,2,2,1,2,5,1,2,3,2,3,4,5,5,5,4,1,1,1,3,1,1,1,1,1,1,1,1,1,1,3,1,1,1,1,1,0,2.8666666666666667,0,2,0,3.1666666666666665,0,1.8333333333333333,0,1,0,1.6666666666666667,0,2.135135135135135,0,0,0,0,0.11176668158219974,0.26858729811154597,-0.6189692744445258,-0.1751909881664899,1,1,1,1,1,1,1,2,-0.571114413698515,5,5,5,5,3,3,5,4.428571428571429,0,-0.01221901475905518,0,0.52537357909512294,2,2,1,4,3,2,1,2,2,3,4,4,3,4,4,4,4,4,3,3,2.4,0,3.6,0,2.8,0,3,0,3.1333333333333333,0,1,1,1,4,1,1,1,2,1,1,1,2,1,1,1,1,1,1,1,1,1.25,0,"White, Caucasian, Anglo, European American",0,28,0,1,NA,5,2,0,0,1,0,0,TRUE,TRUE,TRUE,TRUE,TRUE,6,0.5784799999999504,0.6100250000001397,0.6804718749998138,0.6268624999991153,0.6625448275845627,0.7704241379311887,0.967741935483871,1,1,1,0.9354838709677419,0.9354838709677419,0.074,0.506,0.398,0.017,1.776,219.95915451961315,2087.754874360332,0.073,0.43,0.422,0.02,1.867,175.6679530399738,2051.0515715067127,0.266,0.265,0.874,0.022,1.469,169.38589938498757,1993.620964085751,104.47058823529412,93.35,66.77272727272728,FALSE,344,1.0192592592592593,0,1,0,9,12,FALSE
464,2022-03-19T01:04:15Z,0.8999999761581421,1.7777777777777777,720,4,2,5,3,4,3,5,4,4,4,3,4,5,5,1,5,4,3,4,1,1,5,5,4,4,0,2,0,0,0,0,2,4,3,3,4,1,2,2,4,3,1,5,1,3,2,3,4,5,5,5,5,4,1,1,1,2,1,1,1,2,1,4,4,4,1,1,5,2,3,1,2,2,0,3.933333333333333,0,2.7777777777777777,0,3.5,0,1.6666666666666667,0,2.4285714285714284,0,2.3333333333333335,0,2.72972972972973,0,0,0,0,1.2281102932565262,1.485070327959461,-0.274357657721105,0.605356335119178,2,2,5,2,1,3,1,1,-0.21150737850196963,5,5,5,4,3,3,4,4.142857142857143,0,-0.30418514155265464,0,0.1927347219325869,3,3,3,2,3,3,3,4,4,3,5,3,4,3,4,1,3,4,3,5,2.8,0,3.6,0,2.8,0,4,0,3.466666666666667,0,1,1,2,3,3,2,2,4,3,1,4,3,1,2,3,3,1,2,3,2,2.3,0,"White, Caucasian, Anglo, European American",0,21,1,2,NA,5,1,0,0,1,1,0,TRUE,TRUE,TRUE,TRUE,TRUE,4,0.42322333332896234,0.40950967741589395,0.42065806452112814,0.5813227272711017,0.47518333332737284,0.5694681818160143,0.9375,0.96875,0.96875,0.6875,0.75,0.6875,0.055,0.286,0.409,0.01,1.856,128.63779659959576,2072.003139359872,0.042,0.306,0.396,0.008,1.302,88.96563429497252,2057.7919408347693,0.053,0.311,0.458,0.009,1.86,156.25834709936126,2140.880793004667,185.6,162.75,206.66666666666669,FALSE,360,1.0666666666666667,0,1,0,0,3,FALSE
466,2022-03-19T01:06:12Z,0.8999999761581421,1.6,900,4,4,3,3,2,3,2,2,3,3,2,3,3,2,3,4,3,2,2,3,3,4,2,3,3,1,1,2,0,2,1,3,2,4,3,3,3,4,2,3,2,3,4,3,3,3,4,3,3,4,3,2,3,2,2,3,3,3,3,2,3,3,2,3,3,3,2,3,4,2,2,3,2.75,0,2.7333333333333334,0,3,0,3.0833333333333335,0,2.6666666666666665,0,2.7142857142857144,0,2.6666666666666665,0,2.891891891891892,0,1,1,0,0.9276405981693304,0.7590745144143026,0.9028288697079768,0.8309516920611397,3,4,3,2,3,3,2,2.5,0.7004373413042606,2,2,3,3,2,3,3,2.5714285714285716,0,1.0417609922763496,0,0.16110697269010804,3,2,3,3,2,4,3,3,4,3,3,2,3,4,2,3,3,2,3,3,2.6,0,2.8,0,3,0,3.2,0,3,0,2,3,2,3,3,3,3,4,1,1,1,3,1,1,2,4,2,2,1,1,2.15,0,"Asian or Asian American (e.g., Chinese, Japanese, and others)",0,22,0,1,NA,5,2,0,0,1,0,0,TRUE,TRUE,TRUE,TRUE,TRUE,6,0.7638538461533877,0.7030965517240352,0.7795774193559923,0.7992583333334575,0.8043722222215599,0.9495880000007153,0.896551724137931,0.9354838709677419,0.96875,0.8,0.5806451612903226,0.8333333333333334,0.079,0.34,0.225,0.006,1.785,152.5179492618151,2057.546202314725,0.057,0.42,0.143,0.008,1.819,169.54060274370818,2250.5643624136637,0.066,0.427,0.174,0.013,1.784,229.6597790004768,2261.642782739952,297.5,227.375,137.23076923076923,TRUE,304,0.9007407407407407,1,1,0,0,3,FALSE
467,2022-03-19T01:15:32Z,1,1.6,900,3,2,3,4,4,3,4,4,3,4,3,2,3,4,1,4,4,3,4,1,1,3,5,4,5,4,2,0,0,0,0,2,4,4,4,5,1,1,1,3,1,3,5,1,3,2,1,5,4,5,5,4,4,1,1,1,4,1,1,3,1,1,5,5,4,1,4,3,3,2,3,1,2.25,0,3.3333333333333335,0,2.7777777777777777,0,3.25,0,2,0,2.857142857142857,0,2.6666666666666665,0,2.810810810810811,0,2,0,0,1.1995985703650403,1.2039350129214537,0.2505208533318137,0.7272279331266337,2,1,3,1,1,3,1,1,-0.5432457265250663,3,3,4,3,1,1,3,2.5714285714285716,0,-0.9179826386886498,1,-1.0325523257975882,2,3,2,3,2,4,5,4,4,3,5,4,3,3,3,5,5,4,4,2,2.4,0,4.4,0,4,0,3.2,0,3.8666666666666667,0,2,3,3,4,3,3,4,3,3,1,4,3,2,3,1,3,1,3,3,4,2.8,0,"White, Caucasian, Anglo, European American",0,24,1,1,NA,5,2,0,0,0,0,0,TRUE,TRUE,TRUE,TRUE,TRUE,6,0.52028125,0.40975,0.44378125,0.5515,0.5079655172413793,0.5654814814814815,1,1,1,0.875,0.90625,0.84375,0.059,0.345,0.595,0.013,1.789,43.55021302274506,1907.7563156578271,0.053,0.317,0.54,0.016,1.71,127.73241653527911,2019.000850081004,0.053,0.372,0.41,0.018,1.764,119.08406704137344,1982.3796506491956,137.6153846153846,106.875,98.00000000000001,FALSE,378,1.12,0,1,0,0,3,FALSE
468,2022-03-19T00:56:53Z,0.8999999761581421,1.7777777777777777,864,3,2,5,3,5,4,5,3,5,5,5,4,5,5,2,5,4,5,5,5,2,5,5,5,5,40,2,0,0,0,0,5,5,4,3,4,5,4,4,5,4,5,5,5,5,2,2,5,5,5,5,5,5,5,5,5,5,5,2,5,5,5,2,2,3,4,5,5,4,5,5,5,4.75,0,4.333333333333333,0,4.333333333333333,0,4.416666666666667,0,5,0,3.4285714285714284,0,4.666666666666667,0,4.324324324324325,0,6,0,0,3.074792652843526,2.9016619153807746,1.9895011088844925,2.4455815121326334,4,4,3,4,2,5,5,6.5,2.8281964417663685,2,3,3,1,2,1,2,2,0,-0.698640248793604,0,-1.2085638767930065,1,4,2,3,3,5,5,5,5,2,5,5,4,5,4,5,5,5,5,3,2.6,0,5,0,4.2,0,4.4,0,4.533333333333333,0,3,4,4,4,3,4,4,3,3,4,4,3,4,4,3,4,2,3,1,4,3.4,0,"White, Caucasian, Anglo, European American",0,28,1,2,NA,5,2,1,0,2,0,1,TRUE,TRUE,TRUE,TRUE,TRUE,6,0.6594749999791384,0.5364468749761582,0.6164290322795991,0.8014499999880791,0.5678406250178814,0.6103875000178814,1,1,1,1,1,1,0.127,0.346,0.602,0.024,1.481,54.919906980689035,1836.292823987224,0.153,0.284,0.627,0.037,1.872,161.66605554792017,1946.344785020704,0.139,0.281,0.353,0.01,1.243,177.506865891563,1961.8890468011227,61.708333333333336,50.5945945945946,124.30000000000001,FALSE,386,1.1437037037037037,0,1,0,3,6,FALSE
469,2022-03-19T00:34:15Z,1,1.6,900,3,2,3,2,4,4,3,4,2,3,2,3,4,5,3,4,4,2,4,5,1,2,4,3,3,0,2,0,0,0,0,4,5,4,4,3,4,5,5,4,1,3,2,3,3,2,2,4,4,3,5,4,5,4,1,3,3,1,1,1,4,1,2,1,1,1,1,3,1,3,3,4,2.75,0,3.3333333333333335,0,4.222222222222222,0,3,0,2.8333333333333335,0,1.5714285714285714,0,1.6666666666666667,0,2.891891891891892,0,0,0,0,1.08993809770548,1.1301849302776952,-0.01589894517853939,0.5571429925495779,3,2,3,3,2,2,2,2.5,0.4516335802869379,5,5,5,5,3,4,4,4.428571428571429,0,0.4486270873193201,0,0.806070108082841,4,3,3,4,4,4,4,4,3,4,5,3,5,3,4,1,4,5,4,4,3.6,0,4.2,0,3.6,0,3.6,0,3.8,0,4,4,4,4,4,4,1,3,4,4,4,4,2,3,1,4,3,4,2,4,3.35,0,"White, Caucasian, Anglo, European American",0,23,1,2,NA,4,2,0,0,1,1,0,TRUE,TRUE,TRUE,TRUE,TRUE,3,0.6248781250012108,0.48431250000046566,0.5271466666678587,0.6846645161293207,0.5237466666668653,0.5689827586206897,1,1,0.967741935483871,0.96875,0.967741935483871,0.9354838709677419,0.043,0.447,0.527,0.03,1.663,78.12174289038768,1966.7186551398167,0.057,0.375,0.552,0.037,1.942,123.86848010146475,1950.9538466983245,0.222,0.276,0.636,0.021,1.55,129.23905866845774,1955.3672464546817,55.43333333333334,52.486486486486484,73.80952380952381,FALSE,304,0.9007407407407407,1,1,0,0,3,FALSE
470,2022-03-19T00:48:27Z,0.8999999761581421,1.7786458333333333,768,3,2,5,3,3,3,4,1,4,5,5,3,3,4,5,4,3,5,5,5,3,5,5,4,4,2,2,0,0,0,0,1,1,5,3,1,1,5,2,1,1,3,5,5,3,5,1,5,5,5,5,5,5,3,5,5,5,3,3,3,1,1,3,3,2,1,3,4,3,5,4,2,3.5,0,3.6666666666666665,0,2.2222222222222223,0,4,0,4.333333333333333,0,2.2857142857142856,0,2.6666666666666665,0,3.189189189189189,0,1,0,0,2.2567255268032045,2.0604193060243023,0.46192257080005794,1.26117093841218,4,3,5,3,1,3,3,1,0.28610014353267543,4,4,4,4,1,1,2,2.857142857142857,0,-1.0534549923719885,1,-0.9602617655709698,4,4,5,5,5,3,2,2,2,1,5,3,1,4,3,1,5,5,2,3,4.6,0,4.2,0,1.4,0,2.8,0,2.8,0,1,4,1,2,3,2,3,4,1,1,3,4,3,4,4,4,1,3,4,4,2.8,0,"White, Caucasian, Anglo, European American",0,26,1,2,NA,5,2,0,0,1,0,0,TRUE,TRUE,TRUE,TRUE,TRUE,4,0.6007124999910594,0.5341906250417232,0.5499812499582768,0.6530500000417233,0.5900343749672174,0.6490258064423838,1,1,1,1,1,1,0.158,0.365,0.852,0.014,1.561,16.418368317593742,1797.29662940167,0.191,0.301,0.868,0.013,1.232,36.18301761590841,1820.366452357404,0.152,0.364,0.643,0.018,1.411,115.52431763218212,1896.916407483414,111.5,94.76923076923077,78.3888888888889,FALSE,304,0.9007407407407407,1,1,1,21,24,FALSE
471,2022-03-19T01:45:58Z,1,1.7777777777777777,864,6,3,2,2,2,2,2,1,2,2,2,2,1,2,2,2,2,2,2,1,1,2,1,1,2,0,1,0,0,2,0,2,2,3,2,4,2,4,4,3,2,2,2,1,3,1,2,2,1,2,1,1,1,1,1,1,2,1,1,1,1,1,1,1,1,1,2,1,2,1,2,2,1.75,0,1.8666666666666667,0,2.888888888888889,0,1.6666666666666667,0,1.1666666666666667,0,1,0,1.3333333333333333,0,1.7297297297297298,0,0,0,0,-0.6383109514091944,-0.6724637564228123,-0.3605105619019602,-0.5164871591623863,1,1,1,2,1,2,2,1.5,-0.5157127766089035,4,4,4,4,2,1,4,3.2857142857142856,0,-0.8792700537047221,0,-0.62195951996656,2,2,2,2,2,4,2,4,4,4,5,4,4,4,4,5,4,4,3,3,2,0,4.2,0,3.6,0,3.8,0,3.8666666666666667,0,1,1,1,1,1,1,1,2,1,1,1,2,1,1,1,2,1,1,1,1,1.15,0,"White, Caucasian, Anglo, European American",0,25,0,1,NA,5,2,0,0,0,0,0,TRUE,TRUE,TRUE,TRUE,TRUE,2,0.5394031250029803,0.4524999999925494,0.5136156250312924,0.5860718749985099,0.516356249988079,0.5782625000104308,1,1,1,1,1,1,0.13,0.326,0.718,0.022,1.662,33.48635496983766,1815.5525731853604,0.069,0.341,0.598,0.022,1.585,63.50707916485324,1848.9514762858416,0.117,0.338,0.591,0.032,1.769,60.020759392945,1841.2756491566884,75.54545454545455,72.04545454545455,55.28124999999999,FALSE,320,0.9481481481481481,0,1,0,0,3,FALSE
472,2022-03-19T01:38:17Z,0.8999999761581421,1.7786458333333333,768,3,2,2,2,2,3,3,2,2,2,2,2,1,2,3,2,3,2,3,3,1,2,1,1,1,3,2,0,0,0,0,2,2,3,3,3,2,2,2,2,2,2,1,1,3,3,2,2,2,1,1,1,3,1,2,1,3,1,1,2,1,1,2,2,2,1,1,1,2,2,2,2,2,0,2.2,0,2.3333333333333335,0,1.75,0,1.8333333333333333,0,1.5714285714285714,0,1,0,1.8108108108108107,0,2,0,0,-0.4233764249964559,-0.382380098024029,0.16436794915095845,-0.10900607443653527,2,1,3,1,1,1,1,1,-0.7091149005366146,4,4,4,3,3,3,4,3.5714285714285716,0,-0.9124655511234351,0,-0.48737319892134634,3,3,3,3,3,3,4,3,3,2,4,3,3,3,2,2,4,3,3,3,3,0,3.4,0,2.8,0,2.8,0,3,0,1,1,2,2,3,2,2,3,2,1,3,2,1,3,1,3,1,1,1,1,1.8,0,"Hispanic of Latino (e.g., Mexican American, Central American, and others) & White, Caucasian, Anglo, European American",1,23,0,1,NA,5,2,0,0,1,0,0,TRUE,TRUE,TRUE,TRUE,TRUE,1,0.5592000000092291,0.5411199999928474,0.5235419354823327,0.6157399999896686,0.5988266666650772,0.6026586206986986,1,1,1,0.9375,0.9375,0.90625,0.052,0.41,0.464,0.013,1.419,117.31625994747412,2005.0324177875832,0.063,0.371,0.392,0.016,1.503,45.43000413277544,1888.8691567916037,0.053,0.426,0.385,0.01,1.033,115.20274186936136,1981.682609751362,109.15384615384616,93.93749999999999,103.29999999999998,FALSE,460,1.3629629629629632,0,1,0,0,3,FALSE
473,2022-03-19T01:29:55Z,1,1.7786458333333333,768,3,3,5,1,4,2,3,5,5,5,5,4,4,4,3,5,3,1,4,3,1,2,5,5,2,5,2,0,0,0,0,1,1,1,1,2,1,1,1,1,2,2,4,2,1,3,1,3,2,2,3,3,4,1,1,1,2,1,1,5,2,1,2,3,2,1,1,1,1,1,2,1,1.25,0,3.8666666666666667,0,1.1111111111111112,0,2.3333333333333335,0,1.6666666666666667,0,2.2857142857142856,0,1,0,1.8108108108108107,0,3,0,0,0.30696232291621733,0.8364629344684865,0.12527204004442455,0.48086748725645556,1,2,3,1,2,2,2,1,-0.4603111395192921,5,5,5,5,2,3,4,4.142857142857143,0,-0.14160432944649845,0,0.2917609899912483,1,3,2,3,2,4,5,4,4,2,4,5,4,5,3,4,3,4,5,3,2.2,0,4,0,4,0,3.8,0,3.933333333333333,0,1,2,1,3,2,1,2,3,2,2,1,3,1,1,1,3,1,1,1,2,1.7,0,"White, Caucasian, Anglo, European American",0,19,1,2,NA,5,2,0,0,0,0,0,TRUE,TRUE,TRUE,TRUE,TRUE,6,0.5549249999988825,0.4552468750067055,0.44549062500707803,0.6197548387127538,0.5186593750044703,0.5333566666722298,1,1,1,0.96875,1,0.9375,0.075,0.296,0.526,0.02,2.043,73.59432217092757,1921.1636577380712,0.091,0.297,0.603,0.014,1.388,60.72363175665989,1844.209433702421,0.212,0.196,0.594,0.018,1.436,177.48790741784998,2003.843985848641,102.15,99.14285714285714,79.77777777777779,FALSE,460,1.3629629629629632,0,1,0,0,3,FALSE
474,2022-03-19T01:39:53Z,1,1.7777777777777777,1080,4,2,4,3,4,3,3,3,2,3,2,4,2,4,2,4,3,4,4,1,1,2,3,4,1,2,1,1,0,1,0,2,2,3,3,3,3,3,3,3,2,3,3,1,3,2,1,5,4,3,4,4,4,1,1,1,3,2,1,3,3,1,3,2,3,1,1,4,2,3,3,3,2.75,0,3.066666666666667,0,2.7777777777777777,0,2.9166666666666665,0,2,0,2.2857142857142856,0,2,0,2.5405405405405403,0,1,0,0,0.5372493155012946,0.6420577166195388,0.20346385825749233,0.4227607874385156,4,3,4,3,3,3,3,2.5,0.949241102321583,3,4,4,3,2,1,4,3,0,0.2948236782175459,0,-0.061636688240204796,2,2,3,2,2,4,3,3,4,2,5,3,5,3,4,4,3,5,3,1,2.2,0,4,0,3.4,0,3,0,3.466666666666667,0,1,1,1,1,3,2,4,2,2,2,2,2,3,2,1,3,1,2,1,3,1.95,0,"Hispanic of Latino (e.g., Mexican American, Central American, and others)",0,20,0,1,NA,5,2,0,0,0,0,0,TRUE,TRUE,TRUE,TRUE,TRUE,5,0.6438718750178813,0.5902656249925494,0.6846000000089407,0.7103718750067055,0.6522387096843412,0.785832258062978,1,1,1,1,1,1,0.245,0.157,0.477,0.01,1.664,59.51709044953026,1845.2338714609928,0.139,0.366,0.615,0.028,1.871,70.12150246836936,1854.3045090404896,0.23,0.267,0.621,0.018,1.515,14.6524357625398,1795.7932173174042,166.39999999999998,66.82142857142857,84.16666666666667,FALSE,355,1.0518518518518518,0,1,0,6,9,FALSE
475,2022-03-19T01:53:46Z,0.8999999761581421,1.7777777777777777,1080,4,2,4,4,5,2,5,3,5,4,5,2,3,4,1,4,4,3,4,1,1,3,4,3,5,4,2,0,0,0,0,3,1,3,3,4,2,5,1,3,3,2,5,1,4,4,2,4,5,5,5,5,3,1,1,1,3,3,1,3,3,2,3,4,3,2,2,1,2,4,2,2,2.5,0,3.6666666666666665,0,2.7777777777777777,0,3.75,0,2,0,2.7142857142857144,0,1.6666666666666667,0,2.864864864864865,0,2,0,0,1.0723924220799503,1.2639184134717107,0.33667375751266887,0.8002960854921898,1,1,3,1,1,1,1,1,-0.7920494875423887,3,4,4,3,1,1,3,2.7142857142857144,0,-0.698640248793604,0,-0.8215505005896206,3,4,2,2,2,4,5,4,5,3,4,4,3,2,5,3,3,4,5,5,2.6,0,3.8,0,3.8,0,4.2,0,3.933333333333333,0,2,2,2,4,4,3,4,4,4,4,4,3,1,4,1,4,1,4,4,4,3.15,0,"White, Caucasian, Anglo, European American",0,20,0,1,NA,5,2,0,0,0,0,0,TRUE,TRUE,TRUE,TRUE,TRUE,4,0.4530406250096857,0.4514437499977648,0.44884687499701975,0.5619933333277702,0.5167967741873957,0.5473322580591324,1,1,1,0.9375,0.96875,0.96875,0.077,0.318,0.605,0.013,1.625,59.51884095113882,1882.5985725201404,0.072,0.312,0.557,0.018,1.727,66.46964414392156,1889.104691550224,0.069,0.318,0.499,0.015,1.924,102.47937719697772,1968.3919247502024,125,95.94444444444446,128.26666666666668,FALSE,432,1.28,0,1,0,0,3,FALSE
476,2022-03-19T01:43:37Z,0.8999999761581421,1.7777777777777777,1080,4,3,3,2,4,2,2,2,3,4,2,2,4,2,3,3,1,2,2,1,1,1,2,1,3,1,2,0,0,0,0,1,1,4,2,4,1,4,1,4,2,2,1,2,3,2,1,1,2,2,3,3,2,1,1,1,3,1,1,2,2,1,1,1,2,1,1,1,2,1,2,2,1.75,0,2.6,0,2.4444444444444446,0,2,0,1.5,0,1.4285714285714286,0,1,0,1.837837837837838,0,1,0,0,-0.4869794991390009,-0.25051495025698906,-0.14114775846592847,-0.19583135436145876,1,1,2,2,1,2,3,2.5,0.036960645258067054,4,3,4,4,3,3,4,3.5714285714285716,0,0.2196552803757379,0,0.2021897297078348,3,3,4,3,3,3,4,4,4,3,4,4,3,3,4,4,5,4,4,3,3.2,0,4,0,3.6,0,3.6,0,3.7333333333333334,0,3,4,2,3,3,2,2,2,4,1,2,3,2,2,2,3,1,3,3,3,2.5,0,"Asian or Asian American (e.g., Chinese, Japanese, and others)",0,21,0,1,NA,5,2,0,0,0,0,0,TRUE,TRUE,TRUE,TRUE,TRUE,4,0.4457718750052154,0.4086968750208616,0.4103903225814143,0.5008064516129033,0.47459354839786405,0.4954062499925494,1,1,1,0.96875,1,1,0.104,0.275,0.741,0.028,1.85,41.33128736725236,1823.716353031487,0.082,0.296,0.724,0.009,0.955,41.89356090055149,1826.936161577532,0.082,0.296,0.612,0.017,1.624,50.603834982541585,1874.838378386648,66.07142857142857,106.11111111111111,95.52941176470588,FALSE,526,1.5585185185185184,0,1,0,15,18,FALSE
477,2022-03-19T01:55:47Z,0.8999999761581421,1.7786458333333333,768,6,2,3,2,2,2,1,3,3,2,2,2,3,1,2,2,1,1,1,1,1,1,2,1,1,1,2,0,0,0,0,1,1,1,1,1,1,1,1,1,1,2,1,1,2,1,1,1,1,1,1,2,1,1,1,1,1,2,1,2,1,1,2,1,2,2,3,1,2,1,1,1,1.25,0,2.066666666666667,0,1,0,1.25,0,1.1666666666666667,0,1.4285714285714286,0,2,0,1.2702702702702702,0,1,0,0,-1.1800336863474237,-0.9494690668327693,-0.31345356682763886,-0.6314613168302041,1,1,4,1,1,2,1,1,-0.6261803135308405,3,3,3,3,1,1,2,2.2857142857142856,0,-0.804101655862914,0,-1.1179939636366307,2,2,2,2,3,4,4,3,4,5,3,4,5,4,4,4,4,4,4,2,2.2,0,3.8,0,4.4,0,3.4,0,3.8666666666666667,0,1,1,1,2,1,1,1,1,1,1,1,1,1,1,1,1,1,2,1,1,1.1,0,"White, Caucasian, Anglo, European American",0,30,0,1,NA,5,2,0,0,1,0,0,TRUE,TRUE,TRUE,TRUE,TRUE,2,0.6229612903210424,0.5685129032327283,0.5515843750052154,0.7127656250074506,0.6367466666618983,0.6503218750171363,1,1,1,1,0.967741935483871,1,0.126,0.361,0.659,0.015,1.628,114.69913681316578,1902.054045623759,0.065,0.435,0.543,0.025,1.854,53.03020643703979,1876.7436883956857,0.091,0.454,0.601,0.015,1.714,83.50884325361118,1864.4725943708677,108.53333333333333,74.16,114.26666666666667,FALSE,388,1.1496296296296296,0,1,0,0,0,FALSE
478,2022-03-19T02:04:41Z,0.8999999761581421,3.5555555555555554,1080,8,3,3,1,2,2,3,2,3,2,1,1,1,3,2,3,2,2,3,1,1,1,2,2,3,4,1,0,0,1,0,2,2,4,2,1,1,1,1,2,2,1,1,1,4,1,3,2,3,3,3,4,3,1,1,1,5,1,2,5,1,1,1,1,1,1,1,1,1,1,3,2,1.75,0,2.066666666666667,0,1.7777777777777777,0,2.3333333333333335,0,2,0,1.7142857142857142,0,1,0,1.9189189189189189,0,2,0,0,-0.2720449727262622,-0.3388183825424489,0.07821504497010326,-0.13030166878617283,1,2,3,2,1,2,1,1.5,-0.3498436025973552,5,5,5,5,3,3,4,4.285714285714286,0,-0.23191923190205752,0,0.3141538050621014,2,3,3,2,3,5,3,4,3,2,2,3,4,3,5,3,3,4,3,3,2.6,0,3.4,0,3,0,3.6,0,3.3333333333333335,0,2,1,3,3,2,3,1,3,3,1,1,2,2,4,1,1,1,2,1,2,1.95,0,"White, Caucasian, Anglo, European American",0,30,0,1,NA,5,2,0,0,1,0,0,TRUE,TRUE,TRUE,TRUE,TRUE,6,0.5315625,0.44425,0.45221875,0.5625161290322581,0.5123548387096775,0.52859375,1,1,1,0.96875,0.96875,1,0.106,0.273,0.608,0.019,1.78,40.45018932175908,1822.117290340995,0.061,0.343,0.676,0.022,1.928,170.69637844534577,1992.7389933647312,0.081,0.316,0.433,0.022,1.836,104.48583573840835,1928.8256933035968,93.6842105263158,87.63636363636364,83.45454545454547,FALSE,400,1.1851851851851851,0,1,0,0,3,FALSE
479,2022-03-19T02:13:43Z,0.8999999761581421,1.7777777777777777,1440,4,4,1,1,1,1,1,1,1,1,1,1,1,1,1,1,3,1,1,1,1,1,1,1,1,0,2,0,0,0,0,2,1,1,2,1,1,1,1,1,3,1,1,1,1,2,1,4,3,2,2,2,1,1,1,1,1,1,1,1,2,1,1,1,1,1,1,1,1,1,1,1,1,0,1.1333333333333333,0,1.2222222222222223,0,1.9166666666666667,0,1,0,1.1428571428571428,0,1,0,1.3783783783783783,0,0,0,0,-1.1909997336133797,-1.3643378650647924,-0.6189692744445258,-0.9916535697546591,1,1,1,1,1,1,1,1.5,-0.7645165376262261,5,5,5,5,4,4,5,4.714285714285714,0,1.2043418043825058,0,1.4211733693589266,1,2,2,1,2,5,1,5,5,1,5,1,5,1,1,5,3,4,2,5,1.6,0,3.6,0,2.8,0,3.4,0,3.2666666666666666,0,2,2,1,3,2,1,1,2,2,3,2,1,2,1,1,2,1,1,1,1,1.6,0,"White, Caucasian, Anglo, European American",0,25,0,1,NA,5,2,0,0,1,0,0,TRUE,TRUE,TRUE,TRUE,TRUE,2,0.5276281250000465,0.4630531249999185,0.47982812500017463,0.6024451612902264,0.5307533333335692,0.5820225806451973,1,1,1,1,0.9375,0.96875,0.072,0.357,0.591,0.016,1.698,90.13807486664918,1916.6842664166995,0.056,0.321,0.357,0.016,1.329,116.44601854088496,1982.7470322169015,0.09,0.35,0.539,0.014,1.447,26.84463989657927,1807.48753475406,106.125,83.0625,103.35714285714286,FALSE,370,1.0962962962962963,0,1,0,3,6,FALSE
480,2022-03-19T02:12:23Z,1,1.7777777777777777,1080,2,4,1,2,3,2,3,2,2,3,2,2,2,3,1,2,4,1,1,1,1,1,1,1,1,2,2,0,0,0,0,1,1,1,1,1,1,1,1,1,2,1,5,2,1,2,1,5,2,5,5,5,2,1,1,1,3,1,1,2,2,2,3,3,4,1,1,3,2,1,1,3,1.75,0,2.2666666666666666,0,1,0,3,0,1.5,0,2.4285714285714284,0,1.6666666666666667,0,2.054054054054054,0,1,0,0,-0.7523578429751374,-0.5745236466719011,-0.14114775846592847,-0.35783570256891484,1,1,2,1,1,2,1,1,-0.7920494875423887,4,5,5,4,5,5,4,4.571428571428571,0,-0.018093929572226358,0,0.5991979053192441,1,2,2,2,2,4,5,5,4,5,4,5,5,4,4,1,5,5,3,2,1.8,0,4.6,0,3.8,0,3.8,0,4.066666666666666,0,2,1,2,2,3,2,2,2,2,2,3,2,1,4,1,2,1,2,2,3,2.05,0,"White, Caucasian, Anglo, European American",0,19,0,3,NA,5,2,0,0,1,0,0,TRUE,TRUE,TRUE,TRUE,TRUE,3,0.4661290322580645,0.4695625,0.4875,0.5796875,0.5190625,0.55990625,1,1,1,1,1,1,0.262,0.162,0.816,0.015,1.356,66.3208123392586,1845.8366348953944,0.067,0.365,0.624,0.02,1.249,39.907361114468955,1820.801766703256,0.069,0.357,0.626,0.012,1.546,108.14392237988058,1891.8299768373693,90.4,62.45,128.83333333333334,FALSE,278,0.8237037037037037,0,1,0,0,3,FALSE
481,2022-03-19T02:07:36Z,0.8999999761581421,1.6,800,3,1,5,5,2,5,1,2,3,2,2,1,1,4,1,4,3,2,1,1,2,1,2,2,2,3,1,1,0,0,0,2,2,1,2,1,1,3,1,1,2,2,5,1,4,1,2,1,2,5,5,5,2,1,1,1,1,1,1,3,3,4,2,2,2,1,4,4,2,2,2,4,2.5,0,2.7333333333333334,0,1.5555555555555556,0,2.9166666666666665,0,1.1666666666666667,0,2.4285714285714284,0,3,0,2.2162162162162162,0,2,0,0,-0.2413400403815852,-0.027101366568162897,0.33667375751266887,0.15478619547225297,5,5,5,2,2,2,2,1,0.3690347305384496,1,1,1,1,1,1,1,1,0,-0.8909091494812069,1,-1.8674915750235574,2,4,4,1,2,4,4,5,5,1,5,4,5,5,5,1,5,5,2,1,2.6,0,4.6,0,2.6,0,4.2,0,3.8,0,1,3,4,4,1,4,4,4,4,2,1,4,1,1,1,4,1,4,3,2,2.65,0,"White, Caucasian, Anglo, European American",0,25,0,1,NA,5,2,1,0,1,0,1,TRUE,TRUE,TRUE,TRUE,TRUE,1,0.527528124993667,0.47254062499664723,0.5258906249888241,0.5666548387062165,0.5207580645180517,0.6063562500011176,1,1,1,0.96875,1,1,0.134,0.336,0.727,0.013,1.33,21.874149638650614,1802.6945628027972,0.08,0.38,0.894,0.038,1.824,39.61086404186838,1818.8279933360027,0.055,0.427,0.576,0.035,1.936,103.91685363611444,1929.1445502564047,102.30769230769232,48,55.31428571428571,FALSE,368,1.0903703703703704,0,1,0,0,3,FALSE
482,2022-03-19T02:20:35Z,1,1.7777777777777777,864,5,3,1,1,1,1,1,1,1,1,1,1,1,1,1,1,4,1,1,1,1,1,1,1,1,2,2,0,0,0,0,2,5,5,5,5,1,4,3,1,1,1,1,1,4,1,1,1,1,1,1,1,1,1,1,1,1,1,1,2,1,1,1,1,1,1,1,1,1,1,1,1,1,0,1.2,0,3.4444444444444446,0,1.25,0,1,0,1.1428571428571428,0,1,0,1.7027027027027026,0,1,0,0,-0.9804516261070234,-1.1936310071053726,-0.39960647100849406,-0.7966187390569334,1,1,3,1,1,1,1,1,-0.7920494875423887,5,5,5,5,3,3,5,4.428571428571429,0,-0.17479982686521142,0,0.4263473110364615,1,1,2,3,2,4,4,4,5,1,5,4,3,3,4,2,4,4,3,3,1.8,0,4.2,0,2.6,0,3.8,0,3.533333333333333,0,1,1,1,1,1,1,1,1,1,1,1,1,1,1,1,1,1,1,1,1,1,0,"White, Caucasian, Anglo, European American",0,29,0,1,NA,5,2,0,0,0,0,0,TRUE,TRUE,TRUE,TRUE,TRUE,6,0.4317064516159796,0.4149125000089407,0.4546193548171751,0.48521851850439,0.48061612907532725,0.5253225805836339,0.96875,1,0.96875,0.84375,0.96875,0.96875,0.05,0.364,0.554,0.022,1.774,132.44001691889684,2000.5237125478895,0.054,0.346,0.818,0.028,1.949,79.72749110653824,1906.0022637203504,0.036,0.367,0.488,0.023,1.503,150.6703844294805,2143.8430354665325,80.63636363636364,69.60714285714286,65.34782608695652,FALSE,380,1.125925925925926,0,1,0,0,3,FALSE
484,2022-03-19T02:31:20Z,0.8999999761581421,1.6,900,6,3,4,2,3,2,3,2,4,4,3,2,3,3,2,3,3,2,4,1,1,2,3,3,2,1,2,0,0,0,0,2,2,3,3,3,3,3,3,3,2,2,2,2,2,2,1,2,3,3,4,4,2,1,1,1,1,1,1,2,3,2,2,2,2,2,2,3,2,2,1,2,1.75,0,2.8666666666666667,0,2.7777777777777777,0,2.4166666666666665,0,1.1666666666666667,0,2,0,2.3333333333333335,0,2.2162162162162162,0,1,0,0,0.16440370845878854,0.30398733778055026,-0.14114775846592847,0.08141978965731089,2,2,3,2,1,2,2,2.5,0.20282981926961546,4,4,5,4,3,3,4,3.857142857142857,0,1.2043418043825058,0,0.9567573179148636,2,2,2,3,2,4,5,4,4,3,4,4,4,4,5,5,4,4,5,3,2.2,0,4,0,4.4,0,4,0,4.133333333333334,0,1,1,2,2,2,2,1,1,2,2,2,2,1,2,3,2,2,2,1,2,1.75,0,"White, Caucasian, Anglo, European American",0,24,0,1,NA,5,2,0,0,0,0,0,TRUE,TRUE,TRUE,TRUE,TRUE,6,0.46746874998882415,0.43170312499441205,0.43437187499739227,0.5356241379298012,0.487210714291249,0.5109620689688058,1,1,1,0.90625,0.875,0.9354838709677419,0.059,0.334,0.616,0.021,1.914,58.62954642231184,1903.851517678159,0.045,0.358,0.627,0.019,1.634,82.03127008415106,1981.376147574171,0.05,0.38,0.51,0.012,1.217,349.0858306167777,2213.639974606313,91.14285714285714,86,101.41666666666667,FALSE,436,1.2918518518518518,0,1,0,3,6,FALSE
486,2022-03-19T02:33:42Z,0.8999999761581421,1.7777777777777777,900,3,3,3,2,3,2,2,2,4,3,2,1,3,2,1,2,3,3,4,5,2,2,3,4,2,2,2,0,0,0,0,1,2,4,2,1,1,3,3,1,2,1,2,2,3,1,2,2,2,3,3,3,4,3,1,1,3,3,1,2,4,4,1,2,2,1,1,1,3,3,2,2,2.5,0,2.3333333333333335,0,2,0,2.1666666666666665,0,2.5,0,2.2857142857142856,0,1,0,2.108108108108108,0,1,0,0,0.6622622543331936,0.40595911871598694,0.11731095407663712,0.261635036396312,1,1,3,1,1,1,2,1.5,-0.5157127766089035,4,4,5,3,2,3,3,3.4285714285714284,0,0.1293403779201788,0,0.06977719429733369,1,3,3,2,2,4,5,4,5,4,5,5,3,5,5,5,5,5,5,2,2.2,0,4.8,0,4.4,0,4.2,0,4.466666666666667,0,2,1,1,3,3,2,1,2,1,2,1,1,1,1,1,1,1,2,1,2,1.5,0,"White, Caucasian, Anglo, European American",0,23,0,1,NA,5,2,0,0,1,0,0,TRUE,TRUE,TRUE,TRUE,TRUE,5,0.7391161290318254,0.5812718750000931,0.7595406250003726,0.8150031250000466,0.6824843750009313,0.8363312499999301,1,1,1,1,1,1,0.164,0.319,0.388,0.02,1.818,66.09910291567897,1849.2200098284795,0.138,0.293,0.532,0.014,1.75,46.61364472623006,1829.969036318029,0.085,0.505,0.418,0.009,1.02,75.26972178576924,1856.2459023255196,90.9,125,113.33333333333334,TRUE,316,0.9362962962962963,0,1,0,0,3,FALSE
487,2022-03-19T02:58:40Z,0.8999999761581421,1.7777777777777777,1080,6,3,2,2,1,2,1,2,1,1,3,1,1,1,2,1,1,1,1,1,1,3,2,2,1,1,2,0,0,0,0,1,2,1,1,1,1,1,1,1,1,1,1,1,1,2,1,1,1,1,1,1,1,1,1,1,3,1,1,2,1,1,1,1,3,1,3,1,2,1,1,1,1.25,0,1.4666666666666666,0,1.1111111111111112,0,1.0833333333333333,0,1.3333333333333333,0,1.4285714285714286,0,1.6666666666666667,0,1.2432432432432432,0,1,0,0,-0.954133112668729,-1.059504190137257,-0.31345356682763886,-0.6864788784824479,2,1,4,2,2,3,3,1,-0.1285727914961955,3,4,3,4,1,1,3,2.7142857142857144,0,-0.8792700537047221,0,-0.9315702209292682,2,3,3,3,3,4,4,3,4,2,5,4,4,4,3,4,4,4,4,3,2.8,0,4.2,0,3.6,0,3.4,0,3.7333333333333334,0,1,1,2,1,1,1,1,2,1,1,2,1,2,1,1,2,1,1,1,1,1.25,0,"White, Caucasian, Anglo, European American",0,24,0,1,NA,5,2,0,0,1,0,0,TRUE,TRUE,TRUE,TRUE,TRUE,2,0.5754875000044704,0.48609354838440494,0.5861064516229014,0.6368531250003725,0.5039193548425551,0.6282129032265755,1,1,0.96875,1,0.96875,0.96875,0.066,0.401,0.365,0.022,1.614,103.10933710755332,1974.464113147738,0.057,0.363,0.467,0.055,1.821,91.86437498455592,1918.0785469317211,0.211,0.252,0.661,0.018,1.504,19.989405557110743,1802.6600329615835,73.36363636363637,33.10909090909091,83.55555555555556,FALSE,272,0.8059259259259259,0,1,0,0,3,FALSE
488,2022-03-19T03:02:53Z,0.8999999761581421,1.7777777777777777,864,4,2,3,2,2,2,2,2,3,3,2,2,2,3,2,3,2,2,3,5,1,2,2,2,2,1,2,0,0,0,0,1,2,2,2,2,3,4,2,3,4,2,2,1,3,2,1,3,3,2,2,3,4,1,5,1,3,1,1,1,1,1,2,1,2,1,1,2,2,3,2,1,2,0,2.3333333333333335,0,2.3333333333333335,0,2.3333333333333335,0,2.5,0,1.2857142857142858,0,1.3333333333333333,0,2.081081081081081,0,1,0,0,0.15782408009921495,0.06670873855469797,-0.05499485428507328,0.005856942134812346,2,3,3,2,3,3,3,1,0.037296382515353055,5,5,5,3,1,1,3,3.2857142857142856,0,-0.8792700537047221,0,-0.62195951996656,2,2,2,3,2,4,4,4,4,4,4,4,4,4,4,3,4,4,4,3,2.2,0,4,0,3.8,0,3.8,0,3.8666666666666667,0,1,1,2,1,2,1,1,1,1,1,1,1,1,2,1,1,2,2,1,1,1.25,0,"Hispanic of Latino (e.g., Mexican American, Central American, and others)",0,21,0,1,NA,5,2,1,1,0,0,2,TRUE,TRUE,TRUE,TRUE,TRUE,3,0.5194249999996974,0.5409218750002328,0.5010499999998137,0.5491870967738571,0.5714906250002095,0.5754032258064516,1,1,1,1,1,0.96875,0.078,0.354,0.554,0.014,1.509,92.79525154007985,1918.3617962546532,0.102,0.311,0.443,0.055,1.945,81.45081727861519,1862.6954506364157,0.097,0.332,0.569,0.018,1.312,104.11769355819013,1885.7474792848768,107.78571428571428,35.36363636363637,72.8888888888889,FALSE,400,1.1851851851851851,0,1,0,0,3,FALSE
489,2022-03-19T03:12:03Z,NA,1.7777777777777777,864,1,3,2,2,3,2,3,3,2,2,2,2,2,1,3,1,3,2,2,1,1,2,1,1,1,0,1,1,0,1,0,2,2,2,2,2,1,1,1,1,1,1,1,1,2,2,2,2,1,1,1,3,1,1,1,1,3,2,1,1,1,1,1,1,2,1,1,1,1,1,1,2,1.25,0,2.2,0,1.5555555555555556,0,1.5,0,1.5,0,1.1428571428571428,0,1,0,1.4054054054054055,0,0,0,0,-0.9300078086836255,-0.7231054798381933,-0.5328163702636706,-0.6279609250509319,1,2,4,1,1,2,2,1.5,-0.2669090155915809,4,4,4,4,2,2,4,3.4285714285714284,0,0.003250347887277641,1,-0.007022920991855086,1,1,1,1,1,5,4,4,5,3,3,4,4,3,3,4,5,4,3,3,1,0,4.2,0,3.6,0,3.6,0,3.8,0,1,1,1,2,2,1,2,3,2,1,2,2,2,1,1,2,1,1,1,3,1.6,0,"White, Caucasian, Anglo, European American",0,23,0,1,NA,5,2,0,0,0,0,0,TRUE,TRUE,TRUE,TRUE,TRUE,5,0.5238645161255714,0.4113968750052154,0.4475093749929219,0.5600843749977649,0.5121451612922453,0.5331968749929219,1,1,1,1,0.96875,1,0.12,0.286,0.779,0.014,1.472,49.975644583936,1837.1341277211131,0.069,0.293,0.569,0.019,1.92,50.11238372452958,1877.044777637575,0.111,0.308,0.581,0.028,1.952,86.23285698476298,1868.0520310600073,105.14285714285714,101.05263157894737,69.71428571428571,FALSE,424,1.2562962962962962,0,1,0,0,3,FALSE
490,2022-03-19T03:11:12Z,0.8999999761581421,1.6,1050,4,4,3,2,2,2,1,1,2,3,1,1,2,3,2,3,5,2,4,1,1,1,3,2,1,4,2,0,0,0,0,2,2,3,1,2,1,1,1,1,1,1,1,1,3,1,4,3,1,1,3,3,3,1,1,1,3,1,1,3,1,1,2,1,2,1,1,1,2,1,2,1,1.5,0,2.2,0,1.5555555555555556,0,1.9166666666666667,0,1.6666666666666667,0,1.5714285714285714,0,1,0,1.6486486486486487,0,2,0,0,-0.44750172898155904,-0.398605116205656,-0.007937859210751935,-0.20327148770820397,1,1,2,1,1,1,1,1,-0.874984074548163,5,5,5,5,4,4,5,4.714285714285714,0,0.8670061021784026,0,1.2157057299771732,2,2,2,1,2,4,3,3,4,3,4,3,4,4,5,2,3,3,3,3,1.8,0,3.4,0,3,0,3.8,0,3.4,0,1,1,1,1,3,1,1,2,1,1,1,1,1,2,1,1,1,1,1,2,1.25,0,"White, Caucasian, Anglo, European American",0,30,0,1,NA,5,2,0,1,0,0,1,TRUE,TRUE,TRUE,TRUE,TRUE,2,0.49024999999441204,0.4772906250078231,0.4688531250022352,0.5565437499899417,0.5369343750011176,0.547678125004284,1,1,1,1,1,1,0.083,0.344,0.668,0.016,1.467,34.62654636618576,1816.853419602149,0.162,0.311,0.97,0.03,1.842,36.424316366379536,1819.4726315944345,0.143,0.298,0.743,0.019,1.566,38.91730409427286,1820.0570539799191,91.6875,61.400000000000006,82.42105263157896,FALSE,384,1.1377777777777778,0,1,0,0,3,FALSE
491,2022-03-19T03:19:16Z,0.8999999761581421,1.7786458333333333,768,6,3,3,2,2,2,2,3,4,3,3,2,3,2,3,4,3,3,5,2,2,3,4,4,4,1,1,1,0,0,0,3,2,2,2,2,2,2,2,2,2,3,3,4,3,4,2,3,5,4,5,3,4,1,2,1,3,2,3,2,2,2,3,2,2,2,2,3,1,1,2,2,1.5,0,2.7333333333333334,0,2.111111111111111,0,3.4166666666666665,0,2.1666666666666665,0,2.2857142857142856,0,2.3333333333333335,0,2.5945945945945947,0,1,0,0,1.1403819151288779,0.9021496747431939,-0.22730066264678367,0.33742450604820506,3,2,3,3,3,2,3,1.5,0.2306985064430642,4,4,4,3,4,4,4,3.857142857142857,0,0.1293403779201788,0,0.30198522001936523,3,2,3,3,2,4,3,4,3,4,2,4,4,3,4,4,2,3,4,2,2.6,0,3,0,3.8,0,3.2,0,3.3333333333333335,0,2,3,3,3,2,3,4,3,2,3,3,2,2,3,2,2,3,3,2,2,2.6,0,"Hispanic of Latino (e.g., Mexican American, Central American, and others)",0,27,0,1,NA,5,2,0,0,0,0,0,TRUE,TRUE,TRUE,TRUE,TRUE,1,0.5104300003051758,0.46184333318074544,0.5069968748688698,0.601074999888738,0.5276545456106012,0.5788520000457764,0.9375,0.967741935483871,1,0.75,0.6875,0.78125,0.053,0.367,0.433,0.013,1.809,71.2347875949128,1993.6490874974704,0.036,0.396,0.515,0.018,1.712,117.4953904539121,2086.137728005001,0.047,0.403,0.445,0.01,1.474,88.62481626053741,2106.7207773988157,139.15384615384616,95.11111111111111,147.4,FALSE,315,0.9333333333333332,0,1,0,0,3,FALSE
492,2022-03-19T03:39:24Z,0.8999999761581421,1.7777777777777777,1440,7,3,2,2,2,2,2,1,2,2,2,1,3,2,2,2,2,1,3,1,1,1,2,1,1,1,2,0,0,0,0,1,1,1,2,2,1,2,2,2,1,1,1,1,2,3,2,4,2,3,3,2,1,1,1,1,1,1,1,2,2,2,1,1,3,1,1,1,1,1,1,1,1,0,1.9333333333333333,0,1.5555555555555556,0,2.0833333333333335,0,1,0,1.7142857142857142,0,1,0,1.6216216216216217,0,1,0,0,-0.7896424036793878,-0.7451321711877957,-0.39960647100849406,-0.5723693210981449,2,2,3,1,2,2,1,2,-0.07350689166386981,5,5,5,5,1,2,5,4,0,0.2196552803757379,0,0.4343977554298661,3,3,3,4,3,4,3,5,4,2,4,4,3,3,3,2,4,4,3,4,3.2,0,4,0,2.6,0,3.8,0,3.466666666666667,0,2,3,2,3,4,1,4,4,1,1,4,3,2,3,1,3,1,1,1,3,2.35,0,"White, Caucasian, Anglo, European American",0,27,0,1,NA,5,2,0,0,1,0,0,TRUE,TRUE,TRUE,TRUE,TRUE,4,0.4160718749994412,0.41212499999953434,0.4163531250001397,0.5469173913057084,0.5065740740740741,0.5411208333335817,1,1,1,0.71875,0.84375,0.75,0.056,0.323,0.638,0.009,1.503,44.34616936501301,1936.2536950335568,0.059,0.316,0.638,0.017,1.908,87.17551456021269,1948.866334365978,0.057,0.325,0.647,0.009,1.639,28.96386627318549,1914.5556265953776,167,112.23529411764704,182.11111111111111,FALSE,308,0.9125925925925925,0,1,0,3,6,FALSE
493,2022-03-19T04:10:33Z,0.8999999761581421,1.6,900,4,3,4,2,4,3,4,4,5,4,2,3,4,4,4,4,4,3,5,1,1,3,3,4,4,2,1,1,0,0,0,3,2,1,4,5,4,4,4,4,1,2,2,1,4,1,3,2,3,4,5,5,1,1,1,1,5,5,1,5,1,1,2,3,2,1,1,3,2,2,2,1,1.75,0,3.6666666666666665,0,3.4444444444444446,0,2.75,0,2.3333333333333335,0,2.142857142857143,0,1.6666666666666667,0,2.6486486486486487,0,1,0,0,0.932027017075713,1.1695183076876998,-0.14114775846592847,0.5141852746108857,1,1,4,1,1,1,1,1,-0.7091149005366146,5,5,5,5,3,5,4,4.571428571428571,0,-0.5931788417242938,0,0.24891971486416042,4,3,5,5,5,2,5,3,3,3,2,2,1,4,4,5,2,2,5,2,4.4,0,2,0,3.8,0,3.2,0,3,0,4,4,4,3,4,4,3,2,4,4,4,3,4,4,4,3,4,4,4,4,3.7,0,"White, Caucasian, Anglo, European American",0,21,0,1,NA,5,2,0,0,1,0,0,TRUE,TRUE,TRUE,TRUE,TRUE,5,0.5226451612903221,0.47238709677418605,0.4795625,0.5937333333333352,0.5215333333333333,0.5646896551724098,1,0.96875,1,0.9375,0.967741935483871,0.90625,0.06,0.365,0.556,0.015,1.795,62.958043640262,1916.8285751351625,0.05,0.371,0.435,0.035,1.504,117.23771399670844,1986.5059395942792,0.057,0.415,0.514,0.028,1.972,24.85275973511045,1866.2447043937427,119.66666666666667,42.97142857142857,70.42857142857143,FALSE,330,0.9777777777777777,0,1,0,0,3,FALSE
494,2022-03-19T04:23:02Z,0.8999999761581421,3.5555555555555554,1440,4,3,2,2,2,3,5,2,2,3,4,2,4,3,1,3,5,2,3,1,1,2,2,3,3,0,2,0,0,0,0,2,3,4,4,4,1,3,2,1,3,1,2,2,3,3,1,2,2,3,5,5,2,1,1,3,2,1,1,1,1,1,1,3,5,1,1,2,1,2,2,2,1.75,0,2.8666666666666667,0,2.6666666666666665,0,2.6666666666666665,0,1.6666666666666667,0,1.8571428571428572,0,1.3333333333333333,0,2.2432432432432434,0,0,0,0,0.10080063431624411,0.2612122898471704,-0.3605105619019602,-0.0496491360273949,2,2,2,3,1,2,2,4.5,0.9764383149804601,4,5,5,5,3,3,4,4.142857142857143,0,0.14448688253392986,0,0.4660161476558744,3,4,2,3,3,4,5,4,5,4,4,5,3,4,4,4,5,4,4,5,3,0,4.4,0,4,0,4.4,0,4.266666666666667,0,3,4,4,4,4,4,4,4,4,3,4,3,4,4,3,4,3,4,4,4,3.75,0,"White, Caucasian, Anglo, European American",0,25,0,1,NA,5,2,0,0,1,0,0,TRUE,TRUE,TRUE,TRUE,TRUE,6,0.4905531250004424,0.41570937500090804,0.4730999999997439,0.5906354838710639,0.5003103448281,0.5910068965519554,1,1,1,0.96875,0.90625,0.90625,0.06,0.345,0.457,0.01,1.51,56.8334983162788,1912.6905464757483,0.053,0.32,0.504,0.024,1.891,151.98223666384993,2007.658507371532,0.066,0.346,0.459,0.016,1.675,43.26191232590843,1867.1296481436784,151,78.79166666666667,104.6875,FALSE,362,1.0725925925925925,0,1,0,0,3,FALSE
495,2022-03-19T04:29:36Z,0.8999999761581421,1.7777777777777777,864,6,2,3,2,1,3,1,1,2,2,3,1,1,1,1,3,3,1,3,2,1,1,1,1,2,2,2,0,0,0,0,2,5,3,1,2,3,5,5,1,1,1,1,1,2,1,2,2,3,1,1,2,2,4,4,1,3,1,1,2,1,1,2,1,2,1,1,1,2,2,3,1,2,0,1.8666666666666667,0,3,0,1.5,0,2.5,0,1.4285714285714286,0,1,0,1.972972972972973,0,1,0,0,-0.4803998707794273,-0.5662636374158003,-0.05499485428507328,-0.31062924585043683,3,3,4,4,1,1,1,2,0.2582314563592268,2,3,3,1,2,2,2,2.142857142857143,0,-0.6199644421145296,1,-1.083240592588669,3,3,4,1,3,3,4,2,4,2,4,3,2,4,3,3,3,4,3,2,2.8,0,3.4,0,2.8,0,3,0,3.066666666666667,0,1,1,1,2,4,1,2,3,2,1,1,2,1,1,1,1,1,1,2,2,1.55,0,"White, Caucasian, Anglo, European American",0,24,0,1,NA,5,2,0,1,2,0,1,TRUE,TRUE,TRUE,TRUE,TRUE,1,0.6062548387096707,0.48122812500000145,0.504606250000008,0.6562156249999862,0.5599724137930978,0.6383999999999923,1,1,1,1,1,0.9375,0.073,0.325,0.425,0.013,1.857,138.2787231294459,1986.5796500209565,0.157,0.201,0.566,0.022,1.703,28.642847071244873,1810.074847663436,0.167,0.236,0.453,0.025,1.728,28.731423616101004,1811.084562164932,142.84615384615384,77.40909090909092,69.11999999999999,FALSE,390,1.1555555555555557,0,1,0,0,3,FALSE
496,2022-03-19T05:11:00Z,0.8999999761581421,1.7777777777777777,720,4,3,2,2,2,2,2,1,1,1,1,1,1,2,1,2,2,2,3,4,1,1,1,1,1,0,2,0,0,0,0,2,1,1,1,1,1,1,1,2,1,1,1,1,1,2,1,2,1,3,2,2,3,1,1,2,2,1,1,1,1,1,2,2,1,1,1,1,2,2,2,2,2,0,1.5333333333333334,0,1.2222222222222223,0,1.5,0,1.6666666666666667,0,1.2857142857142858,0,1,0,1.3783783783783783,0,0,0,0,-0.704107235004931,-0.8622473024260843,-0.274357657721105,-0.5683024800735946,1,1,2,1,1,1,1,1.5,-0.6815819506204519,5,5,5,5,3,3,5,4.428571428571429,0,0.2196552803757379,0,0.6666057811518976,2,1,2,2,2,4,5,4,5,2,3,4,4,4,5,4,4,4,5,4,1.8,0,3.8,0,4,0,4.4,0,4.066666666666666,0,2,4,2,3,2,2,1,3,2,1,1,3,2,3,1,3,1,2,1,1,2,0,"White, Caucasian, Anglo, European American",0,21,0,1,NA,5,2,0,0,1,0,0,TRUE,TRUE,TRUE,TRUE,TRUE,3,0.4785281250178814,0.4246531249731779,0.4493968750089407,0.5632387096651139,0.495359375,0.5293096774008966,1,1,1,0.96875,1,0.96875,0.066,0.346,0.659,0.019,1.674,80.25314746999057,1909.226989586237,0.122,0.258,0.757,0.017,1.572,52.1988127572364,1835.1927648756157,0.063,0.36,0.578,0.022,2.055,132.88847185950573,1966.393037532135,88.10526315789474,92.47058823529412,93.40909090909092,FALSE,354,1.0488888888888888,0,1,0,0,3,FALSE
497,2022-03-19T05:06:16Z,0.800000011920929,1.7777777777777777,1080,4,4,1,1,3,2,4,1,4,3,1,1,1,2,4,2,2,2,3,1,1,1,2,2,1,3,2,0,0,0,0,1,2,2,1,1,1,1,1,1,2,1,3,4,2,4,1,1,4,3,3,1,2,1,5,1,3,1,1,3,1,1,1,1,1,1,1,1,2,2,2,2,2,0,2.1333333333333333,0,1.2222222222222223,0,2.4166666666666665,0,2.1666666666666665,0,1.2857142857142858,0,1,0,1.7567567567567568,0,2,0,0,-0.5396165260155897,-0.48966188490981644,0.16436794915095845,-0.162646967879429,1,1,2,1,1,1,1,2.5,-0.2947777027650296,5,5,5,5,5,5,5,5,0,1.1862928115775437,0,1.5649852675592943,2,3,3,3,3,4,5,4,4,1,5,4,4,5,5,1,4,4,1,1,2.8,0,4.2,0,2.4,0,3.8,0,3.466666666666667,0,1,2,1,1,1,1,4,4,1,1,4,3,4,3,2,3,1,2,1,4,2.2,0,"White, Caucasian, Anglo, European American",0,30,0,1,NA,5,2,0,0,1,0,0,TRUE,TRUE,TRUE,TRUE,TRUE,1,0.5183125,0.5058125,0.58828125,0.6379666666666667,0.595741935483871,0.61603125,1,1,1,0.9375,0.96875,1,0.217,0.299,0.734,0.049,1.489,88.99651984824575,1873.9572066425785,0.068,0.373,0.565,0.015,1.597,92.45212250558316,1918.4586329660401,0.076,0.347,0.474,0.012,1.735,29.19105644824809,1871.3140990226264,30.387755102040817,106.46666666666667,144.58333333333334,FALSE,320,0.9481481481481481,0,1,0,0,3,FALSE
498,2022-03-19T05:19:11Z,0.800000011920929,1.7777777777777777,1440,5,3,4,1,3,3,1,1,1,1,1,1,1,1,2,2,2,1,1,1,1,1,1,1,1,0,2,0,0,0,0,2,3,2,2,1,1,1,1,4,1,1,1,1,2,1,2,4,1,1,1,1,2,1,1,1,2,1,1,1,1,1,2,1,1,1,1,2,1,1,1,1,1,0,1.6666666666666667,0,1.8888888888888888,0,1.4166666666666667,0,1.3333333333333333,0,1.1428571428571428,0,1.3333333333333333,0,1.4594594594594594,0,0,0,0,-1.1383627067367903,-1.0960842311285612,-0.6189692744445258,-0.8575267527865436,5,5,5,4,5,5,4,2.5,1.7785869723793248,5,5,5,5,3,3,4,4.285714285714286,0,-0.23191923190205752,0,0.3141538050621014,2,1,1,2,2,5,4,5,5,5,3,5,5,5,5,5,5,3,4,3,1.6,0,4.2,0,4.6,0,4.6,0,4.466666666666667,0,1,1,1,4,1,1,1,3,1,1,1,2,1,1,1,2,1,1,1,1,1.35,0,"Hispanic of Latino (e.g., Mexican American, Central American, and others) & White, Caucasian, Anglo, European American",1,23,0,1,NA,5,2,0,0,1,0,0,TRUE,TRUE,TRUE,TRUE,TRUE,5,0.5602687500268221,0.4461312499977648,0.511225000012666,0.6456937500163913,0.5268656249791384,0.5955218750052154,1,1,1,1,1,1,0.122,0.294,0.531,0.009,1.06,107.92921614061628,1891.1325798163953,0.115,0.279,0.716,0.017,1.602,24.44366144194784,1806.1870169728356,0.239,0.169,0.602,0.013,1.357,36.09154204796755,1817.4373254212553,117.77777777777779,94.23529411764706,104.38461538461539,FALSE,388,1.1496296296296296,0,1,0,3,6,FALSE
499,2022-03-19T05:22:28Z,0.8999999761581421,1.7777777777777777,1080,4,3,4,2,1,2,1,1,1,1,1,1,1,1,2,1,4,1,1,1,1,1,1,1,1,4,2,0,0,0,0,1,1,3,1,1,1,1,1,1,1,2,1,1,3,1,2,1,1,2,2,1,1,1,1,1,3,1,1,3,3,1,2,2,2,1,1,1,1,1,2,2,1.5,0,1.6,0,1.2222222222222223,0,1.5,0,1.3333333333333333,0,2,0,1,0,1.4594594594594594,0,2,0,0,-1.1383627067367903,-1.1251909304119647,-0.007937859210751935,-0.5665643948113583,1,1,3,1,1,1,1,2.5,-0.21184311575925535,5,5,5,5,3,2,4,4.142857142857143,0,0.9905165020526746,0,0.9813239186204294,2,3,4,4,4,4,2,3,4,2,5,1,4,4,5,5,5,5,3,3,3.4,0,4,0,3.2,0,3.8,0,3.6666666666666665,0,1,2,2,2,1,3,2,3,3,2,2,2,3,3,2,3,1,2,3,3,2.25,0,"Black or African American & Hispanic of Latino (e.g., Mexican American, Central American, and others) & White, Caucasian, Anglo, European American",1,24,0,1,NA,5,2,0,0,1,0,0,TRUE,TRUE,TRUE,TRUE,TRUE,3,0.40434687498956917,0.4991343749910593,0.41893750001117586,0.4553799999952316,0.5233250000029802,0.480890625,1,1,1,1,1,1,0.117,0.246,0.673,0.021,1.553,94.00312518614696,1876.0092660833825,0.063,0.411,0.689,0.095,1.451,88.52717087974597,1868.2550489722844,0.086,0.3,0.87,0.021,1.533,63.58638692674493,1851.3688742707104,73.95238095238095,15.273684210526316,72.99999999999999,FALSE,478,1.4162962962962962,0,1,0,6,9,FALSE
500,2022-03-19T05:35:09Z,0.8999999761581421,1.7777777777777777,1440,6,4,1,1,2,2,1,2,3,1,1,1,1,2,1,2,3,1,1,1,1,1,3,1,1,0,2,0,0,0,0,1,4,1,2,3,2,4,1,4,1,1,2,1,3,2,1,3,2,2,1,2,1,1,1,1,3,2,1,1,1,1,2,2,1,1,1,1,1,1,1,1,1,0,1.6,0,2.4444444444444446,0,1.75,0,1.5,0,1.2857142857142858,0,1,0,1.7297297297297298,0,0,0,0,-0.8006084509453439,-0.8980406758691885,-0.6189692744445258,-0.7585049751568571,2,1,2,1,1,1,1,1,-0.7920494875423887,5,5,5,5,3,3,5,4.428571428571429,0,0.6863762972672843,0,0.9508806591561714,2,2,2,3,2,4,4,3,5,3,4,5,4,4,3,5,4,4,4,2,2.2,0,4.2,0,4,0,3.4,0,3.8666666666666667,0,2,1,2,2,3,2,2,3,1,1,3,3,3,3,1,3,1,3,3,2,2.2,0,"White, Caucasian, Anglo, European American",0,24,0,1,NA,5,2,0,0,1,0,0,TRUE,TRUE,TRUE,TRUE,TRUE,6,0.4393499999977648,0.3941687499973923,0.40724687500856815,0.5100531249977648,0.4516312499884516,0.4821656249966472,1,1,1,1,1,1,0.091,0.272,0.667,0.022,1.729,78.9737429522967,1860.1567250609144,0.109,0.269,0.878,0.026,1.673,53.38591576399895,1836.7610318789652,0.152,0.265,0.874,0.016,1.371,30.496682739263385,1813.3906820470495,78.5909090909091,64.34615384615385,85.6875,FALSE,366,1.0844444444444443,0,1,0,0,3,FALSE
501,2022-03-19T05:35:13Z,0.8999999761581421,1.7777777777777777,1080,3,3,4,2,3,3,2,3,3,4,3,3,3,3,4,3,3,5,4,4,3,3,3,4,2,5,1,2,0,2,0,2,3,1,3,3,3,3,2,3,1,1,3,3,1,1,1,2,2,2,2,2,3,2,1,1,2,1,1,5,5,5,1,2,2,1,1,1,3,4,4,5,4,0,3.066666666666667,0,2.5555555555555554,0,1.75,0,1.6666666666666667,0,3,0,1,0,2.108108108108108,0,3,0,0,0.9057085036374181,0.8898579943025677,1.0729539860338317,0.9814059901681997,3,3,4,3,3,3,2,2.5,0.7833719283100348,5,5,5,3,3,3,4,4,0,0.4183340780918181,0,0.5554109280505,3,2,4,3,4,2,3,3,4,2,4,3,4,3,2,4,4,4,2,3,3.2,0,3.4,0,3,0,3,0,3.1333333333333333,0,3,2,2,3,2,1,2,2,2,1,4,2,2,2,1,3,1,1,1,1,1.9,0,"Hispanic of Latino (e.g., Mexican American, Central American, and others)",0,18,0,1,NA,5,2,0,0,0,0,0,TRUE,TRUE,TRUE,TRUE,TRUE,5,0.5514062500004656,0.48095806451622514,0.5482374999999301,0.6257419354838709,0.5556064516130474,0.637363333333532,1,1,1,1,0.96875,0.967741935483871,0.078,0.33,0.363,0.029,1.838,148.16663944806078,1975.362897333808,0.07,0.326,0.486,0.02,1.815,23.9218705280808,1847.0338853003,0.169,0.211,0.513,0.021,1.956,75.15235300237846,1862.78883170006,63.37931034482759,90.75,93.14285714285714,FALSE,304,0.9007407407407407,1,1,0,6,9,FALSE
502,2022-03-19T05:14:34Z,0.8999999761581421,1.7777777777777777,864,4,4,5,2,2,3,2,2,3,2,1,2,3,2,1,3,2,1,2,1,1,2,2,3,1,0,2,0,0,0,0,1,2,2,4,3,3,2,1,2,3,3,4,2,2,2,1,1,1,2,2,2,1,1,1,1,1,1,1,1,1,1,1,1,1,1,1,1,2,3,2,2,2.25,0,2.3333333333333335,0,2.2222222222222223,0,2.0833333333333335,0,1,0,1,0,1,0,1.6486486486486487,0,0,0,0,-0.6097992285177086,-0.4495418399516116,-0.1882047535402498,-0.3188732967459307,1,1,3,2,2,1,2,4.5,0.8105691409689116,5,5,5,5,4,4,5,4.714285714285714,0,1.1379508095450799,0,1.3807353104866444,3,2,2,3,2,4,4,4,4,3,4,4,3,4,3,4,5,4,4,4,2.4,0,4.2,0,3.6,0,3.8,0,3.8666666666666667,0,2,3,2,2,1,4,2,3,3,1,4,3,1,3,2,3,1,3,4,2,2.45,0,"White, Caucasian, Anglo, European American",0,19,0,1,NA,5,2,0,0,2,0,0,TRUE,TRUE,TRUE,TRUE,TRUE,4,0.5766593750016764,0.6662625000001863,0.5103624999970198,0.6073374999985098,0.6669875000016764,0.6033387096783808,1,1,1,1,1,0.96875,0.076,0.388,0.651,0.014,1.635,64.64418200453817,1893.286279418724,0.119,0.27,0.309,0.078,1.695,146.20167663340337,1933.325149757776,0.144,0.323,0.583,0.046,1.821,84.77555689413306,1867.4301622623095,116.78571428571428,21.73076923076923,39.58695652173913,FALSE,374,1.108148148148148,0,1,1,6,9,FALSE
503,2022-03-19T05:51:11Z,0.8999999761581421,1.7777777777777777,1080,6,2,2,3,3,3,4,2,2,3,2,3,3,3,2,3,3,2,2,1,1,1,1,1,1,3,1,0,0,1,1,2,3,2,3,3,3,4,4,4,3,2,2,2,4,1,3,2,2,3,3,3,3,2,1,1,3,3,1,3,1,1,3,4,3,3,2,1,1,1,2,2,1.5,0,2.7333333333333334,0,3.111111111111111,0,2.5,0,2.1666666666666665,0,2.2857142857142856,0,2,0,2.5135135135135136,0,2,1,0,-0.291783857804983,-0.06102640458429197,0.6914271522397325,0.31520037382772026,3,2,5,1,1,3,2,1.5,0.06482933243151565,2,3,2,4,1,1,2,2.142857142857143,0,-0.2622122411295596,0,-0.8653374778583651,3,4,3,2,3,3,2,3,2,2,5,4,3,2,3,3,4,4,3,3,3,0,4,0,2.6,0,2.6,0,3.066666666666667,0,3,1,4,2,3,4,3,3,3,2,2,2,2,3,1,3,1,3,2,3,2.5,0,"Asian or Asian American (e.g., Chinese, Japanese, and others)",0,27,0,1,NA,5,2,0,1,0,0,1,TRUE,TRUE,TRUE,TRUE,TRUE,5,0.5769312499994412,0.47995806451694617,0.5387468749997206,0.5862718749998603,0.5794899999996026,0.6479999999997672,1,1,1,1,0.9375,1,0.078,0.4,0.548,0.018,1.762,98.80589464717922,1884.6345243881965,0.084,0.346,0.73,0.016,1.836,76.13860015862812,1923.390025442188,0.153,0.346,0.676,0.035,0.936,64.6246226877639,1849.7440870266691,97.8888888888889,114.75,26.74285714285714,FALSE,348,1.031111111111111,0,1,0,6,9,FALSE
504,2022-03-19T06:53:53Z,0.800000011920929,1.6,900,4,3,1,1,1,1,1,1,1,1,1,1,1,1,1,1,1,2,2,3,1,1,1,1,1,1,2,0,0,0,0,1,2,1,1,1,1,1,1,1,1,1,1,1,1,1,1,1,1,1,1,1,2,1,1,1,3,1,1,2,1,1,1,1,1,1,1,1,1,1,1,1,1,0,1,0,1.1111111111111112,0,1,0,1.5,0,1.1428571428571428,0,1,0,1.135135135135135,0,1,0,0,-1.0243158151708476,-1.3104511380130859,-0.39960647100849406,-0.85502880451079,1,1,2,1,1,1,1,1,-0.874984074548163,5,5,5,5,3,3,5,4.428571428571429,0,1.2043418043825058,0,1.2663680188775723,2,2,2,3,2,4,5,4,4,5,5,5,5,5,5,5,5,4,5,5,2.2,0,4.6,0,5,0,4.6,0,4.733333333333333,0,1,1,1,1,2,2,2,1,1,1,3,1,1,2,1,1,1,2,1,1,1.35,0,"White, Caucasian, Anglo, European American",0,25,0,1,NA,5,2,0,0,1,0,0,TRUE,TRUE,TRUE,TRUE,TRUE,5,0.5616093749997672,0.4920032258061392,0.5041718750002329,0.617038709677155,0.5460249999995577,0.5667741935486275,1,1,1,0.96875,1,0.96875,0.074,0.376,0.635,0.02,1.776,50.82281890747301,1873.2406840289248,0.147,0.32,0.856,0.046,2.049,57.91800313909065,1837.820776947096,0.072,0.374,0.394,0.024,2.052,48.66102493029684,1872.6484486253205,88.8,44.54347826086956,85.5,FALSE,388,1.1496296296296296,0,1,0,0,3,FALSE
505,2022-03-19T06:55:52Z,0.8999999761581421,1.6,1200,5,2,4,3,1,4,2,1,4,2,1,1,1,4,2,3,5,3,4,1,1,2,2,3,2,0,2,0,0,0,0,2,3,4,2,4,2,2,2,2,2,1,1,1,3,2,1,4,3,3,1,2,2,2,1,1,3,4,1,1,1,1,3,2,2,1,1,1,2,2,2,2,2,0,2.533333333333333,0,2.5555555555555554,0,2,0,2.1666666666666665,0,1.5714285714285714,0,1,0,2,0,0,0,0,0.024038303454551324,0.06405373557952233,-0.274357657721105,-0.10515196107079133,2,2,3,2,1,3,3,1.5,-0.01810525457425849,4,4,4,4,2,2,3,3.2857142857142856,0,-1.1834102584901123,0,-0.8072081299121721,1,3,3,4,3,3,3,4,3,1,2,4,4,3,2,3,4,4,4,4,2.8,0,3.4,0,3,0,3.2,0,3.2,0,2,1,1,1,1,1,1,2,2,1,1,2,1,1,1,3,1,1,1,1,1.3,0,"White, Caucasian, Anglo, European American",0,24,0,1,NA,5,2,0,0,0,0,0,TRUE,TRUE,TRUE,TRUE,TRUE,6,0.5034437499996275,0.5141562499981374,0.5336156249986962,0.5812999999979511,0.6647064516159796,0.6725999999991779,1,1,1,1,0.96875,0.9354838709677419,0.087,0.318,0.408,0.014,1.817,109.19387543395403,1959.9384391107656,0.072,0.336,0.365,0.02,1.995,62.88045885289012,1887.9161934149645,0.114,0.296,0.549,0.02,1.725,28.332073134629052,1809.7847563668065,129.78571428571428,99.75,86.25,FALSE,303,0.8977777777777777,0,1,0,9,12,FALSE
506,2022-03-19T07:31:38Z,0.8999999761581421,1.7777777777777777,1080,4,1,5,3,4,4,3,1,2,5,3,2,5,4,3,4,5,4,4,5,2,2,5,4,4,0,2,0,0,0,0,2,4,4,4,1,1,3,2,3,3,2,5,1,5,3,2,5,5,5,5,5,5,2,4,4,3,1,1,1,1,1,3,4,5,2,4,5,2,2,1,1,1.5,0,3.533333333333333,0,2.6666666666666665,0,3.8333333333333335,0,3.1666666666666665,0,2.2857142857142856,0,3.6666666666666665,0,3.135135135135135,0,0,0,0,1.7347416769436959,1.651155514073205,-0.4466634660828154,0.6022460239951948,1,1,4,1,1,1,1,2,-0.32231065268119236,4,4,4,5,1,2,1,3,0,-0.9515359633553193,0,-0.8207812783367516,5,5,4,4,4,2,4,2,2,2,3,2,3,3,3,1,3,4,2,4,4.4,0,2.8,0,2.4,0,2.8,0,2.6666666666666665,0,2,1,2,4,4,2,3,3,4,2,1,2,1,1,2,2,1,3,4,4,2.4,0,"White, Caucasian, Anglo, European American",0,28,0,1,NA,5,2,0,0,0,0,0,TRUE,TRUE,TRUE,TRUE,TRUE,5,0.5570874999947846,0.5656562499981374,0.5286749999988825,0.6131906250007451,0.699393750006333,0.7028935483867123,1,1,1,1,1,0.96875,0.099,0.324,0.46,0.011,1.876,56.50826265589593,1883.0882443689736,0.14,0.293,0.486,0.012,1.56,74.83154651871374,1858.7999753453817,0.215,0.248,0.708,0.012,1.112,37.566676224447505,1820.2328779279271,170.54545454545453,130,92.66666666666667,FALSE,304,0.9007407407407407,1,1,0,3,6,FALSE
507,2022-03-19T07:43:25Z,1,1.7777777777777777,864,3,3,2,2,3,3,3,2,2,3,3,2,3,2,2,2,2,1,1,2,1,2,1,1,2,1,2,0,0,0,0,1,2,2,1,1,1,1,1,2,1,2,1,1,2,2,1,3,2,1,1,2,2,1,1,1,2,2,1,2,2,1,2,3,3,1,3,1,2,1,1,2,1.5,0,2.4,0,1.3333333333333333,0,1.5833333333333333,0,1.5,0,2,0,1.6666666666666667,0,1.5945945945945945,0,1,0,0,-0.8071880793049175,-0.553185289426974,-0.22730066264678367,-0.39024297603687885,1,2,3,2,1,1,2,1.5,-0.3498436025973552,3,3,5,3,1,1,2,2.5714285714285716,0,-0.8792700537047221,0,-1.0089728961699453,3,4,4,2,3,3,4,4,3,2,3,3,5,4,2,4,3,4,3,3,3.2,0,3.2,0,3.6,0,3.2,0,3.3333333333333335,0,1,1,2,3,2,1,2,4,2,1,1,2,2,2,1,2,1,1,1,2,1.7,0,"Hispanic of Latino (e.g., Mexican American, Central American, and others) & White, Caucasian, Anglo, European American",1,27,0,1,NA,5,2,0,0,1,0,0,TRUE,TRUE,TRUE,TRUE,TRUE,1,0.49504687501862643,0.4622718750089407,0.5181838709731256,0.5997599999944369,0.5829366666674614,0.6093156250044703,1,1,1,0.9375,1,1,0.113,0.335,0.641,0.018,1.832,53.67986396749323,1839.468838916589,0.105,0.304,0.653,0.017,1.836,57.61889473560605,1839.434508798912,0.058,0.369,0.487,0.017,1.87,53.08533022935735,1899.126947770981,101.77777777777779,108,110,FALSE,368,1.0903703703703704,0,1,0,0,3,FALSE
508,2022-03-19T07:03:49Z,0.8999999761581421,1.5998125585754452,1067,4,3,2,1,2,1,2,1,1,2,2,1,2,2,1,2,1,2,2,1,1,1,2,2,1,1,2,0,0,0,0,1,1,2,1,1,1,1,1,1,1,1,2,1,2,1,1,2,1,2,1,1,1,1,1,1,1,1,1,2,2,1,1,1,2,1,1,1,2,1,1,1,1.25,0,1.5333333333333334,0,1.1111111111111112,0,1.3333333333333333,0,1,0,1.4285714285714286,0,1,0,1.2162162162162162,0,1,0,0,-0.9716787882942585,-1.0421975040768552,-0.31345356682763886,-0.677825535452247,1,1,2,1,1,1,1,1,-0.874984074548163,5,5,5,5,3,3,5,4.428571428571429,0,0.25285077779445086,0,0.6868248105880386,2,2,2,2,2,5,2,2,4,4,5,4,3,4,4,3,4,5,3,2,2,0,4.6,0,3,0,3.2,0,3.6,0,1,1,1,1,1,1,1,2,1,1,1,2,1,1,1,2,1,1,1,1,1.15,0,"White, Caucasian, Anglo, European American",0,30,0,1,NA,5,2,0,0,1,0,0,TRUE,TRUE,TRUE,TRUE,TRUE,4,0.44046875000093133,0.38463225806504486,0.4490031250009779,0.4999677419362049,0.4432375000007451,0.4754833333333333,1,0.96875,1,0.96875,1,0.967741935483871,0.051,0.35,0.572,0.039,1.741,93.58058794950126,1922.8075452061712,0.054,0.301,0.643,0.03,1.715,175.95523766516314,2008.893427931464,0.05,0.345,0.598,0.016,1.55,168.55181319553856,1989.713953897772,44.64102564102564,57.16666666666667,96.875,FALSE,422,1.2503703703703704,0,1,0,3,6,FALSE
509,2022-03-19T09:21:05Z,1,1.7777777777777777,864,7,2,3,2,3,2,2,3,4,3,2,3,4,3,3,3,1,2,4,1,1,2,3,3,2,0,2,0,0,0,0,1,1,1,1,1,1,1,1,3,2,2,3,1,2,2,1,5,5,3,4,4,3,1,1,1,4,3,1,1,1,1,3,5,3,1,1,1,2,2,1,1,1.5,0,2.7333333333333334,0,1.2222222222222223,0,2.8333333333333335,0,2.1666666666666665,0,2.142857142857143,0,1,0,2.054054054054054,0,0,0,0,0.05912965470561092,0.17497385987573516,-0.4466634660828154,-0.1358448031035401,1,1,2,1,1,2,1,1,-0.7920494875423887,5,5,5,5,3,3,4,4.285714285714286,0,1.2766077140331027,0,1.2329817515257324,1,1,1,1,1,4,5,3,5,5,5,4,5,3,4,1,5,4,2,3,1,0,4.4,0,3.6,0,3.6,0,3.8666666666666667,0,1,1,2,2,3,2,2,2,1,1,2,2,3,3,1,3,1,1,1,2,1.8,0,"White, Caucasian, Anglo, European American",0,27,0,1,NA,5,2,0,0,1,0,0,TRUE,TRUE,TRUE,TRUE,TRUE,2,0.5094812499918043,0.40185624999552966,0.4897677419262548,0.5406218749955296,0.4841533333381017,0.5466161290407181,1,1,1,1,0.9375,0.96875,0.066,0.376,0.619,0.02,1.552,74.19076121008813,1899.5571598602592,0.061,0.305,0.645,0.024,2.013,20.96139627180465,1863.351865832331,0.161,0.238,0.611,0.02,1.12,134.4850799197704,1926.054723954046,77.6,83.875,56.00000000000001,FALSE,386,1.1437037037037037,0,1,0,0,3,FALSE
510,2022-03-19T09:58:23Z,1,1.7777777777777777,1080,3,3,3,2,3,3,3,3,2,2,3,1,1,2,1,2,5,1,2,1,1,1,2,2,2,1,2,0,0,0,0,2,2,3,2,5,2,5,4,5,3,2,1,1,3,2,2,1,1,1,2,1,2,1,1,1,3,1,1,2,2,1,2,2,1,3,3,1,3,1,2,2,2,0,2.4,0,3.3333333333333335,0,1.6666666666666667,0,1.5,0,1.5714285714285714,0,2.3333333333333335,0,2.081081081081081,0,1,0,0,-0.4102171682773084,-0.2862099902565679,-0.05499485428507328,-0.1706024222708206,2,1,2,1,1,1,1,2.5,-0.21184311575925535,2,4,4,4,4,3,3,3.4285714285714284,0,1.2946567068380648,0,0.7795591523626557,4,2,3,3,4,2,4,5,5,4,5,4,4,5,5,2,3,4,4,2,3.2,0,3.6,0,3.6,0,4.4,0,3.8666666666666667,0,1,2,1,2,3,4,4,3,2,1,3,3,1,1,1,4,1,3,1,1,2.1,0,Filipino,0,19,0,1,NA,5,2,0,0,1,0,0,TRUE,TRUE,TRUE,TRUE,TRUE,6,0.4858000000100583,0.4248031250089407,0.5172562499959021,0.5712531250100583,0.5036562500018626,0.6029032258083743,1,1,1,1,1,0.96875,0.066,0.33,0.321,0.016,1.612,137.15313859899885,1962.8211211634264,0.088,0.276,0.61,0.015,1.488,30.29292650354297,1809.9013417423373,0.09,0.321,0.509,0.019,1.507,20.346235100598765,1802.9216378467183,100.75,99.2,79.3157894736842,FALSE,294,0.8711111111111112,0,1,0,0,3,FALSE
511,2022-03-19T10:57:13Z,1,1.7777777777777777,1080,3,1,2,1,2,2,1,3,2,2,1,1,1,1,2,2,1,1,3,1,1,1,2,2,3,0,2,0,0,0,0,1,2,3,1,1,1,4,2,1,1,2,5,1,2,2,1,3,5,5,5,2,1,5,1,1,3,3,1,1,1,1,2,2,2,1,1,1,2,2,1,1,1.5,0,1.6,0,1.7777777777777777,0,2.8333333333333335,0,2.3333333333333335,0,1.4285714285714286,0,1,0,2.081081081081081,0,0,0,0,-0.2479196687411588,-0.5263402593446456,-0.4466634660828154,-0.48650186271373047,1,2,3,1,1,1,1,2,-0.32231065268119236,5,5,5,5,2,3,5,4.285714285714286,0,0.1957313727576048,0,0.5746313046136784,2,3,3,1,2,4,4,3,4,3,5,1,4,3,3,5,4,4,4,4,2.2,0,3.6,0,4,0,3.4,0,3.6666666666666665,0,2,1,1,3,1,2,2,4,3,1,2,3,3,4,2,4,1,3,4,2,2.4,0,"White, Caucasian, Anglo, European American",0,28,0,1,NA,5,2,0,0,1,0,0,TRUE,TRUE,TRUE,TRUE,TRUE,5,0.49290625,0.46209375,0.50278125,0.582103448275862,0.5973846153846154,0.6607931034482759,1,1,1,0.90625,0.8125,0.90625,0.075,0.351,0.498,0.01,1.886,102.30913354400258,1960.688021762655,0.066,0.365,0.646,0.014,2.034,76.3712338144011,1937.2706967730323,0.061,0.376,0.601,0.013,1.772,108.22584957368588,1963.692067576409,188.6,145.28571428571428,136.30769230769232,FALSE,304,0.9007407407407407,1,1,0,6,9,FALSE
513,2022-03-19T11:51:27Z,0.5,1.7777777777777777,864,4,2,5,5,1,3,2,5,4,5,3,3,4,4,3,5,5,2,4,1,5,5,4,4,3,3,1,3,0,4,0,2,2,3,3,3,2,4,2,3,2,4,2,2,3,3,3,3,2,2,3,3,3,1,1,1,4,2,5,1,1,1,4,4,5,2,3,1,2,2,1,1,1.5,0,3.8,0,2.6666666666666665,0,2.6666666666666665,0,2,0,3,0,2,0,2.5675675675675675,0,2,0,0,1.203984989271423,1.4106319112110275,-0.007937859210751935,0.7013470260001378,1,1,5,1,1,1,1,4.5,0.7276345539631375,3,3,3,4,1,1,1,2.2857142857142856,0,-1.5837402805442329,0,-1.5928636757289039,2,2,4,3,4,5,3,5,5,2,5,1,5,5,5,5,4,4,3,1,3,0,3.8,0,3.6,0,4.2,0,3.8666666666666667,0,1,3,1,4,4,2,1,1,1,1,2,1,2,1,1,1,2,2,1,1,1.65,0,"White, Caucasian, Anglo, European American",0,30,0,1,NA,5,2,1,0,1,0,1,TRUE,TRUE,TRUE,TRUE,TRUE,4,0.6027249999903143,0.6216562499850988,0.6180156250111759,0.7090800000111261,0.6422100000063579,0.6724896551699474,1,1,1,0.9375,0.967741935483871,0.90625,0.076,0.324,0.26,0.016,1.959,90.42274726867016,1997.6227863900133,0.075,0.385,0.315,0.032,1.545,37.223890395682496,1861.3334656919865,0.084,0.403,0.427,0.016,2.06,192.41103035258712,2062.6219866320816,122.4375,48.28125,128.75,FALSE,434,1.285925925925926,0,1,0,0,3,FALSE
514,2022-03-19T13:06:09Z,0.800000011920929,1.7777777777777777,1080,6,3,4,3,2,3,3,3,2,3,3,3,2,3,2,3,3,3,4,1,1,3,3,3,2,2,2,0,0,0,0,1,4,4,4,5,4,4,4,4,2,3,2,3,3,3,2,5,4,4,5,5,4,4,1,1,3,1,1,2,2,1,4,3,2,2,3,3,3,2,2,1,2,0,2.8,0,3.7777777777777777,0,3.4166666666666665,0,2.3333333333333335,0,2.142857142857143,0,2.6666666666666665,0,3.027027027027027,0,1,0,0,0.8530714767608292,0.7380311574999499,-0.05499485428507328,0.34151815160743826,4,3,5,3,3,3,3,2,0.838773565399646,3,4,4,4,2,2,3,3.142857142857143,0,-0.9695849561602813,0,-0.7543720553770608,3,2,4,4,4,3,4,4,3,3,5,3,3,4,4,5,4,3,4,4,3.4,0,3.6,0,3.8,0,3.8,0,3.7333333333333334,0,1,1,1,1,1,1,1,1,1,1,1,1,1,1,1,1,1,1,1,1,1,0,"White, Caucasian, Anglo, European American",0,30,0,1,NA,5,2,0,0,1,0,0,TRUE,TRUE,TRUE,TRUE,TRUE,6,0.6385624999962747,0.5292774193498396,0.5676125000081956,0.6973874999973924,0.62003125,0.6912967741950866,1,1,1,1,1,0.96875,0.088,0.383,0.517,0.017,2.239,82.98118562622078,1911.0349864381824,0.12,0.349,0.703,0.011,1.406,79.8355975547421,1863.2214111544044,0.148,0.385,0.59,0.026,1.763,69.98034596698942,1851.5275553417512,131.70588235294116,127.81818181818181,67.8076923076923,FALSE,304,0.9007407407407407,1,1,0,3,6,FALSE
515,2022-03-19T13:34:26Z,0.8999999761581421,1.7777777777777777,1080,6,4,2,1,2,2,1,1,2,2,2,1,1,1,3,2,1,2,1,1,1,1,2,1,1,0,2,0,0,0,0,1,1,1,2,1,1,2,1,1,1,1,1,1,2,1,1,1,1,1,1,1,1,1,1,1,3,1,1,1,1,1,1,1,1,1,1,1,1,1,1,2,1.25,0,1.6,0,1.2222222222222223,0,1.0833333333333333,0,1.3333333333333333,0,1,0,1,0,1.135135135135135,0,0,0,0,-1.1866133147069973,-1.1576409667752183,-0.5328163702636706,-0.8452286685194444,1,1,2,1,1,1,1,1,-0.874984074548163,5,4,5,5,4,3,5,4.428571428571429,0,0.7766911997228434,0,1.005890519325995,2,1,3,1,1,4,4,4,5,5,4,5,5,2,4,5,5,5,4,2,1.6,0,4.6,0,4.6,0,3.4,0,4.2,0,1,3,1,4,1,2,1,1,1,1,2,1,1,2,2,1,1,2,1,2,1.55,0,"White, Caucasian, Anglo, European American",0,28,0,1,NA,5,2,0,0,1,0,0,TRUE,TRUE,TRUE,TRUE,TRUE,2,0.46018709677265535,0.3999935483932495,0.42157419355069436,0.5916071428358555,0.47192666666110356,0.5257599999904633,0.96875,1,0.96875,0.875,0.9375,0.9375,0.057,0.33,0.578,0.02,1.974,140.4162248729556,2023.2396494611055,0.067,0.308,0.773,0.02,1.81,111.93574760609737,1957.7636242010992,0.058,0.341,0.515,0.011,1.792,140.04260248409307,2044.7978835231536,98.7,90.5,162.90909090909093,FALSE,307,0.9096296296296296,0,0,0,0,3,FALSE
516,2022-03-19T13:18:52Z,0.8999999761581421,1.7777777777777777,1080,4,4,2,2,3,2,2,3,2,2,1,2,3,2,2,2,1,2,2,1,1,1,2,2,2,1,2,0,0,0,0,1,2,2,1,1,2,1,2,3,1,2,2,1,3,2,1,1,2,2,2,2,2,1,1,1,2,1,1,2,2,1,2,2,1,1,1,1,1,1,1,1,1,0,2.066666666666667,0,1.6666666666666667,0,1.75,0,1.3333333333333333,0,1.5714285714285714,0,1,0,1.5675675675675675,0,1,0,0,-0.6624362553942977,-0.6013686767542292,-0.39960647100849406,-0.5004875738813617,1,1,2,2,1,1,2,2,-0.32231065268119236,5,5,5,5,4,4,5,4.714285714285714,0,0.9905165020526746,0,1.290934619583138,3,3,3,3,3,3,3,3,3,3,2,3,2,3,3,3,4,4,3,2,3,0,3.2,0,2.8,0,2.8,0,2.933333333333333,0,1,2,1,2,2,1,1,3,1,2,2,2,3,2,2,2,1,2,2,2,1.8,0,"White, Caucasian, Anglo, European American",0,19,0,1,NA,5,2,0,0,1,0,0,TRUE,TRUE,TRUE,TRUE,TRUE,2,0.5694827586206896,0.584125,0.57,0.6169677419354839,0.6043793103448276,0.6252413793103448,0.90625,1,1,0.96875,0.9666666666666667,0.9666666666666667,0.058,0.433,0.433,0.022,1.558,58.712381164101345,1885.58866831941,0.059,0.421,0.394,0.028,1.739,106.23734816543184,1937.4950200134456,0.063,0.358,0.288,0.019,1.888,356.59180642357563,2284.8943047565062,70.81818181818183,62.10714285714286,99.36842105263158,FALSE,506,1.4992592592592593,0,1,0,3,6,FALSE
517,2022-03-19T13:54:08Z,1,1.7777777777777777,1080,4,1,1,1,1,1,1,1,1,1,3,1,1,1,1,1,5,3,1,1,3,1,2,2,1,7,1,1,0,1,0,1,5,5,5,5,5,5,5,5,2,1,1,1,2,1,5,1,1,1,5,1,1,1,2,1,4,5,3,5,5,5,1,1,1,1,1,1,3,1,5,5,3.5,0,1.4,0,4.555555555555555,0,1.8333333333333333,0,2.3333333333333335,0,3,0,1,0,2.72972972972973,0,4,0,0,0.17317654627155374,-0.33046003984282296,1.1200109811081531,0.39477547063266505,5,5,5,5,5,5,5,3.5,2.3312603942462955,3,2,5,3,1,1,1,2.2857142857142856,0,-0.788955151249163,0,-1.108768386481476,1,5,1,5,1,5,5,5,5,1,5,5,5,5,5,5,3,1,5,1,2.6,0,3.8,0,4.2,0,4.2,0,4.066666666666666,0,4,1,4,1,4,3,4,4,4,2,2,3,4,4,1,4,1,2,2,4,2.9,0,"Hispanic of Latino (e.g., Mexican American, Central American, and others) & Native American/Alaskan Native/indigenous",1,27,0,2,NA,5,2,0,0,0,0,0,TRUE,TRUE,TRUE,TRUE,TRUE,5,0.431625,0.40403125,0.4376451612903226,0.5053793103448276,0.4962857142857143,0.5155666666666667,1,1,1,0.90625,0.9032258064516129,0.9375,0.065,0.331,0.642,0.011,1.357,130.88010724936777,1997.4039498560555,0.067,0.314,0.808,0.016,1.801,21.64915168076714,1875.9175118761511,0.065,0.303,0.562,0.02,2.134,150.6888954516886,2008.28132139522,123.36363636363637,112.5625,106.69999999999999,FALSE,410,1.2148148148148148,0,1,1,0,3,FALSE
518,2022-03-19T14:31:22Z,0.8999999761581421,1.7777777777777777,1152,6,4,3,2,4,2,3,1,3,3,2,1,2,3,1,2,2,2,3,1,1,2,3,1,2,1,1,0,0,1,0,2,2,2,2,2,2,2,2,2,2,2,3,2,3,4,3,3,2,3,3,2,3,1,1,1,2,2,1,3,1,1,2,1,1,1,1,1,2,3,1,1,1.75,0,2.2666666666666666,0,2,0,2.6666666666666665,0,1.6666666666666667,0,1.4285714285714286,0,1,0,1.972972972972973,0,1,0,0,-0.2369536214752029,-0.22789825824623636,-0.14114775846592847,-0.18452300835608243,2,1,3,1,1,1,1,1.5,-0.5157127766089035,4,4,5,4,3,3,5,4,0,0.9182505924020775,0,0.8599048354909147,3,3,4,3,2,3,4,4,4,4,5,4,4,3,3,5,4,4,4,5,3,0,4,0,4.2,0,3.8,0,4,0,2,1,1,2,2,1,3,3,1,2,1,3,1,2,1,2,1,2,1,3,1.75,0,"Asian or Asian American (e.g., Chinese, Japanese, and others)",0,24,0,1,NA,5,2,0,0,1,0,0,TRUE,TRUE,TRUE,TRUE,TRUE,3,0.5162593750000014,0.47419062499999565,0.5468343749999949,0.5624884615384732,0.5226259259259225,0.6201781249999876,1,1,1,0.8666666666666667,0.8709677419354839,1,0.09,0.368,0.513,0.016,1.453,46.046864421756034,1827.3130045346193,0.052,0.363,0.513,0.023,2.012,252.2897107148929,2179.268584057716,0.056,0.37,0.411,0.015,1.606,108.71122089331048,2006.7197974167227,90.8125,87.47826086956522,107.06666666666668,FALSE,372,1.1022222222222222,0,1,0,0,3,FALSE
519,2022-03-19T14:31:27Z,0.8999999761581421,1.7777777777777777,864,7,3,1,1,1,1,1,1,1,1,1,1,1,1,1,1,1,1,1,1,1,1,1,1,1,0,2,0,0,0,0,1,1,3,1,1,1,1,1,1,1,1,1,1,1,1,1,1,1,1,2,2,1,1,1,1,2,1,1,1,1,1,1,1,1,1,1,1,1,1,1,1,1,0,1,0,1.2222222222222223,0,1.1666666666666667,0,1.1666666666666667,0,1,0,1,0,1.135135135135135,0,0,0,0,-1.3489108142431467,-1.5287513826386112,-0.6189692744445258,-1.0738603285415684,1,1,1,1,1,1,1,1,-0.9579186615539372,5,5,5,5,3,3,5,4.428571428571429,0,1.0237119994713875,0,1.1563482985379245,2,2,2,3,2,4,3,4,5,1,5,4,3,3,4,3,5,4,3,3,2.2,0,4.4,0,2.6,0,3.8,0,3.6,0,1,1,1,2,1,1,1,1,1,1,2,1,2,1,1,1,1,1,1,1,1.15,0,"White, Caucasian, Anglo, European American",0,28,0,1,NA,5,2,0,0,1,0,0,TRUE,TRUE,TRUE,TRUE,TRUE,4,0.4516906249932945,0.4144218750111759,0.447609375,0.5402566666722298,0.480658620694588,0.5267781249880791,1,1,1,0.9375,0.90625,1,0.071,0.328,0.597,0.013,1.282,71.30530267541258,1858.4801513029784,0.053,0.321,0.617,0.016,1.444,79.00330234682355,1935.031087398332,0.06,0.344,0.612,0.018,1.805,135.85340894127734,1986.0447155583815,98.61538461538463,90.25,100.27777777777779,FALSE,386,1.1437037037037037,0,1,0,0,3,FALSE
520,2022-03-19T14:40:57Z,1,1.7777777777777777,1080,6,2,4,2,2,2,3,4,4,5,3,4,5,3,2,4,3,3,5,5,1,3,5,4,5,5,2,0,0,0,0,1,1,1,1,1,2,3,1,3,2,2,5,4,4,4,4,5,5,5,5,5,5,1,1,3,1,1,1,3,3,2,3,3,2,1,2,3,1,1,1,1,1,0,3.3333333333333335,0,1.5555555555555556,0,4.166666666666667,0,2,0,2.4285714285714284,0,2,0,2.675675675675676,0,3,0,0,1.5176139410777658,1.4178102525883536,0.03911913586356937,0.7284646942259615,1,1,2,1,1,1,1,3.5,0.0920265450903926,5,5,5,5,5,5,4,4.857142857142857,0,1.1140269019269466,0,1.4435661844297796,4,4,5,5,5,1,2,5,1,1,1,2,2,4,4,2,3,1,2,2,4.6,0,1.6,0,1.8,0,3.2,0,2.2,0,1,1,4,3,3,4,2,3,3,4,3,3,1,4,1,4,1,4,2,3,2.7,0,"White, Caucasian, Anglo, European American",0,24,0,1,NA,5,2,0,0,1,0,0,TRUE,TRUE,TRUE,TRUE,TRUE,1,0.4638125,0.40596875,0.43409375,0.6246,0.508,0.5319285714285714,1,1,1,0.9375,0.90625,0.9032258064516129,0.056,0.334,0.538,0.012,1.464,40.588760980899806,1928.389807237611,0.064,0.315,0.769,0.014,1.642,98.93621669132474,1958.175650520545,0.065,0.336,0.489,0.011,1.839,116.05508148580051,1965.973700812487,122,117.28571428571428,167.1818181818182,FALSE,294,0.8711111111111112,0,1,0,3,6,FALSE
521,2022-03-19T14:52:06Z,0.8999999761581421,1.6,900,7,3,4,4,4,4,3,2,3,3,2,3,3,4,2,4,5,3,2,1,1,1,3,3,2,2,1,1,0,1,0,2,3,3,4,5,4,4,4,4,3,3,3,1,4,4,3,4,4,3,3,3,4,3,2,1,3,1,3,2,2,2,5,4,2,2,3,2,2,2,2,2,2,0,3.3333333333333335,0,3.6666666666666665,0,3.1666666666666665,0,2.3333333333333335,0,2.857142857142857,0,2.3333333333333335,0,3.027027027027027,0,1,0,0,0.52847647768853,0.752584507141652,-0.05499485428507328,0.3487948264282894,4,3,4,4,3,4,3,2,0.9217081524054204,3,3,3,3,1,1,2,2.2857142857142856,0,-0.698640248793604,0,-1.0537585263116522,4,5,4,4,4,2,4,3,2,3,3,3,3,3,2,4,3,4,4,3,4.2,0,3,0,3.6,0,2.6,0,3.066666666666667,0,3,2,3,4,2,3,3,3,2,1,2,3,3,3,3,4,2,3,4,3,2.8,0,"White, Caucasian, Anglo, European American",0,28,0,1,NA,5,2,0,0,1,0,0,TRUE,TRUE,TRUE,TRUE,TRUE,4,0.49186250000074505,0.4746870967745781,0.4925000000028841,0.5842806451599444,0.5589599999984105,0.5536766666650772,1,1,1,0.96875,0.9375,0.9375,0.06,0.375,0.562,0.02,1.73,52.90366089822744,1897.664112725901,0.059,0.391,0.722,0.019,1.766,17.617887177921496,1860.1935571963816,0.079,0.368,0.717,0.01,1.445,66.91543935051206,1891.415178277472,86.5,92.94736842105263,144.5,FALSE,416,1.2325925925925925,0,1,0,3,6,FALSE
522,2022-03-19T15:15:24Z,1,1.7777777777777777,1080,4,2,3,3,4,3,3,2,2,3,2,3,3,3,1,3,2,3,3,4,1,2,3,3,2,1,2,0,0,0,0,2,3,4,3,4,2,4,4,3,3,3,2,1,3,2,4,4,2,2,4,4,4,4,1,3,3,3,1,2,1,1,3,5,4,3,4,1,2,2,1,1,1.5,0,2.6666666666666665,0,3.2222222222222223,0,2.8333333333333335,0,3,0,2.4285714285714284,0,2.6666666666666665,0,2.864864864864865,0,1,0,0,0.8289461727757258,0.6635927407515164,-0.22730066264678367,0.21814603905236638,2,1,3,2,1,2,1,1.5,-0.3498436025973552,2,2,2,2,1,1,2,1.7142857142857142,0,-1.0086553683921653,0,-1.5521961862365288,2,3,2,2,2,4,4,5,5,3,5,4,3,4,2,5,4,4,4,4,2.2,0,4.2,0,3.8,0,4,0,4,0,1,1,3,4,2,3,3,4,2,1,3,3,2,2,2,3,1,3,2,3,2.4,0,"White, Caucasian, Anglo, European American",0,25,0,1,NA,5,2,0,0,0,0,0,TRUE,TRUE,TRUE,TRUE,TRUE,3,0.4286000000089407,0.4116312500089407,0.43966249999776486,0.5706071428656578,0.5293000000139763,0.5736142856989588,1,1,1,0.875,0.90625,0.875,0.068,0.317,0.556,0.011,1.641,25.54408802336867,1887.4580377004588,0.065,0.295,0.536,0.013,1.707,166.4727538505304,2055.4531394588025,0.069,0.298,0.556,0.009,1.646,77.10681823113445,1938.2194012275709,149.1818181818182,131.30769230769232,182.88888888888889,FALSE,328,0.9718518518518519,0,1,0,3,6,FALSE
523,2022-03-19T15:15:17Z,0.8999999761581421,1.7777777777777777,864,4,3,2,3,1,3,2,1,2,1,2,1,2,3,1,2,4,2,1,1,1,2,1,2,2,1,1,0,0,2,0,3,2,3,4,4,1,3,3,2,2,3,1,1,3,2,1,1,1,2,1,3,2,1,1,1,1,2,1,2,1,1,3,3,4,1,2,1,2,1,1,1,1.25,0,2,0,2.7777777777777777,0,1.75,0,1.3333333333333333,0,2.142857142857143,0,1.3333333333333333,0,1.972972972972973,0,1,0,0,-0.4803998707794273,-0.5080502388489936,-0.31345356682763886,-0.4107519028383162,1,1,4,1,1,3,2,2,-0.07350689166386981,3,4,5,4,2,2,3,3.2857142857142856,0,-0.6595698365617197,0,-0.4881424211742156,1,1,2,2,1,4,4,4,5,1,5,4,4,3,5,4,5,5,3,3,1.4,0,4.6,0,3.2,0,4,0,3.933333333333333,0,1,1,1,2,2,1,2,1,1,1,3,1,1,1,1,1,1,1,1,1,1.25,0,"White, Caucasian, Anglo, European American",0,22,0,1,NA,5,2,0,0,0,0,0,TRUE,TRUE,TRUE,TRUE,TRUE,4,0.6789322580649487,0.5497187500002328,0.5183656250000931,0.7533843750001397,0.6092499999988359,0.5826562500004656,1,1,1,1,1,1,0.144,0.308,0.723,0.012,1.23,96.39564161740508,1882.915726173448,0.081,0.361,0.429,0.024,1.546,73.52892940394963,1862.4668962705568,0.191,0.277,0.491,0.016,1.601,104.4371167149783,1889.9522470765512,102.5,64.41666666666667,100.0625,FALSE,384,1.1377777777777778,0,1,0,0,3,FALSE
524,2022-03-19T15:30:47Z,0.8999999761581421,1.7777777777777777,1152,4,2,2,2,2,3,2,1,3,1,2,1,1,2,1,2,3,3,2,2,1,3,3,1,1,0,1,1,0,0,0,2,2,2,3,4,3,3,3,4,2,4,3,1,2,1,2,1,2,1,1,2,3,1,1,1,3,2,1,1,1,1,3,4,2,1,1,1,2,2,1,2,1.75,0,1.8666666666666667,0,2.888888888888889,0,1.8333333333333333,0,1.8333333333333333,0,1.8571428571428572,0,1,0,2.027027027027027,0,0,0,0,-0.1207135204560685,-0.3243633663442723,-0.3605105619019602,-0.34243696412311625,2,1,3,1,1,2,3,1,-0.4603111395192921,5,5,5,5,4,4,4,4.571428571428571,0,0.43348058270556905,0,0.874247206168363,2,1,2,2,2,4,3,4,5,4,5,3,4,4,4,1,3,4,2,2,1.8,0,3.8,0,2.8,0,3.8,0,3.466666666666667,0,1,1,1,4,1,1,1,2,1,1,2,1,1,2,1,1,1,1,1,1,1.3,0,"White, Caucasian, Anglo, European American",0,26,0,1,NA,5,2,0,0,1,0,0,TRUE,TRUE,TRUE,TRUE,TRUE,1,0.44601290326733745,0.4263903225391142,0.4058580644976708,0.4999645161551814,0.505596874974668,0.5036064516190559,0.96875,1,0.96875,1,1,0.96875,0.062,0.302,0.538,0.013,1.431,166.17545047157594,2049.20907267152,0.069,0.342,0.843,0.018,1.658,113.25639194883752,1898.5653725422148,0.055,0.346,0.532,0.02,1.4,144.70028375943255,1973.9976210503369,110.07692307692308,92.11111111111111,70,FALSE,304,0.9007407407407407,1,1,0,3,6,FALSE
525,2022-03-19T15:43:01Z,0.8999999761581421,1.7777777777777777,1080,6,3,1,2,1,1,1,1,1,1,2,1,1,1,1,1,2,1,1,1,1,1,1,1,1,1,2,0,0,0,0,1,2,3,2,3,1,3,2,1,1,1,1,1,1,1,2,2,1,1,1,1,1,1,1,1,1,1,1,2,2,1,3,4,3,1,1,1,1,1,2,2,1.5,0,1.2,0,2,0,1.1666666666666667,0,1,0,2.2857142857142856,0,1,0,1.5405405405405406,0,1,0,0,-1.0857256798602015,-1.2644310864433808,-0.22730066264678367,-0.7458658745450822,1,1,3,1,1,2,2,1,-0.6261803135308405,5,5,5,5,4,4,4,4.571428571428571,0,-0.5360594366874477,0,0.28371054559784326,2,2,2,2,2,4,5,4,4,3,4,5,4,3,3,4,3,3,3,4,2,0,3.8,0,3.8,0,3.6,0,3.7333333333333334,0,1,1,1,2,1,1,1,2,1,1,1,2,1,1,1,2,1,1,2,1,1.25,0,"Hispanic of Latino (e.g., Mexican American, Central American, and others) & White, Caucasian, Anglo, European American",1,25,0,2,NA,5,2,0,0,1,0,0,TRUE,TRUE,TRUE,TRUE,TRUE,6,0.4484838709678621,0.4200687500000349,0.4503812499999185,0.5199666666667908,0.4942960000000894,0.5506230769230482,0.96875,1,1,0.84375,0.78125,0.8125,0.055,0.348,0.553,0.012,1.677,35.79861351611889,1940.1796547987567,0.049,0.341,0.656,0.018,1.775,91.64608077659548,1946.203632158463,0.052,0.333,0.46,0.011,1.505,115.26209031153626,2099.2125465204435,139.75,98.61111111111111,136.8181818181818,FALSE,311,0.9214814814814816,0,1,0,3,6,FALSE
527,2022-03-19T15:50:39Z,1,1.7777777777777777,1080,2,2,3,2,1,2,1,1,3,2,2,1,2,2,1,3,3,3,2,1,1,2,1,3,2,5,2,0,0,0,0,2,3,2,1,2,3,4,2,1,1,1,2,1,2,4,1,2,1,3,2,4,3,1,1,1,1,1,3,4,1,1,1,2,1,1,1,2,1,2,2,3,2,0,1.9333333333333333,0,2.2222222222222223,0,2,0,1.3333333333333333,0,1.8571428571428572,0,1.3333333333333333,0,1.864864864864865,0,3,0,0,-0.3071363239773215,-0.4206318075552585,0.3837307525869902,-0.018450527484134144,1,1,2,1,1,1,1,2,-0.48817982669274074,4,5,5,3,2,3,5,3.857142857142857,0,0.8670061021784026,0,0.75128967853311035,4,2,3,3,2,3,5,4,5,3,5,5,3,3,3,5,5,3,5,4,2.8,0,4.2,0,4.2,0,3.8,0,4.066666666666666,0,1,1,1,3,3,2,3,3,3,1,2,3,1,1,1,3,1,3,1,2,1.95,0,"Hispanic of Latino (e.g., Mexican American, Central American, and others) & White, Caucasian, Anglo, European American",1,22,0,1,NA,5,2,0,0,1,0,0,TRUE,TRUE,TRUE,TRUE,TRUE,2,0.5269032258064517,0.49315625,0.51109375,0.6089677419354839,0.5435483870967742,0.627,1,1,1,1,1,1,0.181,0.224,0.622,0.011,1.283,78.04370465620599,1863.9130652179863,0.101,0.358,0.775,0.029,1.797,76.09974503461211,1856.0180346258455,0.185,0.266,0.745,0.014,1.473,57.71095523471782,1839.9505772482364,116.63636363636364,61.9655172413793,105.21428571428572,FALSE,420,1.2444444444444445,0,1,0,0,3,FALSE
528,2022-03-19T16:01:32Z,0.8999999761581421,1.7777777777777777,1080,5,3,3,3,3,3,3,2,4,3,4,4,3,3,3,3,3,3,4,4,3,3,2,4,3,0,2,0,0,0,0,3,4,2,2,3,3,3,4,4,3,3,3,3,3,3,2,4,4,3,3,3,3,3,3,3,3,3,3,3,2,2,2,4,3,3,3,3,3,3,3,3,3,0,3.1333333333333333,0,3.111111111111111,0,3.0833333333333335,0,3,0,2.7142857142857144,0,3,0,3,0,0,0,0,1.3224182997437484,1.1992150076322532,0.0702539590023158,0.6347344833172845,3,3,2,4,2,3,5,1,0.28610014353267543,3,3,4,4,2,2,2,2.857142857142857,0,0.4002850852868561,0,-0.07480392615590334,3,3,3,3,3,3,3,4,4,4,2,3,3,3,2,4,3,3,3,3,3,0,2.8,0,3.4,0,3.2,0,3.1333333333333333,0,2,2,3,2,3,2,1,3,2,2,2,3,2,2,3,2,3,2,2,2,2.25,0,"White, Caucasian, Anglo, European American",0,21,0,1,NA,5,2,0,1,2,0,1,TRUE,TRUE,TRUE,TRUE,TRUE,4,0.7100031250044704,0.5177580645122836,0.7916218750067056,0.8316500000119209,0.5835068965574791,0.8465166666666667,1,1,1,0.967741935483871,0.9354838709677419,0.967741935483871,0.092,0.388,0.251,0.009,1.545,97.27821005177772,1923.5347013216424,0.06,0.411,0.612,0.015,1.504,30.701315263840304,1876.63236033922,0.098,0.404,0.332,0.014,2.004,46.584704904601374,1871.1595079382712,171.66666666666669,100.26666666666667,143.14285714285714,FALSE,304,0.9007407407407407,1,1,0,0,3,FALSE
529,2022-03-19T16:06:05Z,0.8999999761581421,1.7777777777777777,864,5,3,2,2,1,2,1,1,2,1,1,1,1,2,1,2,2,1,1,1,1,1,1,1,1,0,2,0,0,0,0,3,3,3,3,3,3,3,3,3,1,2,1,1,2,1,2,1,1,1,1,1,2,1,1,1,1,1,1,1,1,1,2,1,1,1,1,1,1,1,1,1,1,0,1.4666666666666666,0,3,0,1.25,0,1.1666666666666667,0,1.1428571428571428,0,1,0,1.6216216216216217,0,0,0,0,-1.0330886529836123,-1.1126042496407633,-0.6189692744445258,-0.8657867620426445,2,2,3,1,1,1,1,1,-0.6261803135308405,4,4,4,4,2,2,5,3.5714285714285716,0,-0.5360594366874477,0,-0.2581081810868965,1,1,1,1,1,5,4,5,5,4,5,4,5,4,4,5,4,5,4,5,1,0,4.6,0,4.4,0,4.6,0,4.533333333333333,0,1,1,1,2,1,1,1,1,1,1,1,1,1,1,1,1,1,1,1,1,1.05,0,"White, Caucasian, Anglo, European American",0,28,0,1,NA,5,2,0,0,1,0,0,TRUE,TRUE,TRUE,TRUE,TRUE,1,0.502322580647084,0.5005843750089407,0.5273218750040978,0.6021187499910593,0.5569714285752603,0.5870551724166706,0.96875,1,1,1,0.9032258064516129,0.9354838709677419,0.06,0.381,0.486,0.018,1.766,80.07327165022764,1929.2618429925544,0.051,0.36,0.367,0.019,1.361,173.42928727030173,2061.6650571794826,0.104,0.336,0.665,0.016,1.87,96.95705311725418,1919.9969115599672,98.11111111111111,71.63157894736842,116.875,FALSE,372,1.1022222222222222,0,1,0,0,3,FALSE
530,2022-03-19T16:15:20Z,0.8999999761581421,1.7777777777777777,1080,4,2,3,2,3,2,2,2,2,2,2,2,2,2,2,2,2,2,2,1,1,1,2,2,2,0,2,0,0,0,0,2,2,4,2,4,2,2,2,2,2,2,3,2,2,2,2,2,2,3,4,4,2,1,1,1,1,2,1,1,1,1,2,2,2,1,1,1,2,2,1,1,1.5,0,2.1333333333333333,0,2.4444444444444446,0,2.5,0,1.3333333333333333,0,1.4285714285714286,0,1,0,1.972972972972973,0,0,0,0,-0.3992511210113525,-0.3952617791258056,-0.4466634660828154,-0.4209626226043105,2,2,2,2,1,2,2,1.5,-0.2669090155915809,2,2,4,3,1,1,3,2.2857142857142856,0,0.005829978045906746,0,-0.6246730972340481,1,2,2,3,2,4,3,4,4,2,5,3,4,2,3,3,4,5,3,3,2,0,4.2,0,3,0,3.2,0,3.466666666666667,0,1,1,1,1,1,1,1,2,1,1,1,1,1,1,1,1,1,1,1,1,1.05,0,"Asian or Asian American (e.g., Chinese, Japanese, and others)",0,21,0,1,NA,5,2,0,0,2,0,0,TRUE,TRUE,TRUE,TRUE,TRUE,5,0.45939687502384186,0.40065937499329446,0.44202500000968575,0.5239516129147622,0.4741999999900018,0.5937900000135103,1,1,1,0.96875,0.96875,0.9375,0.06,0.344,0.545,0.009,1.464,206.15266174919867,2054.942610961813,0.064,0.304,0.683,0.011,1.287,37.9310679976479,1862.5200410207192,0.069,0.327,0.537,0.023,1.858,114.23537541327664,1940.9661155158376,162.66666666666669,117,80.78260869565219,FALSE,306,0.9066666666666667,0,1,0,6,9,FALSE
531,2022-03-19T16:18:56Z,0.8999999761581421,1.7777777777777777,864,7,3,1,1,1,1,1,1,1,1,1,1,2,2,1,1,2,1,1,2,1,1,1,1,1,1,2,0,0,0,0,1,1,1,1,2,4,4,1,2,1,1,1,1,2,1,1,5,5,3,3,3,1,5,1,3,4,1,1,2,1,1,1,1,1,1,1,1,1,1,1,1,1,0,1.2,0,1.8888888888888888,0,2.25,0,2.5,0,1.1428571428571428,0,1,0,1.8918918918918919,0,1,0,0,-0.7764831469602406,-1.056455853387982,-0.39960647100849406,-0.728031162198238,1,2,1,1,1,1,1,1,-0.874984074548163,5,5,5,5,4,4,5,4.714285714285714,0,0.29192119002633504,0,0.8654275395220894,3,2,3,1,1,5,5,5,5,5,5,5,5,4,5,5,5,5,3,3,2,0,5,0,4.6,0,4.4,0,4.666666666666667,0,2,1,1,1,1,2,1,1,1,1,1,2,2,3,1,2,1,2,1,1,1.4,0,"White, Caucasian, Anglo, European American",0,30,0,1,NA,5,2,0,0,1,0,0,TRUE,TRUE,TRUE,TRUE,TRUE,3,0.48652187500707805,0.4307967741931638,0.4975562500022352,0.5972099999984105,0.4895483870986969,0.6297387096804957,1,1,1,0.9375,0.96875,0.96875,0.082,0.341,0.526,0.019,2.41,83.44588859164773,1910.617539403955,0.061,0.319,0.59,0.02,1.692,47.121036567828334,1876.6933941389027,0.079,0.311,0.472,0.015,2.013,84.70495157171149,1935.7626787247425,126.8421052631579,84.6,134.2,FALSE,460,1.3629629629629632,0,1,1,6,9,FALSE
532,2022-03-19T16:19:42Z,0.800000011920929,1.5,960,6,3,3,2,4,3,3,1,3,3,2,1,2,2,3,2,1,4,3,3,3,2,3,4,5,1,1,2,1,0,0,2,3,2,3,4,3,2,3,4,3,2,4,3,3,4,3,3,3,4,4,3,3,2,3,2,2,3,3,4,4,3,1,4,3,3,2,1,2,1,2,3,2,0,2.3333333333333335,0,2.888888888888889,0,3.25,0,2.5,0,3.142857142857143,0,2,0,2.918918918918919,0,1,0,1,1.3509300226352343,0.8691096377187905,0.8511386348440838,0.8601241362814371,3,2,2,3,4,4,3,1.5,0.39656768045461255,3,4,4,3,2,3,2,3,0,-0.20799532428392437,0,-0.3678984708064509,3,4,4,3,3,3,2,4,3,3,2,3,4,3,3,2,3,4,3,2,3.4,0,3,0,2.8,0,3,0,2.933333333333333,0,2,3,3,3,2,3,3,2,2,2,3,2,2,3,3,3,2,1,1,1,2.3,0,"Asian or Asian American (e.g., Chinese, Japanese, and others)",0,28,0,1,NA,5,2,0,0,4,0,0,TRUE,TRUE,TRUE,TRUE,TRUE,2,0.8895625,0.8384193548387097,0.92596875,0.9649354838709677,0.8919375,0.9641935483870968,1,1,1,1,1,1,0.497,0.398,0.944,0.025,1.171,60.93161710029496,1844.4091539494984,0.225,0.534,0.741,0.028,1.734,25.279953805041636,1806.7678583018255,0.394,0.424,0.853,0.017,1.56,58.95973848129887,1840.6020525716076,46.839999999999996,61.92857142857142,91.76470588235294,TRUE,304,0.9007407407407407,1,1,0,0,3,FALSE
533,2022-03-19T16:23:39Z,0.8999999761581421,1.7786458333333333,768,4,3,3,2,5,3,4,2,5,2,3,2,1,3,1,3,2,2,4,2,1,1,1,1,1,1,2,0,0,0,0,1,2,3,1,1,1,1,2,1,3,1,3,2,3,4,3,5,5,5,2,5,3,2,1,1,5,4,3,1,1,1,2,2,3,1,1,1,2,1,1,1,1.25,0,2.7333333333333334,0,1.4444444444444444,0,3.4166666666666665,0,2.6666666666666665,0,1.8571428571428572,0,1,0,2.324324324324324,0,1,0,0,-0.1711573378794666,0.020098686323842062,-0.31345356682763886,-0.1466774402518984,2,1,3,1,1,2,1,1.5,-0.4327781896031293,5,4,5,5,4,4,3,4.285714285714286,0,0.5389419897748792,0,0.7836772930119874,3,2,3,2,3,4,5,5,5,2,5,4,4,5,3,2,5,4,1,2,2.6,0,4.4,0,2.8,0,4,0,3.7333333333333334,0,2,1,1,2,3,2,3,2,2,1,4,2,1,2,1,2,1,2,1,2,1.85,0,"White, Caucasian, Anglo, European American",0,27,0,1,NA,5,2,0,0,1,0,0,TRUE,TRUE,TRUE,TRUE,TRUE,5,0.6073548387096774,0.5807562500536442,0.6599718750268221,0.6282374999970197,0.599183870976971,0.7089999999671147,0.96875,1,1,1,1,0.90625,0.063,0.459,0.265,0.034,1.379,92.6315313423686,1978.7692566026512,0.155,0.354,0.661,0.365,1.869,75.13918070827468,1861.0333037465705,0.173,0.305,0.572,0.075,1.374,162.41546440888348,1986.581361475243,40.55882352941176,5.120547945205479,18.320000000000004,FALSE,232,0.6874074074074075,0,1,0,0,3,FALSE
534,2022-03-19T16:49:02Z,0.8999999761581421,1.778125,960,7,2,2,1,2,1,2,2,2,2,2,1,3,2,3,2,2,2,3,4,2,1,2,2,2,1,2,0,0,0,0,1,2,1,1,1,1,2,1,1,1,1,2,1,2,1,2,1,2,1,1,2,3,1,1,2,3,1,1,3,2,1,1,2,2,1,1,1,1,2,2,2,1.75,0,1.9333333333333333,0,1.2222222222222223,0,1.4166666666666667,0,1.8333333333333333,0,1.7142857142857142,0,1,0,1.4594594594594594,0,1,0,0,-0.32687520905604234,-0.43390682243113493,-0.14114775846592847,-0.2875272904485317,1,2,3,2,1,2,2,2,-0.07350689166386981,5,5,5,5,3,3,5,4.428571428571429,0,1.0417609922763496,0,1.1673417508189108,2,3,3,2,2,4,4,4,5,3,4,4,5,4,4,5,5,4,4,4,2.4,0,4.2,0,4.2,0,4.2,0,4.2,0,1,3,4,4,4,4,3,4,3,3,2,3,2,4,2,3,3,4,3,3,3.1,0,"White, Caucasian, Anglo, European American",0,29,0,1,NA,5,2,0,0,1,0,0,TRUE,TRUE,TRUE,TRUE,TRUE,3,0.5020874999910593,0.4592874999977648,0.4796218750067055,0.587190000017484,0.5172193548371715,0.5440937499962747,1,1,1,0.967741935483871,0.96875,1,0.126,0.301,0.771,0.018,1.626,77.87070636564268,1861.2638045082265,0.063,0.354,0.623,0.028,1.91,49.83674026017546,1873.7075640919168,0.071,0.39,0.683,0.021,1.934,70.08097178711557,1894.969576239209,90.33333333333333,68.21428571428571,92.09523809523809,FALSE,426,1.2622222222222224,0,1,0,0,3,FALSE
535,2022-03-19T16:56:22Z,0.8999999761581421,1.7777777777777777,1080,4,2,4,4,3,4,3,3,4,3,3,3,3,4,2,4,4,5,4,3,2,5,5,4,4,5,2,0,0,0,0,3,4,4,4,4,3,4,4,4,3,4,4,3,4,3,4,4,4,4,5,5,4,4,1,3,5,1,3,4,3,1,3,3,3,3,2,3,3,2,3,2,2.5,0,3.4,0,3.7777777777777777,0,3.9166666666666665,0,3,0,2.857142857142857,0,2.6666666666666665,0,3.4324324324324325,0,3,0,0,2.0900416083606723,1.831892383272176,0.5560365609487006,1.1939644721104383,3,2,5,2,1,2,2,3.5,0.8384378281423601,3,3,3,2,1,1,2,2.142857142857143,0,-1.0598998586158404,0,-1.3512006422316245,2,2,2,2,2,4,4,4,4,3,3,4,4,4,4,4,4,4,4,4,2,0,3.8,0,3.8,0,4,0,3.8666666666666667,0,1,3,4,4,4,4,4,4,4,3,3,4,3,3,2,4,1,4,2,4,3.25,0,"White, Caucasian, Anglo, European American",0,24,0,1,NA,5,2,0,0,1,0,0,TRUE,TRUE,TRUE,TRUE,TRUE,1,0.5555781250074506,0.49754516127032616,0.5704093749783933,0.6139935484086313,0.49705937498807906,0.6471032257810716,1,1,1,1,1,1,0.162,0.218,0.448,0.028,2.005,106.41290864544314,1892.2003473216691,0.131,0.312,0.713,0.164,1.19,39.32920113889041,1819.1927965045184,0.084,0.374,0.476,0.027,1.626,92.5390743690736,1880.102731744925,71.60714285714285,7.2560975609756095,60.22222222222222,FALSE,281,0.8325925925925926,0,1,0,0,3,FALSE
536,2022-03-19T17:07:43Z,0.8999999761581421,1.7777777777777777,720,3,3,4,3,3,3,4,3,3,4,2,3,2,4,2,4,4,4,4,1,1,4,4,4,3,20,2,0,0,0,0,2,2,4,2,3,1,2,1,2,2,1,1,1,3,2,1,5,3,2,3,3,3,1,1,1,3,1,1,5,5,5,3,3,2,1,4,1,3,2,3,3,2.75,0,3.2,0,2.111111111111111,0,2.25,0,1.6666666666666667,0,3.4285714285714284,0,2,0,2.324324324324324,0,6,0,0,0.8026276593374314,0.8787463151842415,1.300277875437651,1.0895120953109463,3,3,4,2,2,3,3,3,0.8938394652319717,3,3,3,2,1,1,2,2.142857142857143,0,-0.6083253463380449,0,-1.0761513413825055,2,2,2,2,2,4,5,4,4,5,4,4,5,5,5,4,4,3,5,3,2,0,3.8,0,4.8,0,4.2,0,4.266666666666667,0,1,1,1,1,1,2,2,1,1,2,3,3,1,1,2,3,1,3,2,2,1.7,0,"White, Caucasian, Anglo, European American",0,27,0,1,NA,5,2,0,0,1,0,0,TRUE,TRUE,TRUE,TRUE,TRUE,6,0.5951250000000146,0.4881968749999796,0.5482343750000291,0.6487399999999751,0.587106249999968,0.7064966666667412,1,1,1,0.9375,1,0.967741935483871,0.097,0.342,0.51,0.005,1.283,113.83531453360062,1941.8168887097163,0.092,0.266,0.397,0.026,2.116,52.731285047587335,1835.2547728784057,0.079,0.323,0.297,0.017,2.071,133.35489851803368,1981.630421394941,256.59999999999997,81.38461538461539,121.82352941176471,FALSE,212,0.6281481481481481,0,1,0,0,3,FALSE
537,2022-03-19T18:17:09Z,1,1.7777777777777777,1080,4,2,2,1,1,2,1,1,1,1,1,1,1,2,2,3,2,3,2,1,1,1,1,1,1,0,2,0,0,0,0,1,2,1,1,2,1,1,2,2,1,2,1,1,2,2,2,1,1,1,1,4,1,1,1,1,3,3,1,1,1,1,2,1,3,1,1,1,3,2,1,1,1.75,0,1.4666666666666666,0,1.4444444444444444,0,1.5833333333333333,0,1.6666666666666667,0,1.4285714285714286,0,1,0,1.4864864864864864,0,0,0,0,-0.8773707818070364,-1.007879132286626,-0.3605105619019602,-0.6841948470942931,1,1,2,1,1,1,1,1.5,-0.6815819506204519,5,5,5,4,1,1,4,3.5714285714285716,0,-0.33738063897136766,0,-0.1370950084662627,3,2,2,3,2,3,3,4,5,2,1,4,4,3,5,5,4,5,4,5,2.4,0,3.4,0,3.6,0,4.4,0,3.8,0,2,1,1,2,2,2,4,4,1,1,1,3,1,1,1,3,1,2,3,1,1.85,0,"Asian or Asian American (e.g., Chinese, Japanese, and others)",0,19,0,1,NA,5,2,0,0,1,0,0,TRUE,TRUE,TRUE,TRUE,TRUE,3,0.43884375,0.4131290322580645,0.43240625,0.5497333333333333,0.47103125,0.49789655172413794,1,0.96875,1,0.9375,1,0.9354838709677419,0.06,0.325,0.617,0.022,1.909,138.59177454261834,1991.5407696619225,0.053,0.319,0.534,0.029,1.84,137.75343186906272,1961.2067389296935,0.072,0.322,0.624,0.016,1.907,89.19182196911254,1935.9071442039556,86.77272727272728,63.44827586206897,119.1875,FALSE,272,0.8059259259259259,0,1,0,0,3,FALSE
538,2022-03-19T18:12:03Z,1,1.7777777777777777,864,7,2,2,2,2,1,2,1,2,1,2,1,1,2,1,2,3,2,2,1,1,1,1,1,1,0,1,0,0,1,0,1,5,4,3,5,3,4,3,4,1,3,4,2,3,1,3,2,2,1,1,1,3,1,5,1,4,2,2,1,1,1,3,4,2,1,1,1,1,1,1,1,1,0,1.6666666666666667,0,3.5555555555555554,0,2,0,2.6666666666666665,0,2,0,1,0,2.4054054054054053,0,0,0,0,-0.3619665603071019,-0.5739336460107513,-0.6189692744445258,-0.5964514602276385,1,1,4,2,1,1,1,2,-0.23937606567541822,5,5,4,4,1,1,4,3.4285714285714284,0,-0.39450004400821376,0,-0.2492885144406229,2,2,3,2,3,3,3,3,4,4,2,2,5,4,2,2,2,3,3,1,2.4,0,2.4,0,3.4,0,2.8,0,2.8666666666666667,0,1,2,3,2,2,3,2,3,1,1,4,2,1,2,1,3,1,2,1,2,1.95,0,"White, Caucasian, Anglo, European American",0,29,0,1,NA,5,2,0,0,0,0,0,TRUE,TRUE,TRUE,TRUE,TRUE,1,0.5475,0.478375,0.5166875,0.6165333333333334,0.50375,0.5646,1,1,1,0.967741935483871,1,0.967741935483871,0.064,0.378,0.49,0.031,2.01,32.292929045512246,1859.0655945617405,0.07,0.334,0.535,0.04,1.925,141.51735184229008,1924.1978935609104,0.068,0.41,0.491,0.025,1.855,110.8522304284584,1940.82215890001,64.83870967741935,48.125,74.19999999999999,FALSE,390,1.1555555555555557,0,1,0,0,3,FALSE
539,2022-03-19T18:22:00Z,1,1.7786458333333333,768,2,1,4,2,3,3,5,1,4,1,3,1,1,2,2,3,5,2,1,1,1,1,1,1,1,0,2,0,0,0,0,2,5,4,3,5,2,4,4,3,1,3,1,1,4,3,4,4,3,2,2,3,3,1,1,1,4,1,1,1,1,1,2,1,1,1,1,1,1,1,1,1,1,0,2.6666666666666665,0,3.5555555555555554,0,2.5833333333333335,0,1.8333333333333333,0,1.1428571428571428,0,1,0,2.2972972972972974,0,0,0,0,-0.5132980125772953,-0.2391082708080874,-0.6189692744445258,-0.4290387726263066,1,1,4,1,1,1,1,1,-0.7091149005366146,4,4,4,3,2,2,4,3.2857142857142856,0,-0.8792700537047221,0,-0.62195951996656,2,1,1,1,1,5,3,2,5,1,5,4,5,3,4,5,4,5,2,3,1.2,0,4.6,0,3.2,0,3.4,0,3.7333333333333334,0,1,2,1,2,2,2,1,2,2,2,2,2,2,1,1,2,1,2,1,1,1.6,0,"White, Caucasian, Anglo, European American",0,23,0,1,NA,5,2,0,0,1,0,0,TRUE,TRUE,TRUE,TRUE,TRUE,6,0.566203125,0.6702843750026077,0.6046062500011176,0.6333064516071351,0.7598645161255714,0.7103419354769491,1,1,1,1,0.96875,1,0.072,0.428,0.437,0.019,1.88,103.82253847223576,1888.0215389841355,0.087,0.343,0.222,0.163,1.561,229.53243168430015,2053.5059651807055,0.172,0.255,0.581,0.016,1.6,72.34140685278759,1860.4363092273531,98.94736842105263,9.576687116564417,100,FALSE,344,1.0192592592592593,0,1,0,0,3,FALSE
540,2022-03-19T18:48:48Z,0.8999999761581421,1.6,900,4,2,3,3,4,2,3,3,4,4,3,3,3,3,2,3,2,2,2,1,1,2,2,3,3,0,2,0,0,0,0,2,4,1,3,4,2,4,3,3,2,1,2,1,3,2,1,2,2,2,1,3,1,1,1,1,3,1,2,1,1,1,3,2,3,1,1,1,2,2,2,1,1.75,0,3,0,2.888888888888889,0,1.8333333333333333,0,1.3333333333333333,0,1.8571428571428572,0,1,0,1.945945945945946,0,0,0,0,-0.1733505473326576,0.13505048180458043,-0.3605105619019602,-0.11273004004868988,1,2,3,2,1,2,2,3.5,0.5066994801192636,4,4,5,3,3,2,4,3.5714285714285716,0,0.1957313727576048,0,0.18761792841029293,3,2,2,3,3,3,4,3,4,2,4,3,1,3,3,4,3,4,3,2,2.6,0,3.4,0,2.8,0,3,0,3.066666666666667,0,1,2,2,2,2,2,3,3,3,2,2,4,3,3,2,4,1,3,2,3,2.45,0,"White, Caucasian, Anglo, European American",0,27,0,1,NA,5,2,0,0,1,0,0,TRUE,TRUE,TRUE,TRUE,TRUE,1,0.8797225806463149,0.4768468749970198,0.5865093749985099,0.8305870967718862,0.5515620689659283,0.6936838709731256,1,1,1,0.96875,0.9354838709677419,1,0.136,0.362,0.605,0.013,1.543,62.08982199075193,1845.7443319896493,0.06,0.365,0.532,0.026,2.095,99.36791089666325,1969.848620935668,0.094,0.413,0.212,0.125,1.549,157.67478809807076,1985.0215045115467,118.6923076923077,80.5769230769231,12.392,FALSE,312,0.9244444444444444,0,1,0,0,3,FALSE
541,2022-03-19T19:15:22Z,0.8999999761581421,1.7777777777777777,1080,4,3,2,1,2,1,2,2,1,2,1,1,2,1,1,1,2,2,2,1,1,2,2,2,1,1,2,0,0,0,0,1,1,3,1,2,1,1,1,1,2,1,1,1,1,2,1,2,1,1,2,2,1,5,1,1,1,1,1,5,5,1,1,2,2,2,1,1,1,1,2,2,1.5,0,1.4666666666666666,0,1.3333333333333333,0,1.4166666666666667,0,1.6666666666666667,0,2.4285714285714284,0,1.3333333333333333,0,1.6216216216216217,0,1,0,0,-0.6273449041432382,-0.8397289438588569,-0.22730066264678367,-0.5335148032528203,3,2,3,3,2,2,2,2.5,0.4516335802869379,5,5,5,5,3,3,5,4.428571428571429,0,0.6473058850354002,0,0.9270832807034747,2,2,3,3,2,3,5,3,4,3,4,4,3,4,4,4,4,4,2,3,2.4,0,3.8,0,3.4,0,3.6,0,3.6,0,1,2,1,2,1,1,2,2,1,1,2,1,1,1,1,2,1,2,2,1,1.4,0,"Asian or Asian American (e.g., Chinese, Japanese, and others)",0,20,0,1,NA,5,2,0,0,1,0,0,TRUE,TRUE,TRUE,TRUE,TRUE,3,0.6043187499986962,0.5949781249994412,0.5823781249988824,0.6891218749997206,0.6611290322578242,0.6601531250001863,1,1,1,1,1,1,0.176,0.328,0.738,0.009,1.227,15.10961272647832,1797.4966219037155,0.15,0.361,0.625,0.018,1.423,40.60119824821155,1822.0162913587903,0.248,0.317,0.851,0.007,1.002,35.98140982212031,1820.9593403125623,136.33333333333334,79.05555555555556,143.14285714285714,FALSE,280,0.8296296296296296,0,1,0,3,6,FALSE
543,2022-03-19T20:09:04Z,0.8999999761581421,1.7777777777777777,864,6,2,4,1,2,3,4,2,4,3,2,2,2,4,2,4,3,2,5,1,1,3,5,3,1,1,2,0,0,0,0,1,1,3,2,2,1,1,1,1,3,1,1,2,3,1,1,3,1,1,1,3,5,1,1,1,1,1,1,1,1,1,4,5,3,1,1,1,1,1,1,1,1,0,2.8,0,1.4444444444444444,0,1.75,0,1.6666666666666667,0,2.2857142857142856,0,1,0,1.7027027027027026,0,1,0,0,0.07448212087794913,0.21440557072926442,-0.39960647100849406,-0.09260045013961482,1,1,1,1,1,1,1,2,-0.571114413698515,5,5,5,5,2,2,5,4.142857142857143,0,0.1625358753388918,0,0.4770095999368606,2,2,2,2,2,4,4,4,4,3,5,3,5,4,4,4,4,5,3,5,2,0,4.2,0,3.8,0,4.2,0,4.066666666666666,0,1,1,1,2,3,1,2,3,1,1,2,2,2,1,1,3,1,1,1,2,1.6,0,"White, Caucasian, Anglo, European American",0,30,0,1,NA,5,2,0,0,1,0,0,TRUE,TRUE,TRUE,TRUE,TRUE,6,0.6236967741866265,0.5891562499925495,0.573337500013411,0.6052281250022352,0.617318750012666,0.7242366666754086,1,1,1,1,1,0.967741935483871,0.084,0.364,0.428,0.012,1.934,47.75323788288868,1875.5214629381992,0.06,0.411,0.371,0.024,1.44,180.74465696410223,1965.8565969219887,0.104,0.401,0.503,0.048,0.565,30.30475780902881,1810.07024869976,161.16666666666666,60,11.770833333333332,FALSE,342,1.0133333333333332,0,1,0,0,3,FALSE
544,2022-03-19T20:24:25Z,1,1.7777777777777777,1080,6,3,1,1,1,1,1,1,1,1,1,1,1,1,1,1,1,1,1,1,1,1,1,1,1,4,1,2,0,2,0,1,1,3,1,1,1,4,1,1,1,1,1,1,3,3,1,1,1,1,1,1,1,1,1,1,3,1,2,2,3,1,1,1,1,1,1,1,2,1,1,1,1.25,0,1,0,1.5555555555555556,0,1.3333333333333333,0,1.3333333333333333,0,1.5714285714285714,0,1,0,1.4054054054054055,0,2,0,0,-1.17345405798785,-1.4107512504085977,-0.09409076339160714,-0.7524210069001024,1,1,3,1,1,1,2,3,0.06449359517422987,4,4,4,4,2,2,3,3.2857142857142856,0,0.5569909825798411,0,0.25285201860823364,1,1,1,1,1,5,5,5,5,5,5,5,5,5,4,5,5,5,5,3,1,0,5,0,5,0,4.4,0,4.8,0,1,1,1,1,1,1,1,1,1,1,1,1,1,1,1,1,1,1,1,1,1,0,"Asian or Asian American (e.g., Chinese, Japanese, and others)",0,26,0,1,NA,5,2,0,0,1,0,0,TRUE,TRUE,TRUE,TRUE,TRUE,6,0.5102093750001514,0.45293124999979045,0.490971875000163,0.5979437499998022,0.5315833333333333,0.610209375000326,1,1,1,1,0.9375,1,0.197,0.262,0.852,0.005,1.003,38.81379538326164,1822.5859200960113,0.064,0.338,0.607,0.02,2,96.85516911217007,1945.406823910248,0.112,0.326,0.593,0.011,1.26,31.996905335251583,1815.346653932249,200.59999999999997,100,114.54545454545455,FALSE,304,0.9007407407407407,1,1,0,3,6,FALSE
545,2022-03-19T20:15:43Z,0.8999999761581421,1.7777777777777777,1080,4,3,2,3,2,2,1,4,4,1,3,2,1,4,1,3,5,3,1,1,1,2,1,2,1,2,2,0,0,0,0,1,5,5,1,1,1,1,1,2,1,3,5,1,4,3,1,4,2,5,5,4,1,1,1,1,3,2,3,2,2,2,2,3,3,2,2,1,1,2,2,3,2,0,2.533333333333333,0,2,0,3.1666666666666665,0,1.5,0,2.4285714285714284,0,1.6666666666666667,0,2.3513513513513513,0,1,0,0,-0.2347604120220116,-0.10999645945974755,-0.05499485428507328,-0.08249565687241042,1,1,5,1,1,1,1,4.5,0.7276345539631375,1,2,2,2,1,1,1,1.4285714285714286,0,-1.2405296635269585,0,-1.8482337387746575,1,1,1,1,2,5,5,5,5,5,5,5,5,5,5,5,5,5,5,3,1.2,0,5,0,5,0,4.6,0,4.866666666666666,0,1,1,1,1,3,1,1,1,2,1,4,1,1,1,1,1,1,1,1,1,1.3,0,Black or African American,0,22,0,1,NA,5,2,0,0,1,0,0,TRUE,TRUE,TRUE,TRUE,TRUE,5,0.5916312500014901,0.4726843749955296,0.5759593749959022,0.6163843750022352,0.5287290322588336,0.5966967741962402,1,1,1,1,1,1,0.112,0.392,0.603,0.035,1.284,36.13299847241323,1818.8045627586368,0.144,0.288,0.769,0.038,1.991,26.87711289986779,1808.9003132096984,0.216,0.318,0.816,0.04,1.586,27.728607307663623,1808.2353624830823,36.68571428571428,52.39473684210527,39.65,FALSE,320,0.9481481481481481,0,1,0,0,3,FALSE
546,2022-03-19T20:15:11Z,0.8999999761581421,1.7777777777777777,1080,3,2,2,1,2,2,2,2,1,3,5,1,3,3,2,2,1,2,5,3,1,2,3,2,2,2,2,0,0,0,0,1,3,5,2,2,2,3,3,3,2,1,4,1,4,3,1,5,5,4,5,5,5,1,4,1,4,3,1,5,1,1,2,3,1,2,4,2,2,2,2,1,1.75,0,2.1333333333333333,0,2.6666666666666665,0,3.3333333333333335,0,3,0,2,0,2.6666666666666665,0,2.810810810810811,0,1,0,0,0.7127060717565914,0.3525640588819057,-0.14114775846592847,0.1057081502079886,1,1,1,1,1,1,1,1.5,-0.7645165376262261,3,5,5,5,2,2,1,3.2857142857142856,0,-0.39450004400821376,0,-0.32669118968129995,2,2,1,1,2,5,5,4,5,3,5,5,4,4,4,5,5,5,3,3,1.6,0,5,0,4,0,4,0,4.333333333333333,0,2,4,1,4,1,3,2,4,3,2,1,4,2,3,1,4,1,2,2,2,2.4,0,"White, Caucasian, Anglo, European American",0,27,0,2,NA,5,2,0,1,2,0,1,TRUE,TRUE,TRUE,TRUE,TRUE,1,0.46175,0.45440625,0.47190625,0.5356129032258065,0.5091875,0.5207666666666667,1,1,1,1,1,0.9375,0.04,0.408,0.652,0.029,1.806,127.93400291820198,1982.4767315823683,0.056,0.374,0.766,0.048,2.007,57.04609685208234,1841.1138309322364,0.064,0.392,0.889,0.016,1.367,76.60247197881287,1867.8214447877776,62.275862068965516,41.8125,85.4375,FALSE,354,1.0488888888888888,0,1,0,0,3,FALSE
548,2022-03-19T20:58:31Z,1,1.6,800,4,2,3,2,3,3,2,2,4,2,3,2,2,3,2,3,3,2,3,1,1,2,2,2,2,0,1,1,0,1,0,2,3,3,2,3,3,3,3,3,2,2,3,1,3,1,3,3,3,3,3,4,4,1,1,1,4,2,1,1,1,1,2,2,2,2,2,2,2,1,2,2,1.75,0,2.6,0,2.7777777777777777,0,2.5833333333333335,0,2.1666666666666665,0,1.4285714285714286,0,2,0,2.2972972972972974,0,0,0,0,-0.026405513968846484,0.05923539684679709,-0.3605105619019602,-0.15063758252758155,2,2,4,3,1,2,2,3.5,0.755503241136586,3,4,4,3,2,2,3,3,0,-0.12355533664153649,0,-0.3164669596531828,2,3,3,3,3,4,4,4,4,3,3,4,3,3,3,3,3,4,3,3,2.8,0,3.6,0,3.2,0,3.4,0,3.4,0,1,2,3,2,2,3,2,2,2,2,3,2,1,3,2,2,3,3,3,2,2.25,0,"White, Caucasian, Anglo, European American",0,26,0,1,NA,5,2,1,1,0,0,2,TRUE,TRUE,TRUE,TRUE,TRUE,6,0.6786166666676601,0.5907499999962748,0.5786875000018626,0.7101843750001863,0.6521281249988824,0.6729500000011176,0.967741935483871,1,1,1,1,1,0.314,0.197,0.836,0.013,1.601,138.998087622668,1925.9652936673692,0.116,0.435,0.746,0.021,1.381,52.70695578238649,1832.9337061067977,0.068,0.487,0.348,0.094,1.758,65.91642458535837,1890.975473798289,123.15384615384616,65.76190476190476,18.70212765957447,FALSE,334,0.9896296296296296,0,1,0,0,3,FALSE
550,2022-03-19T21:56:41Z,1,1.7777777777777777,1080,4,3,1,2,2,1,2,1,1,2,1,1,2,1,3,1,1,1,2,1,1,1,3,1,1,1,2,0,0,0,0,1,1,4,1,1,1,2,1,1,1,1,1,1,2,2,1,4,2,1,2,4,2,2,1,1,2,2,1,2,1,1,2,2,2,1,1,1,2,1,2,1,1.5,0,1.4666666666666666,0,1.4444444444444444,0,1.8333333333333333,0,1.6666666666666667,0,1.5714285714285714,0,1,0,1.5945945945945945,0,1,0,0,-0.8071880793049175,-0.9606790793946209,-0.22730066264678367,-0.5939898710207023,1,1,3,1,1,1,1,1.5,-0.5986473636146776,5,5,5,4,2,3,4,4,0,-0.44574453423188864,0,0.029109704804958614,2,1,3,4,2,4,4,4,5,3,4,3,3,4,4,5,4,4,4,3,2.4,0,3.8,0,3.8,0,4,0,3.8666666666666667,0,2,2,1,4,4,3,4,4,4,3,4,3,1,1,2,3,2,2,2,4,2.75,0,"White, Caucasian, Anglo, European American",0,22,0,1,NA,5,2,0,0,1,0,0,TRUE,TRUE,TRUE,TRUE,TRUE,6,0.39728125000000003,0.36478125,0.39825,0.46462068965517245,0.44064285714285717,0.4979642857142857,1,1,1,0.90625,0.875,0.9032258064516129,0.055,0.307,0.617,0.009,1.302,81.03537387704131,1943.104611628686,0.053,0.304,0.839,0.023,1.83,33.67262844814081,1892.7131507573224,0.055,0.314,0.741,0.022,1.892,73.11191490394062,1926.812168586925,144.66666666666669,79.56521739130436,86,FALSE,312,0.9244444444444444,0,1,0,0,3,FALSE
551,2022-03-19T23:54:47Z,1,1.7777777777777777,1080,3,1,3,3,3,3,3,3,4,2,2,2,2,4,1,4,4,4,2,3,1,1,4,4,3,5,2,0,0,0,0,2,4,2,3,3,2,4,3,3,2,1,5,1,3,2,1,5,5,5,5,5,3,1,4,4,3,1,2,3,2,2,3,3,3,2,2,4,2,3,1,4,2.5,0,2.8666666666666667,0,2.888888888888889,0,3.3333333333333335,0,2.6666666666666665,0,2.5714285714285716,0,2.6666666666666665,0,2.918918918918919,0,3,0,0,0.9451862737948602,0.8290879262041103,0.5560365609487006,0.6925622435764054,2,1,4,1,1,1,1,8,2.081449421457115,5,5,5,5,2,3,5,4.285714285714286,0,0.7615446951090925,0,0.9192622669301631,2,4,3,4,3,4,5,4,5,3,5,4,3,3,4,4,5,4,4,4,3.2,0,4.4,0,3.8,0,4,0,4.066666666666666,0,1,2,2,2,2,1,3,2,2,1,3,2,3,3,1,2,1,2,1,4,2,0,"White, Caucasian, Anglo, European American",0,25,0,1,NA,5,2,0,0,1,0,0,TRUE,TRUE,TRUE,TRUE,TRUE,3,0.5713249999769032,0.5600218750201166,0.60222666665713,0.6814999999701977,0.6487666666944821,0.6500218749940395,1,1,0.967741935483871,1,0.9375,1,0.081,0.386,0.386,0.04,1.993,120.49968841160552,1949.192953193606,0.073,0.356,0.396,0.008,1.36,80.66068754468455,1926.2237182036704,0.2,0.239,0.601,0.018,1.959,18.67453901535093,1801.1706458457652,49.825,170,108.83333333333334,FALSE,326,0.965925925925926,0,1,0,0,3,FALSE
552,2022-03-20T00:06:23Z,0.8999999761581421,1.7777777777777777,1080,5,2,3,2,4,2,2,2,3,2,4,2,1,2,2,2,4,3,2,1,1,3,3,4,2,0,2,0,0,0,0,2,5,4,5,5,2,5,5,5,2,2,1,1,4,1,2,4,1,1,3,3,2,1,1,1,1,1,1,1,1,1,4,4,3,1,1,1,1,1,1,1,1,0,2.466666666666667,0,4.222222222222222,0,2.0833333333333335,0,1.1666666666666667,0,2.142857142857143,0,1,0,2.3783783783783785,0,0,0,0,0.35082651198004217,0.2547222825745193,-0.6189692744445258,-0.18212349593500324,1,2,2,1,1,1,1,1,-0.7920494875423887,4,4,4,4,2,2,3,3.2857142857142856,0,-0.8792700537047221,0,-0.62195951996656,3,4,3,2,3,2,4,2,3,4,2,2,3,4,4,4,3,2,4,3,3,0,2.2,0,3.8,0,3.2,0,3.066666666666667,0,3,2,4,4,4,4,1,3,4,2,4,3,1,3,1,3,1,4,1,3,2.75,0,"White, Caucasian, Anglo, European American",0,22,0,1,NA,5,2,0,0,0,0,0,TRUE,TRUE,TRUE,TRUE,TRUE,1,0.6276593749979511,0.5402562499982305,0.5847562500010245,0.7441531250011176,0.6533187499996275,0.734265625001397,1,1,1,1,1,1,0.102,0.407,0.634,0.007,1.352,69.59098990825025,1855.717000195064,0.09,0.414,0.698,0.015,1.663,55.837323606404254,1837.399269214088,0.116,0.412,0.535,0.014,1.719,39.14089056089761,1823.5823360691063,193.14285714285714,110.86666666666667,122.78571428571429,FALSE,304,0.9007407407407407,1,0,0,0,3,FALSE
553,2022-03-20T03:27:08Z,0.800000011920929,1.7786458333333333,768,3,3,1,2,3,3,4,2,3,3,2,2,2,3,3,3,3,1,1,1,1,1,2,1,2,1,2,0,0,0,0,2,2,1,2,2,3,3,2,3,3,2,2,1,3,2,2,2,2,3,3,3,1,1,1,1,2,1,2,2,1,1,2,2,2,1,1,1,2,2,2,2,2,0,2.6,0,2.2222222222222223,0,2.3333333333333335,0,1.1666666666666667,0,1.7142857142857142,0,1,0,1.8918918918918919,0,1,0,0,-0.6953343971921657,-0.3906401072801299,-0.05499485428507328,-0.22281748078260158,2,2,4,2,1,2,2,2.5,0.2857644062753896,4,5,5,4,3,3,4,4,0,0.13872270157061628,1,0.38510257022558925,3,3,3,2,3,3,5,3,3,3,3,3,4,3,3,4,3,3,4,3,2.8,0,3,0,4,0,3,0,3.3333333333333335,0,2,3,2,3,3,3,2,3,4,2,2,3,2,2,1,4,1,2,1,2,2.35,0,"White, Caucasian, Anglo, European American",0,25,0,1,NA,5,2,0,0,0,0,0,TRUE,TRUE,TRUE,TRUE,TRUE,2,0.5335593750000699,0.4828687500000233,0.5736218749999534,0.5700290322581366,0.5327633333332836,0.6275781249996507,1,1,1,0.96875,0.9375,1,0.173,0.292,0.619,0.023,1.554,109.09705654603752,1891.7389928145303,0.057,0.385,0.594,0.019,1.42,24.33988835859024,1868.4417720452284,0.06,0.395,0.476,0.023,1.517,55.82779987092883,1883.6251168842764,67.56521739130434,74.73684210526315,65.95652173913044,TRUE,352,1.0429629629629629,0,1,0,3,6,FALSE
554,2022-03-20T05:33:33Z,0.8999999761581421,1.6,900,5,4,4,3,4,3,4,4,4,4,3,3,4,4,2,4,3,2,1,1,1,3,3,3,2,1,2,0,0,0,0,2,2,1,2,2,2,2,2,2,3,2,3,1,3,2,1,3,3,3,2,3,2,1,1,1,2,1,2,2,2,1,3,4,4,1,1,1,2,2,1,3,2,0,3.533333333333333,0,1.8888888888888888,0,2.4166666666666665,0,1.3333333333333333,0,2.5714285714285716,0,1,0,2.027027027027027,0,1,0,0,-0.1207135204560685,0.4033041157408113,-0.05499485428507328,0.17415463072786902,2,1,3,2,1,1,1,2,-0.23937606567541822,3,4,4,4,1,3,4,3.2857142857142856,0,0.2196552803757379,0,0.047384379226480366,4,4,4,3,4,2,5,3,2,5,4,2,5,4,3,4,5,4,4,4,3.8,0,3.4,0,4.6,0,3.2,0,3.7333333333333334,0,1,1,1,2,4,2,4,2,2,1,1,2,2,2,1,3,1,2,1,4,1.95,0,"White, Caucasian, Anglo, European American",0,20,0,1,NA,5,2,0,0,1,0,0,TRUE,TRUE,TRUE,TRUE,TRUE,1,0.5156375000001281,0.53015625,0.5978156249997555,0.6478687500000233,0.5778741935484352,0.7114903225807413,1,1,1,1,0.96875,1,0.195,0.264,0.56,0.012,1.446,74.09813622702853,1859.9792064717496,0.054,0.429,0.567,0.017,1.198,53.27690822606191,1879.814626422636,0.115,0.335,0.637,0.008,1.281,56.09198686205523,1841.8026682824247,120.5,70.47058823529412,160.125,FALSE,632,1.8725925925925926,0,1,0,0,3,FALSE
555,2022-03-20T06:08:02Z,0.8999999761581421,1.7777777777777777,1080,6,4,3,2,2,2,2,1,2,2,2,1,1,2,2,2,3,1,3,5,1,1,3,2,2,2,1,2,0,1,0,2,1,2,2,2,1,3,3,3,2,2,1,1,2,2,2,1,2,3,1,2,3,4,1,2,4,1,1,2,2,2,2,2,2,1,1,1,2,3,2,2,2.25,0,1.9333333333333333,0,2.111111111111111,0,1.75,0,2.5,0,1.8571428571428572,0,1,0,1.9189189189189189,0,1,0,0,-0.02859872342203749,-0.2333065976401118,0.031158049895781924,-0.10107427387216494,1,2,3,1,1,2,1,1,-0.6261803135308405,5,4,4,4,3,3,4,3.857142857142857,0,0.003250347887277641,1,0.22518510473017647,2,1,2,2,2,4,4,4,5,2,3,4,3,5,5,3,5,4,3,3,1.8,0,4,0,3,0,4.4,0,3.8,0,1,2,4,4,3,4,3,4,4,3,2,3,3,3,1,4,1,4,2,2,2.85,0,"White, Caucasian, Anglo, European American",0,23,0,1,NA,5,2,0,0,1,0,0,TRUE,TRUE,TRUE,TRUE,TRUE,3,0.430131250007078,0.3999562499914318,0.4198843750022352,0.4867800000031789,0.43208666666746137,0.4703774193525314,1,1,1,0.9375,0.9375,0.96875,0.055,0.346,0.74,0.024,1.497,44.36682279745223,1873.5203829767504,0.042,0.336,0.676,0.022,1.215,105.34237913776632,1971.9960737523827,0.044,0.361,0.654,0.023,1.584,48.316422337145696,1896.0469089907424,62.375,55.227272727272734,68.86956521739131,FALSE,315,0.9333333333333332,0,1,0,0,3,FALSE
556,2022-03-20T07:09:58Z,0.800000011920929,1.7777777777777777,1080,4,3,4,5,1,5,4,5,5,3,3,1,4,5,4,5,4,4,5,1,1,5,5,4,5,2,1,1,0,1,0,1,4,5,4,5,1,5,4,4,2,1,5,1,3,2,5,5,5,5,5,5,5,1,1,1,5,5,3,2,3,2,5,5,5,4,5,5,2,1,2,3,2,0,3.8666666666666667,0,3.6666666666666665,0,3.6666666666666665,0,3,0,3.5714285714285716,0,4.666666666666667,0,3.6216216216216215,0,1,0,0,2.05056383820323,2.0090892485042464,-0.05499485428507328,0.9770471971095865,3,3,5,3,2,2,3,1,0.20316555652690138,3,3,2,2,1,1,1,1.8571428571428572,0,-0.5751298489193319,0,-1.2107376624277189,5,5,5,5,4,1,3,1,1,1,5,2,2,1,4,2,5,5,1,3,4.8,0,3.6,0,1.8,0,2,0,2.466666666666667,0,1,1,1,1,4,1,2,2,1,1,1,1,1,1,1,1,1,2,1,3,1.4,0,"Hispanic of Latino (e.g., Mexican American, Central American, and others)",0,24,1,3,NA,5,2,0,0,1,0,0,TRUE,TRUE,TRUE,TRUE,TRUE,2,0.4174375,0.36378125,0.41103125,0.5334,0.45675862068965517,0.5044074074074074,1,1,1,0.9375,0.90625,0.84375,0.06,0.318,0.692,0.014,1.719,72.75016661525693,1935.0508538639992,0.055,0.287,0.673,0.025,2.015,82.59074585930824,1940.5293234208805,0.062,0.327,0.708,0.016,2.02,91.6128233791539,1940.2783344467884,122.78571428571429,80.6,126.25,FALSE,279,0.8266666666666667,0,1,0,0,3,FALSE
557,2022-03-20T07:15:16Z,0.8999999761581421,1.7777777777777777,1080,3,1,4,3,4,3,4,3,4,4,3,2,2,3,2,3,3,3,4,2,1,4,4,4,2,5,2,0,0,0,0,2,3,2,1,4,3,4,4,4,3,2,3,2,4,2,2,5,4,4,5,5,4,3,3,1,5,1,1,5,5,3,2,2,3,1,2,3,2,4,4,4,3.5,0,3.1333333333333333,0,3,0,3.4166666666666665,0,2.8333333333333335,0,3,0,2,0,3.027027027027027,0,3,0,0,1.1776664758331283,1.1018648985424924,0.9006481776721214,1.0012565381073069,2,2,4,2,1,3,1,2.5,0.2857644062753896,4,3,4,1,2,2,2,2.5714285714285716,0,-1.1502147610713993,0,-1.1740024766794166,3,2,3,4,3,4,2,4,4,3,1,2,3,4,5,1,2,2,3,3,3,0,2.2,0,2.4,0,4,0,2.8666666666666667,0,2,1,3,4,2,3,1,3,1,2,3,2,1,1,2,3,1,3,2,2,2.1,0,"Hispanic of Latino (e.g., Mexican American, Central American, and others)",0,30,0,1,NA,5,2,0,0,1,0,0,TRUE,TRUE,TRUE,TRUE,TRUE,5,0.50984375,0.4993870967741936,0.5378125,0.58332,0.5718666666666666,0.6623333333333333,1,0.96875,1,0.8064516129032258,0.9375,0.84375,0.064,0.422,0.591,0.006,1.31,33.68197119271561,1897.842778927047,0.06,0.403,0.639,0.019,1.67,80.00378150814076,1989.6726364600916,0.052,0.376,0.428,0.015,1.879,89.1272447045749,1992.1928128322224,218.33333333333334,87.89473684210526,125.26666666666667,FALSE,276,0.8177777777777777,0,1,0,0,3,FALSE
558,2022-03-20T10:46:07Z,1,1.7786458333333333,768,4,3,4,2,4,3,2,2,4,2,1,1,3,3,3,2,2,2,3,1,1,1,3,2,2,1,2,0,0,0,0,3,4,3,3,5,4,3,3,3,2,3,3,2,3,3,4,2,3,3,2,2,3,2,2,1,4,1,1,1,3,1,4,3,3,2,2,2,2,1,1,1,1.25,0,2.533333333333333,0,3.4444444444444446,0,2.6666666666666665,0,2.1666666666666665,0,2.2857142857142856,0,2,0,2.6486486486486487,0,1,0,0,0.20168826916303972,0.18352886946241112,-0.31345356682763886,-0.06496234868261387,2,4,2,4,4,3,3,1.5,0.4795022674603866,5,5,5,5,4,4,4,4.571428571428571,0,0.7376207874909593,0,1.0594958161139754,3,4,3,2,3,3,3,5,3,3,3,3,4,1,3,3,3,4,2,3,3,0,3.2,0,3,0,3,0,3.066666666666667,0,2,2,2,3,2,1,1,4,2,2,1,3,2,2,1,4,2,2,1,2,2.05,0,"White, Caucasian, Anglo, European American",0,30,0,1,NA,5,2,0,0,1,0,0,TRUE,TRUE,TRUE,TRUE,TRUE,1,0.5851774193509932,0.6097656249962747,0.633680645158214,0.6519464285756861,0.6838580645092072,0.6984269230847175,0.96875,1,1,0.875,0.96875,0.8387096774193549,0.057,0.456,0.348,0.015,1.64,49.86172453296942,1951.591121821962,0.082,0.389,0.389,0.023,1.859,73.0978647844192,1900.651863393035,0.06,0.395,0.389,0.008,1.388,108.94249865123466,2015.300057293254,109.33333333333333,80.82608695652173,173.49999999999997,FALSE,388,1.1496296296296296,0,1,0,0,3,FALSE
559,2022-03-20T10:51:08Z,1,1.7777777777777777,1152,4,2,4,2,1,2,2,1,1,1,1,1,1,1,1,1,2,2,2,1,1,1,1,1,1,1,2,0,0,0,0,1,2,1,1,5,2,4,1,2,1,1,1,1,3,1,1,2,1,1,2,2,2,1,1,2,1,1,1,1,1,1,1,1,1,1,1,1,1,1,1,1,1,0,1.4666666666666666,0,2.111111111111111,0,1.4166666666666667,0,1.3333333333333333,0,1,0,1,0,1.4594594594594594,0,1,0,0,-0.9760652072006408,-1.0742542066660088,-0.39960647100849406,-0.7369303388372515,3,2,4,3,2,3,3,4,1.280643713087394,4,4,4,4,2,2,5,3.5714285714285716,0,-0.23191923190205752,0,-0.07285957114128414,2,2,3,3,2,4,4,5,4,2,2,2,5,4,5,3,4,4,2,1,2.4,0,3.2,0,3.2,0,3.8,0,3.4,0,2,4,3,3,3,4,4,4,3,2,3,4,2,2,1,3,1,2,1,2,2.65,0,"Black or African American & Hispanic of Latino (e.g., Mexican American, Central American, and others)",1,28,0,1,NA,5,2,0,0,1,0,0,TRUE,TRUE,TRUE,TRUE,TRUE,2,0.45934687500167637,0.4549125000005588,0.4784468749985099,0.549420689658872,0.5194531250018627,0.5677241379330898,1,1,1,0.90625,1,0.90625,0.058,0.369,0.556,0.017,1.904,35.64554333519135,1890.4989012089693,0.083,0.353,0.79,0.019,1.426,46.94289843615043,1832.2396274168248,0.057,0.353,0.586,0.011,1.518,102.38292595600755,1957.7549774108015,111.99999999999999,75.05263157894737,138,FALSE,266,0.788148148148148,0,1,0,3,6,FALSE
560,2022-03-20T11:46:10Z,0.8999999761581421,1.7777777777777777,1080,6,2,4,2,2,3,3,2,4,3,2,4,2,5,1,5,4,2,1,1,1,2,4,2,2,2,2,0,0,0,0,4,4,5,5,5,1,3,2,3,2,2,2,1,4,2,5,4,3,2,2,2,5,1,1,1,4,4,1,2,3,1,2,1,2,1,1,2,2,1,1,2,1.5,0,3.066666666666667,0,3.5555555555555554,0,2.5833333333333335,0,2.6666666666666665,0,1.7142857142857142,0,1.3333333333333333,0,2.5675675675675675,0,1,0,0,0.14905124228645034,0.380982424060634,-0.22730066264678367,0.07684088070692516,1,1,3,1,1,1,1,1,-0.7920494875423887,4,4,4,4,1,1,4,3.142857142857143,0,0.6806121163039708,1,0.25074567980046913,1,1,2,2,2,5,3,4,4,2,5,4,5,4,4,1,5,4,3,2,1.6,0,4.6,0,2.8,0,3.6,0,3.6666666666666665,0,3,1,3,4,1,2,1,4,1,1,2,2,3,1,1,3,1,1,3,3,2.05,0,Black or African American,0,30,0,1,NA,5,2,0,0,1,0,0,TRUE,TRUE,TRUE,TRUE,TRUE,2,0.4966968750003725,0.428499999998603,0.4691625000005588,0.5608218750008382,0.4960750000020489,0.522448387096005,1,1,1,1,1,0.96875,0.073,0.346,0.628,0.02,1.835,113.86236341886554,1946.6144325445084,0.086,0.318,0.799,0.02,1.614,64.9565303462394,1845.2503006546888,0.095,0.33,0.59,0.024,1.916,59.009879176534966,1839.9154061111776,91.75,80.7,79.83333333333333,FALSE,306,0.9066666666666667,0,1,0,3,6,FALSE
561,2022-03-20T13:15:27Z,1,1.7777777777777777,1080,6,2,4,3,2,3,3,1,3,3,3,3,2,3,1,4,3,1,3,1,1,2,4,3,1,2,2,0,0,0,0,1,3,5,5,5,5,5,5,5,4,4,1,1,5,1,1,4,1,2,4,3,4,1,1,1,3,3,1,2,2,1,2,1,1,1,2,2,2,1,1,3,1.75,0,2.7333333333333334,0,4.333333333333333,0,2.5833333333333335,0,2.1666666666666665,0,1.4285714285714286,0,1.6666666666666667,0,2.6486486486486487,0,1,0,0,0.2828370189311145,0.32542402846900254,-0.14114775846592847,0.09213813500153703,5,4,5,1,4,5,3,1,0.7007730785615464,2,3,3,1,1,1,3,2,0,-0.5512059413011987,0,-1.1187631858894997,1,1,1,1,1,5,4,5,5,5,5,5,5,5,5,5,5,5,5,5,1,0,5,0,4.8,0,5,0,4.933333333333334,0,1,1,1,2,2,1,1,1,1,1,1,4,1,2,1,4,1,1,1,1,1.45,0,"White, Caucasian, Anglo, European American",0,22,0,1,NA,5,2,0,0,1,0,0,TRUE,TRUE,TRUE,TRUE,TRUE,1,0.5781625000005588,0.508268750000745,0.5254156249994412,0.6679499999955296,0.5590387096741507,0.6141999999996155,1,1,1,1,0.96875,0.96875,0.068,0.413,0.599,0.015,1.625,49.247953684769634,1870.658364297292,0.061,0.414,0.625,0.032,1.732,139.54026913030597,1968.617269557142,0.103,0.413,0.676,0.01,1.308,89.07426426968081,1874.256726203408,108.33333333333334,54.125,130.8,FALSE,530,1.5703703703703704,0,1,0,0,3,FALSE
562,2022-03-20T14:16:18Z,1,1.7777777777777777,864,4,2,2,2,2,2,2,1,2,2,2,2,1,2,2,2,3,2,2,1,1,1,1,1,1,1,2,0,0,0,0,1,2,2,2,4,2,2,2,2,1,2,1,1,3,2,5,4,1,3,1,1,1,1,1,1,2,2,1,2,2,1,1,1,1,1,1,1,1,1,1,2,1.25,0,1.9333333333333333,0,2.111111111111111,0,2.0833333333333335,0,1.3333333333333333,0,1.2857142857142858,0,1,0,1.7297297297297298,0,1,0,0,-0.8006084509453439,-0.7525071794521716,-0.31345356682763886,-0.5329803731399052,5,5,5,4,4,5,4,3.5,2.082456633228973,3,3,3,3,1,1,4,2.5714285714285716,0,-0.8792700537047221,0,-1.0089728961699453,2,2,2,3,2,4,4,4,4,1,2,5,5,4,4,4,5,4,3,3,2.2,0,4,0,3.4,0,3.8,0,3.7333333333333334,0,1,1,1,2,3,2,1,2,1,1,2,3,1,2,1,3,1,2,1,1,1.6,0,"Asian or Asian American (e.g., Chinese, Japanese, and others)",0,18,0,1,NA,5,2,1,1,1,0,2,TRUE,TRUE,TRUE,TRUE,TRUE,6,0.5155387096635757,0.43882812501117585,0.45480937499180435,0.582666666674614,0.5124806451566758,0.5132466666618983,0.96875,1,1,0.9375,0.96875,0.9375,0.068,0.298,0.455,0.022,1.947,114.3122069762339,1962.4016700565312,0.06,0.339,0.619,0.014,1.385,61.506304781056706,1886.7619064179903,0.052,0.37,0.394,0.015,1.546,112.9092627609087,2002.7203202327307,88.50000000000001,98.92857142857143,103.06666666666668,FALSE,366,1.0844444444444443,0,1,0,3,6,FALSE
563,2022-03-20T15:36:57Z,0.8999999761581421,1.5,1000,7,3,4,2,3,2,3,3,3,3,2,2,4,4,2,5,4,2,4,1,1,2,3,3,2,0,2,0,0,0,0,3,4,4,3,3,1,4,2,3,1,2,1,1,4,2,3,1,1,1,3,3,3,1,1,1,3,1,1,1,1,1,2,2,2,1,1,2,2,1,1,1,1.25,0,3.066666666666667,0,3,0,1.9166666666666667,0,1.6666666666666667,0,1.4285714285714286,0,1.3333333333333333,0,2,0,0,0,0,0.024038303454551324,0.2969073298467495,-0.5328163702636706,-0.11795452020846053,2,2,2,2,2,2,1,1.5,-0.2669090155915809,3,4,4,4,2,2,4,3.2857142857142856,0,0.2196552803757379,0,0.047384379226480366,1,1,1,1,1,5,5,5,5,3,4,5,5,4,4,5,5,5,4,5,1,0,4.8,0,4.4,0,4.6,0,4.6,0,1,1,1,1,1,2,2,2,2,1,2,3,1,1,1,3,2,2,1,2,1.6,0,"White, Caucasian, Anglo, European American",0,24,0,1,NA,5,2,0,0,1,0,0,TRUE,TRUE,TRUE,TRUE,TRUE,2,0.5154093750026076,0.45743437499925493,0.4805906250011176,0.5757066666662694,0.5172290322578722,0.5672299999982119,1,1,1,0.9375,0.96875,0.9375,0.062,0.318,0.417,0.014,1.687,89.94839440412777,1934.0833204703008,0.08,0.32,0.6,0.007,0.952,131.04699998736265,1975.0855153558568,0.063,0.367,0.441,0.02,1.771,53.79680628530305,1896.1965835022208,120.5,136,88.55,FALSE,436,1.2918518518518518,0,1,0,0,3,FALSE
564,2022-03-20T15:43:40Z,0.8999999761581421,1.6,900,4,2,3,1,2,2,2,2,1,2,2,1,3,3,1,3,2,2,2,1,1,1,3,3,2,1,1,1,1,0,0,1,2,4,1,1,1,1,1,1,1,1,1,1,3,2,1,4,2,3,4,4,3,2,1,1,3,1,1,2,2,1,1,1,1,1,1,1,2,2,2,2,2,0,2,0,1.4444444444444444,0,2.25,0,1.8333333333333333,0,1.2857142857142858,0,1,0,1.7027027027027026,0,1,0,1,-0.4124103777304997,-0.46232518760986324,0.8511386348440838,0.19440672361711028,1,1,1,1,1,1,1,1,-0.9579186615539372,5,5,5,5,3,1,5,4.142857142857143,0,0.4486270873193201,0,0.6512647576014867,2,3,2,2,2,5,4,4,5,4,5,5,5,4,4,5,5,4,5,3,2.2,0,4.8,0,4.6,0,4,0,4.466666666666667,0,1,2,3,1,2,3,2,4,1,1,1,2,1,4,2,4,1,3,2,3,2.15,0,"White, Caucasian, Anglo, European American",0,23,0,1,NA,5,2,0,0,1,0,0,TRUE,TRUE,TRUE,TRUE,TRUE,1,0.8435624999999891,0.8716875000000073,0.7934375000000055,0.9800666666666705,0.9798064516129033,0.8969687500000091,1,1,1,0.967741935483871,1,1,0.246,0.22,0.449,0.014,1.863,110.76431551656285,1891.9171982616313,0.141,0.316,0.245,0.174,1.203,184.32317269365183,1971.4203718564104,0.104,0.377,0.229,0.009,1.522,19.53037345445456,1842.2489020580488,133.07142857142856,6.913793103448277,169.11111111111111,FALSE,392,1.1614814814814816,0,1,0,3,6,FALSE
565,2022-03-20T15:51:28Z,0.8999999761581421,1.7777777777777777,1080,5,2,1,2,2,2,3,1,2,1,2,1,1,2,2,2,2,2,1,1,1,2,2,1,2,0,1,0,0,1,0,1,3,1,1,2,1,1,1,2,2,1,1,1,2,2,1,3,2,2,3,3,1,1,1,1,2,2,1,1,1,1,2,2,2,1,1,1,1,1,1,1,1,0,1.7333333333333334,0,1.4444444444444444,0,1.9166666666666667,0,1.3333333333333333,0,1.4285714285714286,0,1,0,1.5405405405405406,0,0,0,0,-0.7611306807879024,-0.8132772475506287,-0.6189692744445258,-0.7161232609975772,1,2,4,2,2,2,2,1,-0.29444196550774376,4,4,5,5,1,1,4,3.4285714285714284,0,-0.788955151249163,0,-0.48954698455605894,2,2,2,3,3,4,4,4,4,3,4,4,3,3,4,4,4,4,4,3,2.4,0,4,0,3.6,0,3.6,0,3.7333333333333334,0,2,2,3,3,2,3,2,3,2,2,2,3,3,3,1,3,1,2,2,3,2.35,0,Native American/Alaskan Native/indigenous,0,25,0,1,NA,5,2,0,1,1,0,1,TRUE,TRUE,TRUE,TRUE,TRUE,5,0.521,0.43724062500055877,0.4885562499957159,0.5433774193539734,0.5105312499990686,0.5477312499978579,1,1,1,0.96875,1,1,0.073,0.387,0.706,0.033,1.939,127.47006536995583,1934.0450306717648,0.079,0.33,0.725,0.021,1.608,30.99942521759097,1811.341412794054,0.069,0.332,0.4,0.029,2.089,159.71866535686755,1984.7333852024503,58.75757575757576,76.57142857142857,72.03448275862068,FALSE,342,1.0133333333333332,0,1,1,6,9,FALSE
566,2022-03-21T14:25:34Z,0.8999999761581421,1.7777777777777777,1080,6,3,1,1,1,1,1,1,1,1,1,1,1,1,1,1,1,1,1,1,1,1,1,1,1,0,2,0,0,0,0,1,1,1,1,1,1,1,1,1,1,1,1,1,1,1,2,1,1,1,1,1,1,1,1,1,1,1,1,1,1,1,1,1,1,1,1,1,1,1,1,1,1,0,1,0,1,0,1.0833333333333333,0,1,0,1,0,1,0,1.027027027027027,0,0,0,0,-1.4190935167452654,-1.5759514355306168,-0.6189692744445258,-1.0974603549875712,1,1,3,1,1,1,1,1,-0.7920494875423887,5,5,5,4,3,3,5,4.285714285714286,0,-0.3222341343576166,0,0.25914394489227754,2,1,2,2,2,4,4,4,4,4,5,4,5,5,5,5,4,5,4,4,1.8,0,4.4,0,4.4,0,4.4,0,4.4,0,1,1,1,1,1,1,1,1,1,1,1,1,1,1,1,1,1,1,1,1,1,0,"White, Caucasian, Anglo, European American",0,27,0,1,NA,5,2,0,0,1,0,0,TRUE,TRUE,TRUE,TRUE,TRUE,2,0.5890437499955297,0.6522593750208616,0.5766687499955296,0.6378129032081173,0.738475000012666,0.6552781249918044,1,1,1,1,1,1,0.152,0.365,0.761,0.016,1.612,29.884160492740556,1814.0310131703989,0.092,0.391,0.334,0.018,1.492,25.847128652503095,1806.7721279334105,0.164,0.367,0.755,0.037,1.817,53.04665368566176,1833.7204106656263,100.75,82.8888888888889,49.10810810810811,FALSE,292,0.8651851851851852,0,1,1,0,3,FALSE
567,2022-03-21T14:34:29Z,0.8999999761581421,1.7777777777777777,720,6,4,2,1,3,2,3,2,3,2,2,1,2,1,3,2,2,2,1,1,1,1,1,1,1,1,2,0,0,0,0,2,3,1,1,1,1,1,1,1,1,1,1,1,1,1,3,1,1,1,1,2,1,1,1,1,2,1,1,2,1,1,1,1,2,1,1,1,1,1,1,1,1,0,2.066666666666667,0,1.3333333333333333,0,1.25,0,1.1666666666666667,0,1.2857142857142858,0,1,0,1.2432432432432432,0,1,0,0,-1.1975793619729533,-0.9612690800557708,-0.39960647100849406,-0.6804377755321325,1,1,2,1,1,2,2,1,-0.7091149005366146,5,5,5,5,4,3,5,4.571428571428571,0,1.7281822263108981,0,1.6628364028562057,3,3,2,2,2,4,5,4,4,3,5,4,4,4,5,5,5,2,4,4,2.4,0,4,0,4.2,0,4.2,0,4.133333333333334,0,2,2,3,3,1,3,3,2,2,1,3,2,2,3,1,2,1,3,3,2,2.2,0,"White, Caucasian, Anglo, European American",0,30,1,2,NA,5,2,0,0,1,0,0,TRUE,TRUE,TRUE,TRUE,TRUE,6,0.6616333333492279,0.6318774193333041,0.7777312500104309,0.736496874988079,0.7358437500149012,0.9460000000074505,0.967741935483871,0.96875,1,1,1,1,0.195,0.216,0.35,0.007,1.506,45.02322815049923,1827.3709167311165,0.225,0.275,0.624,0.011,1.378,108.35867030550436,1933.0823148095208,0.08,0.445,0.308,0.104,1.742,116.6737521201896,1945.1606217759256,215.14285714285714,125.27272727272727,16.75,FALSE,347,1.028148148148148,0,1,0,0,3,FALSE
