id,meta_start,meta_end,meta_duration,meta_finished,meta_recorded,meta_captcha,meta_browser,meta_version,meta_operating system,meta_resolution_width,meta_resolution_height,meta_feedback,meta_resolution_ratio,meta_task_duration,meta_state_duration,meta_ace_duration,meta_temp_orient_duration,meta_psychopath_duration,meta_dems_duration,meta_task_duration_z,meta_state_duration_z,meta_ace_duration_z,meta_temp_orient_duration_z,meta_psychopath_duration_z,meta_dems_duration_z,stai_s01,stai_s02,stai_s03,stai_s04,stai_s05,stai_s06,stai_s07,stai_s08,stai_s09,stai_s10,stai_s11,stai_s12,stai_s13,stai_s14,stai_s15,stai_s16,stai_s17,stai_s18,stai_s19,stai_s20,sd_stai,sick,meal,hungry,sleep,rested,stai_s_mean,stai_s_missing,chaos01,chaos02,chaos03,chaos04,chaos05,chaos06,chaos07,chaos08,chaos09,chaos10,chaos11,chaos12,chaos13,chaos14,chaos15,unp01,unp02,unp03,unp04,unp05,unp06,unp07,unp08,unp_moving,unp_household_size,unp_partners_mother,unp_partners_father,quic01,quic02,quic03,quic04,quic05,quic06,quic07,quic08,quic09,quic10,quic11,quic12,quic13,quic14,quic15,quic16,quic17,quic18,quic19,quic20,quic21,quic22,quic23,quic24,quic25,quic26,quic27,quic28,quic29,quic30,quic31,quic32,quic33,quic34,quic35,quic36,quic37,change_env01,change_env02,change_env03,change_env04,sd_quic,sd_chaos,unp_mean,unp_missing,change_env_mean,change_env_missing,chaos_mean,chaos_missing,quic_monitoring_mean,quic_monitoring_missing,quic_par_predict_mean,quic_par_predict_missing,quic_par_env_mean,quic_par_env_missing,quic_phys_env_mean,quic_phys_env_missing,quic_safety_mean,quic_safety_missing,quic_total_mean,quic_total_missing,unp_moving_binned,unp_partners_mother_binned,unp_partners_father_binned,unpredictability_subj,unpredictability_obj,unpredictability_composite,violence01,violence02,violence03,violence04,violence05,violence06,violence07,aces_fighting1,aces_fighting2,sd_violence,violence_mean,violence_missing,fighting_mean,violence_composite,ses01,ses02,ses03,ses04,ses05,ses06,ses07,dems_edu_mother,dems_edu_father,dems_income_past,dems_class_past,sd_ses,ses_subj_mean,ses_subj_missing,ses_subj_mean_recoded,edu_parents_recoded,income_past_recoded,class_past_recoded,ses_obj_mean,ses_obj_missing,poverty_composite,impuls01,impuls02,impuls03,impuls04,impuls05,fos01,fos02,fos03,fos04,fos05,fos06,fos07,fos08,fos09,fos10,fos11,fos12,fos13,fos14,fos15,sd_fos,impuls_mean,impuls_missing,fos_pa_mean,fos_pa_missing,fos_tp_mean,fos_tp_missing,fos_fc_mean,fos_fc_missing,fos_fo_mean,fos_fo_missing,depression01,depression02,depression03,depression04,depression05,depression06,depression07,depression08,depression09,depression10,depression11,depression12,depression13,depression14,depression15,depression16,depression17,depression18,depression19,depression20,sd_depression,depression_mean,depression_missing,dems_ethnicity,dems_ethnicity_mixed,dems_age,dems_sex,dems_gender,dems_gender_4_text,dems_born_us,dems_class_current,dems_edu,dems_occupation,dems_income,dems_colorblind,weight,height,activity,att_check01,att_check02,att_getup,att_interrupted,att_noise,attention_check_sum,attention_interrupt_sum,ex_narb_NA_selfreport_pass,ex_narb_attention_checks_pass,ex_narb_suspect_responses_pass,ex_narb_resolution_ratio,ex_narb_resolution_height,counterbalance.x,rt_change,acc_change,rt_var_change,counterbalance.y,rt_cueing_cued,rt_cueing_neutral,acc_cueing_cued,acc_cueing_neutral,rt_var_cueing_cued,rt_var_cueing_neutral,counterbalance,rt_flanker_congruent,rt_flanker_incongruent,acc_flanker_congruent,acc_flanker_incongruent,rt_var_flanker_congruent,rt_var_flanker_incongruent,a.x,v,t0,penalty.x,fit.x,time.x,method.x,task.x,n_trials.x,bic.x,change_EZ_v,change_EZ_a,change_EZ_t0,a.y,v_neutral,t0_neutral,v_cued,t0_cued,penalty.y,fit.y,time.y,method.y,task.y,n_trials.y,bic.y,cueing_neutral_EZ_v,cueing_neutral_EZ_a,cueing_neutral_EZ_t0,cueing_cued_EZ_v,cueing_cued_EZ_a,cueing_cued_EZ_t0,start_a_flanker,start_t0_flanker,start_p_flanker,start_rd_flanker,start_sda_flanker,start_g2_flanker,start_bbic_flanker,a_flanker,t0_flanker,p_flanker,rd_flanker,sda_flanker,g2_flanker,bbic_flanker,final_width_px,scale_factor,fullscreenenter,fullscreenexit,blur_event,focus_event,event_during_cueing,event_during_change,event_during_flanker
1,2021-11-12T18:09:54Z,2021-11-12T18:40:56Z,1861,1,2021-11-12T18:40:57Z,1,Chrome,95.0.4638.69,Windows NT 10.0,1280,720,NA,1.7777777777777777,735,96,625,121,79,107,-0.13925781347288652,0.05628551762956986,0.9507902260980237,0.2000843091083093,0.09744193443982496,0.02742145097557139,3,4,2,2,3,1,1,4,1,4,3,1,2,1,4,4,1,1,2,3,1.2258187382102494,0,1,2,5,5,1.45,0,4,5,2,2,2,1,5,4,2,1,1,5,2,4,4,2,4,4,1,2,2,1,3,5,1,2,3,4,4,5,5,4,5,4,5,5,2,4,2,1,5,1,5,3,3,3,3,3,1,1,5,4,3,1,3,3,3,3,5,2,1,1,1,3,2,2,2,2,1.456063226690421,1.533747356112131,2.375,0,2,0,1.8666666666666667,0,1.4444444444444444,0,2.0833333333333335,0,3,0,2.142857142857143,0,1.6666666666666667,0,2.108108108108108,0,3,2,3,-0.1288122820061409,1.1282568208640904,0.49972226942897474,4,2,2,3,2,4,4,4,1,1,3,0,2.5,0.8469035402869574,5,5,5,5,2,2,1,4,7,NA,3,1.8126539343499315,4.142857142857143,0,1.8571428571428572,3.5,3.8333333333333335,3.2559414990859232,-0.4571894270818581,0,-0.563033266702152,3,4,4,2,2,2,3,2,2,2,1,4,1,3,3,3,4,1,3,4,1.0600988273786194,3,0,4.4,0,3.2,0,3.2,0,3.6,0,2,1,1,4,2,1,1,3,1,1,2,4,2,2,2,4,1,2,1,2,1.050062654772261,1.45,0,"White, Caucasian, Anglo, European American",0,26,1,2,NA,1,3,6,Teacher,1,0,109,69,2,5,2,0,0,1,0,0,TRUE,TRUE,TRUE,TRUE,TRUE,1,0.9689083333317604,0.72,0.18178143326077806,1,0.43045312499953436,0.5180600000013907,1,0.9375,0.0018699774092332136,0.006123577973863204,1,0.5644843749981373,0.6408548387096774,1,0.96875,0.007203311683837731,0.0076763203127120155,1.4271,0.6613,0.5237,0,35.7724,0.003,ML,change,50,-59.808730983715556,0.626208460365299,1.5082223710134788,0.4390385812856056,1.3424,2.986,0.3113,5.9454,0.3176,0,-74.7244,0.006,ML,cueing,64,161.92544925007903,3.332313586687916,0.8126636736471793,0.4113652523518987,5.525268716238181,0.749852168133524,0.36471702009802237,0.079,0.389,0.481,0.018,1.703,103.20194913820089,1991.507559707122,0.081,0.383,0.502,0.016,1.812,137.226478185379,1966.9647197256543,357,1.0577777777777777,1,0,0,1,FALSE,FALSE,FALSE
2,2021-11-12T18:29:39Z,2021-11-12T18:57:30Z,1671,1,2021-11-12T18:57:34Z,1,Chrome,95.0.4638.69,Windows NT 10.0,1536,864,NA,1.7777777777777777,778,79,399,105,93,140,-0.028775031717708392,-0.09815503369452862,-0.13722781824789776,0.0051018045636124325,0.2908107693556527,0.5848365540837228,2,3,4,3,2,1,1,3,2,2,3,2,3,3,1,2,2,3,2,2,0.8013147091860318,0,1,2,3,4,2.6,0,4,5,3,4,4,2,4,1,1,2,1,5,3,4,3,2,1,1,1,1,1,3,1,0,2,0,0,4,3,4,4,4,5,4,4,5,3,5,3,1,5,1,5,2,1,2,3,3,5,1,1,1,1,1,1,1,1,1,5,1,2,1,1,1,1,1,2,1,1.6237723475403307,1.3870146083619754,1.375,0,1.25,0,2,0,1.8888888888888888,0,1.8333333333333333,0,0.8333333333333334,0,1,0,1,0,1.5135135135135136,0,0,0,0,-0.756787244710855,-0.6588395645607719,-0.7078134046358134,4,1,5,2,1,2,1,1,1,1.6035674514745464,1.4285714285714286,0,1,-0.6467170085812028,5,4,5,5,4,4,2,6,4,4,4,1.0690449676496976,4.428571428571429,0,1.5714285714285714,4,3.8333333333333335,3.2559414990859232,-0.1748077221195339,0,-0.5811844090638635,2,2,3,1,2,1,4,3,2,3,1,5,2,4,4,2,5,2,4,5,1.4074631010979937,2,0,4.8,0,3.8,0,3.2,0,3.933333333333333,0,1,2,1,3,2,1,2,3,1,2,1,4,1,2,1,4,1,2,1,1,1.0052493799000692,1.4,0,"White, Caucasian, Anglo, European American",0,18,1,2,NA,1,4,4,Full time student,5,0,150,71,2,5,2,0,0,0,0,0,TRUE,TRUE,TRUE,TRUE,TRUE,5,0.7139536585342593,0.82,0.04087522292360682,5,0.429609677416663,0.4857483870925442,0.96875,0.96875,0.001390286360862519,0.0026939386187109986,5,0.5176093749981373,0.565940625006333,1,1,0.006477084103693077,0.003834502489063209,1.4835,1.1292,0.3229,0,20.9154,0.004,ML,change,50,-30.094730983715564,1.3744022906192483,1.1032777664281141,0.4570791701354315,0.9093,3.7334,0.3726,6.0256,0.3585,0,-99.9974,0.015,ML,cueing,64,212.47144925007902,4.643697197004439,0.7394942130809792,0.41110141988604365,5.47879122221684,0.6267782554955031,0.3759842890149056,0.216,0.257,0.83,0.026,1.382,75.99435886107264,1871.475580759815,0.206,0.263,0.828,0.022,1.452,90.2314775094241,1873.0229409285553,388,1.1496296296296296,1,0,0,1,FALSE,FALSE,FALSE
3,2021-11-12T20:05:45Z,2021-11-12T20:37:26Z,1901,1,2021-11-12T20:37:28Z,1,Chrome,95.0.4638.69,Macintosh,1920,1200,N/A,1.6,763,94,472,256,135,119,-0.06731553698114262,0.038116041003205335,0.2142116385541034,1.845249191204189,0.870917274103136,0.2301178521058083,3,3,2,2,2,1,3,2,1,2,1,1,1,2,2,3,3,1,2,2,0.7591546545162482,0,1,1,2,1,2.25,0,4,5,1,5,1,1,4,2,1,1,2,5,2,4,5,1,2,1,1,1,2,2,1,0,2,0,0,5,2,1,4,4,5,4,5,5,1,5,3,1,4,1,5,1,2,3,3,2,5,1,1,1,1,1,1,1,1,1,5,1,1,1,1,1,1,1,1,1,1.692147559571376,1.7265434778633235,1.375,0,1,0,1.4,0,2.111111111111111,0,1.75,0,0.8333333333333334,0,0.8571428571428571,0,1,0,1.5135135135135136,0,0,0,0,-1.014636397091459,-0.7372407672780129,-0.8759385821847359,5,1,5,1,1,1,3,3,1,1.9023794624226837,1.2857142857142858,0,2,-0.3631965189619651,5,5,5,5,4,4,1,6,4,4,4,1.4638501094227998,4.714285714285714,0,1.2857142857142858,4,3.8333333333333335,3.2559414990859232,-0.1748077221195339,0,-0.740526403906737,1,3,2,4,2,2,5,2,3,3,1,1,3,4,4,1,5,1,5,3,1.505545305418162,2.4,0,4,0,4.2,0,3.6,0,3.933333333333333,0,2,1,3,3,1,3,3,4,3,3,2,3,3,3,1,2,1,3,2,3,0.8870412083230169,2.25,0,"White, Caucasian, Anglo, European American",0,30,1,2,NA,1,2,4,phlebotomist,2,0,190,67,1,5,2,0,0,1,0,0,TRUE,TRUE,TRUE,TRUE,TRUE,2,0.9792903225792031,0.62,0.06825520449297964,2,0.5632875000005588,0.6372724137927951,1,0.90625,0.0069835624193429514,0.013751682540539246,2,0.884878125003539,1.4514379310376686,1,1,0.03535617789282836,0.25000669243792767,1.5002,0.3439,0.463,0,43.3537,0.004,ML,change,50,-74.97133098371557,0.4276300315612371,1.1447938385697825,0.658042396827053,1.1888,2.4509,0.4279,3.4956,0.3932,0,-49.7157,0.008,ML,cueing,64,111.90804925007902,2.4361512855055065,0.9312572477811482,0.4819769445984061,3.974598273491216,1.042403393073554,0.4362522353582041,0.149,0.387,0.213,0.005,1.845,152.64665072923555,1963.5816135943735,0.149,0.381,0.273,0.004,1.873,107.30748140015605,1889.5008253145288,104,0.3081481481481481,1,0,0,1,FALSE,FALSE,FALSE
4,2021-11-12T20:10:50Z,2021-11-12T20:47:03Z,2172,1,2021-11-12T20:47:05Z,1,Chrome,95.0.4638.69,Windows NT 10.0,1920,1080,NA,1.7777777777777777,997,71,574,143,88,187,0.5339163451284313,-0.1708329401999867,0.7052640302500502,0.4681852528572675,0.22175047117142851,1.3787307918438174,4,4,1,1,2,1,1,4,3,4,2,1,1,2,4,2,2,3,1,2,1.2085223687584246,0,1,3,2,2,1.85,0,3,4,4,5,2,1,5,3,2,2,3,4,2,3,3,3,4,1,3,2,1,2,5,2,4,0,0,4,5,3,4,5,5,4,5,5,2,4,2,4,4,4,5,2,2,1,3,3,5,1,1,1,2,1,3,4,5,5,5,3,1,1,1,1,3,3,3,5,1.5663503610155212,1.162919151265879,2.625,0,3.5,0,2.2666666666666666,0,1.5555555555555556,0,2.3333333333333335,0,1,0,3,0,1,0,2,0,1,0,0,0.10406499300426954,0.24986373369091455,0.17696436334759205,5,3,2,1,1,2,3,1,4,1.3972762620115438,2.142857142857143,0,2.5,0.33410042935609163,5,4,5,4,3,4,5,6,7,3,3,0.7559289460184544,3.7142857142857144,0,2.2857142857142856,2.5,3.8333333333333335,3.2559414990859232,-1.0219528370065065,0,-0.6064019794001662,4,3,4,5,4,4,4,3,5,5,5,3,3,4,3,5,3,2,4,5,0.990430401872025,4,0,2.6,0,3.4,0,2.4,0,2.8,0,2,3,1,2,3,2,4,2,1,1,3,1,2,1,1,3,1,2,1,1,0.9333020044867296,2.05,0,"White, Caucasian, Anglo, European American",0,23,0,1,NA,1,4,6,executive officer,4,0,176.37,67,4,5,2,0,0,0,0,0,TRUE,TRUE,TRUE,TRUE,TRUE,2,0.7565170731733485,0.82,0.020608396146742692,2,0.47689666666686537,0.582609374997206,0.967741935483871,1,0.007027707225293465,0.020265348619957296,2,0.6721593750026077,0.7561483870965819,1,1,0.01767298700535223,0.026144731913724486,1.2143,1.3358,0.4566,0,3.0262,0.003,ML,change,50,5.683669016284438,1.631052181113421,0.9296744193266515,0.574122041530985,1.6462,4.0791,0.3808,3.4146,0.2454,0,-54.2693,0.008,ML,cueing,63,120.9680041791746,3.045257171089072,1.3605204728603686,0.3662065994621392,3.6370659431762657,0.9351486706044916,0.3566326252698806,0.127,0.4,0.467,0.014,1.206,39.54045034769179,1842.1913161349378,0.127,0.404,0.481,0.013,1.259,54.9055008624497,1838.9200518069986,104,0.3081481481481481,1,1,11,12,FALSE,FALSE,FALSE
5,2021-11-12T19:50:08Z,2021-11-12T21:01:17Z,4269,1,2021-11-12T21:01:18Z,0.8999999761581421,Chrome,95.0.4638.69,Windows NT 10.0,1920,1080,-,1.7777777777777777,2663,50,424,56,38,165,4.814481796387192,-0.36161244477681426,-0.01687183989104805,-0.5920321156045217,-0.46885251067081346,1.0071207231050496,3,3,2,2,3,1,1,3,2,3,4,1,1,2,1,3,1,2,2,2,0.9119095061289915,0,1,2,4,3,1.9,0,5,5,2,5,2,1,5,1,1,1,1,5,1,5,3,1,1,1,1,1,1,1,1,4,2,0,0,4,5,5,5,5,5,5,5,5,1,5,1,1,5,1,5,1,1,1,1,1,5,1,1,1,5,1,1,5,5,1,5,1,1,1,1,1,1,1,3,3,1.9977464781575742,1.88477610139267,1,0,2,0,1.2666666666666666,0,1.1111111111111112,0,1,0,1.5,0,2,0,1,0,1.3513513513513513,0,2,0,0,-1.3027808890723365,-0.01745100881601569,-0.6601159489441761,4,3,4,2,3,3,3,8,8,0.6900655593423543,2.5714285714285716,0,8,2.619934196080626,4,4,4,4,2,2,1,4,4,3,3,1.2909944487358056,3.5714285714285716,0,2.4285714285714284,5,3.8333333333333335,3.2559414990859232,0.38995568780511447,0,0.17922328042708108,4,5,2,3,3,4,3,4,4,4,3,4,1,5,4,4,2,5,4,4,1.0465362369445672,3.4,0,2.4,0,3.6,0,3,0,3,0,1,1,1,4,1,1,4,4,1,1,1,3,1,1,1,4,1,1,1,1,1.260743306232687,1.2,0,"White, Caucasian, Anglo, European American",0,23,0,1,NA,1,4,6,Teacher / tutor,2,0,185,71,2,5,2,0,0,0,0,0,TRUE,TRUE,TRUE,TRUE,TRUE,NA,NA,NA,NA,6,0.4833451612918608,0.5990677419367336,1,0.96875,0.008427499892490739,0.023712034989482954,6,0.8268968750010245,0.8990187499998137,1,1,0.10725188031256856,0.12237486866959332,NA,NA,NA,NA,NA,NA,NA,NA,NA,NA,NA,NA,NA,1.4176,3.0074,0.3742,4.1763,0.3136,0,-56.1129,0.006,ML,cueing,63,124.6552041791746,2.6959920676941485,1.2737378739478995,0.37760394923212803,3.7921700634540123,1.0925498216232032,0.34379345053163035,0.196,0.066,0.247,0.198,1.483,115.4468639382837,1905.0791444784265,0.19,0.059,0.234,0.225,1.541,138.33129328988872,1923.415806816613,104,0.3081481481481481,1,1,6,7,FALSE,FALSE,FALSE
6,2021-11-12T20:40:27Z,2021-11-12T21:11:50Z,1882,1,2021-11-12T21:11:51Z,1,Chrome,95.0.4638.69,Macintosh,1440,900,no,1.6,735,64,862,66,50,70,-0.13925781347288652,-0.23442610839226255,2.091764900920959,-0.47016805026408615,-0.3031077950286754,-0.5975591191759924,3,3,1,1,3,1,2,3,1,4,3,1,1,2,3,4,1,1,3,4,1.164157703189193,0,1,3,4,4,1.45,0,5,4,3,4,3,1,4,2,3,1,3,5,3,4,4,1,3,1,1,2,3,2,2,1,2,0,0,5,5,5,5,5,5,4,5,5,2,4,1,1,4,3,5,2,1,1,1,1,5,1,1,1,3,2,1,5,1,1,3,3,2,1,3,1,2,2,2,2,1.7133112488498508,1.2227992865708155,1.875,0,2,0,2.066666666666667,0,1.1111111111111112,0,1.5,0,1.3333333333333333,0,2.142857142857143,0,1.6666666666666667,0,1.5675675675675675,0,1,0,0,-0.4900333918726625,-0.22054348261253207,-0.3552884372425973,4,2,5,2,1,2,1,2,1,1.5118578920369088,1.5714285714285714,0,1.5,-0.3767559860388676,5,4,5,4,1,1,3,6,7,2,3,1.7043362064926932,3.2857142857142856,0,2.7142857142857144,2.5,3.8333333333333335,3.2559414990859232,-1.0219528370065065,0,-0.3673889871358558,1,3,2,3,2,1,5,1,1,3,1,5,2,4,5,1,3,2,4,2,1.5886502207249789,2.2,0,4.4,0,4.2,0,4.6,0,4.4,0,2,1,2,3,3,2,3,3,2,3,1,3,1,2,1,3,3,3,2,2,0.7863975156570492,2.05,0,"White, Caucasian, Anglo, European American",0,20,1,2,NA,1,2,4,student and content creator for Buzzfeed,1,0,110,63,2,5,2,0,1,1,0,1,TRUE,TRUE,TRUE,TRUE,TRUE,2,1.02324999998297,0.84,0.07472284746013637,2,1.147586666695277,1.217406451594445,1,1,0.33013720045746214,0.27411897995518664,2,1.1711187499687077,1.3209483870767778,1,1,0.15261331963155408,0.20588094791120307,1.4705,1.2037,0.6199,0,18.9551,0.004,ML,change,50,-26.174130983715564,1.2697510835624068,1.3059473609199186,0.6735577583610718,2.7348,1.8299,0.4701,1.7789,0.379,0,27.3976,0.008,ML,cueing,61,-42.462578407480066,1.5879167051920593,2.609163763341364,0.42151225025747097,1.515789444060466,2.733318102079526,0.2741467830210661,0.22,0.246,0.243,0.023,1.813,69.59989012493155,1857.5204239137613,0.226,0.237,0.243,0.02,1.909,74.59689236875099,1858.286929990217,104,0.3081481481481481,1,0,0,1,FALSE,FALSE,FALSE
7,2021-11-12T20:50:28Z,2021-11-12T21:15:48Z,1520,1,2021-11-12T21:15:48Z,0.8999999761581421,Chrome,95.0.4638.54,Macintosh,1440,900,/,1.6,722,86,361,86,79,91,-0.1726595847011962,-0.03456186550225277,-0.32016890535030934,-0.2264399195832151,0.09744193443982496,-0.2428404171980778,3,2,2,2,1,2,4,2,2,2,1,2,3,2,3,1,4,3,3,2,0.8645047258706176,0,1,3,3,1,2.8,0,4,3,2,4,1,3,4,2,1,1,3,5,1,5,4,3,1,1,1,3,1,1,1,5,2,0,0,3,5,5,5,5,5,4,5,4,1,5,2,1,5,1,5,4,3,2,2,3,4,1,1,1,3,1,1,4,4,1,4,3,2,1,1,1,2,1,3,3,1.622384705343382,1.4573295865416045,1.5,0,2.25,0,1.8,0,1.4444444444444444,0,1.8333333333333333,0,1.3333333333333333,0,2.2857142857142856,0,1,0,1.7297297297297298,0,3,0,0,-0.6960997752879425,0.2640426676977418,-0.21602855379510036,5,2,4,1,1,1,1,2,2,1.6761634196950514,1.2857142857142858,0,2,-0.3631965189619651,5,5,5,5,2,1,3,7,7,2,3,1.7043362064926932,3.7142857142857144,0,2.2857142857142856,2,3.8333333333333335,3.2559414990859232,-1.3043345419688306,0,-0.7475928318813282,2,3,3,4,3,2,5,1,1,4,1,5,3,5,4,1,3,2,4,3,1.533747356112131,3,0,4.2,0,4.2,0,4.4,0,4.266666666666667,0,3,2,4,2,4,4,4,2,4,4,1,3,3,2,2,2,3,3,4,4,0.9733285267845752,3.1,0,"Asian or Asian American (e.g., Chinese, Japanese, and others)",0,19,1,2,NA,1,3,4,Student,3,0,99,63,1,5,2,0,0,0,0,0,TRUE,TRUE,TRUE,TRUE,TRUE,5,1.127168750008568,0.64,0.2276926481612541,5,0.5036870967707326,0.6003551724183148,1,0.90625,0.003578048495075049,0.009642999353870502,5,0.8239687500018626,1.0438566666662692,1,0.9375,0.0553570086672784,0.10097657611776177,1.5852,0.3632,0.5607,0,51.7665,0.004,ML,change,50,-91.79693098371557,0.37024121863328363,1.5540250948489027,0.539542353136915,1.2016,2.5193,0.3964,4.3195,0.3646,0,-58.3806,0.008,ML,cueing,63,129.1906041791746,2.6621969385429884,0.8521847157408299,0.4703121858317604,4.697869394036432,0.8819178182456306,0.4127567393293366,0.08,0.537,0.203,0.017,1.861,161.4808442084978,2032.7644509328375,0.081,0.535,0.21,0.017,2.001,165.3037253136812,2031.7168055783238,104,0.3081481481481481,1,0,1,2,FALSE,FALSE,FALSE
8,2021-11-12T21:14:28Z,2021-11-12T21:32:10Z,1062,1,2021-11-12T21:32:12Z,0.8999999761581421,Chrome,95.0.4638.69,Macintosh,1440,900,NA,1.6,543,46,251,61,46,67,-0.6325762808448446,-0.39795139802954327,-0.8497352101204481,-0.5311000829343039,-0.3583560335760547,-0.6482332194585516,2,3,2,1,3,1,2,3,2,3,3,2,1,1,3,3,2,1,2,3,0.812727700887249,0,1,1,4,3,1.85,0,4,4,2,3,1,1,5,1,1,1,2,3,2,4,5,1,2,1,1,1,2,2,2,0,2,0,0,5,5,4,5,5,4,5,5,5,1,3,1,1,3,1,4,2,2,3,3,4,3,1,1,1,3,3,3,1,4,1,2,4,2,1,3,1,2,1,2,4,1.5002502293786697,1.5023790657297036,1.5,0,2.25,0,1.6666666666666667,0,1.2222222222222223,0,2.1666666666666665,0,1.8333333333333333,0,2.5714285714285716,0,1.6666666666666667,0,1.972972972972973,0,0,0,0,-0.6488661467737779,-0.34523475369180734,-0.4970504502327926,2,4,2,5,5,5,4,3,1,1.3451854182690985,4.428571428571429,0,2,1.5170815544512093,5,5,5,4,2,3,3,7,4,1,2,1.2149857925879117,3.857142857142857,0,2.142857142857143,3.5,3.8333333333333335,3.2559414990859232,-0.4571894270818581,0,-0.40369127185927867,1,2,2,1,1,1,5,2,1,2,3,4,2,5,4,2,4,1,4,1,1.486446705914413,1.4,0,4.2,0,3.8,0,4.6,0,4.2,0,2,3,3,4,3,4,4,2,1,2,3,1,4,2,1,1,3,3,2,4,1.0954451150103321,2.8,0,"White, Caucasian, Anglo, European American",0,19,1,2,NA,1,2,4,Student,1,0,140,67,1,5,2,0,0,1,0,0,TRUE,TRUE,TRUE,TRUE,TRUE,NA,NA,NA,NA,6,0.45028275861822326,0.5163833333333333,0.9666666666666667,0.9375,0.0035171796437376236,0.0038664351534692556,6,0.6012903225806452,0.6385310344901578,0.96875,0.90625,0.00784758103946578,0.008346833830926773,NA,NA,NA,NA,NA,NA,NA,NA,NA,NA,NA,NA,NA,1.0609,3.2571,0.3704,3.9948,0.3228,0,-68.9227,0.008,ML,cueing,62,150.2268031551353,3.738259918131621,0.7244146368655101,0.43160287114785134,4.303209002214178,0.7825080836775211,0.3654227300066418,0.056,0.418,0.307,0.029,1.885,171.1811682593823,2143.8142227883613,0.056,0.419,0.308,0.03,2.024,214.1671367525536,2145.8706797163827,368,1.0903703703703704,1,0,0,1,FALSE,FALSE,FALSE
9,2021-11-12T21:05:27Z,2021-11-12T21:32:25Z,1618,1,2021-11-12T21:32:27Z,1,Chrome,95.0.4638.69,Windows NT 10.0,1280,720,Have a beautiful day! :),1.7777777777777777,687,72,471,124,89,105,-0.26258743031587606,-0.16174820188680444,0.2093973994198294,0.23664352871043995,0.23556253080827336,-0.006361282546134758,4,4,1,1,4,1,2,3,1,2,2,1,2,2,4,4,1,1,2,3,1.2085223687584246,0,0,2,4,3,1.55,0,3,4,4,3,3,2,3,4,3,2,5,3,2,3,4,4,5,1,1,3,4,2,3,0,2,0,0,5,4,5,4,4,5,4,4,5,2,5,5,2,4,3,5,2,5,5,5,3,1,1,1,1,1,1,1,1,1,1,5,1,2,1,1,2,1,1,1,1,1.7220526895148898,0.8618916073713346,2.875,0,1,0,2.933333333333333,0,1.5555555555555556,0,3,0,1.5,0,1,0,1.3333333333333333,0,1.945945945945946,0,0,0,0,0.4747715446625703,-0.7372407672780129,-0.1312346113077213,5,2,2,1,1,1,1,1,1,1.4638501094227998,1.5714285714285714,0,1,-0.5612498234260587,5,5,5,4,2,2,3,5,3,2,3,1.3801311186847085,3.7142857142857144,0,2.2857142857142856,5,3.8333333333333335,3.2559414990859232,0.38995568780511447,0,0.09955228300564435,3,3,3,5,4,4,3,3,2,2,1,3,4,4,4,4,3,4,3,3,0.9154754164341269,3.6,0,3,0,2.4,0,3.6,0,3,0,2,2,3,2,3,3,4,2,2,2,1,2,1,3,1,2,2,3,1,3,0.8335087534664907,2.4,0,"White, Caucasian, Anglo, European American",0,20,1,2,NA,1,3,3,full time student,2,0,104,62,1,5,2,0,0,1,0,0,TRUE,TRUE,TRUE,TRUE,TRUE,1,0.9724891891898335,0.74,0.11390051086141297,1,0.4799218749997672,0.6022833333328367,1,0.9375,0.0026409495061828735,0.009795786088605736,1,0.6559374999993015,0.8810516129030336,1,0.96875,0.009115615967729272,0.04722352861881764,1.5403,0.7126,0.5142,0,37.899,0.007,ML,change,50,-64.06193098371557,0.7723817353691175,1.3542119230497136,0.5516987346141434,1.2955,2.9381,0.4013,4.9896,0.3501,0,-68.0203,0.008,ML,cueing,64,148.51724925007903,2.963038904033737,0.9139435183978187,0.4673373193757776,5.068418528897817,0.8174413187800618,0.4018012272027125,0.105,0.419,0.435,0.007,1.493,103.48146143750917,1945.3544663177622,0.101,0.416,0.372,0.008,1.548,117.54684762763912,1942.4558706647474,345,1.0222222222222224,1,0,0,1,FALSE,FALSE,FALSE
10,2021-11-12T21:02:28Z,2021-11-12T21:33:39Z,1870,1,2021-11-12T21:33:40Z,1,Chrome,95.0.4638.69,Windows NT 10.0,1366,768,No comments,1.7786458333333333,836,108,524,111,75,136,0.12024825530090397,0.16530237738775702,0.4645520735363508,0.07822024376787376,0.04219369589244561,0.5172710870403106,1,4,1,1,3,1,1,4,1,4,4,2,1,1,3,3,1,1,3,3,1.268027892769755,0,1,2,3,3,1.45,0,5,5,2,4,1,1,5,1,2,5,2,5,1,4,5,1,1,1,1,1,1,1,1,1,2,0,0,4,5,5,5,4,5,5,4,5,1,5,1,1,5,2,5,1,1,2,2,3,5,1,3,1,3,1,1,1,2,1,5,1,2,1,1,1,2,2,1,2,1.7424224619867699,1.780850519113991,1,0,1.75,0,1.6,0,1.3333333333333333,0,1.4166666666666667,0,1.5,0,1.1428571428571428,0,1,0,1.3783783783783783,0,1,0,0,-1.14791653328819,-0.2989446853297732,-0.7234306093089816,4,2,2,2,1,2,2,3,2,0.8997354108424374,2.142857142857143,0,2.5,0.33410042935609163,4,5,5,3,3,3,1,1,3,NA,2,1.3972762620115438,4,0,2,7,3.8333333333333335,3.2559414990859232,1.5194825076544112,0,0.5049736980874192,1,1,3,2,3,2,3,1,1,1,1,3,3,4,3,5,2,1,1,5,1.4540583599999397,2,0,3.8,0,1.8,0,3.6,0,3.066666666666667,0,1,1,1,3,2,1,1,2,1,1,2,3,2,1,1,4,1,1,1,1,0.8870412083230169,1.35,0,"Hispanic of Latino (e.g., Mexican American, Central American, and others)",0,27,0,1,NA,1,2,6,Software Developer,1,0,139,64,3,5,2,0,0,0,0,0,TRUE,TRUE,TRUE,TRUE,TRUE,2,0.9162511627906283,0.86,0.06616325993461322,2,0.4577937499994878,0.5143593749995343,1,1,0.0017245935081051178,0.00221258507058204,2,0.5518562500001862,0.7028266666675608,1,0.967741935483871,0.00456476124987975,0.01368023516125704,1.4727,1.3009,0.5414,0,16.5184,0.004,ML,change,50,-21.30073098371556,1.4035395009876568,1.293365783692477,0.5845101025627935,4.6728,9.9384,0.2793,11.3467,0.2519,0,-110.735,0.011,ML,cueing,64,233.94664925007902,5.297701691536328,0.7820626693667283,0.4428544795691814,5.638204289217517,0.7348323178560326,0.39466471357166566,0.095,0.371,0.499,0.013,1.775,144.62745565061175,1976.9728094607617,0.098,0.365,0.545,0.012,1.912,154.29222024909782,1983.087330536714,342,1.0133333333333332,1,0,0,1,FALSE,FALSE,FALSE
11,2021-11-12T21:07:52Z,2021-11-12T21:34:07Z,1575,1,2021-11-12T21:34:08Z,1,Chrome,95.0.4638.69,Windows NT 10.0,1366,768,no,1.7786458333333333,681,76,464,107,65,114,-0.27800363242124976,-0.1254092486340754,0.1756977254799115,0.02947461763169954,-0.09592690047600279,0.1456610183015429,3,3,2,2,3,1,1,1,1,2,2,1,3,1,2,2,1,1,1,3,0.8335087534664907,0,1,1,4,3,2.1,0,2,5,2,3,4,2,2,2,3,2,3,5,1,4,4,3,4,1,1,2,3,3,1,1,2,0,0,5,2,4,3,5,5,2,4,4,4,5,2,1,3,2,5,1,3,3,4,1,3,1,1,1,3,2,1,1,1,1,4,2,1,1,3,1,2,1,1,1,1.4632638658632766,1.2227992865708155,2.25,0,1.25,0,2.4,0,2.2222222222222223,0,2.1666666666666665,0,1.6666666666666667,0,1.1428571428571428,0,1.6666666666666667,0,1.9189189189189189,0,1,0,0,-0.034635395644906565,-0.4557470907642554,-0.245191243204581,5,1,2,1,1,1,1,2,1,1.4960264830861913,1.4285714285714286,0,1.5,-0.4622231711940119,2,2,2,4,1,2,3,4,4,2,1,0.9511897312113419,2.2857142857142856,0,3.7142857142857144,5,3.8333333333333335,3.2559414990859232,0.38995568780511447,0,0.8962622572200118,4,4,2,2,2,1,3,3,2,1,1,5,1,4,3,1,4,2,2,3,1.2983506020002016,2.8,0,4.6,0,3.2,0,3.4,0,3.7333333333333334,0,1,1,1,4,1,1,2,3,1,1,1,3,1,1,1,4,1,1,1,2,1.0462967275611939,1.2,0,"White, Caucasian, Anglo, European American",0,23,1,2,NA,1,2,6,Unemployed,4,0,105,61,1,5,2,0,0,1,0,0,TRUE,TRUE,TRUE,TRUE,TRUE,4,0.8690575000286103,0.8,0.06632701064763906,4,0.4583500000834465,0.5489225806574668,1,0.96875,0.007580701290978461,0.006242672249080944,4,0.6149718751311303,0.6701531249880791,1,1,0.017071703400719167,0.02549168775148461,1.3768,1.0197,0.4977,0,22.4988,0.006,ML,change,50,-33.26153098371556,1.13066276793139,1.226090042441384,0.5437376759705712,1.6831,3.9605,0.3498,4.1467,0.2554,0,-60.6926,0.007,ML,cueing,64,133.86184925007902,3.7637275952977736,0.9123899425599797,0.435289812412146,3.8939031758943092,1.0640055849462622,0.32599496146850215,0.203,0.162,0.438,0.04,1.501,204.90573928021075,2019.1875176564072,0.201,0.157,0.417,0.06,1.61,244.61818256103413,2030.2132960172187,360,1.0666666666666667,1,0,0,1,FALSE,FALSE,FALSE
12,2021-11-12T21:02:45Z,2021-11-12T21:36:48Z,2043,1,2021-11-12T21:36:51Z,1,Chrome,95.0.4638.69,Macintosh,1440,900,N/A,1.6,760,123,628,134,136,141,-0.07502363803382947,0.30157345208549097,0.9652329435008457,0.3585075940508755,0.8847293337399809,0.6017279208445759,2,2,3,3,2,3,3,1,2,2,2,2,1,2,2,1,2,2,2,1,0.6488856845230502,0,1,1,4,4,2.8,0,2,4,2,4,2,2,3,4,3,2,5,3,2,3,2,4,4,1,1,4,4,4,4,7,2,0,3,4,4,4,3,3,3,3,3,3,2,4,4,3,4,2,4,2,4,4,4,4,2,4,1,1,3,1,1,4,4,4,5,1,1,1,1,1,3,2,4,4,1.2728393929008168,0.990430401872025,3.25,0,3.25,0,2.8666666666666667,0,2.6666666666666665,0,2.9166666666666665,0,2.1666666666666665,0,2.142857142857143,0,1,0,2.4864864864864864,0,4,0,3,0.8395738927566005,1.3100888930607648,1.0748313929086826,4,2,3,2,2,2,2,4,1,0.7867957924694432,2.142857142857143,0,2.5,0.33410042935609163,4,4,4,4,3,3,2,3,3,3,3,0.7867957924694432,3.7142857142857144,0,2.2857142857142856,6,3.8333333333333335,3.2559414990859232,0.9547190977297628,0,0.3819339879679685,2,3,3,3,2,3,3,3,2,2,2,3,3,3,3,2,3,2,3,4,0.5936168397046637,2.6,0,3.4,0,3,0,3,0,3.1333333333333333,0,3,1,2,4,2,2,3,3,2,1,2,3,3,3,2,3,2,2,1,2,0.8013147091860318,2,0,"White, Caucasian, Anglo, European American",0,26,1,2,NA,1,3,6,Regulatory Affairs Associate,3,0,196,64,2,5,2,0,0,1,0,0,TRUE,TRUE,TRUE,TRUE,TRUE,3,1.0447829268292819,0.8367346938775511,0.05851560933677633,3,0.5256750000001048,0.5831290322580345,1,1,0.0025811567741905205,0.0027844161290262806,3,0.7734468750000233,0.8307375000000174,1,1,0.005957691602836485,0.006307882419359183,1.5352,1.1668,0.6009,0,21.7373,0.003,ML,change,49,-31.799139105668125,1.334287465776262,1.2247214838923541,0.7356994462887357,10,12.3001,0.1766,12.1844,0.1153,0,-97.759,0.017,ML,cueing,63,207.9474041791746,5.001830370037438,0.8283237174955459,0.5029145365675495,5.097519531544849,0.8127746643740507,0.44844376515736745,0.394,0.338,0.881,0.019,1.214,66.80717023017279,1862.3706696554855,0.396,0.329,0.887,0.018,1.271,86.59533614288871,1875.161958907044,378,1.12,1,0,0,1,FALSE,FALSE,FALSE
13,2021-11-12T21:12:43Z,2021-11-12T21:53:24Z,2441,1,2021-11-12T21:53:26Z,0.8999999761581421,Chrome,95.0.4638.69,Windows NT 10.0,1920,1080,no,1.7777777777777777,1409,84,525,122,87,131,1.5924955563640915,-0.0527313421286173,0.4693663126706248,0.21227071564235284,0.20793841153458367,0.43281425323604517,2,2,3,3,2,1,3,1,1,1,1,2,1,2,1,1,2,1,1,1,0.7539370349250519,0,1,3,2,2,2.8,0,5,5,2,5,1,1,5,1,1,1,1,5,3,5,4,2,1,1,1,2,2,1,2,3,1,0,0,5,4,4,5,3,5,4,4,3,1,5,1,1,5,1,5,1,1,1,1,2,3,1,1,3,3,1,1,2,1,1,5,1,1,1,1,1,1,1,1,2,1.6407901121691928,1.889822365046136,1.5,0,1.25,0,1.2666666666666666,0,1.8888888888888888,0,1.0833333333333333,0,1.8333333333333333,0,1,0,1,0,1.4324324324324325,0,2,0,0,-1.0530621153704003,-0.25265461696773905,-0.6528583661690697,5,1,3,1,1,2,1,3,1,1.5275252316519468,1.4285714285714286,0,2,-0.2777293338068208,5,5,5,5,2,2,2,5,8,4,4,1.6035674514745464,4,0,2,2.5,3.8333333333333335,3.2559414990859232,-1.0219528370065065,0,-0.7657439742430396,3,2,3,3,3,2,4,2,2,3,2,4,1,3,4,2,4,3,3,3,0.9411239481143202,2.8,0,3.8,0,3.8,0,3.6,0,3.7333333333333334,0,2,2,2,2,3,3,3,1,2,2,2,2,2,3,2,2,1,2,4,2,0.6958523739384593,2.5,0,"Hispanic of Latino (e.g., Mexican American, Central American, and others) & White, Caucasian, Anglo, European American",1,30,0,1,NA,1,2,3,janitor,2,0,132,67,2,5,2,0,1,0,0,1,TRUE,TRUE,TRUE,TRUE,TRUE,5,1.4878534883718157,0.8775510204081632,0.5048131320833759,5,0.5844812500001862,0.6618354838709197,1,1,0.010016456411251838,0.01750726169897229,5,0.8221406249997671,0.9486687499999534,1,1,0.032586169586893095,0.06833836092750596,2.2116,0.8548,0.5262,0,59.157,0.003,ML,change,49,-106.63853910566812,0.8969754992802919,2.1956459770035317,0.5636717467992721,1.7962,3.8131,0.4263,4.4165,0.3811,0,-58.7509,0.007,ML,cueing,63,129.93120417917459,3.1586967856021353,1.311659525306965,0.4606971266007557,3.6319007172365603,1.1407621102440157,0.4323414504381888,0.176,0.348,0.346,0.016,1.363,44.61533847667385,1838.1488588091224,0.172,0.345,0.337,0.014,1.391,58.55805099461045,1840.7849835096363,326,0.965925925925926,1,0,1,2,FALSE,FALSE,FALSE
14,2021-11-12T21:23:40Z,2021-11-12T21:57:52Z,2051,1,2021-11-12T21:57:54Z,0.8999999761581421,Chrome,95.0.4638.69,Windows NT 10.0,1366,768,N/A; thank you!!,1.7786458333333333,704,88,941,81,67,102,-0.21890819101731726,-0.016392388875888245,2.472089792528604,-0.28737195225343287,-0.06830278120231312,-0.057035382828693984,4,4,1,2,4,1,3,4,1,4,3,1,1,1,4,4,2,1,4,4,1.3869694338832115,0,1,1,2,2,1.25,0,2,5,3,5,2,3,4,4,3,1,3,3,2,3,4,2,3,4,1,1,4,3,1,7,2,1,2,5,4,3,5,4,5,5,5,3,1,4,1,1,3,1,5,2,2,2,1,3,2,2,1,1,1,1,1,2,1,1,4,2,1,1,1,1,1,2,1,1,1.5339011874475008,1.1254628677422756,2.375,0,1.25,0,2.466666666666667,0,1.6666666666666667,0,1.6666666666666667,0,1.5,0,1.2857142857142858,0,1,0,1.5675675675675675,0,4,1,2,-0.1032596633017564,0.713062832016679,0.3049015843574613,5,1,5,1,1,1,1,1,1,1.9518001458970664,1,0,1,-0.9031185640466358,5,5,5,5,4,3,1,6,8,6,4,1.5275252316519468,4.571428571428571,0,1.4285714285714286,2,3.8333333333333335,3.2559414990859232,-1.3043345419688306,0,-1.2256188164099486,2,2,2,2,2,2,5,2,2,3,1,4,1,4,4,2,4,2,5,3,1.3345232785352157,2,0,4.2,0,4.4,0,3.8,0,4.133333333333334,0,1,1,1,3,1,2,1,3,2,3,2,4,2,2,2,4,1,3,2,1,0.998683343734455,1.65,0,"White, Caucasian, Anglo, European American",0,30,1,2,NA,1,1,6,Currently unemployed,1,0,125,67,4,5,2,1,1,0,0,2,TRUE,TRUE,TRUE,TRUE,TRUE,4,0.7646774193856024,0.62,0.07912295564796706,4,0.42638064509053386,0.510173333311081,0.96875,0.9375,0.0034786586987303352,0.005321731837819333,4,0.5285187499672175,0.6206499999682108,1,0.9375,0.00918655577071163,0.00943996587942089,1.4592,0.3443,0.2709,0,42.4399,0.004,ML,change,50,-73.14373098371557,0.4121226794179739,1.1878701410222732,0.4187988156553172,0.8426,3.1483,0.3878,3.9829,0.3273,0,-79.205,0.01,ML,cueing,64,170.88664925007902,3.4513096857456222,0.7846442213768371,0.410709107231872,4.35620051077847,0.7882987011246366,0.3415555744268009,0.067,0.36,0.418,0.015,1.857,78.12014280487675,1936.671649945356,0.074,0.363,0.475,0.016,1.987,93.56402777580045,1944.3057626361494,326,0.965925925925926,1,0,0,1,FALSE,FALSE,FALSE
15,2021-11-12T21:44:46Z,2021-11-12T22:07:49Z,1383,1,2021-11-12T22:07:50Z,1,Chrome,91.0.4472.114,Macintosh,1440,900,NA,1.6,705,56,339,73,62,94,-0.216338823999755,-0.30710401489772066,-0.4260821663043371,-0.38486320452578127,-0.1373630793865373,-0.19216631691551858,3,3,2,1,3,1,1,3,1,3,3,2,2,1,3,3,1,1,3,3,0.9333020044867296,0,1,1,4,4,1.65,0,4,4,2,4,3,2,4,2,2,2,3,5,2,4,5,2,3,1,1,1,3,2,3,0,2,0,0,5,3,5,4,4,5,5,5,5,2,4,1,1,5,2,5,2,3,3,3,1,5,1,1,1,1,1,1,1,2,1,4,3,2,1,1,1,1,1,1,2,1.6476391336438676,1.1464230084422218,2,0,1.25,0,2,0,1.4444444444444444,0,1.8333333333333333,0,0.8333333333333334,0,1.5714285714285714,0,1,0,1.5135135135135136,0,0,0,0,-0.4881943776477256,-0.6588395645607719,-0.5735169711042487,4,2,4,1,2,2,1,2,1,1.2535663410560174,1.7142857142857142,0,1.5,-0.2912888008837234,5,5,5,5,3,2,1,8,8,5,4,1.7043362064926932,4.285714285714286,0,1.7142857142857142,1,3.8333333333333335,3.2559414990859232,-1.869097951893479,0,-1.3486585265293993,2,2,3,3,3,2,4,2,2,3,1,2,2,4,5,2,5,1,4,3,1.3201731488169053,2.6,0,4.2,0,3.8,0,4,0,4,0,2,1,1,3,2,2,2,2,1,3,2,4,2,1,2,4,2,2,2,1,0.8870412083230169,1.75,0,"White, Caucasian, Anglo, European American",0,29,1,2,NA,1,3,7,Teacher,5,0,155,63,3,5,2,0,0,1,0,0,TRUE,TRUE,TRUE,TRUE,TRUE,1,0.9518543478302334,0.92,0.016351335685178818,1,0.4511933332125346,0.5524129032627229,0.9375,1,0.0022516503220970396,0.003915803825280631,1,0.5787593750059604,0.7037499999701977,1,1,0.004875701847163053,0.003494584518905762,1.3887,2.0299,0.6733,0,-9.8457,0.005,ML,change,50,31.42746901628444,2.4475204939692543,0.9978862450333729,0.7806148325956445,1.5231,4.4238,0.3803,3.8554,0.2746,0,-65.4942,0.01,ML,cueing,63,143.4178041791746,4.593114403464644,0.9020316853563051,0.4572875571000222,4.279292182742807,0.6328266651253732,0.3864953284563142,0.144,0.36,0.678,0.009,1.411,122.29769886802934,1930.685932917939,0.151,0.363,0.731,0.011,1.584,122.57020830761758,1907.4827506811707,437,1.2948148148148149,1,0,0,1,FALSE,FALSE,FALSE
16,2021-11-12T21:58:52Z,2021-11-12T22:23:46Z,1493,1,2021-11-12T22:23:52Z,0.8999999761581421,Chrome,95.0.4638.69,Windows NT 10.0,1360,768,None,1.7708333333333333,720,53,333,90,66,95,-0.17779831873632074,-0.33435822983726743,-0.454967601109981,-0.17769429344704088,-0.08211484083915795,-0.1752749501546655,2,2,3,3,2,2,1,2,1,2,2,3,3,3,2,3,1,2,2,2,0.6708203932499369,0,1,1,4,4,2.55,0,4,4,2,4,3,1,4,2,3,1,2,4,2,4,3,1,1,1,1,1,1,1,1,2,4,0,0,4,4,5,3,2,4,4,5,4,3,4,1,1,4,4,1,1,1,1,1,2,5,1,1,1,1,1,1,2,1,1,4,1,2,1,1,1,1,1,2,1,1.502750231494994,1.1254628677422756,1,0,1.25,0,2.066666666666667,0,2.111111111111111,0,2,0,0.8333333333333334,0,1.2857142857142858,0,1,0,1.6756756756756757,0,1,0,0,-0.8196040990257993,-0.4557470907642554,-0.6376755948950273,2,3,1,3,1,4,3,5,1,1.1338934190276817,3.2857142857142856,0,3,1.202331747984437,3,3,4,3,1,1,3,1,6,3,3,1.1338934190276817,2.5714285714285716,0,3.4285714285714284,5.5,3.8333333333333335,3.2559414990859232,0.6723373927674386,0,0.8781111148583004,2,3,3,2,3,3,4,2,3,2,4,3,3,4,3,4,3,1,4,3,0.8837151016885368,2.6,0,3.2,0,3,0,3.4,0,3.2,0,2,2,3,2,3,3,3,2,2,1,2,2,3,3,2,2,1,1,1,2,0.7181848464596079,2.3,0,"Hispanic of Latino (e.g., Mexican American, Central American, and others)",0,26,0,1,NA,1,2,4,Part time employed and student,2,0,168,70,4,5,2,0,0,1,0,0,TRUE,TRUE,TRUE,TRUE,TRUE,6,0.7918545454545793,0.8979591836734694,0.07293664807853319,6,0.5004677419358444,0.5766033333331346,0.96875,0.9375,0.010441729032231615,0.008766817247975399,6,0.6216586206890643,0.6261599999999007,0.9354838709677419,0.9375,0.01728918262363172,0.007168919314474632,1.4399,1.6201,0.4391,0,4.4353,0.004,ML,change,49,2.8048608943318794,1.5601270161651335,1.393958119403511,0.43628193532415593,0.9605,2.8924,0.4277,3.8327,0.3833,0,-68.7786,0.012,ML,cueing,64,150.03384925007902,3.046398329546932,0.8889350334908299,0.4489414076485583,3.3095405918744945,1.0376023829156802,0.35350591944426835,0.058,0.425,0.313,0.021,1.342,182.74227604094057,2137.467476640337,0.057,0.428,0.303,0.018,1.405,218.14790014158683,2149.8716433547465,104,0.3081481481481481,1,0,0,1,FALSE,FALSE,FALSE
17,2021-11-12T22:07:46Z,2021-11-12T22:32:17Z,1470,1,2021-11-12T22:32:18Z,0.4000000059604645,Safari,13.0.5,Macintosh,1280,800,no,1.6,633,142,363,144,52,93,-0.4013332492642393,0.47418348003595395,-0.3105404270817614,0.48037165939131105,-0.2754836757549857,-0.20905768367637165,3,3,2,1,3,2,3,4,3,3,3,2,2,3,3,2,2,1,2,3,0.7608859102526822,0,1,2,4,4,2.1,0,4,4,2,4,2,1,3,3,2,1,2,4,3,2,4,4,3,5,1,1,2,2,2,0,1,0,1,5,4,4,5,5,4,4,5,5,2,3,1,1,4,3,4,5,3,3,2,2,1,2,5,1,5,2,1,1,1,1,5,2,3,1,3,2,3,2,1,1,1.536346432403955,1.0997835284835873,2.5,0,1.75,0,2.2,0,1.4444444444444444,0,2.4166666666666665,0,3.1666666666666665,0,1.2857142857142858,0,2,0,2.108108108108108,0,0,0,1,0.06815582050682095,-0.32558751222710886,-0.12871584586014395,5,1,5,1,1,2,1,1,2,1.889822365046136,1.1428571428571428,0,1.5,-0.6331575415043005,4,3,4,4,4,3,2,1,3,4,3,0.7867957924694432,3.7142857142857144,0,2.2857142857142856,7,3.8333333333333335,3.2559414990859232,1.5194825076544112,0,0.6643156929302927,3,2,2,3,3,4,5,4,3,3,1,4,4,4,3,2,5,1,4,5,1.3020130933435712,2.6,0,4.2,0,3.6,0,2.6,0,3.466666666666667,0,3,2,1,2,3,1,2,3,2,3,2,3,2,2,1,2,1,1,1,2,0.7591546545162482,1.95,0,"Hispanic of Latino (e.g., Mexican American, Central American, and others) & White, Caucasian, Anglo, European American",1,21,0,1,NA,0,3,4,student,3,0,119.05,67,3,5,2,0,0,2,0,0,TRUE,TRUE,TRUE,TRUE,TRUE,4,0.8236190476190379,0.84,0.050091154693875005,4,0.40571875,0.4669333333333333,1,0.967741935483871,0.0013853054435491604,0.006540703225807003,4,0.6704062500000013,0.7580666666666701,1,0.9375,0.010106700604839033,0.016929661290322546,1.3998,1.3136,0.4848,0,11.4197,0.004,ML,change,50,-11.103330983715564,1.4032714344621247,1.1816873313886938,0.5373068753583974,1.2845,3.9241,0.3105,5.838,0.2957,0,-85.7524,0.009,ML,cueing,63,183.93420417917457,3.702955383747642,0.9185088744493362,0.350911109414655,5.95560806234913,0.6956694737157224,0.34913932136678993,0.066,0.503,0.391,0.017,1.68,51.40500538509753,1896.9615037831989,0.07,0.497,0.386,0.017,1.813,54.74113741189264,1898.172731518886,418,1.2385185185185186,1,0,0,1,FALSE,FALSE,FALSE
19,2021-11-12T22:02:26Z,2021-11-12T22:40:35Z,2288,1,2021-11-12T22:40:36Z,1,Chrome,95.0.4638.69,Windows NT 10.0,1280,720,N/A,1.7777777777777777,1371,40,435,142,113,82,1.4948596096967248,-0.45245982790863687,0.03608479058596582,0.4559988463232239,0.5670519620925495,-0.39486271804575546,2,2,3,3,2,2,2,2,2,2,2,2,2,2,2,2,2,2,2,2,0.30779350562554625,0,1,1,3,3,2.6,0,4,5,4,5,4,1,4,2,2,2,1,4,3,5,4,2,2,1,2,2,2,2,2,1,2,1,1,4,5,4,4,4,4,4,4,4,1,5,3,1,4,4,3,2,3,3,4,4,3,3,1,1,1,1,1,2,1,1,4,2,2,1,1,1,2,2,1,1,1.3917388177876397,1.3972762620115438,1.875,0,1.5,0,2,0,1.8888888888888888,0,2.5833333333333335,0,1.5,0,1.4285714285714286,0,1,0,1.945945945945946,0,1,1,1,-0.35607572411937555,0.005736966445190152,-0.1751693788370927,4,2,3,1,1,1,2,1,1,1.1547005383792515,1.7142857142857142,0,1,-0.4757826382709144,4,4,4,4,2,3,2,1,8,3,3,0.9511897312113419,3.5714285714285716,0,2.4285714285714284,4.5,3.8333333333333335,3.2559414990859232,0.10757398284279028,0,0.038032427945918976,2,4,3,3,3,2,4,2,2,4,1,5,2,2,3,2,4,2,5,4,1.2798809468443688,3,0,4.4,0,4.2,0,3,0,3.8666666666666667,0,2,2,3,1,3,2,2,1,1,1,3,3,3,3,2,3,1,3,3,3,0.8506963092234007,2.45,0,"Asian or Asian American (e.g., Chinese, Japanese, and others)",0,21,1,2,NA,0,3,3,Student,2,0,104,63,1,5,2,1,0,1,0,1,TRUE,TRUE,TRUE,TRUE,TRUE,5,1.0950250000001862,0.8163265306122449,0.24057081266145336,5,0.4909172413796187,0.679753333333383,0.9354838709677419,0.9375,0.08098100698938134,0.23233058240928392,5,0.546512499999837,0.6515218749999767,1,1,0.0068864514516115615,0.011847543054418225,1.9876,0.8302,0.3872,0,49.3484,0.004,ML,change,49,-87.02133910566812,0.8706485662650586,1.7132686305068816,0.47255533440374276,1.2852,1.4592,0.3183,2.5819,0.3035,0,-7.9576,0.007,ML,cueing,63,28.344604179174596,1.342674007615796,2.0169081889884284,0.02255931030368108,1.7344965187214298,1.541743451522033,0.10382830861952158,0.116,0.338,0.544,0.013,1.473,38.837193651199904,1823.7972063938957,0.118,0.333,0.549,0.013,1.544,51.311259304835744,1833.6805255677984,368,1.0903703703703704,1,0,3,4,FALSE,FALSE,FALSE
20,2021-11-12T22:09:08Z,2021-11-12T22:41:14Z,1926,1,2021-11-12T22:41:16Z,1,Chrome,95.0.4638.69,Windows NT 10.0,1536,864,NA,1.7777777777777777,763,103,500,119,131,142,-0.06731553698114262,0.1198786858218457,0.3490103343137751,0.17571149604022218,0.8156690355557566,0.618619287605429,2,3,1,1,2,1,1,2,1,3,2,1,1,2,2,3,1,1,2,2,0.7326950970650465,0,1,4,3,3,1.9,0,5,4,3,4,5,2,3,2,2,2,2,4,2,4,4,2,2,1,2,1,1,1,1,3,2,0,0,4,5,5,4,4,5,3,5,5,3,4,1,2,5,2,3,4,1,1,1,1,5,1,1,1,3,1,1,2,1,1,5,2,2,1,2,1,2,1,1,1,1.619605854250695,1.1464230084422218,1.375,0,1.25,0,2.2666666666666666,0,1.5555555555555556,0,1.8333333333333333,0,1.1666666666666667,0,1.2857142857142858,0,1.3333333333333333,0,1.5675675675675675,0,2,0,0,-0.6189579680629647,-0.25265461696773905,-0.43580629251535186,3,4,3,2,3,3,2,1,1,0.6900655593423543,2.857142857142857,0,1,0.20795484297024003,4,5,5,3,3,3,2,6,1,2,3,1.1338934190276817,3.857142857142857,0,2.142857142857143,5.5,3.8333333333333335,3.2559414990859232,0.6723373927674386,0,0.16107213806536974,1,2,2,1,1,2,4,2,2,3,1,4,3,4,4,2,4,2,3,3,0.990430401872025,1.4,0,4.2,0,3.4,0,3.8,0,3.8,0,2,1,1,3,1,1,2,2,2,1,1,3,1,1,1,3,1,1,1,2,0.7591546545162482,1.45,0,"Hispanic of Latino (e.g., Mexican American, Central American, and others)",0,22,1,2,NA,1,3,7,Engineer,3,0,115,63,1,5,2,1,1,0,0,2,TRUE,TRUE,TRUE,TRUE,TRUE,3,0.9916636363737511,0.673469387755102,0.05409282938603563,3,0.5515612903218116,0.62767666665713,1,1,0.012858842452420286,0.007681085985795044,3,0.608018750000745,0.6681312499940395,1,1,0.017231462857402804,0.016045314477288568,1.4585,0.5385,0.5524,0,34.6989,0.006,ML,change,49,-57.72233910566813,0.6611054437605123,1.0950126731809833,0.7043400637220135,2.2189,5.129,0.4114,4.8548,0.323,0,-65.0592,0.01,ML,cueing,61,142.45102159251994,3.88111791592099,1.0675106544420374,0.49444817825582876,3.412023593163135,1.2142749348783421,0.3791813505229674,0.129,0.273,0.388,0.016,1.398,64.83239848615786,1873.7124439151787,0.131,0.271,0.388,0.017,1.509,87.96298038531249,1871.8708207105417,330,0.9777777777777777,1,0,0,1,FALSE,FALSE,FALSE
21,2021-11-12T22:19:45Z,2021-11-12T22:47:30Z,1664,1,2021-11-12T22:47:31Z,0.8999999761581421,Chrome,95.0.4638.69,Windows NT 10.0,1366,768,no,1.7786458333333333,755,97,434,104,78,111,-0.08787047312164088,0.06537025594275213,0.03127055145169184,-0.007084601970431121,0.08362987480298012,0.0949869180189837,3,3,2,2,3,1,2,3,1,4,3,4,4,1,3,4,4,2,3,3,1.019545822516343,0,1,1,4,2,2.05,0,3,3,5,1,5,5,2,5,3,5,4,2,2,1,1,5,5,2,1,5,5,5,5,1,4,0,0,5,1,1,1,2,5,1,2,3,1,1,5,2,2,3,4,5,5,5,5,4,2,1,5,1,3,1,1,1,1,1,1,5,5,2,5,3,2,1,1,1,1.710241189108988,1.5976172734359604,4.125,0,1.25,0,4.2,0,3.6666666666666665,0,3.8333333333333335,0,2.3333333333333335,0,2.5714285714285716,0,3.3333333333333335,0,3.324324324324324,0,1,0,0,2.1486616502444646,-0.4557470907642554,0.8464572797401047,5,1,5,1,1,2,4,1,1,1.889822365046136,1.5714285714285714,0,1,-0.5612498234260587,3,3,3,3,1,1,5,4,6,3,1,1.3801311186847085,2.142857142857143,0,3.857142857142857,4,3.8333333333333335,3.2559414990859232,-0.1748077221195339,0,0.6935515496791245,2,3,3,3,3,1,5,1,1,1,1,5,2,4,5,3,5,3,4,4,1.6903085094570331,2.8,0,4.6,0,3.4,0,4.2,0,4.066666666666666,0,3,4,4,2,3,4,4,3,2,2,3,2,1,4,2,2,4,4,1,4,1.0711528467275955,3,0,"White, Caucasian, Anglo, European American",0,26,1,2,NA,1,2,4,Caregiver,1,0,165,65,3,5,2,0,0,1,0,0,TRUE,TRUE,TRUE,TRUE,TRUE,5,1.1427500000012418,0.72,0.24515518605829242,5,0.4589624999994412,0.5209666666651765,1,0.9375,0.0020326069354378363,0.005592460877136473,5,0.6563312499998137,0.766737500000745,1,1,0.011822138347119836,0.017611547580263502,1.9952,0.4515,0.5583,0,54.6313,0.003,ML,change,50,-97.52653098371557,0.5810935306786392,1.6253177138934018,0.5274103374877824,1.3961,3.0351,0.3142,6.2593,0.3474,0,-76.0975,0.011,ML,cueing,64,164.671649250079,3.4087601040456796,0.794438481572278,0.41900383411636716,5.411269247624845,0.7656493397015993,0.39042748872075766,0.172,0.347,0.551,0.012,1.333,43.92312911434753,1846.3137092238253,0.169,0.34,0.536,0.011,1.419,64.96717130568749,1848.2617780326468,104,0.3081481481481481,1,1,0,1,FALSE,FALSE,FALSE
22,2021-11-12T22:29:16Z,2021-11-12T22:54:24Z,1508,1,2021-11-12T22:54:26Z,1,Chrome,95.0.4638.69,Windows NT 10.0,1536,864,NA,1.7777777777777777,753,81,394,100,63,72,-0.09300920715676544,-0.07998555706816408,-0.1612990139192677,-0.05583022810660534,-0.12355101974969247,-0.5637763856542862,2,1,2,1,1,4,4,1,3,2,3,3,1,1,1,1,3,2,3,2,1.050062654772261,0,1,1,4,4,2.85,0,3,4,2,4,4,2,1,2,2,2,1,4,2,4,4,2,3,1,1,1,2,2,3,6,2,0,0,4,4,4,3,2,4,3,4,3,4,4,2,1,3,2,4,1,1,3,4,2,4,1,1,1,4,4,1,3,3,1,5,1,2,1,2,1,3,1,2,1,1.2985323200391226,1.162919151265879,1.875,0,1.75,0,2.3333333333333335,0,2.5555555555555554,0,2.25,0,2,0,1.5714285714285714,0,1.3333333333333333,0,2.135135135135135,0,3,0,0,-0.13152240823236297,0.10724026226325957,-0.0121410729845517,4,2,3,1,1,2,1,1,3,1.1547005383792515,1.7142857142857142,0,2,-0.10679496349653231,4,3,3,3,2,2,3,7,7,3,2,0.6900655593423543,2.857142857142857,0,3.142857142857143,2,3.8333333333333335,3.2559414990859232,-1.3043345419688306,0,-0.2695668473527077,2,3,3,4,3,2,4,4,3,2,1,4,2,4,4,2,4,2,3,4,1.0690449676496976,3,0,4.2,0,3.4,0,3,0,3.533333333333333,0,1,3,3,3,3,4,3,3,1,2,4,3,4,4,2,3,3,3,1,2,0.9665456669582609,2.55,0,"Hispanic of Latino (e.g., Mexican American, Central American, and others) & White, Caucasian, Anglo, European American",1,27,1,2,NA,1,3,8,Lawyer,5,0,215,67,1,5,2,0,1,1,0,1,TRUE,TRUE,TRUE,TRUE,TRUE,3,1.0055894736843674,0.7916666666666666,0.04085619283241332,3,0.46871875,0.5428906249997671,1,1,0.004450998991880109,0.0038870002317387873,3,0.6698687499994412,0.7561312499991618,1,1,0.006790331249905847,0.004374800927467103,1.3402,1.0797,0.6616,0,15.199,0.006,ML,change,48,-18.784396967276326,1.2362560882673557,1.0798742100460574,0.7508175746801227,2.8381,7.1381,0.3441,7.1611,0.2706,0,-91.3813,0.015,ML,cueing,64,195.239249250079,4.601599876722714,0.9003683148006116,0.44811578273509145,4.4483414965356936,0.9313886376794921,0.3673008683631368,0.192,0.369,0.639,0.013,1.447,53.38206240039111,1854.2360072195843,0.19,0.38,0.648,0.014,1.447,71.23605826942739,1851.918948328009,392,1.1614814814814816,1,0,0,1,FALSE,FALSE,FALSE
23,2021-11-12T22:27:46Z,2021-11-12T22:55:17Z,1650,1,2021-11-12T22:55:18Z,1,Chrome,95.0.4638.69,Windows NT 10.0,1536,864,N/A,1.7777777777777777,670,92,505,120,82,119,-0.30626666961443483,0.01994656437684081,0.37308152998514504,0.18789790257426575,0.1388781133503595,0.2301178521058083,3,3,2,2,2,1,1,3,1,3,3,1,2,2,3,3,1,1,2,2,0.8255779474818965,0,1,4,3,3,1.85,0,5,5,2,5,2,1,5,2,1,2,1,4,1,5,4,1,2,1,1,1,1,1,1,0,2,0,0,4,5,3,5,5,5,3,5,4,1,5,1,2,3,2,3,2,1,1,2,2,4,1,1,1,2,1,1,1,1,1,5,1,2,1,1,1,2,1,2,2,1.5716138106958624,1.7320508075688772,1.125,0,1.75,0,1.4,0,1.6666666666666667,0,1.75,0,1.1666666666666667,0,1,0,1,0,1.4864864864864864,0,0,0,0,-1.1336883706005216,-0.5020371591262895,-0.8178627648634056,3,2,3,1,1,2,2,1,1,0.816496580927726,2,0,1,-0.3048482679606258,5,5,5,4,3,3,1,3,3,2,2,1.4960264830861913,4.285714285714286,0,1.7142857142857142,6,3.8333333333333335,3.2559414990859232,0.9547190977297628,0,0.06324999828222155,2,2,2,3,2,2,3,2,2,1,1,4,3,3,5,2,5,2,3,3,1.2227992865708155,2.2,0,4.4,0,2.8,0,3.8,0,3.6666666666666665,0,1,1,1,3,3,1,1,2,1,1,1,3,1,2,1,3,1,2,1,2,0.8207826816681233,1.5,0,"Asian or Asian American (e.g., Chinese, Japanese, and others)",0,20,0,1,NA,1,2,3,full time student,1,0,133,68,2,5,2,0,0,1,0,0,TRUE,TRUE,TRUE,TRUE,TRUE,4,0.8770547619047742,0.8571428571428571,0.25828227500001,4,0.47334193548386644,0.5223062500000014,1,1,0.0043476191827964365,0.0026575025403204875,4,0.5698718749999753,0.6431812500000087,1,1,0.011832676925406781,0.01860986415322154,1.6873,1.1125,0.361,0,30.2276,0.003,ML,change,49,-48.77973910566812,0.9886993366559182,1.81223897174679,0.2224288506703188,1.98,7.2168,0.3851,6.2353,0.3146,0,-97.5608,0.009,ML,cueing,63,207.55100417917458,5.060507493366095,0.8187192157748681,0.4439411609924625,4.474552626261884,0.925932729469935,0.37310874944316874,0.246,0.146,0.564,0.029,1.724,43.747596667520526,1830.686265966899,0.241,0.143,0.563,0.023,1.745,50.95933351487188,1831.6370578046462,386,1.1437037037037037,1,0,0,1,FALSE,FALSE,FALSE
24,2021-11-12T22:39:01Z,2021-11-12T23:03:05Z,1443,1,2021-11-12T23:03:08Z,1,Chrome,95.0.4638.69,Macintosh,1440,900,NA,1.6,716,68,369,88,52,98,-0.1880757868065699,-0.1980871551395335,-0.28165499227611746,-0.202067106515128,-0.2754836757549857,-0.12460084987210628,2,2,1,1,2,1,2,1,1,3,1,2,2,2,2,2,2,1,2,2,0.5712405705774795,0,1,1,3,3,2.3,0,1,4,2,4,3,3,4,3,2,3,3,4,2,3,3,2,5,5,2,2,2,4,2,1,3,2,6,3,4,4,4,4,4,4,4,4,1,5,2,1,4,2,5,3,3,2,2,2,1,4,5,5,5,1,1,2,2,2,4,2,3,1,1,1,2,2,2,2,1.4099602788688723,0.8837151016885368,3,0,2,0,2.6666666666666665,0,2.111111111111111,0,1.8333333333333333,0,4,0,1.8571428571428572,0,1,0,2.2432432432432434,0,1,2,6,0.5416535883168487,1.2514208139685998,0.8965372011427243,4,2,3,2,2,2,2,8,5,0.7867957924694432,2.142857142857143,0,6.5,1.8100511284536203,3,4,4,4,1,1,3,6,6,2,2,1.3451854182690985,2.857142857142857,0,3.142857142857143,3,3.8333333333333335,3.2559414990859232,-0.7395711320441822,0,0.012814857609616537,3,3,3,3,3,3,5,3,2,5,2,3,3,2,4,1,4,1,5,2,1.3627702877384937,3,0,3.8,0,4.6,0,3.4,0,3.933333333333333,0,2,3,3,3,3,4,3,1,3,3,4,2,3,3,2,2,3,3,3,3,0.6958523739384593,3,0,"Hispanic of Latino (e.g., Mexican American, Central American, and others)",0,20,1,3,NA,1,2,4,Teacher Assistant,1,0,160,62,3,5,2,0,0,1,0,0,TRUE,TRUE,TRUE,TRUE,TRUE,4,1.5061000000019558,0.6666666666666666,0.43405604040769585,4,0.5911406250018626,0.6670516129025529,1,0.96875,0.008561564425707708,0.011679715444033909,4,0.8263406249987892,1.0022516129021684,1,1,0.027641856683509092,0.01588851991351925,2.2482,0.333,0.3583,0,76.1638,0.004,ML,change,48,-140.71399696727633,0.37688147202215133,1.8391649152739598,0.6927740377721728,1.486,2.931,0.4343,4.1433,0.4118,0,-53.2203,0.009,ML,cueing,64,118.91724925007901,3.218123830364665,1.0670773983535682,0.51162175474773,3.7772367992216647,1.0968692053527767,0.45048330072390635,0.264,0.335,0.52,0.004,1.112,67.97248834401225,1851.965466271415,0.264,0.336,0.552,0.004,1.084,63.995963860976545,1853.966521778102,104,0.3081481481481481,1,0,0,1,FALSE,FALSE,FALSE
25,2021-11-12T22:39:18Z,2021-11-12T23:08:47Z,1769,1,2021-11-12T23:08:48Z,1,Chrome,95.0.4638.69,Windows NT 10.0,1280,720,NA,1.7777777777777777,789,99,491,83,101,89,-5.119945245232906e-4,0.08353973256911665,0.3056821821053092,-0.26299913918534573,0.40130724645041144,-0.27662315071978394,3,3,2,3,3,3,4,2,1,3,3,2,1,3,3,4,3,1,2,4,0.9333020044867296,1,1,1,3,2,2.15,0,5,4,2,4,4,1,2,1,3,3,1,4,2,5,4,1,2,1,1,1,1,1,2,1,2,0,0,3,5,4,1,3,2,1,4,4,3,4,1,1,4,1,4,5,1,3,4,4,3,1,1,1,3,1,1,3,3,1,5,1,1,1,1,1,4,4,2,3,1.4632638658632766,1.4142135623730951,1.25,0,3.25,0,2.066666666666667,0,3,0,2.4166666666666665,0,1.5,0,1.4285714285714286,0,1,0,2.1621621621621623,0,1,0,0,-0.5031000718919498,0.1714625309736735,-0.16581877045913818,5,1,3,1,1,1,1,1,2,1.5735915849388864,1.2857142857142858,0,1.5,-0.5476903563491562,5,5,5,3,3,2,1,8,6,NA,3,1.618347187425374,4,0,2,2,3.8333333333333335,3.2559414990859232,-1.3043345419688306,0,-0.9069348267242017,1,2,2,4,2,1,3,1,2,1,2,3,3,4,3,4,1,1,4,2,1.1751393027860062,2.2,0,3.6,0,2.6,0,4,0,3.4,0,1,3,1,1,1,2,1,3,3,2,1,4,3,2,1,3,2,2,2,1,0.9445132413883326,1.85,0,Middle Eastern,0,20,1,2,NA,1,3,3,student,3,0,125,62,3,5,2,0,0,1,0,0,TRUE,TRUE,TRUE,TRUE,TRUE,3,1.6458677419354357,0.6326530612244898,0.4137756466670948,3,0.703855172414461,1.0107206896548642,0.9666666666666667,0.9666666666666667,0.1612462465400888,0.2919489261599003,NA,NA,NA,NA,NA,NA,NA,2.3779,0.2444,0.4333,0,85.7188,0.003,ML,change,49,-159.76213910566813,0.30180536637954103,1.8012119966924243,0.8541777592760589,1.9018,1.4776,0.3941,1.9742,0.2415,0,17.1504,0.008,ML,cueing,60,-22.017766313333702,1.4256547224216043,2.3619294188334856,0.23757855961883723,1.6537454946846888,2.036163267449142,0.12927490727470858,NA,NA,NA,NA,NA,NA,NA,NA,NA,NA,NA,NA,NA,NA,104,0.3081481481481481,1,0,0,1,FALSE,FALSE,FALSE
26,2021-11-12T22:38:41Z,2021-11-12T23:13:35Z,2093,1,2021-11-12T23:13:36Z,1,Chrome,92.0.4515.159,Windows NT 10.0,1366,768,"You didn't ask about if we had 1 parent or not growing up. I have only ever had a mother, never a father in the picture. I tried to convey this in answers, but it was all clicking buttons. I may have answered the divorce question wrong, but they were never married so I didn't think of it initially. If you ever do this study again, I suggest setting up the answers first asking if the participant has a single parent household or not, which parent it is, and then continuing from there, so the data can include whether or not its 2 parent, single father, or single mother. These environmental factors play into whether or not for instance someone would get in a fight or not, even if they lived in a more dangerous or more safe neighborhood. The format of the ""'at least one parent"" sort of includes this but negligence from 2 whole parents vs 1 parent/1 not negligent vs only 1 parent vs only 1 negligent parent are differnt dynamics.",1.7786458333333333,690,100,659,88,147,100,-0.2548793292631892,0.09262447088229891,1.1144743566633393,-0.202067106515128,1.036661989745274,-0.09081811635040013,2,2,3,3,1,2,3,1,1,2,2,3,4,4,1,1,4,2,1,1,1.0894228312566052,0,1,1,3,2,3.25,0,2,2,5,2,5,3,1,5,4,3,4,2,3,2,1,3,3,1,2,2,4,5,3,5,2,0,0,4,5,1,4,5,5,5,5,4,3,4,3,1,1,3,5,5,3,3,5,5,1,2,5,1,5,3,1,3,1,2,2,5,4,1,2,1,2,2,2,1,1.5957902576925787,1.3870146083619754,2.875,0,1.75,0,4.133333333333334,0,1.7777777777777777,0,3.25,0,3.3333333333333335,0,2.7142857142857144,0,1.3333333333333333,0,2.7027027027027026,0,3,0,0,1.3156849965704867,0.10724026226325957,0.7114626294168731,3,3,2,3,3,5,2,1,1,1,3.2857142857142856,0,1,0.4643563984356728,4,4,2,2,1,1,5,6,1,1,1,1.6035674514745464,2.142857142857143,0,3.857142857142857,5.5,3.8333333333333335,3.2559414990859232,0.6723373927674386,0,1.1171241071226108,3,2,3,3,2,1,5,2,1,4,1,5,1,5,5,1,5,1,5,2,1.9073791542572855,2.6,0,5,0,4.8,0,4.6,0,4.8,0,2,1,4,2,3,4,4,2,4,2,4,2,3,4,2,2,1,4,4,4,1.1192102478745307,3.1,0,"White, Caucasian, Anglo, European American",0,22,1,2,NA,1,1,5,student,1,0,200,64,2,5,2,0,0,0,0,0,TRUE,TRUE,TRUE,TRUE,TRUE,5,1.0152051282052237,0.78,0.22102502866935056,5,0.5971156249998603,0.6701093750001164,1,1,0.010192976844729376,0.014367682167323486,5,0.6564875000002212,0.7219812500000699,1,1,0.018941939838805093,0.014262549314493351,1.6257,0.7875,0.4517,0,41.7095,0.003,ML,change,50,-71.68293098371556,0.7744252375405246,1.634329967539372,0.42429929413873246,1.5575,3.9964,0.4752,3.7298,0.3883,0,-60.1127,0.009,ML,cueing,64,132.702049250079,3.3186833487779412,1.2484272498963132,0.48789646535593423,3.6160733803473106,1.1457551577655207,0.44364109719883127,0.234,0.245,0.566,0.019,1.435,43.18925237672738,1844.3233895939704,0.228,0.246,0.561,0.018,1.519,58.974742236530794,1842.5562722743525,365,1.0814814814814815,1,0,0,1,FALSE,FALSE,FALSE
27,2021-11-12T22:43:50Z,2021-11-12T23:13:49Z,1798,1,2021-11-12T23:13:51Z,1,Chrome,95.0.4638.69,Windows NT 10.0,1536,864,NA,1.7777777777777777,861,89,458,77,68,131,0.184482430739961,-0.0073076505627059805,0.14681229067426757,-0.3361175783896071,-0.054490721565468275,0.43281425323604517,2,2,2,3,2,2,2,2,1,2,2,2,3,3,2,2,2,1,2,2,0.5104177855340404,0,1,2,5,4,2.55,0,2,3,4,3,5,3,3,3,2,3,3,3,2,3,2,1,3,1,1,2,2,3,2,2,2,0,0,5,4,3,4,5,5,3,3,4,3,4,2,2,3,2,5,4,3,3,4,4,3,1,1,1,2,1,2,2,3,2,3,3,3,1,1,1,2,1,2,2,1.2586040219561052,0.7988086367179802,1.875,0,1.75,0,3.2,0,2,0,2.75,0,1.3333333333333333,0,2.4285714285714284,0,1,0,2.189189189189189,0,1,0,0,0.2641560207961311,-0.2989446853297732,-0.01739433226682105,4,1,3,1,1,2,2,1,1,1.1547005383792515,1.7142857142857142,0,1,-0.4757826382709144,5,4,5,4,3,1,2,6,6,4,3,1.5118578920369088,3.7142857142857144,0,2.2857142857142856,3,3.8333333333333335,3.2559414990859232,-0.7395711320441822,0,-0.465211126919004,4,3,3,4,4,3,5,3,3,3,3,3,5,2,4,3,3,2,3,3,0.8618916073713346,3.6,0,3.2,0,3,0,3,0,3.066666666666667,0,2,4,4,3,4,3,4,1,1,1,3,2,2,3,1,3,3,3,2,4,1.0894228312566052,2.75,0,"White, Caucasian, Anglo, European American",0,18,1,2,NA,1,3,4,student,5,0,165,63,3,5,2,0,0,1,0,0,TRUE,TRUE,TRUE,TRUE,TRUE,1,0.8565363636369054,0.66,0.08779950628873678,1,0.42161562500102445,0.4971866666674614,1,0.9375,0.002205771038216012,0.006072185876910743,1,0.6324281249986962,0.8615032258072207,1,0.96875,0.017245356280493392,0.036395634152822834,1.4818,0.4723,0.3723,0,39.8578,0.004,ML,change,50,-67.97953098371556,0.5388132022179581,1.2310281460808596,0.4909838816966755,1.3822,3.2562,0.3131,5.3412,0.2922,0,-72.5264,0.007,ML,cueing,64,157.529449250079,3.3393420984451527,0.8109532121201714,0.3909405799105007,5.301788354094619,0.781459848956768,0.35022092022256973,0.108,0.385,0.346,0.006,1.347,90.226412421958,1938.2007378190299,0.108,0.385,0.429,0.005,1.364,50.4987565841104,1874.3397291522954,382,1.1318518518518519,1,0,0,1,FALSE,FALSE,FALSE
28,2021-11-12T22:54:46Z,2021-11-12T23:19:32Z,1486,1,2021-11-12T23:19:33Z,1,Chrome,94.0.4606.114,CrOS x86_64 14150.74.0,1536,864,This was a fun study!,1.7777777777777777,667,66,418,86,57,126,-0.3139747706671217,-0.21625663176589804,-0.04575727469669198,-0.2264399195832151,-0.2064233775707615,0.3483574194317798,4,4,1,1,4,1,1,4,1,4,4,1,1,1,4,4,1,1,4,4,1.538967528127731,0,0,1,3,2,1,0,1,2,4,1,4,4,1,2,1,4,2,3,2,1,1,3,4,5,1,3,2,4,5,0,2,0,8,1,1,3,2,3,1,1,1,3,4,2,1,1,3,1,5,3,5,5,5,5,1,1,5,4,2,1,1,1,1,1,5,1,1,3,5,1,1,1,1,1,1.6421622017013717,1.2649110640673518,3.375,0,1,0,3.6666666666666665,0,4.222222222222222,0,3.1666666666666665,0,2.8333333333333335,0,0.8571428571428571,0,3,0,2.972972972972973,0,0,0,6,1.4461582163186295,0.32145711411707156,0.8838076652178506,3,3,2,3,3,3,2,1,1,0.4879500364742666,3,0,1,0.2934220281253842,2,2,2,2,1,1,5,4,3,1,1,1.3451854182690985,1.5714285714285714,0,4.428571428571429,5.5,3.8333333333333335,3.2559414990859232,0.6723373927674386,0,1.435808096808358,4,4,4,4,4,2,4,3,1,4,1,4,1,3,4,5,4,2,2,4,1.3345232785352157,4,0,4.2,0,3.2,0,3.4,0,3.6,0,2,4,4,4,4,4,4,1,2,3,3,1,4,4,2,1,3,3,3,3,1.0990426455975697,3.25,0,"Black or African American & Hispanic of Latino (e.g., Mexican American, Central American, and others) & White, Caucasian, Anglo, European American",1,21,1,2,NA,1,3,4,Case Aid,1,0,106,62,1,5,2,0,0,1,0,0,TRUE,TRUE,TRUE,TRUE,TRUE,NA,NA,NA,NA,6,0.5425266666667226,0.5799481481482378,0.9375,0.8709677419354839,0.014538096088717579,0.008632234903221856,6,0.7395406249999069,0.750846666666648,1,0.967741935483871,0.022694410876999707,0.022931051569929493,NA,NA,NA,NA,NA,NA,NA,NA,NA,NA,NA,NA,NA,1.1772,2.0986,0.3556,2.1826,0.2967,0,-25.354,0.006,ML,cueing,63,63.137404179174595,2.4251483934309603,0.78739202518775675,0.4595031302709327,2.6845425577198823,1.0087566663134944,0.3781295554184663,0.072,0.518,0.369,0.044,1.653,42.996111223717904,1875.7890208837066,0.071,0.52,0.374,0.035,1.77,54.34531915910984,1879.5631165901532,104,0.3081481481481481,1,1,1,2,FALSE,FALSE,FALSE
29,2021-11-12T22:16:03Z,2021-11-12T23:19:42Z,3818,1,2021-11-12T23:19:44Z,0.8999999761581421,Edge,95.0.1020.40,Windows NT 10.0,1366,768,-,1.7786458333333333,2298,62,525,632,81,91,3.87666283497696,-0.2525955850186271,0.4693663126706248,6.427338048004565,0.12506605371351465,-0.2428404171980778,4,2,4,3,2,2,4,2,1,3,1,4,3,4,2,3,3,3,2,2,0.9787209698591858,0,1,2,2,2,2.9,0,2,4,2,4,3,1,4,3,3,1,4,3,1,3,4,4,4,1,1,3,4,3,3,7,2,0,0,5,4,4,5,4,5,5,5,5,1,4,4,1,4,2,5,5,4,4,5,5,4,1,1,1,5,3,2,4,4,4,3,3,2,1,3,1,4,2,4,4,1.4831384627537982,1.1464230084422218,2.875,0,3.5,0,2.4,0,1.3333333333333333,0,3,0,2,0,3,0,1.6666666666666667,0,2.3783783783783785,0,4,0,0,0.4314095250430094,0.8591411550804637,0.6452753400617366,4,1,1,1,1,1,2,1,1,1.1338934190276817,1.8571428571428572,0,1,-0.39031545311577004,3,5,4,4,1,1,4,3,3,2,2,1.5735915849388864,2.857142857142857,0,3.142857142857143,6,3.8333333333333335,3.2559414990859232,0.9547190977297628,0,0.8599599724965891,3,3,3,2,3,2,4,5,2,2,1,4,1,4,5,2,4,1,4,3,1.4375905768565218,2.8,0,4.4,0,3.8,0,3.4,0,3.8666666666666667,0,3,3,3,1,4,4,2,2,3,3,3,2,3,3,4,2,3,3,3,4,0.7880689256524124,3.2,0,"Hispanic of Latino (e.g., Mexican American, Central American, and others) & White, Caucasian, Anglo, European American",1,23,1,2,NA,1,2,4,Caregiver,3,0,205,66,1,5,2,0,0,1,0,0,TRUE,TRUE,TRUE,TRUE,TRUE,NA,NA,NA,NA,3,0.5826580645163213,0.6664266666630904,0.96875,0.967741935483871,0.1352836088608807,0.018910169848988308,3,0.65516451612884,0.9473133333355188,1,0.967741935483871,0.006084081699383791,0.23955729724643765,NA,NA,NA,NA,NA,NA,NA,NA,NA,NA,NA,NA,NA,1.4321,2.6218,0.4081,2.4756,0.3072,0,-28.1309,0.007,ML,cueing,63,68.6912041791746,2.839754085112614,1.1977084211245277,0.46914956510734007,1.7444138325994893,1.9685622415455681,0.05367604575452212,0.082,0.467,0.339,0.032,1.52,242.92017589768048,2111.7726861489673,0.08,0.463,0.324,0.014,1.684,209.98861768819728,2037.0608885651102,104,0.3081481481481481,1,0,0,1,FALSE,FALSE,FALSE
30,2021-11-12T22:44:26Z,2021-11-12T23:21:56Z,2249,1,2021-11-12T23:21:58Z,0.8999999761581421,Chrome,89.0.4389.114,Windows NT 6.3,1536,864,"During the Arrow Detection game, the frame in which the arrows appeared was a bit too small, requiring me to scroll left/right to find some arrows. Zooming out did not work. This is why there were some long pauses in my Arrow Detection game.",1.7777777777777777,899,80,587,102,76,186,0.2821183774073277,-0.08907029538134635,0.7678491389956121,-0.03145741503851823,0.05600575552929045,1.3618394250829642,2,2,2,2,2,1,3,2,1,2,1,1,1,2,2,2,2,1,2,2,0.5501196042201808,0,1,3,3,2,2.35,0,5,4,3,3,3,2,4,2,3,2,2,4,3,3,4,2,2,1,1,2,2,2,2,0,2,0,0,5,4,4,3,4,5,4,4,5,1,5,1,2,4,3,5,4,3,3,3,3,5,1,1,1,1,1,1,1,1,1,3,3,2,1,2,1,1,2,1,2,1.5211225505572565,0.9154754164341269,1.75,0,1.5,0,2.3333333333333335,0,1.7777777777777777,0,2.25,0,0.8333333333333334,0,1.5714285714285714,0,1.3333333333333333,0,1.7567567567567568,0,0,0,0,-0.34784855521834285,-0.5804383618435307,-0.46414345853093675,5,2,3,1,1,3,2,1,2,1.3972762620115438,1.8571428571428572,0,1.5,-0.20582161572857902,4,4,4,4,1,1,2,6,6,NA,3,1.4638501094227998,3.142857142857143,0,2.857142857142857,3,3.8333333333333335,3.2559414990859232,-0.7395711320441822,0,-0.14652713723325692,2,2,2,1,1,2,5,2,2,3,2,5,2,4,5,1,4,2,4,3,1.3345232785352157,1.6,0,4.2,0,4.2,0,4,0,4.133333333333334,0,2,1,3,1,3,3,2,2,3,2,4,3,2,1,1,2,1,2,2,3,0.8750939799154206,2.35,0,"White, Caucasian, Anglo, European American",0,29,1,3,NA,1,3,6,freelance online work (various),3,0,90,61,2,5,2,0,0,1,0,0,TRUE,TRUE,TRUE,TRUE,TRUE,3,0.7434126923109989,0.78,0.015627711677323703,NA,NA,NA,NA,NA,NA,NA,3,0.605275483869557,0.6260481249992154,0.96875,1,0.013686476220208469,0.005812443415646874,0.9661,1.3667,0.5495,0,-12.6927,0.004,ML,change,50,37.121469016284436,1.5018135347888044,0.8427586674461973,0.5862877088035627,NA,NA,NA,NA,NA,NA,NA,NA,NA,NA,NA,NA,NA,NA,NA,NA,NA,NA,0.062,0.419,0.304,0.035,1.752,110.22930592671699,1945.7421767801152,0.069,0.415,0.335,0.049,1.743,136.84304251036204,1965.474117880944,376,1.114074074074074,1,1,6,7,TRUE,FALSE,FALSE
31,2021-11-12T23:07:24Z,2021-11-12T23:25:37Z,1093,1,2021-11-12T23:25:38Z,0.8999999761581421,Chrome,95.0.4638.69,Macintosh,1440,900,NA,1.6,574,51,257,59,48,67,-0.5529259033004139,-0.35252770646363196,-0.8208497753148042,-0.555472896002391,-0.3307319143023651,-0.6482332194585516,2,3,2,4,2,1,3,2,1,2,3,1,1,1,3,3,1,1,2,2,0.9176629354822471,0,1,1,3,2,2.1,0,4,3,2,4,2,2,4,2,3,2,3,3,2,4,2,2,3,1,1,2,3,2,1,0,2,0,0,4,2,1,3,3,4,3,4,4,2,5,1,1,3,3,4,3,2,2,4,4,4,2,1,1,1,1,1,1,1,1,4,2,4,1,3,1,2,1,1,1,1.3037253160461753,0.8618916073713346,1.875,0,1.25,0,2.4,0,2.888888888888889,0,2.3333333333333335,0,1.1666666666666667,0,1.5714285714285714,0,1.6666666666666667,0,2.135135135135135,0,0,0,0,-0.10287250241229595,-0.6588395645607719,-0.3808560334865339,4,2,3,1,2,2,2,3,1,0.9511897312113419,2,0,2,0.06413940681375631,5,5,5,5,3,2,3,6,2,5,3,1.2909944487358056,4,0,2,5,3.8333333333333335,3.2559414990859232,0.38995568780511447,0,-0.05978971183722909,3,2,2,5,2,2,3,2,2,4,1,5,3,4,4,3,4,1,2,4,1.2227992865708155,2.8,0,4.6,0,3,0,3.6,0,3.7333333333333334,0,2,2,3,2,3,3,3,1,2,2,3,2,4,2,1,2,2,3,1,3,0.8013147091860318,2.6,0,"White, Caucasian, Anglo, European American & Filipino",1,23,1,2,NA,1,3,6,CNA,2,0,105,64,1,5,2,0,0,0,0,0,TRUE,TRUE,TRUE,TRUE,TRUE,3,0.6859794871797547,0.78,0.02386811592235382,3,0.4522709677418874,0.49578965517313317,1,0.90625,0.007105520129125845,0.003944887086769305,3,0.6004093750005122,0.7348749999992017,1,0.875,0.007444306038311978,0.013341118991725107,1.2004,1.1332,0.3955,0,7.0473,0.004,ML,change,50,-2.3585309837155624,1.3509377168317769,0.9368798854025044,0.4917985381661244,1.1037,2.8899,0.3304,3.7868,0.3066,0,-61.9999,0.009,ML,cueing,63,136.42920417917458,3.328775986437144,0.6815368623668131,0.4126136314741452,3.9574325892267854,1.0469249021879183,0.32413126148946775,0.071,0.445,0.454,0.006,1.313,53.0724401520098,1957.9996840223423,0.071,0.445,0.454,0.007,1.369,69.9730267772944,1966.3469391637116,104,0.3081481481481481,1,0,0,1,FALSE,FALSE,FALSE
32,2021-11-12T23:04:49Z,2021-11-12T23:26:28Z,1299,1,2021-11-12T23:26:29Z,1,Firefox,94.0,Macintosh,1440,900,NA,1.6,651,57,347,66,43,80,-0.3550846429481182,-0.2980192765845384,-0.38756825323014515,-0.47016805026408615,-0.39979221248658925,-0.4286454515674616,3,2,2,3,1,3,2,1,1,2,1,2,1,1,2,1,2,2,1,1,0.7326950970650465,0,1,2,5,4,2.7,0,1,1,2,1,2,5,1,5,3,5,5,1,1,1,1,2,5,1,1,4,5,4,4,0,2,0,0,1,1,4,1,1,3,2,2,1,1,5,5,3,2,2,5,5,5,5,5,5,1,1,1,1,3,1,1,1,4,3,1,5,4,3,4,5,2,1,3,3,1.6854794097943888,1.7593288763724921,3.25,0,2.25,0,4.2,0,4.222222222222222,0,3.5,0,1.8333333333333333,0,3.142857142857143,0,4,0,3.4324324324324325,0,0,0,0,1.8190909430913276,-0.34523475369180734,0.7369280946997601,2,5,2,5,5,5,5,5,4,1.4638501094227998,4.714285714285714,0,4.5,2.6104851116974532,2,2,3,3,1,1,5,4,3,2,1,1.3972762620115438,1.8571428571428572,0,4.142857142857143,5.5,3.8333333333333335,3.2559414990859232,0.6723373927674386,0,1.2764661019654844,1,1,2,2,1,1,1,2,1,3,3,4,4,5,5,4,4,5,4,3,1.4375905768565218,1.4,0,3.4,0,2.4,0,4.4,0,3.4,0,3,3,4,1,4,4,4,1,3,2,4,1,3,4,4,1,4,4,4,4,1.2096106376585989,3.7,0,"White, Caucasian, Anglo, European American",0,22,1,2,NA,1,2,3,Student,1,0,104,64,3,5,2,0,0,1,0,0,TRUE,TRUE,TRUE,TRUE,TRUE,1,0.8895833333333333,0.72,0.08669979591836734,1,0.50303125,0.5674516129032258,1,1,0.0018409989919354844,0.003644855913978494,1,0.641258064516129,0.6873333333333334,0.96875,0.9375,0.021554822580645158,0.014142887096774196,1.545,0.6579,0.3925,0,38.1447,0.003,ML,change,50,-64.55333098371557,0.753532160982342,1.253379295197705,0.523648793015874,9.9976,11.0406,0.1147,14.1673,0.1502,0,-99.6639,0.013,ML,cueing,63,211.7572041791746,4.67619273863977,0.8860059792139159,0.47567627981321803,5.546884293237425,0.7469300795480273,0.43780647909173304,0.062,0.454,0.369,0.022,1.801,78.05496259337788,1981.9676843170112,0.065,0.446,0.349,0.02,1.885,97.52011449120789,1989.7782415306579,400,1.1851851851851851,1,0,0,1,FALSE,FALSE,FALSE
33,2021-11-12T23:08:17Z,2021-11-12T23:26:30Z,1092,1,2021-11-12T23:26:31Z,1,Chrome,95.0.4638.69,Windows NT 10.0,1920,1080,NA,1.7777777777777777,571,45,288,57,36,58,-0.5606340043531007,-0.40703613634272556,-0.6716083621523106,-0.5798457090704782,-0.49647662994450314,-0.8002555203062293,3,3,1,1,2,1,3,2,1,2,2,2,2,1,2,2,2,1,3,2,0.7181848464596079,0,0,2,4,3,2.1,0,2,4,3,3,4,4,3,4,4,2,2,2,4,3,1,5,5,5,4,5,5,5,4,7,2,4,0,2,1,2,2,2,4,2,2,2,3,2,4,5,2,3,4,4,5,5,5,5,1,5,5,1,5,4,1,5,3,3,3,4,2,5,5,4,4,4,3,2,1.4311002927985332,1,4.75,0,3.25,0,3.4,0,3.888888888888889,0,4.083333333333333,0,4,0,2.857142857142857,0,4.666666666666667,0,3.891891891891892,0,4,4,0,2.3173670078268196,1.6072727827353175,1.9623198952810685,4,3,2,1,1,2,3,4,1,1.1126972805283737,2.2857142857142856,0,2.5,0.41956761451123586,2,2,2,2,1,1,5,4,2,1,1,1.3451854182690985,1.5714285714285714,0,4.428571428571429,6,3.8333333333333335,3.2559414990859232,0.9547190977297628,0,1.57699894928952,4,4,4,4,4,3,3,4,3,2,3,4,2,3,5,4,4,3,3,3,0.7988086367179802,4,0,3.4,0,2.8,0,3.2,0,3.1333333333333333,0,3,2,3,2,4,4,4,2,3,3,3,2,3,2,2,2,3,3,2,4,0.7677718959499145,3,0,"White, Caucasian, Anglo, European American",0,24,1,2,NA,1,2,4,Remote Clerk,3,0,210,60,3,5,2,0,0,0,0,0,TRUE,TRUE,TRUE,TRUE,TRUE,6,0.646543902439088,0.8367346938775511,0.020018925646219512,6,0.45315483870940104,0.47112499999976715,0.96875,1,0.0030073049092729986,0.002993490322596182,6,0.5437249999999767,0.586859375,1,1,0.004248900645133172,0.004076435393120124,1.0601,1.6079,0.4428,0,-11.9779,0.006,ML,change,49,35.63126089433188,1.7446453112894926,0.9366548687289697,0.46575976915457096,1.149,5.1451,0.3595,4.5364,0.3324,0,-92.0296,0.028,ML,cueing,64,196.53584925007902,4.9121093899783785,0.8434532697590779,0.38795346510417483,4.51769025317733,0.7601201082942758,0.37428570851342347,0.122,0.367,0.721,0.014,1.035,29.49977922976759,1817.748993003297,0.126,0.363,0.732,0.014,1.085,44.402109713303304,1827.7791289368802,276,0.8177777777777777,1,1,0,1,FALSE,FALSE,FALSE
34,2021-11-12T23:09:09Z,2021-11-12T23:28:55Z,1186,1,2021-11-12T23:28:56Z,1,Chrome,93.0.4577.82,Macintosh,1440,900,N/A,1.6,670,51,227,56,41,89,-0.30626666961443483,-0.35252770646363196,-0.9652769493430238,-0.5920321156045217,-0.42741633176027893,-0.27662315071978394,2,3,3,3,2,1,3,2,1,2,2,2,2,2,2,2,2,2,2,2,0.5525062514530825,0,1,3,4,4,2.5,0,5,5,1,5,1,1,5,1,1,1,1,5,1,5,5,5,1,1,1,1,1,1,1,4,2,0,0,5,5,5,5,5,5,5,5,5,1,5,1,1,5,1,5,1,1,1,1,1,5,1,1,1,1,1,1,4,1,1,5,1,1,1,1,1,1,1,1,1,1.9643978361978662,2.065591117977289,1.5,0,1,0,1,0,1,0,1,0,0.8333333333333334,0,1.2857142857142858,0,1,0,1.0810810810810811,0,2,0,0,-1.3186544855402116,-0.33105581968498016,-0.8248551526125959,5,1,5,1,1,1,1,1,1,1.9518001458970664,1,0,1,-0.9031185640466358,5,5,5,5,5,5,1,4,4,6,4,1.5118578920369088,5,0,1,5,3.8333333333333335,3.2559414990859232,0.38995568780511447,0,-0.6174866937872863,1,3,1,3,1,1,5,3,1,4,1,3,3,5,4,1,4,3,5,3,1.486446705914413,1.8,0,4,0,4.4,0,4,0,4.133333333333334,0,1,1,1,4,3,2,2,4,1,1,1,4,1,2,1,4,1,2,2,2,1.1697953037312037,1.4,0,"White, Caucasian, Anglo, European American",0,23,1,2,NA,1,4,6,unemployed,4,0,130,65,3,5,2,0,0,1,0,0,TRUE,TRUE,TRUE,TRUE,TRUE,4,0.9663125000223517,0.64,0.1380754632886694,4,0.6313656249940396,0.683050000011921,1,1,0.007505101037733517,0.004980950320489636,4,0.818090624988079,0.9828125,1,1,0.02123556991022056,0.048311502414092704,1.414,0.4166,0.5477,0,38.4372,0.003,ML,change,50,-65.13833098371556,0.41955885497362577,1.371355027031262,0.508713520741017,10,9.4878,0.1561,9.279,0.0925,0,-73.8739,0.011,ML,cueing,64,160.22444925007903,4.324983369296029,0.9579539093270327,0.5757642869327959,3.903672349884204,1.0613428472075612,0.499672210296617,0.321,0.245,0.589,0.006,1.289,119.93514721078661,1944.3917864988202,0.326,0.257,0.587,0.007,1.371,148.06551553909674,1934.4481312350472,104,0.3081481481481481,1,0,0,1,FALSE,FALSE,FALSE
35,2021-11-12T23:07:21Z,2021-11-12T23:33:54Z,1592,1,2021-11-12T23:33:55Z,0.8999999761581421,Safari,14.1.2,Macintosh,1440,900,great survey!,1.6,891,67,307,67,53,80,0.26156344126682946,-0.20717189345271578,-0.5801378186011047,-0.45798164373004263,-0.2616716161181409,-0.4286454515674616,3,3,1,2,2,1,1,2,1,2,1,1,2,2,2,3,1,1,2,3,0.7677718959499145,0,1,2,3,3,2,0,4,5,3,4,2,2,3,2,2,2,2,4,3,3,3,1,2,1,1,1,2,2,1,0,2,2,2,4,4,3,3,4,5,4,4,3,2,4,2,1,3,2,4,1,1,2,2,3,4,2,1,1,1,1,1,1,1,1,5,2,2,1,1,1,1,1,1,1,1.3378302544754286,0.9611501047232549,1.375,0,1,0,2.2666666666666666,0,2.2222222222222223,0,1.9166666666666667,0,1.1666666666666667,0,1.1428571428571428,0,1,0,1.7027027027027026,0,0,2,2,-0.5608838346439097,0.028924941706396007,-0.2659794464687568,5,2,4,1,1,1,1,1,1,1.6761634196950514,1.2857142857142858,0,1,-0.7321841937363471,5,5,5,5,3,2,2,6,4,4,3,1.4638501094227998,4.142857142857143,0,1.8571428571428572,4,3.8333333333333335,3.2559414990859232,-0.1748077221195339,0,-0.42184241422098995,3,3,3,3,3,3,4,2,2,2,1,3,1,4,3,2,4,2,3,3,0.9856107606091623,3,0,3.8,0,3.6,0,3.6,0,3.6666666666666665,0,1,1,1,1,1,2,3,3,2,1,1,3,1,2,1,3,1,2,1,2,0.812727700887249,1.65,0,"White, Caucasian, Anglo, European American",0,24,1,2,NA,1,3,6,social service specialist,4,0,150,65,2,5,2,0,0,0,0,0,TRUE,TRUE,TRUE,TRUE,TRUE,6,0.6942499999999935,0.7346938775510204,0.023051395408162794,NA,NA,NA,NA,NA,NA,NA,6,0.7298125000000073,0.9487187499999873,1,1,0.028278608870965928,0.05329298286290684,1.1106,0.9749,0.4238,0,4.647,0.005,ML,change,49,2.3814608943318785,1.1242607895251229,0.905990487691746,0.5051209095239937,NA,NA,NA,NA,NA,NA,NA,NA,NA,NA,NA,NA,NA,NA,NA,NA,NA,NA,0.202,0.267,0.418,0.01,1.805,41.424772250225196,1833.0123783183162,0.192,0.271,0.406,0.009,1.79,52.34223406102912,1835.9028272779121,104,0.3081481481481481,1,1,0,1,FALSE,FALSE,FALSE
36,2021-11-12T23:11:33Z,2021-11-12T23:38:13Z,1599,1,2021-11-12T23:38:14Z,1,Chrome,94.0.4606.81,Windows NT 10.0,1600,900,NA,1.7777777777777777,820,72,412,66,65,92,0.07913838301990746,-0.16174820188680444,-0.07464270950233591,-0.47016805026408615,-0.09592690047600279,-0.2259490504372247,3,3,1,1,3,1,3,3,1,3,3,1,2,2,3,3,1,1,2,3,0.9333020044867296,0,1,4,2,3,1.75,0,4,4,2,4,1,2,4,2,1,1,1,4,1,4,4,1,1,1,1,1,1,1,1,2,2,0,0,5,3,4,4,3,4,4,4,4,2,5,4,1,4,1,2,1,1,1,1,1,5,1,1,1,1,1,1,1,1,1,5,1,1,1,1,1,2,1,2,1,1.5706581317928376,1.4040757000349275,1,0,1.5,0,1.6666666666666667,0,2.111111111111111,0,1.6666666666666667,0,0.8333333333333334,0,0.8571428571428571,0,1,0,1.4864864864864864,0,1,0,0,-1.072807320732879,-0.3773458880470143,-0.7250766043899466,3,3,2,3,1,2,1,1,1,0.8997354108424374,2.4285714285714284,0,1,-0.048446712495193056,5,5,5,3,2,2,2,3,4,2,1,1.5118578920369088,3.7142857142857144,0,2.2857142857142856,5.5,3.8333333333333335,3.2559414990859232,0.6723373927674386,0,0.24074313548680643,1,1,1,4,1,1,4,1,1,1,1,4,3,2,4,2,5,1,3,2,1.3972762620115438,1.6,0,4.8,0,3,0,4,0,3.933333333333333,0,1,1,2,3,3,2,2,2,1,2,3,3,2,3,1,3,2,3,1,1,0.8255779474818965,1.95,0,"White, Caucasian, Anglo, European American",0,20,1,2,NA,1,2,5,student,3,0,150,66,1,5,2,0,0,0,0,0,TRUE,TRUE,TRUE,TRUE,TRUE,1,0.8493604651051898,0.86,0.03093137900661594,1,0.5197903225806452,0.5434064516405905,1,1,0.0027705922350472474,0.005921758621036756,1,0.6670750000476837,0.7022812499552965,1,1,0.019004117400558847,0.008531419632610315,1.3947,1.4183,0.4807,0,8.9327,0.017,ML,change,50,-6.129330983715564,1.697379853057816,1.0694659556421733,0.6225357249990822,2.924,6.3728,0.314,8.1853,0.3412,0,-88.3561,0.015,ML,cueing,62,189.09360315513527,4.141902001136836,1.0002976229892349,0.42642658079805884,5.008057899003154,0.8272936954694987,0.4397751965928244,0.288,0.191,0.618,0.023,1.346,63.190247088349054,1857.9004181880814,0.289,0.197,0.629,0.023,1.383,77.37959424030997,1862.2878868820967,446,1.3214814814814815,1,0,0,1,FALSE,FALSE,FALSE
38,2021-11-12T23:13:03Z,2021-11-12T23:46:26Z,2002,1,2021-11-12T23:46:29Z,1,Edge,95.0.1020.44,Windows NT 10.0,1536,864,I enjoyed talking.,1.7777777777777777,884,97,475,120,89,136,0.2435778721438935,0.06537025594275213,0.22865435595692538,0.18789790257426575,0.23556253080827336,0.5172710870403106,2,2,2,2,2,1,3,2,1,3,4,1,2,1,1,1,1,2,1,1,0.8506963092234007,0,1,3,2,2,2.35,0,4,5,3,4,3,3,4,1,1,1,1,4,1,4,5,1,1,1,2,1,1,2,2,1,2,1,0,3,5,5,5,5,4,4,4,4,1,5,2,1,5,1,5,2,1,3,2,3,5,1,1,1,1,1,1,2,1,1,5,1,1,1,1,1,1,3,2,3,1.7084843923544981,1.533747356112131,1.375,0,2.25,0,1.7333333333333334,0,1.6666666666666667,0,1.5833333333333333,0,0.8333333333333334,0,1,0,1,0,1.3783783783783783,0,1,1,0,-0.9294610014101783,0.06449092769773276,-0.43248503685622275,5,1,5,1,1,2,1,1,1,1.889822365046136,1.1428571428571428,0,1,-0.8176513788914915,5,5,5,5,4,3,2,6,6,5,3,1.2149857925879117,4.428571428571429,0,1.5714285714285714,3,3.8333333333333335,3.2559414990859232,-0.7395711320441822,0,-0.8635661140261877,5,5,4,2,3,4,4,2,3,3,1,2,5,1,1,4,4,4,3,5,1.3870146083619754,3.8,0,3,0,2.6,0,2,0,2.533333333333333,0,3,1,1,4,3,2,4,3,1,1,4,3,1,2,2,3,1,3,3,1,1.1285761872936695,2,0,"Asian or Asian American (e.g., Chinese, Japanese, and others) & White, Caucasian, Anglo, European American",1,22,1,2,NA,1,3,4,Parttime Student,7,0,102,64,1,5,2,0,0,2,0,0,TRUE,TRUE,TRUE,TRUE,TRUE,5,1.0165937500004656,0.64,0.10158691102023713,5,0.5401967741928755,0.5967379310336607,0.96875,0.90625,0.018697195957340523,0.00956741286301729,5,0.7532156249987892,0.8521225806445845,1,1,0.017307860716193682,0.024564331140271966,1.3644,0.435,0.5869,0,34.2636,0.004,ML,change,50,-56.791130983715554,0.4530149975828211,1.2700774764049014,0.6240883193956467,1.1055,2.3465,0.3898,2.7526,0.348,0,-40.7095,0.01,ML,cueing,64,93.895649250079,2.667439544267756,0.8505098254967742,0.4672056170396752,2.860992352424485,1.2002783585125942,0.3435410648282595,0.153,0.417,0.469,0.012,1.348,40.539950443485345,1826.313014389156,0.153,0.417,0.466,0.012,1.383,46.59049620193799,1829.2838956442151,374,1.108148148148148,1,0,0,1,FALSE,FALSE,FALSE
39,2021-11-12T23:21:40Z,2021-11-12T23:46:50Z,1510,1,2021-11-12T23:46:51Z,1,Chrome,94.0.4606.81,Windows NT 10.0,1504,1003,NA,1.4995014955134596,760,62,403,97,73,80,-0.07502363803382947,-0.2525955850186271,-0.11797086171080182,-0.092389447708736,0.014569576618755927,-0.4286454515674616,2,1,3,2,1,1,3,2,1,2,1,1,4,3,1,1,1,2,1,1,0.9233805168766387,1,1,2,4,4,2.9,0,4,5,2,4,1,1,5,1,1,1,3,4,1,4,4,1,4,5,2,1,4,1,1,0,2,0,1,5,3,1,5,5,5,3,2,1,2,5,3,2,1,1,3,1,4,4,5,2,1,5,4,1,2,1,1,1,1,1,5,2,2,2,3,3,2,3,1,1,1.5494840757171082,1.624221425205085,2.375,0,1.75,0,1.5333333333333334,0,2.6666666666666665,0,2.75,0,2.8333333333333335,0,1.1428571428571428,0,2.6666666666666665,0,2.4864864864864864,0,0,0,1,-0.10945423753312258,-0.32558751222710886,-0.21752087488011573,4,3,2,1,2,4,5,1,1,1.4142135623730951,3,0,1,0.2934220281253842,5,3,4,5,2,2,1,1,1,2,2,1.5735915849388864,3.7142857142857144,0,2.2857142857142856,8,3.8333333333333335,3.2559414990859232,2.0842459175790595,0,0.946697397892617,5,3,5,5,5,4,5,5,4,2,1,5,4,4,3,5,5,2,5,3,1.3201731488169053,4.6,0,4.2,0,3,0,2.6,0,3.2666666666666666,0,1,1,2,1,2,2,3,2,1,3,1,2,3,4,1,2,3,3,2,1,0.9176629354822471,2.3,0,"Asian or Asian American (e.g., Chinese, Japanese, and others)",0,20,1,2,NA,1,2,3,barista,1,0,105,59,2,5,2,0,0,1,0,0,TRUE,TRUE,TRUE,TRUE,TRUE,2,0.8322604651340219,0.86,0.09776715347690806,2,0.49092187501490114,0.5950064516067505,1,1,0.001163773379426099,0.006293711960180323,2,0.6675437500327825,0.7097343749850988,1,1,0.007554708350978476,0.0063789145869093365,1.3344,1.3602,0.5636,0,10.365,0.003,ML,change,50,-8.993930983715563,1.2730064994141501,1.4259864089253769,0.4289984963621526,3.7502,7.054,0.3292,11.4157,0.3267,0,-101.358,0.01,ML,cueing,63,215.1454041791746,4.079301251393669,1.0156481394886085,0.47440869791137885,6.220787835597241,0.6660144721032367,0.4390633695569613,0.132,0.438,0.591,0.013,0.907,28.57804785540747,1824.5842787051233,0.131,0.439,0.593,0.013,0.985,40.24865039096012,1822.9433082758894,104,0.3081481481481481,1,1,0,1,FALSE,FALSE,FALSE
40,2021-11-12T23:26:24Z,2021-11-12T23:47:40Z,1276,1,2021-11-12T23:47:41Z,1,Chrome,95.0.4638.54,Macintosh,1440,900,n/a,1.6,598,47,374,70,41,93,-0.49126109487891917,-0.38886665971636103,-0.2575837966047475,-0.421422424127912,-0.42741633176027893,-0.20905768367637165,4,4,1,1,4,1,1,3,1,4,3,1,1,1,4,4,1,1,3,3,1.3803127029389886,0,1,1,4,4,1.2,0,4,4,1,4,1,1,5,1,1,1,1,5,3,4,4,1,3,3,1,1,1,1,1,5,2,0,3,5,3,3,4,4,5,5,5,5,1,5,1,1,3,1,4,1,1,1,1,1,3,1,1,3,4,1,1,3,1,1,5,1,1,1,1,1,2,1,1,1,1.65763317647414,1.6761634196950514,1.5,0,1.25,0,1.4666666666666666,0,1.6666666666666667,0,1.25,0,2,0,1.1428571428571428,0,1,0,1.4864864864864864,0,3,0,3,-0.9438827445425771,0.4797867975263196,-0.23204797350812878,5,1,3,1,1,1,1,1,1,1.5735915849388864,1.2857142857142858,0,1,-0.7321841937363471,5,5,5,5,2,2,2,6,7,3,3,1.6035674514745464,4,0,2,2.5,3.8333333333333335,3.2559414990859232,-1.0219528370065065,0,-0.7657439742430396,2,2,2,3,2,1,4,2,1,2,1,4,2,4,5,2,4,2,4,3,1.3345232785352157,2.2,0,4.4,0,3.6,0,4.2,0,4.066666666666666,0,1,1,1,4,1,1,1,4,1,1,1,4,1,1,1,4,2,1,2,2,1.2085223687584246,1.15,0,"White, Caucasian, Anglo, European American",0,24,1,2,NA,1,4,6,Registered Nurse,5,0,150,69,3,5,2,0,0,1,0,0,TRUE,TRUE,TRUE,TRUE,TRUE,4,0.6423829268304313,0.82,0.02645736661655393,4,0.4011093750009313,0.46980344827627313,1,0.90625,0.0012374447479533007,0.0044235359576019284,4,0.49753124999860304,0.6050166666681568,1,0.9375,0.0053823912499923595,0.006363234475789165,1.1473,1.3669,0.3496,0,-0.1068,0.003,ML,change,50,11.949669016284437,1.5322945256946852,0.9895927081516086,0.4357192200179642,0.953,3.022,0.3362,5.5705,0.3156,0,-88.2518,0.007,ML,cueing,64,188.98024925007903,3.234825244089306,0.7013310983224573,0.3817258127953153,6.126057095748557,0.676313436462556,0.34763463330877575,0.064,0.348,0.375,0.015,1.705,90.46026332939185,1971.470304654588,0.065,0.349,0.422,0.014,1.806,113.38804363431426,1959.6850992172776,398,1.1792592592592592,1,0,0,1,FALSE,FALSE,FALSE
41,2021-11-12T23:21:04Z,2021-11-12T23:49:29Z,1704,1,2021-11-12T23:49:30Z,1,Chrome,87.0.4280.88,Macintosh,1440,900,NA,1.6,720,68,434,78,61,108,-0.17779831873632074,-0.1980871551395335,0.03127055145169184,-0.3239311718555635,-0.15117513902338214,0.04431281773642447,4,4,1,1,4,1,1,4,1,4,3,1,1,1,4,4,1,1,4,4,1.5035046776746235,0,1,1,5,5,1.05,0,1,3,4,3,4,3,2,4,5,4,4,2,3,2,2,4,4,4,2,2,4,4,4,9,1,5,2,4,2,1,2,1,2,2,2,2,3,2,4,2,1,4,2,3,4,5,5,1,1,5,5,4,5,5,5,5,5,5,4,1,2,2,4,1,4,4,4,4,1.5446313106647445,1.0997835284835873,3.5,0,4,0,3.8666666666666667,0,4,0,3.6666666666666665,0,4.666666666666667,0,3.4285714285714284,0,2.3333333333333335,0,3.810810810810811,0,5,5,2,1.945886134389598,2.6051013660749422,2.27549375023227,3,4,2,4,2,2,3,7,3,0.8997354108424374,3.142857142857143,0,5,1.854839912378057,1,2,4,2,1,1,4,3,1,1,2,1.3451854182690985,1.8571428571428572,0,4.142857142857143,7,3.8333333333333335,3.2559414990859232,1.5194825076544112,0,1.7000386594089707,1,1,1,3,1,2,5,1,1,3,1,4,2,4,4,3,4,1,4,1,1.4474937289114918,1.4,0,4.4,0,3.8,0,4.6,0,4.266666666666667,0,2,2,2,1,2,2,3,2,3,3,3,2,3,3,1,2,1,2,3,3,0.7163503994113789,2.55,0,"Hispanic of Latino (e.g., Mexican American, Central American, and others)",0,25,1,2,NA,1,2,4,assistant,2,0,170,61,2,5,2,0,0,0,0,0,TRUE,TRUE,TRUE,TRUE,TRUE,3,0.7259413513505982,0.74,0.03746064051581908,3,0.5253724193110341,0.5636268749949522,1,1,0.0036234140064492736,0.003470739015349525,3,0.6374042187671876,0.71544953128614,1,1,0.014577951601736052,0.010868396690462441,1.252,0.8977,0.4043,0,15.4607,0.004,ML,change,50,-19.18533098371556,1.0199282326955594,1.0255315243292231,0.4846228370189328,6.0433,9.1767,0.2344,10.1066,0.2264,0,-91.338,0.014,ML,cueing,63,195.10540417917457,4.733768385689719,0.8752297089389324,0.47407044643184953,4.6830953970002795,0.8847000488278298,0.43386743172836184,0.25,0.265,0.699,0.014,1.507,62.998273338393894,1874.5655153740759,0.25,0.268,0.697,0.016,1.58,80.89752608842011,1865.8388294864276,432,1.28,1,0,0,1,FALSE,FALSE,FALSE
42,2021-11-12T23:18:18Z,2021-11-12T23:50:28Z,1929,1,2021-11-12T23:50:30Z,1,Chrome,94.0.4606.81,Windows NT 10.0,1600,900,"My back arrow currently does not work on my keyboard, so I was only able to click the right arrow on the first attention game, then I remembered, that I can use my on-screen keyboard application, so I was able to complete the final two attention games successfully. Sorry that I didn't think of the solution sooner.",1.7777777777777777,768,78,532,113,97,153,-0.05446870189333121,-0.10723977200771087,0.5030659866105427,0.10259305683596086,0.34605900790303207,0.8044243219748128,2,2,3,3,2,2,3,2,1,2,2,3,3,2,2,2,2,3,2,2,0.5501196042201808,0,1,1,4,4,2.75,0,1,4,4,3,2,4,3,4,2,3,2,3,3,3,3,3,4,5,1,2,5,5,4,4,1,0,5,3,2,3,4,3,3,2,2,3,2,4,2,1,4,2,4,2,3,3,2,3,2,3,3,2,3,1,2,2,5,5,3,2,1,1,1,2,2,3,2,2,1.0419143849595252,0.8837151016885368,3.625,0,2.25,0,3.066666666666667,0,3.2222222222222223,0,2.1666666666666665,0,2.5,0,2.7142857142857144,0,1.3333333333333333,0,2.5675675675675675,0,2,0,5,1.121523810506113,0.9431984283971292,1.0323611194516211,4,1,3,2,1,2,2,1,1,1.0690449676496976,1.8571428571428572,0,1,-0.39031545311577004,3,4,5,5,3,2,2,5,6,2,2,1.2724180205607036,3.7142857142857144,0,2.2857142857142856,3.5,3.8333333333333335,3.2559414990859232,-0.4571894270818581,0,-0.3240202744378419,3,4,4,5,3,3,5,2,3,3,2,4,2,4,5,5,4,2,3,2,1.162919151265879,3.8,0,3.8,0,3.2,0,4,0,3.6666666666666665,0,2,3,3,2,3,3,3,3,2,3,2,3,3,4,3,3,1,3,3,3,0.6386663736585051,2.65,0,"White, Caucasian, Anglo, European American",0,19,1,2,NA,1,3,3,currently unemployed,1,0,147,65,2,5,2,0,0,1,0,0,TRUE,TRUE,TRUE,TRUE,TRUE,4,1.1108970588235294,0.68,0.08561965962297319,NA,NA,NA,NA,NA,NA,NA,NA,NA,NA,NA,NA,NA,NA,1.5462,0.5081,0.5665,0,43.8574,0.003,ML,change,50,-75.97873098371556,0.6124289822242229,1.2307905475649237,0.7491534036537696,NA,NA,NA,NA,NA,NA,NA,NA,NA,NA,NA,NA,2.106961592744993,1.9664025868614772,0.47317598340059225,2.384839162584348,1.7372805644057752,0.4336948728395616,NA,NA,NA,NA,NA,NA,NA,NA,NA,NA,NA,NA,NA,NA,104,0.3081481481481481,1,1,7,8,TRUE,FALSE,FALSE
43,2021-11-12T23:18:00Z,2021-11-12T23:53:17Z,2117,1,2021-11-12T23:53:18Z,1,Firefox,94.0,Windows NT 10.0,2560,1440,"Feeling a little bit sick today, probably a cold.

",1.7777777777777777,1117,78,582,101,74,86,0.8422403872359052,-0.10723977200771087,0.7437779433242422,-0.04364382157256178,0.028381636255600768,-0.3272972510023432,2,4,3,2,2,1,1,2,1,3,3,2,3,1,2,2,1,1,2,3,0.8870412083230169,1,1,1,5,5,2.05,0,4,4,2,4,3,2,4,2,1,1,1,4,3,5,4,1,2,1,1,1,2,1,2,0,2,0,0,5,3,4,3,3,5,2,5,5,1,5,2,1,4,1,5,1,3,3,3,1,5,1,1,1,1,1,1,1,1,1,5,2,2,1,1,1,1,1,1,1,1.626082453058314,1.3345232785352157,1.375,0,1,0,1.8666666666666667,0,2.111111111111111,0,1.6666666666666667,0,0.8333333333333334,0,1.1428571428571428,0,1,0,1.5405405405405406,0,0,0,0,-0.8024722296671781,-0.7372407672780129,-0.7698564984725955,5,1,5,1,1,1,1,1,1,1.9518001458970664,1,0,1,-0.9031185640466358,5,5,5,5,3,2,1,5,6,4,4,1.7043362064926932,4.285714285714286,0,1.7142857142857142,3.5,3.8333333333333335,3.2559414990859232,-0.4571894270818581,0,-0.6427042641235889,1,2,2,3,2,1,5,1,1,1,2,5,3,4,5,2,5,2,2,2,1.624221425205085,2,0,4.6,0,3,0,4.6,0,4.066666666666666,0,1,1,1,2,2,2,2,3,4,1,1,3,1,3,1,3,1,1,1,2,0.9514531821875089,1.7,0,"White, Caucasian, Anglo, European American",0,29,0,1,NA,1,3,6,Currently unemployed,3,0,178,69,2,5,2,0,1,0,0,1,TRUE,TRUE,TRUE,TRUE,TRUE,5,0.9184565217391304,0.92,0.10328742897959187,5,0.41225,0.46950000000000003,1,0.9375,0.002253741935483871,0.00402154435483871,5,0.52515625,0.6189655172413793,1,0.90625,0.0017918135080645153,0.003957353830645161,1.5497,1.5595,0.5538,0,11.5955,0.003,ML,change,50,-11.454930983715562,1.543841741055306,1.581993134671769,0.4880774881291429,1.1248,3.4236,0.3273,5.0354,0.3006,0,-80.6277,0.008,ML,cueing,64,173.73204925007903,3.701680755805464,0.7315731365691351,0.3830356967920502,5.273348189386059,0.7856744098048815,0.34008312829309956,0.05,0.449,0.543,0.018,1.877,138.21541520924964,2040.9993574836055,0.05,0.449,0.671,0.02,1.936,139.88074725567208,2005.7957274819453,380,1.125925925925926,1,0,0,1,FALSE,FALSE,FALSE
44,2021-11-12T23:37:12Z,2021-11-12T23:57:13Z,1200,1,2021-11-12T23:57:15Z,1,Chrome,95.0.4638.69,Windows NT 10.0,1280,720,no,1.7777777777777777,632,41,258,54,51,93,-0.4039026162818016,-0.44337508959545463,-0.8160355361805302,-0.6164049286726088,-0.28929573539183057,-0.20905768367637165,4,3,2,2,3,1,1,2,1,3,3,1,1,2,3,3,1,2,3,3,0.9514531821875089,0,1,2,4,4,1.7,0,2,4,2,4,1,1,3,1,1,1,2,5,3,4,4,1,1,2,1,1,1,1,1,0,2,0,1,5,5,5,5,5,5,4,4,5,1,5,1,1,4,1,5,2,2,2,2,3,4,2,1,1,4,2,1,1,2,2,5,1,1,1,1,1,2,2,2,3,1.6899277664609975,1.4074631010979937,1.125,0,2.25,0,1.8666666666666667,0,1.2222222222222223,0,1.5833333333333333,0,1.8333333333333333,0,1.1428571428571428,0,1,0,1.4594594594594594,0,0,0,1,-0.9447538565438629,-0.1687851067926266,-0.5567694816682447,5,1,4,1,1,2,1,1,1,1.6761634196950514,1.2857142857142858,0,1,-0.7321841937363471,5,5,5,5,3,3,2,5,7,4,4,1.2909944487358056,4.285714285714286,0,1.7142857142857142,3,3.8333333333333335,3.2559414990859232,-0.7395711320441822,0,-0.783895116604751,2,2,2,2,2,2,5,3,2,4,1,5,2,4,4,1,4,2,3,2,1.3345232785352157,2,0,4.4,0,4.2,0,3.8,0,4.133333333333334,0,1,1,1,3,2,1,1,4,1,1,2,3,2,1,2,4,2,2,1,1,1.0052493799000692,1.4,0,"White, Caucasian, Anglo, European American",0,19,1,2,NA,1,3,4,n/a,3,0,160,65,2,5,2,0,0,0,0,0,TRUE,TRUE,TRUE,TRUE,TRUE,3,0.8148774999979883,0.8,0.05646608637102879,3,0.535746874999255,0.6370800000001987,1,1,0.014206722570445878,0.014461858896272889,3,0.6561906249979511,0.7123566666687529,1,0.9375,0.009228459586622216,0.006435049102890453,1.4441,1.0405,0.3927,0,22.1958,0.003,ML,change,50,-32.65553098371556,1.1770875747482235,1.1777325586130805,0.5147131153221085,1.8895,4.3483,0.4198,4.0465,0.3023,0,-57.5599,0.007,ML,cueing,62,127.50120315513527,3.3132672246278196,1.2504680261209333,0.4542708846803908,3.328043693497237,1.244915965041843,0.35455749586178326,0.058,0.497,0.393,0.012,1.295,92.09836594866671,1978.3250612381619,0.058,0.496,0.382,0.012,1.362,119.85446242406495,1988.5660652953193,360,1.0666666666666667,1,0,0,1,FALSE,FALSE,FALSE
45,2021-11-12T23:38:20Z,2021-11-13T00:02:44Z,1463,1,2021-11-13T00:02:46Z,1,Chrome,95.0.4638.69,Windows NT 10.0,1707,960,"A very thorough and interesting study, thank you for the opportunity to participate!",1.778125,631,72,344,115,66,112,-0.40647198329936385,-0.16174820188680444,-0.40201097063296715,0.12696586990404798,-0.08211484083915795,0.11187828477983676,3,3,1,1,3,1,2,3,1,4,3,1,1,2,3,3,2,1,3,4,1.0699237552766379,0,1,1,2,1,1.55,0,3,2,4,2,5,4,3,2,4,2,3,3,2,3,2,2,3,3,1,1,3,3,3,1,2,0,0,3,2,4,5,5,5,4,5,3,3,4,4,1,3,2,5,5,4,4,5,4,2,1,1,1,3,3,1,3,1,1,3,2,3,1,3,1,2,1,2,2,1.4431155818514962,0.9611501047232549,2.375,0,1.75,0,3.3333333333333335,0,2,0,3.1666666666666665,0,2,0,1.8571428571428572,0,1.6666666666666667,0,2.3783783783783785,0,1,0,0,0.617633912873446,-0.2989446853297732,0.15934461377183642,5,1,3,1,1,1,1,1,1,1.5735915849388864,1.2857142857142858,0,1,-0.7321841937363471,2,3,4,2,1,2,4,4,3,2,2,1.1338934190276817,2.2857142857142856,0,3.7142857142857144,5.5,3.8333333333333335,3.2559414990859232,0.6723373927674386,0,1.037453109701174,1,1,2,4,2,1,5,2,2,4,1,5,4,4,5,2,5,4,2,4,1.4960264830861913,2,0,4.4,0,3.4,0,3.8,0,3.8666666666666667,0,2,1,2,3,4,1,2,4,1,1,2,4,1,1,1,3,1,1,1,4,1.2139539573337679,1.6,0,"Black or African American & White, Caucasian, Anglo, European American",1,26,1,2,NA,1,3,7,Reporting Analyst,3,0,145,66,1,5,2,0,0,1,0,0,TRUE,TRUE,TRUE,TRUE,TRUE,6,0.9000581395347971,0.86,0.08658228000001983,6,0.36774062500020954,0.4189310344826302,1,0.90625,8.736231350623663e-4,0.0015720185483967765,6,0.48892812500009314,0.5640222222222774,1,0.84375,0.005251881441572614,0.0057332961190106335,1.6094,1.2509,0.4772,0,21.6419,0.004,ML,change,50,-31.54773098371556,1.3122651916512191,1.3833255489723653,0.5205638111030393,0.8446,3.4221,0.3129,6.6764,0.3045,0,-106.2503,0.016,ML,cueing,64,224.977249250079,4.18966016523392,0.5414958378113939,0.36642494199897013,6.683153908806263,0.619937051117767,0.3228094423231964,0.059,0.369,0.501,0.011,1.489,159.26696156064722,2063.0909166673964,0.06,0.368,0.576,0.011,1.55,168.27914089142467,2036.2516394741283,419,1.2414814814814816,1,0,0,1,FALSE,FALSE,FALSE
47,2021-11-12T23:43:35Z,2021-11-13T00:07:04Z,1409,1,2021-11-13T00:07:07Z,1,Firefox,94.0,Windows NT 10.0,1366,768,NA,1.7786458333333333,680,82,353,99,76,72,-0.28057299943881203,-0.07090081875498182,-0.3586828184245012,-0.06801663464064889,0.05600575552929045,-0.5637763856542862,2,2,2,1,2,1,2,2,1,2,1,3,1,1,2,2,3,1,2,2,0.6386663736585051,0,1,3,2,2,2.35,0,5,5,1,5,1,1,5,1,1,1,1,5,1,5,5,1,1,1,1,1,1,1,1,0,2,0,0,5,5,5,5,5,5,5,5,5,1,5,1,1,4,1,5,1,1,1,1,1,5,1,1,1,2,1,1,1,3,1,5,1,1,1,1,1,1,1,1,1,1.9081774396373994,2.065591117977289,1,0,1,0,1,0,1,0,1.0833333333333333,0,1,0,1.1428571428571428,0,1,0,1.1081081081081081,0,0,0,0,-1.5219139525069039,-0.7372407672780129,-1.1295773598924583,4,1,2,2,1,3,2,1,1,1.0690449676496976,2.142857142857143,0,1,-0.21938108280548152,5,5,5,5,1,1,3,3,3,2,2,1.9023794624226837,3.5714285714285716,0,2.4285714285714284,6,3.8333333333333335,3.2559414990859232,0.9547190977297628,0,0.46160498538940525,2,2,3,3,3,2,3,2,2,1,1,3,2,3,4,3,4,2,2,3,0.9154754164341269,2.6,0,4,0,2.6,0,3.6,0,3.4,0,2,2,4,1,2,4,4,1,1,1,1,2,1,2,1,3,2,4,2,4,1.1964860832322377,2.5,0,"White, Caucasian, Anglo, European American",0,22,1,2,NA,1,2,3,none,2,0,100,62,1,5,2,0,0,1,0,0,TRUE,TRUE,TRUE,TRUE,TRUE,2,1.0122142857142857,0.84,0.05238965551020408,2,0.5271875,0.59071875,1,1,0.004263318548387096,0.01204278931451613,2,0.66196875,0.84553125,1,1,0.008293966733870964,0.03458774092741935,1.3595,1.2398,0.6605,0,14.858,0.003,ML,change,50,-17.979930983715562,1.3876200285890175,1.1950159571346624,0.7194068765859155,1.7136,3.9752,0.3787,4.9163,0.3675,0,-73.277,0.014,ML,cueing,64,159.03064925007902,3.4684123362304584,1.1945334996975523,0.4238982835081645,4.496509843154503,0.9214112435890806,0.42793083501283846,0.325,0.147,0.607,0.007,1.297,68.24999468088835,1862.9795037515664,0.318,0.151,0.605,0.007,1.385,81.07247096658283,1864.9502709547878,268,0.794074074074074,1,0,0,1,FALSE,FALSE,FALSE
48,2021-11-12T23:48:28Z,2021-11-13T00:09:40Z,1272,1,2021-11-13T00:09:41Z,1,Chrome,95.0.4638.69,Macintosh,1440,900,NA,1.6,665,54,303,75,53,72,-0.31911350470224625,-0.3252734915240852,-0.5993947751382007,-0.3604903914576942,-0.2616716161181409,-0.5637763856542862,3,2,3,3,2,1,2,2,1,2,2,1,1,1,2,2,2,1,2,2,0.6708203932499369,0,1,1,4,2,2.25,0,2,3,5,3,5,3,3,3,4,2,2,3,3,3,2,3,3,1,1,2,2,4,3,0,2,0,0,2,3,3,2,2,4,3,5,4,5,3,2,1,4,3,4,5,4,2,2,3,4,1,1,1,1,1,1,1,1,1,2,5,4,1,3,2,2,2,2,2,1.3836236534601505,0.9611501047232549,2.375,0,2,0,3.3333333333333335,0,2.888888888888889,0,2.8333333333333335,0,1,0,2.2857142857142856,0,2,0,2.4324324324324325,0,0,0,0,0.6408635662410679,-0.4236359564090485,0.10861380491600969,5,2,3,1,1,1,1,3,1,1.5275252316519468,1.4285714285714286,0,2,-0.2777293338068208,3,3,3,3,2,2,3,7,7,NA,3,0.4879500364742666,2.7142857142857144,0,3.2857142857142856,2,3.8333333333333335,3.2559414990859232,-1.3043345419688306,0,-0.189895849931271,3,3,3,3,3,2,5,3,2,3,1,4,2,3,4,2,4,2,4,3,1.0997835284835873,3,0,4.2,0,4,0,3.4,0,3.8666666666666667,0,2,3,3,3,3,4,4,3,1,4,2,3,2,3,2,4,3,3,1,3,0.8944271909999159,2.5,0,"White, Caucasian, Anglo, European American",0,22,1,2,NA,1,3,6,Teacher,1,0,125,66,2,5,2,0,0,1,0,0,TRUE,TRUE,TRUE,TRUE,TRUE,2,0.7427257142858846,0.7,0.03616631617969496,2,0.5646625000010245,0.6679161290338924,1,0.96875,0.020994414032177812,0.0100915641831699,2,0.7430906249992549,0.8749531249990686,1,1,0.011883863457845893,0.013261038054329743,1.0788,0.801,0.5039,0,7.978,0.004,ML,change,50,-4.219930983715562,0.8479514617941134,0.9992291995045011,0.5070449602506688,1.4247,3.2894,0.4611,3.1145,0.336,0,-47.466,0.008,ML,cueing,64,107.40864925007901,3.33788365727247,1.0287917606125334,0.5234395123200584,3.0184678530387123,1.3725952794960563,0.3444014699434764,0.178,0.406,0.553,0.007,1.408,24.787588378390087,1817.2563080397917,0.182,0.407,0.549,0.009,1.473,31.587839433438095,1813.8269473225093,104,0.3081481481481481,1,0,0,1,FALSE,FALSE,FALSE
49,2021-11-12T23:24:53Z,2021-11-13T00:11:42Z,2809,1,2021-11-13T00:11:42Z,1,Safari,13.1.3,Macintosh,1680,1050,These types of surveys that ask about the past always make me feel a little sad.,1.6,784,86,461,95,59,127,-0.013358829612334701,-0.03456186550225277,0.16125500807708953,-0.11676226077682311,-0.17879925829707183,0.3652487861926329,1,2,3,1,2,2,4,2,2,2,2,3,3,2,1,1,3,1,1,1,0.8870412083230169,0,1,1,3,3,2.95,0,3,2,3,3,2,3,3,3,5,2,1,2,1,2,3,5,5,3,4,3,4,4,4,6,2,0,0,2,2,1,1,1,2,1,3,2,1,2,3,3,4,5,3,5,5,4,3,3,1,2,3,1,2,3,1,4,3,2,1,4,3,3,3,1,5,4,4,4,1.238763308519644,0.990430401872025,4,0,4.25,0,2.933333333333333,0,4.333333333333333,0,3.4166666666666665,0,2.5,0,3,0,2.3333333333333335,0,3.3783783783783785,0,3,0,0,1.5738245196181855,0.8912522894356707,1.232538404526928,3,1,2,2,1,1,1,1,1,0.7867957924694432,1.8571428571428572,0,1,-0.39031545311577004,1,2,3,2,1,2,3,1,1,NA,2,0.816496580927726,2,0,4,8,3.8333333333333335,3.2559414990859232,2.0842459175790595,0,1.902749366949858,2,2,3,4,5,2,5,4,3,2,1,5,4,3,5,3,2,2,3,2,1.2798809468443688,3.2,0,4,0,3,0,3.4,0,3.466666666666667,0,4,4,4,2,2,2,3,2,1,2,2,2,4,4,2,2,2,4,4,3,1.019545822516343,2.95,0,"Hispanic of Latino (e.g., Mexican American, Central American, and others)",0,24,1,2,NA,1,3,4,English teacher,1,0,110,57,1,5,2,0,0,1,0,0,TRUE,TRUE,TRUE,TRUE,TRUE,NA,NA,NA,NA,3,0.48237500000000366,0.5238709677419392,1,0.96875,0.006835983870966455,0.003540378024193993,3,0.6565312500000055,0.7787187499999991,1,1,0.006970773185484743,0.014036466733870535,NA,NA,NA,NA,NA,NA,NA,NA,NA,NA,NA,NA,NA,1.2232,4.3791,0.3947,4.1897,0.3364,0,-78.8819,0.01,ML,cueing,64,170.24044925007902,4.337089734049523,0.7917722286273395,0.4382967105954239,3.9958781556024987,1.0368521173706384,0.35668917455829235,0.246,0.306,0.699,0.004,0.875,22.79936390496364,1825.0326368759029,0.248,0.305,0.699,0.005,0.926,36.295948974481256,1821.2131885740214,438,1.2977777777777777,1,0,0,1,FALSE,FALSE,FALSE
50,2021-11-12T23:38:41Z,2021-11-13T00:11:50Z,1989,1,2021-11-13T00:11:53Z,1,Firefox,94.0,Windows NT 10.0,1920,1080,n/a,1.7777777777777777,731,56,615,331,76,89,-0.14953528154313564,-0.30710401489772066,0.9026478347552838,2.7592296812574557,0.05600575552929045,-0.27662315071978394,2,1,1,2,1,1,1,1,1,2,2,1,1,1,2,1,1,1,1,2,0.47016234598162726,0,1,2,3,2,2.3,0,1,1,3,1,5,3,1,3,1,1,2,1,1,1,1,3,4,5,1,2,1,3,2,10,2,3,0,2,1,2,2,1,2,2,2,2,3,2,2,2,3,2,3,3,2,2,2,2,1,2,2,3,3,2,1,5,4,4,3,3,2,1,4,1,1,1,1,3,0.9388191419977446,1.2227992865708155,2.625,0,1.5,0,3.6,0,4.222222222222222,0,2.5,0,2.6666666666666665,0,3,0,2,0,3.054054054054054,0,5,3,0,1.1300413500742408,1.0549236299181224,1.0924824899961816,2,3,1,2,2,3,3,4,2,0.7559289460184544,3.142857142857143,0,3,1.1168645628292926,3,3,3,3,1,1,3,2,1,1,2,0.9759000729485332,2.4285714285714284,0,3.5714285714285716,7.5,3.8333333333333335,3.2559414990859232,1.8018642126167355,0,1.5225455222043855,2,2,2,3,3,3,2,2,3,2,1,3,3,3,2,2,1,2,3,1,0.7745966692414834,2.4,0,3.2,0,2.8,0,3.4,0,3.1333333333333333,0,1,2,2,1,2,3,1,1,2,1,1,3,2,2,1,2,1,1,2,3,0.7326950970650465,2,0,"Hispanic of Latino (e.g., Mexican American, Central American, and others) & White, Caucasian, Anglo, European American",1,23,1,2,NA,1,2,3,Currently unemployed,1,0,259,61,1,5,2,0,0,0,0,0,TRUE,TRUE,TRUE,TRUE,TRUE,6,1.03671875,0.64,0.17094897306122447,6,0.5362903225806451,0.659125,0.96875,1,0.005041813508064517,0.006188822580645162,6,0.66471875,0.6750625,1,1,0.005526724798387099,0.007426383064516128,1.5745,0.38,0.5213,0,48.1874,0.003,ML,change,50,-84.63873098371556,0.3977456097929011,1.4465631567954793,0.5275519937489002,1.5384,4.066,0.4699,4.1291,0.3612,0,-65.1987,0.007,ML,cueing,64,142.87404925007903,4.096476673455683,1.0113898007129356,0.539536394041439,3.970215883264701,0.8649371483702254,0.4341701104260478,0.215,0.333,0.68,0.06,1.458,118.59135831956593,1919.2120494199357,0.224,0.327,0.665,0.123,1.489,134.23655320372825,1919.4952905799437,317,0.9392592592592592,1,0,0,1,FALSE,FALSE,FALSE
52,2021-11-12T23:55:11Z,2021-11-13T00:13:41Z,1109,1,2021-11-13T00:13:42Z,1,Chrome,95.0.4638.69,Windows NT 10.0,1920,1080,NA,1.7777777777777777,581,77,244,50,65,58,-0.534940334177478,-0.11632451032089314,-0.883434884060366,-0.665150554808783,-0.09592690047600279,-0.8002555203062293,3,3,1,1,3,1,1,1,1,1,3,1,1,1,3,3,1,1,3,3,1.0052493799000692,0,0,4,3,2,1.7,0,5,5,2,5,2,2,5,2,2,2,2,5,2,5,2,2,3,1,1,1,2,2,1,0,2,0,0,5,1,1,1,1,5,4,4,4,1,5,1,1,4,2,4,3,2,2,2,2,4,1,1,1,2,2,1,1,1,1,3,4,1,1,1,1,2,1,1,1,1.4305755997312923,1.52127765851133,1.625,0,1.25,0,1.7333333333333334,0,3.111111111111111,0,1.75,0,1.3333333333333333,0,1.5714285714285714,0,1,0,1.972972972972973,0,0,0,0,-0.5664976675410849,-0.6588395645607719,-0.6126686160509284,5,2,2,3,2,2,2,2,1,1.1338934190276817,2.2857142857142856,0,1.5,0.050579939736853735,4,5,5,5,2,2,3,6,4,3,3,1.3801311186847085,3.7142857142857144,0,2.2857142857142856,4,3.8333333333333335,3.2559414990859232,-0.1748077221195339,0,-0.18282942195667984,1,1,1,1,1,1,5,2,1,4,2,5,1,5,4,1,5,3,3,3,1.6035674514745464,1,0,4.4,0,4.4,0,4.2,0,4.333333333333333,0,1,3,1,4,4,1,1,3,1,1,3,3,1,1,2,4,1,1,3,1,1.2139539573337679,1.6,0,"White, Caucasian, Anglo, European American",0,21,0,1,NA,1,3,4,student,3,0,130,70,1,5,2,0,0,0,0,0,TRUE,TRUE,TRUE,TRUE,TRUE,4,0.7399743589774156,0.78,0.071688108265939507,4,0.3601225806436231,0.4448538461510952,0.96875,0.8125,0.0017063835380264872,0.0036642185377830914,4,0.5061093750018626,0.5713129032331128,1,0.96875,0.0071996924897162785,0.007354714668189193,1.2552,1.0023,0.4094,0,17.1409,0.004,ML,change,50,-22.545730983715558,1.0261907165428814,1.2333636944165316,0.4034464320828458,0.9077,2.0793,0.296,3.9323,0.2502,0,-66.2381,0.008,ML,cueing,64,144.95284925007903,2.4437007772486745,0.6000477155162808,0.3681198561124466,5.205250729193025,0.6597160027712096,0.30071297822722876,0.066,0.362,0.449,0.026,1.894,31.36838013772483,1870.1017757908135,0.066,0.362,0.454,0.025,1.945,45.49426679149872,1870.4570801052655,310,0.9185185185185185,1,0,1,2,FALSE,FALSE,FALSE
53,2021-11-12T23:47:17Z,2021-11-13T00:15:12Z,1674,1,2021-11-13T00:15:13Z,1,Chrome,95.0.4638.54,Windows NT 10.0,1536,864,NA,1.7777777777777777,813,128,399,102,59,131,0.06115281389697148,0.3469971436514023,-0.13722781824789776,-0.03145741503851823,-0.17879925829707183,0.43281425323604517,3,3,1,2,3,1,1,3,1,3,2,1,1,3,3,3,2,1,3,3,0.9333020044867296,0,1,3,3,2,1.75,0,4,4,5,3,4,3,3,3,3,2,1,4,3,4,3,3,4,2,3,2,2,2,3,0,4,0,0,4,4,4,4,4,4,4,4,4,1,4,1,3,4,4,4,4,3,1,1,1,4,1,1,1,4,4,2,1,1,1,4,2,1,1,1,1,3,2,1,1,1.4405120877920723,0.9611501047232549,2.625,0,1.75,0,2.7333333333333334,0,2,0,2.0833333333333335,0,2,0,1.2857142857142858,0,1,0,1.864864864864865,0,0,0,0,0.24654020032568483,-0.5020371591262895,-0.12774847940030237,4,1,1,1,1,1,1,1,1,1.1338934190276817,1.7142857142857142,0,1,-0.4757826382709144,3,2,3,2,1,1,4,1,3,2,1,1.1126972805283737,2,0,4,7,3.8333333333333335,3.2559414990859232,1.5194825076544112,0,1.6203676619875336,2,4,3,4,4,3,4,4,2,3,2,4,3,4,3,2,3,2,4,2,0.8451542547285166,3.4,0,3.6,0,3.6,0,3.4,0,3.533333333333333,0,2,2,1,2,2,1,2,3,2,1,1,3,1,2,1,3,1,2,1,2,0.7163503994113789,1.65,0,"White, Caucasian, Anglo, European American",0,30,1,2,NA,1,2,6,veterinary tech,2,0,190,62,2,5,2,0,0,1,0,0,TRUE,TRUE,TRUE,TRUE,TRUE,3,0.9018787878715631,0.66,0.09536663714670683,3,0.6519781250059604,0.7917937499955296,1,1,0.016587829505509594,0.0270801702829205,3,0.8165062499959022,0.9725870967718863,1,0.96875,0.017733615443774633,0.043840710232521715,1.4164,0.4854,0.4408,0,36.7362,0.005,ML,change,50,-61.736330983715554,0.5277911816338446,1.2567360738331261,0.5208990011482639,3.4348,3.6455,0.3207,5.3722,0.3323,0,-40.6326,0.009,ML,cueing,64,93.74184925007901,2.832367788287368,1.462781332115325,0.5416374282518106,3.2015854945506192,1.2940884238273547,0.45619260518826865,0.104,0.557,0.409,0.008,1.402,48.63816688154877,1882.6218337365742,0.103,0.557,0.406,0.008,1.43,65.84755219037562,1890.1186591317964,104,0.3081481481481481,1,0,0,1,FALSE,FALSE,FALSE
54,2021-11-12T23:51:15Z,2021-11-13T00:16:00Z,1484,1,2021-11-13T00:16:01Z,1,Chrome,95.0.4638.69,Windows NT 10.0,1920,1080,NA,1.7777777777777777,626,58,324,77,71,75,-0.4193188183871753,-0.2889345382713561,-0.49829575331844694,-0.3361175783896071,-0.013054542654933752,-0.513102285371727,2,1,4,3,2,4,3,2,1,2,2,3,1,1,2,2,4,1,2,2,1.0052493799000692,0,0,2,4,4,2.8,0,2,2,4,3,2,3,1,4,2,1,5,2,3,3,5,2,1,1,1,1,4,4,3,0,2,0,0,5,4,5,5,5,5,5,5,5,1,5,5,2,5,1,5,5,5,5,5,5,4,1,1,1,2,1,1,1,1,1,3,5,4,1,3,3,1,2,2,2,1.7866707005467437,1.2649110640673518,2.125,0,1.75,0,3.2,0,1.1111111111111112,0,3.0833333333333335,0,1.1666666666666667,0,2.142857142857143,0,2.3333333333333335,0,2.108108108108108,0,0,0,0,0.33674868756994975,-0.5020371591262895,-0.0826442357781699,3,3,2,4,1,3,2,2,1,0.9759000729485332,2.857142857142857,0,1.5,0.3924486803574311,5,4,4,3,2,4,5,6,6,1,2,1.0690449676496976,3.2857142857142856,0,2.7142857142857144,3,3.8333333333333335,3.2559414990859232,-0.7395711320441822,0,-0.22619813465469363,2,2,2,3,2,2,5,2,2,4,1,4,2,5,5,2,5,2,5,2,1.52127765851133,2.2,0,4.4,0,4.4,0,4.4,0,4.4,0,2,2,4,1,3,4,4,2,3,4,3,2,2,4,4,3,3,4,4,3,0.9445132413883326,3.25,0,"White, Caucasian, Anglo, European American",0,27,1,2,NA,1,3,7,Teacher,4,0,230,65,1,5,2,0,0,0,0,0,TRUE,TRUE,TRUE,TRUE,TRUE,1,0.8644117647128947,0.68,0.07607939877499204,1,0.4668374999947846,0.5523099999944369,1,0.967741935483871,0.002843435966943177,0.004561914644226802,1,0.5748718750048428,0.6955677419343302,1,0.96875,0.00944902724620155,0.009736782568988267,1.4437,0.5469,0.4202,0,36.5146,0.004,ML,change,50,-61.293130983715564,0.6307864288744259,1.1949714956953168,0.5234170010668664,1.7733,4.4087,0.3596,5.4729,0.3048,0,-74.245,0.008,ML,cueing,63,160.9194041791746,4.051984744480213,0.839390470631809,0.4554147380132853,4.9756707123856705,0.832678640907295,0.3857773294160752,0.094,0.393,0.512,0.013,1.848,55.98906271229835,1904.9306369205633,0.095,0.393,0.552,0.014,1.946,62.28815448484281,1885.1922032587102,349,1.0340740740740741,1,0,0,1,FALSE,FALSE,FALSE
57,2021-11-12T23:53:14Z,2021-11-13T00:19:36Z,1581,1,2021-11-13T00:19:37Z,0.699999988079071,Safari,14.0.3,Macintosh,1440,900,NA,1.6,714,241,345,85,57,74,-0.19321452084169444,1.3735725730409982,-0.39719673149869317,-0.23862632611725865,-0.2064233775707615,-0.5299936521325801,1,2,3,3,1,2,3,2,1,4,1,3,3,2,2,1,2,1,2,1,0.9176629354822471,0,1,1,3,3,2.8,0,2,3,2,5,2,3,3,3,1,4,3,2,2,2,3,2,4,1,1,1,2,3,2,1,2,0,0,4,4,4,5,5,5,5,5,3,3,5,3,1,3,2,5,3,2,3,3,5,2,1,1,1,3,1,2,2,2,1,3,2,4,1,1,2,2,1,2,2,1.4488268009320848,0.9759000729485332,2,0,1.75,0,2.8,0,1.5555555555555556,0,2.5,0,1.6666666666666667,0,2.142857142857143,0,1.3333333333333333,0,2.027027027027027,0,1,0,0,0.07628619918548828,-0.2989446853297732,-0.11132924307214245,4,2,3,1,1,2,2,2,1,1.0690449676496976,1.8571428571428572,0,1.5,-0.20582161572857902,4,4,4,4,2,2,1,7,8,NA,3,1.2909944487358056,3.5714285714285716,0,2.4285714285714284,1.5,3.8333333333333335,3.2559414990859232,-1.5867162469311549,0,-0.8091126869410536,3,3,4,3,4,3,5,2,3,2,2,3,2,3,4,2,5,2,4,3,1.0690449676496976,3.4,0,3.8,0,3.8,0,3.4,0,3.6666666666666665,0,2,3,4,4,4,4,4,2,3,2,1,1,2,4,1,1,2,4,2,3,1.1821033884786185,2.85,0,"White, Caucasian, Anglo, European American",0,21,1,2,NA,1,3,4,student,1,0,95,59,2,5,2,0,1,1,0,1,TRUE,TRUE,TRUE,TRUE,TRUE,NA,NA,NA,NA,4,0.51865625,0.6203793103448236,1,0.9354838709677419,0.004310232862903826,0.00863549462365673,4,0.8501874999999995,0.907321428571426,1,0.9032258064516129,0.016765770161290088,0.028239090322580408,NA,NA,NA,NA,NA,NA,NA,NA,NA,NA,NA,NA,NA,1.58,3.0244,0.3857,4.0968,0.3258,0,-51.353,0.023,ML,cueing,63,115.1354041791746,3.0352706412635615,0.8810247801538049,0.4939747398712784,4.484224125713034,0.9239356932750847,0.41885496021523544,0.061,0.649,0.301,0.018,1.344,84.24596498083002,1961.9503288671754,0.059,0.653,0.298,0.016,1.476,89.12269110623718,1944.8067181503448,422,1.2503703703703704,1,0,0,1,FALSE,FALSE,FALSE
58,2021-11-12T23:56:06Z,2021-11-13T00:20:40Z,1474,1,2021-11-13T00:20:41Z,1,Chrome,94.0.4606.71,Windows NT 10.0,1536,864,n/a (fun!),1.7777777777777777,609,87,403,128,84,68,-0.46299805768573404,-0.025477127189070508,-0.11797086171080182,0.28538915484661415,0.16650223262404917,-0.6313418526976985,2,3,3,3,1,2,4,1,3,2,1,4,2,2,2,1,4,1,1,1,1.0894228312566052,0,1,2,5,5,3.15,0,4,5,5,4,5,1,4,2,3,1,1,5,3,5,4,1,3,1,1,1,2,2,1,1,2,0,0,5,5,3,5,2,5,3,3,3,2,5,2,1,5,2,5,2,1,1,1,2,5,1,1,1,3,2,1,2,2,2,5,1,1,1,1,1,2,2,2,2,1.5744773669313188,1.5522640914238175,1.5,0,2,0,2.1333333333333333,0,2.2222222222222223,0,1.4166666666666667,0,1.3333333333333333,0,1.2857142857142858,0,1,0,1.5945945945945945,0,1,0,0,-0.6109243796066618,-0.22054348261253207,-0.41573393110959694,4,1,3,1,1,1,1,1,1,1.2535663410560174,1.4285714285714286,0,1,-0.6467170085812028,5,5,5,5,2,2,1,3,6,3,3,1.8126539343499315,4.142857142857143,0,1.8571428571428572,4.5,3.8333333333333335,3.2559414990859232,0.10757398284279028,0,-0.28065156173982786,2,2,3,4,3,2,5,3,2,2,2,4,2,4,4,1,5,1,4,5,1.4375905768565218,2.8,0,4.4,0,4,0,3.2,0,3.8666666666666667,0,1,1,3,1,3,3,2,2,3,3,1,2,4,3,2,2,2,4,4,3,0.998683343734455,2.75,0,"Hispanic of Latino (e.g., Mexican American, Central American, and others)",0,20,1,2,NA,1,3,4,Student,4,0,135,61,1,5,2,0,0,1,0,0,TRUE,TRUE,TRUE,TRUE,TRUE,6,0.7234405406230204,0.74,0.038229965715789786,6,0.3831225806820777,0.4575192307875707,1,0.8125,0.0020888138069012955,0.006254063186612552,6,0.49268387097697103,0.5421586206699239,0.96875,0.90625,0.011973963835913594,0.014282000223766625,1.3113,0.8549,0.3407,0,20.3814,0.004,ML,change,50,-29.02673098371556,1.014757888833268,1.0307567614825883,0.479656653374554,0.8855,1.8615,0.2925,5.1492000000000004,0.2971,0,-72.3285,0.01,ML,cueing,63,157.08640417917462,2.137975886607947,0.685852949969364,0.3572706507133236,5.374493747678308,0.7708883703104684,0.31364644545902803,0.066,0.273,0.296,0.038,1.878,193.97459012439438,2136.478991011482,0.066,0.27,0.275,0.032,2.061,221.71391266147853,2153.8399008065353,386,1.1437037037037037,1,0,0,1,FALSE,FALSE,FALSE
59,2021-11-13T00:07:49Z,2021-11-13T00:30:23Z,1354,1,2021-11-13T00:30:26Z,1,Chrome,95.0.4638.69,Windows NT 10.0,1368,912,NA,1.5,812,63,263,60,44,75,0.058583446879409196,-0.24351084670544482,-0.7919643405091602,-0.5432864894683475,-0.3859801528497444,-0.513102285371727,3,2,1,1,3,1,2,3,1,4,2,2,1,1,3,3,2,1,3,4,1.0399898784932577,0,1,2,3,4,1.65,0,5,5,2,4,1,1,3,1,1,1,1,5,2,4,3,1,1,1,1,1,1,1,1,0,2,0,0,5,3,5,5,4,4,4,5,5,2,4,1,1,4,1,5,1,1,1,1,2,5,1,1,1,1,1,1,1,1,1,5,1,1,1,1,1,1,1,1,1,1.7376764714754929,1.6388149028228556,1,0,1,0,1.5333333333333334,0,1.5555555555555556,0,1.3333333333333333,0,0.8333333333333334,0,0.8571428571428571,0,1,0,1.2432432432432432,0,0,0,0,-1.234640572527312,-0.7372407672780129,-0.9859406699026625,5,1,4,1,1,2,1,1,1,1.6761634196950514,1.2857142857142858,0,1,-0.7321841937363471,5,5,5,5,2,2,1,5,7,NA,3,1.8126539343499315,4.142857142857143,0,1.8571428571428572,3,3.8333333333333335,3.2559414990859232,-0.7395711320441822,0,-0.7042241191833141,1,1,1,1,1,1,5,1,1,1,1,4,1,4,4,3,5,2,4,1,1.6417180315870614,1,0,4.6,0,3.6,0,4.6,0,4.266666666666667,0,1,1,2,3,1,1,2,1,2,1,1,3,2,3,1,2,1,2,2,2,0.7326950970650465,1.8,0,"White, Caucasian, Anglo, European American",0,22,1,2,NA,1,3,6,Unemployed,5,0,190,66,2,5,2,0,0,1,0,0,TRUE,TRUE,TRUE,TRUE,TRUE,5,0.9045418604652635,0.8775510204081632,0.10710586593541711,5,0.4151437500001048,0.47052580645151676,1,1,0.0011058180241830453,0.0018090986451667391,5,0.577603124999965,0.6363129032259026,1,0.96875,0.009194512570612766,0.0077204099898932205,1.3572,1.3967,0.5849,0,10.9874,0.004,ML,change,49,-10.29933910566812,1.3216301189877713,1.4901602333139095,0.4788467218812291,9.9987,14.27,0.1202,16.5437,0.113,0,-118.8504,0.021,ML,cueing,63,250.1302041791746,5.5711766890812315,0.7436731874814755,0.405868603801255,6.30074028197803,0.6575631657508748,0.3645929981588324,0.068,0.395,0.36,0.02,1.498,71.40794704158237,1912.4188759547353,0.068,0.395,0.392,0.016,1.6,92.00909233276067,1917.0173559820366,430,1.2740740740740741,1,0,0,1,FALSE,FALSE,FALSE
60,2021-11-12T23:58:37Z,2021-11-13T00:33:40Z,2103,1,2021-11-13T00:33:42Z,1,Edge,95.0.1020.44,Windows NT 10.0,1366,768,dd,1.7786458333333333,636,86,1061,76,52,110,-0.3936251482115524,-0.03456186550225277,3.0497984886414824,-0.3483039849236506,-0.2754836757549857,0.07809555125813061,2,2,2,2,2,2,4,1,2,4,1,2,1,1,3,3,2,2,2,2,0.8522416262267903,0,1,1,1,1,2.4,0,2,1,3,1,4,4,3,3,2,4,1,1,2,1,2,5,5,1,2,3,5,4,5,9,2,6,10,2,2,3,1,2,4,4,4,4,1,1,3,1,1,2,1,4,3,1,5,4,2,5,5,3,5,1,4,5,5,4,4,1,4,1,3,3,1,2,5,5,1.479083394433082,1.162919151265879,3.75,0,3.25,0,3.6,0,3.111111111111111,0,3.25,0,3.6666666666666665,0,3.4285714285714284,0,2.3333333333333335,0,3.2972972972972974,0,5,6,6,1.7180419509421723,3.282329553112966,2.500185752027569,4,2,2,1,1,2,3,3,2,1.0690449676496976,2.142857142857143,0,2.5,0.33410042935609163,3,3,3,3,4,4,3,4,3,1,2,0.4879500364742666,3.2857142857142856,0,2.7142857142857144,5.5,3.8333333333333335,3.2559414990859232,0.6723373927674386,0,0.4797561277511168,4,4,4,5,4,2,3,4,2,3,2,2,3,2,4,3,1,2,2,2,0.8338093878327919,4.2,0,3,0,2.8,0,3.2,0,3,0,1,1,1,2,1,2,2,2,3,3,2,3,3,3,1,2,2,3,3,3,0.812727700887249,2.25,0,"Hispanic of Latino (e.g., Mexican American, Central American, and others) & White, Caucasian, Anglo, European American",1,19,1,2,NA,1,3,3,cashier,2,0,160,64,2,5,2,0,1,0,0,1,TRUE,TRUE,TRUE,TRUE,TRUE,5,1.107406666658322,0.6122448979591837,0.1857327301522096,NA,NA,NA,NA,NA,NA,NA,5,0.7611517241391642,0.857779166671137,0.90625,0.75,0.031319036843246835,0.04890713189926922,1.8164,0.2659,0.45,0,61.1546,0.004,ML,change,49,-110.63373910566813,0.31112118878183487,1.4681044524293205,0.577750569940638,NA,NA,NA,NA,NA,NA,NA,NA,NA,NA,NA,NA,NA,NA,NA,NA,NA,NA,0.066,0.437,0.175,0.002,0.996,176.93420829819226,2321.7741644695966,0.066,0.497,0.212,0.002,0.913,167.69504618939416,2276.191501620762,308,0.9125925925925925,1,0,0,1,FALSE,FALSE,FALSE
61,2021-11-13T00:08:35Z,2021-11-13T00:37:06Z,1710,1,2021-11-13T00:37:08Z,1,Chrome,95.0.4638.69,Macintosh,1440,900,NA,1.6,822,113,442,114,71,89,0.08427711705503202,0.21072606895366833,0.06978446452588374,0.11477946337000441,-0.013054542654933752,-0.27662315071978394,1,2,3,3,1,1,1,2,1,2,2,1,2,2,1,2,1,1,4,2,0.8506963092234007,0,1,2,4,5,2.35,0,5,5,2,5,2,1,5,2,1,1,1,4,2,4,4,1,1,1,1,1,1,1,1,0,2,0,0,5,5,5,5,5,5,5,5,5,1,5,1,1,5,1,5,1,1,1,1,1,5,1,1,1,2,1,1,1,1,1,5,1,1,1,1,1,1,1,1,1,1.9521298140264163,1.6676187756655838,1,0,1,0,1.4666666666666666,0,1,0,1,0,1,0,0.8571428571428571,0,1,0,1.027027027027027,0,0,0,0,-1.356209091817867,-0.7372407672780129,-1.04672492954794,5,1,4,2,1,1,1,1,1,1.6761634196950514,1.2857142857142858,0,1,-0.7321841937363471,5,5,5,5,3,3,1,6,7,6,4,1.5735915849388864,4.428571428571429,0,1.5714285714285714,2.5,3.8333333333333335,3.2559414990859232,-1.0219528370065065,0,-1.00475696650735,1,1,1,1,1,1,5,1,1,3,1,5,1,4,5,1,5,1,5,1,1.9148542155126762,1,0,5,0,4.6,0,4.8,0,4.8,0,1,1,1,2,2,1,1,4,1,1,2,2,1,3,1,3,1,2,1,2,0.8750939799154206,1.55,0,"White, Caucasian, Anglo, European American",0,28,1,2,NA,1,3,7,Analyst,3,0,140,65,3,5,2,0,0,0,0,0,TRUE,TRUE,TRUE,TRUE,TRUE,4,0.7025911764677834,0.68,0.027831511628053814,4,0.4604875000193715,0.5499593750163912,1,1,0.0017961830646547581,0.004696828942004317,4,0.6242406250052154,0.6744500000067055,1,1,0.005499767006397732,0.0040986735496946316,1.0696,0.7263,0.4542,0,7.7427,0.004,ML,change,50,-3.749330983715563,0.8110822743407896,0.9293407416516547,0.4963465835462373,2.9433,6.7355,0.3315,9.1967,0.3005,0,-98.8617,0.012,ML,cueing,64,210.20004925007902,4.3889568235399095,0.9439907688701961,0.4457784620898635,5.581164781096107,0.7423423046788893,0.39606151226736336,0.076,0.493,0.579,0.02,1.493,73.21102206980457,1861.7446501218374,0.079,0.496,0.602,0.029,1.546,85.26359647786576,1872.6017101152916,382,1.1318518518518519,1,0,0,1,FALSE,FALSE,FALSE
62,2021-11-13T00:12:53Z,2021-11-13T00:37:07Z,1453,1,2021-11-13T00:37:08Z,0.8999999761581421,Chrome,94.0.4606.71,Windows NT 10.0,1366,768,NA,1.7786458333333333,768,57,320,58,80,83,-0.05446870189333121,-0.2980192765845384,-0.5175527098555429,-0.5676593025364346,0.1112539940766698,-0.3779713512849024,3,2,3,3,2,2,1,2,1,2,2,2,1,2,2,1,2,1,2,2,0.6407232755171874,0,1,4,2,3,2.4,0,3,4,2,4,2,2,5,2,2,2,4,4,1,4,5,2,4,1,1,1,2,2,1,2,2,0,0,5,3,5,5,5,4,5,5,4,3,4,2,1,5,5,5,2,2,2,4,3,3,1,1,1,2,2,2,3,1,1,4,4,3,3,4,1,2,2,2,2,1.4678741957860881,1.2798809468443688,1.75,0,2,0,2,0,1.4444444444444444,0,2.3333333333333335,0,1.5,0,2.142857142857143,0,2.6666666666666665,0,2.027027027027027,0,1,0,0,-0.3749498174805686,-0.22054348261253207,-0.2977466500465503,3,2,4,2,1,2,1,1,1,1.0690449676496976,1.8571428571428572,0,1,-0.39031545311577004,4,5,4,5,3,2,2,6,6,NA,3,1.2724180205607036,3.857142857142857,0,2.142857142857143,3,3.8333333333333335,3.2559414990859232,-0.7395711320441822,0,-0.5448821243404407,3,2,4,4,3,3,4,2,2,3,1,3,4,2,3,5,3,2,2,3,1.01418510567422,3.2,0,3.6,0,2.4,0,3.2,0,3.066666666666667,0,3,4,3,2,3,4,3,1,2,2,4,3,4,3,1,2,1,2,1,4,1.0954451150103321,2.8,0,"Asian or Asian American (e.g., Chinese, Japanese, and others) & Filipino",1,24,1,2,NA,1,2,6,NA,1,0,181,67,1,5,2,0,0,2,0,0,TRUE,TRUE,TRUE,TRUE,TRUE,6,0.7254444444444444,0.7346938775510204,0.050971701238056916,6,0.4236433333158493,0.5012566666682561,0.967741935483871,0.9375,0.00329592761208767,0.003791499962449304,6,0.5211093749925494,0.5926892857381276,1,0.9032258064516129,0.005877547329066022,0.008462406793369712,1.1715,0.9127,0.4431,0,10.8243,0.025,ML,change,49,-9.97313910566812,0.9219536479444943,1.1047947836265797,0.44420625828882887,1.0594,3.002,0.3433,4.9103,0.3201,0,-75.0577,0.007,ML,cueing,63,162.5448041791746,3.756595318163241,0.7208788734865087,0.417301787199218,4.39501310293605,0.7738765054852774,0.3412830567880355,0.07,0.35,0.401,0.02,1.648,89.58821932796057,1990.5238315920135,0.07,0.344,0.41,0.016,1.834,104.1328938480067,1989.9045020469325,348,1.031111111111111,1,0,0,1,FALSE,FALSE,FALSE
63,2021-11-13T00:10:34Z,2021-11-13T00:38:28Z,1673,1,2021-11-13T00:38:30Z,1,Chrome,95.0.4638.69,Windows NT 10.0,1280,720,all its ok,1.7777777777777777,786,83,373,98,51,140,-0.008220095577210136,-0.06181608044179956,-0.2623980357390215,-0.08020304117469244,-0.28929573539183057,0.5848365540837228,3,4,2,2,4,1,1,3,1,4,4,1,1,1,4,4,1,1,4,4,1.3954814298487213,0,1,1,5,5,1.2,0,3,4,2,4,3,2,4,2,1,1,4,4,1,4,3,1,2,3,1,1,2,3,3,0,2,0,0,5,4,4,5,4,5,3,3,3,2,5,1,1,4,2,5,3,2,1,4,2,4,1,1,1,3,1,1,1,3,1,4,2,2,1,1,1,3,2,2,2,1.4806053465364064,1.2071217242444348,2,0,2.25,0,2.1333333333333333,0,2,0,1.8333333333333333,0,1.3333333333333333,0,1.5714285714285714,0,1,0,1.7297297297297298,0,0,0,0,-0.33797595253710344,-0.34523475369180734,-0.3416053531144554,5,2,3,1,1,1,1,2,2,1.5275252316519468,1.4285714285714286,0,2,-0.2777293338068208,3,4,4,5,2,2,3,3,1,1,2,1.1126972805283737,3.2857142857142856,0,2.7142857142857144,7,3.8333333333333335,3.2559414990859232,1.5194825076544112,0,0.903328685194603,2,2,2,2,2,2,3,2,2,3,4,4,2,4,4,2,3,2,4,2,0.9154754164341269,2,0,3.4,0,3.6,0,4,0,3.6666666666666665,0,1,1,1,3,3,1,3,1,1,1,1,4,2,2,1,4,1,2,1,2,1.0563093645728086,1.6,0,Native American/Alaskan Native/indigenous,0,21,0,1,NA,1,3,4,Student,2,0,183,70,4,5,2,0,0,1,0,0,TRUE,TRUE,TRUE,TRUE,TRUE,6,0.9433666666646798,0.72,0.09967656491554432,6,0.5061156249940395,0.566456666670243,1,0.967741935483871,0.0020398194252397557,0.002177332258386548,6,0.6687033333321413,0.7254281250108033,0.9375,1,0.006163326521906345,0.00808563434556498,1.6254,0.599,0.3008,0,46.6332,0.004,ML,change,50,-81.53033098371557,0.7277095024218608,1.2978552646318708,0.5510010904714918,1.4681,5.1053,0.4317,5.9282,0.3823,0,-91.4442,0.01,ML,cueing,63,195.31780417917457,4.874986458190022,0.6976834522172085,0.4995158020967837,5.4064795367525695,0.7663276441216549,0.43745912678700405,0.065,0.531,0.455,0.022,1.401,105.91316886808487,1992.4826690054888,0.063,0.53,0.432,0.026,1.522,132.3161239723271,2000.0727248042265,350,1.0370370370370372,1,0,1,2,FALSE,FALSE,FALSE
64,2021-11-13T00:21:15Z,2021-11-13T00:40:13Z,1138,1,2021-11-13T00:40:13Z,1,Chrome,95.0.4638.69,Macintosh,1440,900,NA,1.6,598,53,301,57,35,62,-0.49126109487891917,-0.33435822983726743,-0.6090232534067487,-0.5798457090704782,-0.510288689581348,-0.732690053262817,3,3,2,1,3,1,1,2,2,3,2,3,3,1,3,3,2,1,2,2,0.812727700887249,0,1,2,3,3,2.05,0,4,5,2,5,2,1,4,1,1,1,1,5,1,5,4,2,3,1,1,1,2,1,1,1,2,0,0,5,5,5,5,5,5,5,5,5,1,4,1,1,5,1,5,1,1,2,3,1,4,1,1,1,3,2,1,2,2,1,5,1,1,1,1,1,1,1,1,1,1.8112925718339323,1.780850519113991,1.5,0,1,0,1.3333333333333333,0,1,0,1.3333333333333333,0,1.5,0,1.1428571428571428,0,1,0,1.2702702702702702,0,1,0,0,-1.0941011696531993,-0.5341482934814965,-0.8141247315673479,5,1,5,1,1,1,1,1,1,1.9518001458970664,1,0,1,-0.9031185640466358,5,5,5,5,3,2,1,6,7,5,4,1.7043362064926932,4.285714285714286,0,1.7142857142857142,2.5,3.8333333333333335,3.2559414990859232,-1.0219528370065065,0,-0.9250859690859132,2,2,2,3,2,2,4,2,2,2,1,4,3,4,3,2,5,3,4,3,1.0997835284835873,2.2,0,4.2,0,3.4,0,3.6,0,3.7333333333333334,0,2,1,1,3,2,1,1,2,1,2,2,4,2,2,1,4,2,2,2,2,0.8870412083230169,1.65,0,Prefer not to say,0,22,1,2,NA,1,4,6,Model,1,0,140,64,3,5,2,0,0,0,0,0,TRUE,TRUE,TRUE,TRUE,TRUE,NA,NA,NA,NA,6,0.4675906249999534,0.5547099999999627,1,0.9375,0.004580473780235238,0.00668766611897372,6,0.6511516129032618,0.727343333333296,1,0.967741935483871,0.011695599247325588,0.014382498494638409,NA,NA,NA,NA,NA,NA,NA,NA,NA,NA,NA,NA,NA,1.2691,3.251,0.3795,4.6755,0.3319,0,-70.345,0.012,ML,cueing,64,153.16664925007902,3.259706745552263,0.8307649774929092,0.44320927124604226,4.416567720582316,0.9380892558453214,0.36470824844711125,0.065,0.493,0.388,0.019,1.596,73.26052254316546,1907.5269191248497,0.064,0.497,0.422,0.02,1.689,81.6816492678608,1906.7162022479413,104,0.3081481481481481,1,1,5,6,FALSE,FALSE,FALSE
65,2021-11-13T00:08:00Z,2021-11-13T00:41:26Z,2005,1,2021-11-13T00:41:27Z,1,Chrome,95.0.4638.69,Windows NT 10.0,1920,1080,NA,1.7777777777777777,738,83,559,171,79,130,-0.13154971242019967,-0.06181608044179956,0.6330504432359404,0.8094046358104869,0.09744193443982496,0.4159228864751921,3,2,1,2,1,1,2,2,1,2,3,1,1,1,2,1,2,2,1,2,0.6708203932499369,1,1,2,3,2,2.25,0,2,3,3,3,2,2,4,2,2,1,1,5,1,4,3,2,2,5,1,2,2,2,3,1,4,0,0,4,3,4,4,4,3,3,5,3,2,3,1,1,4,4,5,3,5,1,5,2,3,1,3,1,2,1,2,2,1,1,5,1,2,1,1,1,3,3,2,2,1.4405120877920723,1.1872336794093274,2.375,0,2.5,0,2.1333333333333333,0,2.3333333333333335,0,2.5,0,1.6666666666666667,0,1.2857142857142858,0,1,0,2.027027027027027,0,1,0,0,-0.0490571387773049,-0.06374107717804986,-0.05639910797767738,5,1,1,1,1,1,1,1,2,1.5118578920369088,1.5714285714285714,0,1.5,-0.3767559860388676,4,4,5,4,1,1,2,8,8,3,4,1.632993161855452,3.2857142857142856,0,2.7142857142857144,1,3.8333333333333335,3.2559414990859232,-1.869097951893479,0,-0.7909615445793421,2,2,3,3,3,3,4,2,3,3,4,3,2,4,4,1,3,3,3,4,0.8837151016885368,2.6,0,2.8,0,3.8,0,3.4,0,3.3333333333333335,0,1,3,2,2,3,2,3,1,1,1,2,2,1,1,1,2,1,3,1,3,0.8335087534664907,2.1,0,"White, Caucasian, Anglo, European American",0,22,0,1,NA,1,3,7,unemployed,2,0,190,73,3,5,2,0,0,1,0,0,TRUE,TRUE,TRUE,TRUE,TRUE,2,0.9394512195143758,0.82,0.08001829381210249,2,0.4517593750022352,0.5119838709715874,1,0.96875,0.004085450231647294,0.010013242862749764,2,0.8318733333359162,1.220229032259795,0.9375,0.96875,0.028881059355110043,0.20017350692142483,1.5389,1.0872,0.5196,0,22.1834,0.005,ML,change,50,-32.63073098371556,1.16193432666264,1.305019960743745,0.5800450311823158,1.5009,3.4739,0.3043,5.1353,0.3056,0,-69.7033,0.011,ML,cueing,64,151.88324925007902,3.344391641976668,1.0267897938100108,0.36806899275954563,4.544671672156969,0.9116466546471417,0.3545952935901385,0.092,0.476,0.159,0.067,1.841,212.40335819559567,2130.6518504795777,0.096,0.471,0.163,0.015,2.004,210.76000327905717,2099.7223923386596,310,0.9185185185185185,1,1,0,1,FALSE,FALSE,FALSE
66,2021-11-12T23:57:52Z,2021-11-13T00:48:39Z,3047,1,2021-11-13T00:48:40Z,1,Chrome,95.0.4638.69,Windows NT 10.0,1366,768,No I do not have any other feedback.,1.7786458333333333,1193,129,844,539,85,138,1.0375122805706387,0.35608188196458457,2.0051085965040274,5.294002240338515,0.18031429226089402,0.5510538205620167,2,2,3,1,2,3,3,2,1,3,2,1,1,3,2,2,2,1,2,2,0.7254762501100116,0,0,3,2,2,2.4,0,2,3,4,4,3,4,2,4,3,4,4,2,3,2,4,5,5,5,2,5,5,5,4,7,2,20,15,4,3,3,4,4,4,4,5,2,2,2,5,3,2,4,4,2,5,5,5,5,1,4,5,4,4,2,4,3,4,4,4,2,2,2,2,5,3,5,5,4,1.1930731006201687,0.8618916073713346,4.5,0,4.25,0,3.466666666666667,0,2.3333333333333335,0,3.8333333333333335,0,3.8333333333333335,0,2.857142857142857,0,3,0,3.27027027027027,0,4,6,6,1.9714387530939819,3.3928418901854136,2.6821403216396975,4,2,4,2,1,1,1,8,3,1.3451854182690985,1.5714285714285714,0,5.5,1.099194713058661,3,3,3,3,1,2,3,3,2,2,3,0.7867957924694432,2.5714285714285716,0,3.4285714285714284,6.5,3.8333333333333335,3.2559414990859232,1.237100802692087,0,1.1604928198206246,4,4,3,2,3,3,4,2,1,2,1,3,4,4,4,4,2,2,4,2,1.1464230084422218,3.2,0,3.4,0,2.8,0,4.2,0,3.466666666666667,0,2,4,3,1,3,4,3,2,3,3,4,2,3,4,3,1,4,4,4,3,0.9733285267845752,3.4,0,"White, Caucasian, Anglo, European American",0,30,1,2,NA,1,1,4,Stay at home mom,2,0,130,68,1,5,2,0,1,2,0,1,TRUE,TRUE,TRUE,TRUE,TRUE,NA,NA,NA,NA,5,0.5874343750011176,0.6548000000012107,1,1,0.029133753941519586,0.013628842580329661,5,0.6054531250009313,0.7220218749996274,1,1,0.0043332574092732265,0.013088323054601796,NA,NA,NA,NA,NA,NA,NA,NA,NA,NA,NA,NA,NA,1.7764,3.7479,0.4178,3.3006,0.3183,0,-46.6979,0.01,ML,cueing,64,105.872449250079,3.362774539159301,1.232058432150293,0.4773339534008955,2.781079362875892,1.4897578191034253,0.32796625148736813,0.095,0.42,0.499,0.014,1.57,25.27692568150686,1814.0421805662359,0.096,0.421,0.498,0.015,1.608,36.56664992494157,1815.9468125162587,392,1.1614814814814816,1,0,0,1,FALSE,FALSE,FALSE
68,2021-11-13T00:28:58Z,2021-11-13T00:50:22Z,1283,1,2021-11-13T00:50:23Z,1,Chrome,95.0.4638.69,Macintosh,1440,900,NA,1.6,661,62,268,91,56,70,-0.3293909727724954,-0.2525955850186271,-0.7678931448377903,-0.1655078869129973,-0.22023543720760635,-0.5975591191759924,2,3,3,2,2,3,3,2,1,3,3,3,3,2,2,2,2,1,3,3,0.6805570473787206,0,0,3,4,3,2.4,0,4,5,2,5,1,1,5,1,1,1,1,5,2,4,5,1,1,1,1,1,1,1,1,0,2,0,0,5,5,5,5,5,5,5,5,5,1,5,1,1,4,1,5,1,1,1,1,1,5,1,1,1,1,1,1,1,1,1,5,1,1,1,1,1,1,1,1,1,1.9382354750537296,1.8464895909600492,1,0,1,0,1.2666666666666666,0,1,0,1.0833333333333333,0,0.8333333333333334,0,0.8571428571428571,0,1,0,1.027027027027027,0,0,0,0,-1.4421588092780684,-0.7372407672780129,-1.0896997882780406,5,1,3,1,1,2,1,1,1,1.5275252316519468,1.4285714285714286,0,1,-0.6467170085812028,5,5,5,5,3,3,1,7,7,NA,3,1.5735915849388864,4.428571428571429,0,1.5714285714285714,2,3.8333333333333335,3.2559414990859232,-1.3043345419688306,0,-1.145947818988512,2,2,2,3,2,3,4,3,2,2,2,4,3,3,3,4,4,3,3,3,0.7037315505489968,2.2,0,3.6,0,2.8,0,3.2,0,3.2,0,1,1,2,4,1,2,1,3,1,1,2,3,2,1,2,4,1,2,2,1,0.9880869341680844,1.45,0,"White, Caucasian, Anglo, European American",0,21,1,3,NA,1,3,4,student,7,0,115,60,2,5,2,0,0,1,0,0,TRUE,TRUE,TRUE,TRUE,TRUE,3,0.7934558823529412,0.6938775510204082,0.03729466588285492,3,0.4442000000106877,0.5149935483874813,1,0.96875,0.003646572857310007,0.005945992569507244,3,0.6106656250059604,0.6949419354834864,1,0.96875,0.0176954500718404,0.017014306088015182,1.3174,0.6663,0.4004,0,24.2543,0.005,ML,change,49,-36.833139105668124,0.8145079325477003,1.004668328955812,0.5543143989833957,1.5204,4.1712,0.3414,4.522,0.2761,0,-67.4062,0.007,ML,cueing,61,147.14502159251992,3.8098223594918315,0.9013510028701665,0.40409381534802635,4.675642209675085,0.8861103011300437,0.3524030536528758,0.076,0.352,0.281,0.013,1.683,115.91639608697635,1962.8879419739392,0.079,0.361,0.303,0.014,1.775,121.2147525655778,1946.5048051941676,434,1.285925925925926,1,0,0,1,FALSE,FALSE,FALSE
69,2021-11-13T00:17:39Z,2021-11-13T00:51:23Z,2023,1,2021-11-13T00:51:23Z,1,Chrome,95.0.4638.69,Windows NT 10.0,1536,864,"No, it was great.",1.7777777777777777,831,112,608,105,95,149,0.10740142021309255,0.20164133064048606,0.8689481608153659,0.0051018045636124325,0.3184348886293424,0.7368588549314005,4,4,1,2,4,1,2,3,1,3,3,1,1,1,4,3,2,1,4,4,1.2763022245616642,0,1,1,5,4,1.35,0,4,4,3,3,4,3,3,2,2,3,2,3,3,3,2,3,4,5,1,2,3,3,3,7,2,1,1,3,1,3,3,2,2,1,1,3,3,4,2,1,3,2,4,5,5,4,3,3,1,1,1,2,3,3,1,5,5,5,5,1,4,1,3,1,3,4,4,4,1.4311002927985332,0.7037315505489968,3,0,3.75,0,2.8,0,3.888888888888889,0,2.9166666666666665,0,2.3333333333333335,0,3,0,1.6666666666666667,0,3.027027027027027,0,4,1,1,0.9357833737875021,1.3206252122899094,1.1282042930387057,4,2,4,1,1,1,1,1,1,1.4142135623730951,1.4285714285714286,0,1,-0.6467170085812028,4,3,5,5,1,1,3,3,7,3,2,1.6761634196950514,3.142857142857143,0,2.857142857142857,4,3.8333333333333335,3.2559414990859232,-0.1748077221195339,0,0.13585456772906723,3,2,2,3,2,3,4,4,2,4,2,2,1,3,4,1,5,1,5,2,1.4074631010979937,2.4,0,3.8,0,4.6,0,3.4,0,3.933333333333333,0,3,4,2,3,2,2,3,3,3,1,2,3,3,3,2,3,1,2,2,3,0.7608859102526822,2.3,0,"White, Caucasian, Anglo, European American",0,27,1,2,NA,1,3,6,"Student, English teacher",2,0,112,62,2,5,2,0,0,1,0,0,TRUE,TRUE,TRUE,TRUE,TRUE,2,1.3508108695797298,0.92,0.17821716056586864,2,0.5335499999523163,0.5685718750208616,1,1,0.0036574477425243006,0.0018312330512520382,2,0.6140031250566244,0.7716599999427796,1,0.9375,0.008059516428429022,0.015498375708348363,2.0297,1.2538,0.6662,0,34.9922,0.004,ML,change,50,-58.248330983715555,1.3470299922902453,1.8131348591701968,0.7854807394341211,5.5767,11.5037,0.3262,9.1896,0.2301,0,-101.7411,0.015,ML,cueing,64,215.95884925007903,5.554264913729714,0.7459375436252642,0.5035203329526488,4.672162743300981,0.886770207722756,0.44161627611498305,0.087,0.451,0.494,0.01,1.675,32.20524715201663,1884.4356471648564,0.086,0.452,0.551,0.01,1.742,17.732463013704457,1862.0555991555943,376,1.114074074074074,1,0,0,1,FALSE,FALSE,FALSE
70,2021-11-13T00:27:47Z,2021-11-13T00:53:43Z,1555,1,2021-11-13T00:53:44Z,0.8999999761581421,Chrome,85.0.4183.102,Macintosh,1440,900,n/a,1.6,768,73,319,41,148,129,-0.05446870189333121,-0.15266346357362218,-0.5223669489898168,-0.7748282136151751,1.050474049382119,0.39903151971433903,2,2,3,3,2,1,3,2,2,2,2,2,3,1,2,2,3,1,2,2,0.6407232755171874,0,0,4,3,2,2.6,0,3,3,3,3,3,1,3,2,2,2,3,5,4,4,4,2,2,1,1,1,1,1,1,2,2,0,0,4,4,4,4,4,5,5,4,4,2,4,3,3,3,3,3,3,2,4,4,4,5,5,1,1,1,1,1,1,1,1,5,1,1,1,1,1,1,1,1,1,1.5245734893157248,1,1.25,0,1,0,2.466666666666667,0,1.7777777777777777,0,3,0,1.5,0,0.8571428571428571,0,1,0,1.945945945945946,0,1,0,0,-0.42411925044203497,-0.5341482934814965,-0.47913377196176576,5,1,3,2,1,3,3,4,1,1.3972762620115438,2,0,2.5,0.24863324420094737,5,5,5,5,3,3,1,5,5,6,4,1.5735915849388864,4.428571428571429,0,1.5714285714285714,4,3.8333333333333335,3.2559414990859232,-0.1748077221195339,0,-0.5811844090638635,1,2,2,4,4,2,4,3,3,3,3,3,3,3,3,4,3,4,4,3,0.560611910581388,2.6,0,3,0,3.2,0,3,0,3.066666666666667,0,3,1,1,3,2,1,2,3,1,2,2,3,1,2,1,3,1,2,2,2,0.7880689256524124,1.7,0,"White, Caucasian, Anglo, European American",0,18,0,1,NA,1,4,3,Unemployed,7,0,165,72,3,5,3,0,0,2,1,0,TRUE,TRUE,TRUE,TRUE,TRUE,2,1.045731818179995,0.7333333333333333,0.1981721780430064,2,0.4263118749968271,0.5225154838671217,1,0.96875,0.0019436104355094708,0.010823585382358232,2,0.7554538709678567,0.8769028124934266,1,1,0.17193776667564417,0.11310529960628485,1.487,0.6885,0.517,0,34.0059,0.009,ML,change,45,-56.59181253068903,0.6524942921560289,1.550359786804968,0.4913198926352811,1.3412,3.0878,0.3136,7.2563,0.3339,0,-84.3361,0.01,ML,cueing,64,181.14884925007902,3.2799560922281263,1.0469613336050436,0.37289057690869315,5.472177660619082,0.7571272322183357,0.35929403934704907,0.124,0.307,0.318,0.004,1.013,117.43788133276776,1933.1240327210658,0.125,0.311,0.329,0.004,1.027,138.60150732674435,1920.2491507099958,440,1.3037037037037038,1,0,0,1,FALSE,FALSE,FALSE
71,2021-11-13T00:34:17Z,2021-11-13T00:54:03Z,1185,1,2021-11-13T00:54:05Z,1,Chrome,95.0.4638.69,Windows NT 10.0,1280,720,I was a little confused if when it asked me about the number of romantic partners my mom or dad had before I was 13 if this referred to their total number of romantic partners in their life before I hit 13 or the number of romantic partners when I was aged 0-13,1.7777777777777777,612,39,250,89,39,55,-0.4552899566330472,-0.46154456622181916,-0.8545494492547221,-0.18988069998108442,-0.4550404510339686,-0.8509296205887885,2,3,2,2,2,1,2,2,1,3,2,1,1,2,2,2,1,2,2,3,0.6407232755171874,0,1,1,4,4,2.1,0,2,5,3,5,3,3,4,3,2,2,2,4,2,3,3,2,2,1,3,2,1,4,2,1,2,0,0,4,4,5,4,4,5,5,5,5,2,4,1,1,5,2,5,1,2,2,2,2,4,1,1,1,3,1,1,3,1,1,5,1,1,1,3,1,2,2,1,1,1.633912381270694,1.0327955589886444,2.125,0,1.5,0,2.4,0,1.4444444444444444,0,1.5833333333333333,0,1.3333333333333333,0,1.1428571428571428,0,1.6666666666666667,0,1.4864864864864864,0,1,0,0,-0.2741911959985085,-0.3773458880470143,-0.3257685420227614,5,2,4,1,1,1,1,1,1,1.6761634196950514,1.2857142857142858,0,1,-0.7321841937363471,4,5,5,5,2,3,3,7,7,5,3,1.2149857925879117,3.857142857142857,0,2.142857142857143,2,3.8333333333333335,3.2559414990859232,-1.3043345419688306,0,-0.827263829302765,2,2,2,3,3,2,4,2,2,3,1,4,4,4,5,2,4,2,4,3,1.162919151265879,2.4,0,4.2,0,3.4,0,4,0,3.8666666666666667,0,2,1,2,4,2,2,2,3,1,1,3,3,2,2,1,3,2,2,1,2,0.8255779474818965,1.75,0,"White, Caucasian, Anglo, European American",0,22,1,2,NA,1,3,4,Student,1,0,138,70,3,5,2,0,0,0,0,0,TRUE,TRUE,TRUE,TRUE,TRUE,6,0.8102540540542151,0.74,0.03912425387767074,6,0.47694193548252506,0.5965655172415848,0.96875,0.9666666666666667,0.006830527701881968,0.009846476091575747,6,0.6439812499973923,0.6538419354856014,1,1,0.013102251895646604,0.004608145849591081,1.4163,0.7853,0.3954,0,28.7819,0.003,ML,change,50,-45.82773098371556,1.0089087679379753,1.0367325455208956,0.5636353122689208,1.309,3.2409,0.4027,3.6414,0.3045,0,-55.8512,0.01,ML,cueing,62,124.08380315513527,3.326755395125665,1.0121861784368664,0.4545792592109244,3.6799952033273713,0.9331499131792916,0.3580792746270726,0.126,0.438,0.635,0.044,1.432,43.73880034581698,1838.6452493903496,0.123,0.439,0.638,0.036,1.476,57.34580280321297,1840.8972785994968,362,1.0725925925925925,1,0,0,1,FALSE,FALSE,FALSE
72,2021-11-13T00:27:03Z,2021-11-13T00:55:43Z,1720,1,2021-11-13T00:55:48Z,1,Chrome,95.0.4638.69,Windows NT 10.0,1536,1024,NA,1.5,833,69,449,168,51,82,0.11254015424821712,-0.18900241682635124,0.10348413846580166,0.7728454162083563,-0.28929573539183057,-0.39486271804575546,2,3,1,3,2,1,1,2,1,3,3,1,2,1,3,3,1,1,2,3,0.8870412083230169,1,1,5,4,3,1.85,0,3,5,3,4,4,1,2,1,1,1,1,4,1,4,4,1,2,1,1,1,1,1,2,2,2,1,4,4,3,5,5,5,5,5,5,5,2,5,1,1,5,1,1,1,2,2,3,3,5,4,1,1,2,1,1,3,3,1,5,1,1,1,1,1,1,1,2,2,1.7264068119885534,1.5023790657297036,1.25,0,1.5,0,1.9333333333333333,0,1.3333333333333333,0,1.9166666666666667,0,1.5,0,1.4285714285714286,0,1,0,1.5945945945945945,0,1,1,4,-0.8043112438921151,0.5350859071427324,-0.13461266837469132,5,1,4,1,1,1,1,2,2,1.7320508075688772,1.1428571428571428,0,2,-0.44866370411710943,5,5,5,5,4,4,2,3,4,3,3,1.1126972805283737,4.571428571428571,0,1.4285714285714286,5.5,3.8333333333333335,3.2559414990859232,0.6723373927674386,0,-0.23728284904181396,2,2,2,2,2,2,5,2,2,3,1,4,3,4,5,3,4,2,4,2,1.2227992865708155,2,0,4.2,0,3.6,0,4.2,0,4,0,2,2,3,2,1,3,3,2,3,2,3,2,2,2,1,2,3,3,1,3,0.7163503994113789,2.45,0,"White, Caucasian, Anglo, European American",0,30,1,2,NA,1,2,3,Housewife,2,0,187,62,1,5,2,0,1,2,0,1,TRUE,TRUE,TRUE,TRUE,TRUE,5,0.8898217391301271,0.9387755102040817,0.037532288418429,5,0.5991531250004191,0.6713968750002095,1,1,0.0072620032157143044,0.004783530635104136,5,0.7343781250003958,0.7715968750001629,1,1,0.009577992086679952,0.014504240957706823,1.4895,2.0421,0.5712,0,-6.8965,0.004,ML,change,49,25.468460894331876,2.127896715029424,1.2829706858132144,0.6252712497814044,1.6727,5.5042,0.5195,5.1875,0.4379,0,-85.5806,0.007,ML,cueing,64,183.63784925007903,4.368932696538459,0.9483173612800609,0.5662587889331091,3.9359392366789883,1.0526419431940643,0.46961010856278756,0.276,0.267,0.579,0.038,1.301,33.87545331028744,1847.4137612377722,0.276,0.273,0.586,0.039,1.349,55.164051790486205,1837.0941061358567,519,1.5377777777777777,1,0,0,1,FALSE,FALSE,FALSE
73,2021-11-13T00:37:31Z,2021-11-13T00:57:16Z,1184,1,2021-11-13T00:57:16Z,1,Chrome,95.0.4638.69,Windows NT 10.0,1920,1080,N/A,1.7777777777777777,656,37,275,67,45,62,-0.3422378078603068,-0.47971404284818364,-0.7341934708978723,-0.45798164373004263,-0.37216809321289956,-0.732690053262817,3,3,2,1,3,1,1,3,1,2,2,1,1,1,3,3,1,1,2,2,0.8750939799154206,0,1,3,3,3,1.75,0,4,5,3,4,1,1,4,1,1,1,2,3,1,4,3,2,1,1,1,1,1,1,2,0,2,0,0,5,1,2,4,4,5,5,5,5,2,5,1,1,4,2,5,1,1,2,3,3,4,1,1,1,1,1,1,1,1,1,4,2,2,1,1,1,1,1,1,1,1.6251588048991217,1.4573295865416045,1.25,0,1,0,1.7333333333333334,0,2,0,1.6666666666666667,0,1,0,1.2857142857142858,0,1,0,1.5675675675675675,0,0,0,0,-0.9018757880361272,-0.7372407672780129,-0.81955827765707,5,1,5,1,1,1,1,1,1,1.9518001458970664,1,0,1,-0.9031185640466358,5,5,5,5,3,2,1,7,6,6,4,1.7043362064926932,4.285714285714286,0,1.7142857142857142,2.5,3.8333333333333335,3.2559414990859232,-1.0219528370065065,0,-0.9250859690859132,2,2,2,1,2,1,4,3,1,5,1,4,1,4,4,1,4,2,3,4,1.4735767952260144,1.8,0,4.4,0,4.4,0,3.6,0,4.133333333333334,0,1,2,1,4,1,1,2,1,1,1,1,3,1,2,2,2,1,1,1,1,0.8271701918685112,1.5,0,"White, Caucasian, Anglo, European American",0,24,0,1,NA,1,4,6,Software Engineer,6,0,125,69,1,5,2,0,0,0,0,0,TRUE,TRUE,TRUE,TRUE,TRUE,6,0.9425463414642868,0.8367346938775511,0.042435825349207784,6,0.38460937500000003,0.4423766666680574,1,1,0.001639010554375649,0.0035681721958764076,6,0.5709624999975785,0.6194387096791498,1,0.96875,0.016095947580796605,0.00418458031282337,1.3903,1.2792,0.5811,0,12.4326,0.003,ML,change,49,-13.189739105668123,1.4458864104860094,1.1301928790347977,0.6793339961622469,2.0656,6.7902,0.2903,8.7521,0.2666,0,-106.9036,0.01,ML,cueing,62,226.18860315513527,4.701116818774019,0.881308609444851,0.3515718910889697,5.710406918823837,0.7255410665628864,0.32306665849797145,0.075,0.373,0.38,0.036,1.95,145.74870719719442,2002.1563431127372,0.074,0.38,0.411,0.028,2.111,160.2143201792689,1986.0320607109506,320,0.9481481481481481,1,0,2,3,FALSE,FALSE,FALSE
74,2021-11-13T00:31:43Z,2021-11-13T00:57:50Z,1567,1,2021-11-13T00:57:53Z,0.8999999761581421,Chrome,95.0.4638.69,Windows NT 10.0,1536,864,N/A,1.7777777777777777,724,67,415,101,89,91,-0.1675208506660716,-0.20717189345271578,-0.060199992099513946,-0.04364382157256178,0.23556253080827336,-0.2428404171980778,2,2,1,1,2,1,1,2,1,2,2,1,1,1,2,2,1,1,2,2,0.512989176042577,0,0,1,3,2,2,0,2,5,2,5,2,2,4,2,2,2,2,5,3,4,4,1,1,1,1,1,1,1,1,0,2,0,0,4,3,4,4,4,5,5,5,5,2,5,1,1,4,2,5,3,2,2,2,2,5,1,1,1,1,1,1,1,1,1,5,2,2,1,1,1,1,1,1,1,1.6237723475403307,1.2798809468443688,1,0,1,0,2,0,1.6666666666666667,0,1.75,0,0.8333333333333334,0,1.1428571428571428,0,1,0,1.4594594594594594,0,0,0,0,-0.9411726183163546,-0.7372407672780129,-0.8392066927971837,5,1,4,1,1,1,1,3,1,1.7320508075688772,1.1428571428571428,0,2,-0.44866370411710943,5,5,5,5,3,3,1,4,3,NA,4,1.5735915849388864,4.428571428571429,0,1.5714285714285714,5.5,3.8333333333333335,3.2559414990859232,0.6723373927674386,0,-0.15761185162037722,3,3,2,2,2,2,4,2,2,3,2,3,2,3,3,3,3,2,3,3,0.6172133998483676,2.4,0,3.6,0,3.4,0,3.4,0,3.466666666666667,0,2,2,2,3,2,1,2,2,2,1,3,3,2,2,1,3,1,2,1,2,0.6863327411532597,1.85,0,"White, Caucasian, Anglo, European American",0,20,1,2,NA,1,4,4,N/A,7,0,127,63,1,5,2,0,0,0,0,0,TRUE,TRUE,TRUE,TRUE,TRUE,NA,NA,NA,NA,5,0.5752468750011176,0.7099258064521897,1,1,0.009828738699806744,0.015339177978505106,5,0.7413125000009313,0.9027677419344263,1,1,0.016946477903233413,0.013334888924898697,NA,NA,NA,NA,NA,NA,NA,NA,NA,NA,0.5675405740684046,1.2755367145599816,0.5129732535714424,1.7368,4.0901,0.4976,4.4456,0.3799,0,-63.5463,0.009,ML,cueing,63,139.5220041791746,3.264840526707369,1.2690159572877926,0.5216533321052769,3.649119174924144,1.1353793964478176,0.4245394388248673,0.18,0.382,0.535,0.004,1.121,27.724842424444624,1822.4537554851995,0.187,0.385,0.546,0.005,1.189,35.52569560473379,1819.2994589143827,104,0.3081481481481481,1,1,2,3,FALSE,TRUE,FALSE
76,2021-11-13T00:39:07Z,2021-11-13T00:59:22Z,1215,1,2021-11-13T00:59:23Z,0.8999999761581421,Chrome,95.0.4638.69,Windows NT 10.0,1920,1080,NA,1.7777777777777777,606,64,303,76,47,68,-0.4707061587384209,-0.23442610839226255,-0.5993947751382007,-0.3483039849236506,-0.34454397393920994,-0.6313418526976985,3,3,1,2,3,1,1,2,1,2,2,1,1,1,2,2,1,1,2,2,0.7326950970650465,0,1,1,3,2,1.9,0,4,4,3,4,3,2,4,2,3,2,2,3,2,4,4,1,1,1,1,2,1,2,1,0,2,0,0,5,4,5,4,3,4,3,5,4,2,4,1,1,3,2,5,2,3,1,2,2,5,1,1,1,2,1,2,1,1,1,5,2,2,1,1,1,1,1,2,2,1.5022505639062869,0.8837151016885368,1.25,0,1.5,0,2.2666666666666666,0,1.8888888888888888,0,1.8333333333333333,0,1,0,1.2857142857142858,0,1,0,1.5945945945945945,0,0,0,0,-0.6610617147917793,-0.5804383618435307,-0.620750038317655,4,2,3,2,2,3,2,3,1,0.7867957924694432,2.2857142857142856,0,2,0.2350737771240448,4,4,5,2,4,4,2,2,2,3,3,1.1338934190276817,3.857142857142857,0,2.142857142857143,7,3.8333333333333335,3.2559414990859232,1.5194825076544112,0,0.584644695508856,2,2,3,2,2,3,2,2,2,3,2,3,2,3,3,4,3,2,2,3,0.6324555320336759,2.2,0,3.4,0,2.6,0,3.4,0,3.1333333333333333,0,2,2,3,2,2,4,2,2,1,3,2,3,3,4,1,2,2,3,1,3,0.8750939799154206,2.45,0,"White, Caucasian, Anglo, European American",0,21,1,2,NA,1,2,5,Unemployed,4,0,170,63,2,5,2,0,0,1,0,0,TRUE,TRUE,TRUE,TRUE,TRUE,3,0.882141463407656,0.82,0.07336217814352806,3,0.38114374996721745,0.4675612903333479,1,0.96875,0.0014788651201080886,0.0038309250696132555,3,0.5500906249955296,0.6184899999856949,1,0.967741935483871,0.004377387973885603,0.006386075292158874,1.3388,1.1551,0.5838,0,16.2279,0.004,ML,change,50,-20.719730983715564,1.187437744608373,1.2769911485912824,0.5380079124870709,1.3864,3.9247,0.3015,6.9063,0.2808,0,-90.6182,0.009,ML,cueing,64,193.71304925007902,4.252407764469001,0.8075394916681865,0.3785448653605819,5.859092478611175,0.7071290889359048,0.32268492657371506,0.07,0.41,0.491,0.017,1.521,20.27310343555343,1848.934084934962,0.073,0.41,0.554,0.015,1.585,23.752087951092946,1850.5869155174137,284,0.8414814814814815,1,0,0,1,FALSE,FALSE,FALSE
77,2021-11-13T00:39:37Z,2021-11-13T00:59:51Z,1214,1,2021-11-13T00:59:52Z,1,Chrome,95.0.4638.69,Macintosh,1440,900,NA,1.6,583,56,302,103,46,87,-0.5298016001423533,-0.30710401489772066,-0.6042090142724746,-0.019271008504474677,-0.3583560335760547,-0.31040588424149007,3,3,3,3,3,1,1,3,1,3,1,2,1,2,3,3,2,2,3,3,0.8645047258706176,0,1,1,2,1,2,0,2,2,4,2,3,3,3,3,2,3,2,2,2,2,3,2,2,1,3,2,2,3,3,1,3,0,0,4,2,3,4,3,4,4,4,4,2,3,2,1,3,2,4,5,3,3,4,4,4,1,1,1,4,4,2,1,2,1,2,4,4,1,5,2,3,2,1,1,1.2645549015756885,0.6399404734221844,2.25,0,1.75,0,3.2,0,2.4444444444444446,0,2.8333333333333335,0,2,0,2.4285714285714284,0,2.6666666666666665,0,2.5675675675675675,0,1,0,0,0.5879193146073626,-0.2989446853297732,0.1444873146387947,3,5,3,5,3,3,3,4,2,0.9759000729485332,3.5714285714285716,0,3,1.3732661182947257,3,3,4,2,1,1,5,7,7,3,2,1.4960264830861913,2.142857142857143,0,3.857142857142857,2,3.8333333333333335,3.2559414990859232,-1.3043345419688306,0,0.12878813975447612,3,2,3,3,3,3,3,4,2,3,4,4,2,3,3,3,4,2,4,4,0.7745966692414834,2.8,0,3.4,0,3.4,0,2.8,0,3.2,0,2,1,2,2,3,3,3,2,3,3,3,3,3,3,1,2,1,2,2,3,0.7451598203705946,2.45,0,"White, Caucasian, Anglo, European American",0,25,1,2,NA,1,3,7,teacher,2,0,180,65,2,5,2,0,0,0,0,0,TRUE,TRUE,TRUE,TRUE,TRUE,5,0.6829249999978476,0.72,0.0561116908735381,5,0.44126666666617,0.5145406250003726,0.9375,1,0.002672198054442193,0.003440372167123275,5,0.6484312499999069,0.7319448275848709,1,0.90625,0.008678188669534695,0.006696637812609755,1.3099,0.7432,0.2991,0,24.9757,0.004,ML,change,50,-38.21533098371556,0.8401231898652501,1.1241941898929564,0.3885363618076327,1.0495,4.4792,0.3974,4.127,0.3251,0,-86.3234,0.008,ML,cueing,64,185.12344925007903,4.744179777659282,0.873308963943964,0.42537683921756125,4.099963741928469,0.6605058901882984,0.37078523191536916,0.058,0.505,0.411,0.012,1.657,108.09947211608363,2007.0179267420183,0.059,0.505,0.44,0.014,1.73,127.21392091734175,1983.5250782963283,406,1.202962962962963,1,0,0,1,FALSE,FALSE,FALSE
78,2021-11-13T00:28:17Z,2021-11-13T01:01:34Z,1996,1,2021-11-13T01:01:35Z,1,Chrome,95.0.4638.69,Windows NT 10.0,1280,720,n/a,1.7777777777777777,843,88,656,105,105,128,0.13823382442383994,-0.016392388875888245,1.1000316392605174,0.0051018045636124325,0.4565554849977908,0.38214015295348597,2,3,3,3,2,1,3,2,1,2,3,3,1,2,2,2,3,1,2,1,0.7880689256524124,0,0,1,3,4,2.5,0,3,3,4,2,4,3,3,4,4,3,3,2,4,2,3,3,5,1,3,4,3,4,4,5,4,0,0,4,2,3,3,2,4,4,5,2,3,3,2,1,3,3,5,4,3,3,3,5,4,1,1,1,3,3,2,4,3,3,3,4,3,2,3,1,2,1,3,3,1.115008180796555,0.7432233529572065,3.375,0,2.25,0,3.533333333333333,0,2.7777777777777777,0,2.8333333333333335,0,1.6666666666666667,0,3,0,2,0,2.6486486486486487,0,3,0,0,1.2494804844727638,0.2640426676977418,0.7567615760852529,4,3,4,1,2,3,2,2,1,1.1126972805283737,2.142857142857143,0,1.5,-0.03488724541829051,3,2,4,3,2,1,4,4,4,4,2,1.1126972805283737,2.4285714285714284,0,3.5714285714285716,5,3.8333333333333335,3.2559414990859232,0.38995568780511447,0,0.8165912597985752,1,2,1,1,1,1,5,2,1,3,1,5,2,5,5,2,5,2,4,2,1.647508942095828,1.2,0,4.8,0,4,0,4.6,0,4.466666666666667,0,3,4,1,4,3,2,3,3,1,1,3,3,2,2,1,3,1,2,1,2,1.019545822516343,1.95,0,"White, Caucasian, Anglo, European American",0,23,1,4,Genderqueer,1,2,4,Unemployed - disabled student,5,0,220,67,2,5,2,0,1,1,0,1,TRUE,TRUE,TRUE,TRUE,TRUE,5,0.8013880952341216,0.8571428571428571,0.11003504041828142,5,0.5652281249966472,0.6403200000007947,1,1,0.007929395634900412,0.0032616451027136666,5,0.6990593750011176,0.7426161290330272,1,1,0.008016668942586931,0.0069288173970388925,1.4617,1.2865,0.4484,0,16.2234,0.004,ML,change,49,-20.771339105668126,1.2237850450906693,1.4641128982707126,0.3741092477226532,2.419,6.7392,0.4608,5.8255,0.3576,0,-82.4171,0.009,ML,cueing,62,177.21560315513528,4.807876665547773,0.86173897847263,0.5535031270371609,3.850370067563114,1.0760354598885888,0.4298632985675337,0.201,0.365,0.601,0.029,1.515,20.682491559840134,1815.6179899588897,0.202,0.364,0.603,0.03,1.589,34.96980216369109,1817.9443752406642,348,1.031111111111111,1,0,0,1,FALSE,FALSE,FALSE
79,2021-11-13T00:43:12Z,2021-11-13T01:02:43Z,1171,1,2021-11-13T01:02:44Z,1,Chrome,95.0.4638.69,Macintosh,1280,800,The survey went well!,1.6,582,38,302,56,41,74,-0.5323709671599156,-0.4706293045350014,-0.6042090142724746,-0.5920321156045217,-0.42741633176027893,-0.5299936521325801,3,3,2,2,2,1,2,2,1,2,2,2,2,1,2,2,2,2,2,2,0.5104177855340404,0,1,1,3,3,2.25,0,2,2,3,3,4,3,2,4,3,3,5,2,2,3,2,3,3,1,3,3,4,4,5,2,4,2,5,4,1,1,3,1,1,2,2,1,5,2,5,4,3,5,2,5,5,5,5,5,2,5,1,1,1,1,3,3,1,1,4,3,3,2,2,3,2,2,3,3,1.5658709882847794,0.9154754164341269,3.25,0,2.5,0,3.533333333333333,0,4.222222222222222,0,4.583333333333333,0,2,0,2.142857142857143,0,2.3333333333333335,0,3.4864864864864864,0,1,2,5,1.5558215382582787,1.2317735725039012,1.39379755538109,4,2,4,1,1,2,2,1,1,1.2535663410560174,1.7142857142857142,0,1,-0.4757826382709144,3,2,3,3,2,2,3,3,4,NA,3,0.5345224838248488,2.5714285714285716,0,3.4285714285714284,5.5,3.8333333333333335,3.2559414990859232,0.6723373927674386,0,0.8781111148583004,5,3,4,4,4,4,3,3,3,4,2,4,4,4,4,5,3,2,2,5,0.990430401872025,4,0,3.4,0,2.4,0,3,0,2.933333333333333,0,2,3,2,2,2,4,2,2,2,2,4,2,3,3,1,2,1,3,2,2,0.8013147091860318,2.5,0,"Asian or Asian American (e.g., Chinese, Japanese, and others)",0,23,1,2,NA,1,1,6,Unemployed,7,0,190,63,2,5,2,0,0,1,0,0,TRUE,TRUE,TRUE,TRUE,TRUE,6,0.7758952380943867,0.84,0.03575496816214319,6,0.4068375000059605,0.4757793103374284,1,0.90625,0.001060592096865408,0.0040188977321996555,6,0.6730343750044704,0.7356656249966472,1,1,0.008704773941302828,0.007771834587381108,1.1331,1.4622,0.5107,0,-2.101,0.004,ML,change,50,15.938069016284437,1.5266794033090985,1.0861665343812854,0.5339999057219307,1.1093,2.5874,0.2884,7.3825,0.3317,0,-87.3855,0.008,ML,cueing,64,187.247649250079,3.313343599786928,0.68471122085384,0.3918266730408436,6.36686142770623,0.6507342390651287,0.35733125574005886,0.139,0.438,0.602,0.019,1.446,61.72617513864691,1868.5553619373634,0.143,0.432,0.615,0.02,1.583,80.53916815518652,1864.2179858330333,292,0.8651851851851852,1,0,0,1,FALSE,FALSE,FALSE
80,2021-11-13T00:21:16Z,2021-11-13T01:03:58Z,2561,1,2021-11-13T01:04:00Z,1,Chrome,95.0.4638.69,Windows NT 10.0,1536,864,NA,1.7777777777777777,1352,67,841,105,38,90,1.4460416363630415,-0.20717189345271578,1.9906658791012053,0.0051018045636124325,-0.46885251067081346,-0.2597317839589309,1,2,3,2,1,1,1,1,1,2,2,2,2,2,2,2,2,1,2,2,0.5712405705774795,1,1,2,2,2,2.5,0,1,2,5,2,5,5,1,5,3,2,5,1,1,1,1,5,5,3,1,3,5,5,5,0,2,3,2,3,3,2,3,1,5,2,3,2,3,5,5,3,2,3,5,3,5,5,5,5,1,5,1,1,3,3,1,2,1,1,3,3,3,2,5,5,1,1,1,1,1.470939721288287,1.7994708216848747,4,0,1,0,4.266666666666667,0,3.3333333333333335,0,3.5833333333333335,0,2.8333333333333335,0,1.8571428571428572,0,4,0,3.1621621621621623,0,0,3,2,2.0539040225490397,0.2355581492994198,1.1447310859242297,1,5,1,1,3,5,5,1,3,2,4.142857142857143,0,2,1.3461471841409207,1,2,4,2,1,1,5,2,3,1,1,1.6035674514745464,1.7142857142857142,0,4.285714285714286,6.5,3.8333333333333335,3.2559414990859232,1.237100802692087,0,1.6385188043492451,3,3,3,3,3,3,3,3,3,3,3,3,3,3,3,3,3,3,3,3,0,3,0,3,0,3,0,3,0,3,0,2,2,2,2,2,2,3,2,2,2,3,2,2,3,2,3,1,2,2,3,0.5231483637805969,2.3,0,"Hispanic of Latino (e.g., Mexican American, Central American, and others) & White, Caucasian, Anglo, European American",1,20,1,2,NA,1,2,4,no occupation,2,0,104,57,1,5,2,0,0,1,0,0,TRUE,TRUE,TRUE,TRUE,TRUE,6,1.2711225806451703,0.62,0.2941272780612195,6,0.722396874999984,0.8695843749999985,1,1,0.050161845473791884,0.07314316910281701,6,0.8192562499999912,0.8898533333333054,1,1,0.019885488346772656,0.0281661018850461,1.8146,0.2854,0.5847,0,61.7952,0.004,ML,change,50,-111.85433098371557,0.29680301907594697,1.6494044664466117,0.6042542428842703,1.8541,2.4763,0.4952,3.0514,0.4186,0,-23.8108,0.041,ML,cueing,64,60.098249250079014,2.2093730443079123,1.8752535870144884,0.45846052312251867,2.4278347198703414,1.7065143242587768,0.38193182231427675,0.068,0.608,0.313,0.015,1.078,88.07278926579212,1883.4251928918404,0.085,0.591,0.372,0.017,1.091,95.9904926751105,1880.5412591236877,386,1.1437037037037037,1,0,0,1,FALSE,FALSE,FALSE
81,2021-11-13T00:33:51Z,2021-11-13T01:03:59Z,1807,1,2021-11-13T01:04:00Z,1,Chrome,95.0.4638.69,Windows NT 10.0,1920,1080,No feedback.,1.7777777777777777,773,108,571,100,69,98,-0.041621866805519804,0.16530237738775702,0.6908213128472283,-0.05583022810660534,-0.04067866192862343,-0.12460084987210628,4,3,1,1,3,1,1,3,1,4,3,1,1,1,4,4,1,1,3,3,1.2814465510343749,0,0,2,4,4,1.3,0,2,2,4,2,4,3,3,3,2,3,3,3,3,3,1,3,4,5,3,2,3,3,4,4,2,3,1,1,2,2,2,1,4,3,2,3,1,3,2,3,3,2,5,4,4,3,4,5,2,4,1,3,4,1,3,3,1,1,4,2,3,1,4,2,3,3,1,2,1.2068373778005288,0.7988086367179802,3.375,0,2.25,0,3.4,0,3.7777777777777777,0,2.9166666666666665,0,2.6666666666666665,0,2,0,2.3333333333333335,0,2.918918918918919,0,2,3,1,1.3083289396707392,0.8572994635794774,1.0828142016251083,4,2,3,1,2,2,3,3,1,0.9759000729485332,2.142857142857143,0,2,0.14960659196890055,3,3,3,2,1,1,4,4,5,1,2,1.1338934190276817,2.142857142857143,0,3.857142857142857,4.5,3.8333333333333335,3.2559414990859232,0.10757398284279028,0,0.8347424021602866,4,4,3,4,3,3,4,3,2,4,1,3,2,3,4,1,3,1,3,2,1.0555973258234952,3.6,0,3.8,0,4,0,3.6,0,3.8,0,2,3,1,2,4,1,4,2,4,3,3,3,2,2,1,2,1,1,2,4,1.0894228312566052,2.45,0,"White, Caucasian, Anglo, European American",0,27,1,2,NA,1,2,6,Unemployed,1,0,145,61,1,5,2,0,0,0,0,0,TRUE,TRUE,TRUE,TRUE,TRUE,3,0.7321384615370861,0.78,0.029901084592617436,3,0.4524714285710028,0.5535766666581233,0.875,0.9375,0.0035127882254439324,0.004683449678121574,3,0.63171875,0.6678906250018627,1,1,0.008398788024459999,0.004026260877816713,1.1026,1.1814,0.489,0,1.6769,0.004,ML,change,50,8.382269016284438,1.2769330454705328,0.9911767714217897,0.5147977818651654,1.0641,3.0342,0.396,2.2147,0.2659,0,-46.6699,0.009,ML,cueing,64,105.81644925007902,3.5633272769842628,0.7599779617756873,0.4602677078026071,3.0786314857537187,0.6320698524847674,0.3754806631030928,0.16,0.399,0.702,0.034,1.598,21.870954864645743,1814.0867384192015,0.161,0.4,0.721,0.03,1.67,37.68628588782247,1818.852392659709,430,1.2740740740740741,1,0,0,1,FALSE,FALSE,FALSE
82,2021-11-13T00:28:35Z,2021-11-13T01:04:36Z,2161,1,2021-11-13T01:04:39Z,1,Chrome,94.0.4606.81,Macintosh,1440,900,n/a,1.6,884,118,626,135,135,141,0.2435778721438935,0.25614976051957966,0.9556044652322977,0.370694000584919,0.870917274103136,0.6017279208445759,2,2,3,3,2,2,2,2,1,3,1,2,3,3,2,2,2,3,1,1,0.7181848464596079,1,1,1,1,1,2.8,0,2,4,4,3,3,2,2,3,4,2,3,2,4,3,3,3,4,2,2,3,4,3,4,4,2,0,0,4,3,2,3,2,3,2,3,2,3,4,2,2,2,3,1,2,4,4,4,5,3,2,3,1,3,1,1,3,2,1,4,5,3,1,1,2,2,2,2,1,1.1416231003721427,0.7988086367179802,3.125,0,1.75,0,3.2,0,3.3333333333333335,0,3.3333333333333335,0,2,0,2.2857142857142856,0,1.3333333333333333,0,2.810810810810811,0,2,0,0,1.0684827686500429,-0.0958522115332568,0.486315278558393,3,3,2,2,2,4,3,5,1,0.7559289460184544,3,0,3,1.0313973776741485,4,4,4,4,2,2,3,6,6,3,3,0.9511897312113419,3.2857142857142856,0,2.7142857142857144,3,3.8333333333333335,3.2559414990859232,-0.7395711320441822,0,-0.22619813465469363,2,3,3,3,2,2,3,2,3,2,2,2,2,3,4,5,3,3,2,3,0.8837151016885368,2.6,0,3.2,0,2.4,0,3.4,0,3,0,2,1,3,2,4,4,4,2,4,4,3,3,2,3,2,3,3,4,3,4,0.9176629354822471,3,0,Filipino,0,27,1,2,NA,1,3,6,unemployed,3,0,128,61,1,5,2,0,0,0,0,0,TRUE,TRUE,TRUE,TRUE,TRUE,4,0.914159459463648,0.74,0.06918372237053995,4,0.42484062500298025,0.49160645161328775,1,0.96875,0.0019410902322693603,0.0015234198279785345,4,0.5854218749944121,0.6331781250014901,1,1,0.009701985633831891,0.0066710617628430455,1.2961,0.8417,0.5704,0,21.0058,0.004,ML,change,50,-30.275530983715562,0.874908089535375,1.195518212362347,0.5862114448106618,1.2686,5.4641,0.3846,5.6293,0.3122,0,-99.2851,0.007,ML,cueing,64,211.04684925007902,5.3549561130344,0.6412727073759842,0.4354721761426044,5.473952989010982,0.7568816785070897,0.35786625314358467,0.253,0.195,0.675,0.011,1.105,46.703936407390245,1842.1553659811398,0.258,0.193,0.671,0.013,1.161,56.55117808500026,1840.0118548675825,440,1.3037037037037038,1,0,0,1,FALSE,FALSE,FALSE
83,2021-11-13T00:45:41Z,2021-11-13T01:07:54Z,1333,1,2021-11-13T01:07:55Z,1,Chrome,95.0.4638.69,Macintosh,1440,900,NA,1.6,677,55,338,82,48,88,-0.28828110049149885,-0.31618875321090295,-0.4308964054386111,-0.2751855457193893,-0.3307319143023651,-0.293514517480637,3,2,1,1,2,1,1,1,2,2,2,1,1,1,2,1,1,1,2,1,0.6048053188292994,0,0,3,2,2,2.15,0,5,5,1,5,1,1,5,1,1,1,1,5,4,4,5,2,2,1,1,1,1,1,1,1,2,0,0,5,5,5,5,5,5,3,4,5,2,5,1,1,4,1,5,1,1,1,3,3,3,1,1,1,2,2,1,1,2,1,4,1,1,1,2,1,2,1,1,2,1.6756514577345158,1.9639610121239315,1.25,0,1.5,0,1.2666666666666666,0,1.3333333333333333,0,1.5,0,1.5,0,1.1428571428571428,0,1.3333333333333333,0,1.4324324324324325,0,1,0,0,-1.160499262195652,-0.3773458880470143,-0.7689225751213331,5,1,3,1,1,2,1,1,1,1.5275252316519468,1.4285714285714286,0,1,-0.6467170085812028,5,5,5,5,2,1,1,7,6,3,4,1.9880595947760098,4,0,2,2.5,3.8333333333333335,3.2559414990859232,-1.0219528370065065,0,-0.7657439742430396,1,1,2,1,2,1,4,1,1,1,1,4,1,4,4,3,5,1,1,5,1.6846647257229665,1.4,0,4.8,0,2.8,0,3.8,0,3.8,0,1,3,4,3,4,4,4,1,2,2,4,1,2,4,1,1,1,4,3,4,1.3088765773505315,3.05,0,"White, Caucasian, Anglo, European American",0,20,1,2,NA,1,3,4,Waitress,2,0,100,62,2,5,2,0,0,1,0,0,TRUE,TRUE,TRUE,TRUE,TRUE,5,1.018165853658691,0.82,0.1311688012898051,5,0.41051935483875773,0.4869593750000931,0.96875,1,0.0017756645161407549,0.0032720411996115797,5,0.5918781250000466,0.7022031250000582,1,1,0.008946688215764437,0.007280659022170328,1.6405,0.9842,0.482,0,33.3557,0.004,ML,change,50,-54.97533098371556,1.0268837146329701,1.4766496612618525,0.5580086957737944,1.4049,4.4164,0.3279,5.8786,0.2962,0,-87.2364,0.008,ML,cueing,64,186.94944925007903,4.804053148923191,0.8624248312740252,0.4000042530023296,5.153717247488373,0.6663126903515467,0.34991570535556166,0.244,0.232,0.657,0.006,1.072,31.93125989627689,1834.4897825704325,0.245,0.232,0.686,0.006,1.083,39.70590295307955,1824.914058183068,426,1.2622222222222224,1,0,0,1,FALSE,FALSE,FALSE
84,2021-11-13T00:46:18Z,2021-11-13T01:09:04Z,1365,1,2021-11-13T01:09:05Z,1,Chrome,95.0.4638.69,Windows NT 10.0,1366,768,"The games were fun, minus the color dot one where u have to say if it changed or not, that one was kind of hard. I liked the arrow games tho",1.7786458333333333,640,59,368,65,68,93,-0.3833476801413033,-0.2798497999581739,-0.28646923141039143,-0.4823544567981297,-0.054490721565468275,-0.20905768367637165,4,4,2,2,3,2,3,3,1,4,3,2,1,2,4,2,2,2,3,3,0.9403246919632545,0,1,1,5,5,1.8,0,1,4,4,4,1,3,3,3,1,2,5,2,3,2,2,3,3,1,1,4,3,3,5,2,2,0,0,3,1,5,2,1,5,3,3,1,3,5,5,1,2,5,2,2,5,5,5,5,4,1,1,1,1,1,1,1,3,3,3,2,2,1,1,4,2,4,1,1,1.5995494861236894,1.2344267996967353,2.875,0,2,0,3.066666666666667,0,3.3333333333333335,0,3.75,0,1,0,2,0,2,0,2.7837837837837838,0,1,0,0,0.8921309835008454,-0.22054348261253207,0.33579375044415666,5,1,4,1,1,2,1,8,2,1.6761634196950514,1.2857142857142858,0,5,0.7437665053611813,5,5,5,5,5,5,1,6,7,6,3,1.5118578920369088,5,0,1,2.5,3.8333333333333335,3.2559414990859232,-1.0219528370065065,0,-1.3234409561930969,4,4,4,5,4,3,5,3,3,2,1,4,4,2,3,1,4,1,5,2,1.3557637102737474,4.2,0,4.2,0,3.8,0,3,0,3.6666666666666665,0,3,1,2,2,2,2,2,3,1,2,1,4,3,4,3,3,2,3,3,3,0.8870412083230169,2.25,0,"Asian or Asian American (e.g., Chinese, Japanese, and others)",0,24,1,2,NA,1,3,6,Student in nursing school.,3,0,125,61,2,5,2,0,0,1,0,0,TRUE,TRUE,TRUE,TRUE,TRUE,3,0.7676315789473194,0.76,0.01621852981224349,3,0.42627666666659836,0.4924322580645582,0.967741935483871,0.96875,0.0022679959784980305,0.003975354798366624,3,0.5740625000000582,0.6222,1,0.9375,0.0019518533870954318,0.0045699219354752895,1.1455,1.1076,0.4912,0,2.7473,0.009,ML,change,50,6.241469016284437,1.3712773030856555,0.840588192734336,0.6082524879209177,1.9589,4.6948,0.2966,5.2101,0.2513,0,-67.2575,0.009,ML,cueing,63,146.94440417917457,4.213246251081637,0.8150454542275004,0.40175335303472304,4.825518893222069,0.7048355745616255,0.3579563133246165,0.047,0.497,0.569,0.032,1.564,33.089398235815736,1891.2290448992705,0.048,0.495,0.59,0.029,1.648,36.1016112789513,1880.2631560368966,326,0.965925925925926,1,0,0,1,FALSE,FALSE,FALSE
85,2021-11-13T00:40:18Z,2021-11-13T01:10:03Z,1784,1,2021-11-13T01:10:04Z,1,Edge,95.0.1020.44,Windows NT 10.0,1536,864,NA,1.7777777777777777,814,118,502,117,66,120,0.06372218091453376,0.25614976051957966,0.35863881258232305,0.15133868297213507,-0.08211484083915795,0.24700921886666136,3,4,1,1,2,2,2,3,1,4,3,2,1,1,3,3,2,1,3,3,1.019545822516343,0,1,2,3,2,1.65,0,5,5,2,5,1,1,5,1,1,1,1,5,1,4,5,2,2,5,1,1,1,2,1,5,1,1,1,5,4,4,5,4,5,5,5,5,1,4,1,1,5,1,5,1,1,1,1,2,4,2,1,1,2,1,1,3,1,1,5,1,1,1,1,1,1,2,2,1,1.7578652081687294,1.9591057240729093,1.875,0,1.5,0,1.1333333333333333,0,1.3333333333333333,0,1.1666666666666667,0,1.3333333333333333,0,1.1428571428571428,0,1,0,1.2702702702702702,0,3,1,1,-1.018895166875523,0.4119219140382229,-0.3034866264186501,5,1,5,1,1,1,1,1,1,1.9518001458970664,1,0,1,-0.9031185640466358,5,5,5,5,4,3,1,7,3,6,4,1.5275252316519468,4.571428571428571,0,1.4285714285714286,4,3.8333333333333335,3.2559414990859232,-0.1748077221195339,0,-0.6608554064853003,1,2,2,3,3,2,3,2,1,2,1,5,2,4,5,2,5,2,4,2,1.424279266355945,2.2,0,4.6,0,3.4,0,4.4,0,4.133333333333334,0,1,1,2,3,2,2,4,4,1,2,3,4,1,1,1,4,2,2,1,1,1.1652874052533586,1.6,0,"White, Caucasian, Anglo, European American",0,23,1,2,NA,1,3,4,stay at home mom mostly/ part time assistant,3,0,160,62,1,5,2,0,0,0,0,0,TRUE,TRUE,TRUE,TRUE,TRUE,2,0.7888125000953674,0.8,0.03355692983891913,2,0.4828612901626095,0.5108103446960449,1,0.90625,0.012638407126005523,0.00646423990310446,2,0.6602322580891271,0.7833857142584665,1,0.875,0.07767181216858281,0.07056614947280854,1.2604,1.1786,0.4897,0,9.4767,0.004,ML,change,50,-7.217330983715561,1.3406337314416636,1.0340589891238419,0.5574161914230823,1.0243,2.8105,0.3586,3.791,0.3478,0,-64.059,0.01,ML,cueing,63,140.54740417917458,2.942143476147346,0.7710988807007948,0.4043373182021427,3.426805135106734,1.2090371535708835,0.3119652665570372,0.064,0.44,0.353,0.009,1.492,92.04900357724499,1967.5942376525657,0.064,0.441,0.383,0.01,1.525,102.01774175073608,1963.5338970474907,357,1.0577777777777777,1,0,0,1,FALSE,FALSE,FALSE
86,2021-11-13T00:52:57Z,2021-11-13T01:12:05Z,1148,1,2021-11-13T01:12:07Z,1,Chrome,95.0.4638.69,Windows NT 10.0,1536,864,N/A,1.7777777777777777,617,49,250,63,42,80,-0.4424431215452358,-0.3706971830899965,-0.8545494492547221,-0.5067272698662169,-0.4136042721234341,-0.4286454515674616,3,2,4,4,2,4,4,2,4,3,1,4,4,4,1,2,4,3,2,2,1.0990426455975697,0,0,1,2,3,3.45,0,4,2,5,2,4,4,4,4,4,5,5,2,1,1,2,1,1,1,1,1,4,4,3,1,2,0,0,2,1,1,2,4,5,2,2,1,2,5,5,1,1,5,5,5,5,5,5,5,5,1,1,1,1,1,1,2,1,1,2,5,5,1,1,1,1,3,1,1,1.8265640794498113,1.4375905768565218,2,0,1.5,0,3.8,0,3.7777777777777777,0,3.75,0,0.8333333333333334,0,2.5714285714285716,0,1,0,2.891891891891892,0,1,0,0,0.8777092403684471,-0.3773458880470143,0.2501816761607164,5,1,5,1,1,1,1,6,8,1.9518001458970664,1,0,7,1.310807484599657,5,5,5,5,5,5,1,6,6,5,4,1.5118578920369088,5,0,1,3,3.8333333333333335,3.2559414990859232,-0.7395711320441822,0,-1.1822501037119346,2,2,1,1,1,1,4,3,1,5,1,4,1,5,5,1,4,4,5,2,1.709915063331955,1.4,0,4,0,4.8,0,4.4,0,4.4,0,3,3,3,1,3,4,3,2,4,4,3,3,3,4,2,3,2,3,4,2,0.8255779474818965,3.05,0,"White, Caucasian, Anglo, European American",0,23,1,2,NA,1,4,7,Accountant,3,0,175,70,3,5,2,0,0,1,0,0,TRUE,TRUE,TRUE,TRUE,TRUE,2,0.9638187500052154,0.64,0.13837517877656724,2,0.46085862068883304,0.5190199999928474,0.9666666666666667,0.9375,0.004104750861544034,0.0014743634576560513,2,0.5676781250033528,0.679087096773809,1,0.96875,0.007492773376877459,0.014747736773361619,1.5462,0.3857,0.3998,0,46.6141,0.003,ML,change,50,-81.49213098371557,0.41933148299375744,1.3720986099012444,0.5057233930462105,0.9942,4.3842,0.4199,3.4612,0.3242,0,-77.9371,0.01,ML,cueing,62,168.25560315513528,4.757141146732585,0.5692600067084869,0.4666668649369279,4.140181466127087,0.8133208308708253,0.3691839624212331,0.096,0.338,0.436,0.011,1.602,67.89446527687414,1915.364294933359,0.096,0.341,0.427,0.012,1.714,102.31661615181004,1924.1334841229625,104,0.3081481481481481,1,1,0,1,FALSE,FALSE,FALSE
87,2021-11-13T00:48:10Z,2021-11-13T01:12:46Z,1475,1,2021-11-13T01:12:46Z,0.8999999761581421,Chrome,94.0.4606.114,CrOS x86_64 14150.74.0,1200,800,no,1.5,712,64,418,66,71,85,-0.198353254876819,-0.23442610839226255,-0.04575727469669198,-0.47016805026408615,-0.013054542654933752,-0.34418861776319626,2,2,2,2,2,3,3,1,2,2,1,2,1,3,2,1,2,2,1,1,0.6708203932499369,0,0,3,2,1,2.85,0,2,2,5,2,4,5,2,5,5,5,5,1,2,1,1,5,5,5,2,5,5,5,5,11,2,7,0,2,1,3,1,2,3,2,3,2,5,2,4,4,1,2,3,5,4,4,5,5,1,5,5,4,5,3,1,5,5,5,1,5,4,4,3,5,3,3,5,5,1.4947355064472891,1.7265434778633235,4.625,0,4,0,4.466666666666667,0,3.888888888888889,0,4.166666666666667,0,4.333333333333333,0,4.142857142857143,0,4,0,4.162162162162162,0,6,6,0,2.8381951943733776,2.661927753666121,2.7500614740197493,2,4,2,4,4,4,3,8,2,0.9511897312113419,3.857142857142857,0,5,2.2821758381537784,3,3,3,3,2,1,4,7,6,NA,1,0.9511897312113419,2.4285714285714284,0,3.5714285714285716,2.5,3.8333333333333335,3.2559414990859232,-1.0219528370065065,0,0.11063699739276467,5,5,5,5,5,5,5,5,5,2,2,3,5,3,3,1,3,2,3,2,1.3870146083619754,5,0,3,0,3.2,0,2.4,0,2.8666666666666667,0,3,4,4,1,3,4,4,1,4,4,4,1,2,4,3,1,3,4,4,3,1.190974832912761,3.65,0,"White, Caucasian, Anglo, European American",0,22,1,2,NA,1,1,4,disability (was a barista),1,0,110,64,2,5,2,0,0,2,0,0,TRUE,TRUE,TRUE,TRUE,TRUE,4,0.9541705882338917,0.68,0.08232556949001775,4,0.5980906249992549,0.7088774193539735,1,0.96875,0.013612221522250601,0.03255648447570016,4,0.7804281250007916,0.8010482758625314,1,0.9666666666666667,0.017278173699364723,0.01380585178146131,1.4425,0.5557,0.5061,0,35.3037,0.004,ML,change,50,-58.87133098371556,0.6184654214586756,1.2187776005303244,0.5994539614287229,1.5047,2.6079,0.4379,3.7174,0.3957,0,-43.4203,0.008,ML,cueing,64,99.31724925007902,2.490585418838297,1.378787163255331,0.44937759337434574,3.3638005894676875,1.2316826209508371,0.4207328257911064,0.088,0.551,0.384,0.072,1.59,89.95615913088315,1963.6066979326908,0.072,0.575,0.358,0.041,1.754,102.80733613273715,1930.7182002016325,370,1.0962962962962963,1,0,0,1,FALSE,FALSE,FALSE
88,2021-11-13T00:41:28Z,2021-11-13T01:14:44Z,1995,1,2021-11-13T01:14:45Z,1,Chrome,95.0.4638.69,Windows NT 10.0,1536,864,N/A,1.7777777777777777,991,67,565,110,84,102,0.5185001430230577,-0.20717189345271578,0.6619358780415844,0.0660338372338302,0.16650223262404917,-0.057035382828693984,3,3,2,2,3,2,2,3,3,3,3,2,2,3,3,3,2,1,3,3,0.6048053188292994,0,1,2,4,5,2.05,0,4,4,3,4,3,3,4,2,2,2,3,5,4,4,4,2,2,1,1,2,2,2,2,1,2,0,0,5,5,5,5,5,5,5,5,5,2,5,3,1,5,1,5,1,1,2,2,3,5,1,1,1,2,1,2,2,2,1,5,3,2,1,2,2,2,1,2,2,1.7150631013001945,0.9102589898327995,1.75,0,1.75,0,2.3333333333333335,0,1,0,1.5833333333333333,0,1,0,1.7142857142857142,0,1.6666666666666667,0,1.4324324324324325,0,1,0,0,-0.48722647542407477,-0.2989446853297732,-0.393085580376924,5,1,3,1,1,3,2,1,1,1.4960264830861913,1.7142857142857142,0,1,-0.4757826382709144,5,5,5,5,3,3,2,6,4,3,3,1.2909944487358056,4.285714285714286,0,1.7142857142857142,4,3.8333333333333335,3.2559414990859232,-0.1748077221195339,0,-0.5015134116424268,2,3,2,2,2,2,4,3,3,3,1,3,2,3,4,1,4,2,4,2,1.0327955589886444,2.2,0,4,0,4,0,3.4,0,3.8,0,2,1,3,3,3,2,1,2,1,2,2,1,2,2,1,2,2,2,1,2,0.6708203932499369,2.05,0,"White, Caucasian, Anglo, European American",0,29,1,2,NA,1,3,7,Natural Resources,3,0,130,64,2,5,2,0,0,0,0,0,TRUE,TRUE,TRUE,TRUE,TRUE,3,0.9186418604649776,0.86,0.03857472459185775,3,0.5025225806451372,0.5489906249999185,1,1,0.01447804313977957,0.010187011844743145,3,0.7125374999999186,0.8725031249999884,1,1,0.013716223709653733,0.02507247063505934,1.4142,1.407,0.5732,0,9.7387,0.003,ML,change,50,-7.741330983715562,1.6062130686786673,1.1301675985811623,0.6653377730913658,2.2954,4.8057,0.3102,4.4363,0.2438,0,-59.1243,0.01,ML,cueing,63,130.6780041791746,3.6166026116683523,1.1455874950221001,0.39556101094415824,3.312340904406638,1.250817728597812,0.3196112032311938,0.166,0.369,0.471,0.007,1.374,24.16120060117226,1817.0077928556766,0.163,0.379,0.473,0.008,1.409,34.23924142933463,1814.9223098299015,382,1.1318518518518519,1,0,0,1,FALSE,FALSE,FALSE
89,2021-11-13T00:10:54Z,2021-11-13T01:14:49Z,3834,1,2021-11-13T01:14:50Z,0.8999999761581421,Chrome,95.0.4638.69,Windows NT 6.3,1366,768,Thansk,1.7786458333333333,2535,104,445,89,47,154,4.4856028181392205,0.12896342413502795,0.08422718192870571,-0.18988069998108442,-0.34454397393920994,0.8213156887356658,4,4,2,2,4,1,1,4,1,4,4,1,1,1,3,4,1,1,4,4,1.4317821063276353,0,1,1,3,3,1.15,0,5,5,1,5,1,1,5,1,1,1,1,5,1,5,5,1,1,3,1,1,1,1,1,0,1,3,4,5,3,5,5,3,5,5,5,5,1,5,1,1,5,1,5,1,1,1,1,1,5,3,3,1,2,1,1,1,1,1,5,1,1,1,1,1,1,1,1,1,1.834766024965136,2.065591117977289,1.25,0,1,0,1,0,1.4444444444444444,0,1,0,1.6666666666666667,0,0.8571428571428571,0,1,0,1.2432432432432432,0,0,3,4,-1.3564026722625975,0.5884574430977813,-0.3839726145824081,5,1,3,1,1,1,1,2,2,1.5735915849388864,1.2857142857142858,0,2,-0.3631965189619651,5,5,5,5,2,2,2,6,6,4,3,1.6035674514745464,4,0,2,3,3.8333333333333335,3.2559414990859232,-0.7395711320441822,0,-0.6245531217618774,1,1,1,1,1,1,1,1,1,3,1,5,1,5,5,1,4,1,3,3,1.6818357317441643,1,0,4.8,0,3.4,0,4.6,0,4.266666666666667,0,2,1,1,1,2,1,1,4,1,1,1,4,1,1,1,4,1,1,1,1,1.0990426455975697,1.25,0,"White, Caucasian, Anglo, European American",0,26,1,2,NA,1,3,6,physiotherapist,4,0,120,60,1,5,2,0,0,1,0,0,TRUE,TRUE,TRUE,TRUE,TRUE,1,0.8879972222232156,0.72,0.07573795887741991,1,0.7214290322603718,0.8110451612905148,0.96875,1,0.1903056854438273,0.19497488655655906,1,0.6261625000014901,0.6844193548377483,1,1,0.012074341128689823,0.009126016279815345,1.4385,0.6863,0.4612,0,33.3397,0.004,ML,change,50,-54.94333098371556,0.77943142650359,1.2117314964801476,0.5459774881441399,1.895,2.2015,0.3806,1.7402,0.1969,0,6.1549,0.007,ML,cueing,63,0.11960417917459765,1.7290909004846764,2.396134711732149,0.13980933981350196,1.6017615933797957,2.143881598034364,0.0940294846422235,0.117,0.396,0.492,0.033,1.674,40.932754499913344,1849.1423374362532,0.114,0.399,0.497,0.032,1.856,59.39511196443596,1845.1164458968872,292,0.8651851851851852,1,0,0,1,FALSE,FALSE,FALSE
90,2021-11-13T00:46:08Z,2021-11-13T01:15:06Z,1737,1,2021-11-13T01:15:07Z,1,Chrome,95.0.4638.69,Macintosh,1440,900,No comments.,1.6,931,44,452,77,40,128,0.36433812196932075,-0.4161208746559078,0.11792685586862363,-0.3361175783896071,-0.4412283913971238,0.38214015295348597,4,4,1,1,4,1,1,4,1,4,4,1,1,1,4,4,1,1,4,4,1.538967528127731,0,1,1,3,3,1,0,4,5,2,5,1,1,4,2,1,1,2,5,1,5,3,2,2,1,1,1,2,2,2,5,2,3,2,3,2,4,5,5,4,5,5,5,1,5,2,1,5,2,4,1,2,1,2,2,5,1,1,1,1,1,1,5,5,2,5,1,1,1,1,1,2,1,1,1,1.7488735113090823,1.6987390281365427,1.625,0,1.25,0,1.4666666666666666,0,1.7777777777777777,0,1.5,0,0.8333333333333334,0,2.142857142857143,0,1,0,1.5945945945945945,0,3,3,2,-0.8437048643947072,0.92323677340621,0.03976595450575143,5,1,3,1,1,1,1,1,1,1.5735915849388864,1.2857142857142858,0,1,-0.7321841937363471,3,4,5,3,2,1,1,6,7,2,3,1.4960264830861913,3.2857142857142856,0,2.7142857142857144,2.5,3.8333333333333335,3.2559414990859232,-1.0219528370065065,0,-0.3673889871358558,1,1,1,1,1,1,3,1,1,3,1,5,2,5,5,1,5,3,3,2,1.624221425205085,1,0,4.6,0,3.6,0,4.8,0,4.333333333333333,0,1,1,1,4,1,1,1,4,1,1,1,4,1,1,1,4,1,1,1,1,1.231174022502185,1,0,"White, Caucasian, Anglo, European American",0,23,0,1,NA,1,3,4,Finance Manager,2,0,156,68,3,5,2,0,0,0,0,0,TRUE,TRUE,TRUE,TRUE,TRUE,3,1.046291666669978,0.72,0.14369522075104382,3,0.5025741935545398,0.5571999999973923,1,1,0.0023034499790864685,0.004975488386465964,3,0.8018093750122934,0.9262937499955296,1,1,0.019954940231629872,0.03276245867034475,1.6318,0.5965,0.5605,0,46.9145,0.004,ML,change,50,-82.09293098371556,0.6641187330025524,1.4221276436080015,0.5751890369048905,6.3193,8.5922,0.1895,11.2548,0.2218,0,-91.6834,0.011,ML,cueing,63,195.7962041791746,4.326169838521731,0.9576911866703914,0.4499731259128601,4.859759295057542,0.8525390816382965,0.41231131510838176,0.237,0.321,0.493,0.013,1.581,23.885576093820415,1820.6490016685623,0.239,0.323,0.495,0.015,1.658,35.98875243944865,1818.033990517419,104,0.3081481481481481,1,0,3,4,FALSE,FALSE,FALSE
91,2021-11-13T00:54:06Z,2021-11-13T01:16:36Z,1349,1,2021-11-13T01:16:37Z,0.8999999761581421,Chrome,95.0.4638.54,Macintosh,1280,800,NA,1.6,720,47,287,115,42,71,-0.17779831873632074,-0.38886665971636103,-0.6764226012865845,0.12696586990404798,-0.4136042721234341,-0.5806677524151392,3,2,3,3,2,1,2,2,1,3,2,3,3,3,3,3,3,1,1,2,0.8013147091860318,0,1,1,3,3,2.5,0,1,3,4,2,5,3,1,4,4,3,1,1,3,2,2,4,4,4,1,1,5,5,5,1,2,0,NA,3,1,1,1,1,4,3,4,2,5,3,5,3,4,3,4,5,5,5,5,5,1,1,4,1,4,5,1,1,1,1,3,3,1,3,4,4,3,3,1,1,1.572091432287407,1.2983506020002016,3.625,0,2,0,3.8,0,3.7777777777777777,0,4,0,3.1666666666666665,0,1.4285714285714286,0,3.6666666666666665,0,3.3513513513513513,0,1,0,NA,1.7735027483573693,-0.13158132221341223,0.8209607130719785,4,1,4,1,1,1,1,1,1,1.4638501094227998,1.2857142857142858,0,1,-0.7321841937363471,3,3,3,3,1,1,3,7,7,NA,3,0.9759000729485332,2.4285714285714284,0,3.5714285714285716,2,3.8333333333333335,3.2559414990859232,-1.3043345419688306,0,-0.030553855088397364,3,3,4,4,4,4,4,3,3,3,3,4,4,3,4,1,4,2,5,1,1.1464230084422218,3.6,0,3.4,0,3.8,0,3.6,0,3.6,0,2,3,3,2,4,4,3,2,3,3,3,2,1,3,1,2,1,3,3,4,0.9403246919632545,2.8,0,"White, Caucasian, Anglo, European American",0,29,1,2,NA,1,3,7,graduate student,1,0,130,63,3,5,2,0,0,0,0,0,TRUE,TRUE,TRUE,TRUE,TRUE,3,0.8579323529408258,0.6938775510204082,0.056785637253419584,3,0.5379258064512283,0.649220689664627,1,0.90625,0.007133421978164435,0.0084466657960672,3,0.8198218749985099,1.0118074074100565,1,0.84375,0.02678248305584184,0.026830280715044966,1.5044,0.6159,0.442,0,29.1218,0.004,ML,change,49,-46.56813910566812,0.7332420661505152,1.1160166080078304,0.5628448547635925,1.3185,2.5119,0.4223,3.4945,0.3493,0,-45.0752,0.009,ML,cueing,63,102.5798041791746,2.751831808207255,0.8244266726447758,0.5275114577402625,3.464104422423366,0.9913059151036935,0.4037858986883479,0.108,0.524,0.396,0.006,1.821,180.68182101831457,2169.0201254875724,0.105,0.532,0.389,0.007,1.869,185.40650076233538,2127.9075248147187,104,0.3081481481481481,1,0,0,1,FALSE,FALSE,FALSE
93,2021-11-13T00:48:54Z,2021-11-13T01:18:08Z,1753,1,2021-11-13T01:18:09Z,1,Chrome,95.0.4638.54,Macintosh,1440,900,n/a,1.6,678,105,483,112,78,111,-0.2857117334739366,0.13804816244821022,0.2671682690311173,0.09040665030191732,0.08362987480298012,0.0949869180189837,2,2,3,3,2,3,2,3,1,2,2,1,2,2,2,2,1,1,2,2,0.6488856845230502,0,1,2,4,4,2.4,0,2,4,3,4,4,3,2,5,3,3,4,2,3,2,4,4,5,5,1,4,5,5,5,3,2,0,2,5,3,3,3,2,4,2,4,1,4,2,4,4,1,3,5,3,5,5,5,5,1,4,3,2,3,2,2,5,1,1,3,2,3,2,2,3,3,4,2,1,1.322591867980916,0.9411239481143202,4.25,0,2.5,0,3.3333333333333335,0,3,0,4,0,3,0,2.2857142857142856,0,2.3333333333333335,0,3.189189189189189,0,2,0,2,1.7718573145771632,0.49225069041682806,1.1320540024969956,5,1,4,2,1,3,2,2,1,1.5118578920369088,1.7142857142857142,0,1.5,-0.2912888008837234,5,5,5,5,3,3,2,4,3,NA,3,1.2909944487358056,4.285714285714286,0,1.7142857142857142,5.5,3.8333333333333335,3.2559414990859232,0.6723373927674386,0,-0.07794085419894053,3,4,4,2,5,2,4,2,2,3,4,4,2,4,5,2,4,3,5,3,1.0997835284835873,3.6,0,3.4,0,4,0,4,0,3.8,0,2,2,3,3,3,3,3,1,1,1,1,2,2,3,2,2,2,3,3,3,0.7863975156570492,2.45,0,"White, Caucasian, Anglo, European American",0,20,1,2,NA,1,2,4,barista,2,0,115,67,1,5,2,0,0,2,0,0,TRUE,TRUE,TRUE,TRUE,TRUE,5,0.6303258064533434,0.6326530612244898,0.10004827158928349,5,0.4697593750013038,0.5258741935491562,1,0.96875,0.003993187006143249,0.009107462580131063,5,0.5987156250020489,0.7325193548423629,1,1,0.006497912329145065,0.007232902945438902,1.2297,0.4359,0.2974,0,27.2463,0.004,ML,change,49,-42.817139105668126,0.4303935870394848,1.2630658610141183,0.24103201110620776,1.2462,3.2259,0.3404,4.6212,0.3349,0,-69.3404,0.009,ML,cueing,64,151.15744925007903,3.424612739880075,1.0027373794694812,0.3886227194911641,4.570698578622744,0.9064554695794345,0.3736987049472661,0.132,0.362,0.564,0.01,1.553,68.90077746248437,1875.5073356749328,0.152,0.364,0.66,0.011,1.678,65.00451539954844,1848.092071059105,447,1.3244444444444445,1,0,1,2,FALSE,FALSE,FALSE
94,2021-11-13T00:49:46Z,2021-11-13T01:18:31Z,1724,1,2021-11-13T01:18:32Z,1,Chrome,93.0.4577.63,Macintosh,1440,900,NA,1.6,610,498,356,75,53,85,-0.46042869066817177,3.7083503195288396,-0.3442401010216793,-0.3604903914576942,-0.2616716161181409,-0.34418861776319626,2,1,3,3,2,1,4,3,3,2,2,3,3,4,2,2,4,4,1,2,0.998683343734455,0,1,2,3,2,3.15,0,3,4,3,3,3,2,1,2,1,5,3,4,4,3,3,3,2,1,1,1,3,3,2,2,2,0,0,2,2,3,3,3,5,5,5,5,2,5,1,1,3,1,5,2,2,1,2,3,5,1,1,1,3,2,1,2,2,1,4,2,2,1,2,1,2,1,1,1,1.4457143874535143,1.0997835284835873,2,0,1.25,0,2.933333333333333,0,2.3333333333333335,0,1.6666666666666667,0,1.3333333333333333,0,1.5714285714285714,0,1.3333333333333333,0,1.7837837837837838,0,1,0,0,0.029052570671323868,-0.4557470907642554,-0.21334726004646576,5,1,4,1,1,1,1,1,1,1.7320508075688772,1.1428571428571428,0,1,-0.8176513788914915,5,5,5,4,3,3,1,3,3,5,4,1.4960264830861913,4.285714285714286,0,1.7142857142857142,6,3.8333333333333335,3.2559414990859232,0.9547190977297628,0,0.06324999828222155,3,5,4,4,4,4,5,3,1,2,2,4,3,3,3,1,3,3,3,2,1.082325538564332,4,0,3.2,0,3.6,0,3.6,0,3.466666666666667,0,3,3,3,2,4,4,4,4,4,3,3,2,2,2,1,2,2,2,3,4,0.9333020044867296,2.85,0,"White, Caucasian, Anglo, European American",0,21,1,2,NA,1,4,4,receptionist/cashier,6,0,165,69,1,5,2,1,1,1,0,2,TRUE,TRUE,TRUE,TRUE,TRUE,2,0.9447189189485602,0.74,0.12163573724501794,2,0.4679374999925494,0.5491406250074505,1,1,0.013338999833208477,0.015804134749682324,2,0.637549999974668,0.6974290322411445,1,0.96875,0.015241419355823915,0.01820794974336264,1.8512,0.6183,0.209,0,53.2649,0.003,ML,change,50,-94.79373098371556,0.7597979464811168,1.3766404081860506,0.5098747613737498,2.1583,3.9643,0.2769,4.5021,0.2282,0,-54.5344,0.008,ML,cueing,64,121.545449250079,3.240558107861961,1.2785250529344987,0.35803602144774554,3.380894956657265,1.2254550287737729,0.29236866772419157,0.075,0.405,0.345,0.011,1.231,65.94328046375597,1903.2029415346838,0.077,0.411,0.346,0.013,1.373,80.8533343114045,1905.4357799043266,336,0.9955555555555555,1,0,0,1,FALSE,FALSE,FALSE
95,2021-11-13T00:55:13Z,2021-11-13T01:18:43Z,1410,1,2021-11-13T01:18:44Z,1,Chrome,95.0.4638.69,Macintosh,1440,900,NA,1.6,696,54,323,67,47,113,-0.2394631271578155,-0.3252734915240852,-0.5031099924527209,-0.45798164373004263,-0.34454397393920994,0.12876965154068984,3,2,3,1,2,1,2,2,1,3,3,3,1,2,2,2,2,1,2,3,0.7591546545162482,0,1,3,4,3,2.15,0,2,2,4,3,4,4,3,4,2,3,5,2,2,2,2,3,4,5,2,3,2,4,2,2,2,2,1,3,3,2,3,3,5,5,5,3,1,5,2,1,4,3,5,5,2,3,2,3,1,2,5,1,3,3,1,2,2,2,1,4,3,1,3,1,1,2,1,1,1.3770970904029955,1.0327955589886444,3.125,0,1.25,0,3.6,0,2.4444444444444446,0,2.1666666666666665,0,3,0,2.5714285714285716,0,1.6666666666666667,0,2.4594594594594597,0,1,2,1,1.0893894566809024,0.13396897132097274,0.6116792140009375,4,2,2,2,1,2,2,1,3,0.8997354108424374,2.142857142857143,0,2,0.14960659196890055,2,4,3,3,1,1,3,4,5,2,1,1.1338934190276817,2.4285714285714284,0,3.5714285714285716,4.5,3.8333333333333335,3.2559414990859232,0.10757398284279028,0,0.6754004073174131,4,5,4,4,3,3,4,3,3,5,2,2,4,3,3,2,3,3,2,2,0.8837151016885368,4,0,3,0,3.4,0,3.2,0,3.2,0,2,2,2,3,2,2,3,4,1,2,3,3,2,2,1,3,2,2,2,3,0.7326950970650465,2,0,"White, Caucasian, Anglo, European American",0,18,1,2,NA,1,2,4,Student,2,0,155,65,2,5,2,0,0,0,0,0,TRUE,TRUE,TRUE,TRUE,TRUE,3,0.7798595237958998,0.84,0.009895812874816988,3,0.46983437505364417,0.5182862068866861,1,0.90625,0.004962372012351137,0.0057345045037441485,3,0.6323843750208616,0.6461322580614397,1,0.96875,0.01159675555351448,0.016696792731441607,1.0764,1.6592,0.5737,0,-12.5461,0.004,ML,change,50,36.82826901628444,2.1048399437736736,0.7878167085857223,0.652601543106444,1.1112,3.0659,0.3634,3.831,0.3248,0,-65.6416,0.01,ML,cueing,64,143.75984925007901,3.031581439943249,0.7483498584028915,0.4180028610492522,4.329025705882529,0.9570593957808111,0.36274892989183855,0.083,0.364,0.332,0.04,1.449,86.89001745808861,1913.0372766880632,0.081,0.382,0.328,0.038,1.49,113.91684690165741,1940.8898662752836,426,1.2622222222222224,1,0,0,1,FALSE,FALSE,FALSE
97,2021-11-13T00:59:08Z,2021-11-13T01:21:37Z,1348,1,2021-11-13T01:21:37Z,1,Firefox,94.0,Windows NT 10.0,1920,1080,NA,1.7777777777777777,653,56,286,63,46,124,-0.34994590891299365,-0.30710401489772066,-0.6812368404208585,-0.5067272698662169,-0.3583560335760547,0.31457468591007365,2,3,3,3,2,1,1,1,1,2,1,2,3,3,2,2,1,1,2,3,0.8255779474818965,0,0,5,4,3,2.45,0,2,2,4,3,4,5,2,5,5,5,5,2,2,2,1,4,5,1,1,5,5,5,5,5,2,0,1,3,4,4,4,2,5,4,4,2,3,3,5,1,4,5,5,5,5,5,5,5,2,2,1,1,2,1,1,3,3,2,4,2,4,1,1,2,1,4,2,2,1.4866775743954068,1.486446705914413,3.875,0,2.25,0,4.2,0,2.4444444444444446,0,3.75,0,1.6666666666666667,0,2.2857142857142856,0,1.3333333333333333,0,2.675675675675676,0,3,0,1,1.762468663007749,0.44049231459692256,1.1014804888023357,5,1,4,1,1,1,1,2,1,1.7320508075688772,1.1428571428571428,0,1.5,-0.6331575415043005,5,5,5,5,3,2,1,3,6,6,4,1.7043362064926932,4.285714285714286,0,1.7142857142857142,4.5,3.8333333333333335,3.2559414990859232,0.10757398284279028,0,-0.3603225591612647,3,5,4,4,4,4,4,3,4,3,2,3,4,3,5,5,3,1,3,2,1.0997835284835873,4,0,3.4,0,2.6,0,3.4,0,3.1333333333333333,0,2,4,2,3,4,3,3,2,1,1,3,3,2,3,2,3,3,3,3,3,0.812727700887249,2.55,0,"White, Caucasian, Anglo, European American",0,27,3,3,NA,1,2,4,homemaker/stay at home parent,2,0,140,62,3,5,2,0,0,0,0,0,TRUE,TRUE,TRUE,TRUE,TRUE,3,0.7203170731707317,0.8367346938775511,0.012774693027210885,3,0.44106451612903225,0.48848387096774193,1,0.96875,0.0031887956989247314,0.002119403225806452,3,0.60340625,0.6724375,1,1,0.008576313508064513,0.00815677016129032,1.0865,1.6855,0.4928,0,-13.8396,0.009,ML,change,49,39.35466089433188,1.9519995850983476,0.8371572092020397,0.5759011221018533,1.682,5.1711,0.3352,5.6586,0.2924,0,-84.3987,0.007,ML,cueing,63,181.22680417917462,4.930686826276246,0.6964521020043292,0.42227363813065055,4.835104006147424,0.8568863712391478,0.3552226530499225,0.205,0.298,0.668,0.014,1.179,102.01544632757589,1906.3091340820208,0.202,0.293,0.658,0.013,1.262,122.67599761678453,1908.5731654822694,326,0.965925925925926,1,0,0,1,FALSE,FALSE,FALSE
98,2021-11-13T00:53:30Z,2021-11-13T01:22:49Z,1758,1,2021-11-13T01:22:50Z,1,Chrome,95.0.4638.69,Windows NT 10.0,2560,1440,nope,1.7777777777777777,613,45,277,63,42,83,-0.45272058961548495,-0.40703613634272556,-0.7245649926293244,-0.5067272698662169,-0.4136042721234341,-0.3779713512849024,3,3,2,1,3,1,1,3,1,3,2,1,1,1,4,3,1,2,3,3,1.0208355710680808,1,1,1,4,4,1.6,0,4,5,2,4,2,2,4,2,2,2,2,4,2,4,3,2,3,1,1,1,2,2,2,3,2,0,0,4,2,4,3,4,5,3,4,5,2,4,1,1,4,2,4,2,2,2,3,3,5,1,1,1,1,1,1,2,2,2,4,3,2,1,1,1,1,2,2,2,1.346221494521727,1.0997835284835873,1.75,0,1.75,0,2,0,2.2222222222222223,0,2,0,0.8333333333333334,0,1.8571428571428572,0,1,0,1.8108108108108107,0,2,0,0,-0.4678684309510564,-0.0958522115332568,-0.2818603212421566,5,1,3,1,1,1,1,1,1,1.5735915849388864,1.2857142857142858,0,1,-0.7321841937363471,5,5,5,5,3,3,1,4,8,6,4,1.5735915849388864,4.428571428571429,0,1.5714285714285714,3,3.8333333333333335,3.2559414990859232,-0.7395711320441822,0,-0.8635661140261877,3,2,2,4,2,3,4,2,2,3,1,3,2,3,4,2,3,4,3,3,0.8618916073713346,2.6,0,3.2,0,3.6,0,3.6,0,3.466666666666667,0,1,1,1,2,2,2,2,2,1,1,1,3,2,2,1,3,1,2,1,2,0.6708203932499369,1.65,0,"Asian or Asian American (e.g., Chinese, Japanese, and others) & White, Caucasian, Anglo, European American",1,25,1,2,NA,1,3,6,Veterinary Student,7,0,169,72,4,5,2,0,0,1,0,0,TRUE,TRUE,TRUE,TRUE,TRUE,5,0.6840428571454116,0.7142857142857143,0.025407884192731607,5,0.32774193548098685,0.41630312499683353,0.96875,1,6.822083871490341e-4,0.00422933902237129,5,0.45360000000242146,0.5027645161324932,1,0.96875,0.00263126387134102,0.0018074289918236458,1.1402,0.8559,0.4178,0,8.9115,0.005,ML,change,49,-6.1475391056681215,0.9959959123129676,0.9199743900015455,0.48611295919207553,1.1652,4.0555,0.2726,7.3351,0.252,0,-100.3722,0.009,ML,cueing,64,213.22104925007903,4.505514269631861,0.9195697712727614,0.3174427993371307,6.546083688507204,0.5245865112470396,0.29017750171446316,0.066,0.334,0.595,0.021,1.649,151.27275230673138,1992.03911011469,0.073,0.328,0.638,0.023,1.775,162.8548471975748,1990.6468016790682,362,1.0725925925925925,1,0,0,1,FALSE,FALSE,FALSE
99,2021-11-13T00:49:10Z,2021-11-13T01:24:24Z,2114,1,2021-11-13T01:24:25Z,1,Chrome,95.0.4638.69,Windows NT 10.0,1536,864,NA,1.7777777777777777,903,77,568,189,108,139,0.29239584547757685,-0.11632451032089314,0.6763785954444064,1.028759953423271,0.49799166390832533,0.5679451873228698,3,2,4,3,2,1,1,3,1,2,2,3,3,3,3,4,1,1,3,2,0.9880869341680844,0,1,1,3,2,2.25,0,4,4,5,3,3,1,4,3,1,1,3,4,2,4,2,2,4,1,1,1,2,2,3,1,2,0,0,3,4,4,4,4,4,2,3,4,3,4,2,2,4,2,4,3,2,2,2,3,4,1,1,1,2,1,1,2,2,1,5,1,1,1,2,1,2,1,2,2,1.238763308519644,1.2798809468443688,2,0,1.75,0,2.4,0,2.4444444444444446,0,2.25,0,1.1666666666666667,0,1.1428571428571428,0,1.3333333333333333,0,1.8918918918918919,0,1,0,0,-0.1536873691539693,-0.2989446853297732,-0.22631602724187125,5,1,5,1,1,1,1,3,1,1.9518001458970664,1,0,2,-0.5341308892722537,3,4,4,4,2,2,3,7,6,3,3,0.8997354108424374,3.142857142857143,0,2.857142857142857,2.5,3.8333333333333335,3.2559414990859232,-1.0219528370065065,0,-0.2877179897144191,2,3,3,3,2,2,4,2,3,2,1,2,3,3,4,1,3,2,4,2,0.990430401872025,2.6,0,3.6,0,3.6,0,3.6,0,3.6,0,2,3,1,2,3,1,2,3,1,1,2,3,2,1,2,3,2,1,1,1,0.812727700887249,1.75,0,"White, Caucasian, Anglo, European American",0,18,1,2,NA,1,4,3,Student studying biomedical engineering,5,0,200,65,3,5,2,0,0,1,0,0,TRUE,TRUE,TRUE,TRUE,TRUE,1,0.8529151515151854,0.66,0.12116349830219614,1,0.4428379310346369,0.49851333333334574,0.9354838709677419,0.967741935483871,0.04151703529041307,0.008712086924753263,1,0.9383406249998371,1.4270038461536885,1,0.9629629629629629,0.2918079528124654,0.4009418419944996,1.4986,0.4534,0.415,0,43.1422,0.004,ML,change,50,-74.54833098371557,0.4971280813373818,1.3342521621909986,0.42348789933451675,1.2414,3.2563,0.3168,2.176,0.2252,0,-37.599,0.009,ML,cueing,62,87.57940315513527,3.446863144741798,0.9867515009554978,0.3646104084079312,2.0498054449705143,1.304586567465672,0.16567679371477667,0.132,0.219,0.156,0.005,1.63,113.51730336336269,1956.682164133382,0.134,0.225,0.156,0.005,1.707,133.43003490219056,1961.3175377969892,376,1.114074074074074,1,0,1,2,FALSE,FALSE,FALSE
100,2021-11-13T00:45:09Z,2021-11-13T01:25:25Z,2416,1,2021-11-13T01:25:26Z,1,Edge,95.0.1020.44,Windows NT 10.0,1920,1080,"No, everything was fine.",1.7777777777777777,1246,46,647,141,44,113,1.1736887325014396,-0.39795139802954327,1.0567034870520515,0.4438124397891804,-0.3859801528497444,0.12876965154068984,3,2,3,2,3,2,3,2,3,3,2,3,2,2,3,3,2,3,2,3,0.5104177855340404,0,1,1,4,3,2.45,0,1,4,1,4,2,2,4,2,2,4,2,5,1,5,3,2,2,3,3,1,1,3,1,1,2,0,3,2,2,5,5,5,3,3,4,3,4,3,2,3,4,3,2,4,4,3,2,4,3,1,2,2,3,1,3,2,4,3,2,3,4,1,1,1,1,1,1,1,1.1585949863271212,1.424279266355945,2,0,1,0,2.1333333333333333,0,2.4444444444444446,0,3.1666666666666665,0,1.8333333333333333,0,3.142857142857143,0,1,0,2.6486486486486487,0,1,0,3,0.05692815471246996,-0.00479935278395429,0.026064400964257835,5,1,3,2,1,1,2,1,1,1.4638501094227998,1.5714285714285714,0,1,-0.5612498234260587,4,4,5,3,3,4,2,3,3,3,3,0.9759000729485332,3.857142857142857,0,2.142857142857143,6,3.8333333333333335,3.2559414990859232,0.9547190977297628,0,0.30226299054653183,2,2,3,3,4,4,2,3,1,3,3,2,2,3,3,3,2,2,3,4,0.816496580927726,2.8,0,2.6,0,3,0,3.2,0,2.933333333333333,0,3,2,3,3,2,3,3,3,1,2,2,3,3,2,2,2,3,2,3,3,0.6069769786668839,2.4,0,"White, Caucasian, Anglo, European American & Native American/Alaskan Native/indigenous",1,21,0,1,NA,1,3,3,Social Manager,3,0,160.9,68,3,5,2,0,0,1,0,0,TRUE,TRUE,TRUE,TRUE,TRUE,3,0.9439594594614731,0.7708333333333334,0.21366242737606375,3,0.428880000000447,0.5564593750000931,0.967741935483871,1,0.002559224924714439,0.009215067651291355,3,0.6348687500003726,0.7349250000009779,1,1,0.01256044737912635,0.03836104709663325,1.5151,0.8192,0.4368,0,33.2816,0.005,ML,change,48,-54.94959696727632,0.7527495312171256,1.611455855554649,0.36417037586854417,1.155,3.3591,0.3845,5.1763,0.3223,0,-76.5325,0.007,ML,cueing,63,165.49440417917458,3.7084110150932728,1.117226410322084,0.4105325777013993,4.68195759784115,0.7264477113655298,0.3563056437741927,0.109,0.361,0.357,0.113,1.888,113.37416584674286,1905.1621041265257,0.111,0.361,0.366,0.047,1.991,134.30982362502075,1918.703348464426,314,0.9303703703703704,1,1,5,6,FALSE,FALSE,FALSE
101,2021-11-13T01:07:39Z,2021-11-13T01:26:31Z,1132,1,2021-11-13T01:26:32Z,0.8999999761581421,Edge,94.0.992.50,Windows NT 10.0,1536,864,no,1.7777777777777777,603,57,264,30,24,89,-0.47841425979110774,-0.2980192765845384,-0.7871501013748863,-0.9088786854896541,-0.6622213455866413,-0.27662315071978394,3,2,2,1,3,1,2,2,1,4,2,2,1,1,3,3,1,1,2,2,0.8870412083230169,0,1,1,4,4,1.85,0,3,4,2,4,1,1,4,2,2,1,1,3,4,3,5,3,4,1,1,1,1,1,2,3,2,0,2,4,2,3,3,4,4,4,4,4,1,4,2,1,1,2,5,5,5,4,2,3,2,4,3,2,3,2,4,3,2,2,2,3,2,2,3,2,3,2,2,2,1.1396485417876858,1.3451854182690985,1.75,0,2.25,0,2,0,2.4444444444444446,0,2.75,0,2.8333333333333335,0,2.7142857142857144,0,2.3333333333333335,0,2.7027027027027026,0,2,0,2,-0.08457915038529361,0.41384948769958696,0.16463516865714667,4,1,3,1,1,1,1,1,1,1.2535663410560174,1.4285714285714286,0,1,-0.6467170085812028,3,4,4,3,1,1,2,5,4,2,2,1.2724180205607036,2.857142857142857,0,3.142857142857143,4.5,3.8333333333333335,3.2559414990859232,0.10757398284279028,0,0.4363874150531028,3,3,2,4,3,2,4,2,4,4,2,2,3,2,4,3,2,3,3,4,0.8837151016885368,3,0,3,0,3.4,0,2.8,0,3.066666666666667,0,3,2,3,2,2,3,2,2,2,2,2,3,2,2,1,2,3,2,1,1,0.6407232755171874,2.2,0,"White, Caucasian, Anglo, European American",0,22,1,2,NA,1,3,3,internet provider,3,0,130,64,2,5,2,0,0,0,0,0,TRUE,TRUE,TRUE,TRUE,TRUE,NA,NA,NA,NA,NA,NA,NA,NA,NA,NA,NA,3,0.6463531250357628,0.7085548387650521,1,1,0.005418067732207775,0.0045102158826363665,NA,NA,NA,NA,NA,NA,NA,NA,NA,NA,NA,NA,NA,NA,NA,NA,NA,NA,NA,NA,NA,NA,NA,NA,NA,NA,NA,NA,NA,NA,NA,0.176,0.394,0.724,0.013,1.236,103.92569368907797,1923.496113348921,0.179,0.393,0.723,0.013,1.327,125.4291360031072,1913.9923694198774,104,0.3081481481481481,1,0,0,1,FALSE,FALSE,FALSE
102,2021-11-13T01:00:48Z,2021-11-13T01:26:33Z,1545,1,2021-11-13T01:26:35Z,1,Edge,95.0.1020.40,Windows NT 10.0,1366,768,no,1.7786458333333333,666,53,484,95,85,90,-0.316544137684684,-0.33435822983726743,0.27198250816539127,-0.11676226077682311,0.18031429226089402,-0.2597317839589309,4,4,1,1,4,1,1,2,1,4,4,1,1,1,4,4,1,1,4,4,1.500876936643164,0,1,1,2,2,1.1,0,1,4,5,2,5,5,2,5,5,5,5,1,1,3,4,5,5,5,5,3,5,5,5,25,4,7,10,4,1,1,5,1,3,2,4,2,5,1,5,3,2,3,1,5,5,5,5,5,2,3,5,1,5,3,3,5,5,1,5,1,1,3,5,3,1,3,4,4,1.635290241570032,1.6846647257229665,4.75,0,3,0,4.066666666666666,0,3.4444444444444446,0,4.583333333333333,0,3.3333333333333335,0,2.2857142857142856,0,3.6666666666666665,0,3.6486486486486487,0,6,6,6,2.4993326258731914,3.407020824192241,2.953176725032716,2,5,1,5,5,5,5,8,3,1.7320508075688772,4.857142857142857,0,5.5,3.0649399716269796,2,2,2,1,1,1,5,6,3,1,1,1.4142135623730951,1.4285714285714286,0,4.571428571428571,4.5,3.8333333333333335,3.2559414990859232,0.10757398284279028,0,1.2330973892674701,3,2,5,5,3,3,4,1,1,5,1,5,2,5,5,1,5,1,5,2,1.8309508328682538,3.6,0,4.6,0,4.6,0,4.8,0,4.666666666666667,0,2,3,1,4,2,1,1,3,1,2,3,1,1,1,1,2,1,2,2,1,0.910465468000326,1.75,0,"White, Caucasian, Anglo, European American",0,22,1,2,NA,1,3,6,Marketing,2,0,140,62,2,5,2,0,0,0,0,0,TRUE,TRUE,TRUE,TRUE,TRUE,1,1.0384195122137303,0.82,0.09270006183882341,1,0.46728666671117147,0.5874593750238418,1,1,0.0014253660126571656,0.005181423787446328,1,0.6104281250238418,0.6573333333015442,1,0.967741935483871,0.012136122734656644,0.013115483240477734,1.5024,1.0808,0.6133,0,23.9403,0.005,ML,change,50,-36.14453098371556,1.119976468380959,1.3539101330942462,0.6515799179707656,10,9.9169,0.0833,15.2689,0.1398,0,-95.8931,0.01,ML,cueing,62,204.16760315513528,4.2825280450465035,0.9674506933314299,0.47803593992820015,5.010475699182814,0.8268944857006808,0.3806588520472638,0.084,0.357,0.335,0.061,1.795,146.71737414201638,2008.9993581687067,0.088,0.342,0.338,0.021,1.915,160.75814282562027,1985.7127852734493,362,1.0725925925925925,1,0,0,1,FALSE,FALSE,FALSE
103,2021-11-13T00:53:40Z,2021-11-13T01:26:37Z,1976,1,2021-11-13T01:26:38Z,1,Chrome,95.0.4638.69,Macintosh,1280,800,N/A,1.6,801,106,674,105,115,128,0.030320409686224094,0.1471329007613925,1.1866879436774491,0.0051018045636124325,0.5946760813662392,0.38214015295348597,2,3,3,3,2,3,2,2,1,2,2,2,1,3,2,1,2,2,1,1,0.7254762501100116,0,1,1,3,3,2.7,0,3,5,2,5,1,1,3,2,1,2,4,4,1,4,3,3,3,1,1,2,3,2,3,1,2,0,0,3,3,5,5,5,5,5,5,4,1,5,3,1,4,2,5,1,3,4,5,5,4,1,1,1,2,1,1,2,1,1,5,1,1,1,1,2,1,3,1,2,1.7242311251607114,1.4375905768565218,2.25,0,1.75,0,1.9333333333333333,0,1.5555555555555556,0,2.4166666666666665,0,1.1666666666666667,0,1,0,1.3333333333333333,0,1.7027027027027026,0,1,0,0,-0.32810334985586437,-0.2989446853297732,-0.3135240175928188,5,1,5,1,1,1,1,2,2,1.9518001458970664,1,0,2,-0.5341308892722537,5,5,5,4,4,4,1,4,6,5,4,1.4142135623730951,4.571428571428571,0,1.4285714285714286,4,3.8333333333333335,3.2559414990859232,-0.1748077221195339,0,-0.6608554064853003,3,2,2,3,3,2,5,1,2,3,1,5,3,3,4,1,5,3,5,1,1.5796322658258457,2.6,0,4.4,0,4.2,0,4.2,0,4.266666666666667,0,4,3,2,3,2,1,2,2,1,2,3,3,2,2,3,4,1,2,1,2,0.910465468000326,2.05,0,"White, Caucasian, Anglo, European American",0,20,1,2,NA,1,4,3,Orientation Leader,6,0,140,63,1,5,2,0,1,4,0,1,TRUE,TRUE,TRUE,TRUE,TRUE,1,0.8391162790725397,0.8775510204081632,0.10474905783811077,1,0.3886437500081956,0.468629999991258,1,0.967741935483871,0.001582991572878159,0.002486410902875531,1,0.6070499999970198,0.632522580642854,1,0.96875,0.007751764514473946,0.012574257247234481,1.5909,1.3166,0.4178,0,19.5326,0.005,ML,change,49,-27.38973910566812,1.3290022315774512,1.4818941606500475,0.41813079146636767,1.0024,4.8483,0.3697,5.8646,0.3032,0,-104.6912,0.007,ML,cueing,63,221.8118041791746,4.71586500927296,0.721224499635649,0.39709552164749107,5.76027004167377,0.7192605027919239,0.3281618969840611,0.079,0.402,0.366,0.076,1.685,95.99212598824934,1956.3332287366381,0.078,0.401,0.36,0.095,1.764,137.5829712076723,1963.8068765235178,388,1.1496296296296296,1,0,0,1,FALSE,FALSE,FALSE
104,2021-11-13T01:08:23Z,2021-11-13T01:28:44Z,1220,1,2021-11-13T01:28:45Z,0.800000011920929,Safari,14.1.1,Macintosh,1440,900,NA,1.6,621,114,259,55,39,81,-0.43216565347498664,0.2198108072668506,-0.8112212970462562,-0.6042185221385653,-0.4550404510339686,-0.4117540848066085,2,3,4,4,3,3,3,2,3,2,2,4,3,2,2,3,4,3,2,2,0.7677718959499145,0,1,1,2,3,3,0,2,3,4,3,5,4,1,5,5,4,3,1,2,2,1,3,5,2,1,4,5,5,5,7,3,0,0,5,2,2,1,3,2,1,3,1,4,2,5,1,3,5,4,5,5,5,5,5,2,1,1,1,5,3,1,5,5,2,3,5,4,2,3,5,3,4,4,3,1.6075086575456083,1.4638501094227998,3.75,0,3.5,0,4.066666666666666,0,3.7777777777777777,0,4.083333333333333,0,2.3333333333333335,0,3.4285714285714284,0,3.3333333333333335,0,3.5945945945945947,0,4,0,0,2.0463543852045625,0.8591411550804637,1.452747770142513,3,2,3,1,1,3,2,3,1,0.8997354108424374,2.142857142857143,0,2,0.14960659196890055,4,3,3,2,3,2,2,7,7,NA,2,0.7559289460184544,3,0,3,2,3.8333333333333335,3.2559414990859232,-1.3043345419688306,0,-0.34923784477414443,3,2,2,4,3,2,5,3,2,1,4,3,4,2,3,5,3,2,4,3,1.162919151265879,2.8,0,3.2,0,2.6,0,3,0,2.933333333333333,0,3,4,3,2,3,3,4,3,3,4,4,3,2,3,2,3,1,3,3,2,0.7880689256524124,2.8,0,"White, Caucasian, Anglo, European American",0,19,1,3,NA,1,3,3,telemetry technician,3,0,130,67,2,5,2,0,1,0,0,1,TRUE,TRUE,TRUE,TRUE,TRUE,3,0.6881388888888873,0.7346938775510204,0.055719308673470976,3,0.48166666666665586,0.5349374999999964,1,1,0.016019769230767946,0.004486383064517314,3,0.6424374999999991,0.6807419354838743,1,1,0.013384705645161605,0.01690273118279549,1.1745,0.8811,0.3722,0,13.5118,0.004,ML,change,49,-15.34813910566812,0.9016540534662323,1.1296678333323986,0.3940947118231767,5.3543,8.4395,0.2177,6.0142,0.0365,0,-64.5885,0.006,ML,cueing,59,141.40961233171714,4.439544425437391,0.9332342081436306,0.43311729588636466,3.2295977247917027,1.2828640219142926,0.2892627471801159,0.168,0.262,0.435,0.038,1.43,67.49152213723518,1876.7631199897235,0.168,0.268,0.435,0.039,1.495,91.53530191411599,1875.4399665606363,424,1.2562962962962962,1,0,0,1,FALSE,FALSE,FALSE
105,2021-11-13T00:40:01Z,2021-11-13T01:28:48Z,2926,1,2021-11-13T01:28:50Z,0.8999999761581421,Chrome,95.0.4638.69,Macintosh,1440,900,Thank you!,1.6,690,1127,564,86,284,120,-0.2548793292631892,9.422650718520483,0.6571216389073103,-0.2264399195832151,2.928914159993017,0.24700921886666136,1,1,3,3,1,1,2,2,1,1,2,3,3,2,1,1,3,3,1,1,0.8944271909999159,0,1,3,2,2,3.1,0,3,1,2,1,3,4,2,3,3,2,4,3,4,2,1,4,2,2,3,3,5,3,5,4,5,2,1,2,1,1,1,1,3,3,3,3,2,5,5,2,1,2,3,5,5,5,5,5,3,5,3,4,3,1,3,4,3,1,1,5,5,4,5,3,3,3,3,2,1.5122125468289127,1.0600988273786194,3.375,0,2.75,0,3.6,0,4,0,3.75,0,3,0,3.5714285714285716,0,4,0,3.72972972972973,0,2,2,1,1.7427234576452704,0.8074686614209358,1.2750960595331031,4,1,4,3,1,1,3,3,3,1.3972762620115438,1.8571428571428572,0,3,0.34765989643299416,3,4,3,3,1,1,5,4,4,1,1,1.4638501094227998,2.2857142857142856,0,3.7142857142857144,5,3.8333333333333335,3.2559414990859232,0.38995568780511447,0,0.8962622572200118,4,4,4,4,4,3,5,4,3,5,1,3,3,3,5,1,5,3,5,5,1.4040757000349275,4,0,3.8,0,4.6,0,2.8,0,3.7333333333333334,0,2,2,2,2,3,1,4,4,2,3,3,3,1,3,2,4,2,1,3,3,0.9459053029269173,2.2,0,"White, Caucasian, Anglo, European American",0,22,1,2,NA,1,2,6,Research Assistant,2,0,148,66,2,5,2,1,1,1,0,2,TRUE,TRUE,TRUE,TRUE,TRUE,2,0.73394102564072,0.78,0.03822378496400457,2,0.47863750000763683,0.5571600000013908,1,0.9375,0.004779921128823358,0.00718250963761583,2,0.6682656249990687,0.7785620689690113,1,0.90625,0.010267068780060977,0.029481759959736724,1.5666,0.9201,0.2623,0,29.4817,0.004,ML,change,50,-47.22733098371556,1.2008988784712789,1.053932513403997,0.4882075096524485,0.9975,3.247,0.4178,3.9751,0.3532,0,-73.1052,0.007,ML,cueing,64,158.687049250079,3.2020500989380847,0.8457238698421043,0.44160771892414363,4.369757251271289,0.9481384178002508,0.3735390884223283,0.061,0.521,0.372,0.014,1.48,68.992406792907,1967.621006667073,0.06,0.521,0.389,0.014,1.568,81.85120762937133,1966.8490156995813,104,0.3081481481481481,1,0,0,1,FALSE,FALSE,FALSE
106,2021-11-13T01:01:52Z,2021-11-13T01:29:55Z,1683,1,2021-11-13T01:29:56Z,1,Edge,95.0.1020.44,Windows NT 10.0,1280,720,no,1.7777777777777777,899,52,418,91,64,99,0.2821183774073277,-0.3434429681504497,-0.04575727469669198,-0.1655078869129973,-0.10973896011284763,-0.10770948311125321,3,3,2,1,2,1,1,2,1,2,2,1,1,1,3,3,1,1,2,2,0.7863975156570492,0,1,2,4,3,1.85,0,3,3,2,4,1,2,4,3,2,1,1,3,4,4,3,2,2,1,1,1,3,1,3,1,2,2,3,5,2,2,3,3,4,3,2,2,2,4,2,1,1,1,1,1,2,4,4,4,4,2,1,1,2,1,1,2,2,2,5,1,2,1,1,1,3,2,2,3,1.2502252049383196,1.1126972805283737,1.75,0,2.5,0,2.2666666666666666,0,3.111111111111111,0,2.75,0,1.3333333333333333,0,1.4285714285714286,0,1,0,2.27027027027027,0,1,2,3,-0.15581675404600126,0.8788742787055398,0.36152876232976927,4,2,2,4,2,3,3,3,1,0.8997354108424374,2.857142857142857,0,2,0.5769425177446221,5,5,5,5,2,2,2,1,1,1,2,1.6035674514745464,4,0,2,8,3.8333333333333335,3.2559414990859232,2.0842459175790595,0,0.7873554030497435,3,2,3,2,2,2,5,2,2,3,2,4,2,3,4,1,4,3,3,2,1.082325538564332,2.4,0,3.8,0,4,0,3.8,0,3.8666666666666667,0,3,2,4,2,2,4,2,2,2,2,1,2,1,3,2,2,3,4,1,2,0.9233805168766387,2.5,0,"Hispanic of Latino (e.g., Mexican American, Central American, and others)",0,19,1,2,NA,1,2,4,Student,2,0,110,63,3,5,2,0,0,0,0,0,TRUE,TRUE,TRUE,TRUE,TRUE,2,1.1501857142857144,0.7142857142857143,0.27543416791707126,2,0.7531310344816282,1.125574193548291,0.9666666666666667,1,0.22238648603543207,0.5254954159785988,2,0.740590624999255,0.8235741935487717,1,1,0.01509942023182017,0.0337829706450145,1.6472,0.5456,0.6684,0,51.063,0.006,ML,change,49,-90.45053910566813,0.5489025240821697,1.6693141162108924,0.4985032168193181,1.9509,1.4116,0.4345,1.9197,0.3454,0,23.1776,0.004,ML,cueing,61,-34.02257840748007,1.3494918354571581,3.0701443443620327,0.02360297169455916,1.526033190459314,2.2065678853111748,0.07835430862159176,0.175,0.358,0.452,0.015,1.208,10.13595520248883,1803.5117025821153,0.184,0.352,0.479,0.011,1.169,17.44867055346937,1797.703539966117,366,1.0844444444444443,1,0,0,1,FALSE,FALSE,FALSE
107,2021-11-13T00:54:55Z,2021-11-13T01:29:56Z,2101,1,2021-11-13T01:29:57Z,0.8999999761581421,Chrome,95.0.4638.69,Windows NT 10.0,1368,912,Everything went well and I had no problems with the tasks.,1.5,686,94,499,147,85,122,-0.26515679733343833,0.038116041003205335,0.3441960951795011,0.5169308789934417,0.18031429226089402,0.2807919523883675,2,3,3,4,2,3,3,2,1,2,2,3,3,4,2,1,2,3,1,1,0.9333020044867296,0,1,1,4,5,3.05,0,4,4,2,5,2,1,4,1,2,2,2,5,1,5,5,1,3,1,1,1,1,1,1,0,2,0,0,5,5,4,4,5,5,5,5,5,1,5,1,2,5,3,5,2,2,2,4,4,5,1,1,1,5,2,1,1,1,1,5,2,1,1,3,1,1,1,1,1,1.7480147469502525,1.6035674514745464,1.25,0,1,0,1.5333333333333334,0,1.2222222222222223,0,2,0,1.6666666666666667,0,1,0,1.6666666666666667,0,1.5945945945945945,0,0,0,0,-0.9762106788125177,-0.7372407672780129,-0.8567257230452653,5,2,3,1,1,1,1,1,1,1.5275252316519468,1.4285714285714286,0,1,-0.6467170085812028,4,4,5,4,5,4,3,6,5,2,2,0.6900655593423543,4.142857142857143,0,1.8571428571428572,3.5,3.8333333333333335,3.2559414990859232,-0.4571894270818581,0,-0.563033266702152,5,5,5,3,4,5,4,3,4,3,4,3,3,4,5,4,3,2,5,4,0.8837151016885368,4.4,0,2.6,0,3.4,0,3.2,0,3.066666666666667,0,3,1,2,3,4,1,4,4,1,2,1,4,2,3,1,4,3,3,1,2,1.190974832912761,1.95,0,"Asian or Asian American (e.g., Chinese, Japanese, and others)",0,26,1,3,NA,1,2,6,student,1,0,99,62,2,5,2,0,0,0,0,0,TRUE,TRUE,TRUE,TRUE,TRUE,6,0.7072242424226168,0.66,0.17060721959289915,6,0.36121199999928477,0.39425925925815547,0.8620689655172413,0.84375,0.0024627716749243468,0.005273612097032463,6,0.550375,0.6158600000023842,1,0.9375,0.010059782580729914,0.006058048225350566,1.2979,0.5019,0.4265,0,31.9198,0.006,ML,change,50,-52.10353098371556,0.45636454383234093,1.4534306540123,0.19765594272709586,0.805,1.9898,0.2472,2.9153,0.2549,0,-54.3419,0.008,ML,cueing,61,121.01642159251995,2.496246061366927,0.6755740067735023,0.30122814008185733,3.2182807518859757,0.5694287121079729,0.29714907925878453,0.072,0.378,0.452,0.013,1.583,95.75722974354248,1955.3944004775549,0.073,0.376,0.475,0.013,1.602,103.74819566225334,1946.634929098448,476,1.4103703703703703,1,0,0,1,FALSE,FALSE,FALSE
108,2021-11-13T01:06:32Z,2021-11-13T01:30:05Z,1413,1,2021-11-13T01:30:06Z,1,Chrome,93.0.4577.82,Macintosh,1440,900,no,1.6,791,54,311,66,41,84,0.0046267395106012734,-0.3252734915240852,-0.5608808620640088,-0.47016805026408615,-0.42741633176027893,-0.3610799845240493,1,1,2,2,1,1,2,1,1,2,2,2,2,2,1,1,2,2,1,2,0.5104177855340404,0,1,2,3,3,2.75,0,1,4,3,3,2,1,3,3,2,2,3,3,2,4,4,2,2,1,1,1,1,1,1,3,2,0,0,4,3,4,4,4,4,4,4,4,2,4,2,1,4,1,5,2,2,3,3,3,4,1,1,1,3,1,1,3,3,1,4,1,1,1,1,1,2,1,2,1,1.3445474360571321,0.9759000729485332,1.25,0,1.5,0,2.533333333333333,0,2.111111111111111,0,2,0,1.3333333333333333,0,1.5714285714285714,0,1,0,1.8108108108108107,0,2,0,0,-0.4535434780410229,-0.17425341425049792,-0.3138984461457604,4,2,4,1,1,1,1,1,1,1.4142135623730951,1.4285714285714286,0,1,-0.6467170085812028,4,4,4,4,4,4,1,6,3,3,2,1.1338934190276817,4.142857142857143,0,1.8571428571428572,4.5,3.8333333333333335,3.2559414990859232,0.10757398284279028,0,-0.28065156173982786,2,3,3,3,2,3,3,3,2,2,2,4,4,4,3,2,4,3,3,3,0.7559289460184544,2.6,0,3.6,0,2.8,0,3.4,0,3.2666666666666666,0,3,3,3,2,2,3,3,2,3,3,2,2,3,3,3,2,2,3,3,2,0.5026246899500346,2.8,0,"Hispanic of Latino (e.g., Mexican American, Central American, and others)",0,21,1,2,NA,1,3,5,student,7,0,145,64,1,5,2,0,0,1,0,0,TRUE,TRUE,TRUE,TRUE,TRUE,NA,NA,NA,NA,2,0.561916129031489,0.7156499999985099,1,1,0.004185088064388799,0.009190049677267111,2,0.679961290324888,0.8969299999992053,0.96875,0.967741935483871,0.00693418064508193,0.07116477982895782,NA,NA,NA,NA,NA,NA,NA,NA,NA,NA,NA,NA,NA,8.4143,7.9751,0.1881,9.7871,0.1321,0,-72.3481,0.011,ML,cueing,63,157.12560417917462,3.7109322846104784,1.1164673479959284,0.5699214255569279,4.517377080751495,0.9171549446348842,0.46357434388354235,0.083,0.476,0.375,0.01,1.545,138.772417334179,2063.3119910053065,0.079,0.496,0.352,0.013,1.727,163.50797258310598,2037.534821239116,268,0.794074074074074,1,0,0,1,FALSE,FALSE,FALSE
109,2021-11-13T00:54:00Z,2021-11-13T01:32:50Z,2329,1,2021-11-13T01:32:51Z,0.800000011920929,Chrome,88.0.4324.190,Windows NT 10.0,1366,768,"My Parents were never married, broke up before I was born. I grew up with my dad only.",1.7786458333333333,874,86,689,143,134,165,0.21788420196827069,-0.03456186550225277,1.258901530691559,0.4681852528572675,0.8571052144662912,1.0071207231050496,2,2,3,3,3,1,1,1,1,2,1,1,1,1,3,2,1,1,2,3,0.8506963092234007,0,1,2,5,1,2.15,0,4,4,1,4,1,1,5,1,2,1,1,5,1,4,2,1,1,1,1,1,2,1,1,3,2,0,2,5,5,5,5,5,5,2,4,3,2,4,1,1,2,1,4,1,1,1,2,1,1,2,5,1,4,4,1,2,3,2,5,1,2,1,1,1,1,1,1,2,1.6237723475403307,1.6417180315870614,1.125,0,1.25,0,1.5333333333333334,0,1.6666666666666667,0,1.5833333333333333,0,3.3333333333333335,0,1.5714285714285714,0,1,0,1.8918918918918919,0,2,0,2,-0.9021661587032226,0.10024467683062248,-0.4009607409363001,5,1,2,1,1,2,1,1,1,1.4638501094227998,1.5714285714285714,0,1,-0.5612498234260587,1,3,4,2,1,1,2,3,4,3,3,1.1547005383792515,2.2857142857142856,0,3.7142857142857144,5.5,3.8333333333333335,3.2559414990859232,0.6723373927674386,0,1.037453109701174,4,4,4,2,2,2,2,3,4,2,2,2,3,4,4,3,3,2,1,4,0.9611501047232549,3.2,0,3.4,0,2.2,0,3,0,2.8666666666666667,0,2,2,3,1,2,3,3,1,2,1,2,1,2,3,1,2,2,3,1,2,0.7591546545162482,2.45,0,"Asian or Asian American (e.g., Chinese, Japanese, and others) & Hispanic of Latino (e.g., Mexican American, Central American, and others)",1,20,1,2,NA,1,1,3,self employed,1,0,145,64,1,5,2,0,0,0,0,0,TRUE,TRUE,TRUE,TRUE,TRUE,2,1.1390314515559905,0.6458333333333334,0.1939662576902275,2,0.580947580416837,0.6437465000897646,0.96875,0.967741935483871,0.03863139058503473,0.012774767661201475,2,0.7058076667909821,0.8714398441952653,1,1,0.02285706692575302,0.023676719128934248,1.6695,0.3789,0.5657,0,50.5705,0.004,ML,change,48,-89.52739696727633,0.40182062536529467,1.4951294744583299,0.5964019764588534,1.6041,3.1578,0.4017,2.2641,0.2425,0,-26.6295,0.007,ML,cueing,63,65.6884041791746,3.1323215459394262,1.0858391553291475,0.4816007878156746,2.386303792703514,1.439040249185826,0.2982718712852523,0.345,0.119,0.581,0.006,1.21,95.87991781724759,1887.6347364394642,0.332,0.126,0.596,0.005,1.258,100.65786153160226,1885.397079467587,344,1.0192592592592593,1,0,0,1,FALSE,FALSE,FALSE
110,2021-11-13T01:06:57Z,2021-11-13T01:33:19Z,1581,1,2021-11-13T01:33:20Z,1,Chrome,95.0.4638.69,Macintosh,1440,900,NA,1.6,714,60,448,120,68,84,-0.19321452084169444,-0.2707650616449916,0.09866989933152767,0.18789790257426575,-0.054490721565468275,-0.3610799845240493,2,4,3,2,2,1,1,2,1,3,3,1,1,2,2,4,1,1,3,2,0.998683343734455,0,1,4,3,3,1.85,0,4,4,2,5,1,1,4,3,1,1,1,4,2,4,5,2,3,5,1,1,1,2,1,2,2,1,2,5,4,4,3,3,5,5,4,4,2,4,1,1,3,1,5,2,2,1,1,1,3,1,2,3,2,1,1,2,1,1,5,1,1,1,1,1,1,2,1,1,1.4972447167185936,1.5675276256394517,2,0,1.25,0,1.6,0,1.8888888888888888,0,1.5,0,1.8333333333333333,0,1,0,1,0,1.5675675675675675,0,1,1,2,-0.6368641592005065,0.10378541062712981,-0.2665393742866884,5,1,5,1,1,2,1,1,1,1.889822365046136,1.1428571428571428,0,1,-0.8176513788914915,5,5,5,5,2,2,1,4,6,NA,3,1.8126539343499315,4.142857142857143,0,1.8571428571428572,4,3.8333333333333335,3.2559414990859232,-0.1748077221195339,0,-0.42184241422098995,2,2,3,3,2,2,4,2,2,1,2,3,2,3,5,1,3,2,4,3,1.121223821162776,2.4,0,3.6,0,3.6,0,3.8,0,3.6666666666666665,0,1,1,1,4,2,1,1,4,1,1,1,3,2,1,1,3,1,1,1,1,1.0462967275611939,1.2,0,"White, Caucasian, Anglo, European American",0,21,1,2,NA,1,4,4,Student,7,0,215,64,2,5,2,0,0,1,0,0,TRUE,TRUE,TRUE,TRUE,TRUE,3,0.7896675675753001,0.74,0.03064934041421359,3,0.43976249999552963,0.5793096774162785,1,0.96875,0.003950130160861132,0.003289109508710302,3,0.6575093749985099,0.7409593750163913,1,1,0.020675486681151878,0.025717867637156663,1.4261,0.8222,0.3768,0,25.464,0.004,ML,change,50,-39.19193098371556,1.0724032715387306,0.9753500226476246,0.5713877360530071,1.8143,4.6009,0.3942,4.861,0.2531,0,-70.7086,0.008,ML,cueing,64,153.89384925007903,4.417649275320495,0.7773335976826758,0.4968279996721078,4.583103265493517,0.9040020454231227,0.344221124341042,0.215,0.253,0.532,0.019,1.628,27.108850758369133,1812.1479720693133,0.21,0.25,0.529,0.018,1.723,32.72432492224249,1815.3090658912463,448,1.3274074074074074,1,0,1,2,FALSE,FALSE,FALSE
111,2021-11-13T01:09:48Z,2021-11-13T01:33:49Z,1440,1,2021-11-13T01:33:50Z,0.8999999761581421,Chrome,95.0.4638.69,Windows NT 10.0,1536,864,N/A,1.7777777777777777,710,61,335,69,57,135,-0.20349198891194356,-0.26168032333180935,-0.44533912284143307,-0.4336088306619555,-0.2064233775707615,0.5003797202794574,4,3,1,1,3,1,2,3,1,4,2,1,1,1,4,3,1,1,3,3,1.1821033884786185,1,0,2,3,2,1.45,0,4,5,2,4,3,1,5,1,1,1,1,4,2,5,5,1,1,1,1,1,1,1,2,3,2,0,0,5,4,5,4,5,5,2,5,3,1,4,1,1,3,1,4,4,1,1,2,1,5,1,1,1,3,1,1,2,1,1,4,3,1,1,1,1,1,1,2,1,1.60797561722359,1.709915063331955,1.125,0,1.25,0,1.4666666666666666,0,1.7777777777777777,0,1.6666666666666667,0,1.1666666666666667,0,1.4285714285714286,0,1,0,1.5675675675675675,0,2,0,0,-1.0701939847290214,-0.25265461696773905,-0.6614243008483802,5,1,5,1,1,1,1,1,1,1.9518001458970664,1,0,1,-0.9031185640466358,5,5,5,5,4,3,1,6,7,5,4,1.5275252316519468,4.571428571428571,0,1.4285714285714286,2.5,3.8333333333333335,3.2559414990859232,-1.0219528370065065,0,-1.0844279639287866,2,3,3,2,2,3,4,1,1,1,1,3,1,4,2,1,4,1,4,3,1.3345232785352157,2.4,0,4,0,3.8,0,3.8,0,3.8666666666666667,0,1,3,1,4,2,1,1,4,1,1,1,4,1,1,1,4,1,1,1,1,1.2513150976809202,1.15,0,"White, Caucasian, Anglo, European American",0,19,1,2,NA,1,4,3,vet anesthesia assistant,1,0,112,61,2,5,2,0,1,0,0,1,TRUE,TRUE,TRUE,TRUE,TRUE,NA,NA,NA,NA,NA,NA,NA,NA,NA,NA,NA,6,0.8094250000001048,0.8933333333332713,1,0.967741935483871,0.020396151612911907,0.02283140397853056,NA,NA,NA,NA,NA,NA,NA,NA,NA,NA,NA,NA,NA,NA,NA,NA,NA,NA,NA,NA,NA,NA,NA,NA,NA,2.2758328074422733,1.175019817221067,0.47528930762385274,2.637956272565562,1.5705850659768894,0.34450993347075193,0.074,0.581,0.312,0.015,1.484,35.289766437437976,1868.4835347564135,0.075,0.592,0.342,0.018,1.724,35.291801953278416,1860.8174292632764,104,0.3081481481481481,1,1,1,2,TRUE,FALSE,FALSE
112,2021-11-13T01:14:19Z,2021-11-13T01:33:52Z,1172,1,2021-11-13T01:33:53Z,1,Chrome,95.0.4638.69,Windows NT 10.0,2066,1162,N/A,1.7779690189328743,592,48,287,79,59,65,-0.5066772969842929,-0.3797819214031788,-0.6764226012865845,-0.31174476532151996,-0.17879925829707183,-0.6820159529802577,4,4,1,1,4,1,1,4,1,4,4,1,3,1,4,4,1,1,4,4,1.500876936643164,0,1,2,3,4,1.1,0,2,4,2,3,3,4,3,2,2,1,1,4,1,3,2,2,3,5,1,2,2,2,1,5,2,1,2,4,3,4,4,3,2,3,2,3,1,3,3,1,2,1,5,3,3,1,1,1,3,1,1,3,2,1,1,3,3,1,3,2,1,1,1,1,2,2,2,2,1.150792911137501,1.0600988273786194,2.25,0,2,0,2.466666666666667,0,2.888888888888889,0,1.9166666666666667,0,1.6666666666666667,0,1.8571428571428572,0,1,0,2.081081081081081,0,3,1,2,0.06370347027802684,0.7451739663718859,0.40443871832495637,4,1,2,1,1,2,2,1,2,1.0690449676496976,1.8571428571428572,0,1.5,-0.20582161572857902,5,5,5,5,2,2,2,6,3,2,3,1.6035674514745464,4,0,2,4.5,3.8333333333333335,3.2559414990859232,0.10757398284279028,0,-0.20098056431839117,2,2,2,2,2,1,4,1,1,1,1,4,1,4,1,2,1,1,3,4,1.3627702877384937,2,0,4,0,3.4,0,3.4,0,3.6,0,1,1,1,1,1,2,2,3,1,1,1,3,1,2,1,3,1,2,1,1,0.7608859102526822,1.5,0,"White, Caucasian, Anglo, European American",0,26,0,1,NA,1,3,7,Unemployed,1,0,215,70,3,5,2,0,0,1,0,0,TRUE,TRUE,TRUE,TRUE,TRUE,2,0.6655787878795103,0.66,0.0648259567714906,NA,NA,NA,NA,NA,NA,NA,2,0.5247218749993481,0.603261290322869,1,0.96875,0.002169203699700842,0.0035008670565580577,1.2655,0.5412,0.3144,0,25.8141,0.005,ML,change,50,-39.89213098371556,0.5812647854771006,1.1411223146192044,0.35147138811812284,NA,NA,NA,NA,NA,NA,NA,NA,NA,NA,NA,NA,NA,NA,NA,NA,NA,NA,0.065,0.425,0.657,0.022,1.925,43.2582416046017,1905.977727451422,0.073,0.419,0.704,0.025,2.152,48.89630158587032,1876.3931268759152,105,0.3111111111111111,1,1,3,4,FALSE,FALSE,FALSE
113,2021-11-13T01:05:07Z,2021-11-13T01:34:09Z,1742,1,2021-11-13T01:34:11Z,1,Chrome,95.0.4638.69,Macintosh,1440,900,nope :),1.6,756,107,470,92,68,102,-0.0853011061040786,0.15621763907457475,0.20458316028555543,-0.15332148037895377,-0.054490721565468275,-0.057035382828693984,3,2,1,2,2,3,3,1,1,2,1,1,1,2,2,1,2,1,2,1,0.7326950970650465,0,1,1,2,1,2.5,0,5,4,2,4,2,1,5,2,2,1,1,4,3,4,4,2,2,1,1,2,1,1,3,0,2,0,0,5,2,3,4,4,5,2,3,4,1,4,1,2,4,2,5,2,1,2,2,1,5,1,1,1,2,1,1,1,1,1,5,1,1,1,3,2,1,1,1,1,1.4760347823404023,1.4375905768565218,1.625,0,1,0,1.7333333333333334,0,2.4444444444444446,0,1.5833333333333333,0,1,0,0.8571428571428571,0,2,0,1.6486486486486487,0,0,0,0,-0.7058755877468168,-0.7372407672780129,-0.7215581775124149,4,2,3,1,1,3,2,1,1,1.1126972805283737,2,0,1,-0.3048482679606258,5,5,5,5,3,2,1,6,6,5,3,1.7043362064926932,4.285714285714286,0,1.7142857142857142,3,3.8333333333333335,3.2559414990859232,-0.7395711320441822,0,-0.783895116604751,1,3,1,1,1,1,4,1,1,3,2,5,2,4,3,3,5,1,5,1,1.5796322658258457,1.4,0,4.8,0,3.8,0,4.4,0,4.333333333333333,0,2,3,4,1,3,4,4,1,2,3,4,1,2,1,1,1,2,4,4,3,1.2354415362426845,3.1,0,"White, Caucasian, Anglo, European American",0,20,1,2,NA,1,3,4,unemployed,5,0,200,64,1,5,2,0,0,0,0,0,TRUE,TRUE,TRUE,TRUE,TRUE,2,1.1700358974322294,0.7959183673469388,0.24580718831063444,2,0.48373749999329446,0.5667062500081956,1,1,0.00292126822640917,0.007214141250998484,2,0.6506656250059605,0.709806451628285,1,0.96875,0.008036759101702436,0.015484387893903122,1.6273,0.8086,0.6093,0,42.1764,0.004,ML,change,49,-72.67733910566812,0.8023513017071086,1.6962352403989909,0.5444406476865723,6.3161,7.9642,0.1702,9.9439,0.1662,0,-83.9407,0.015,ML,cueing,64,180.35804925007903,3.9424512699318854,1.0509032180030253,0.43759083135927723,4.942192252950415,0.8383192142956687,0.40157540498736827,0.079,0.442,0.37,0.024,1.516,65.26643816754665,1900.0841138115418,0.079,0.438,0.367,0.02,1.606,89.45642832798173,1912.853037176701,378,1.12,1,0,0,1,FALSE,FALSE,FALSE
115,2021-11-13T01:05:17Z,2021-11-13T01:35:10Z,1793,1,2021-11-13T01:35:13Z,0.8999999761581421,Safari,14.0.1,Macintosh,1440,900,NA,1.6,678,119,662,134,80,85,-0.2857117334739366,0.2652344988327619,1.1289170740661612,0.3585075940508755,0.1112539940766698,-0.34418861776319626,4,3,2,3,2,1,2,3,1,3,3,1,1,2,2,2,1,1,2,2,0.8870412083230169,0,1,2,2,2,1.95,0,4,5,2,5,2,2,4,2,2,1,1,4,2,4,3,2,4,5,1,1,3,2,2,3,3,1,6,4,5,3,4,4,4,3,3,3,3,5,2,1,3,4,4,5,4,4,4,1,2,4,5,2,1,1,1,4,4,2,4,2,2,1,1,1,1,2,1,2,1.3639502778182058,1.3557637102737474,2.5,0,1.5,0,1.8,0,2.3333333333333335,0,2.8333333333333335,0,2.6666666666666665,0,2.2857142857142856,0,1,0,2.4864864864864864,0,2,1,6,0.058863959159771675,1.0910776747376103,0.574970816948691,5,1,3,1,2,2,1,1,1,1.4638501094227998,1.5714285714285714,0,1,-0.5612498234260587,5,5,5,5,4,4,1,5,8,5,4,1.4638501094227998,4.714285714285714,0,1.2857142857142858,2.5,3.8333333333333335,3.2559414990859232,-1.0219528370065065,0,-1.1640989613502233,1,1,3,3,1,2,5,1,1,4,1,5,2,5,5,1,5,1,5,3,1.8309508328682538,1.8,0,4.8,0,4.6,0,4.6,0,4.666666666666667,0,2,4,2,2,1,2,2,3,1,1,4,3,2,3,2,3,2,3,2,4,0.9403246919632545,2.3,0,"White, Caucasian, Anglo, European American",0,21,1,2,NA,1,3,6,student,3,0,139,66,4,5,2,0,0,1,0,0,TRUE,TRUE,TRUE,TRUE,TRUE,6,1.3234999999999948,0.7083333333333334,0.22919291489361468,6,0.44387499999999724,0.5529062499999982,1,1,0.0025310806451611994,0.006360732862903239,6,0.6250624999999964,0.71453125,1,1,0.004109415322581272,0.0037916118951618425,2.0524,0.4656,0.4902,0,64.7971,0.008,ML,change,48,-117.98059696727633,0.5578725836176486,1.59051228014646,0.7295351148970983,1.5802,5.5132,0.4096,6.3099,0.3187,0,-96.657,0.006,ML,cueing,64,205.790649250079,4.068512973855585,1.0183412841535642,0.43166808198097406,5.122547552649486,0.8088035657665332,0.3673966026514873,0.186,0.381,0.773,0.013,1.502,52.158603540256095,1843.8880421779506,0.189,0.383,0.801,0.014,1.552,62.065608898089806,1844.9031760221499,408,1.208888888888889,1,0,0,1,FALSE,FALSE,FALSE
116,2021-11-13T01:10:06Z,2021-11-13T01:35:14Z,1507,1,2021-11-13T01:35:18Z,1,Chrome,95.0.4638.69,Windows NT 10.0,2560,1080,No feedback,2.3703703703703702,626,66,468,110,68,115,-0.4193188183871753,-0.21625663176589804,0.19495468201700744,0.0660338372338302,-0.054490721565468275,0.16255238506239597,4,4,1,2,3,1,1,3,1,3,2,1,1,1,4,4,1,1,3,3,1.2396943596157715,0,1,3,3,3,1.4,0,4,4,2,4,2,1,4,2,2,1,2,4,2,4,5,2,3,1,1,2,1,1,1,1,2,0,0,5,4,5,5,5,5,4,4,4,1,5,2,1,3,3,5,4,3,3,3,3,4,1,1,1,2,1,1,2,1,1,5,2,2,1,1,1,1,1,1,1,1.578287360080854,1.3020130933435712,1.5,0,1,0,1.8,0,1.4444444444444444,0,2.3333333333333335,0,1.1666666666666667,0,1.2857142857142858,0,1,0,1.6756756756756757,0,1,0,0,-0.7193294286555646,-0.5341482934814965,-0.6267388610685305,5,1,4,1,1,1,2,1,1,1.6761634196950514,1.2857142857142858,0,1,-0.7321841937363471,5,5,5,4,2,2,1,3,4,5,3,1.7182493859684491,4,0,2,5.5,3.8333333333333335,3.2559414990859232,0.6723373927674386,0,0.081401140643933,2,2,2,1,1,2,5,1,1,3,2,5,2,3,4,1,5,3,4,5,1.533747356112131,1.6,0,4.2,0,4.2,0,3.6,0,4,0,1,2,1,4,1,1,1,3,1,1,1,3,1,1,2,3,1,1,1,2,0.9403246919632545,1.3,0,"White, Caucasian, Anglo, European American",0,20,0,1,NA,1,3,3,Student,4,0,160,68,3,5,2,0,0,1,0,0,TRUE,TRUE,TRUE,TRUE,TRUE,3,0.7945051282046315,0.78,0.05198038041231931,3,0.42882187499979046,0.4853166666665425,1,0.9375,0.0012905714415548503,0.004074016411291552,3,0.5623000000005047,0.6002718750002095,1,1,0.004169228000011489,0.004400536925421816,1.376,0.9659,0.3933,0,22.3628,0.005,ML,change,50,-32.98953098371556,1.1120645537683493,1.13812311438435,0.5079440010220811,0.9719,3.4252,0.3605,6.2848,0.3515,0,-96.7403,0.008,ML,cueing,64,205.95724925007903,3.689703629026585,0.7339478921283024,0.3982901097691135,6.062014651821748,0.6834583821314987,0.37421129207329457,0.274,0.273,0.941,0.016,0.886,35.188530086575426,1835.1943667197513,0.271,0.276,0.943,0.015,0.921,51.57829170847764,1834.401416581255,328,0.9718518518518519,1,0,0,1,FALSE,FALSE,FALSE
118,2021-11-13T01:09:46Z,2021-11-13T01:37:05Z,1639,1,2021-11-13T01:37:06Z,0.8999999761581421,Safari,14.1.2,Macintosh,1440,900,none,1.6,628,145,409,61,46,82,-0.41418008435205067,0.5014376949755007,-0.08908542690515787,-0.5311000829343039,-0.3583560335760547,-0.39486271804575546,2,2,4,4,4,1,1,2,1,1,2,1,1,2,1,1,2,1,1,2,1.0563093645728086,0,1,2,2,2,2.5,0,2,2,2,4,4,4,4,4,4,4,2,4,2,4,4,2,2,1,1,2,3,3,2,2,2,0,0,4,4,2,4,4,4,4,4,4,1,5,1,1,4,2,4,4,4,4,4,4,2,1,4,1,1,1,1,1,1,1,5,1,1,1,1,2,1,1,1,1,1.5156837721956706,0.9759000729485332,2,0,1,0,2.933333333333333,0,2.2222222222222223,0,2.5,0,1.8333333333333333,0,0.8571428571428571,0,1.3333333333333333,0,1.972972972972973,0,1,0,0,0.11035635745800056,-0.5341482934814965,-0.21189596801174798,2,4,1,3,3,4,4,3,1,1.1547005383792515,3.857142857142857,0,2,1.175212813830632,2,4,4,3,1,1,4,5,3,1,2,1.3801311186847085,2.4285714285714284,0,3.5714285714285716,5,3.8333333333333335,3.2559414990859232,0.38995568780511447,0,0.8165912597985752,4,4,4,5,4,4,4,4,4,2,4,4,2,4,4,2,4,2,5,4,0.990430401872025,4.2,0,3.2,0,3.8,0,2.8,0,3.2666666666666666,0,3,1,1,3,3,1,2,3,2,1,3,3,1,1,3,3,1,2,1,1,0.9445132413883326,1.75,0,"Hispanic of Latino (e.g., Mexican American, Central American, and others)",0,28,1,1,NA,1,2,6,Paralegal,2,0,152,62,1,5,2,1,1,3,0,2,TRUE,TRUE,TRUE,TRUE,TRUE,4,0.8241142857142807,0.7142857142857143,0.0675774396258514,4,0.4462258064516185,0.5480625000000082,1,1,0.0023791139784948715,0.005282512096774333,4,0.5738750000000027,0.6566666666666662,1,0.9375,0.005319983870967932,0.012520129032257535,1.3933,0.6709,0.3565,0,31.9164,0.004,ML,change,49,-52.15733910566812,0.7799185465723368,1.1748543946046164,0.5013183806341972,9.6286,10.0042,0.0668,12.6128,0.0645,0,-90.3873,0.014,ML,cueing,63,193.2040041791746,4.261891305004674,0.9721352399406133,0.4375768087546004,5.20245919067934,0.7963800530745768,0.3720788359383088,0.063,0.439,0.393,0.035,1.66,148.2038479868804,2038.2165666009155,0.063,0.438,0.397,0.029,1.787,186.06130262121576,2031.8586548437613,442,1.3096296296296297,1,0,0,1,FALSE,FALSE,FALSE
119,2021-11-13T01:16:49Z,2021-11-13T01:37:25Z,1235,1,2021-11-13T01:37:26Z,1,Firefox,94.0,Windows NT 10.0,1504,1003,NA,1.4995014955134596,696,47,244,46,99,66,-0.2394631271578155,-0.38886665971636103,-0.883434884060366,-0.7138961809449572,0.37368312717672175,-0.6651245862194046,3,3,2,1,2,1,2,3,1,2,2,2,2,1,2,3,2,1,2,3,0.7254762501100116,0,1,2,4,5,2,0,2,4,3,3,4,2,3,4,4,2,3,2,4,2,2,3,5,1,1,4,4,3,4,0,3,0,0,4,3,4,4,4,5,4,4,3,2,2,3,1,4,3,4,4,5,4,4,4,2,2,3,1,3,3,2,1,1,1,4,2,2,1,1,4,2,4,1,3,1.2556180058348068,0.8837151016885368,3.125,0,2.5,0,3.3333333333333335,0,2.111111111111111,0,3.1666666666666665,0,2.5,0,1.4285714285714286,0,2,0,2.4324324324324325,0,0,0,0,0.9631750067168229,-0.26683355097456624,0.34817072787112835,5,2,5,1,1,2,3,3,4,1.7043362064926932,1.5714285714285714,0,3.5,0.3612193635098966,5,5,5,5,4,3,1,6,7,NA,4,1.5275252316519468,4.571428571428571,0,1.4285714285714286,2.5,3.8333333333333335,3.2559414990859232,-1.0219528370065065,0,-1.0844279639287866,2,3,3,2,2,2,4,3,2,4,1,4,3,3,3,2,5,2,3,4,1.0690449676496976,2.4,0,4.4,0,3.6,0,3,0,3.6666666666666665,0,2,2,2,3,3,3,3,3,2,2,4,3,2,3,2,3,1,3,2,2,0.6882472016116853,2.3,0,"White, Caucasian, Anglo, European American",0,20,1,1,NA,1,4,5,Student,7,0,150,67,2,5,2,0,0,2,0,0,TRUE,TRUE,TRUE,TRUE,TRUE,6,1.1638809523809523,0.84,0.13362795469387753,6,0.4783125,0.538625,1,1,0.0032206088709677413,0.003394435483870967,6,0.59053125,0.66596875,1,1,0.005114450604838711,0.0062408054435483876,1.7339,0.9989,0.6005,0,37.0362,0.004,ML,change,50,-62.33633098371556,1.0980133365478766,1.5102075916645559,0.6962449373391986,4.9653,8.9781,0.2621,9.3059,0.2115,0,-94.5763,0.011,ML,cueing,64,201.62924925007903,4.760149632085167,0.8703790944858696,0.4500584828783697,4.823119231285777,0.8590156136959173,0.3920434969065315,0.302,0.199,0.781,0.016,1.532,55.59275453823635,1848.1312155080598,0.303,0.203,0.783,0.019,1.62,72.59798864878441,1855.2092401455764,456,1.3511111111111112,1,0,0,1,FALSE,FALSE,FALSE
120,2021-11-13T01:09:40Z,2021-11-13T01:37:34Z,1674,1,2021-11-13T01:37:35Z,1,Chrome,95.0.4638.69,Windows NT 10.0,1536,864,no,1.7777777777777777,965,75,339,75,61,92,0.45169660056643834,-0.13449398694725767,-0.4260821663043371,-0.3604903914576942,-0.15117513902338214,-0.2259490504372247,1,2,3,4,1,2,4,2,1,1,2,2,2,3,1,1,2,2,1,1,0.9679060415469871,1,1,2,3,1,3.1,0,2,3,3,3,3,3,3,3,3,3,4,3,4,2,3,3,3,3,2,2,2,3,3,7,2,0,0,4,4,4,4,4,5,5,5,5,1,5,1,1,4,4,5,5,4,4,3,4,3,1,2,1,4,5,1,5,4,1,5,1,2,1,2,1,3,2,3,3,1.6056394607999884,0.5345224838248488,2.625,0,2.75,0,3.2666666666666666,0,1.5555555555555556,0,2.5833333333333335,0,2.5,0,2,0,1.3333333333333333,0,2.1621621621621623,0,4,0,0,0.6035025404081422,0.6239375469287404,0.6137200436684414,5,1,3,1,1,2,1,1,1,1.5275252316519468,1.4285714285714286,0,1,-0.6467170085812028,3,3,3,3,1,1,3,4,1,3,2,0.9759000729485332,2.4285714285714284,0,3.5714285714285716,6.5,3.8333333333333335,3.2559414990859232,1.237100802692087,0,1.2401638172420615,1,1,1,1,1,2,5,1,1,3,3,4,3,5,5,1,3,3,5,1,1.5583874449479591,1,0,3.4,0,4.2,0,5,0,4.2,0,3,1,3,2,4,4,4,3,2,1,2,2,2,3,2,2,2,2,2,4,0.9459053029269173,2.6,0,"White, Caucasian, Anglo, European American",0,22,1,2,NA,1,2,5,student,2,0,190,62,2,5,2,0,0,0,0,0,TRUE,TRUE,TRUE,TRUE,TRUE,4,0.6154060606089505,0.66,0.026868070677941884,4,0.4510093750040978,0.5202535714230367,1,0.9032258064516129,0.00488994345809344,0.005861238581555424,4,0.6249124999959021,0.7357499999981374,1,1,0.01313320951519023,0.01425917741831791,1.1725,0.6233,0.3431,0,13.3233,0.004,ML,change,50,-14.910530983715562,0.7244395070363513,0.915596417599822,0.4131870686943908,1.2442,2.6291,0.3236,3.8341,0.2888,0,-53.9246,0.008,ML,cueing,63,120.2786041791746,2.983761883765248,0.7485825975792997,0.4190900626166133,4.344967526916046,0.9535479150824011,0.34470828794030894,0.257,0.226,0.648,0.016,1.695,17.502345762038296,1811.6076300541108,0.26,0.214,0.636,0.017,1.769,23.493493486301734,1806.417387225728,298,0.882962962962963,1,0,0,1,FALSE,FALSE,FALSE
121,2021-11-13T01:08:41Z,2021-11-13T01:38:48Z,1807,1,2021-11-13T01:38:51Z,1,Chrome,94.0.4606.81,Macintosh,1440,900,NA,1.6,735,68,621,170,78,86,-0.13925781347288652,-0.1980871551395335,0.9315332695609277,0.7972182292764435,0.08362987480298012,-0.3272972510023432,2,1,3,3,2,1,1,2,1,2,1,1,1,1,2,1,2,3,2,1,0.7451598203705946,0,1,1,3,3,2.55,0,3,4,2,4,2,1,2,2,3,1,2,4,1,3,4,2,2,1,1,1,1,1,1,0,2,0,0,5,4,4,3,2,5,4,5,5,5,4,2,2,4,3,3,3,5,2,4,3,2,1,1,1,2,1,2,1,1,1,5,1,1,1,3,2,2,1,1,1,1.4932279563850022,1.1254628677422756,1.25,0,1.25,0,2.1333333333333333,0,1.8888888888888888,0,3,0,1.5,0,1,0,2,0,2.081081081081081,0,0,0,0,-0.5092946461233157,-0.6588395645607719,-0.5840671053420438,4,2,3,1,1,2,2,3,1,1.0690449676496976,1.8571428571428572,0,2,-0.021327778341387937,5,4,4,4,2,2,2,4,7,4,3,1.2535663410560174,3.5714285714285716,0,2.4285714285714284,3.5,3.8333333333333335,3.2559414990859232,-0.4571894270818581,0,-0.24434927701640521,1,2,1,2,1,1,4,1,1,4,2,5,2,4,5,1,4,1,3,2,1.5430334996209192,1.4,0,4.6,0,4,0,4.6,0,4.4,0,2,4,1,3,2,2,1,4,1,1,1,4,4,2,2,4,1,2,1,1,1.2258187382102494,1.65,0,Black or African American,0,23,1,2,NA,1,3,6,Account Management,5,0,200,64,2,5,2,0,0,0,0,0,TRUE,TRUE,TRUE,TRUE,TRUE,2,0.9075682926832176,0.82,0.029051874860606782,2,0.5484031250048429,0.6258600000023842,1,0.9375,0.015251782894425822,0.026975135485103444,2,0.7225968750026077,0.9010612903275798,1,0.96875,0.019513166117059506,0.054803381253901565,1.3797,1.2092,0.5591,0,13.8501,0.004,ML,change,50,-15.964130983715561,1.4968744056397878,1.0130091633973641,0.6910084189451106,1.4173,2.3035,0.3523,3.2603,0.331,0,-35.522,0.006,ML,cueing,64,83.520649250079,2.3001505805044205,1.1773360509764268,0.401924868681882,3.2695075209541598,1.267204525402779,0.3606677587277708,0.089,0.452,0.303,0.006,1.275,22.498057398498464,1854.0810314534197,0.088,0.462,0.303,0.008,1.362,28.378939646668794,1853.0532483885904,104,0.3081481481481481,1,0,0,1,FALSE,FALSE,FALSE
122,2021-11-13T01:17:20Z,2021-11-13T01:39:29Z,1329,1,2021-11-13T01:39:30Z,1,Chrome,95.0.4638.69,Macintosh,1440,900,NA,1.6,620,68,270,171,89,75,-0.434735020492549,-0.1980871551395335,-0.7582646665692423,0.8094046358104869,0.23556253080827336,-0.513102285371727,3,3,1,2,3,1,1,3,1,3,3,1,1,1,3,4,1,1,2,2,1.025978352085154,0,1,2,4,3,1.6,0,5,5,1,5,1,1,5,1,1,1,1,5,1,5,5,1,1,1,1,1,1,1,1,0,2,0,0,5,5,5,5,5,5,5,5,5,1,5,1,1,5,1,5,1,1,1,1,1,5,1,1,1,1,1,1,1,1,1,5,1,1,1,1,1,1,1,1,1,1.9666895707934864,2.065591117977289,1,0,1,0,1,0,1,0,1,0,0.8333333333333334,0,0.8571428571428571,0,1,0,1,0,0,0,0,-1.568373259242148,-0.7372407672780129,-1.1528070132600805,5,1,5,1,1,1,1,1,1,1.9518001458970664,1,0,1,-0.9031185640466358,5,5,5,5,5,5,1,4,6,4,3,1.5118578920369088,5,0,1,4,3.8333333333333335,3.2559414990859232,-0.1748077221195339,0,-0.8998683987496106,1,1,1,1,1,1,5,2,1,1,1,4,1,3,4,1,4,1,4,3,1.5023790657297036,1,0,4.6,0,4,0,3.8,0,4.133333333333334,0,1,2,2,3,4,1,2,4,1,1,1,4,2,1,1,4,2,2,1,3,1.1652874052533586,1.6,0,"White, Caucasian, Anglo, European American",0,20,1,2,NA,1,3,4,Full time student,5,0,120,67,2,5,2,0,1,2,0,1,TRUE,TRUE,TRUE,TRUE,TRUE,3,1.0880162790715695,0.8775510204081632,0.07076196093425587,3,0.46643225806374705,0.5150933333337306,1,0.9375,0.0041754389245313595,0.002691952096944322,3,0.7378250000020489,0.7389419354834864,1,0.96875,0.027193083225284173,0.012482081128477204,1.7981,1.2144,0.5348,0,28.926,0.004,ML,change,49,-46.17653910566812,1.4659301484583196,1.3434750956835948,0.742003616870893,1.0943,4.2164,0.3986,3.8823,0.3255,0,-77.4267,0.008,ML,cueing,63,167.2828041791746,4.092421381759056,0.6617232069924827,0.444351863662596,4.519984655721102,0.9166258387951434,0.36820390675630993,0.068,0.513,0.357,0.023,1.636,109.05910536424271,1955.1847616433913,0.069,0.511,0.353,0.025,1.645,126.82447743468016,1953.597491148923,422,1.2503703703703704,1,0,0,1,FALSE,FALSE,FALSE
123,2021-11-13T01:04:40Z,2021-11-13T01:39:45Z,2105,1,2021-11-13T01:39:46Z,1,Chrome,95.0.4638.69,Windows NT 10.0,1920,1080,My dad was/is a narcissist and abusive to our family. Mom was/is wonderful.  Good luck on your study!,1.7777777777777777,1026,77,393,124,65,110,0.6084279886377375,-0.11632451032089314,-0.1661132530535417,0.23664352871043995,-0.09592690047600279,0.07809555125813061,2,2,2,2,2,1,4,1,1,2,1,3,3,2,2,2,3,1,2,2,0.7947194142390263,0,1,1,2,3,2.7,0,3,4,3,3,4,3,2,3,2,3,2,3,2,2,2,4,5,4,1,2,2,3,2,5,2,0,0,4,2,4,2,3,5,4,4,4,2,5,5,1,4,1,4,3,4,5,5,5,2,1,1,1,3,1,1,4,3,1,3,3,1,2,3,3,2,2,3,1,1.4326732190393427,0.7037315505489968,2.875,0,2,0,3,0,2.4444444444444446,0,3,0,1.6666666666666667,0,2.142857142857143,0,2.6666666666666665,0,2.5135135135135136,0,3,0,0,0.7473328108426686,0.1856414649805007,0.46648713791158464,5,2,3,2,1,1,1,4,1,1.4638501094227998,1.5714285714285714,0,2.5,-0.007768311264485517,3,3,3,3,1,1,3,6,6,2,3,0.9759000729485332,2.4285714285714284,0,3.5714285714285716,3,3.8333333333333335,3.2559414990859232,-0.7395711320441822,0,0.25182784987392687,2,2,2,5,3,2,2,2,1,2,1,4,3,3,5,4,4,3,3,3,1.1464230084422218,2.8,0,4,0,2.4,0,4,0,3.466666666666667,0,3,1,4,2,3,4,4,1,4,2,3,2,3,3,2,2,2,4,2,4,1.019545822516343,3.05,0,"White, Caucasian, Anglo, European American",0,29,1,3,NA,1,2,6,artist,2,0,195,68,1,5,2,0,1,0,0,1,TRUE,TRUE,TRUE,TRUE,TRUE,6,0.8229190476190332,0.84,0.056290972346935496,6,0.44769999999997673,0.4697928571428638,0.967741935483871,0.9032258064516129,0.0024327874623629037,0.006673919698921166,6,0.5708687500000306,0.6307366666667008,1,0.9375,0.007286731250001905,0.003705720796373577,1.4104,1.2828,0.4535,0,13.3048,0.004,ML,change,50,-14.873530983715563,1.3629259412926904,1.2166677780237696,0.5194050913612691,0.9507,2.4778,0.3072,4.2896,0.3419,0,-66.4232,0.007,ML,cueing,62,145.22780315513526,2.888459399511505,0.7732815015107493,0.3618435963315404,4.741639674965554,0.7173040582605773,0.3769411040187727,0.065,0.428,0.507,0.015,1.583,95.75739474861096,1953.4039581466634,0.065,0.428,0.517,0.015,1.657,108.2249413925408,1953.151766150767,316,0.9362962962962963,1,0,0,1,FALSE,FALSE,FALSE
124,2021-11-13T01:02:41Z,2021-11-13T01:40:13Z,2252,1,2021-11-13T01:40:14Z,1,Chrome,95.0.4638.69,Windows NT 10.0,1280,720,NA,1.7777777777777777,676,52,939,72,105,336,-0.29085046750906113,-0.3434429681504497,2.462461314260056,-0.39704961105982484,0.4565554849977908,3.8955444392109255,4,4,1,1,4,2,3,3,1,4,2,1,1,1,4,4,1,2,3,3,1.2763022245616642,0,1,1,3,2,1.45,0,3,4,1,4,3,2,1,3,1,2,1,4,1,4,3,3,3,5,1,1,1,1,1,7,3,0,5,3,4,3,1,1,5,5,5,5,1,3,1,3,3,3,4,2,4,3,5,5,2,4,1,1,5,3,4,5,5,1,4,3,2,1,2,1,5,5,5,5,1.5082356496167217,1.245945806357946,2,0,5,0,2.2,0,2.4444444444444446,0,2.9166666666666665,0,2.8333333333333335,0,3,0,1.3333333333333333,0,2.72972972972973,0,4,0,5,0.12042254058397016,2.211796605879814,1.166109573231892,4,1,2,1,1,1,1,1,1,1.1338934190276817,1.5714285714285714,0,1,-0.5612498234260587,3,3,4,4,2,2,3,4,3,5,4,0.816496580927726,3,0,3,5.5,3.8333333333333335,3.2559414990859232,0.6723373927674386,0,0.6390981225939902,2,3,3,2,1,2,5,2,3,5,2,4,1,3,4,1,3,2,5,1,1.4573295865416045,2.2,0,3.8,0,5,0,3.8,0,4.2,0,2,2,1,3,1,1,4,3,1,2,2,4,1,1,2,4,2,2,3,1,1.0711528467275955,1.7,0,"White, Caucasian, Anglo, European American",0,21,1,2,NA,1,2,6,Actuary,4,0,156,62,3,5,2,0,1,3,0,1,TRUE,TRUE,TRUE,TRUE,TRUE,1,1.0632261904705138,0.84,0.33394923551327743,1,0.4938687500059605,0.5983387096697285,1,0.96875,0.003307913182982244,0.011498738059272536,1,0.65224062500149,0.7955499999895692,1,1,0.003946805715123329,0.007421165159963945,1.7181,0.9532,0.4743,0,40.367,0.004,ML,change,50,-68.99793098371556,0.873296726041384,1.898814030965406,0.32396225957877667,2.1659,3.6854,0.3211,5.2702,0.2884,0,-58.036,0.007,ML,cueing,64,128.54864925007902,3.230712199504168,1.062919564612464,0.4441177468775118,4.790975705966369,0.8647789053139932,0.4064382748858669,0.116,0.473,0.661,0.011,1.734,49.76478751544059,1844.0141969519989,0.119,0.474,0.682,0.013,1.791,56.039128841942585,1837.5807458443496,104,0.3081481481481481,1,1,0,1,FALSE,FALSE,FALSE
125,2021-11-13T01:11:57Z,2021-11-13T01:41:31Z,1773,1,2021-11-13T01:41:32Z,1,Chrome,94.0.4606.71,Macintosh,1280,800,NA,1.6,863,77,465,112,58,113,0.1896211647750856,-0.11632451032089314,0.18051196461418548,0.09040665030191732,-0.19261131793391667,0.12876965154068984,4,4,1,1,4,1,1,3,1,4,3,1,1,1,4,4,1,1,3,4,1.4244112357114616,0,1,2,4,3,1.15,0,4,5,2,5,2,1,4,2,1,1,3,4,3,4,5,2,4,1,1,1,3,2,1,0,2,0,0,5,5,5,5,5,5,5,5,5,2,5,2,1,5,1,5,3,3,3,3,4,3,1,1,1,3,1,1,1,1,1,4,2,1,1,1,1,1,2,1,1,1.7346495349231237,1.486446705914413,1.875,0,1.25,0,1.7333333333333334,0,1,0,2.0833333333333335,0,1.5,0,1.1428571428571428,0,1,0,1.5135135135135136,0,0,0,0,-0.6565125743406198,-0.6588395645607719,-0.6576760694506958,5,2,4,2,1,1,2,1,3,1.5118578920369088,1.5714285714285714,0,2,-0.19226214865167657,5,5,5,5,3,3,1,6,6,6,4,1.5735915849388864,4.428571428571429,0,1.5714285714285714,3,3.8333333333333335,3.2559414990859232,-0.7395711320441822,0,-0.8635661140261877,2,3,3,2,2,3,4,3,2,2,1,4,2,4,4,2,4,1,4,3,1.1254628677422756,2.4,0,4.2,0,3.6,0,3.6,0,3.8,0,1,1,1,4,2,2,1,4,1,1,2,4,2,1,1,4,1,1,1,1,1.1964860832322377,1.2,0,"White, Caucasian, Anglo, European American",0,23,1,2,NA,1,3,6,Clinical Lab Assistant,2,0,150,69,3,5,2,0,0,2,0,0,TRUE,TRUE,TRUE,TRUE,TRUE,3,0.7717184210576509,0.76,0.04075718171782819,3,0.41561875003576276,0.4985699999888738,1,0.9375,0.0015135699591259809,0.007214683184410372,3,0.6394687500223517,0.7216343750581146,1,1,0.005274575767736031,0.007153998463449968,1.2277,0.9992,0.4869,0,12.3115,0.004,ML,change,50,-12.886930983715564,1.0891234831893395,1.05835520740305,0.519063549344674,1.2729,2.8875,0.303,7.1338,0.3264,0,-83.7894,0.007,ML,cueing,64,180.05544925007902,3.198474264849358,0.8466693732268482,0.38275920392977464,5.825213797619444,0.7112416591618805,0.3564779715810177,0.095,0.463,0.53,0.008,0.995,55.32305108350011,1852.1826820999133,0.095,0.462,0.543,0.007,1.047,75.86926736733787,1861.1880060822145,104,0.3081481481481481,1,1,0,1,FALSE,FALSE,FALSE
126,2021-11-13T01:17:49Z,2021-11-13T01:42:12Z,1463,1,2021-11-13T01:42:14Z,0.8999999761581421,Chrome,95.0.4638.69,Windows NT 10.0,1920,1080,NA,1.7777777777777777,656,63,466,88,49,85,-0.3422378078603068,-0.24351084670544482,0.18532620374845948,-0.202067106515128,-0.31691985466552025,-0.34418861776319626,2,3,4,4,2,2,2,2,1,2,1,2,3,3,2,2,3,1,2,2,0.8506963092234007,0,1,1,3,2,2.75,0,5,5,3,4,1,2,1,1,1,1,1,4,2,4,4,1,1,1,1,1,1,1,1,1,2,0,0,5,3,1,5,5,5,5,5,5,1,5,2,1,4,1,5,3,1,1,1,2,5,1,1,1,2,3,1,2,2,1,5,2,1,1,1,1,2,1,2,2,1.7394037844978736,1.5946338585572373,1,0,1.75,0,1.8,0,1.6666666666666667,0,1.4166666666666667,0,1.3333333333333333,0,1.2857142857142858,0,1,0,1.4594594594594594,0,1,0,0,-1.0271223357765558,-0.2989446853297732,-0.6630335105531645,5,1,4,1,1,1,1,1,1,1.7320508075688772,1.1428571428571428,0,1,-0.8176513788914915,5,5,5,5,3,3,1,6,5,4,3,1.5735915849388864,4.428571428571429,0,1.5714285714285714,3.5,3.8333333333333335,3.2559414990859232,-0.4571894270818581,0,-0.7223752615450256,3,2,3,2,2,2,5,4,1,2,2,4,1,3,4,4,4,3,3,2,1.2227992865708155,2.4,0,3.8,0,3.4,0,3.6,0,3.6,0,3,1,2,3,4,2,4,2,1,1,1,3,3,3,1,1,2,3,1,4,1.118033988749895,2.35,0,"White, Caucasian, Anglo, European American",0,22,1,2,NA,1,3,6,lab technician,2,0,162,66,1,5,2,0,1,1,0,1,TRUE,TRUE,TRUE,TRUE,TRUE,6,0.8815081081084303,0.74,0.10898544367344591,6,0.47759333333174386,0.5299500000001862,1,1,0.0011451937472487064,0.0054588361283562465,6,0.5764062500009314,0.6820354838707755,1,1,0.0022950328629937748,0.008099651032522644,1.3494,0.7706,0.5105,0,28.6332,0.004,ML,change,50,-45.53033098371556,0.7809465115210088,1.3393600454729084,0.46989680545028323,9.9807,9.4167,0,16.3409,0.1722,0,-96.4634,0.01,ML,cueing,62,205.30820315513526,4.227050925806388,0.9801478144248175,0.41763550321624887,6.2458672911500335,0.6633401789151158,0.4261504537148047,0.121,0.401,0.672,0.013,1.426,8.129140151282458,1796.164699606697,0.123,0.403,0.691,0.013,1.498,17.811947734530865,1798.6889547529204,396,1.1733333333333333,1,0,0,1,FALSE,FALSE,FALSE
127,2021-11-13T01:11:06Z,2021-11-13T01:42:22Z,1876,1,2021-11-13T01:42:23Z,1,Chrome,95.0.4638.69,Windows NT 10.0,1536,864,NA,1.7777777777777777,814,76,595,158,61,103,0.06372218091453376,-0.1254092486340754,0.806363052069804,0.6509813508679207,-0.15117513902338214,-0.040144016067840904,3,3,1,1,3,1,2,3,1,4,2,1,1,2,3,3,1,1,3,3,1.0208355710680808,0,1,1,3,3,1.6,0,4,4,3,4,2,2,4,2,2,2,1,4,1,4,3,2,2,1,1,1,1,2,3,4,4,0,0,5,4,5,3,1,3,3,2,2,2,4,1,1,2,1,5,2,2,1,3,1,5,1,1,1,1,1,1,5,3,1,3,2,3,2,3,1,2,2,2,1,1.3987338762096442,1.1464230084422218,1.625,0,1.75,0,2,0,2.888888888888889,0,1.75,0,0.8333333333333334,0,2.4285714285714284,0,2,0,2.081081081081081,0,2,0,0,-0.40543873752557247,-0.0958522115332568,-0.25064547452941466,3,2,3,1,2,2,2,1,1,0.6900655593423543,2.142857142857143,0,1,-0.21938108280548152,4,3,3,3,1,1,2,1,1,2,2,1.1338934190276817,2.7142857142857144,0,3.2857142857142856,8,3.8333333333333335,3.2559414990859232,2.0842459175790595,0,1.5043943798426742,1,1,2,3,2,2,4,2,1,1,3,3,3,4,5,1,4,2,4,3,1.2649110640673518,1.8,0,3.6,0,3.4,0,4.2,0,3.7333333333333334,0,2,2,2,2,3,3,3,2,3,1,3,3,2,1,2,3,2,3,1,3,0.7326950970650465,2.3,0,"Hispanic of Latino (e.g., Mexican American, Central American, and others)",0,24,1,2,NA,1,2,6,Unemployed,2,0,97,58,1,5,2,0,0,1,0,0,TRUE,TRUE,TRUE,TRUE,TRUE,NA,NA,NA,NA,3,0.5402812499995343,0.5855935483848856,1,0.96875,0.007850403507915238,0.005326355121117399,3,0.7294718750002794,0.8157656249976717,1,1,0.006746998215658644,0.021228156522241914,NA,NA,NA,NA,NA,NA,NA,NA,NA,NA,NA,NA,NA,1.5001,4.2222,0.4194,3.9229,0.3491,0,-65.8104,0.005,ML,cueing,64,144.09744925007902,3.9160956173227066,0.876890541000845,0.48063123866090574,3.860019506640708,1.0733455411983692,0.40559235901762847,0.241,0.307,0.538,0.046,1.247,150.37720891542122,1950.1735269335043,0.244,0.305,0.56,0.019,1.356,174.17638096705474,1962.046534444011,104,0.3081481481481481,1,1,5,6,FALSE,FALSE,FALSE
128,2021-11-13T01:19:06Z,2021-11-13T01:42:29Z,1402,1,2021-11-13T01:42:30Z,1,Chrome,95.0.4638.69,Windows NT 10.0,1366,768,NA,1.7786458333333333,624,66,352,66,79,91,-0.4244575524222998,-0.21625663176589804,-0.36349705755877526,-0.47016805026408615,0.09744193443982496,-0.2428404171980778,2,2,4,4,2,2,2,1,1,1,2,3,3,4,2,2,3,4,2,1,1.0399898784932577,0,1,2,2,3,3.15,0,3,2,4,2,5,3,2,4,5,3,2,3,1,3,3,3,5,1,1,2,3,4,4,2,2,0,0,5,3,5,4,5,4,3,4,2,3,4,5,1,2,3,3,5,4,5,4,5,3,1,1,1,3,1,1,3,3,3,2,5,4,1,4,3,2,2,2,2,1.3911992795553898,1.1338934190276817,2.875,0,2,0,3.4,0,2.111111111111111,0,3.6666666666666665,0,1.5,0,3.142857142857143,0,2.6666666666666665,0,2.810810810810811,0,1,0,0,1.046995339284992,-0.22054348261253207,0.41322592833622995,5,1,3,1,1,2,1,4,3,1.5275252316519468,1.4285714285714286,0,3.5,0.27575217835475235,2,3,4,2,1,1,5,5,6,2,2,1.5118578920369088,2,0,4,3.5,3.8333333333333335,3.2559414990859232,-0.4571894270818581,0,0.6320316946193991,2,2,2,3,3,2,5,1,1,2,1,5,1,4,5,3,3,2,3,3,1.486446705914413,2.4,0,4.2,0,3.6,0,4.4,0,4.066666666666666,0,1,1,2,3,4,2,2,3,1,3,3,3,1,4,1,3,1,2,2,3,1.019545822516343,2.05,0,"White, Caucasian, Anglo, European American",0,21,1,2,NA,1,2,5,Waitress,1,0,115,64,2,5,2,0,0,1,0,0,TRUE,TRUE,TRUE,TRUE,TRUE,4,0.8102488371937774,0.86,0.015462355617607858,4,0.4374125000536442,0.4924034483021703,1,0.90625,0.0020680366139170427,0.006341246123387835,4,0.5677531250715255,0.6189137931034483,1,0.90625,0.005830396768437816,0.00954001119540626,1.1015,1.6772,0.5836,0,-9.8385,0.005,ML,change,50,31.41306901628444,2.0186449950102903,0.8992616191184202,0.6498768135428427,1.2154,2.8875,0.3128,4.529,0.3032,0,-66.9589,0.008,ML,cueing,64,146.39444925007902,2.9563072036619515,0.7674045303912144,0.3869482066800348,5.387942328605983,0.7689641933237771,0.36828276398284765,0.058,0.403,0.346,0.019,1.544,149.94401118079384,2036.5350452261162,0.061,0.4,0.353,0.019,1.585,186.34045024947994,2052.1230004320228,324,0.96,1,0,0,1,FALSE,FALSE,FALSE
129,2021-11-13T00:57:02Z,2021-11-13T01:43:00Z,2758,1,2021-11-13T01:43:01Z,1,Edge,95.0.1020.40,Windows NT 10.0,1366,768,NA,1.7786458333333333,1068,130,720,168,121,204,0.7163414033753533,0.3651666202777668,1.4081429438540527,0.7728454162083563,0.6775484391873082,1.6658840267783195,2,1,3,3,2,1,1,2,1,2,2,1,3,2,1,2,1,1,2,1,0.7326950970650465,0,1,4,3,1,2.5,0,5,4,3,4,4,4,4,2,2,3,1,3,2,3,2,3,2,1,1,2,1,4,3,0,2,0,0,4,4,4,5,5,5,4,4,4,2,4,2,1,4,2,5,2,2,2,3,3,4,1,1,1,1,1,1,1,1,1,4,2,2,1,2,1,2,2,3,3,1.4617238578598342,1.0997835284835873,2.125,0,2.5,0,2.533333333333333,0,1.6666666666666667,0,2,0,1,0,1.2857142857142858,0,1.3333333333333333,0,1.6216216216216217,0,0,0,0,-0.15881725093931895,-0.26683355097456624,-0.21282540095694258,4,2,4,1,1,1,3,1,1,1.3801311186847085,1.7142857142857142,0,1,-0.4757826382709144,4,4,4,4,3,3,2,3,4,NA,4,0.7867957924694432,3.7142857142857144,0,2.2857142857142856,5.5,3.8333333333333335,3.2559414990859232,0.6723373927674386,0,0.24074313548680643,3,3,3,3,4,2,5,2,2,1,2,4,4,3,4,2,3,2,4,2,1.1464230084422218,3.2,0,3.8,0,3.2,0,3.8,0,3.6,0,3,1,3,2,4,3,4,1,1,1,3,2,3,4,2,2,2,3,3,3,1,2.8,0,"Hispanic of Latino (e.g., Mexican American, Central American, and others) & White, Caucasian, Anglo, European American",1,19,1,2,NA,1,3,3,n/a,6,0,260,67,2,5,2,0,0,0,0,0,TRUE,TRUE,TRUE,TRUE,TRUE,4,1.0617880952273095,0.84,0.13354148019133322,4,0.503966666650772,0.6105031249970198,1,1,0.00972373816186949,0.015755524829769923,4,0.6414781249836087,0.7188612903279643,1,0.96875,0.026740332080950144,0.05489218673486908,1.7354,1.0304,0.4717,0,34.8322,0.004,ML,change,50,-57.92833098371556,1.098191047452467,1.5099632076315077,0.5943034150474399,1.5635,4.0237,0.4162,4.6388,0.3354,0,-67.4714,0.008,ML,cueing,62,147.32420315513528,3.2430547137970387,1.2775408039726412,0.41969264489884917,3.6589306694723853,1.1323348542673997,0.3540663967134733,0.079,0.37,0.254,0.097,1.656,73.30577380920563,1927.1969101889135,0.081,0.365,0.263,0.039,1.806,90.14927323754986,1915.8533496921184,338,1.0014814814814814,1,0,0,1,FALSE,FALSE,FALSE
130,2021-11-13T01:10:03Z,2021-11-13T01:43:07Z,1983,1,2021-11-13T01:43:08Z,NA,Chrome,95.0.4638.69,Windows NT 10.0,1280,720,N/A,1.7777777777777777,883,79,508,98,84,152,0.2410085051263312,-0.09815503369452862,0.387524247387967,-0.08020304117469244,0.16650223262404917,0.7875329552139597,2,3,3,3,2,1,2,2,1,2,2,1,3,2,2,2,2,1,2,2,0.6488856845230502,0,1,2,3,3,2.4,0,4,4,3,3,4,2,3,3,2,3,2,3,2,3,3,2,3,1,1,1,2,2,2,4,2,0,0,4,3,3,4,2,4,2,2,2,2,4,3,2,3,3,3,3,2,3,2,3,4,1,1,1,3,3,3,4,2,1,4,2,2,2,3,1,2,2,2,2,0.9562501840075193,0.7037315505489968,1.75,0,2,0,2.6666666666666665,0,3.111111111111111,0,2.5833333333333335,0,1.6666666666666667,0,2.142857142857143,0,2,0,2.4864864864864864,0,2,0,0,0.10900129434488952,-0.01745100881601569,0.045775142764436914,3,3,2,2,2,3,3,1,1,0.5345224838248488,2.857142857142857,0,1,0.20795484297024003,1,3,4,3,1,1,4,6,3,2,2,1.3972762620115438,2.142857142857143,0,3.857142857142857,4.5,3.8333333333333335,3.2559414990859232,0.10757398284279028,0,0.8347424021602866,2,2,3,3,3,3,5,3,2,4,1,4,2,4,4,2,3,2,3,3,1.0690449676496976,2.6,0,3.8,0,4,0,3.6,0,3.8,0,2,1,2,2,2,2,3,1,2,2,1,2,2,3,1,2,1,3,2,3,0.6863327411532597,2.25,0,"Asian or Asian American (e.g., Chinese, Japanese, and others)",0,25,1,2,NA,1,3,6,Account Manager,4,0,120,64,1,5,2,0,0,3,0,0,TRUE,TRUE,TRUE,TRUE,TRUE,4,1.1225285714297069,0.84,0.18788050681119772,4,0.5303129032249412,0.5762374999998138,1,1,0.007684635161259829,0.00791157661296242,4,0.6309000000013039,0.7038687500003725,1,1,0.0046819987097615964,0.005084182217834904,1.5588,1.0387,0.6285,0,31.2726,0.004,ML,change,50,-50.80913098371556,1.0083504922683404,1.6444957277436898,0.5680303570488482,1.1003,4.2987,0.4483,5.0941,0.4223,0,-90.1069,0.008,ML,cueing,63,192.64320417917457,3.852536258958204,1.075430430215318,0.4410248557516819,3.880669711336168,1.0676339484106712,0.3970536381422238,0.231,0.332,0.751,0.009,1.025,28.4382508723838,1833.5990850606875,0.233,0.332,0.761,0.01,1.083,35.650403512323464,1820.3737113095635,409,1.211851851851852,1,0,0,1,FALSE,FALSE,FALSE
131,2021-11-13T01:23:24Z,2021-11-13T01:43:11Z,1186,1,2021-11-13T01:43:12Z,1,Chrome,95.0.4638.69,Macintosh,1440,900,N/A,1.6,599,59,281,65,49,78,-0.4886917278613569,-0.2798497999581739,-0.7053080360922285,-0.4823544567981297,-0.31691985466552025,-0.4624281850891678,2,3,2,1,3,1,2,2,1,3,3,2,1,1,3,3,2,1,2,2,0.7947194142390263,0,1,1,4,2,1.9,0,5,5,2,4,2,1,4,3,2,1,1,4,1,4,5,1,1,1,1,1,3,3,3,1,2,0,0,5,4,4,5,5,4,5,5,5,1,4,3,1,5,1,5,1,2,2,3,3,5,1,4,1,2,1,1,2,2,1,5,1,1,1,1,1,2,1,1,2,1.7018802532482702,1.5796322658258457,1.75,0,1.5,0,1.6,0,1.3333333333333333,0,1.75,0,1.5,0,1.1428571428571428,0,1,0,1.4864864864864864,0,1,0,0,-0.779145786077191,-0.3773458880470143,-0.5782458370621026,5,1,5,1,1,1,1,1,1,1.9518001458970664,1,0,1,-0.9031185640466358,5,5,5,5,3,2,1,7,8,6,4,1.7043362064926932,4.285714285714286,0,1.7142857142857142,1.5,3.8333333333333335,3.2559414990859232,-1.5867162469311549,0,-1.2074676740482373,2,3,2,2,2,1,5,2,2,3,1,4,1,5,5,1,4,1,4,3,1.61245154965971,2.2,0,4.6,0,4.4,0,4.2,0,4.4,0,1,2,1,4,2,1,2,4,1,2,2,3,1,2,1,3,1,2,2,2,0.9445132413883326,1.55,0,"White, Caucasian, Anglo, European American",0,22,1,2,NA,1,4,6,News Reporter,2,0,135,63,3,5,2,0,0,1,0,0,TRUE,TRUE,TRUE,TRUE,TRUE,3,0.7540449999991804,0.8,0.016082268852969497,3,0.46019687499967404,0.5025741935482909,1,0.96875,9.49164828636135e-4,0.0023237295867105223,3,0.5864499999999534,0.6647399999993543,1,0.9375,0.006579915483808292,0.006743255312561892,1.0488,1.3904,0.5472,0,-7.4816,0.005,ML,change,50,26.69926901628444,1.6112720284623248,0.8603726351799605,0.5938536815907609,1.0654,5.282,0.4099,6.4546,0.3777,0,-111.5742,0.01,ML,cueing,64,235.62504925007903,4.818528365724108,0.7126630671954344,0.4332458037593769,6.546016340848075,0.6329245927080538,0.41336337602413603,0.064,0.433,0.399,0.014,1.523,47.63070723950753,1932.3894999550853,0.066,0.429,0.407,0.015,1.574,66.99141422161456,1934.5567234531536,412,1.2207407407407407,1,0,0,1,FALSE,FALSE,FALSE
132,2021-11-13T01:05:20Z,2021-11-13T01:43:18Z,2277,1,2021-11-13T01:43:19Z,1,Chrome,95.0.4638.69,Windows NT 10.0,1536,864,NA,1.7777777777777777,712,55,427,859,64,93,-0.198353254876819,-0.31618875321090295,-0.0024291224882260847,9.193652331232453,-0.10973896011284763,-0.20905768367637165,2,2,3,3,1,2,3,1,2,1,1,3,1,1,2,1,2,3,1,2,0.812727700887249,0,1,1,2,2,2.95,0,1,5,4,2,2,3,2,4,3,2,5,2,2,3,3,4,5,3,2,4,5,5,5,4,2,0,2,4,3,3,4,3,4,3,5,3,2,4,5,2,3,3,4,1,5,5,5,5,2,2,2,1,2,1,2,3,3,1,5,2,1,1,1,3,2,3,2,2,1.3819949022734888,1.1872336794093274,4.125,0,2.25,0,3.2666666666666666,0,2.4444444444444446,0,3.3333333333333335,0,1.8333333333333333,0,1.7142857142857142,0,1.6666666666666667,0,2.4864864864864864,0,2,0,2,1.3875033415653846,0.41384948769958696,0.9006764146324857,5,2,5,2,1,2,1,3,1,1.7182493859684491,1.4285714285714286,0,2,-0.2777293338068208,5,5,5,5,4,4,1,7,7,6,5,1.4638501094227998,4.714285714285714,0,1.2857142857142858,2,3.8333333333333335,3.2559414990859232,-1.3043345419688306,0,-1.3052898138313853,4,4,5,5,5,5,4,4,4,2,2,5,4,2,3,4,2,3,3,4,1.0555973258234952,4.6,0,3,0,2.6,0,2.2,0,2.6,0,3,2,4,2,4,4,4,2,4,3,4,2,3,4,2,2,3,3,4,4,0.8750939799154206,3.35,0,"White, Caucasian, Anglo, European American",0,23,1,2,NA,1,5,6,research assistant,6,0,125,63,3,5,2,0,0,1,0,0,TRUE,TRUE,TRUE,TRUE,TRUE,4,0.9979216216230714,0.74,0.12763910019889385,4,0.4416124999993481,0.5532967741941252,1,0.96875,0.002215337257961956,0.005811617893067038,4,0.6269968750001863,0.6671925925949106,1,0.84375,0.010868273860214276,0.010118938992167793,1.5049,0.7161,0.5329,0,36.9335,0.004,ML,change,50,-62.130930983715565,0.7507018392461968,1.3933208905322216,0.5524757784857858,1.8076,3.9888,0.3366,5.8459,0.287,0,-73.151,0.009,ML,cueing,64,158.778649250079,3.8316563696949486,0.896214814993584,0.4436573248293878,5.2960555465538075,0.7823057537769801,0.3700631466825579,0.051,0.492,0.417,0.022,1.838,54.87950009997663,1914.5555935437856,0.05,0.493,0.42,0.023,1.946,62.514151514989294,1924.5080704813906,104,0.3081481481481481,1,1,1,2,FALSE,FALSE,FALSE
133,2021-11-13T01:18:27Z,2021-11-13T01:44:25Z,1558,1,2021-11-13T01:44:26Z,1,Chrome,95.0.4638.69,Windows NT 10.0,1536,864,None,1.7777777777777777,657,72,461,100,112,87,-0.3396684408427445,-0.16174820188680444,0.16125500807708953,-0.05583022810660534,0.5532399024557046,-0.31040588424149007,1,2,3,3,1,1,3,2,2,1,1,3,3,2,1,2,4,2,1,1,0.9445132413883326,0,1,1,3,2,3.15,0,1,4,3,3,2,1,2,3,3,1,4,2,1,1,2,5,5,1,1,4,5,4,5,0,2,3,4,4,2,4,3,2,4,4,4,3,3,3,4,2,2,5,4,5,5,5,4,4,2,1,1,1,3,2,3,1,1,1,3,3,1,1,1,3,2,4,1,1,1.3506755066722445,1.082325538564332,3.75,0,2,0,3,0,2.6666666666666665,0,3.8333333333333335,0,1.8333333333333333,0,1.7142857142857142,0,1.6666666666666667,0,2.7027027027027026,0,0,3,4,1.2046666115177265,0.9020622539667457,1.053364432742236,4,1,4,1,1,1,1,1,1,1.4638501094227998,1.2857142857142858,0,1,-0.7321841937363471,2,1,2,3,3,3,1,6,3,5,4,0.8997354108424374,2.7142857142857144,0,3.2857142857142856,4.5,3.8333333333333335,3.2559414990859232,0.10757398284279028,0,0.5160584124745394,2,2,2,3,2,4,4,2,2,3,2,3,2,3,4,2,3,1,4,3,0.9411239481143202,2.2,0,3.4,0,3.8,0,3.6,0,3.6,0,3,3,3,2,2,3,1,2,2,3,2,2,2,3,2,1,1,3,3,2,0.7163503994113789,2.55,0,"White, Caucasian, Anglo, European American",0,21,1,2,NA,1,4,3,Student,4,0,250,68,1,5,2,0,1,2,0,1,TRUE,TRUE,TRUE,TRUE,TRUE,6,0.6915390243902803,0.82,0.026789197636824948,6,0.41517931034493033,0.4777548387098697,0.9354838709677419,0.96875,0.002305113957000395,0.003280991249911918,6,0.5150124999994877,0.6113919999998808,1,0.78125,0.0057007333869603105,0.009652127378937437,1.1628,1.3472,0.4102,0,1.3463,0.004,ML,change,50,9.043469016284437,1.5275272879784139,0.9926811136545249,0.48358335716953404,1.0311,3.5451,0.3377,3.9451,0.2957,0,-73.9408,0.011,ML,cueing,63,160.31100417917457,4.420379425173883,0.7768534947314086,0.395375015479871,4.222757341643348,0.6332707359371599,0.34987146309146216,0.059,0.379,0.477,0.011,1.688,29.17226149099484,1958.1283942816847,0.061,0.379,0.481,0.011,1.781,50.75868468482687,1946.5730723274019,338,1.0014814814814814,1,0,0,1,FALSE,FALSE,FALSE
134,2021-11-13T01:21:55Z,2021-11-13T01:45:24Z,1409,1,2021-11-13T01:45:26Z,0.8999999761581421,Edge,95.0.1020.44,Windows NT 10.0,1920,1080,None,1.7777777777777777,668,63,395,71,64,104,-0.31140540364955943,-0.24351084670544482,-0.15648477478499373,-0.4092360175938684,-0.10973896011284763,-0.02325264930698783,3,3,2,1,2,1,2,3,1,2,2,1,3,1,2,2,2,1,2,2,0.7181848464596079,0,1,2,4,5,2.1,0,3,3,2,4,2,1,4,3,2,1,2,3,3,3,3,2,3,5,2,2,2,2,2,3,3,2,1,5,2,2,3,5,2,2,3,3,1,4,3,3,3,2,4,2,2,3,5,3,2,3,4,3,4,1,2,4,4,3,4,2,1,1,1,1,2,3,3,3,1.18802837146737,0.9102589898327995,2.5,0,2.75,0,2.3333333333333335,0,3,0,2.5833333333333335,0,3,0,2.4285714285714284,0,1,0,2.6486486486486487,0,2,2,1,0.3577521658231747,0.8074686614209358,0.5826104136220552,3,2,1,2,2,2,1,1,1,0.6900655593423543,2.4285714285714284,0,1,-0.048446712495193056,2,3,3,4,2,2,2,6,6,NA,2,0.7867957924694432,2.857142857142857,0,3.142857142857143,3,3.8333333333333335,3.2559414990859232,-0.7395711320441822,0,0.012814857609616537,2,3,2,2,2,2,5,2,1,2,3,4,2,3,4,1,4,2,3,3,1.162919151265879,2.2,0,3.8,0,3.8,0,3.8,0,3.8,0,2,1,2,3,2,3,2,3,2,1,1,2,3,2,1,2,2,2,1,1,0.7181848464596079,1.9,0,Filipino,0,23,0,1,NA,0,3,6,Unemployed,3,0,195,69,2,5,2,0,0,1,0,0,TRUE,TRUE,TRUE,TRUE,TRUE,5,0.9251049999998883,0.8,0.08471427443262812,5,0.4701419354837027,0.5435379310344057,0.96875,0.9666666666666667,0.0020605283870883968,0.006737599816136939,5,0.5146281249998137,0.6098531249999068,1,1,0.008844542086662046,0.007977699344728506,1.4227,1.0163,0.5158,0,23.5101,0.004,ML,change,50,-35.28413098371556,1.0635711504152348,1.303433588414522,0.557447343648743,1.1919,3.3325,0.3746,4.9353,0.3541,0,-73.4568,0.019,ML,cueing,62,159.29500315513528,3.6577563630789887,0.9205905193619802,0.4260864481056852,4.96553635995105,0.6915642048624528,0.4048578055266983,0.15,0.207,0.479,0.013,1.691,174.85529852504473,2010.7987412334212,0.147,0.21,0.477,0.017,1.803,208.40314300685048,1994.6890196399702,104,0.3081481481481481,1,0,0,1,FALSE,FALSE,FALSE
135,2021-11-13T01:27:15Z,2021-11-13T01:46:35Z,1160,1,2021-11-13T01:46:36Z,1,Chrome,94.0.4606.81,Macintosh,1440,900,NA,1.6,620,56,281,58,46,64,-0.434735020492549,-0.30710401489772066,-0.7053080360922285,-0.5676593025364346,-0.3583560335760547,-0.6989073197411108,2,1,3,3,1,1,3,1,1,1,1,2,3,3,1,1,2,2,1,1,0.8645047258706176,0,1,2,4,3,3.1,0,4,4,4,3,4,3,3,3,2,3,3,3,2,3,2,2,3,1,1,1,3,3,2,0,2,0,0,3,4,4,5,5,5,5,5,4,5,4,4,1,4,2,3,2,3,4,3,4,2,1,1,1,2,1,1,1,1,1,3,3,2,1,1,1,1,2,1,1,1.5166740916559167,0.7037315505489968,2,0,1.25,0,2.933333333333333,0,1.5555555555555556,0,2.9166666666666665,0,1.5,0,1.5714285714285714,0,1,0,2,0,0,0,0,0.12197118414181142,-0.6588395645607719,-0.26843419020948023,5,1,5,1,1,1,1,1,1,1.9518001458970664,1,0,1,-0.9031185640466358,5,5,5,5,4,3,1,6,7,6,4,1.5275252316519468,4.571428571428571,0,1.4285714285714286,2.5,3.8333333333333335,3.2559414990859232,-1.0219528370065065,0,-1.0844279639287866,1,1,1,1,1,1,5,2,1,2,1,2,3,4,5,2,5,1,4,2,1.5430334996209192,1,0,4.4,0,3.6,0,4.4,0,4.133333333333334,0,2,3,3,2,4,3,2,2,2,1,3,2,1,3,1,2,3,4,2,2,0.8750939799154206,2.55,0,"White, Caucasian, Anglo, European American",0,25,1,2,NA,1,2,6,Painter,1,0,135,65,3,5,2,0,0,1,0,0,TRUE,TRUE,TRUE,TRUE,TRUE,4,0.852991304350936,0.9387755102040817,0.05064196837226682,4,0.6611937500238418,0.6643000000044703,1,1,0.003341834153460225,0.0019004535491863367,4,0.7127562500163913,0.7519249999672174,1,1,0.0062721076976840155,0.006466056129853493,1.6539,1.8605,0.4617,0,2.5854,0.005,ML,change,49,6.504660894331879,1.974350076750691,1.3827482471163182,0.5456921709516698,9.6691,13.6514,0.3102,11.5032,0.2409,0,-102.2623,0.02,ML,cueing,64,217.001249250079,5.502983106713689,0.7528888688276857,0.5980303897282736,4.778771567297802,0.866987397921241,0.5733161406938851,0.072,0.557,0.471,0.028,1.579,25.042426905082024,1811.69210222783,0.072,0.557,0.474,0.03,1.638,37.767865715381454,1819.1142293759608,434,1.285925925925926,1,0,0,1,FALSE,FALSE,FALSE
136,2021-11-13T01:13:55Z,2021-11-13T01:46:43Z,1968,1,2021-11-13T01:46:44Z,1,Chrome,95.0.4638.69,Windows NT 10.0,1366,768,"I wasn't sure on my parent's education levels. or financial situation; it would've been better for quality control if there was an unsure button in my opinion. However, it was overall a good study! (:",1.7786458333333333,850,59,323,195,216,156,0.15621939354677591,-0.2798497999581739,-0.5031099924527209,1.1018783926275322,1.9896941046875678,0.855098422257372,2,1,4,4,1,3,4,1,3,1,2,4,4,3,1,1,4,2,1,1,1.3088765773505315,0,0,1,3,1,3.65,0,1,1,5,1,5,5,1,5,5,5,5,1,3,1,1,5,5,5,5,5,5,5,5,20,5,50,2,1,1,1,1,1,3,1,1,1,5,1,5,5,1,5,3,5,5,5,5,5,1,5,5,5,5,5,5,5,5,5,3,5,5,5,5,5,5,5,5,5,1.829028525022326,2,5,0,5,0,4.866666666666666,0,4.777777777777778,0,4.833333333333333,0,4.833333333333333,0,4.571428571428571,0,5,0,4.837837837837838,0,6,6,2,3.461621016626932,3.3284318583334467,3.3950264374801895,1,5,1,5,5,5,5,8,3,1.9518001458970664,5,0,5.5,3.1504071567821237,1,1,1,1,1,1,5,2,5,1,1,1.5118578920369088,1,0,5,5.5,3.8333333333333335,3.2559414990859232,0.6723373927674386,0,1.7544920864941047,4,5,5,5,5,4,5,4,3,5,2,4,3,5,5,1,4,2,5,4,1.2798809468443688,4.8,0,3.6,0,4.6,0,3.4,0,3.8666666666666667,0,2,4,4,1,3,4,4,3,2,4,4,2,4,4,2,1,4,4,4,4,1.105012502906165,3.5,0,"White, Caucasian, Anglo, European American",0,22,1,2,NA,1,1,4,Homemaker/Stay At Home Parent/Self Employed,2,0,190,63,3,5,2,1,0,0,0,1,TRUE,TRUE,TRUE,TRUE,TRUE,6,0.744245945946993,0.74,0.03629902719981122,6,0.42874687499832365,0.47093548387096773,1,0.96875,0.0022864832158404663,0.0036387191935252374,6,0.5362749999994412,0.6120964285720671,1,0.9333333333333333,0.005339475484094955,0.004058551310399796,1.3084,0.8506,0.3689,0,20.6796,0.004,ML,change,50,-29.623130983715562,1.0279918388081,1.0174872170147096,0.5066984063024533,1.4853,4.7898,0.3238,5.2767,0.288,0,-84.5183,0.011,ML,cueing,64,181.513249250079,4.307484084248773,0.7972141364473632,0.3841808681484876,5.254368045280417,0.7885124701367242,0.35605769060334425,0.065,0.409,0.543,0.017,1.805,128.04530686523353,1994.808293640362,0.064,0.409,0.585,0.016,1.873,149.21235035254895,1995.7861914179578,339,1.0044444444444445,1,0,0,1,FALSE,FALSE,FALSE
137,2021-11-13T01:17:39Z,2021-11-13T01:47:23Z,1783,1,2021-11-13T01:47:24Z,0.8999999761581421,Chrome,95.0.4638.69,Macintosh,1366,768,no,1.7786458333333333,685,620,240,31,30,140,-0.2677261643510006,4.816688393737076,-0.902691840597462,-0.8966922789556105,-0.5793489877655722,0.5848365540837228,2,2,3,3,1,1,2,2,2,2,2,3,3,3,1,1,3,3,1,1,0.8255779474818965,0,1,2,3,2,3.05,0,1,1,4,1,4,4,4,4,4,4,4,2,2,2,2,5,5,1,1,4,4,4,5,2,3,0,0,3,4,4,4,4,2,2,2,2,5,3,5,4,1,3,3,4,4,4,4,4,1,1,3,2,2,3,4,2,3,1,1,5,5,4,4,4,3,3,3,3,1.2508255532105843,1.3020130933435712,3.625,0,3,0,3.933333333333333,0,3,0,4,0,2.5,0,3.4285714285714284,0,4,0,3.4594594594594597,0,1,0,0,1.877261866732748,0.0930613282564324,0.9851615974945902,1,4,2,4,4,3,3,8,4,1.1547005383792515,3.857142857142857,0,6,2.6511635129281608,3,3,3,3,1,1,5,5,3,2,1,1.3801311186847085,2.142857142857143,0,3.857142857142857,5,3.8333333333333335,3.2559414990859232,0.38995568780511447,0,0.9759332546414488,5,5,5,5,5,4,4,3,4,4,3,4,4,3,3,4,3,4,4,4,0.4879500364742666,5,0,2.8,0,3.2,0,2.6,0,2.8666666666666667,0,4,4,3,2,3,4,4,3,3,3,3,3,4,4,4,2,4,4,4,4,0.6863327411532597,3.45,0,"Hispanic of Latino (e.g., Mexican American, Central American, and others)",0,25,1,2,NA,1,2,6,IT Tech,3,0,100,65,2,4,2,0,0,2,1,0,TRUE,TRUE,TRUE,TRUE,TRUE,2,0.9473945945944838,0.7551020408163265,0.13541700397958553,2,0.6548814814814401,0.665729629629671,0.9310344827586207,0.8709677419354839,0.11390947051723284,0.03086394146233623,NA,NA,NA,NA,NA,NA,NA,1.3243,0.8499,0.5655,0,24.4476,0.005,ML,change,49,-37.219739105668125,0.7901447924418334,1.4250695234938417,0.48730405520743747,1.3533,1.6899,0.3896,1.5788,0.2817,0,3.1916,0.01,ML,cueing,60,5.8998336866663,1.7636251516983839,1.0827371695428223,0.4379825017844393,1.5670496430795378,1.6608852801431513,0.19803646013225135,NA,NA,NA,NA,NA,NA,NA,NA,NA,NA,NA,NA,NA,NA,446,1.3214814814814815,1,0,0,1,FALSE,FALSE,FALSE
138,2021-11-13T01:23:22Z,2021-11-13T01:47:34Z,1451,1,2021-11-13T01:47:34Z,1,Chrome,95.0.4638.54,Windows NT 10.0,1366,768,NA,1.7786458333333333,749,68,352,65,46,106,-0.10328667522701457,-0.1980871551395335,-0.36349705755877526,-0.4823544567981297,-0.3583560335760547,0.010530084214718316,3,2,2,2,3,1,1,3,1,3,4,2,1,2,4,4,2,2,3,3,0.99472291830968,0,1,4,2,3,1.7,0,5,4,2,4,2,1,5,2,2,1,2,4,2,5,4,2,1,1,1,3,1,1,3,4,2,0,0,4,3,4,4,4,4,4,3,4,1,3,4,3,5,3,5,1,4,5,5,3,5,1,2,1,1,1,4,3,5,4,4,3,3,2,2,1,3,4,4,5,1.3506755066722445,1.4638501094227998,1.625,0,4,0,1.6666666666666667,0,2.2222222222222223,0,2.8333333333333335,0,1,0,3.2857142857142856,0,1.6666666666666667,0,2.4324324324324325,0,2,0,0,-0.397695519736365,0.6097586129219131,0.10603154659277406,4,2,3,2,1,2,2,5,2,0.9511897312113419,2,0,3.5,0.6176209189753294,3,4,4,3,2,1,2,7,7,2,3,1.1126972805283737,3,0,3,2,3.8333333333333335,3.2559414990859232,-1.3043345419688306,0,-0.34923784477414443,2,2,3,3,3,2,3,2,1,1,2,4,2,4,2,2,4,3,4,3,1.0555973258234952,2.6,0,3.8,0,3.2,0,3.6,0,3.533333333333333,0,2,2,2,3,2,1,3,3,1,2,3,3,4,4,1,3,2,2,1,2,0.9233805168766387,2.1,0,"White, Caucasian, Anglo, European American",0,30,0,1,NA,1,3,7,Teacher,3,0,123,64,3,5,2,0,0,1,0,0,TRUE,TRUE,TRUE,TRUE,TRUE,2,0.8575315789486233,0.76,0.04937483514230103,NA,NA,NA,NA,NA,NA,NA,2,0.6404531250037253,0.6661875000037253,1,1,0.003205453538440327,0.006260782419372316,1.1725,0.9767,0.5548,0,12.6562,0.006,ML,change,50,-13.576330983715563,1.0381300059259546,1.1103421569153653,0.5794460220818797,NA,NA,NA,NA,NA,NA,NA,NA,NA,NA,NA,NA,2.432687707241041,1.0848319419545494,0.3724380497886216,4.150263679843379,0.9982822890298586,0.3739813436194189,0.074,0.514,0.605,0.075,1.623,48.45536600034161,1841.1891697806984,0.078,0.511,0.607,0.116,1.695,65.70300941886576,1851.6245714306326,496,1.4696296296296296,1,0,5,6,TRUE,FALSE,FALSE
139,2021-11-13T01:13:49Z,2021-11-13T01:47:55Z,2045,1,2021-11-13T01:47:56Z,1,Opera,80.0.4170.91,Windows NT 10.0,1536,864,Was good :),1.7777777777777777,920,104,573,140,80,164,0.3360750847761356,0.12896342413502795,0.7004497911157763,0.4316260332551368,0.1112539940766698,0.9902293563441966,4,3,3,2,2,2,2,4,2,3,4,2,3,2,4,3,3,2,2,3,0.7863975156570492,0,1,1,4,5,2.05,0,1,3,2,3,1,1,4,3,1,1,1,3,2,4,3,3,1,1,3,1,1,1,1,4,3,0,2,4,1,1,2,4,2,1,1,2,5,3,1,1,1,2,3,4,4,1,3,4,2,4,1,1,3,1,1,4,2,1,4,1,1,1,3,2,4,3,2,4,1.2938988268694636,1.1464230084422218,1.5,0,3.25,0,2.2,0,4,0,3,0,2.1666666666666665,0,1.5714285714285714,0,2,0,2.810810810810811,0,2,0,2,-0.0596072730150998,0.7274542985685514,0.3339235127767258,3,3,2,1,1,2,3,3,2,0.8997354108424374,2.4285714285714284,0,2.5,0.5050347996663801,3,3,5,3,2,2,3,1,3,1,2,1,3,0,3,7,3.8333333333333335,3.2559414990859232,1.5194825076544112,0,1.0626706800374763,2,2,2,3,3,1,4,1,1,2,1,4,2,3,5,3,4,2,3,3,1.2983506020002016,2.4,0,4.4,0,3.2,0,4.2,0,3.933333333333333,0,1,1,1,3,2,2,2,4,1,1,3,4,2,2,1,4,3,2,1,1,1.0990426455975697,1.55,0,"Hispanic of Latino (e.g., Mexican American, Central American, and others) & White, Caucasian, Anglo, European American",1,21,0,1,NA,1,2,3,Student,2,0,154,69,2,5,2,0,0,3,0,0,TRUE,TRUE,TRUE,TRUE,TRUE,4,0.902473684209546,0.76,0.09439784365724617,4,0.4806161290332675,0.6007218750000466,1,1,0.005817080731145739,0.007545368860846275,4,0.680425000000745,0.6302870967743859,1,0.96875,0.007923347096802225,0.010960435766086227,1.3262,0.8626,0.4888,0,25.0463,0.006,ML,change,50,-38.35653098371556,0.8828514612975039,1.3056324426810397,0.5179645680348179,2.8996,5.2462,0.3244,6.9937,0.2733,0,-73.9973,0.012,ML,cueing,63,160.42400417917457,3.8984536534791103,1.0627636223644883,0.4686756394052241,4.160410862238586,0.9958474928512812,0.3646747844588774,0.245,0.224,0.578,0.081,1.316,179.797029025522,2018.386747016152,0.271,0.201,0.594,0.32,1.309,180.12199383267173,2004.6889552496361,104,0.3081481481481481,1,0,4,5,FALSE,FALSE,FALSE
140,2021-11-13T01:23:15Z,2021-11-13T01:48:01Z,1485,1,2021-11-13T01:48:02Z,1,Chrome,95.0.4638.69,Macintosh,1440,900,NA,1.6,784,59,349,74,62,91,-0.013358829612334701,-0.2798497999581739,-0.3779397749615972,-0.37267679799173775,-0.1373630793865373,-0.2428404171980778,3,3,2,1,2,1,1,3,1,2,2,1,1,2,2,2,1,2,3,2,0.7451598203705946,0,1,3,4,4,1.95,0,2,4,3,3,4,2,4,3,2,2,4,3,2,3,2,2,3,4,1,2,3,2,2,2,2,0,0,4,4,2,4,2,3,2,2,3,3,4,2,2,3,3,4,3,2,2,3,1,2,1,3,2,3,2,2,2,2,1,4,2,2,1,1,2,2,2,1,2,0.9291734839971293,0.8338093878327919,2.375,0,1.75,0,2.8666666666666667,0,3.111111111111111,0,2.3333333333333335,0,2.3333333333333335,0,1.7142857142857142,0,1.3333333333333333,0,2.3783783783783785,0,1,0,0,0.41708457213297584,-0.2989446853297732,0.05906994340160132,4,1,2,1,1,2,1,1,1,1.1126972805283737,1.7142857142857142,0,1,-0.4757826382709144,4,5,5,5,2,3,1,6,6,3,3,1.618347187425374,4.142857142857143,0,1.8571428571428572,3,3.8333333333333335,3.2559414990859232,-0.7395711320441822,0,-0.7042241191833141,3,4,3,3,2,2,4,2,3,3,2,4,4,4,3,4,4,2,2,4,0.9154754164341269,3,0,4,0,2.6,0,3.2,0,3.2666666666666666,0,2,2,3,4,3,3,2,2,1,2,2,3,4,2,1,2,1,2,2,4,0.9333020044867296,2.25,0,"Black or African American & White, Caucasian, Anglo, European American",1,20,1,2,NA,1,4,4,student,5,0,120,66,2,5,2,0,0,1,0,0,TRUE,TRUE,TRUE,TRUE,TRUE,2,1.2602605263143778,0.76,0.2849639336140553,2,0.7201322580633625,0.7675322580635547,1,1,0.05547758959060272,0.034811136257481765,2,0.9227709677440504,0.9961968750022352,1,1,0.13937109479518783,0.06946798160268683,1.8548,0.67,0.5623,0,52.4314,0.003,ML,change,50,-93.12673098371556,0.6697777009051441,1.7209881851555273,0.5921927068934871,1.6097,2.9892,0.4983,3.1162,0.4618,0,-37.5282,0.009,ML,cueing,62,87.43780315513527,2.6600080109907407,1.5575647551709402,0.4839070113843445,2.3674624448749744,1.7500318686619467,0.3620815154979842,0.09,0.614,0.289,0.152,1.647,265.43670036539794,2047.4992919160975,0.083,0.61,0.271,0.109,1.836,263.7211667997821,2049.4306320514797,104,0.3081481481481481,1,0,0,1,FALSE,FALSE,FALSE
141,2021-11-13T01:25:24Z,2021-11-13T01:48:16Z,1371,1,2021-11-13T01:48:17Z,1,Firefox,94.0,Windows NT 10.0,1920,1080,NA,1.7777777777777777,649,49,341,106,66,100,-0.36022337698324275,-0.3706971830899965,-0.41645368803578914,0.017288211097655985,-0.08211484083915795,-0.09081811635040013,3,3,2,2,1,1,1,2,1,2,2,1,1,2,3,3,1,1,2,2,0.7677718959499145,0,1,2,2,4,2,0,4,5,2,5,1,1,4,1,3,1,1,4,1,4,2,1,1,5,1,1,1,1,2,2,2,1,0,5,1,2,3,2,4,5,5,4,1,5,1,1,2,3,4,5,2,1,2,2,2,1,1,1,1,1,1,4,1,1,2,2,4,1,1,1,1,2,2,1,1.4881917600614225,1.5946338585572373,1.625,0,1.5,0,1.6666666666666667,0,2.5555555555555554,0,2.0833333333333335,0,1.3333333333333333,0,2.2857142857142856,0,1,0,2.081081081081081,0,1,1,0,-0.5486882666259079,-0.1707126804539906,-0.3597004735399492,3,2,4,1,1,2,2,1,1,1.0690449676496976,1.8571428571428572,0,1,-0.39031545311577004,5,5,5,5,2,2,1,6,6,5,4,1.8126539343499315,4.142857142857143,0,1.8571428571428572,3,3.8333333333333335,3.2559414990859232,-0.7395711320441822,0,-0.7042241191833141,2,1,1,3,1,3,5,1,2,5,3,2,1,4,5,1,3,5,4,3,1.505545305418162,1.6,0,2.4,0,4.8,0,4.2,0,3.8,0,1,1,2,2,3,4,4,2,3,1,3,1,1,2,3,1,2,4,4,2,1.1285761872936695,2.7,0,"White, Caucasian, Anglo, European American",0,23,0,2,NA,1,3,5,IT Manager,2,0,189,69,2,5,2,0,0,1,0,0,TRUE,TRUE,TRUE,TRUE,TRUE,4,0.7515263157894737,0.76,0.08799991673469389,4,0.404625,0.5230967741935484,1,0.96875,0.006039919354838712,0.009251447580645163,4,0.6358709677419355,0.7259310344827586,0.96875,0.9354838709677419,0.01768317641129032,0.022318490322580643,1.2491,0.9488,0.4226,0,16.2517,0.004,ML,change,50,-20.76733098371556,0.898478301691368,1.282924148272127,0.3802760831207134,1.4508,3.5478,0.3266,4.5631,0.2457,0,-66.7672,0.009,ML,cueing,64,146.01104925007903,3.4112095097699484,1.0066773074623416,0.3847646117973442,4.1214943552515795,1.005250612829878,0.2864838056613388,0.06,0.443,0.269,0.037,1.691,123.53139365793447,2056.5618162775477,0.063,0.436,0.29,0.022,1.768,126.2834366674028,2034.6423743272253,272,0.8059259259259259,1,1,7,9,FALSE,FALSE,FALSE
143,2021-11-13T01:32:07Z,2021-11-13T01:50:36Z,1109,1,2021-11-13T01:50:37Z,0.8999999761581421,Chrome,95.0.4638.69,Windows NT 10.0,1280,720,NA,1.7777777777777777,616,55,213,100,41,56,-0.44501248856279807,-0.31618875321090295,-1.0326762972228596,-0.05583022810660534,-0.42741633176027893,-0.8340382538279354,4,3,4,4,3,3,4,3,4,3,2,4,3,4,2,2,4,3,2,2,0.812727700887249,0,1,1,4,3,3.05,0,5,5,2,4,2,1,4,2,1,1,3,4,5,5,3,1,2,1,1,1,1,1,1,2,2,0,0,4,5,2,5,5,5,2,3,5,1,5,1,1,4,1,5,3,1,1,3,3,5,1,1,1,1,1,1,1,1,1,4,3,4,1,3,1,2,1,2,1,1.6589913357978252,1.5522640914238175,1.125,0,1.5,0,1.9333333333333333,0,2,0,1.5833333333333333,0,0.8333333333333334,0,1.7142857142857142,0,1.6666666666666667,0,1.6486486486486487,0,1,0,0,-0.8348001639371186,-0.3773458880470143,-0.6060730259920665,4,2,3,1,1,2,1,1,1,1.1547005383792515,1.7142857142857142,0,1,-0.4757826382709144,2,3,4,4,3,3,2,6,3,3,2,0.816496580927726,3.2857142857142856,0,2.7142857142857144,4.5,3.8333333333333335,3.2559414990859232,0.10757398284279028,0,0.19737442278879264,1,1,1,3,4,1,4,3,2,3,1,4,3,3,3,1,4,4,4,1,1.2227992865708155,2,0,4,0,3.8,0,3.6,0,3.8,0,1,2,1,3,2,1,2,2,1,3,2,4,1,2,1,3,1,1,1,2,0.8944271909999159,1.6,0,"Asian or Asian American (e.g., Chinese, Japanese, and others)",0,21,1,2,NA,1,3,4,Student,3,0,116,65,1,5,2,0,0,0,0,0,TRUE,TRUE,TRUE,TRUE,TRUE,5,0.6224722222222222,0.72,0.022480585408164878,5,0.44078124999953433,0.5147612903238304,1,0.96875,0.003676951895116223,0.008745112096642752,5,0.6011258064522859,0.6537483870978317,1,0.96875,0.025562091978523455,0.006809769516540815,0.9975,0.9371,0.4128,0,0.8238,0.004,ML,change,50,10.088469016284437,1.0559768749066165,0.8943961096916759,0.43613561882873453,1.6792,3.8067,0.3033,4.9869,0.2724,0,-67.2682,0.011,ML,cueing,64,147.013049250079,3.459548884216036,0.9926112679466641,0.38026787877736035,4.665954584597458,0.8879500756540197,0.3486027235915192,0.071,0.396,0.41,0.015,1.817,78.65632987352039,1910.5880910552241,0.073,0.395,0.418,0.017,1.853,89.30869652973496,1912.6929339433552,104,0.3081481481481481,1,1,1,2,FALSE,FALSE,FALSE
144,2021-11-13T01:24:09Z,2021-11-13T01:51:23Z,1633,1,2021-11-13T01:51:24Z,1,Chrome,95.0.4638.69,Windows NT 10.0,1536,864,NA,1.7777777777777777,638,80,487,96,69,178,-0.3884864141764279,-0.08907029538134635,0.28642522556821326,-0.10457585424277956,-0.04067866192862343,1.2267084909961397,4,4,1,1,4,1,2,3,1,4,4,1,1,1,4,3,1,1,4,4,1.4317821063276353,0,1,1,2,1,1.15,0,2,3,4,3,4,3,3,2,4,2,3,5,2,4,4,2,2,1,2,2,3,3,3,4,2,0,0,5,5,2,5,5,5,4,5,5,1,4,2,1,4,2,5,3,2,2,3,3,4,1,1,1,2,1,1,4,4,1,4,2,2,1,1,1,1,1,3,3,1.578287360080854,0.9411239481143202,2.25,0,2,0,2.8,0,1.4444444444444444,0,2,0,1.1666666666666667,0,2.142857142857143,0,1,0,1.7297297297297298,0,2,0,0,0.05596025248881939,-0.01745100881601569,0.01925462183640185,3,2,3,2,1,3,3,5,4,0.7867957924694432,2.4285714285714284,0,4.5,1.2430101492151444,5,5,5,5,3,3,2,8,1,3,3,1.2909944487358056,4.285714285714286,0,1.7142857142857142,4.5,3.8333333333333335,3.2559414990859232,0.10757398284279028,0,-0.3603225591612647,2,3,3,4,3,2,3,2,3,3,2,4,3,4,4,3,4,2,2,4,0.8451542547285166,3,0,4,0,2.8,0,3.4,0,3.4,0,1,2,2,4,2,1,2,4,1,1,3,4,1,2,1,4,1,2,1,1,1.1697953037312037,1.4,0,"White, Caucasian, Anglo, European American & Other & Greek",1,22,1,2,NA,1,2,6,"Post Graduate Student, Project Engineer",2,0,120,64,3,5,2,0,0,0,0,0,TRUE,TRUE,TRUE,TRUE,TRUE,1,0.6682780487788159,0.82,0.02447871905684279,1,0.4077406249996275,0.5171258064527665,1,0.96875,0.0018966270060264995,0.008406948669113873,1,0.5344031250006519,0.636744827583946,1,0.90625,0.014573673215545221,0.01035451861878529,1.2376,1.3617,0.4061,0,2.04,0.005,ML,change,50,7.656069016284437,1.562362231787355,0.9705479680172341,0.46949229766000256,2.0317,4.0202,0.2763,5.7871,0.2322,0,-68.5355,0.012,ML,cueing,64,149.54764925007902,3.493825561729401,0.9828731125275083,0.3852583839506488,5.505756647501253,0.7525095988889853,0.3415377649209358,0.068,0.364,0.415,0.012,1.669,54.07359671953995,1918.6457747161899,0.068,0.365,0.441,0.011,1.678,70.50342126514713,1930.0147449600804,354,1.0488888888888888,1,0,0,1,FALSE,FALSE,FALSE
145,2021-11-13T01:28:59Z,2021-11-13T01:52:09Z,1390,1,2021-11-13T01:52:13Z,1,Edge,95.0.1020.44,Windows NT 10.0,1280,800,"For the one question about my parents' marriage, I accidently selected an answer and could not figure out how to deselect. The answer is best left blank for me because I did not grow up in a two-parent household.",1.6,643,44,371,82,52,85,-0.37563957908861645,-0.4161208746559078,-0.27202651400756944,-0.2751855457193893,-0.2754836757549857,-0.34418861776319626,2,3,2,2,3,1,1,3,1,2,2,1,2,1,2,2,1,1,2,1,0.7163503994113789,0,1,1,5,5,2.05,0,1,4,4,2,5,4,5,5,4,5,2,1,1,1,1,5,5,NA,4,5,5,5,5,0,1,0,NA,4,2,1,1,1,3,1,1,4,5,2,1,5,2,2,5,4,4,1,1,4,5,1,2,1,2,2,2,1,1,1,4,5,3,1,2,5,1,2,1,2,1.5387877916944455,1.7320508075688772,4.857142857142857,1,1.5,0,3.8,0,4,0,3,0,1.3333333333333333,0,2,0,2.6666666666666665,0,2.810810810810811,0,0,0,NA,2.0707178668913184,-0.6114411611880771,0.7296383528516206,5,1,5,1,1,2,2,8,3,1.8126539343499315,1.2857142857142858,0,5.5,0.9282603427483724,5,5,5,4,2,3,3,7,NA,3,3,1.2149857925879117,3.857142857142857,0,2.142857142857143,2,3.8333333333333335,3.2559414990859232,-1.3043345419688306,0,-0.827263829302765,4,2,2,1,2,2,4,3,1,4,2,3,1,4,5,2,3,2,4,2,1.2071217242444348,2.2,0,3.6,0,4.2,0,4.2,0,4,0,1,1,2,3,3,1,2,2,2,1,3,3,1,3,2,2,1,1,4,3,0.9445132413883326,2.05,0,"Asian or Asian American (e.g., Chinese, Japanese, and others)",0,19,1,3,NA,1,2,4,Student,2,0,80,58,2,5,2,0,0,1,0,0,TRUE,TRUE,TRUE,TRUE,TRUE,1,0.7894499999992549,0.8163265306122449,0.07043677458127207,1,0.4067000000002208,0.48059032258006834,0.8709677419354839,0.96875,0.006868205247530776,0.0042980341937549444,1,0.6144812500011176,0.6729124999968334,1,1,0.009277068669380877,0.010695655322463903,1.1983,1.2523,0.4863,0,6.5911,0.003,ML,change,49,-1.506739105668121,1.1835967332645851,1.2602728909731347,0.45263109874509067,0.9548,4.028,0.3676,2.0694,0.23,0,-59.2296,0.01,ML,cueing,63,130.8886041791746,4.131838616470266,0.831103903912569,0.3863030110171047,2.567782970080709,0.7436541667010196,0.2992642430782407,0.162,0.295,0.508,0.02,1.39,44.21739028859729,1850.4616075031615,0.164,0.299,0.521,0.02,1.461,64.6785080345267,1848.6654996666314,375,1.1111111111111112,1,0,0,1,FALSE,FALSE,FALSE
146,2021-11-13T01:29:41Z,2021-11-13T01:52:22Z,1360,1,2021-11-13T01:52:24Z,0.800000011920929,Safari,14.1.2,Macintosh,1440,900,NA,1.6,697,118,305,70,52,78,-0.23689376014025323,0.25614976051957966,-0.5897662968696528,-0.421422424127912,-0.2754836757549857,-0.4624281850891678,2,2,2,3,2,1,2,2,1,3,2,1,1,3,2,3,1,1,2,3,0.7591546545162482,0,0,2,3,4,2.15,0,5,4,2,3,3,2,4,2,2,2,1,4,2,3,4,2,2,1,1,1,1,2,1,5,2,0,0,4,3,4,3,4,5,4,3,5,3,5,1,1,5,1,5,2,1,2,2,2,5,1,1,1,4,1,2,2,2,1,4,3,2,2,2,1,2,1,2,2,1.4539993514833884,1.1254628677422756,1.375,0,1.75,0,2.066666666666667,0,2.111111111111111,0,1.5,0,1.3333333333333333,0,1.8571428571428572,0,1.6666666666666667,0,1.7567567567567568,0,3,0,0,-0.6236038987364887,0.10724026226325957,-0.25818181823661457,3,3,2,1,2,2,2,2,1,0.6900655593423543,2.4285714285714284,0,1.5,0.13604712489199797,3,3,4,4,2,2,4,3,3,2,2,0.8997354108424374,2.857142857142857,0,3.142857142857143,6,3.8333333333333335,3.2559414990859232,0.9547190977297628,0,0.8599599724965891,2,4,2,3,3,3,4,2,2,3,1,4,3,4,4,4,4,1,3,2,1.0997835284835873,2.8,0,4.2,0,3,0,4,0,3.7333333333333334,0,1,1,2,2,4,2,3,3,1,3,2,4,1,2,2,3,3,3,1,2,0.9665456669582609,2.05,0,"White, Caucasian, Anglo, European American",0,18,1,2,NA,1,2,4,full-time student and part-time retail worker,2,0,125,63,3,5,2,0,0,0,0,0,TRUE,TRUE,TRUE,TRUE,TRUE,4,0.8310000000000013,0.8775510204081632,0.03064388520408205,4,0.50396875,0.526300000000002,1,0.9375,0.006450482862902757,0.0034916129032252475,4,0.6494687499999959,0.7832333333333323,1,0.9375,0.00963206350806465,0.020946564516129154,1.4788,1.5488,0.4775,0,6.2624,0.003,ML,change,49,-0.8493391056681219,1.807079606826548,1.0898471982228193,0.6032995045577447,1.3264,3.378,0.3492,4.3981,0.3532,0,-67.2609,0.011,ML,cueing,64,146.99844925007903,3.834781773042608,0.7061810453306651,0.44573369254959544,4.054286524706381,1.0219146331034377,0.3818782422391244,0.077,0.457,0.397,0.009,1.523,23.480163979171135,1866.899908623116,0.077,0.458,0.425,0.01,1.597,30.21611813549866,1873.863682027007,336,0.9955555555555555,1,0,0,1,FALSE,FALSE,FALSE
147,2021-11-13T01:27:40Z,2021-11-13T01:52:46Z,1505,1,2021-11-13T01:52:46Z,1,Chrome,95.0.4638.69,Windows NT 10.0,1366,768,NA,1.7786458333333333,695,60,355,160,103,77,-0.2420324941753778,-0.2707650616449916,-0.34905434015595327,0.6753541639360079,0.4289313657241011,-0.47931955185002084,2,2,3,3,1,3,2,2,1,2,1,2,2,3,1,2,2,2,2,2,0.6488856845230502,0,1,2,3,3,2.8,0,2,4,3,2,4,3,2,2,4,2,3,5,2,4,3,1,3,1,1,1,1,1,2,0,2,0,0,5,3,5,5,5,5,5,5,5,3,4,1,1,2,2,4,2,1,3,3,3,5,1,1,1,3,1,1,1,1,1,4,2,2,1,1,1,2,1,1,1,1.633912381270694,1,1.375,0,1.25,0,2.8666666666666667,0,1.2222222222222223,0,2.25,0,1.1666666666666667,0,1.2857142857142858,0,1,0,1.5945945945945945,0,0,0,0,-0.3494939889985495,-0.6588395645607719,-0.5041667767796607,5,1,2,1,1,1,1,1,1,1.4960264830861913,1.4285714285714286,0,1,-0.6467170085812028,5,5,5,5,2,2,2,7,4,4,3,1.6035674514745464,4,0,2,3.5,3.8333333333333335,3.2559414990859232,-0.4571894270818581,0,-0.48336226928071535,1,3,1,1,1,1,5,1,2,3,2,4,1,2,5,1,4,5,5,2,1.6417180315870614,1.4,0,3.6,0,4.6,0,4,0,4.066666666666666,0,2,1,2,2,3,3,2,2,3,3,3,2,3,4,2,2,2,3,3,3,0.6882472016116853,2.7,0,"White, Caucasian, Anglo, European American",0,21,1,2,NA,1,2,4,Nanny,6,0,300,67,1,5,2,0,0,2,0,0,TRUE,TRUE,TRUE,TRUE,TRUE,4,0.6948352941175758,0.68,0.019724662648976193,4,0.4900718750000233,0.5987678571429902,1,0.875,0.0014567240221762,0.006116559314520564,4,0.6890500000000175,0.838386206896526,1,0.9666666666666667,0.009201423225806775,0.016298797747120918,1.0318,0.7783,0.4581,0,1.5948,0.004,ML,change,50,8.546469016284437,0.8839886990333868,0.8526939351154664,0.5212076125775122,1.1463,2.2821,0.3974,5.5019,0.3859,0,-69.7326,0.011,ML,cueing,64,151.94184925007903,2.6800561982460858,0.7260706511784264,0.4971742807209374,5.881230134912893,0.704467370150428,0.4320523153859584,0.085,0.482,0.375,0.012,1.702,107.75924682988656,1947.674697071489,0.087,0.481,0.392,0.012,1.737,121.30614677461575,1951.7730911597862,104,0.3081481481481481,1,0,0,1,FALSE,FALSE,FALSE
148,2021-11-13T01:22:38Z,2021-11-13T01:53:19Z,1840,1,2021-11-13T01:53:20Z,1,Chrome,93.0.4577.63,Macintosh,1440,900,No feedback,1.6,1073,62,400,86,65,88,0.7291882384631648,-0.2525955850186271,-0.13241357911362378,-0.2264399195832151,-0.09592690047600279,-0.293514517480637,2,3,3,2,2,3,3,2,2,3,3,3,2,1,2,2,3,1,2,2,0.6569466853317864,0,1,1,5,4,2.5,0,4,4,3,4,2,3,3,2,2,3,3,3,2,3,3,2,3,1,1,1,1,2,2,1,2,0,0,5,4,3,4,3,4,4,4,5,2,4,3,1,4,2,5,3,3,2,3,3,5,1,1,1,3,1,1,5,5,5,3,3,4,1,1,1,2,1,2,2,1.4431155818514962,0.7037315505489968,1.625,0,1.75,0,2.533333333333333,0,2,0,2.25,0,1.1666666666666667,0,3.5714285714285716,0,1,0,2.2162162162162162,0,1,0,0,-0.11816535754598059,-0.2989446853297732,-0.2085550214378769,5,2,5,2,2,3,3,1,1,1.3451854182690985,2,0,1,-0.3048482679606258,5,5,5,5,4,4,2,7,8,NA,5,1.1126972805283737,4.571428571428571,0,1.4285714285714286,1.5,3.8333333333333335,3.2559414990859232,-1.5867162469311549,0,-1.3668096688911109,1,1,2,1,3,2,4,1,3,4,2,4,1,4,4,2,3,2,3,2,1.0997835284835873,1.6,0,3.8,0,4,0,4,0,3.933333333333333,0,2,1,1,2,3,1,2,2,2,3,1,2,4,3,1,2,1,2,1,2,0.8522416262267903,2.1,0,"White, Caucasian, Anglo, European American & Middle Eastern",1,22,0,1,NA,1,4,6,Research Assistant,2,0,150,71,3,5,2,1,1,1,0,2,TRUE,TRUE,TRUE,TRUE,TRUE,5,1.169850000038743,0.64,0.14804557706067978,5,0.6059161290199526,0.6974281249791384,1,1,0.012842339390691591,0.021103617574197077,5,0.5860093750655652,0.620462962909981,1,0.84375,0.007593833780311423,0.013565826678269699,1.4442,0.4103,0.7123,0,40.0213,0.003,ML,change,50,-68.30653098371556,0.41230932722941593,1.3954672060654585,0.6960178649232074,2.1701,3.7641,0.4092,4.7457,0.3773,0,-53.5124,0.012,ML,cueing,63,119.4542041791746,3.0145553845284208,1.3743767149395598,0.47659498828658114,3.413119221453471,1.2138851465690044,0.43364684109892504,0.056,0.418,0.342,0.024,1.851,104.51521760002684,2066.994012353171,0.055,0.42,0.342,0.026,2.058,128.88815054841947,2064.426271189774,466,1.3807407407407408,1,0,2,3,FALSE,FALSE,FALSE
149,2021-11-13T01:31:37Z,2021-11-13T01:53:32Z,1315,1,2021-11-13T01:53:33Z,1,Chrome,95.0.4638.69,Macintosh,1280,800,NA,1.6,775,45,284,60,35,65,-0.036483132770395235,-0.40703613634272556,-0.6908653186894065,-0.5432864894683475,-0.510288689581348,-0.6820159529802577,3,3,3,2,3,1,2,2,1,3,2,2,1,2,3,3,2,1,2,2,0.7451598203705946,0,1,1,3,3,2.05,0,4,5,1,4,1,1,3,2,2,3,2,3,3,3,4,1,2,1,1,1,1,2,2,0,2,0,0,5,5,5,5,5,5,5,5,4,1,5,1,1,3,1,5,1,3,3,4,3,3,1,1,1,1,1,1,1,1,1,5,1,2,1,1,2,1,1,1,1,1.7646852733884628,1.2227992865708155,1.375,0,1,0,2.066666666666667,0,1.1111111111111112,0,1.9166666666666667,0,1.1666666666666667,0,1,0,1.3333333333333333,0,1.4324324324324325,0,0,0,0,-0.7629818189422206,-0.7372407672780129,-0.7501112931101168,4,2,2,2,1,2,2,1,1,0.8997354108424374,2.142857142857143,0,1,-0.21938108280548152,5,5,5,4,3,4,1,3,2,4,3,1.4638501094227998,4.428571428571429,0,1.5714285714285714,6.5,3.8333333333333335,3.2559414990859232,1.237100802692087,0,0.12476985334194696,1,1,1,3,1,2,4,2,1,2,2,2,3,3,4,3,5,2,4,2,1.0997835284835873,1.4,0,3.8,0,3.2,0,4,0,3.6666666666666665,0,2,1,2,2,2,2,2,2,2,2,2,2,1,2,1,2,1,2,2,2,0.41039134083406165,2,0,"White, Caucasian, Anglo, European American",0,25,1,2,NA,1,3,5,Unemployed,4,0,145,61,2,5,2,0,0,1,0,0,TRUE,TRUE,TRUE,TRUE,TRUE,2,1.2533151515148806,0.673469387755102,0.19200580353758606,2,0.5353187499998603,0.5727645161292486,1,0.96875,0.027342140282108088,0.01705230902213674,2,0.7056874999996507,0.7682633333332837,1,0.967741935483871,0.009090897257994847,0.00630842866668411,1.5225,0.4947,0.7162,0,41.6762,0.003,ML,change,49,-71.67693910566813,0.48164501411050964,1.5030132525374824,0.711989525655376,1.2591,3.414,0.3954,3.1265,0.3339,0,-54.8308,0.006,ML,cueing,64,122.13824925007901,2.927622109201493,1.1729612212218754,0.3849583198583376,2.825558918119453,1.4663062588512543,0.2839553508590712,0.074,0.538,0.463,0.013,1.402,74.08870094220724,1909.2895703068302,0.076,0.536,0.492,0.013,1.5,85.99697810303809,1915.412010037611,346,1.0251851851851852,1,0,0,1,FALSE,FALSE,FALSE
150,2021-11-13T01:24:48Z,2021-11-13T01:54:28Z,1779,1,2021-11-13T01:54:29Z,0.8999999761581421,Safari,15.1,Macintosh,1440,900,The survey was clear and the activities were very well explained.,1.6,626,101,566,223,77,106,-0.4193188183871753,0.10170920919548118,0.6667501171758583,1.4430977755807517,0.06981781516613529,0.010530084214718316,3,3,2,1,3,1,1,4,1,4,3,2,1,2,3,4,1,1,3,3,1.1285761872936695,0,1,3,2,3,1.5,0,3,4,2,4,2,2,3,2,2,3,3,3,2,4,3,2,3,1,2,2,3,2,1,2,4,0,0,4,5,5,5,4,5,5,5,2,3,4,2,2,3,3,2,4,2,1,3,3,4,1,1,1,3,3,2,2,2,1,5,1,1,2,2,2,2,1,2,2,1.404625563263382,0.7745966692414834,2,0,1.75,0,2.4,0,1.5555555555555556,0,2.6666666666666665,0,1.6666666666666667,0,1.2857142857142858,0,2,0,1.972972972972973,0,1,0,0,-0.11884288910253611,-0.2989446853297732,-0.20889378721615465,3,2,4,1,2,3,3,3,1,0.9759000729485332,2.2857142857142856,0,2,0.2350737771240448,4,3,3,4,2,2,3,1,1,1,2,0.816496580927726,3,0,3,8,3.8333333333333335,3.2559414990859232,2.0842459175790595,0,1.3450523849998008,2,2,2,3,3,2,3,2,2,3,2,4,3,4,4,2,5,2,4,3,1,2.4,0,4.2,0,3.4,0,3.8,0,3.8,0,1,1,1,4,2,1,2,4,1,1,2,4,1,1,1,4,1,1,1,1,1.2085223687584246,1.15,0,"Hispanic of Latino (e.g., Mexican American, Central American, and others)",0,25,0,1,NA,1,4,4,Student,2,0,139,70,3,5,2,0,0,0,0,0,TRUE,TRUE,TRUE,TRUE,TRUE,4,0.7362571428571362,0.7,0.04532672489796584,4,0.42046874999999634,0.4644999999999982,1,1,0.004616257056451497,0.0021914838709664332,4,0.5536562499999986,0.5792333333333357,1,0.9375,0.006208039314516044,0.011077544354838242,1.3358,0.6816,0.3779,0,25.3673,0.005,ML,change,50,-38.99853098371556,0.8014168638882768,1.0572498515645445,0.4724119708364155,1.5099,6.4776,0.348,5.878,0.292,0,-102.1861,0.012,ML,cueing,64,216.848849250079,5.3104084326263665,0.7801913504311125,0.39333688888348284,4.407983886089179,0.939916032693889,0.31718528978298866,0.067,0.358,0.32,0.054,1.814,126.6832828840256,2038.4016913719342,0.065,0.36,0.333,0.039,1.944,172.57643053258658,2039.12061806119,442,1.3096296296296297,1,0,0,1,FALSE,FALSE,FALSE
151,2021-11-13T01:07:46Z,2021-11-13T01:55:08Z,2842,1,2021-11-13T01:55:09Z,1,Chrome,95.0.4638.69,Windows NT 10.0,1920,1080,Everything OK,1.7777777777777777,1839,71,396,99,76,120,2.6973233739158724,-0.1708329401999867,-0.15167053565071972,-0.06801663464064889,0.05600575552929045,0.24700921886666136,3,4,1,1,2,1,1,3,1,4,4,1,2,2,3,4,1,1,1,3,1.2258187382102494,0,1,3,4,3,1.55,0,2,4,2,3,1,1,4,2,1,1,1,5,2,5,4,1,1,1,1,1,1,1,1,1,3,0,0,5,5,4,5,5,5,5,5,5,2,3,2,1,4,2,5,1,1,1,2,2,5,1,1,1,3,2,1,1,1,1,5,1,2,1,2,1,1,2,2,2,1.7168131661446004,1.505545305418162,1,0,1.75,0,1.7333333333333334,0,1.1111111111111112,0,1.6666666666666667,0,1.3333333333333333,0,1,0,1.3333333333333333,0,1.3783783783783783,0,1,0,0,-1.0906167216480558,-0.2989446853297732,-0.6947807034889145,4,3,2,1,1,1,2,1,2,1.1547005383792515,2,0,1.5,-0.12035443057343476,4,5,5,5,2,3,2,1,6,3,3,1.3801311186847085,4,0,2,5.5,3.8333333333333335,3.2559414990859232,0.6723373927674386,0,0.081401140643933,2,2,1,1,3,2,2,1,1,2,1,1,2,1,5,1,4,1,3,5,1.4573295865416045,1.8,0,3.8,0,3.2,0,3.4,0,3.466666666666667,0,2,1,1,3,2,2,3,3,1,1,2,4,1,2,2,4,1,2,1,2,0.9733285267845752,1.6,0,"Hispanic of Latino (e.g., Mexican American, Central American, and others)",0,21,0,1,NA,1,3,3,Student,4,0,146,63,4,5,2,1,0,1,0,1,TRUE,TRUE,TRUE,TRUE,TRUE,1,1.5219707317076079,0.8723404255319149,0.16117337215513527,1,0.42459333333373067,0.49615312499925496,1,1,0.0023555413340088024,0.005007572893657382,1,0.535156250005588,0.7139517241428638,1,0.90625,0.005363852863150917,0.011790059193797343,1.8078,1.0981,0.9424,0,33.8836,0.003,ML,change,47,-56.21675719486983,1.1721683804200853,1.6395362898182837,1.0011704354164075,5.4181,8.1874,0.1653,10.5261,0.1672,0,-89.8091,0.017,ML,cueing,62,191.99960315513528,4.31922347028452,0.9592313884418239,0.3885810794746222,5.2154262916023795,0.7944000154048007,0.3508146073106506,0.086,0.332,0.423,0.009,1.913,94.89263096241966,1962.4781418957991,0.087,0.331,0.451,0.01,2.088,110.69037622496754,1972.3238688929287,104,0.3081481481481481,1,0,0,1,FALSE,FALSE,FALSE
153,2021-11-13T01:22:20Z,2021-11-13T01:56:37Z,2056,1,2021-11-13T01:56:38Z,0.8999999761581421,Safari,14.1,Macintosh,1792,1120,NA,1.6,798,186,598,101,88,98,0.022612308633537248,0.8739119658159735,0.820805769472626,-0.04364382157256178,0.22175047117142851,-0.12460084987210628,2,3,2,1,2,1,1,2,1,3,2,1,1,1,1,2,1,1,2,3,0.7451598203705946,0,1,1,3,4,1.95,0,4,4,2,3,2,2,4,1,2,4,2,4,3,4,3,3,4,5,2,2,3,2,4,4,2,2,1,4,2,3,4,4,2,2,3,3,2,4,2,1,3,3,3,5,3,2,2,2,2,3,2,2,3,1,2,3,3,1,4,1,1,1,2,1,2,2,2,2,1.0433544884595018,1.0327955589886444,3.125,0,2,0,2.2666666666666666,0,3,0,2.5,0,2.3333333333333335,0,1.7142857142857142,0,1.3333333333333333,0,2.4054054054054053,0,2,2,1,0.49316168691193807,0.5722650532692125,0.5327133700905753,4,2,3,1,1,1,1,1,1,1.2149857925879117,1.5714285714285714,0,1,-0.5612498234260587,3,3,5,4,2,2,2,6,6,2,2,1.1547005383792515,3.2857142857142856,0,2.7142857142857144,3,3.8333333333333335,3.2559414990859232,-0.7395711320441822,0,-0.22619813465469363,2,2,3,4,3,3,5,2,1,2,1,3,4,4,5,1,3,1,5,2,1.52127765851133,2.8,0,3.8,0,3.8,0,4.4,0,4,0,2,1,3,1,2,3,3,2,3,1,3,1,1,3,1,2,3,2,1,3,0.8870412083230169,2.45,0,"White, Caucasian, Anglo, European American",0,30,1,2,NA,1,3,6,Teacher,2,0,144,64,2,5,2,0,0,0,0,0,TRUE,TRUE,TRUE,TRUE,TRUE,6,1.1206249999999869,0.8163265306122449,0.12007762925169585,6,0.5636451612903226,0.6022580645161328,1,0.96875,0.015039969892473724,0.010495587701613077,6,0.7400625000000054,0.8208965517241359,1,0.9354838709677419,0.018413931451612887,0.017161569892471112,1.5803,0.9692,0.6536,0,32.2191,0.003,ML,change,49,-52.76273910566812,1.0358290740360687,1.4400588998390826,0.6808527952206478,1.4581,3.3744,0.3948,3.3517,0.3461,0,-50.117,0.009,ML,cueing,63,112.66340417917459,3.3052866259368368,1.0389377966613806,0.45491771334553255,3.280958617124003,1.2627817689524194,0.3772179640242711,0.072,0.518,0.318,0.035,1.75,172.0244865496954,2072.7883358418057,0.073,0.518,0.332,0.017,1.98,140.1627115737089,2011.465848573886,448,1.3274074074074074,1,0,0,1,FALSE,FALSE,FALSE
154,2021-11-13T01:26:53Z,2021-11-13T01:56:46Z,1792,1,2021-11-13T01:56:48Z,0.8999999761581421,Chrome,94.0.4606.71,Macintosh,1440,900,This was a very interesting survey.,1.6,609,49,339,92,59,404,-0.46299805768573404,-0.3706971830899965,-0.4260821663043371,-0.15332148037895377,-0.17879925829707183,5.044157378948934,2,3,1,1,2,1,1,1,1,2,2,1,2,1,2,2,1,1,2,2,0.6048053188292994,0,1,1,3,2,2.05,0,4,4,3,4,2,2,3,2,2,2,1,4,1,3,3,2,1,1,1,1,1,1,1,0,2,3,2,5,2,4,4,5,5,3,4,5,2,4,2,1,4,2,4,2,1,2,1,3,3,3,1,1,1,1,1,1,1,1,5,1,1,1,2,1,2,3,4,4,1.5007505629691607,1.0465362369445672,1.125,0,3.25,0,2.1333333333333333,0,1.8888888888888888,0,1.8333333333333333,0,1.5,0,0.8571428571428571,0,1.3333333333333333,0,1.6216216216216217,0,0,3,2,-0.7604652731607284,0.9411689737545899,0.09035185029693071,5,1,2,1,1,2,1,2,1,1.4638501094227998,1.5714285714285714,0,1.5,-0.3767559860388676,5,5,5,5,2,3,1,6,6,2,3,1.7043362064926932,4.285714285714286,0,1.7142857142857142,3,3.8333333333333335,3.2559414990859232,-0.7395711320441822,0,-0.783895116604751,2,3,3,3,2,2,4,2,1,2,1,3,1,3,2,2,4,2,4,2,1.0465362369445672,2.6,0,4,0,3.8,0,3.6,0,3.8,0,3,1,1,3,3,1,1,2,1,3,3,3,1,2,2,3,2,2,1,1,0.8870412083230169,1.85,0,"Asian or Asian American (e.g., Chinese, Japanese, and others)",0,18,1,2,NA,1,3,3,Unemployed,3,0,130,63,3,5,2,0,1,2,0,1,TRUE,TRUE,TRUE,TRUE,TRUE,NA,NA,NA,NA,5,0.4456357142840113,0.5226137930935827,0.9032258064516129,0.90625,0.0026703322798492884,0.007883607731792648,5,0.596506451602905,0.6926099999904632,1,0.9375,0.007057545294279032,0.008518031448605756,NA,NA,NA,NA,NA,NA,NA,NA,NA,NA,NA,NA,NA,0.9821,2.696,0.3731,2.5798,0.297,0,-50.5067,0.009,ML,cueing,63,113.4428041791746,2.7997029982972754,0.8103300752608877,0.40503110904640105,3.6317854570645225,0.6150121607988508,0.3773528331922112,0.076,0.394,0.383,0.012,1.649,89.21892222154432,1964.9837235942286,0.076,0.397,0.389,0.013,1.775,108.336300061743,1974.9762779645741,434,1.285925925925926,1,0,0,1,FALSE,FALSE,FALSE
155,2021-11-13T01:36:31Z,2021-11-13T01:57:40Z,1269,1,2021-11-13T01:57:41Z,1,Edge,95.0.1020.44,Windows NT 10.0,1536,864,No,1.7777777777777777,660,56,280,89,69,66,-0.3319603397900577,-0.30710401489772066,-0.7101222752265024,-0.18988069998108442,-0.04067866192862343,-0.6651245862194046,4,3,1,2,3,1,1,2,1,4,3,1,1,1,4,4,1,1,3,2,1.2258187382102494,0,1,1,4,3,1.45,0,4,5,2,4,2,1,4,1,2,1,1,5,3,4,4,2,1,1,1,1,1,1,2,0,2,0,0,5,4,5,5,4,5,5,5,3,1,5,1,1,3,2,5,1,1,1,1,2,5,1,1,1,3,1,1,1,1,1,5,1,1,1,2,1,1,1,1,1,1.7578652081687294,1.505545305418162,1.25,0,1,0,1.6666666666666667,0,1.4444444444444444,0,1.3333333333333333,0,1.1666666666666667,0,0.8571428571428571,0,1.3333333333333333,0,1.2972972972972974,0,0,0,0,-1.046673960694304,-0.7372407672780129,-0.8919573639861584,5,1,2,1,1,2,1,1,1,1.4638501094227998,1.5714285714285714,0,1,-0.5612498234260587,3,3,4,4,2,2,3,3,3,3,2,0.816496580927726,3,0,3,6,3.8333333333333335,3.2559414990859232,0.9547190977297628,0,0.7802889750751523,2,2,2,3,2,2,3,2,1,1,1,4,3,3,4,3,4,2,3,4,1.1126972805283737,2.2,0,4.2,0,2.6,0,3.6,0,3.466666666666667,0,1,3,2,3,3,2,2,1,1,1,2,3,2,2,1,4,1,1,1,2,0.9119095061289915,1.8,0,"White, Caucasian, Anglo, European American",0,29,1,2,NA,1,3,6,Teacher,4,0,110,62,2,5,2,0,0,0,0,0,TRUE,TRUE,TRUE,TRUE,TRUE,2,0.8640382352979744,0.7555555555555555,0.3726247366387821,2,0.4034968750048429,0.5052133333325386,1,0.967741935483871,0.002340293861043407,0.004879074945883507,2,0.5722624999955297,0.6772413793082895,1,0.90625,0.005585745000405044,0.006373648226414728,1.5694,0.7035,0.4572,0,39.0119,0.003,ML,change,45,-66.60381253068904,0.6146762011329527,1.8358694378240727,0.10076379381831013,0.9942,4.4226,0.3989,4.7183,0.2981,0,-91.8604,0.012,ML,cueing,63,196.15020417917458,3.984466851336383,0.8536141743835567,0.4050064145703166,5.223900496445753,0.7931113406946487,0.3299573223448433,0.07,0.444,0.589,0.007,1.253,73.99315590784512,1963.6028904561072,0.071,0.441,0.583,0.008,1.308,91.43611976206181,1954.2514691632314,374,1.108148148148148,1,0,0,1,FALSE,FALSE,FALSE
156,2021-11-13T00:59:59Z,2021-11-13T01:57:46Z,3466,1,2021-11-13T01:57:47Z,1,Chrome,95.0.4638.69,Windows NT 10.0,1920,1080,nop,1.7777777777777777,1798,171,1046,233,30,105,2.591979326195819,0.7376408911182396,2.9775849016273725,1.5649618409211874,-0.5793489877655722,-0.006361282546134758,2,3,2,2,3,2,2,1,2,1,2,2,2,3,2,3,2,2,2,3,0.5871429486123998,0,1,1,4,4,2.45,0,4,4,3,3,2,2,2,3,2,3,3,2,2,2,3,2,2,1,1,1,1,1,1,0,2,0,0,5,2,4,3,2,4,3,3,3,4,5,4,1,3,2,3,2,3,2,2,3,4,1,1,1,1,1,1,1,4,1,4,2,1,1,1,1,2,1,1,1,1.300842877595981,0.7237468644557459,1.25,0,1.25,0,2.8,0,2.7777777777777777,0,2.5,0,1,0,1.5714285714285714,0,1,0,2.081081081081081,0,0,0,0,-0.22279558792264442,-0.6588395645607719,-0.44081757624170814,4,2,2,1,2,2,1,1,1,1,2,0,1,-0.3048482679606258,4,4,4,3,2,2,2,3,3,1,2,1,3.2857142857142856,0,2.7142857142857144,6,3.8333333333333335,3.2559414990859232,0.9547190977297628,0,0.6209469802322789,2,2,1,2,2,2,4,3,3,4,2,3,3,3,3,3,3,2,3,3,0.5936168397046637,1.8,0,3.6,0,3.4,0,3,0,3.3333333333333335,0,2,1,1,2,1,2,2,2,2,3,2,2,2,2,2,2,1,2,2,1,0.5231483637805969,2,0,"White, Caucasian, Anglo, European American",0,22,0,1,NA,1,3,4,student,1,0,153,65,2,5,2,0,1,0,0,1,TRUE,TRUE,TRUE,TRUE,TRUE,2,0.9226147058820899,0.6938775510204082,0.07131090776359057,2,0.590763333333532,0.6632300000006954,0.9375,0.967741935483871,0.0222326682259929,0.01006408051603291,2,0.6875125000011176,0.7304366666659713,1,0.967741935483871,0.00608248177428162,0.006476533913994683,1.2539,0.6695,0.5868,0,22.5789,0.003,ML,change,49,-33.482339105668125,0.6926566486118625,1.181408314139348,0.5919334785243264,1.8968,4.019,0.4274,2.3853,0.2319,0,-31.8618,0.02,ML,cueing,63,76.15300417917459,3.3247658472300476,1.0229885465455517,0.5193117017729585,2.4140667820736774,1.1217793232613067,0.3874638813170289,0.068,0.549,0.47,0.016,1.187,36.65330643382286,1871.4122286812276,0.067,0.548,0.486,0.016,1.289,50.08130688893492,1876.4951364696462,104,0.3081481481481481,1,0,5,6,FALSE,FALSE,FALSE
157,2021-11-13T01:36:25Z,2021-11-13T02:00:36Z,1450,1,2021-11-13T02:00:37Z,0.8999999761581421,Safari,13.1.2,Macintosh,1440,900,those games hurt my eyes.,1.6,636,141,363,100,60,98,-0.3936251482115524,0.4650987417227717,-0.3105404270817614,-0.05583022810660534,-0.16498719866022699,-0.12460084987210628,1,2,3,2,4,2,1,2,2,2,1,3,2,2,2,2,3,2,2,2,0.7181848464596079,0,1,1,4,2,2.6,0,3,4,3,2,3,3,3,4,3,1,3,3,2,2,2,2,3,1,1,2,4,2,1,1,5,0,0,2,3,3,3,2,4,2,2,2,1,4,3,1,2,3,3,2,2,3,3,4,2,1,1,1,3,1,1,1,1,1,3,3,3,1,1,2,2,4,2,2,0.9863939238321437,0.7988086367179802,2,0,2.5,0,3,0,3.4444444444444446,0,2.5833333333333335,0,1.6666666666666667,0,1.7142857142857142,0,1.3333333333333333,0,2.4324324324324325,0,1,0,0,0.3364583169028547,-0.06374107717804986,0.13635861986240244,5,1,3,1,1,3,1,2,1,1.5735915849388864,1.5714285714285714,0,1.5,-0.3767559860388676,4,4,5,5,2,2,2,6,6,3,3,1.3972762620115438,3.7142857142857144,0,2.2857142857142856,3,3.8333333333333335,3.2559414990859232,-0.7395711320441822,0,-0.465211126919004,4,4,4,3,4,3,4,3,3,4,3,2,2,4,3,2,3,4,3,3,0.7037315505489968,3.8,0,2.6,0,3.8,0,3.2,0,3.2,0,1,1,1,3,4,2,3,3,1,3,1,3,1,2,2,3,2,2,2,3,0.9333020044867296,1.95,0,"White, Caucasian, Anglo, European American",0,22,1,2,NA,1,3,5,surgical technologist,3,0,130,67,1,5,2,0,0,1,0,0,TRUE,TRUE,TRUE,TRUE,TRUE,1,0.9691190476190477,0.84,0.06001889795918397,1,0.4504666666666725,0.5035000000000155,0.9375,0.9375,0.005346458669354541,0.005973770161290237,1,0.598193548387093,0.7194137931034503,0.96875,0.90625,0.013990176411290592,0.025633060483869995,1.4748000000000001,1.1845,0.5688,0,20.4136,0.004,ML,change,50,-29.09113098371556,1.3412506368910848,1.2363297589533129,0.6557159397417086,1.0182,3.0974,0.3549,2.7832,0.2861,0,-56.0145,0.011,ML,cueing,64,124.50564925007902,3.3530115513008782,0.80764714337222,0.39811842889022986,3.44731225645216,0.7855540779729743,0.3507716336826636,0.082,0.359,0.345,0.01,1.337,142.41154775949263,2135.9483806027074,0.082,0.368,0.335,0.01,1.408,171.3796794732848,2100.3355059698692,422,1.2503703703703704,1,0,0,1,FALSE,FALSE,FALSE
158,2021-11-13T01:27:49Z,2021-11-13T02:01:22Z,2013,1,2021-11-13T02:01:23Z,1,Chrome,95.0.4638.69,Windows NT 10.0,1536,864,NA,1.7777777777777777,840,84,616,163,89,169,0.1305257233711531,-0.0527313421286173,0.9074620738895578,0.7119133835381386,0.23556253080827336,1.074686190148462,3,3,1,1,4,1,1,2,1,2,2,1,1,1,3,2,1,1,3,3,0.9880869341680844,0,1,2,4,3,1.65,0,4,4,3,5,2,1,4,1,2,1,1,5,3,4,4,1,2,1,1,1,1,1,2,0,2,0,0,5,3,3,4,2,5,4,3,5,1,5,1,1,3,2,5,2,1,1,3,2,5,1,1,1,1,1,1,1,1,1,5,1,1,1,1,1,1,1,1,1,1.5962606453985038,1.486446705914413,1.25,0,1,0,1.7333333333333334,0,2.2222222222222223,0,1.5833333333333333,0,0.8333333333333334,0,0.8571428571428571,0,1,0,1.4864864864864864,0,0,0,0,-0.9367202680875601,-0.7372407672780129,-0.8369805176827865,5,2,4,1,1,2,2,3,1,1.5118578920369088,1.5714285714285714,0,2,-0.19226214865167657,4,4,4,5,3,3,2,5,5,4,4,0.9759000729485332,3.857142857142857,0,2.142857142857143,4,3.8333333333333335,3.2559414990859232,-0.1748077221195339,0,-0.2625004193781165,2,2,3,3,3,2,5,2,2,2,1,4,3,3,4,3,4,2,4,4,1.1338934190276817,2.6,0,4.2,0,3.4,0,3.4,0,3.6666666666666665,0,2,1,3,1,3,3,3,1,2,2,1,2,1,1,1,2,3,3,2,3,0.8583950752789521,2.4,0,"Hispanic of Latino (e.g., Mexican American, Central American, and others) & Middle Eastern",1,25,1,2,NA,1,3,5,Part business owner,1,0,150,61,1,5,2,0,0,0,0,0,TRUE,TRUE,TRUE,TRUE,TRUE,2,1.0167709677450119,0.6326530612244898,0.21851093171677444,2,0.806848387087545,0.8597781249955296,1,1,0.16386319791441112,0.09687389403494752,2,1.1723968750089406,1.9461299999793371,1,1,0.2901456338435035,0.4989787104262279,1.6151,0.3469,0.3398,0,50.7787,0.003,ML,change,49,-89.88193910566812,0.3540380148966767,1.5354719654826665,0.44145123349245186,2.3298,2.3105,0.3556,2.1894,0.2747,0,3.0088,0.009,ML,cueing,63,6.411804179174597,2.059495299184206,2.0117233227153686,0.3866386695055166,1.805893512397477,2.294229808097139,0.1914923012119445,0.159,0.315,0.126,0.133,1.793,180.46761140458926,1984.930184185752,0.193,0.188,0.183,0.003,1.918,63.18707699859811,1844.4682493998703,380,1.125925925925926,1,0,0,1,FALSE,FALSE,FALSE
159,2021-11-13T01:24:43Z,2021-11-13T02:01:22Z,2198,1,2021-11-13T02:01:23Z,1,Firefox,91.0,Macintosh,1440,900,n/a,1.6,1382,135,373,87,59,78,1.52312264688991,0.4105903118436781,-0.2623980357390215,-0.21425351304917153,-0.17879925829707183,-0.4624281850891678,3,2,3,3,2,2,3,2,3,2,2,3,3,1,3,3,4,1,2,2,0.7591546545162482,0,0,5,5,5,2.65,0,1,3,3,4,2,1,2,5,4,3,1,1,1,1,1,5,4,1,1,4,5,4,4,1,5,0,0,5,2,4,4,5,5,4,4,4,1,4,1,1,1,4,1,5,5,4,5,4,2,1,1,1,1,1,1,1,1,1,4,1,1,5,5,5,4,4,1,1,1.756156053454272,1.3732131246511903,3.5,0,2.5,0,3.2666666666666666,0,1.8888888888888888,0,3.5,0,1.3333333333333333,0,1,0,5,0,2.4594594594594597,0,1,0,0,1.1072956478184441,-0.06374107717804986,0.5217772853201972,3,1,3,4,1,2,3,1,1,1.1338934190276817,2.4285714285714284,0,1,-0.048446712495193056,3,2,4,3,1,1,5,1,1,2,3,1.4960264830861913,2.142857142857143,0,3.857142857142857,8,3.8333333333333335,3.2559414990859232,2.0842459175790595,0,1.8230783695284214,2,3,3,3,3,3,4,2,2,2,1,4,1,4,4,1,4,4,4,3,1.245945806357946,2.8,0,3.6,0,4,0,3.8,0,3.8,0,2,1,3,2,3,3,2,2,3,2,3,2,3,3,1,2,2,3,2,3,0.6708203932499369,2.55,0,"Asian or Asian American (e.g., Chinese, Japanese, and others)",0,28,1,2,NA,1,2,6,Dental Assistant,2,0,134,65,4,5,2,0,0,1,0,0,TRUE,TRUE,TRUE,TRUE,TRUE,NA,NA,NA,NA,3,0.4886875,0.5901935483870968,1,1,0.010076092741935485,0.026387427956989253,3,0.76325,0.8537741935483871,1,0.96875,0.05639509677419355,0.02860787096774193,NA,NA,NA,NA,NA,NA,NA,NA,NA,NA,NA,NA,NA,1.461,3.4194,0.3766,4.4508,0.3246,0,-63.1795,0.009,ML,cueing,63,138.7884041791746,2.850776888079654,1.4533353149156611,0.3432576004685363,3.626514809543041,1.1424563097023692,0.3360954649265755,0.099,0.442,0.294,0.041,1.724,150.72258432515787,2019.215794136347,0.096,0.442,0.288,0.018,1.886,128.39424662140826,1956.0424807417735,356,1.0548148148148149,1,0,2,3,FALSE,FALSE,FALSE
160,2021-11-13T01:35:43Z,2021-11-13T02:02:02Z,1579,1,2021-11-13T02:02:04Z,1,Chrome,95.0.4638.69,Windows NT 10.0,1920,1080,nope,1.7777777777777777,715,89,466,80,85,78,-0.19064515382413216,-0.0073076505627059805,0.18532620374845948,-0.29955835878747644,0.18031429226089402,-0.4624281850891678,3,4,2,2,3,1,2,2,1,2,1,1,1,1,2,2,2,1,3,2,0.8522416262267903,0,1,1,3,3,2,0,4,4,1,4,2,1,4,2,2,1,2,4,1,3,1,2,2,1,1,1,3,3,2,0,3,1,1,4,2,2,3,3,5,3,4,2,2,5,2,1,3,2,5,2,2,2,1,2,4,2,1,1,3,2,2,1,1,1,4,2,2,2,1,2,2,2,1,2,1.1867638385156536,1.2983506020002016,1.875,0,1.75,0,2,0,2.888888888888889,0,1.75,0,1.6666666666666667,0,1.4285714285714286,0,1.6666666666666667,0,2,0,0,1,1,-0.3328460707517538,-0.11895430463408513,-0.22590018769291947,4,2,3,1,1,2,2,1,1,1.0690449676496976,1.8571428571428572,0,1,-0.39031545311577004,5,4,4,5,2,3,2,6,4,3,3,1.2724180205607036,3.857142857142857,0,2.142857142857143,4,3.8333333333333335,3.2559414990859232,-0.1748077221195339,0,-0.2625004193781165,3,3,4,5,4,3,4,3,2,2,1,4,4,3,3,4,4,1,2,3,1.0600988273786194,3.8,0,4.2,0,2.4,0,3.2,0,3.2666666666666666,0,3,1,4,1,3,3,4,2,3,2,2,2,1,4,1,2,3,3,3,4,1.050062654772261,2.85,0,"White, Caucasian, Anglo, European American",0,21,1,3,NA,1,3,3,unemployed,3,0,285,68,1,5,2,0,0,1,0,0,TRUE,TRUE,TRUE,TRUE,TRUE,6,0.8393651162302771,0.8775510204081632,0.03348516066071212,6,0.45966875000298024,0.5148843750208616,1,1,0.0018223048073499816,0.0024970807158889116,6,0.6182125000357628,0.6504354838248222,1,0.96875,0.009610740490152607,0.00733811950286896,1.5131,1.6118,0.5014,0,2.8132,0.006,ML,change,49,6.049060894331879,1.7674622419021198,1.114275937428808,0.6013424828642814,3.8824,9.1314,0.3023,10.4623,0.2741,0,-109.2822,0.013,ML,cueing,64,231.04104925007903,5.139896207688429,0.80607361685516,0.4389213803634633,5.561055624669261,0.7450266650835635,0.3947759822883409,0.066,0.411,0.327,0.035,1.582,115.34316806761628,1978.3705047086703,0.069,0.413,0.341,0.022,1.631,139.29226717436399,1965.1994661231386,424,1.2562962962962962,1,0,0,1,FALSE,FALSE,FALSE
161,2021-11-13T01:37:57Z,2021-11-13T02:02:04Z,1447,1,2021-11-13T02:02:05Z,1,Chrome,95.0.4638.69,Macintosh,1440,900,none!,1.6,703,71,337,112,52,82,-0.22147755803487953,-0.1708329401999867,-0.43571064457288505,0.09040665030191732,-0.2754836757549857,-0.39486271804575546,2,2,3,2,2,1,2,1,1,3,2,2,3,2,2,2,3,2,2,2,0.6048053188292994,0,1,4,3,2,2.55,0,4,4,2,4,2,2,4,3,2,2,2,3,4,4,2,3,2,1,1,1,2,2,3,0,2,0,0,3,1,2,4,4,5,5,4,4,2,5,1,1,2,2,3,2,2,2,1,1,4,1,1,1,1,1,1,1,1,1,4,1,1,1,1,1,1,1,1,1,1.4099602788688723,0.9611501047232549,1.875,0,1,0,2.4,0,2.4444444444444446,0,1.8333333333333333,0,1,0,1,0,1,0,1.6756756756756757,0,0,0,0,-0.3003245560370831,-0.7372407672780129,-0.5187826616575479,5,1,3,1,1,1,1,2,1,1.5735915849388864,1.2857142857142858,0,1.5,-0.5476903563491562,4,4,4,4,3,3,2,3,7,4,4,0.7867957924694432,3.7142857142857144,0,2.2857142857142856,4,3.8333333333333335,3.2559414990859232,-0.1748077221195339,0,-0.18282942195667984,2,2,2,3,2,2,4,2,2,5,1,4,2,4,5,1,5,1,5,1,1.6676187756655838,2.2,0,4.6,0,4.6,0,4.4,0,4.533333333333333,0,3,2,3,1,4,2,3,2,2,2,3,2,2,4,2,2,3,2,3,3,0.7608859102526822,2.8,0,"White, Caucasian, Anglo, European American",0,24,1,2,NA,1,2,6,writer,2,0,210,66,3,5,2,0,0,1,0,0,TRUE,TRUE,TRUE,TRUE,TRUE,1,0.9807794871635926,0.78,0.12830292320049497,1,0.5061687500029802,0.6172033333539962,1,0.967741935483871,0.00783248156900856,0.014294363286018876,1,0.7782812499776482,0.8674843749776483,1,1,0.024782331898510895,0.024348805883428717,1.4992,0.8935,0.5536,0,30.1409,0.003,ML,change,50,-48.54573098371556,0.887218775194864,1.4265549926547618,0.5305687735145228,1.3526,2.8329,0.4046,4.9015,0.3682,0,-62.5544,0.008,ML,cueing,63,137.5382041791746,3.045533539030137,1.1167821132402576,0.4456846748114555,3.8622256961037347,1.0727324222846901,0.3716336896701957,0.108,0.482,0.335,0.042,1.814,86.63242115571767,1882.0218888026093,0.102,0.49,0.335,0.024,1.938,88.56816258223789,1871.2067135055304,352,1.0429629629629629,1,0,0,1,FALSE,FALSE,FALSE
162,2021-11-13T01:36:04Z,2021-11-13T02:02:58Z,1613,1,2021-11-13T02:02:59Z,1,Chrome,95.0.4638.69,Windows NT 10.0,1536,864,NA,1.7777777777777777,642,83,460,123,94,88,-0.3782089461061787,-0.06181608044179956,0.15644076894281556,0.2244571221763964,0.30462282899249754,-0.293514517480637,4,3,1,1,3,1,1,3,1,4,4,1,2,1,3,3,1,1,4,4,1.3018205875255096,0,1,1,3,2,1.3,0,2,3,3,3,5,4,2,4,3,4,3,2,3,1,2,3,2,1,2,2,3,4,4,0,3,0,0,3,2,4,3,2,4,1,2,2,4,2,4,2,4,3,4,5,4,4,3,3,4,1,1,1,3,1,3,1,1,1,2,5,4,2,2,3,1,2,1,1,1.244205790071742,1.0327955589886444,2.625,0,1.25,0,3.7333333333333334,0,3.4444444444444446,0,3.3333333333333335,0,1.3333333333333333,0,2.5714285714285716,0,2.3333333333333335,0,2.864864864864865,0,0,0,0,1.106037374927698,-0.6588395645607719,0.22359890518346304,4,2,3,2,2,3,3,3,2,0.7559289460184544,2.4285714285714284,0,2.5,0.5050347996663801,4,3,4,5,3,3,2,8,6,NA,3,0.9759000729485332,3.7142857142857144,0,2.2857142857142856,2,3.8333333333333335,3.2559414990859232,-1.3043345419688306,0,-0.7475928318813282,3,4,4,3,3,4,5,3,3,4,2,3,2,4,4,5,4,3,4,3,0.9154754164341269,3.4,0,3.2,0,3.6,0,3.4,0,3.4,0,2,1,2,3,3,2,3,3,2,1,3,3,2,2,2,3,1,2,1,3,0.7677718959499145,2,0,"White, Caucasian, Anglo, European American & Middle Eastern",1,29,0,1,NA,0,3,5,Social Worker,3,0,234,72,2,5,2,0,0,1,0,0,TRUE,TRUE,TRUE,TRUE,TRUE,3,0.6686911111103164,0.9,0.02123268561714808,3,0.4355656249960885,0.5118937500016764,1,1,0.0020422765221942544,0.0027910902821637958,3,0.5691250000018626,0.6298419354836787,1,0.96875,0.009373683870736917,0.016087007085763348,1.4345,1.8638,0.3709,0,-5.0223,0.004,ML,change,50,21.78066901628444,2.138894671252024,1.0272710511967622,0.47657860271915964,2.8115,8.0243,0.3367,8.7004,0.274,0,-105.9921,0.009,ML,cueing,64,224.460849250079,4.998837546869435,0.8288196380748973,0.4315831761075626,5.404852646134956,0.7665583129919951,0.36686778859512426,0.077,0.355,0.339,0.03,1.564,71.08242869145097,1910.035218942855,0.078,0.356,0.347,0.02,1.655,87.61537331488239,1911.0805895909225,396,1.1733333333333333,1,0,1,2,FALSE,FALSE,FALSE
163,2021-11-13T01:41:51Z,2021-11-13T02:03:14Z,1282,1,2021-11-13T02:03:15Z,1,Firefox,94.0,Macintosh,1440,900,No,1.6,672,57,289,77,54,77,-0.3011279355793103,-0.2980192765845384,-0.6667941230180365,-0.3361175783896071,-0.24785955648129604,-0.47931955185002084,2,4,3,3,2,1,1,2,1,2,2,3,3,3,2,3,1,1,2,2,0.8750939799154206,0,1,1,3,2,2.35,0,5,5,3,4,2,2,4,3,2,1,1,5,3,5,5,1,1,1,1,1,1,2,1,0,2,0,0,5,5,5,4,5,5,5,5,5,1,5,1,1,4,2,5,3,1,1,1,3,5,1,1,1,4,2,1,1,1,1,5,1,2,1,3,1,3,1,1,1,1.7971448827876204,1.4960264830861913,1.125,0,1.5,0,1.7333333333333334,0,1.1111111111111112,0,1.5,0,1.5,0,1,0,1.6666666666666667,0,1.3783783783783783,0,0,0,0,-1.03689814823543,-0.5804383618435307,-0.8086682550394804,5,1,5,1,1,1,1,1,1,1.9518001458970664,1,0,1,-0.9031185640466358,3,3,5,3,2,2,4,3,3,2,2,1.0690449676496976,2.857142857142857,0,3.142857142857143,6,3.8333333333333335,3.2559414990859232,0.9547190977297628,0,0.8599599724965891,2,2,2,3,2,2,4,2,1,3,1,4,2,4,4,1,5,2,4,1,1.3972762620115438,2.2,0,4.4,0,4,0,4.4,0,4.266666666666667,0,2,1,2,4,3,1,3,3,1,1,4,3,2,2,1,3,2,2,1,3,1.0052493799000692,1.9,0,"White, Caucasian, Anglo, European American",0,23,1,2,NA,1,2,6,teacher,2,0,160,68,3,5,2,0,0,0,0,0,TRUE,TRUE,TRUE,TRUE,TRUE,4,0.7727941176470589,0.68,0.06633596571428572,4,0.42525,0.4566,1,0.9375,0.00484967741935484,0.002780286290322581,4,0.54990625,0.6020689655172414,1,0.90625,0.0067779586693548395,0.005355394153225807,1.4267,0.5622,0.3538,0,34.199,0.004,ML,change,50,-56.66193098371556,0.6527724923214574,1.1547236000949406,0.454382648931656,0.9617,4.1942,0.3529,4.0539,0.3066,0,-86.2127,0.01,ML,cueing,64,184.90204925007902,4.059521046779073,0.6670861340282607,0.3847072372148618,4.353958461114979,0.9515788364527811,0.31938748362018565,0.053,0.423,0.437,0.022,1.884,66.73005020409178,1923.2294004441987,0.053,0.424,0.486,0.024,2.009,79.39896662188897,1936.0299494371343,434,1.285925925925926,1,0,0,1,FALSE,FALSE,FALSE
164,2021-11-13T01:34:22Z,2021-11-13T02:04:33Z,1811,1,2021-11-13T02:04:34Z,1,Safari,15.0,Macintosh,1440,900,NA,1.6,760,219,458,90,85,119,-0.07502363803382947,1.1737083301509883,0.14681229067426757,-0.17769429344704088,0.18031429226089402,0.2301178521058083,3,3,1,2,2,1,2,2,1,2,3,1,1,1,3,2,2,1,2,1,0.7677718959499145,0,1,1,3,3,2,0,2,4,3,4,2,4,2,4,4,4,4,3,2,2,3,2,5,1,1,2,4,4,3,0,2,0,0,4,4,2,3,4,4,5,4,3,1,5,2,1,3,3,5,4,2,2,5,5,1,1,1,1,1,1,1,1,1,1,4,2,2,1,3,2,1,1,1,1,1.4821257357919053,0.9154754164341269,2.75,0,1,0,3.2666666666666666,0,2.3333333333333335,0,2.5,0,1.5,0,1.2857142857142858,0,2,0,2.081081081081081,0,0,0,0,0.6223766337693353,-0.7372407672780129,-0.05743206675433882,5,2,4,2,2,2,2,1,1,1.2535663410560174,1.8571428571428572,0,1,-0.39031545311577004,4,4,5,4,1,1,3,6,1,2,3,1.5735915849388864,3.142857142857143,0,2.857142857142857,5.5,3.8333333333333335,3.2559414990859232,0.6723373927674386,0,0.5594271251725536,2,2,2,3,3,1,4,2,2,2,2,4,3,4,4,2,4,3,4,3,1.0327955589886444,2.4,0,4,0,3.4,0,3.8,0,3.7333333333333334,0,3,3,4,2,3,4,4,2,3,4,3,2,3,3,1,2,4,4,2,2,0.9119095061289915,3.1,0,"Hispanic of Latino (e.g., Mexican American, Central American, and others)",0,25,1,2,NA,1,3,6,Production Assistant,2,0,93,59,3,5,2,0,0,1,0,0,TRUE,TRUE,TRUE,TRUE,TRUE,2,0.8312750000000008,0.8,0.04497634448979478,2,0.6047187499999909,0.6411666666666687,1,1,0.004809434475807099,0.003403522988505413,2,1.0838437500000109,1.5381249999999926,1,1,0.14963955544354865,0.19321024193549252,1.3192,1.1248,0.4904,0,14.0715,0.004,ML,change,50,-16.40693098371556,1.245975947435961,1.1126172732087525,0.5633844499059097,10,10.8226,0.1792,10.4479,0.1262,0,-83.2177,0.02,ML,cueing,62,178.81680315513526,4.756969011446283,0.8709610502869087,0.5524816746649113,4.363037957799045,0.9495985976893854,0.49929637568083046,0.19,0.457,0.275,0,0.586,56.620811304701085,2228.8093087713237,0.173,0.481,0.29,0,0.51,43.20992490907725,1975.04223246697,434,1.285925925925926,1,0,0,1,FALSE,FALSE,FALSE
166,2021-11-13T01:27:19Z,2021-11-13T02:04:45Z,2246,1,2021-11-13T02:04:46Z,0.8999999761581421,Chrome,95.0.4638.69,Windows NT 10.0,1440,900,No,1.6,1501,56,377,89,78,95,1.8288773219798216,-0.30710401489772066,-0.24314107920192551,-0.18988069998108442,0.08362987480298012,-0.1752749501546655,3,2,2,2,3,2,1,3,1,2,3,1,3,1,3,2,1,1,2,2,0.7947194142390263,1,1,2,4,4,2,0,2,5,2,5,2,2,4,3,1,2,1,4,2,3,4,3,4,4,2,2,3,3,2,1,3,0,0,4,4,4,5,3,5,5,5,5,2,5,3,1,3,2,5,5,3,4,4,4,2,1,1,1,2,1,3,2,2,1,3,3,3,1,1,1,1,1,1,1,1.489704406658992,1.3201731488169053,2.875,0,1,0,2,0,1.5555555555555556,0,2.75,0,1.5,0,2.2857142857142856,0,1,0,2.081081081081081,0,1,0,0,0.13174699660068598,-0.5341482934814965,-0.20120064844040525,5,1,5,1,1,1,1,1,1,1.9518001458970664,1,0,1,-0.9031185640466358,5,5,5,5,2,3,1,4,4,5,4,1.7043362064926932,4.285714285714286,0,1.7142857142857142,5,3.8333333333333335,3.2559414990859232,0.38995568780511447,0,-0.21913170668010262,2,4,3,4,4,2,3,4,2,1,1,4,4,2,4,5,4,1,4,4,1.3627702877384937,3.4,0,4.4,0,2.2,0,2.8,0,3.1333333333333333,0,1,1,2,3,2,3,3,3,2,1,1,3,1,3,1,3,2,3,2,3,0.8750939799154206,1.95,0,"White, Caucasian, Anglo, European American",0,21,0,1,NA,1,4,3,None,3,0,190,69,1,5,2,1,0,1,0,1,TRUE,TRUE,TRUE,TRUE,TRUE,6,1.077733333332198,0.84,0.18861045630988643,6,0.489006250000326,0.5694937499994412,1,1,0.007816603185429188,0.007361727056510311,6,0.6590096774207007,0.7149838709689437,1,0.96875,0.0070247269032245475,0.01185622708655509,1.7197,0.9557,0.5023,0,40.1496,0.008,ML,change,50,-68.56313098371557,1.007373457917261,1.64609069612764,0.5221590006110303,1.462,4.555,0.409,4.911,0.3402,0,-80.5276,0.01,ML,cueing,64,173.53184925007903,3.9225416754263978,1.05623727399688,0.43906430605054453,3.8641856024446746,1.0721883347866057,0.35460762682505687,0.082,0.444,0.414,0.017,1.529,64.54617408389929,1915.1653108166975,0.084,0.446,0.408,0.019,1.579,89.48773324121998,1913.9171156422224,304,0.9007407407407407,1,1,5,6,FALSE,FALSE,FALSE
167,2021-11-13T01:41:11Z,2021-11-13T02:05:21Z,1450,1,2021-11-13T02:05:22Z,1,Chrome,94.0.4606.81,Windows NT 10.0,1536,864,NA,1.7777777777777777,599,64,432,102,62,134,-0.4886917278613569,-0.23442610839226255,0.02164207318314386,-0.03145741503851823,-0.1373630793865373,0.4834883535186044,3,3,2,2,3,1,1,3,1,4,2,1,1,1,3,3,1,1,3,3,1.0208355710680808,0,1,1,4,4,1.6,0,1,4,3,4,1,3,2,4,3,3,2,3,1,3,4,3,4,4,3,3,4,4,4,4,2,3,1,5,3,4,5,5,5,5,5,5,1,5,4,4,4,1,5,1,3,1,4,4,1,4,5,5,5,5,5,5,1,1,5,1,1,1,1,1,2,2,2,1,1.7710552325200466,1.0997835284835873,3.625,0,1.75,0,2.7333333333333334,0,1.3333333333333333,0,2.25,0,4.666666666666667,0,2,0,1,0,2.324324324324324,0,2,3,1,0.8737408412514783,0.7004970581449952,0.7871189496982367,5,2,3,2,1,1,1,1,1,1.4638501094227998,1.5714285714285714,0,1,-0.5612498234260587,5,5,5,5,1,1,3,4,3,3,3,1.9023794624226837,3.5714285714285716,0,2.4285714285714284,5.5,3.8333333333333335,3.2559414990859232,0.6723373927674386,0,0.32041413290824317,1,5,1,1,1,1,5,1,1,5,1,5,1,5,5,1,5,1,5,5,2.065591117977289,1.8,0,5,0,5,0,4.2,0,4.733333333333333,0,1,1,2,3,1,1,4,4,3,1,1,3,2,4,2,2,1,2,1,1,1.1239029738980326,1.8,0,"White, Caucasian, Anglo, European American",0,23,1,2,NA,1,3,6,Lead Orthodontic Assistant,4,0,175,66,2,5,2,0,0,3,0,0,TRUE,TRUE,TRUE,TRUE,TRUE,6,0.6686468749999913,0.6530612244897959,0.016916583971082328,6,0.43127096774193246,0.5133964285714485,0.96875,0.875,0.003925098135088127,0.006526112741947177,6,0.5678937499999738,0.6375700000000031,1,0.9375,0.007156120604836141,0.007096260796371351,1.1394,0.5882,0.3412,0,13.5625,0.008,ML,change,49,-15.449539105668121,0.7770207441330108,0.8140356142605566,0.5082942861691129,1.0075,2.0971,0.3204,4.1602,0.3206,0,-59.2967,0.01,ML,cueing,64,131.07004925007902,2.636981334583378,0.7379309529177048,0.40845669930034256,4.226668497914957,0.8124571884876124,0.3411670697685194,0.063,0.394,0.381,0.012,1.471,174.8909508702622,2038.1766280302975,0.063,0.394,0.374,0.011,1.548,206.48488786092716,2055.92230315846,354,1.0488888888888888,1,0,0,1,FALSE,FALSE,FALSE
168,2021-11-13T01:33:06Z,2021-11-13T02:05:28Z,1941,1,2021-11-13T02:05:29Z,1,Chrome,95.0.4638.69,Windows NT 10.0,1920,1080,Question about education can be more inclusive. My father only attended elementary school in his home country.,1.7777777777777777,829,79,481,105,64,150,0.10226268617796799,-0.09815503369452862,0.25753979076256933,0.0051018045636124325,-0.10973896011284763,0.7537502216922536,2,1,2,2,1,1,1,1,1,2,1,2,2,2,2,3,2,3,2,2,0.6386663736585051,0,1,2,4,3,2.55,0,4,4,2,4,2,1,3,3,2,2,1,3,2,3,4,3,1,2,1,1,1,2,3,1,3,0,3,4,4,4,3,3,4,3,4,4,2,4,1,2,3,2,5,5,5,3,2,3,3,2,5,1,4,1,1,2,1,1,5,2,1,1,2,2,2,2,2,1,1.3710871160797478,1.0465362369445672,1.75,0,1.75,0,2.1333333333333333,0,2.3333333333333335,0,2.5833333333333335,0,2.5,0,1.1428571428571428,0,1.6666666666666667,0,2.2162162162162162,0,1,0,3,-0.23634621905375758,0.23040425536776904,-0.002970981842994269,3,3,2,1,2,3,2,4,1,0.7559289460184544,2.5714285714285716,0,2.5,0.5905019848215247,4,4,4,3,2,2,2,3,1,2,2,1,3.2857142857142856,0,2.7142857142857144,7,3.8333333333333335,3.2559414990859232,1.5194825076544112,0,0.903328685194603,2,3,2,2,2,2,4,1,2,3,2,3,2,4,3,3,5,2,3,2,1.0327955589886444,2.2,0,4,0,3.4,0,4,0,3.8,0,2,2,3,3,3,3,3,2,1,1,3,3,2,1,1,3,2,2,1,3,0.8335087534664907,2.1,0,"Hispanic of Latino (e.g., Mexican American, Central American, and others)",0,29,1,2,NA,1,2,6,unemployed,2,0,107,64,2,5,2,0,0,1,0,0,TRUE,TRUE,TRUE,TRUE,TRUE,1,0.947806249999674,0.6530612244897959,0.05547745791660036,1,0.4559781249994412,0.5541656250003725,1,1,0.0029934985383356224,0.00650932684472627,1,0.6134187500005355,0.6303500000004424,1,1,0.0045160312500505655,0.006101745806471811,1.5982,0.4403,0.3896,0,43.1434,0.008,ML,change,49,-74.61133910566812,0.5774064652252011,1.0954545832749079,0.6574187500543437,10,9.3195,0.0176,11.3733,0.0164,0,-83.0373,0.018,ML,cueing,64,178.55124925007902,4.045092663010044,1.024237284915133,0.43151950136087164,4.9121060196199275,0.8434538484802708,0.3728064759703263,0.152,0.377,0.643,0.064,1.428,23.769677306195774,1806.735467444308,0.154,0.378,0.651,0.082,1.45,42.19879000061073,1825.876556542152,279,0.8266666666666667,1,0,0,1,FALSE,FALSE,FALSE
169,2021-11-13T01:41:28Z,2021-11-13T02:05:48Z,1460,1,2021-11-13T02:05:49Z,0.8999999761581421,Chrome,95.0.4638.69,Windows NT 10.0,1536,864,n/a,1.7777777777777777,589,71,322,262,63,90,-0.5143853980369797,-0.1708329401999867,-0.5079242315869948,1.9183676304084505,-0.12355101974969247,-0.2597317839589309,3,2,2,3,2,2,3,1,2,2,1,2,1,1,2,1,3,1,2,1,0.7451598203705946,0,1,3,4,2,2.65,0,5,5,4,4,2,1,4,1,1,1,1,5,1,4,5,1,1,1,1,1,1,1,1,1,2,0,0,5,5,3,5,5,5,5,5,4,1,5,1,1,3,2,5,1,1,1,1,1,4,1,1,1,2,1,1,2,2,1,5,2,1,1,1,1,1,1,2,2,1.7419915426128034,1.791514389985135,1,0,1.5,0,1.4666666666666666,0,1.3333333333333333,0,1.25,0,1.1666666666666667,0,1.2857142857142858,0,1,0,1.2972972972972974,0,1,0,0,-1.2400608249797573,-0.3773458880470143,-0.8087033565133859,5,1,5,1,1,1,1,1,1,1.9518001458970664,1,0,1,-0.9031185640466358,5,5,5,5,3,3,1,7,5,5,4,1.5735915849388864,4.428571428571429,0,1.5714285714285714,3,3.8333333333333335,3.2559414990859232,-0.7395711320441822,0,-0.8635661140261877,2,3,2,1,2,2,3,2,2,2,1,3,2,3,3,3,4,2,3,2,0.7432233529572065,2,0,4,0,3,0,3.6,0,3.533333333333333,0,2,2,3,1,2,2,2,2,1,1,2,2,1,2,1,2,1,3,3,2,0.6708203932499369,2.15,0,"White, Caucasian, Anglo, European American",0,23,1,2,NA,1,4,6,student,7,0,128,67,2,5,2,0,1,1,0,1,TRUE,TRUE,TRUE,TRUE,TRUE,2,0.7542883720935084,0.86,0.030856720771175954,2,0.39719374999776486,0.46944999999925496,1,1,0.0014147696370695577,0.0032442716130782136,2,0.5367718749986962,0.6194724137926924,1,0.90625,0.004813216280131937,0.006529731683443942,1.3663,1.4514,0.4427,0,6.504,0.004,ML,change,50,-1.2719309837155617,1.698405630953353,1.0688200354230373,0.5277375377464093,10,10.9178,0.0115,15.1852,0.0679,0,-104.5686,0.018,ML,cueing,64,221.61384925007903,4.81430047846768,0.8605891437233745,0.3828646552839857,5.924354825555677,0.6993393961684132,0.34001579054168135,0.058,0.405,0.385,0.02,1.748,75.59726655477085,1973.2206887591344,0.058,0.404,0.409,0.019,1.852,101.7492575419104,1989.96240307686,376,1.114074074074074,1,0,0,1,FALSE,FALSE,FALSE
170,2021-11-13T01:38:56Z,2021-11-13T02:05:51Z,1615,1,2021-11-13T02:05:52Z,1,Chrome,95.0.4638.69,Macintosh,1440,900,NA,1.6,627,76,451,107,57,96,-0.41674945136961294,-0.1254092486340754,0.11311261673434965,0.02947461763169954,-0.2064233775707615,-0.15838358339381242,2,2,2,2,2,2,3,2,1,2,2,2,1,3,2,2,2,1,2,2,0.5104177855340404,0,1,2,4,4,2.45,0,2,3,3,3,3,3,3,4,2,4,5,2,2,3,4,3,5,1,1,4,5,4,4,2,2,0,0,5,3,3,4,5,5,5,5,4,1,5,2,4,4,2,5,4,4,5,5,4,1,1,1,1,1,1,1,2,1,1,4,3,2,1,3,2,2,2,1,1,1.6070415621826906,0.8837151016885368,3.375,0,1.5,0,3.2,0,1.6666666666666667,0,2.9166666666666665,0,1.5,0,1.5714285714285714,0,2,0,2.108108108108108,0,1,0,0,0.8739344216962085,-0.3773458880470143,0.2482942668245971,5,1,3,1,1,1,1,1,1,1.5735915849388864,1.2857142857142858,0,1,-0.7321841937363471,4,4,5,4,2,2,3,5,6,NA,2,1.1338934190276817,3.4285714285714284,0,2.5714285714285716,3.5,3.8333333333333335,3.2559414990859232,-0.4571894270818581,0,-0.16467827959496828,3,3,3,4,3,3,5,2,2,4,2,4,2,5,5,2,3,3,5,2,1.2798809468443688,3.2,0,3.4,0,4.4,0,4.4,0,4.066666666666666,0,3,1,2,2,3,2,4,3,1,4,1,2,3,4,2,2,2,3,4,2,1,2.6,0,"White, Caucasian, Anglo, European American",0,22,1,2,NA,1,3,6,Doctoral student/Graduate assistant,7,0,120,68,3,5,2,0,0,0,0,0,TRUE,TRUE,TRUE,TRUE,TRUE,6,0.6348116279119669,0.86,0.021316455027779346,6,0.42823125000670553,0.4800531250089407,1,1,0.0013409964114432472,0.0021678909567167865,6,0.5410451613049353,0.6488096774239694,1,0.96875,0.004289578559008405,0.006798084153396679,1.1948,1.6504,0.4007,0,-6.4436,0.004,ML,change,50,24.62326901628444,1.8629453635554265,0.9744193265946204,0.4465125159591721,9.9916,12.9819,0.0952,15.7855,0.1118,0,-114.0286,0.021,ML,cueing,64,240.53384925007902,5.3247979850067,0.7780829879476299,0.4092741117302503,6.004206086928813,0.6900387272534095,0.37256402212107265,0.084,0.383,0.53,0.013,1.683,30.922869535839702,1864.3975216281217,0.082,0.39,0.535,0.014,1.745,42.5047332887523,1865.0768501998705,474,1.4044444444444446,1,0,0,1,FALSE,FALSE,FALSE
171,2021-11-13T01:46:41Z,2021-11-13T02:05:59Z,1158,1,2021-11-13T02:06:00Z,1,Firefox,93.0,Windows NT 10.0,1536,864,NA,1.7777777777777777,689,48,225,47,41,66,-0.2574486962807515,-0.3797819214031788,-0.9749054276115718,-0.7017097744109136,-0.42741633176027893,-0.6651245862194046,2,2,2,1,2,1,2,2,1,2,2,2,1,1,2,2,2,1,2,2,0.47016234598162726,0,1,1,3,3,2.2,0,3,3,2,3,2,2,3,2,2,2,2,3,2,3,3,3,2,2,1,3,2,2,3,1,2,0,0,4,2,4,4,4,4,4,4,4,1,4,1,1,4,1,4,2,2,3,2,2,4,1,5,1,2,2,1,2,1,1,3,3,2,1,1,1,2,2,2,1,1.3254270092150517,0.5163977794943222,2.25,0,1.75,0,2.466666666666667,0,2.2222222222222223,0,1.75,0,2,0,1.7142857142857142,0,1,0,1.8918918918918919,0,1,0,0,-0.01760031650865043,-0.2989446853297732,-0.1582725009192118,4,1,3,1,1,1,1,1,1,1.2535663410560174,1.4285714285714286,0,1,-0.6467170085812028,3,3,3,3,1,1,3,4,5,NA,3,0.9759000729485332,2.4285714285714284,0,3.5714285714285716,4.5,3.8333333333333335,3.2559414990859232,0.10757398284279028,0,0.6754004073174131,2,4,2,3,2,2,3,2,2,3,3,4,3,2,3,3,4,2,3,3,0.6761234037828132,2.6,0,3.8,0,3,0,3.2,0,3.3333333333333335,0,1,1,1,3,1,1,1,3,1,2,2,3,1,2,1,3,1,2,1,2,0.812727700887249,1.45,0,"White, Caucasian, Anglo, European American",0,27,1,3,NA,1,3,6,unemployed,7,0,130,63,2,5,2,0,0,0,0,0,TRUE,TRUE,TRUE,TRUE,TRUE,2,0.8794285714285714,0.7,0.05786229591836735,2,0.6719032258064516,0.7355,1,1,0.056885490322580654,0.09041909677419353,2,0.698875,0.815516129032258,1,0.96875,0.009014887096774196,0.00668195060483871,1.3124,0.6772,0.5183,0,25.3865,0.003,ML,change,50,-39.036930983715564,0.7539597233047718,1.1237972456583092,0.5813231923421508,2.2787,2.9966,0.3552,2.9623,0.2873,0,-22.2628,0.012,ML,cueing,63,56.955004179174594,2.0953059838209875,1.9773411417630453,0.2783951079522606,2.352675976723228,1.7610307443025064,0.309337672703992,0.235,0.375,0.728,0.01,1.472,193.13487791983513,2042.2207370665835,0.234,0.373,0.736,0.009,1.466,214.09075766317937,2036.7921672288917,409,1.211851851851852,1,0,0,1,FALSE,FALSE,FALSE
172,2021-11-13T01:17:21Z,2021-11-13T02:06:12Z,2930,1,2021-11-13T02:06:13Z,1,Chrome,95.0.4638.69,Macintosh,1280,800,NA,1.6,785,89,599,338,127,277,-0.010789462594772418,-0.0073076505627059805,0.8256200086069,2.8445345269957607,0.7604207970083773,2.898953800320594,4,4,2,1,2,1,1,3,1,3,2,1,1,1,3,3,2,1,3,4,1.1367080817685316,0,1,4,4,3,1.55,0,3,5,5,4,4,3,2,2,2,2,3,4,1,3,2,4,3,5,2,2,2,3,3,0,2,2,3,3,4,5,5,3,3,2,4,3,3,4,1,2,5,2,5,2,1,1,3,3,3,2,1,1,2,1,2,3,1,1,5,1,1,2,3,1,2,2,2,1,1.3661501990507363,1.1952286093343936,3,0,1.75,0,2.7333333333333334,0,2.4444444444444446,0,1.8333333333333333,0,1.5,0,1.2857142857142858,0,2,0,1.8918918918918919,0,0,2,3,0.4193107472473732,0.4405781967573001,0.42994447200233665,4,2,5,1,1,2,1,1,1,1.6035674514745464,1.4285714285714286,0,1,-0.6467170085812028,4,4,4,4,2,2,1,6,6,6,4,1.2909944487358056,3.5714285714285716,0,2.4285714285714284,3,3.8333333333333335,3.2559414990859232,-0.7395711320441822,0,-0.3855401294975673,3,3,2,2,2,2,5,1,1,1,1,4,1,5,5,1,4,1,5,1,1.8464895909600492,2.4,0,4.4,0,4.2,0,5,0,4.533333333333333,0,1,2,3,3,3,2,4,3,2,2,4,3,2,2,1,3,2,3,2,2,0.8255779474818965,2.25,0,"Asian or Asian American (e.g., Chinese, Japanese, and others) & White, Caucasian, Anglo, European American",1,20,1,2,NA,1,3,4,server,5,0,122,68,2,5,2,1,1,1,0,2,TRUE,TRUE,TRUE,TRUE,TRUE,6,1.0423204545405778,0.88,0.10529103774974533,6,0.4624777777857251,0.5163896551872121,0.8709677419354839,0.90625,0.004929835978674469,0.007165697419988492,6,0.6500624999888241,0.7762000000035322,1,0.8709677419354839,0.008073775323560527,0.013753671979773695,1.6111,1.261,0.5715,0,23.7939,0.004,ML,change,50,-35.85173098371556,1.3384556555733653,1.4886037922837962,0.619692003076848,0.9652,2.5264,0.3484,2.1778,0.295,0,-43.0573,0.011,ML,cueing,63,98.54400417917459,2.8673360678981865,0.7912164767561947,0.4042884971538534,2.691170961691319,0.7230719180443177,0.35448315646407724,0.072,0.47,0.402,0.009,1.586,59.13138489437745,1928.0497541330087,0.072,0.471,0.401,0.009,1.677,72.33941989319389,1935.3277444609475,387,1.1466666666666667,1,0,0,1,FALSE,FALSE,FALSE
173,2021-11-13T01:38:14Z,2021-11-13T02:06:52Z,1717,1,2021-11-13T02:06:53Z,0.8999999761581421,Safari,14.1.2,Macintosh,1440,900,no,1.6,687,162,495,119,102,88,-0.26258743031587606,0.6558782462995992,0.32493913864240515,0.17571149604022218,0.4151193060872563,-0.293514517480637,2,3,2,2,3,1,1,2,1,3,3,1,1,1,2,2,1,1,3,3,0.8522416262267903,0,1,1,3,2,1.8,0,4,4,1,4,1,1,4,1,1,1,1,5,1,4,3,1,2,1,1,1,1,1,1,0,2,0,0,4,2,3,4,2,5,3,3,3,1,5,1,1,4,1,5,1,1,1,1,1,4,1,1,1,2,1,1,1,1,1,5,2,1,1,1,1,1,1,1,1,1.460182225659569,1.5946338585572373,1.125,0,1,0,1.4666666666666666,0,2.7777777777777777,0,1.0833333333333333,0,1.1666666666666667,0,1,0,1,0,1.5405405405405406,0,0,0,0,-1.0818088114128326,-0.7372407672780129,-0.9095247893454228,5,1,3,1,1,2,1,1,1,1.5275252316519468,1.4285714285714286,0,1,-0.6467170085812028,4,4,5,4,1,1,1,5,3,3,3,1.7728105208558367,3.4285714285714284,0,2.5714285714285716,5,3.8333333333333335,3.2559414990859232,0.38995568780511447,0,0.25889427784851804,2,2,2,2,2,2,3,2,1,1,1,4,2,3,4,1,3,2,3,3,1.0465362369445672,2,0,4,0,3.2,0,3.8,0,3.6666666666666665,0,1,1,1,3,1,1,1,4,1,1,1,4,1,1,1,4,1,1,1,1,1.145931016569864,1.05,0,"White, Caucasian, Anglo, European American",0,25,1,2,NA,1,3,6,Recreational Therapist,4,0,135,68,3,5,2,0,0,0,0,0,TRUE,TRUE,TRUE,TRUE,TRUE,NA,NA,NA,NA,4,0.44187096774192797,0.5146999999999845,1,0.967741935483871,0.0029858494623658644,0.008129361290322419,4,0.6451874999999996,0.8263124999999972,1,1,0.023220092741935528,0.06683370564516204,NA,NA,NA,NA,NA,NA,NA,NA,NA,NA,NA,NA,NA,1.8225,3.6045,0.2723,5.921,0.288,0,-67.112,0.009,ML,cueing,62,146.60540315513526,3.507038100488678,0.9698204821864429,0.3853527569955305,4.915248930144023,0.8429145268681506,0.35880564800850867,0.09,0.387,0.325,0.012,1.643,67.90365506004524,1859.3188779544755,0.091,0.386,0.324,0.013,1.685,82.86121289015523,1866.3286524938349,436,1.2918518518518518,1,0,0,1,FALSE,FALSE,FALSE
174,2021-11-13T01:50:39Z,2021-11-13T02:07:04Z,984,1,2021-11-13T02:07:04Z,1,Chrome,95.0.4638.54,Macintosh,1440,900,NA,1.6,550,44,198,59,36,63,-0.6145907117219087,-0.4161208746559078,-1.1048898842369694,-0.555472896002391,-0.49647662994450314,-0.7157986865019639,3,3,1,2,2,1,1,2,2,2,1,1,1,4,3,2,1,1,1,2,0.8944271909999159,0,1,1,3,2,2.2,0,5,5,2,5,1,1,5,1,1,1,1,5,2,5,3,1,1,1,1,1,1,1,1,1,2,0,0,5,5,2,5,5,5,5,5,5,1,5,1,1,3,1,5,1,1,1,3,4,5,1,1,1,1,1,1,1,5,1,5,1,1,1,1,1,1,1,1,2,1.8907868930884504,1.88477610139267,1,0,1.25,0,1.2666666666666666,0,1.3333333333333333,0,1.5833333333333333,0,0.8333333333333334,0,1.4285714285714286,0,1,0,1.3783783783783783,0,1,0,0,-1.2911660623885257,-0.4557470907642554,-0.8734565765763905,5,1,3,1,1,1,1,1,1,1.5735915849388864,1.2857142857142858,0,1,-0.7321841937363471,5,5,5,5,5,5,1,6,6,4,4,1.5118578920369088,5,0,1,3,3.8333333333333335,3.2559414990859232,-0.7395711320441822,0,-1.1822501037119346,4,4,4,3,4,2,4,1,2,3,1,4,1,4,4,1,5,2,2,2,1.3557637102737474,3.8,0,4.4,0,3.8,0,4.2,0,4.133333333333334,0,2,4,1,1,4,1,2,2,3,4,3,3,3,3,1,2,1,3,3,3,1.050062654772261,2.65,0,"White, Caucasian, Anglo, European American",0,21,1,2,NA,1,4,4,Student,4,0,125,65,3,5,2,0,0,1,0,0,TRUE,TRUE,TRUE,TRUE,TRUE,2,0.6263866666654746,0.6122448979591837,0.01607146540847145,2,0.3946068965504909,0.5155233333339294,0.9666666666666667,0.9375,0.002748907172302382,0.013489510957846377,2,0.5868687500003725,0.7297500000006208,1,0.7741935483870968,0.009642124153257343,0.025413815612422348,0.9362,0.5032,0.4333,0,-1.9124,0.004,ML,change,49,15.500260894331879,0.5736378914202156,0.7962486602216429,0.47058306485765067,1.2559,2.6997,0.3021,3.7745,0.235,0,-51.5712,0.015,ML,cueing,62,115.52380315513527,2.735256921006282,0.990053321976766,0.35716587702394487,4.576685386922542,0.7357499031085275,0.3195853633323522,0.067,0.411,0.382,0.009,1.657,79.59938380337991,1944.9094136935337,0.068,0.407,0.408,0.009,1.779,82.55616965183106,1935.4564407629061,376,1.114074074074074,1,0,0,1,FALSE,FALSE,FALSE
176,2021-11-13T01:49:13Z,2021-11-13T02:07:42Z,1109,1,2021-11-13T02:07:44Z,1,Chrome,95.0.4638.69,Macintosh,1440,900,Enjoyed the study!,1.6,612,53,246,57,34,71,-0.4552899566330472,-0.33435822983726743,-0.873806405791818,-0.5798457090704782,-0.5241007492181928,-0.5806677524151392,2,2,3,2,1,2,2,2,1,2,2,3,3,2,1,1,2,1,2,1,0.6708203932499369,0,1,1,5,5,2.75,0,3,4,2,4,2,2,4,2,2,2,2,4,2,3,3,1,2,1,1,1,1,3,1,0,2,0,0,4,3,4,4,4,4,4,4,5,1,4,2,1,4,2,5,3,2,1,1,1,3,1,1,1,1,1,1,1,1,1,4,2,2,1,1,1,1,1,1,1,1.4347677716475786,0.8837151016885368,1.375,0,1,0,2.2,0,2,0,1.5833333333333333,0,1.1666666666666667,0,1.2857142857142858,0,1,0,1.5675675675675675,0,0,0,0,-0.6476078738830316,-0.7372407672780129,-0.6924243205805223,5,1,4,1,1,1,1,2,1,1.7320508075688772,1.1428571428571428,0,1.5,-0.6331575415043005,5,5,5,5,3,3,1,7,7,5,3,1.5735915849388864,4.428571428571429,0,1.5714285714285714,2,3.8333333333333335,3.2559414990859232,-1.3043345419688306,0,-1.145947818988512,2,2,2,3,2,2,4,2,2,3,1,3,3,4,4,2,4,2,4,2,1.01418510567422,2.2,0,4,0,3.6,0,4,0,3.8666666666666667,0,1,1,1,3,1,1,1,3,1,1,2,3,1,1,1,3,1,1,1,1,0.8255779474818965,1.25,0,"White, Caucasian, Anglo, European American",0,21,1,2,NA,1,4,4,Merchandiser,2,0,200,68,1,5,2,0,0,1,0,0,TRUE,TRUE,TRUE,TRUE,TRUE,2,0.6681424999937415,0.8,0.02056705748561951,2,0.5056687499973923,0.6218531249947846,1,1,0.004000275120042123,0.005678926440877102,2,0.5954312500059604,0.6905124999955297,1,1,0.005516413185036105,0.007539125645386365,1.1966,1.2836,0.4023,0,1.7806,0.004,ML,change,50,8.174869016284438,1.5151745147650566,0.9149403897773782,0.4869870527113044,2.1521,6.0336,0.4435,6.2992,0.3348,0,-88.2227,0.011,ML,cueing,64,188.92204925007903,4.185486384897988,0.9898813053939757,0.5072968433090438,4.568672519131864,0.9068574534597652,0.4095228614093782,0.176,0.327,0.662,0.011,1.291,28.661974588877516,1819.3572892343616,0.171,0.33,0.662,0.011,1.377,39.62032765874665,1824.8223096093495,438,1.2977777777777777,1,0,0,1,FALSE,FALSE,FALSE
180,2021-11-13T01:47:16Z,2021-11-13T02:08:45Z,1289,1,2021-11-13T02:08:47Z,1,Chrome,95.0.4638.69,Macintosh,1440,900,NA,1.6,697,50,333,63,34,80,-0.23689376014025323,-0.36161244477681426,-0.454967601109981,-0.5067272698662169,-0.5241007492181928,-0.4286454515674616,3,3,2,2,3,1,1,3,1,2,2,2,2,2,2,2,2,2,2,2,0.6048053188292994,0,1,1,2,1,2.15,0,3,4,3,3,3,1,3,1,1,1,1,2,1,1,1,2,1,1,1,1,1,1,1,0,2,0,0,5,5,3,5,5,5,5,5,5,1,5,1,1,5,1,5,1,1,1,1,1,5,1,1,1,1,1,1,1,1,1,5,1,1,1,1,1,1,1,1,1,1.9234603452371197,1.0997835284835873,1.125,0,1,0,2.466666666666667,0,1.2222222222222223,0,1,0,0.8333333333333334,0,0.8571428571428571,0,1,0,1.054054054054054,0,0,0,0,-0.8611271044204237,-0.7372407672780129,-0.7991839358492183,3,2,2,2,1,4,1,1,1,1.0690449676496976,2.4285714285714284,0,1,-0.048446712495193056,5,5,5,5,3,3,2,3,1,2,2,1.2909944487358056,4.285714285714286,0,1.7142857142857142,7,3.8333333333333335,3.2559414990859232,1.5194825076544112,0,0.3456317032445457,2,3,2,4,2,1,5,3,1,3,1,4,5,3,5,4,3,3,3,3,1.3557637102737474,2.6,0,4,0,2.8,0,3.8,0,3.533333333333333,0,3,3,3,3,3,3,3,3,2,1,4,2,1,3,3,3,3,3,3,3,0.7163503994113789,2.65,0,"Asian or Asian American (e.g., Chinese, Japanese, and others)",0,19,1,2,NA,1,2,3,student,3,0,165,65,2,5,2,0,0,0,0,0,TRUE,TRUE,TRUE,TRUE,TRUE,NA,NA,NA,NA,5,0.6736812500000015,0.8260000000000037,1,1,0.04637172286290405,0.043585362000002806,5,1.1086066666666652,1.3220677419355018,1,1,0.28486076064368604,0.44179980625804166,NA,NA,NA,NA,NA,NA,NA,NA,NA,NA,NA,NA,NA,2.4617,3.2448,0.4467,3.0442,0.2694,0,-23.0742,0.011,ML,cueing,63,58.5778041791746,2.5146487459935796,1.6475997822727766,0.5086371294162433,2.475991711019401,1.6733233427044651,0.34633120657486643,0.223,0.141,0.24,0.014,1.932,62.666645549555355,1867.5906776071786,0.223,0.141,0.24,0.014,1.938,79.031199731248,1862.050875197178,348,1.031111111111111,1,0,0,1,FALSE,FALSE,FALSE
181,2021-11-13T01:40:06Z,2021-11-13T02:09:32Z,1766,1,2021-11-13T02:09:33Z,1,Chrome,95.0.4638.54,Macintosh,1440,900,"No feedback on the study itself but I was impressed by how thorough and thoughtful the options for the demographics were (e.g., sex as assigned at birth and gender being two separate questions).",1.6,689,104,533,130,110,105,-0.2574486962807515,0.12896342413502795,0.5078802257448167,0.3097619679147013,0.525615783182015,-0.006361282546134758,4,4,1,1,3,1,1,2,1,3,3,2,1,2,4,3,1,1,3,3,1.1516578439248717,0,1,2,2,4,1.5,0,3,4,3,3,5,1,4,1,2,1,2,3,3,3,3,3,4,4,1,2,3,3,2,3,2,1,1,4,3,4,3,3,5,4,4,4,3,4,3,1,3,2,5,5,4,5,5,5,1,1,5,1,3,2,1,2,2,1,3,3,3,1,1,2,1,2,2,1,1.4142135623730951,1.162919151265879,2.75,0,1.5,0,2.466666666666667,0,2.2222222222222223,0,3.25,0,2.6666666666666665,0,2,0,1.3333333333333333,0,2.5675675675675675,0,2,1,1,0.487644644237128,0.20882944024170652,0.34823704223941726,5,1,4,1,1,1,1,3,3,1.7320508075688772,1.1428571428571428,0,3,-0.07967602934272733,5,5,5,5,2,1,1,4,3,NA,3,1.9880595947760098,4,0,2,5.5,3.8333333333333335,3.2559414990859232,0.6723373927674386,0,0.081401140643933,4,4,3,3,3,2,4,3,3,3,2,4,3,3,4,3,3,1,3,4,0.8451542547285166,3.4,0,4,0,3.2,0,3,0,3.4,0,2,1,2,4,3,2,4,2,1,1,2,2,3,1,1,2,2,2,1,4,1.0208355710680808,2.1,0,"White, Caucasian, Anglo, European American",0,28,1,2,NA,1,2,7,mental health case manager,2,0,175,64,3,5,2,0,0,1,0,0,TRUE,TRUE,TRUE,TRUE,TRUE,5,1.114410869565185,0.92,0.08661973546539325,5,0.5240750000000698,0.5969933333331098,1,0.9375,0.004434135483824624,0.003499232862944885,5,0.6883249999994878,0.7616687500003027,1,1,0.0053695045161447534,0.004019404798359218,1.8229,1.4714,0.6043,0,20.5635,0.004,ML,change,50,-29.390930983715563,1.613282535308773,1.5138991354057856,0.7202842222146426,1.1209,3.7964,0.4624,4.3752,0.396,0,-78.9796,0.01,ML,cueing,64,170.43584925007903,3.8326924025996005,0.7065660159070999,0.5163391614121678,4.452564861850332,0.930505193060745,0.4228494217383087,0.177,0.444,0.75,0.012,1.323,30.352520707302194,1827.1852530747335,0.178,0.445,0.761,0.012,1.367,40.14657683734256,1825.8141442741658,434,1.285925925925926,1,0,0,1,FALSE,FALSE,FALSE
182,2021-11-13T01:42:04Z,2021-11-13T02:09:56Z,1672,1,2021-11-13T02:09:57Z,0.8999999761581421,Chrome,95.0.4638.69,Macintosh,1440,900,None,1.6,726,55,556,111,68,85,-0.16238211663094707,-0.31618875321090295,0.6186077258331184,0.07822024376787376,-0.054490721565468275,-0.34418861776319626,3,3,2,2,3,1,1,3,1,3,2,1,1,1,3,3,1,1,2,2,0.8870412083230169,0,1,1,3,4,1.75,0,3,4,3,4,4,3,2,4,3,3,3,3,2,3,3,3,4,5,3,1,3,3,2,6,1,1,5,5,2,3,4,4,5,3,5,4,4,4,2,3,3,3,5,3,3,3,2,4,1,5,4,1,3,2,5,5,1,1,4,3,3,1,1,2,2,3,3,1,1.3367074424820065,0.6399404734221844,3,0,2.25,0,3,0,2.111111111111111,0,2.75,0,3.1666666666666665,0,2.7142857142857144,0,1.3333333333333333,0,2.5945945945945947,0,3,1,5,0.8358958643067274,1.3529241097866693,1.0944099870466983,5,1,5,1,1,2,1,2,1,1.889822365046136,1.1428571428571428,0,1.5,-0.6331575415043005,5,5,5,5,4,4,1,7,6,4,4,1.4638501094227998,4.714285714285714,0,1.2857142857142858,2.5,3.8333333333333335,3.2559414990859232,-1.0219528370065065,0,-1.1640989613502233,1,1,1,3,2,2,5,2,1,2,2,3,2,4,5,1,5,2,4,3,1.4074631010979937,1.6,0,4,0,4,0,4.2,0,4.066666666666666,0,1,2,1,2,3,2,3,3,1,1,3,3,2,2,2,3,1,2,2,2,0.7591546545162482,1.95,0,"White, Caucasian, Anglo, European American",0,21,1,2,NA,1,2,5,Teacher,2,0,130,70,1,5,2,0,0,0,0,0,TRUE,TRUE,TRUE,TRUE,TRUE,1,0.6913027777738041,0.72,0.027330334701464655,1,0.4665656250417233,0.5497096773962821,1,0.96875,0.0016238932966311133,0.004131696776416996,1,0.7097749999836087,0.8333166666507721,1,0.9375,0.006311644519133184,0.019114304149505094,1.222,0.8283,0.408,0,15.0875,0.016,ML,change,50,-18.438930983715565,1.0056458693259887,0.9391592385039629,0.48584771772433477,1.586,4.289,0.3721,6.6839,0.3479,0,-87.6548,0.005,ML,cueing,64,187.786249250079,4.172810922641149,0.8229433991012537,0.4572648660975827,5.723650701317169,0.7238622590015991,0.4053073827064228,0.069,0.552,0.427,0.011,1.59,74.65876139939752,1943.9148637618946,0.071,0.548,0.431,0.013,1.661,101.8772907505052,1947.8020937798228,104,0.3081481481481481,1,0,0,1,FALSE,FALSE,FALSE
183,2021-11-13T01:39:50Z,2021-11-13T02:10:52Z,1861,1,2021-11-13T02:10:53Z,1,Chrome,95.0.4638.69,Macintosh,1280,800,NA,1.6,694,93,630,152,113,110,-0.24460186119294008,0.029031302690023072,0.9748614217693936,0.5778629116636594,0.5670519620925495,0.07809555125813061,3,2,1,2,2,1,1,2,1,3,3,1,1,2,2,3,1,1,1,2,0.7863975156570492,0,1,1,2,2,1.95,0,2,4,1,4,2,1,5,1,2,1,1,5,4,4,3,1,3,5,1,2,2,2,1,3,2,0,1,5,3,1,5,5,5,5,5,5,2,5,1,1,3,4,4,3,2,3,3,2,2,1,1,1,3,2,2,1,2,1,4,2,1,1,1,1,2,3,1,2,1.5494840757171082,1.5430334996209192,2.125,0,2,0,1.8666666666666667,0,1.6666666666666667,0,2.25,0,1.8333333333333333,0,1.4285714285714286,0,1,0,1.837837837837838,0,2,0,1,-0.3523976956695021,0.15899863808316506,-0.09669952879316851,4,1,3,1,1,1,1,1,1,1.2535663410560174,1.4285714285714286,0,1,-0.6467170085812028,5,5,5,5,3,3,2,5,6,4,3,1.2909944487358056,4.285714285714286,0,1.7142857142857142,3.5,3.8333333333333335,3.2559414990859232,-0.4571894270818581,0,-0.6427042641235889,2,5,3,4,4,3,4,5,4,4,1,4,3,3,1,5,3,1,3,2,1.3345232785352157,3.6,0,4,0,3,0,2.2,0,3.066666666666667,0,2,1,1,3,2,1,2,2,1,2,2,2,1,1,1,2,1,1,1,2,0.6048053188292994,1.65,0,"White, Caucasian, Anglo, European American",0,21,1,2,NA,1,2,5,Bank Teller,2,0,130,69,2,5,2,0,0,0,0,0,TRUE,TRUE,TRUE,TRUE,TRUE,2,1.0574736842230748,0.76,0.1159144036526479,2,0.5182290322549882,0.5944156250059605,0.96875,1,0.013054311766039344,0.005167915554828913,2,0.6199645161128813,0.7486290322465281,0.96875,0.96875,0.009423737417432262,0.013856429513022612,1.5758,0.7615,0.5164,0,38.8042,0.004,ML,change,50,-65.87233098371557,0.8386752123667083,1.37440512482248,0.6313905865177898,1.3568,4.6774,0.4494,3.1443,0.3108,0,-65.71,0.007,ML,cueing,64,143.896649250079,4.2853237934864445,0.9668195277773327,0.4851349191981633,3.129841334121357,1.0971761306389585,0.35390718448905595,0.342,0.118,0.69,0.012,1.668,167.79200113192618,2052.4968148962853,0.342,0.121,0.691,0.012,1.783,186.27071371226117,2052.860048724535,378,1.12,1,0,0,1,FALSE,FALSE,FALSE
184,2021-11-13T01:48:30Z,2021-11-13T02:11:02Z,1352,1,2021-11-13T02:11:03Z,1,Chrome,95.0.4638.69,Macintosh,1440,900,NA,1.6,664,56,331,93,62,89,-0.3216828717198085,-0.30710401489772066,-0.464596079378529,-0.14113507384491022,-0.1373630793865373,-0.27662315071978394,3,2,4,4,2,3,3,2,3,2,2,3,4,4,2,2,3,3,2,2,0.7863975156570492,0,1,1,4,4,3.15,0,3,5,4,3,3,3,3,4,4,3,4,3,3,3,3,2,2,1,1,2,3,3,3,1,2,0,0,4,2,4,4,3,3,4,4,2,3,5,2,1,3,2,5,3,1,1,1,2,4,1,1,1,3,1,1,2,1,1,4,2,3,1,2,2,2,1,1,1,1.2793110007486985,0.6324555320336759,2.125,0,1.25,0,3.1333333333333333,0,2.6666666666666665,0,1.75,0,1.3333333333333333,0,1.5714285714285714,0,1.6666666666666667,0,1.9189189189189189,0,1,0,0,0.22679499496320607,-0.4557470907642554,-0.11447604790052467,4,2,2,2,1,3,1,1,1,1.0690449676496976,2.142857142857143,0,1,-0.21938108280548152,5,5,5,5,3,3,1,7,7,4,3,1.5735915849388864,4.428571428571429,0,1.5714285714285714,2,3.8333333333333335,3.2559414990859232,-1.3043345419688306,0,-1.145947818988512,1,3,2,3,3,2,3,2,2,3,2,3,2,4,5,4,4,2,3,3,0.9611501047232549,2.4,0,3.8,0,3,0,4,0,3.6,0,2,1,3,1,2,3,4,2,1,2,3,2,4,3,2,2,1,4,3,3,0.99472291830968,2.7,0,"White, Caucasian, Anglo, European American",0,22,1,2,NA,1,3,6,graduate student,6,0,175,63,3,5,2,0,0,0,0,0,TRUE,TRUE,TRUE,TRUE,TRUE,6,0.8466153846161488,0.78,0.08406272392156584,6,0.45199687500158325,0.5267689655166248,1,0.9354838709677419,0.00718073644141256,0.004871731828062409,6,0.5854999999995344,0.6496066666682562,1,0.9375,0.008366613548502096,0.006762336764138204,1.6054,0.8659,0.3391,0,34.3931,0.004,ML,change,50,-57.050130983715555,0.9861409577814692,1.283453813923983,0.4821978385614885,1.0896,3.4947,0.3845,3.9986,0.3157,0,-71.8907,0.006,ML,cueing,63,156.2108041791746,3.5022599859651415,0.7635494395455609,0.43182642357483414,3.947028366975568,1.0496845578959524,0.3231807352482104,0.072,0.377,0.357,0.015,1.578,118.16056637064791,2001.0142289374483,0.073,0.384,0.41,0.015,1.92,118.29052485337651,1964.9382618646725,440,1.3037037037037038,1,0,0,1,FALSE,FALSE,FALSE
185,2021-11-13T01:43:58Z,2021-11-13T02:11:26Z,1647,1,2021-11-13T02:11:27Z,1,Opera,80.0.4170.91,Windows NT 10.0,1920,1080,NA,1.7777777777777777,699,205,413,80,64,111,-0.23175502610512866,1.0465219937664365,-0.06982847036806193,-0.29955835878747644,-0.10973896011284763,0.0949869180189837,2,2,2,2,2,1,3,2,1,2,2,2,1,3,2,2,3,1,2,2,0.6048053188292994,1,1,1,3,2,2.45,0,4,4,2,4,3,2,5,1,1,1,1,5,3,5,2,1,2,1,1,1,1,1,1,1,2,4,4,4,4,5,3,4,5,5,5,5,1,5,1,1,4,2,5,1,3,1,1,1,1,3,5,1,4,1,1,2,2,1,5,1,2,1,1,1,2,2,2,2,1.7032031296650734,1.5522640914238175,1.125,0,2,0,1.8,0,1.5555555555555556,0,1.3333333333333333,0,3,0,1.2857142857142858,0,1,0,1.6756756756756757,0,1,4,4,-0.8804851488934421,1.3117879353562858,0.21565139323142185,5,1,2,1,1,2,1,1,1,1.4638501094227998,1.5714285714285714,0,1,-0.5612498234260587,5,5,4,5,2,3,1,4,2,NA,3,1.618347187425374,4.142857142857143,0,1.8571428571428572,6,3.8333333333333335,3.2559414990859232,0.9547190977297628,0,0.1429209957036584,1,2,2,2,2,2,4,1,1,3,3,4,2,3,5,5,4,1,3,2,1.3557637102737474,1.8,0,4,0,3,0,4.4,0,3.8,0,2,2,4,1,3,4,4,2,4,3,3,2,3,3,1,2,2,4,2,3,0.9787209698591858,3,0,"White, Caucasian, Anglo, European American",0,29,1,2,NA,1,1,2,transcriber,1,0,140,62,2,5,2,0,0,0,0,0,TRUE,TRUE,TRUE,TRUE,TRUE,3,1.1721264705859562,0.68,0.26462373169253234,3,0.5074624999994412,0.6758218749985099,1,1,0.01060449661244984,0.02311444886139153,3,0.7252870967734245,0.752296875,1,1,0.022792641827507783,0.018461948054335268,1.7099,0.4468,0.4983,0,55.86,0.004,ML,change,50,-99.98393098371557,0.46189356487236793,1.6319166572166148,0.536168274502061,2.3442,3.7797,0.3657,4.7685,0.2617,0,-51.835,0.006,ML,cueing,64,116.14664925007901,2.9467385772582886,1.4060068844812144,0.44470718096812256,3.580469511276056,1.1571484447342624,0.3509205224311412,0.223,0.255,0.49,0.078,1.27,109.04064510834496,1893.117756655613,0.234,0.247,0.491,0.094,1.345,136.03385473327398,1922.210431376202,474,1.4044444444444446,1,0,0,1,FALSE,FALSE,FALSE
186,2021-11-13T01:54:39Z,2021-11-13T02:13:34Z,1134,1,2021-11-13T02:13:34Z,0.8999999761581421,Chrome,95.0.4638.69,Macintosh,1440,900,NA,1.6,603,60,257,60,49,70,-0.47841425979110774,-0.2707650616449916,-0.8208497753148042,-0.5432864894683475,-0.31691985466552025,-0.5975591191759924,1,1,4,4,2,3,3,1,1,2,1,4,4,4,1,1,4,1,1,2,1.332784974957958,0,1,2,3,3,3.45,0,2,4,4,3,4,4,2,4,3,3,5,2,1,2,1,3,4,1,1,4,4,4,4,3,2,0,0,3,1,4,2,3,5,3,3,1,1,4,4,1,3,4,2,4,4,5,5,4,2,1,1,1,2,1,1,2,1,1,3,2,2,1,1,2,2,2,2,1,1.365050681609794,1.2227992865708155,3.125,0,1.75,0,3.6,0,3.2222222222222223,0,3.4166666666666665,0,1.5,0,1.5714285714285714,0,1.3333333333333333,0,2.5945945945945947,0,2,0,0,1.1474635900999572,-0.0958522115332568,0.5258056892833503,3,3,2,1,1,2,2,1,1,0.816496580927726,2.2857142857142856,0,1,-0.1339138976503373,2,2,1,1,2,2,3,5,7,4,2,0.6900655593423543,1.8571428571428572,0,4.142857142857143,3,3.8333333333333335,3.2559414990859232,-0.7395711320441822,0,0.570511839559674,3,2,2,1,3,3,5,2,3,4,2,3,2,2,3,1,4,2,3,1,1.1126972805283737,2.2,0,3.6,0,4.2,0,3.4,0,3.7333333333333334,0,3,2,4,1,4,4,4,2,3,3,3,1,2,4,2,1,4,4,4,4,1.145931016569864,3.45,0,"White, Caucasian, Anglo, European American",0,19,1,2,NA,1,3,4,Student,4,0,150,67,2,5,2,0,0,1,0,0,TRUE,TRUE,TRUE,TRUE,TRUE,5,0.6606071428571428,0.84,0.039492183507739136,5,0.42516785713178773,0.4985629629779745,0.9032258064516129,0.84375,0.004419808365343355,0.009806623456074663,5,0.6109624999985099,0.6887760000085831,1,0.78125,0.012989825001648355,0.015055568225480587,1.312,1.3079,0.3188,0,9.9152,0.003,ML,change,50,-8.094330983715563,1.4892038791300233,1.113499702654717,0.4063841286626244,0.9159,1.8001,0.3076,2.9576,0.30620000000000003,0,-45.2267,0.008,ML,cueing,63,102.8828041791746,2.1376399784063516,0.7889069116434981,0.3717002762688556,3.201921289460667,0.6975787408825783,0.3373200542261587,0.059,0.436,0.349,0.012,1.733,78.61943479223542,2005.4778580854083,0.059,0.436,0.361,0.012,1.862,94.39213471464562,1992.52577751676,400,1.1851851851851851,1,1,0,1,FALSE,FALSE,FALSE
187,2021-11-13T01:20:27Z,2021-11-13T02:13:34Z,3186,1,2021-11-13T02:13:35Z,1,Chrome,95.0.4638.69,Windows NT 10.0,1920,1080,nope,1.7777777777777777,1002,1519,316,143,61,74,0.5467631802162428,12.98386813728793,-0.5368096663926388,0.4681852528572675,-0.15117513902338214,-0.5299936521325801,2,2,2,1,1,1,2,3,1,2,2,1,1,2,2,3,1,1,4,4,0.9679060415469871,0,1,4,3,2,1.9,0,4,5,4,5,2,3,3,2,1,1,2,3,1,3,5,1,2,1,1,1,2,2,3,1,2,0,0,5,4,5,5,5,5,5,5,5,1,5,1,1,5,1,5,1,1,2,1,5,4,1,1,1,1,1,1,1,1,1,5,1,1,1,1,1,1,1,1,1,1.921507791343088,1.4375905768565218,1.625,0,1,0,2,0,1.1111111111111112,0,1.4166666666666667,0,1,0,0.8571428571428571,0,1,0,1.1891891891891893,0,1,0,0,-0.788728018091335,-0.5341482934814965,-0.6614381557864157,5,1,3,1,1,1,1,1,1,1.5735915849388864,1.2857142857142858,0,1,-0.7321841937363471,5,5,5,5,2,2,2,7,6,5,3,1.6035674514745464,4,0,2,2.5,3.8333333333333335,3.2559414990859232,-1.0219528370065065,0,-0.7657439742430396,3,3,3,1,2,4,5,4,3,2,1,3,1,3,2,1,5,3,3,2,1.3201731488169053,2.4,0,3.6,0,4,0,2.8,0,3.466666666666667,0,1,3,2,2,2,3,2,3,1,1,2,2,3,3,2,1,1,3,4,3,0.8944271909999159,2.4,0,"White, Caucasian, Anglo, European American",0,24,1,2,NA,1,2,6,Rehab Tech,2,0,122,64,2,5,2,1,0,0,0,1,TRUE,TRUE,TRUE,TRUE,TRUE,1,0.714758536585493,0.8367346938775511,0.037284732789256085,1,0.5003580645159368,0.5386566666662693,0.96875,0.967741935483871,0.0043832547983442,0.0027058998494650373,1,0.6100656249992317,0.7770806451612903,1,1,0.007064978457633246,0.012708054279620613,1.2863,1.3728,0.4016,0,5.3695,0.004,ML,change,49,0.9364608943318782,1.493429000480339,1.094213735302367,0.46803791774446024,1.1048,4.3629,0.4182,3.6276,0.3538,0,-75.6618,0.01,ML,cueing,63,163.75300417917458,4.617178458207262,0.736639792559103,0.4640315843904122,4.111607386705696,0.835193363935589,0.40514058567526307,0.369,0.135,0.766,0.01,1.725,30.798540548594243,1826.1013335774976,0.366,0.139,0.78,0.01,1.78,48.8112314400391,1831.554496367023,301,0.8918518518518519,1,1,3,4,FALSE,FALSE,FALSE
188,2021-11-13T01:38:52Z,2021-11-13T02:13:38Z,2086,1,2021-11-13T02:13:39Z,0.8999999761581421,Firefox,93.0,Macintosh,1440,900,"No, thank you.",1.6,699,158,728,163,133,107,-0.23175502610512866,0.6195392930468702,1.4466568569282445,0.7119133835381386,0.8432931548294463,0.02742145097557139,2,3,3,2,2,1,2,2,1,2,1,3,4,1,1,2,1,1,2,2,0.8522416262267903,0,0,4,2,3,2.5,0,2,5,5,4,1,2,2,4,2,3,4,1,4,1,3,3,4,1,1,3,5,3,4,1,3,0,0,3,4,1,3,3,4,5,5,2,2,4,5,1,3,2,3,2,5,5,5,3,3,1,1,1,1,1,1,1,2,1,4,1,2,1,1,4,1,4,1,2,1.4992490612795952,1.4074631010979937,3,0,2,0,3.2666666666666666,0,2.6666666666666665,0,3.1666666666666665,0,1.1666666666666667,0,1.2857142857142858,0,2,0,2.324324324324324,0,1,0,0,0.8343472207488856,-0.22054348261253207,0.30690186906817674,5,1,4,1,2,2,1,6,1,1.6035674514745464,1.4285714285714286,0,3.5,0.27575217835475235,5,5,5,5,5,4,1,4,7,6,4,1.4960264830861913,4.857142857142857,0,1.1428571428571428,3.5,3.8333333333333335,3.2559414990859232,-0.4571894270818581,0,-0.9613882538093358,1,2,1,1,1,1,5,1,1,3,1,5,3,5,5,1,5,1,5,3,1.8516401995451028,1.2,0,5,0,4.2,0,4.6,0,4.6,0,1,3,2,4,2,1,1,4,1,2,4,3,2,2,2,4,1,2,2,1,1.105012502906165,1.7,0,"White, Caucasian, Anglo, European American",0,25,1,2,NA,1,4,6,Student,4,0,185,67,2,5,2,0,0,1,0,0,TRUE,TRUE,TRUE,TRUE,TRUE,3,0.9230294117647059,0.68,0.12626492897959185,3,0.4726774193548387,0.5599677419354838,0.96875,0.96875,0.004651902217741935,0.006248564516129031,3,0.61203125,0.67240625,1,1,0.006011773185483871,0.011285797379032257,1.5135,0.5174,0.4388,0,41.8919,0.004,ML,change,50,-72.04773098371557,0.5557486601738493,1.3563178040601762,0.48373513680512104,1.2531,3.4206,0.3914,4.1162,0.3263,0,-66.7517,0.009,ML,cueing,64,145.98004925007902,3.762840002056278,0.9126051606256381,0.4462813590944656,4.050915391679701,0.8477064743288191,0.3745854150987664,0.301,0.191,0.726,0.017,1.313,27.21206446058494,1823.044042310907,0.302,0.196,0.729,0.019,1.349,32.88727928386896,1814.947744312568,365,1.0814814814814815,1,0,0,1,FALSE,FALSE,FALSE
189,2021-11-13T01:42:01Z,2021-11-13T02:14:08Z,1927,1,2021-11-13T02:14:09Z,1,Edge,95.0.1020.44,Windows NT 10.0,1600,900,NA,1.7777777777777777,1432,57,204,31,63,98,1.651590997768024,-0.2980192765845384,-1.0760044494313257,-0.8966922789556105,-0.12355101974969247,-0.12460084987210628,3,3,1,1,2,1,1,3,1,3,4,1,1,1,3,3,1,1,3,4,1.145931016569864,0,1,1,5,5,1.45,0,4,3,4,3,3,4,3,3,4,4,3,3,4,4,4,5,5,5,3,4,5,4,4,3,5,2,3,3,3,1,3,2,4,2,1,3,3,3,2,4,4,3,3,3,3,3,2,2,1,3,3,3,2,2,3,3,2,3,2,2,4,1,1,2,2,2,2,3,0.8690542303304526,0.5163977794943222,4.375,0,2.25,0,3.1333333333333333,0,3.5555555555555554,0,2.75,0,2.8333333333333335,0,2.857142857142857,0,1.3333333333333333,0,2.918918918918919,0,2,2,3,1.6234779036914775,1.003565549784815,1.3135217267381463,4,2,4,3,3,3,2,2,2,0.816496580927726,2.4285714285714284,0,2,0.32054096227918905,3,3,5,3,3,3,3,4,3,NA,3,0.7559289460184544,3.2857142857142856,0,2.7142857142857144,5.5,3.8333333333333335,3.2559414990859232,0.6723373927674386,0,0.4797561277511168,3,2,2,3,2,3,3,2,2,3,3,3,2,3,4,4,3,3,4,4,0.7037315505489968,2.4,0,3,0,3.2,0,3.4,0,3.2,0,3,2,3,3,3,1,1,2,2,1,3,2,4,4,4,2,4,4,4,3,1.0699237552766379,2.85,0,"Asian or Asian American (e.g., Chinese, Japanese, and others) & Black or African American & White, Caucasian, Anglo, European American",1,22,1,2,NA,1,3,4,student/part time employee,2,0,175,64,2,5,2,0,0,1,0,0,TRUE,TRUE,TRUE,TRUE,TRUE,1,1.1101878048036156,0.82,0.06763891896739545,1,1.0593935484424715,0.9208344827520436,0.96875,0.9666666666666667,0.27969805488674715,0.10607979703022401,NA,NA,NA,NA,NA,NA,NA,1.5976,1.0363,0.6084,0,28.8803,0.003,ML,change,50,-46.02453098371556,1.211796627152563,1.2513217609221672,0.7797503745262322,2.0681,2.0155,0.4866,1.4508,0.3828,0,21.6711,0.006,ML,cueing,62,-30.960796844864724,1.8362546455361173,1.8337847847913002,0.4547955077204759,1.4547502995984651,2.360533766814128,0.29878177644315673,NA,NA,NA,NA,NA,NA,NA,NA,NA,NA,NA,NA,NA,NA,104,0.3081481481481481,1,0,1,2,FALSE,FALSE,FALSE
190,2021-11-13T01:48:03Z,2021-11-13T02:14:17Z,1574,1,2021-11-13T02:14:18Z,1,Chrome,95.0.4638.69,Windows NT 10.0,1366,768,NA,1.7786458333333333,755,75,404,80,67,102,-0.08787047312164088,-0.13449398694725767,-0.11315662257652782,-0.29955835878747644,-0.06830278120231312,-0.057035382828693984,2,3,2,1,3,1,2,3,1,3,2,1,1,2,2,3,2,1,1,3,0.8255779474818965,0,1,1,4,4,1.95,0,1,2,4,3,2,4,1,5,5,5,5,1,4,1,4,5,5,1,1,4,5,5,5,2,2,0,0,5,3,3,3,4,5,5,5,5,1,5,2,1,4,3,5,1,5,5,5,5,1,1,1,1,3,1,1,2,1,1,4,5,5,1,2,3,1,1,1,1,1.7150631013001945,1.6417180315870614,3.875,0,1,0,4.2,0,1.7777777777777777,0,2.6666666666666665,0,1.8333333333333333,0,2.2857142857142856,0,2,0,2.2432432432432434,0,1,0,0,1.5766314360667735,-0.5341482934814965,0.5212415712926385,5,1,3,1,1,1,1,1,1,1.5735915849388864,1.2857142857142858,0,1,-0.7321841937363471,3,3,3,3,2,2,2,5,6,3,3,0.5345224838248488,2.857142857142857,0,3.142857142857143,3.5,3.8333333333333335,3.2559414990859232,-0.4571894270818581,0,0.1540057100907786,1,4,2,2,2,1,4,1,1,2,1,5,1,4,4,1,5,1,3,2,1.5946338585572373,2.2,0,5,0,3.8,0,4.4,0,4.4,0,1,1,2,3,2,2,2,4,1,2,2,3,1,3,3,3,1,2,2,2,0.8522416262267903,1.8,0,"White, Caucasian, Anglo, European American",0,30,1,2,NA,1,3,6,Office Manager,2,0,260,64,3,5,2,0,0,1,0,0,TRUE,TRUE,TRUE,TRUE,TRUE,1,0.7532567567438693,0.74,0.05621467478567786,1,0.49792187494039536,0.5918741935453107,1,1,0.005285276600858242,0.009081410643662587,1,0.7208656250238419,0.8589843750447035,1,1,0.012118911370970048,0.0243518923199385,1.3889,0.7858,0.3358,0,27.9386,0.003,ML,change,50,-44.14113098371556,0.9215119846220946,1.1350569201893037,0.45764078495903376,3.2406,5.4818,0.2963,7.2845,0.2755,0,-74.2721,0.009,ML,cueing,63,160.97360417917457,3.72198112028521,1.1131530742622493,0.4470095360092563,4.261333892000798,0.972262402194969,0.3874072771645166,0.246,0.267,0.541,0.013,1.634,64.08765929680598,1862.221597178903,0.243,0.274,0.541,0.013,1.758,86.66320695686977,1872.2573280697268,384,1.1377777777777778,1,0,0,1,FALSE,FALSE,FALSE
191,2021-11-13T01:55:57Z,2021-11-13T02:15:02Z,1144,1,2021-11-13T02:15:03Z,1,Chrome,95.0.4638.69,Windows NT 10.0,1280,720,NA,1.7777777777777777,701,41,208,42,27,66,-0.2266162920700041,-0.44337508959545463,-1.0567474928942295,-0.7626418070811315,-0.6207851666761067,-0.6651245862194046,2,1,2,2,1,1,2,1,1,1,1,2,1,2,1,1,2,2,1,1,0.5026246899500346,0,1,2,2,1,2.8,0,2,3,4,3,5,3,3,4,4,3,5,2,2,2,1,4,4,1,1,4,4,4,4,0,2,0,0,2,2,4,3,2,3,3,5,2,4,5,3,3,2,4,3,5,5,5,5,5,1,2,1,1,2,2,2,1,1,1,4,3,3,1,1,4,2,5,1,2,1.4242642060125392,1.162919151265879,3.25,0,2.5,0,3.7333333333333334,0,3.111111111111111,0,3.9166666666666665,0,2,0,1.7142857142857142,0,2,0,2.891891891891892,0,0,0,0,1.3862450686746384,-0.26683355097456624,0.559705758850036,5,1,4,1,1,3,1,2,1,1.7043362064926932,1.4285714285714286,0,1.5,-0.4622231711940119,3,3,4,4,2,1,2,6,6,NA,3,1.1126972805283737,3,0,3,3,3.8333333333333335,3.2559414990859232,-0.7395711320441822,0,-0.0668561398118202,1,3,2,3,2,2,4,2,2,3,1,4,2,3,4,2,5,2,3,3,1.082325538564332,2.2,0,4.4,0,3.6,0,3.6,0,3.8666666666666667,0,2,3,3,1,4,4,3,1,2,2,4,1,2,2,2,1,1,3,3,4,1.0954451150103321,3,0,"Asian or Asian American (e.g., Chinese, Japanese, and others) & White, Caucasian, Anglo, European American & Filipino",1,20,1,2,NA,1,4,4,food service worker and student,5,0,110,70,1,5,2,0,0,1,0,0,TRUE,TRUE,TRUE,TRUE,TRUE,2,0.8908323529292556,0.68,0.039908661223789124,2,0.6231464285765376,0.6856499999920527,0.9333333333333333,0.9375,0.028196224412728246,0.07561721161575942,2,0.6973124999925494,0.8416862068957296,1,0.90625,0.025004186936662624,0.045677690958082884,1.3382,0.5948,0.496,0,28.4417,0.004,ML,change,50,-45.14733098371556,0.7411947240161272,1.0169686560801523,0.6438603330765557,1.0485,2.1505,0.4835,2.5329,0.4695,0,-33.3397,0.007,ML,cueing,62,79.06080315513528,1.7776326247228003,1.523402621801283,0.3107195234871044,2.240284154175612,1.1780011587799624,0.39528820449670254,0.103,0.324,0.267,0.01,1.959,103.75901312545841,2037.6192961889258,0.102,0.326,0.266,0.012,2.07,122.39432779887426,2010.2115116344444,412,1.2207407407407407,1,0,0,1,FALSE,FALSE,FALSE
192,2021-11-13T01:38:01Z,2021-11-13T02:15:16Z,2234,1,2021-11-13T02:15:16Z,0.8999999761581421,Chrome,95.0.4638.69,Windows NT 10.0,2048,1152,I did not encounter any technical issues or problems while completing this survey. I enjoyed participating in this survey and I would be very interested in any other future surveys or studies. Thank you! I hope you have a great night! :),1.7777777777777777,689,87,555,593,81,106,-0.2574486962807515,-0.025477127189070508,0.6137934866988445,5.952068193176867,0.12506605371351465,0.010530084214718316,3,2,1,1,2,1,2,1,1,2,1,2,1,1,2,1,2,1,1,1,0.6048053188292994,0,1,2,2,2,2.35,0,4,3,2,3,3,1,3,3,3,1,1,3,3,3,4,2,1,1,1,1,1,1,2,2,2,0,0,5,1,3,4,3,5,3,3,2,2,4,4,2,3,3,4,5,3,3,3,3,4,1,1,1,1,1,1,2,2,1,3,4,3,1,3,1,2,3,2,3,1.274018494027117,0.9759000729485332,1.25,0,2.5,0,2.4,0,2.7777777777777777,0,2.9166666666666665,0,1,0,2.142857142857143,0,1.6666666666666667,0,2.3783783783783785,0,1,0,0,-0.2669319293211263,-0.06374107717804986,-0.1653365032495881,5,1,2,3,1,2,2,2,1,1.3801311186847085,2,0,1.5,-0.12035443057343476,4,3,4,3,1,1,3,4,5,1,2,1.2535663410560174,2.7142857142857144,0,3.2857142857142856,4.5,3.8333333333333335,3.2559414990859232,0.10757398284279028,0,0.5160584124745394,2,1,1,1,1,2,4,2,1,3,1,3,1,3,4,1,3,2,4,3,1.1254628677422756,1.2,0,3.8,0,4.2,0,3.8,0,3.933333333333333,0,1,2,3,1,2,4,3,2,1,2,2,2,3,2,1,2,2,4,2,3,0.8944271909999159,2.5,0,"White, Caucasian, Anglo, European American",0,29,1,2,NA,1,2,3,Self-employed,1,0,200,69,2,5,2,0,0,1,0,0,TRUE,TRUE,TRUE,TRUE,TRUE,2,0.8902181818160144,0.673469387755102,0.02717414410111965,2,0.4937343750037253,0.5550333333273729,1,0.9375,0.005567386199852311,0.004555585120226285,2,0.6619281250014901,0.713358064524589,1,0.96875,0.0036009743454934605,0.009121074344305166,1.0692,0.7105,0.624,0,6.6002,0.004,ML,change,49,-1.5249391056681212,0.7852658107397038,0.9218774449695989,0.6865705585819466,1.067,3.6385,0.4237,4.0306,0.3614,0,-75.7385,0.009,ML,cueing,64,163.95364925007902,3.5880718864044243,0.7547368856692344,0.46300691971747787,4.206294316487543,0.9849845052809449,0.38030867678870817,0.065,0.53,0.485,0.024,1.304,40.42899871875858,1878.4230070169783,0.06,0.531,0.459,0.024,1.388,56.746956096828576,1882.217728109371,340,1.0074074074074075,1,0,0,1,FALSE,FALSE,FALSE
193,2021-11-13T01:49:59Z,2021-11-13T02:15:26Z,1526,1,2021-11-13T02:15:27Z,1,Chrome,95.0.4638.69,Windows NT 10.0,1920,1080,none,1.7777777777777777,852,145,336,80,18,53,0.16135812758190046,0.5014376949755007,-0.44052488370715903,-0.29955835878747644,-0.7450937034077103,-0.8847123541104946,3,2,4,3,1,1,3,3,2,3,2,3,2,3,2,3,3,3,3,3,0.7539370349250519,0,0,3,3,1,2.6,0,3,3,4,3,3,3,2,3,3,3,5,2,3,3,4,2,4,3,4,2,3,2,3,6,2,2,7,3,3,2,4,3,3,3,2,3,2,3,3,2,3,4,3,2,2,2,3,2,1,4,2,3,2,3,3,2,2,3,2,3,3,1,1,1,3,3,2,1,0.8035207810913453,0.7432233529572065,2.875,0,2.25,0,3.2666666666666666,0,3.111111111111111,0,2.5833333333333335,0,3,0,2.7142857142857144,0,1,0,2.72972972972973,0,3,2,6,0.9548510475934248,1.7360069642788738,1.3454290059361493,3,3,2,5,3,3,3,1,2,0.8997354108424374,3.4285714285714284,0,1.5,0.734317420978008,3,2,5,2,3,3,3,3,2,1,2,1,3,0,3,6.5,3.8333333333333335,3.2559414990859232,1.237100802692087,0,0.9214798275563144,4,2,4,2,2,4,2,3,2,4,2,3,3,3,4,2,2,4,4,3,0.8451542547285166,2.8,0,2.6,0,3.4,0,3.4,0,3.1333333333333333,0,2,2,3,2,3,2,3,3,2,2,3,3,2,2,1,3,2,1,3,3,0.6708203932499369,2.25,0,"White, Caucasian, Anglo, European American",0,23,0,1,NA,1,2,3,dasher,1,0,135,71,1,5,2,0,0,1,0,0,TRUE,TRUE,TRUE,TRUE,TRUE,6,0.6630470588233541,0.6938775510204082,0.09336943443093303,6,0.45955862068821646,0.5132580645142063,0.9354838709677419,0.96875,0.005433158516224352,0.004907670160899071,6,0.5658624999979511,0.6227206896574333,1,0.90625,0.005934092742014197,0.006824598458047662,1.4343,0.6082,0.2148,0,33.1166,0.004,ML,change,49,-54.55773910566812,0.64752392034579,1.2637530410875912,0.2846620494019049,0.9001,4.0409,0.4061,3.1813,0.33,0,-76.6387,0.007,ML,cueing,63,165.70680417917458,3.9970720353543214,0.8591256735208526,0.41250552467983204,3.4080513652382805,0.7846562046284064,0.35929454460773635,0.058,0.424,0.413,0.015,1.521,46.18709588529695,1911.0236191731308,0.058,0.424,0.442,0.015,1.611,57.559083389252926,1913.9817252004757,282,0.8355555555555556,1,0,0,1,FALSE,FALSE,FALSE
194,2021-11-13T01:44:33Z,2021-11-13T02:16:24Z,1910,1,2021-11-13T02:16:25Z,1,Chrome,95.0.4638.69,Windows NT 10.0,1536,864,Thank you for giving me the opportunity to complete this study.,1.7777777777777777,963,105,297,99,82,105,0.4465578665313138,0.13804816244821022,-0.6282802099438446,-0.06801663464064889,0.1388781133503595,-0.006361282546134758,4,2,1,1,3,1,2,4,1,4,3,1,1,1,4,4,1,1,4,2,1.332784974957958,0,1,2,2,1,1.35,0,1,3,4,2,5,1,1,4,5,3,4,3,5,3,4,1,5,1,1,1,1,1,3,0,2,2,5,5,3,1,1,1,5,2,2,3,3,4,1,1,1,4,3,5,5,5,5,4,2,4,3,1,2,1,1,1,1,1,3,4,4,1,5,1,4,2,2,4,1.5820881780112646,1.424279266355945,1.75,0,3,0,3.7333333333333334,0,3.4444444444444446,0,3.5833333333333335,0,2.3333333333333335,0,2,0,2.3333333333333335,0,3,0,0,2,5,0.7880814944583723,1.1854835041418672,0.9867824993001197,5,1,3,1,1,1,1,3,1,1.5735915849388864,1.2857142857142858,0,2,-0.3631965189619651,2,3,4,2,1,1,5,4,2,2,2,1.5118578920369088,2,0,4,6,3.8333333333333335,3.2559414990859232,0.9547190977297628,0,1.3379859570252095,1,1,1,1,1,1,5,1,1,3,1,5,1,4,5,1,5,1,4,3,1.791514389985135,1,0,5,0,4.4,0,4.4,0,4.6,0,3,2,1,3,3,2,3,3,1,1,4,2,1,2,3,2,1,1,2,1,0.9445132413883326,2.05,0,"White, Caucasian, Anglo, European American",0,30,1,2,NA,1,2,5,receptionist,2,0,125,62,3,5,2,0,0,2,0,0,TRUE,TRUE,TRUE,TRUE,TRUE,2,0.8790944444868299,0.72,0.09093996149259939,2,0.48342903232574463,0.5466166667620341,1,0.967741935483871,0.004195329462417479,0.0031597401429203807,2,0.6266500000059605,0.6826678571360452,1,0.9032258064516129,0.010472760635524256,0.006326637199381265,1.5079,0.6607,0.4128,0,37.2362,0.004,ML,change,50,-62.736330983715554,0.7445907216560502,1.2684305368998778,0.5043184635327225,1.6973,4.7722,0.3794,4.2348,0.283,0,-66.5149,0.009,ML,cueing,62,145.41120315513527,4.441623563606308,0.7657554344611335,0.4659759001835788,4.28107414604946,0.9677792500311594,0.3679928545778821,0.064,0.457,0.393,0.026,1.943,116.36017731776126,2030.372278076412,0.064,0.456,0.393,0.022,2.074,137.13212272749004,2025.3113304896845,390,1.1555555555555557,1,0,1,2,FALSE,FALSE,FALSE
195,2021-11-13T01:52:57Z,2021-11-13T02:17:06Z,1448,1,2021-11-13T02:17:06Z,0.800000011920929,Safari,14.1,Macintosh,1280,800,NA,1.6,633,138,340,92,48,110,-0.4013332492642393,0.4378445267832249,-0.4212679271700631,-0.15332148037895377,-0.3307319143023651,0.07809555125813061,4,3,1,1,3,1,1,2,1,4,3,1,1,1,3,4,1,1,3,2,1.190974832912761,0,1,2,4,4,1.45,0,4,5,2,5,1,1,4,2,2,1,1,4,1,5,5,1,1,1,1,1,1,1,1,3,2,0,0,5,5,5,5,5,5,4,5,5,1,5,1,1,5,1,5,1,1,1,1,1,5,1,1,1,1,1,1,2,1,1,5,1,1,1,1,1,2,1,2,1,1.923850618213691,1.7265434778633235,1,0,1.5,0,1.4,0,1.1111111111111112,0,1,0,0.8333333333333334,0,1,0,1,0,1.054054054054054,0,2,0,0,-1.3732441709541232,-0.17425341425049792,-0.7737487926023106,5,1,4,1,1,1,1,1,1,1.7320508075688772,1.1428571428571428,0,1,-0.8176513788914915,5,5,5,5,4,4,1,6,8,5,4,1.4638501094227998,4.714285714285714,0,1.2857142857142858,2,3.8333333333333335,3.2559414990859232,-1.3043345419688306,0,-1.3052898138313853,2,2,3,3,3,2,5,1,1,4,1,4,1,5,5,1,5,2,5,3,1.7728105208558367,2.6,0,4.4,0,4.8,0,4.6,0,4.6,0,1,1,1,4,2,1,1,3,1,1,1,4,1,3,1,3,1,2,1,1,1.0809352675491624,1.3,0,"White, Caucasian, Anglo, European American",0,24,1,2,NA,1,3,6,Analyst,3,0,115,64,3,5,2,0,0,1,0,0,TRUE,TRUE,TRUE,TRUE,TRUE,6,0.8334749999999942,0.8163265306122449,0.03580899659863852,6,0.4980624999999996,0.5579999999999985,1,0.9375,0.0240664475806454,0.015171628024194625,6,0.6905,0.8135625000000036,1,1,0.01021432258064464,0.017966254032255883,1.3199,1.2363,0.5029,0,10.0545,0.003,ML,change,49,-8.433539105668123,1.401701651529745,1.0641743021061592,0.5933193544783018,1.1959,2.5335,0.3492,3.3837,0.3213,0,-48.1337,0.019,ML,cueing,64,108.744049250079,2.6560676381111876,1.0195712497095852,0.3900590878983954,2.917154942985567,1.4202655694905375,0.26223644733311424,0.308,0.26,0.712,0.013,1.528,49.81614606753337,1840.875749726269,0.309,0.255,0.714,0.013,1.576,69.85830719108372,1850.27216530018,340,1.0074074074074075,1,0,0,1,FALSE,FALSE,FALSE
196,2021-11-13T01:54:13Z,2021-11-13T02:17:22Z,1389,1,2021-11-13T02:17:23Z,1,Chrome,94.0.4606.61,Macintosh,1440,900,N/A,1.6,581,50,339,185,97,91,-0.534940334177478,-0.36161244477681426,-0.4260821663043371,0.9800143272870967,0.34605900790303207,-0.2428404171980778,3,3,2,2,3,1,2,3,2,3,3,2,2,2,3,3,2,2,3,3,0.6048053188292994,0,1,1,4,4,1.95,0,2,4,2,3,2,2,3,2,2,2,4,3,2,3,3,2,4,1,1,3,4,4,4,1,2,0,0,3,2,3,3,3,4,3,3,3,2,4,2,1,4,2,3,2,3,4,4,4,3,2,1,1,3,3,1,1,1,1,3,3,2,2,3,3,2,2,3,2,0.9871547368444699,0.7367883976130072,2.875,0,2.25,0,2.6,0,3,0,2.5833333333333335,0,2,0,1.5714285714285714,0,2.6666666666666665,0,2.4594594594594597,0,1,0,0,0.5522037225546441,-0.14214227989529096,0.2050307213296766,3,2,3,2,2,3,3,3,1,0.5345224838248488,2.5714285714285716,0,2,0.4060081474343336,4,4,4,4,2,2,3,3,3,2,2,0.9511897312113419,3.2857142857142856,0,2.7142857142857144,6,3.8333333333333335,3.2559414990859232,0.9547190977297628,0,0.6209469802322789,2,3,2,3,2,2,4,3,2,3,2,4,3,4,3,2,4,3,3,2,0.7988086367179802,2.4,0,3.8,0,3.4,0,3.6,0,3.6,0,2,2,3,2,3,3,3,2,1,2,3,2,2,3,1,2,2,3,2,3,0.6569466853317864,2.5,0,"White, Caucasian, Anglo, European American",0,24,1,2,NA,1,3,7,School-based mental health therapist,3,0,260,68,1,5,2,0,0,2,0,0,TRUE,TRUE,TRUE,TRUE,TRUE,3,0.7261093023211457,0.86,0.04820107789388694,3,0.4760032258110662,0.5320548387150611,1,0.96875,0.0015459069887292765,0.004025808135005669,3,0.5367406249903143,0.6184406249970198,1,1,0.008112736037606313,0.008756640554518486,1.28,1.4925,0.4369,0,2.5767,0.003,ML,change,50,6.582669016284437,1.5191990358395586,1.1948993672412784,0.44295761379394905,1.4575,4.4119,0.3734,6.799,0.3688,0,-91.377,0.01,ML,cueing,63,195.1834041791746,4.199983155031051,0.8176192802991751,0.4408023209088546,5.794509166546614,0.7150104706557465,0.4162340224550064,0.155,0.249,0.501,0.027,1.791,89.43467754412694,1882.872390643453,0.156,0.25,0.532,0.023,1.924,99.56190508840399,1881.820036202352,422,1.2503703703703704,1,0,0,1,FALSE,FALSE,FALSE
197,2021-11-13T01:44:25Z,2021-11-13T02:18:17Z,2031,1,2021-11-13T02:18:19Z,1,Chrome,95.0.4638.69,Windows NT 10.0,1366,768,good study :),1.7786458333333333,926,70,657,110,137,76,0.3514912868815093,-0.17991767851316898,1.1048458783947914,0.0660338372338302,0.8985413933768257,-0.4962109186108739,2,2,4,4,2,2,4,3,4,2,3,4,3,4,2,3,4,3,2,2,0.8870412083230169,1,1,4,3,3,3.15,0,4,4,3,4,4,2,4,2,3,2,2,4,2,4,4,3,2,1,1,2,2,2,3,4,2,0,0,5,3,4,5,3,4,4,4,3,2,4,2,2,3,2,3,2,2,2,3,3,4,1,1,1,3,3,1,3,3,1,4,3,3,1,2,4,2,2,3,2,1.1337042318370718,0.9411239481143202,2,0,2.25,0,2.2666666666666666,0,2.111111111111111,0,2.3333333333333335,0,1.6666666666666667,0,2.142857142857143,0,2.3333333333333335,0,2.189189189189189,0,2,0,0,-0.08322408727218257,0.06095019390122543,-0.011136946685478571,4,2,4,1,1,2,4,3,1,1.3972762620115438,2,0,2,0.06413940681375631,5,5,5,5,3,3,3,6,7,4,3,1.0690449676496976,4.142857142857143,0,1.8571428571428572,2.5,3.8333333333333335,3.2559414990859232,-1.0219528370065065,0,-0.8454149716644763,3,3,3,4,3,3,5,2,2,3,2,4,3,4,4,2,4,2,4,3,0.990430401872025,3.2,0,3.8,0,3.8,0,3.8,0,3.8,0,2,3,3,2,3,3,3,2,3,3,3,2,2,3,1,2,2,3,3,3,0.6048053188292994,2.75,0,"Asian or Asian American (e.g., Chinese, Japanese, and others)",0,23,1,2,NA,1,3,6,currently unemployed,4,0,210,65,2,5,2,0,0,1,0,0,TRUE,TRUE,TRUE,TRUE,TRUE,1,0.8546966666668654,0.6122448979591837,0.13717008278029663,1,0.487328125,0.5693937499998137,1,1,0.003701799506120183,0.004076594798216989,1,0.6305531249986962,0.697612500000745,1,1,0.017164578699637566,0.01305663467768056,1.4399,0.3268,0.4175,0,40.3637,0.003,ML,change,49,-69.05193910566813,0.3356115125006983,1.3609735824982003,0.39952056214530995,6.0011,8.5676,0.2192,10.1333,0.1912,0,-89.9779,0.014,ML,cueing,64,192.43244925007903,4.547137719028386,0.9111522417836116,0.47233502990275883,4.658104969764548,0.8894464064859738,0.3948386671758195,0.262,0.156,0.561,0.011,1.131,35.247125654303474,1836.583167211294,0.262,0.152,0.559,0.01,1.206,50.33965150515622,1833.1644928392395,342,1.0133333333333332,1,0,0,1,FALSE,FALSE,FALSE
198,2021-11-13T01:51:31Z,2021-11-13T02:18:17Z,1606,1,2021-11-13T02:18:19Z,1,Chrome,95.0.4638.69,Windows NT 10.0,1536,864,"it was great, thank you!",1.7777777777777777,720,79,412,101,71,92,-0.17779831873632074,-0.09815503369452862,-0.07464270950233591,-0.04364382157256178,-0.013054542654933752,-0.2259490504372247,4,4,1,1,4,1,1,4,1,4,2,1,1,1,4,4,1,1,3,4,1.460893742308382,0,0,1,4,3,1.15,0,2,3,4,3,4,3,2,4,3,3,5,3,2,3,4,3,5,2,3,3,4,4,3,0,2,0,0,4,4,4,5,4,5,5,5,5,2,4,4,1,3,3,4,2,3,5,5,4,4,1,1,1,2,1,1,1,1,1,5,5,1,1,3,1,2,1,1,1,1.632993161855452,0.8618916073713346,3.375,0,1.25,0,3.3333333333333335,0,1.4444444444444444,0,3,0,1.1666666666666667,0,1.4285714285714286,0,1.6666666666666667,0,1.972972972972973,0,0,0,0,0.8731600999172876,-0.6588395645607719,0.10716026767825787,3,2,3,2,2,4,3,3,2,0.7559289460184544,2.7142857142857144,0,2.5,0.6759691699766689,4,4,4,2,2,4,4,5,6,NA,3,0.9759000729485332,3.142857142857143,0,2.857142857142857,3.5,3.8333333333333335,3.2559414990859232,-0.4571894270818581,0,-0.005336284752094855,4,3,5,5,5,4,5,3,4,3,2,3,4,3,4,5,3,2,5,4,0.9856107606091623,4.4,0,3.2,0,3.2,0,2.8,0,3.066666666666667,0,2,1,4,1,3,4,3,1,4,2,4,2,3,4,2,3,4,4,4,4,1.145931016569864,3.25,0,"White, Caucasian, Anglo, European American",0,22,1,2,NA,1,3,4,teacher,5,0,115,64,1,5,2,0,0,0,0,0,TRUE,TRUE,TRUE,TRUE,TRUE,5,0.8383410256436238,0.7959183673469388,0.03368038427762738,5,0.4666906249988824,0.548818750004284,1,1,0.00795127765074647,0.005592649959870334,5,0.5593468750016763,0.6228548387116002,1,0.96875,0.007265872248324954,0.0056059215225040555,1.3783,1.1141,0.4851,0,14.937,0.004,ML,change,49,-18.198539105668118,1.318769659224048,1.032004750500847,0.6067697586475482,6.1453,8.6531,0.1937,7.0026,0.0279,0,-72.2327,0.012,ML,cueing,64,156.942049250079,4.201535959446961,0.9861000277948078,0.43513599075307413,3.8477182626342548,1.0767770516428163,0.33113915038742997,0.09,0.36,0.496,0.016,1.717,115.99878787022071,1978.697367302264,0.089,0.364,0.489,0.016,1.837,153.90779370994107,1985.6964183812577,390,1.1555555555555557,1,0,0,1,FALSE,FALSE,FALSE
199,2021-11-13T01:15:38Z,2021-11-13T02:19:17Z,3819,1,2021-11-13T02:19:18Z,1,Chrome,94.0.4606.104,CrOS x86_64 14150.64.0,1410,940,None,1.5,928,533,989,445,201,537,0.3566300209166339,4.026316160490219,2.7031732709737555,4.148480026138421,1.7825132101348953,7.290709158142393,4,4,2,2,3,1,1,3,1,4,2,2,1,3,4,4,2,1,2,3,1.145931016569864,0,1,1,3,3,1.65,0,3,4,3,3,2,3,2,3,4,2,4,3,4,2,3,4,4,5,3,2,4,3,4,7,2,4,3,4,5,2,2,3,3,1,2,3,2,3,5,2,3,4,5,3,5,5,3,4,1,5,4,4,5,2,2,5,5,5,4,3,2,3,5,3,2,2,3,3,1.2810703107718722,0.7559289460184544,3.625,0,2.5,0,3.1333333333333333,0,3.2222222222222223,0,3.3333333333333335,0,4,0,3.2857142857142856,0,3.6666666666666665,0,3.4864864864864864,0,4,4,3,1.5450778235757536,1.9014181152811362,1.7232479694284448,2,5,2,4,4,5,4,5,1,1.2535663410560174,4.285714285714286,0,3,1.8006020440704469,2,3,3,2,1,1,5,3,5,2,2,1.3972762620115438,1.8571428571428572,0,4.142857142857143,5,3.8333333333333335,3.2559414990859232,0.38995568780511447,0,1.1352752494843223,2,3,2,5,4,3,4,4,3,1,4,3,5,3,3,2,4,3,4,3,0.9611501047232549,3.2,0,3,0,2.8,0,2.8,0,2.8666666666666667,0,3,3,3,1,4,4,4,2,3,3,4,2,4,4,3,2,4,4,3,3,0.8750939799154206,3.45,0,"White, Caucasian, Anglo, European American",0,30,1,2,NA,1,3,6,Research technologist,5,0,195,64,1,5,2,0,0,1,0,0,TRUE,TRUE,TRUE,TRUE,TRUE,6,0.7098738095238805,0.84,0.02235121035122687,6,0.49169062499981375,0.5721677419365414,1,0.96875,0.0011145931350967733,0.003747724667126742,6,0.6194093749979511,0.7117299999992053,1,0.967741935483871,0.0047332724897517515,0.004141539612896973,1.1534,1.4805,0.4584,0,-2.4362,0.004,ML,change,50,16.608469016284438,1.71694618842842,0.9658008432526155,0.5186201238120063,1.2343,3.8181,0.4194,7.7583,0.4121,0,-99.4369,0.009,ML,cueing,64,211.350449250079,4.275814911838444,0.8031187680686246,0.484123256781242,6.288302182096953,0.6588638087697506,0.4409396992123342,0.075,0.481,0.563,0.014,1.629,70.24761778936598,1925.3000525364985,0.075,0.48,0.612,0.013,1.74,87.7329813351316,1918.3995198471619,390,1.1555555555555557,1,0,0,1,FALSE,FALSE,FALSE
200,2021-11-13T01:33:12Z,2021-11-13T02:19:25Z,2772,1,2021-11-13T02:19:27Z,0.800000011920929,Safari,14.1.2,Macintosh,1440,900,"The study was incorrectly calibrated despite the fact that I followed the calibration instructions and used a credit card to size the box. This caused me a lot of trouble throughout the study. I had to change the display size on my laptop, zoom the screen out, and change settings on my browser. I spent an extra 15-20 minutes figuring all of this out. I hope you solve this issue for future participants!",1.6,694,85,1133,449,40,123,-0.24460186119294008,-0.04364660381543503,3.3964237063092098,4.197225652274596,-0.4412283913971238,0.2976833191492206,3,4,1,1,4,1,2,4,1,4,3,1,1,3,4,4,1,2,3,3,1.2773327473170102,0,1,3,5,4,1.4,0,2,5,2,5,1,1,5,2,1,1,2,5,2,4,4,1,2,1,1,1,1,1,1,0,2,0,0,5,5,5,5,5,5,5,5,5,1,5,1,1,5,1,5,1,1,1,1,1,4,1,1,1,2,1,1,1,2,1,5,1,1,1,1,1,1,1,1,2,1.9089641547562237,1.65615734242165,1.125,0,1.25,0,1.6,0,1,0,1,0,1.1666666666666667,0,1,0,1,0,1.0810810810810811,0,0,0,0,-1.2219610533974852,-0.6588395645607719,-0.9404003089791285,5,2,5,1,1,2,1,1,1,1.8126539343499315,1.2857142857142858,0,1,-0.7321841937363471,5,5,5,5,2,3,1,7,6,6,4,1.7043362064926932,4.285714285714286,0,1.7142857142857142,2.5,3.8333333333333335,3.2559414990859232,-1.0219528370065065,0,-0.9250859690859132,3,2,3,2,3,3,3,2,2,1,2,2,2,3,4,2,3,2,3,3,0.7432233529572065,2.6,0,3.2,0,3,0,3.6,0,3.2666666666666666,0,1,1,1,4,2,1,1,4,1,1,1,4,1,1,1,4,1,1,1,2,1.2182817926554552,1.1,0,"White, Caucasian, Anglo, European American",0,27,1,2,NA,1,2,7,Early Childhood Teacher,3,0,110,62,4,5,2,0,0,0,0,0,TRUE,TRUE,TRUE,TRUE,TRUE,2,0.7673333333333369,0.66,0.02001923469387857,2,0.44132258064516505,0.5060645161290341,1,0.96875,0.005169892473118891,0.0020241118951606603,2,0.5419375000000036,0.6109629629629673,1,0.84375,0.0055786411290336705,0.007368258064515545,1.2663,0.5717,0.417,0,21.6681,0.004,ML,change,50,-31.60013098371556,0.7797392197221292,0.8506616066415619,0.5927802858270782,1.0801,4.8202,0.4007,4.9856,0.333,0,-94.3279,0.01,ML,cueing,63,201.08520417917458,4.9877214062321515,0.6884881742180675,0.44135985334224137,4.284914067843316,0.9669119755479381,0.3320209748858315,0.053,0.412,0.376,0.011,1.284,92.53004802641779,2034.5121716253598,0.051,0.411,0.415,0.009,1.35,129.57276952024813,2043.4316137262595,436,1.2918518518518518,1,0,0,1,FALSE,FALSE,FALSE
202,2021-11-13T01:45:21Z,2021-11-13T02:20:01Z,2080,1,2021-11-13T02:20:02Z,1,Chrome,95.0.4638.69,Macintosh,1440,900,N/A,1.6,660,66,345,521,336,90,-0.3319603397900577,-0.21625663176589804,-0.39719673149869317,5.074646922725731,3.6471412611089487,-0.2597317839589309,4,4,1,1,4,1,1,4,1,4,1,1,1,1,4,4,1,1,4,4,1.5312533566021211,1,1,2,4,4,1.15,0,5,5,1,5,2,1,5,1,1,1,1,5,1,5,5,1,1,1,1,1,1,1,1,1,2,0,0,5,4,5,5,5,5,5,5,5,2,5,1,1,5,1,5,1,1,1,1,1,5,1,1,1,2,1,1,2,2,1,5,1,1,1,1,1,2,1,2,2,1.8776382839954893,2.016597794967223,1,0,1.75,0,1.0666666666666667,0,1.1111111111111112,0,1.0833333333333333,0,1,0,1.1428571428571428,0,1,0,1.135135135135135,0,1,0,0,-1.481649220003026,-0.2989446853297732,-0.8902969526663996,5,1,4,1,1,1,1,1,1,1.7320508075688772,1.1428571428571428,0,1,-0.8176513788914915,5,5,5,5,4,5,1,7,7,NA,4,1.4960264830861913,4.857142857142857,0,1.1428571428571428,2,3.8333333333333335,3.2559414990859232,-1.3043345419688306,0,-1.3849608112528222,1,1,1,2,1,1,5,1,1,1,1,5,2,4,3,2,5,1,1,1,1.6676187756655838,1.2,0,5,0,3,0,4.4,0,4.133333333333334,0,1,1,3,2,3,3,3,2,2,1,1,3,1,4,4,2,3,3,3,1,1.0310954828418375,2.4,0,"White, Caucasian, Anglo, European American",0,19,1,2,NA,1,4,4,Merchandise associate and student,6,0,180,64,2,5,2,0,1,0,0,1,TRUE,TRUE,TRUE,TRUE,TRUE,2,0.8215536585366581,0.82,0.05896378981221199,2,0.4849258064514687,0.5841156249996274,0.96875,1,0.003167922973738778,0.0073552149092254845,2,0.6269250000001629,0.7036875,1,1,0.00735511806448954,0.007180642419374441,1.2963,1.234,0.524,0,10.2373,0.004,ML,change,50,-8.738530983715561,1.2541011222994232,1.2091110217554308,0.5130334602193809,1.9176,3.8386,0.3343,4.7395,0.2909,0,-59.0513,0.009,ML,cueing,64,130.57924925007902,3.923409620575506,1.056003610906117,0.45374388243413394,4.4593048560927775,0.7700723129061847,0.403977899025589,0.231,0.28,0.659,0.015,1.395,38.22054728082233,1828.4939232365796,0.225,0.288,0.66,0.015,1.472,60.47788130759241,1840.3604405275712,424,1.2562962962962962,1,0,0,1,FALSE,FALSE,FALSE
204,2021-11-13T01:48:22Z,2021-11-13T02:20:23Z,1921,1,2021-11-13T02:20:24Z,0.8999999761581421,Edge,95.0.1020.44,Windows NT 10.0,1920,1080,I thought the exercises in the beginning were fun! I like being able to focus on little games such as those.,1.7777777777777777,936,134,486,112,52,96,0.3771849570571322,0.4015055735304959,0.2816109864339392,0.09040665030191732,-0.2754836757549857,-0.15838358339381242,4,4,1,1,4,1,1,3,1,3,2,1,2,1,4,3,1,1,4,4,1.3416407864998738,0,1,4,3,2,1.3,0,2,4,5,2,3,4,3,4,3,4,4,2,1,2,2,5,5,1,1,5,5,4,5,3,2,1,0,3,2,4,2,2,4,4,3,2,2,5,4,2,1,2,3,4,4,4,4,4,2,2,1,1,5,4,1,3,2,3,2,3,3,2,3,5,3,3,2,2,1.1734039700277465,1.1338934190276817,3.875,0,2.5,0,3.533333333333333,0,3.111111111111111,0,3.25,0,2.6666666666666665,0,2.5714285714285716,0,3.3333333333333335,0,3.054054054054054,0,2,1,0,1.638577178380432,0.34598460421149024,0.9922808912959611,3,2,3,2,2,3,3,4,2,0.5345224838248488,2.5714285714285716,0,3,0.7749958222087157,2,2,3,2,1,1,5,4,1,2,1,1.3801311186847085,1.7142857142857142,0,4.285714285714286,6.5,3.8333333333333335,3.2559414990859232,1.237100802692087,0,1.6385188043492451,3,3,2,4,4,2,4,2,2,2,2,3,2,4,5,3,3,2,2,3,0.9611501047232549,3.2,0,3.6,0,3,0,4,0,3.533333333333333,0,2,2,2,2,3,2,3,2,2,1,3,3,2,1,1,2,1,2,1,2,0.6863327411532597,2.05,0,"White, Caucasian, Anglo, European American",0,28,1,2,NA,1,2,3,Transportation Lead,1,0,230,62,1,5,2,1,0,0,0,1,TRUE,TRUE,TRUE,TRUE,TRUE,6,0.6491368420939696,0.76,0.012755043024064331,6,0.4628677419308693,0.6161633333206177,0.96875,0.967741935483871,0.0036797715729948014,0.009912544945959403,6,0.6352218750230968,1.0003038461529292,1,0.8125,0.01590992305644746,0.09794153576380282,1.2111,1.1239,0.3855,0,1.1448,0.006,ML,change,50,9.446469016284437,1.4561552376610623,0.791591088728883,0.507796360154629,1.3557,2.9717,0.4019,4.0006,0.3002,0,-55.1601,0.009,ML,cueing,63,122.7496041791746,3.3374002796342253,1.0191158077193314,0.47333263863478503,4.295419672555413,0.7994532470076929,0.3756251118499964,0.098,0.309,0.151,0.027,1.778,354.65204102784537,2375.7370108112254,0.09,0.31,0.159,0.007,1.901,326.42567489609957,2308.3530152207945,104,0.3081481481481481,1,0,1,2,FALSE,FALSE,FALSE
205,2021-11-13T01:57:13Z,2021-11-13T02:20:25Z,1391,1,2021-11-13T02:20:25Z,1,Chrome,95.0.4638.69,Macintosh,1440,900,N/A,1.6,667,65,334,73,50,83,-0.3139747706671217,-0.22534137007908028,-0.45015336197570704,-0.38486320452578127,-0.3031077950286754,-0.3779713512849024,2,1,2,3,1,2,2,1,2,2,2,2,1,1,2,2,2,1,2,1,0.5712405705774795,1,1,1,3,1,2.6,0,1,2,4,2,3,4,1,5,4,4,4,1,2,2,2,4,5,1,2,4,4,4,4,1,3,0,0,2,2,2,2,1,2,3,3,2,2,4,4,1,1,1,2,5,4,4,5,5,1,2,1,1,1,1,1,2,2,3,1,5,5,1,2,1,2,2,2,2,1.4184540923174116,1.3345232785352157,3.5,0,2,0,4.066666666666666,0,3.888888888888889,0,3.5,0,1.6666666666666667,0,3.142857142857143,0,1.3333333333333333,0,3.108108108108108,0,1,0,0,1.7298503580707134,-0.22054348261253207,0.7546534377290907,3,4,2,2,2,3,2,7,4,0.7867957924694432,2.857142857142857,0,5.5,1.8683993794549596,2,2,3,2,1,1,2,6,2,4,2,0.6900655593423543,2.142857142857143,0,3.857142857142857,5,3.8333333333333335,3.2559414990859232,0.38995568780511447,0,0.9759332546414488,1,1,1,1,1,1,4,4,1,4,1,1,1,4,4,1,5,1,2,3,1.5522640914238175,1,0,4.2,0,4,0,3.6,0,3.933333333333333,0,2,3,3,2,3,4,3,2,3,2,2,1,2,2,2,2,1,2,2,2,0.7163503994113789,2.55,0,"White, Caucasian, Anglo, European American",0,28,1,2,NA,1,2,4,Student,5,0,170,67,1,5,2,0,1,2,0,1,TRUE,TRUE,TRUE,TRUE,TRUE,6,0.7492473684227781,0.7755102040816326,0.020858056776660784,6,0.46105333333611487,0.5491625000005588,0.967741935483871,1,0.0036839458277244377,0.004224715967501446,6,0.62746451613307,0.7203275862058689,1,0.90625,0.008291010365832494,0.017766824748030964,1.1072,1.2089,0.5222,0,-1.1029,0.004,ML,change,49,13.881260894331879,1.2348345722230865,0.9334687705278641,0.5527012999884405,1.1766,4.54,0.4196,4.4505,0.3454,0,-83.3988,0.011,ML,cueing,63,179.22700417917457,4.506746346406636,0.9193183747061731,0.4503562208090641,4.274411027014446,0.7957113530183351,0.37397991760818283,0.064,0.454,0.371,0.011,1.543,34.16157521108813,1908.1892952691667,0.064,0.455,0.398,0.012,1.638,48.377713002855195,1902.7077041734126,402,1.1911111111111112,1,0,0,1,FALSE,FALSE,FALSE
206,2021-11-13T01:59:32Z,2021-11-13T02:20:33Z,1261,1,2021-11-13T02:20:34Z,1,Chrome,95.0.4638.54,Macintosh,1440,900,NA,1.6,643,59,311,66,48,73,-0.37563957908861645,-0.2798497999581739,-0.5608808620640088,-0.47016805026408615,-0.3307319143023651,-0.5468850188934331,3,2,2,3,2,2,3,3,1,3,2,2,3,3,2,2,3,2,2,2,0.5871429486123998,0,1,3,3,3,2.55,0,5,3,3,4,2,1,4,1,3,1,1,3,1,4,4,3,2,2,1,1,1,2,2,0,3,1,0,5,2,2,4,4,4,4,4,3,2,3,1,1,1,2,2,1,1,4,4,4,5,2,1,1,1,2,1,1,1,1,4,3,2,2,3,1,2,1,1,1,1.3428712906691034,1.3972762620115438,1.75,0,1.25,0,1.8666666666666667,0,2.4444444444444446,0,2.6666666666666665,0,1.1666666666666667,0,1.4285714285714286,0,2,0,2.135135135135135,0,0,1,0,-0.38579032238545885,-0.45220635696774814,-0.4189983396766035,4,2,2,2,1,3,2,2,1,0.9511897312113419,2.2857142857142856,0,1.5,0.050579939736853735,2,3,4,3,2,2,4,3,3,NA,2,0.8997354108424374,2.5714285714285716,0,3.4285714285714284,6,3.8333333333333335,3.2559414990859232,0.9547190977297628,0,1.0193019673394625,3,3,4,5,4,4,5,2,2,3,1,5,3,5,5,1,5,1,5,3,1.632993161855452,3.8,0,4.4,0,4.2,0,4.2,0,4.266666666666667,0,4,2,4,2,2,4,4,3,3,3,4,3,2,3,1,3,3,4,3,2,0.8870412083230169,2.85,0,"Asian or Asian American (e.g., Chinese, Japanese, and others)",0,21,1,2,NA,1,2,4,Student,7,0,124,62,3,5,2,0,0,2,0,0,TRUE,TRUE,TRUE,TRUE,TRUE,2,0.7986076923081508,0.7959183673469388,0.024539321633579126,2,0.46297999999920525,0.5175200000007948,0.9375,0.9375,0.0033325380642504846,0.005452827742499574,2,0.5868580645178595,0.7070749999987228,0.96875,0.875,0.00976189338686258,0.012322026602794493,1.3188,1.1436,0.4632,0,11.9636,0.004,ML,change,49,-12.25173910566812,1.4274061647930185,0.9534613109457527,0.6009437607498533,0.9658,3.2395,0.3819,3.103,0.3217,0,-65.0242,0.01,ML,cueing,64,142.525049250079,3.430376056136193,0.7894324577791115,0.4168381229626905,3.879746922041052,0.6979966104793152,0.3842703513492232,0.056,0.442,0.35,0.007,1.255,66.35769898722583,2007.1354151699372,0.056,0.442,0.35,0.006,1.276,81.4063369574371,2019.7856462150378,431,1.2770370370370372,1,0,0,1,FALSE,FALSE,FALSE
207,2021-11-13T01:23:48Z,2021-11-13T02:20:43Z,3414,1,2021-11-13T02:20:44Z,1,Chrome,95.0.4638.54,Windows NT 10.0,1280,720,NA,1.7777777777777777,2640,73,428,88,39,92,4.75538635498326,-0.15266346357362218,0.002385116646047904,-0.202067106515128,-0.4550404510339686,-0.2259490504372247,3,3,1,1,3,1,1,3,1,4,3,1,1,1,4,3,1,1,3,2,1.145931016569864,0,1,1,5,5,1.45,0,1,2,5,2,5,5,1,5,5,4,5,1,2,2,5,1,1,1,1,1,2,4,1,0,2,0,0,5,5,3,2,1,5,5,3,2,2,3,1,1,2,2,1,2,1,1,1,1,5,1,1,1,1,1,1,1,1,1,1,4,3,1,1,4,1,1,1,1,1.460182225659569,1.7593288763724921,1.5,0,1,0,4.266666666666667,0,2.5555555555555554,0,2,0,0.8333333333333334,0,2.142857142857143,0,2,0,2.027027027027027,0,0,0,0,0.49170983357646164,-0.7372407672780129,-0.12276546685077563,2,5,1,2,4,5,4,1,1,1.6035674514745464,4.142857142857143,0,1,0.9771595093665387,5,5,5,5,2,2,1,1,2,NA,3,1.8126539343499315,4.142857142857143,0,1.8571428571428572,7.5,3.8333333333333335,3.2559414990859232,1.8018642126167355,0,0.5664935531471447,2,2,2,3,3,3,3,3,3,3,1,3,2,3,3,1,3,3,3,4,0.7988086367179802,2.4,0,3.4,0,3.6,0,2.8,0,3.2666666666666666,0,1,1,1,1,1,1,1,1,1,1,1,3,1,2,1,1,1,1,1,2,0.5231483637805969,1.6,0,"Hispanic of Latino (e.g., Mexican American, Central American, and others)",0,28,1,2,NA,1,3,6,Accountant,3,0,140,66,1,5,2,1,0,1,0,1,TRUE,TRUE,TRUE,TRUE,TRUE,4,0.7807419354877164,0.6326530612244898,0.06117000033756975,4,0.5004818181612275,0.6413344827684863,0.7586206896551724,0.9354838709677419,0.021933621700019057,0.028066160128385975,4,0.6335812499858439,0.7244166666600439,1,0.6206896551724138,0.008228153828660665,0.024584911427870986,1.3045,0.4275,0.4279,0,30.1304,0.004,ML,change,49,-48.585339105668126,0.48672490437310667,1.1168843872683054,0.4763438418750535,1.2169,1.8095,0.3327,1.2447,0.2105,0,-4.2146,0.009,ML,cueing,60,20.712233686666302,2.260598713220609,1.1829382339233248,0.413452144248195,1.2642378871086337,0.9057886304309145,0.3151878298441949,0.054,0.463,0.353,0.011,1.944,232.7634198925515,2187.0382739679353,0.052,0.466,0.355,0.013,2.133,269.048703056195,2197.636938456539,104,0.3081481481481481,1,1,4,5,FALSE,FALSE,FALSE
208,2021-11-13T01:46:32Z,2021-11-13T02:21:09Z,2077,1,2021-11-13T02:21:10Z,0.8999999761581421,Chrome,95.0.4638.69,Windows NT 10.0,1920,1080,"Some of these questions were worded in a way that was difficult to answer because of changes in my living situations, i.e. my parents were divorced, both remarried and made a lot of money, but both married abusive people so I spent most of my early childhood completely alone or with my grandma.",1.7777777777777777,744,54,575,75,51,118,-0.11613351031482598,-0.3252734915240852,0.7100782693843243,-0.3604903914576942,-0.28929573539183057,0.2132264853449552,2,3,3,3,1,2,3,1,1,1,1,2,2,1,2,2,3,1,2,1,0.812727700887249,1,1,1,1,2,2.75,0,1,1,3,2,1,2,1,2,4,2,4,1,1,1,3,5,2,4,2,4,5,3,2,7,2,5,2,4,2,2,1,1,1,1,1,1,3,4,5,1,2,2,1,2,4,4,5,5,2,3,5,2,3,1,2,4,3,3,5,1,2,5,1,5,2,3,2,2,1.5102254072756096,1.0997835284835873,3.375,0,2.25,0,3.4,0,4.444444444444445,0,3.5,0,2.8333333333333335,0,2.142857142857143,0,3.6666666666666665,0,3.4324324324324325,0,4,5,2,1.5290106466631481,1.8532004732577383,1.6911055599604432,4,2,3,4,2,2,3,8,8,0.8997354108424374,2.5714285714285716,0,8,2.619934196080626,2,2,2,2,1,1,1,3,4,3,3,0.5345224838248488,2.142857142857143,0,3.857142857142857,5.5,3.8333333333333335,3.2559414990859232,0.6723373927674386,0,1.1171241071226108,3,5,3,1,1,4,5,2,1,1,4,4,1,5,2,3,2,3,3,5,1.4638501094227998,2.6,0,2.6,0,3.4,0,3.4,0,3.1333333333333333,0,1,1,2,4,2,2,3,3,2,2,4,2,1,1,1,2,2,2,1,2,0.9176629354822471,1.9,0,"Asian or Asian American (e.g., Chinese, Japanese, and others) & Native Hawaiian or other Pacific Islander & Filipino",1,27,1,1,NA,1,2,4,Remote operator,2,0,115,60,4,5,2,0,0,1,0,0,TRUE,TRUE,TRUE,TRUE,TRUE,5,0.7401300000011921,0.625,0.30623541473412946,5,0.4460374999991618,0.5128937500007451,1,1,0.003191597257996141,0.004668522540361881,5,0.5522312499994878,0.6077548387096293,1,0.96875,0.014656624798403088,0.015568456088574326,1.3921,0.3708,0.3555,0,37.0192,0.003,ML,change,48,-62.42479696727632,0.30627740728875275,1.6678527753253234,0.05943468276836472,0.9836,4.4455,0.4023,5.9752,0.3637,0,-104.1318,0.01,ML,cueing,64,220.74024925007902,4.395594581627785,0.9425652547003639,0.40902724530676204,4.83404260259401,0.8570745165067996,0.3601579364408662,0.085,0.286,0.335,0.024,1.436,91.10309051475608,1945.5036707547072,0.09,0.284,0.334,0.018,1.655,120.13334393170922,1944.0726990596631,318,0.9422222222222223,1,0,0,1,FALSE,FALSE,FALSE
209,2021-11-13T02:00:13Z,2021-11-13T02:22:46Z,1353,1,2021-11-13T02:22:47Z,1,Chrome,95.0.4638.69,Macintosh,1440,900,"I felt like I got better at that last game after I figured out to pay attention to the ""+""",1.6,645,67,340,83,46,93,-0.3705008450534919,-0.20717189345271578,-0.4212679271700631,-0.26299913918534573,-0.3583560335760547,-0.20905768367637165,3,4,2,2,2,1,1,4,1,3,2,1,1,1,3,3,1,1,2,2,1.025978352085154,0,1,1,4,4,1.7,0,4,4,3,4,3,1,5,1,1,1,1,5,1,4,5,2,2,1,1,1,1,1,2,1,2,0,0,5,4,5,5,5,5,3,5,4,2,4,2,1,4,1,5,2,5,1,2,1,4,1,1,1,2,1,1,2,2,1,4,1,1,1,1,1,1,1,1,2,1.65763317647414,1.6846647257229665,1.375,0,1.25,0,1.5333333333333334,0,1.4444444444444444,0,1.8333333333333333,0,1.1666666666666667,0,1.2857142857142858,0,1,0,1.5135135135135136,0,1,0,0,-0.9573365854513246,-0.4557470907642554,-0.70654183810779,5,1,3,1,1,1,1,1,1,1.5735915849388864,1.2857142857142858,0,1,-0.7321841937363471,5,5,5,5,3,2,1,6,3,3,2,1.7043362064926932,4.285714285714286,0,1.7142857142857142,4.5,3.8333333333333335,3.2559414990859232,0.10757398284279028,0,-0.3603225591612647,3,1,1,3,2,3,3,2,2,4,1,4,3,3,4,3,3,1,3,2,0.9611501047232549,2,0,4,0,3.2,0,3.8,0,3.6666666666666665,0,1,1,2,3,3,2,3,3,1,1,2,2,1,3,1,1,1,1,2,2,0.8335087534664907,1.9,0,"White, Caucasian, Anglo, European American",0,30,1,2,NA,1,3,7,Mental Health Professional,3,0,150,67,2,5,2,0,0,1,0,0,TRUE,TRUE,TRUE,TRUE,TRUE,4,0.750567741935532,0.62,0.02575702571444535,4,0.43272187500051223,0.4901517241373658,1,0.90625,0.0020338707963702234,0.003136309516145996,4,0.5620281250004191,0.6439433333327373,1,0.9375,0.003889867892983897,0.005717012741811932,1.2501,0.4202,0.392,0,23.613,0.004,ML,change,50,-35.48993098371556,0.5456048376195646,0.8972578532378308,0.5532253890738887,1.0066,3.1367,0.3521,4.8349,0.3286,0,-81.1785,0.011,ML,cueing,64,174.83364925007902,3.5252383427614036,0.6435546538227115,0.4159882059025445,5.410428401922725,0.7657683308255536,0.36416555973501263,0.072,0.42,0.479,0.018,1.778,106.36164021668108,1981.832134858351,0.071,0.421,0.512,0.018,1.859,130.6791895853951,1996.6160844461965,373,1.1051851851851853,1,0,0,1,FALSE,FALSE,FALSE
210,2021-11-13T01:58:12Z,2021-11-13T02:23:21Z,1508,1,2021-11-13T02:23:22Z,1,Chrome,95.0.4638.54,Macintosh,1440,900,NA,1.6,967,46,282,57,44,78,0.4568353346015629,-0.39795139802954327,-0.7004937969579544,-0.5798457090704782,-0.3859801528497444,-0.4624281850891678,4,4,1,1,3,2,4,1,1,2,1,2,2,2,2,1,2,1,1,2,1.050062654772261,0,0,1,5,5,2.35,0,2,5,3,5,1,2,1,1,1,1,3,2,1,3,4,1,5,1,1,1,5,3,3,1,2,0,0,5,5,5,5,5,5,5,5,3,1,5,4,1,5,1,5,5,5,5,5,5,1,1,1,2,2,1,1,3,1,1,4,1,1,1,1,3,2,2,1,2,1.8526824963906883,1.4474937289114918,2.5,0,1.75,0,2.2,0,1.2222222222222223,0,2.9166666666666665,0,1.8333333333333333,0,1.2857142857142858,0,1.6666666666666667,0,1.972972972972973,0,1,0,0,0.010081687087766012,-0.2989446853297732,-0.1444314991210036,5,5,3,1,2,1,3,1,3,1.6761634196950514,2.2857142857142856,0,2,0.2350737771240448,5,5,5,5,5,5,1,7,7,6,4,1.5118578920369088,5,0,1,2,3.8333333333333335,3.2559414990859232,-1.3043345419688306,0,-1.464631808674259,4,4,3,5,3,2,5,2,2,5,1,4,1,5,4,1,5,1,5,2,1.7320508075688772,3.8,0,4.6,0,5,0,4.2,0,4.6,0,2,4,2,1,3,3,4,2,4,4,3,2,4,1,1,2,3,3,1,4,1.1367080817685316,2.95,0,"White, Caucasian, Anglo, European American",0,21,1,2,NA,1,5,4,secretary,1,0,158,64,3,5,2,0,0,1,0,0,TRUE,TRUE,TRUE,TRUE,TRUE,3,0.9274861111077998,0.72,0.10793960869001742,3,0.8892161290337962,1.009112500006333,0.96875,1,0.366518734908989,0.39217666242130245,3,0.7340875000003725,0.9005774193540697,1,0.96875,0.010055469515116452,0.03468868112046995,1.7259,0.596,0.2386,0,48.505,0.003,ML,change,50,-85.27393098371557,0.7133638571112255,1.3239549486926048,0.5191810283525922,2.1093,1.6452,0.3683,1.6083,0.2591,0,27.2756,0.011,ML,cueing,64,-42.07455074992099,1.4519178944166784,2.8535599308499986,0.05713505223145243,1.3596801963577447,2.525584482059803,0.018520410189888037,0.119,0.444,0.418,0.011,1.752,76.6351885789808,1931.647734930289,0.114,0.477,0.426,0.011,1.82,78.9616880808275,1904.6260794439588,104,0.3081481481481481,1,0,1,2,FALSE,FALSE,FALSE
211,2021-11-13T02:07:33Z,2021-11-13T02:24:36Z,1022,1,2021-11-13T02:24:36Z,0.699999988079071,Safari,15.1,Macintosh,1440,900,NA,1.6,644,78,135,24,22,67,-0.3730702120710542,-0.10723977200771087,-1.4081869496962307,-0.9819971246939154,-0.6898454648603309,-0.6482332194585516,3,4,4,4,3,3,3,3,2,4,4,3,3,2,3,3,2,2,3,3,0.6863327411532597,0,1,3,3,4,2.25,0,3,4,3,3,3,4,4,4,3,4,4,3,3,4,4,4,4,3,4,4,3,4,4,1,2,1,1,4,4,4,3,4,4,4,4,3,4,3,4,3,4,4,4,5,4,4,3,4,3,4,4,4,3,4,4,4,4,3,4,4,3,4,3,2,4,4,3,3,0.5708115501860713,0.5163977794943222,3.75,0,3.5,0,3,0,2.2222222222222223,0,3.5,0,3.5,0,3.2857142857142856,0,3,0,3.1621621621621623,0,1,1,1,1.402118665142513,0.632946588183119,1.017532626662816,4,4,4,4,4,4,4,3,3,0,3.4285714285714284,0,3,1.2877989331395812,4,3,3,3,4,3,3,7,7,NA,4,0.4879500364742666,3.2857142857142856,0,2.7142857142857144,2,3.8333333333333335,3.2559414990859232,-1.3043345419688306,0,-0.5085798396170178,5,4,4,3,4,4,4,3,4,3,3,4,3,4,4,4,3,4,3,4,0.50709255283711,4,0,2.8,0,3,0,3,0,2.933333333333333,0,2,3,3,3,3,3,2,3,3,4,3,3,2,3,3,2,3,3,3,2,0.5231483637805969,2.7,0,"White, Caucasian, Anglo, European American",0,19,0,1,NA,1,4,5,retail,3,0,135,73,3,5,2,0,0,0,0,0,TRUE,TRUE,TRUE,TRUE,TRUE,4,0.7611315789473669,0.8085106382978723,0.060898340425539425,4,0.5238999999999923,0.6125625,0.967741935483871,1,0.018100464516128584,0.013626189516129298,4,0.6715937499999969,0.8112333333333305,1,0.9375,0.006382119959677607,0.014073547379032639,1.7318,0.9188,0.2148,0,35.7455,0.003,ML,change,47,-59.940557194869825,1.1925414253712379,1.2078084263964095,0.4486713652880318,1.5805,4.476,0.436,2.909,0.2801,0,-53.5917,0.006,ML,cueing,63,119.6128041791746,3.362938213042664,1.2319984679834408,0.4351137274905693,2.8709931763040553,1.1846762332053518,0.33089266065321005,0.097,0.451,0.442,0.012,1.864,76.42089240952035,1932.9390249402672,0.098,0.461,0.466,0.013,2.042,98.32762995443332,1942.6100419697505,104,0.3081481481481481,1,0,0,1,FALSE,FALSE,FALSE
212,2021-11-13T01:50:51Z,2021-11-13T02:25:45Z,2094,1,2021-11-13T02:25:47Z,1,Firefox,94.0,Macintosh,1440,900,n/a,1.6,768,115,510,114,85,106,-0.05446870189333121,0.22889554558003286,0.397152725656515,0.11477946337000441,0.18031429226089402,0.010530084214718316,4,4,2,1,3,1,1,3,2,4,3,2,1,2,4,4,1,1,3,4,1.2354415362426845,0,1,1,4,4,1.4,0,1,1,2,2,2,5,3,4,3,3,2,1,5,2,4,2,5,5,1,2,4,5,3,1,2,0,2,5,4,3,4,4,4,4,5,4,2,3,2,3,3,3,5,5,4,4,4,5,2,5,1,1,3,1,1,2,1,1,1,5,5,1,4,4,2,3,1,1,1.4688967484672493,1.3451854182690985,3.375,0,1.75,0,3.6,0,1.8888888888888888,0,3.25,0,2.3333333333333335,0,2.7142857142857144,0,3,0,2.7027027027027026,0,1,0,2,1.3013600436604527,0.053954608468588336,0.6776573260645204,4,2,2,4,2,2,2,1,1,0.9759000729485332,2.5714285714285716,0,1,0.03702047265995151,3,2,3,2,1,1,5,4,4,2,2,1.3972762620115438,1.8571428571428572,0,4.142857142857143,5,3.8333333333333335,3.2559414990859232,0.38995568780511447,0,1.1352752494843223,3,3,2,2,2,2,5,3,2,3,1,3,1,4,4,3,3,1,4,3,1.2071217242444348,2.4,0,4,0,4,0,3.6,0,3.8666666666666667,0,3,1,2,3,3,2,3,3,1,3,3,3,2,1,2,3,2,3,4,3,0.8271701918685112,2.3,0,"Asian or Asian American (e.g., Chinese, Japanese, and others) & White, Caucasian, Anglo, European American",1,29,1,2,NA,1,2,4,dog walker & artist,2,0,120,62,3,5,2,0,0,1,0,0,TRUE,TRUE,TRUE,TRUE,TRUE,5,0.8456842105263158,0.76,0.05144418938775511,5,0.46861290322580645,0.5859375,1,1,0.0063135784946236565,0.006714512096774193,5,0.5904193548387097,0.6703666666666667,1,0.967741935483871,0.007185584946236559,0.00869756559139785,1.384,0.8914,0.4664,0,23.834,0.004,ML,change,50,-35.93193098371556,1.027528973281031,1.1217975744836983,0.5618310278423955,1.7601,4.6122,0.3951,6.3208,0.3294,0,-82.9238,0.007,ML,cueing,63,178.27700417917458,4.013829118247638,1.032215025686083,0.4613733647721959,4.076088438607288,1.0164486832889115,0.3478249619474054,0.076,0.437,0.492,0.012,1.452,108.31360166524608,1942.2858109808494,0.076,0.437,0.502,0.012,1.468,133.81306652147572,1957.4042392351428,376,1.114074074074074,1,0,0,1,FALSE,FALSE,FALSE
213,2021-11-13T02:00:57Z,2021-11-13T02:27:52Z,1614,1,2021-11-13T02:27:53Z,1,Chrome,93.0.4577.82,Macintosh,1440,900,NA,1.6,708,77,425,114,74,85,-0.20863072294706814,-0.11632451032089314,-0.012057600756774062,0.11477946337000441,0.028381636255600768,-0.34418861776319626,3,3,1,1,3,1,1,2,1,3,2,1,1,1,3,2,1,1,2,2,0.8506963092234007,0,1,2,5,5,1.75,0,4,4,2,4,2,1,4,2,1,2,1,4,2,4,4,1,2,1,1,1,1,1,1,0,5,0,0,5,5,5,4,2,4,3,3,3,1,4,1,1,3,2,1,2,1,2,1,1,4,1,1,1,1,1,1,1,1,1,3,4,1,1,1,1,2,2,1,1,1.4099602788688723,1.2798809468443688,1.125,0,1.5,0,1.8,0,2.2222222222222223,0,1.8333333333333333,0,1,0,1.5714285714285714,0,1,0,1.7297297297297298,0,0,0,0,-0.85725549552582,-0.5804383618435307,-0.7188469286846754,5,1,3,1,1,1,1,1,1,1.5735915849388864,1.2857142857142858,0,1,-0.7321841937363471,3,3,3,3,1,1,3,3,4,1,2,0.9759000729485332,2.4285714285714284,0,3.5714285714285716,5.5,3.8333333333333335,3.2559414990859232,0.6723373927674386,0,0.9577821122797373,2,2,2,3,2,2,5,1,2,2,1,3,2,4,4,3,5,2,2,2,1.2909944487358056,2.2,0,4.2,0,3.2,0,4.2,0,3.8666666666666667,0,1,1,2,3,3,3,2,2,3,1,1,3,1,1,1,3,1,2,2,3,0.8870412083230169,1.85,0,"Asian or Asian American (e.g., Chinese, Japanese, and others)",0,25,1,2,NA,1,2,4,Unemployed,1,0,207,61,2,5,2,0,0,1,0,0,TRUE,TRUE,TRUE,TRUE,TRUE,4,0.956910416662693,0.96,0.08883010384891502,4,0.4284968750029802,0.529480645133603,1,0.96875,0.0017700493453361335,0.005344258942561601,4,0.6390874999985099,0.6916062500029803,1,1,0.015551779201104217,0.017956425767749015,1.8582,1.8202,0.4792,0,8.805,0.004,ML,change,50,-5.873930983715562,1.8647365062019732,1.704291099454522,0.5364896745676884,1.5069,4.4463,0.3671,5.6308,0.2947,0,-83.8692,0.008,ML,cueing,64,180.21504925007903,3.912811657270725,0.877626501164237,0.42434207510907795,5.601652334530726,0.7396272526325253,0.3645412902756942,0.197,0.214,0.454,0.024,1.217,106.54929748112514,1905.8313173386898,0.196,0.212,0.45,0.021,1.283,136.431813145357,1921.7284525449647,384,1.1377777777777778,1,0,0,1,FALSE,FALSE,FALSE
214,2021-11-13T02:03:18Z,2021-11-13T02:28:22Z,1503,1,2021-11-13T02:28:23Z,0.8999999761581421,Chrome,84.0.4147.135,Macintosh,1440,900,NA,1.6,670,72,371,103,76,88,-0.30626666961443483,-0.16174820188680444,-0.27202651400756944,-0.019271008504474677,0.05600575552929045,-0.293514517480637,4,4,1,1,3,1,1,2,1,3,3,1,1,1,4,4,1,1,4,3,1.3218806379747876,1,1,1,4,3,1.3,0,5,4,2,4,3,2,5,2,3,1,2,5,2,5,2,2,3,1,2,1,1,1,1,2,2,0,0,4,4,2,4,5,5,2,2,5,2,5,1,1,2,3,5,5,3,2,1,2,4,1,1,1,3,1,2,2,1,1,4,2,1,1,1,1,1,1,1,1,1.5022505639062869,1.4074631010979937,1.5,0,1,0,1.9333333333333333,0,2.3333333333333335,0,2.1666666666666665,0,1.3333333333333333,0,1.4285714285714286,0,1,0,1.8918918918918919,0,1,0,0,-0.5691110035449424,-0.5341482934814965,-0.5516296485132195,5,1,4,1,1,1,1,1,1,1.7320508075688772,1.1428571428571428,0,1,-0.8176513788914915,5,5,5,5,3,3,1,4,6,5,4,1.5735915849388864,4.428571428571429,0,1.5714285714285714,4,3.8333333333333335,3.2559414990859232,-0.1748077221195339,0,-0.5811844090638635,2,2,3,3,2,2,2,2,2,2,1,3,3,4,5,3,3,2,2,4,1.0465362369445672,2.4,0,3.8,0,2.4,0,3.8,0,3.3333333333333335,0,1,1,1,4,2,2,1,3,2,2,1,3,2,2,1,4,1,2,1,2,0.9679060415469871,1.5,0,"White, Caucasian, Anglo, European American",0,24,1,2,NA,1,4,4,Retail,6,0,200,67,3,5,2,0,0,1,0,0,TRUE,TRUE,TRUE,TRUE,TRUE,2,1.0384547560867603,0.82,0.09889777733799109,2,0.512320322570421,0.5844943548342393,0.96875,0.96875,0.00275946152326012,0.0026096417564402436,2,0.6963090624994948,0.7189068749976286,1,1,0.028881774708752913,0.008431019323371678,1.7876,0.9281,0.431,0,40.1723,0.004,ML,change,50,-68.60853098371557,1.1020017166525378,1.375993763398278,0.6388927611880885,0.9975,4.8582,0.487,3.6226,0.3801,0,-85.7133,0.011,ML,cueing,64,183.90324925007903,4.680751591516833,0.7336401296554037,0.5110245703237288,4.615882351947575,0.7439503311942617,0.4367710145166375,0.113,0.428,0.458,0.012,1.199,132.92540663435486,1946.1653296976026,0.112,0.433,0.462,0.014,1.223,144.01568606641212,1929.9692620202716,425,1.2592592592592593,1,0,1,2,FALSE,FALSE,FALSE
215,2021-11-13T02:04:09Z,2021-11-13T02:28:42Z,1472,1,2021-11-13T02:28:43Z,1,Chrome,95.0.4638.69,Windows NT 10.0,1920,1080,None. Thank you!,1.7777777777777777,699,88,397,77,52,95,-0.23175502610512866,-0.016392388875888245,-0.14685629651644574,-0.3361175783896071,-0.2754836757549857,-0.1752749501546655,4,3,1,1,3,1,1,2,1,3,3,1,1,1,3,3,1,1,3,2,1.050062654772261,0,1,1,5,4,1.55,0,4,4,4,3,2,1,2,3,3,1,1,3,1,3,2,3,4,5,1,2,3,2,3,3,2,4,4,2,2,3,4,4,3,1,1,2,2,4,3,1,1,3,4,4,3,3,3,4,1,3,3,2,3,1,1,3,3,1,4,2,2,2,2,2,1,2,2,2,1.0440737953277488,1.1254628677422756,2.875,0,1.75,0,2.466666666666667,0,3.5555555555555554,0,2.9166666666666665,0,2.6666666666666665,0,1.8571428571428572,0,2,0,2.810810810810811,0,2,4,4,0.6458966578040526,1.436479206435561,1.0411879321198068,4,2,2,3,2,2,3,1,1,0.7867957924694432,2.5714285714285716,0,1,0.03702047265995151,3,4,4,4,1,2,3,5,6,2,2,1.1547005383792515,3,0,3,3.5,3.8333333333333335,3.2559414990859232,-0.4571894270818581,0,0.07433471266934186,3,3,3,2,3,2,3,4,2,2,2,4,2,3,4,4,4,1,4,4,1.0690449676496976,2.8,0,4.2,0,3,0,3,0,3.4,0,1,2,1,4,2,1,1,4,1,1,1,4,2,1,1,4,2,2,1,1,1.1821033884786185,1.25,0,"White, Caucasian, Anglo, European American",0,27,1,2,NA,1,2,4,Bartender,3,0,177,70,2,5,2,0,0,1,0,0,TRUE,TRUE,TRUE,TRUE,TRUE,1,0.8933387096851103,0.6326530612244898,0.04899955326418937,1,0.5211032258079897,0.713,1,1,0.0021197903225793633,0.016225467741079486,1,0.6413062500031665,0.8017531250016764,1,1,0.004371318024059032,0.020296432892644493,1.0915,0.5011,0.6352,0,13.9815,0.004,ML,change,49,-16.287539105668124,0.514481969437639,1.0566268185903336,0.6209000424736815,3.5476,4.8384,0.3464,9.622,0.3368,0,-77.4806,0.01,ML,cueing,63,167.3906041791746,3.219312886624626,1.2869624271704487,0.5193647593091588,5.3547508454099715,0.773730626503935,0.45111383077682843,0.139,0.389,0.538,0.01,1.559,83.49699296102649,1893.0864876163573,0.142,0.391,0.542,0.011,1.647,101.56546295557024,1883.5439748795482,320,0.9481481481481481,1,0,1,2,FALSE,FALSE,FALSE
216,2021-11-13T02:08:56Z,2021-11-13T02:29:53Z,1257,1,2021-11-13T02:29:54Z,1,Chrome,95.0.4638.69,Windows NT 10.0,1366,768,none,1.7786458333333333,670,44,283,64,48,92,-0.30626666961443483,-0.4161208746559078,-0.6956795578236804,-0.4945408633321733,-0.3307319143023651,-0.2259490504372247,2,2,1,1,1,1,1,2,1,2,2,1,1,3,2,2,1,1,2,2,0.6048053188292994,0,1,1,2,2,2.15,0,3,4,3,3,4,4,3,4,4,3,2,3,2,3,3,2,2,1,1,2,2,3,1,4,2,0,0,3,3,5,4,4,4,3,4,4,2,4,2,1,4,4,4,4,2,4,4,4,5,1,1,1,3,1,1,2,3,1,3,4,4,1,1,1,1,1,1,1,1.3573291208628593,0.6761234037828132,1.75,0,1,0,3.066666666666667,0,2.2222222222222223,0,2.75,0,1.1666666666666667,0,2.4285714285714284,0,1,0,2.2162162162162162,0,2,0,0,0.16475246242718228,-0.33105581968498016,-0.08315167862889894,4,1,3,1,1,1,1,1,1,1.2535663410560174,1.4285714285714286,0,1,-0.6467170085812028,4,4,4,4,3,2,2,7,6,NA,3,0.9511897312113419,3.5714285714285716,0,2.4285714285714284,2.5,3.8333333333333335,3.2559414990859232,-1.0219528370065065,0,-0.5267309819787295,2,2,2,3,2,2,4,3,2,3,2,4,2,4,4,2,4,3,3,3,0.8451542547285166,2.2,0,3.8,0,3.6,0,3.6,0,3.6666666666666665,0,1,2,2,3,2,2,2,3,1,1,3,3,2,2,1,3,2,2,1,1,0.7591546545162482,1.75,0,"White, Caucasian, Anglo, European American",0,28,1,2,NA,1,3,6,Administrative Assistant,2,0,220,65,1,5,2,0,0,0,0,0,TRUE,TRUE,TRUE,TRUE,TRUE,2,0.7658131578972465,0.76,0.01823575603046319,2,0.44372500002384185,0.5121931034449874,1,0.90625,0.003770278061075518,0.0072011128583689245,2,0.5855250000059604,0.6658937499672174,1,1,0.003631689669288205,0.006772259311291057,1.0528,1.1469,0.5296,0,-1.95,0.004,ML,change,50,15.636069016284438,1.331671837588745,0.865588260862781,0.59681285206227,1.0588,2.4489,0.3297,4.8309,0.3341,0,-68.6025,0.009,ML,cueing,64,149.68164925007903,2.8638041212844154,0.7921922887312768,0.3998152648542875,4.636808384705632,0.8935315809162038,0.35038399397022146,0.059,0.488,0.554,0.022,1.658,68.9038055198202,1874.1828652437896,0.061,0.488,0.575,0.026,1.751,83.4332766528749,1864.0300170673634,350,1.0370370370370372,1,0,0,1,FALSE,FALSE,FALSE
217,2021-11-13T01:54:59Z,2021-11-13T02:29:57Z,2097,1,2021-11-13T02:29:58Z,1,Chrome,95.0.4638.69,Windows NT 10.0,1536,864,No!,1.7777777777777777,1476,136,268,59,36,72,1.7646431465407644,0.4196750501568604,-0.7678931448377903,-0.555472896002391,-0.49647662994450314,-0.5637763856542862,2,2,2,1,3,1,2,3,1,3,2,1,2,2,2,2,1,1,2,2,0.6708203932499369,0,1,2,3,3,2.05,0,4,5,2,5,1,1,4,2,2,1,2,4,1,3,4,2,3,1,1,1,2,2,1,1,2,0,0,5,3,2,4,3,5,5,5,5,4,5,1,1,2,1,3,2,1,1,3,3,3,1,1,1,1,2,1,1,2,1,4,1,1,1,1,1,1,1,1,1,1.5314520382125407,1.486446705914413,1.625,0,1,0,1.6666666666666667,0,1.8888888888888888,0,2.0833333333333335,0,1.3333333333333333,0,1.1428571428571428,0,1,0,1.7027027027027026,0,1,0,0,-0.7112958401992617,-0.5341482934814965,-0.6227220668403791,5,1,4,1,1,1,1,1,1,1.7320508075688772,1.1428571428571428,0,1,-0.8176513788914915,5,5,5,5,3,3,1,6,6,4,3,1.5735915849388864,4.428571428571429,0,1.5714285714285714,3,3.8333333333333335,3.2559414990859232,-0.7395711320441822,0,-0.8635661140261877,2,3,3,2,2,2,4,5,2,2,1,3,2,3,4,1,4,2,3,3,1.162919151265879,2.4,0,4,0,3.6,0,3,0,3.533333333333333,0,1,2,1,4,1,1,1,3,1,1,1,3,2,1,1,3,1,1,1,2,0.9403246919632545,1.3,0,"Asian or Asian American (e.g., Chinese, Japanese, and others) & White, Caucasian, Anglo, European American",1,19,1,2,NA,1,4,4,Sales Associate,4,0,150,69,2,5,2,1,1,1,0,2,TRUE,TRUE,TRUE,TRUE,TRUE,6,0.6231642857137181,0.84,0.012245912248873591,6,0.42161562500009314,0.48724137931034484,1,0.9354838709677419,0.001098457489917083,0.003995315182859345,6,0.49806875000009315,0.5634290322598912,1,0.96875,0.0039835589920488934,0.00674855700612605,1.1235,1.622,0.4161,0,-9.7831,0.004,ML,change,50,31.302269016284434,1.9956490038125752,0.8309217068911321,0.4815996218859312,1.0814,3.4757,0.3455,6.5724,0.3393,0,-93.8048,0.009,ML,cueing,63,200.03900417917458,3.68028510780958,0.7266145342250723,0.4012619236985245,6.311268848875176,0.6564662076041875,0.3712333917404611,0.085,0.353,0.575,0.031,1.842,119.43469910129393,2000.4930467555837,0.08,0.352,0.559,0.026,1.999,134.2676984185013,1965.6915253665372,386,1.1437037037037037,1,0,0,1,FALSE,FALSE,FALSE
218,2021-11-13T02:11:24Z,2021-11-13T02:30:06Z,1122,1,2021-11-13T02:30:07Z,1,Chrome,95.0.4638.69,Windows NT 10.0,1920,1080,The break in between the color-changing test was a good idea. Thank you for that.,1.7777777777777777,571,43,263,60,48,59,-0.5606340043531007,-0.4252056129690901,-0.7919643405091602,-0.5432864894683475,-0.3307319143023651,-0.7833641535453761,2,2,2,2,2,2,1,2,1,2,2,1,1,1,2,2,1,1,1,1,0.5104177855340404,0,1,1,3,4,2.25,0,3,4,4,3,5,2,5,3,3,1,2,4,2,3,3,2,5,1,1,1,3,2,2,0,2,0,0,4,5,4,5,5,5,3,3,5,5,4,1,1,4,1,5,3,1,1,1,2,2,1,1,1,1,1,1,1,2,1,4,2,2,1,1,1,2,2,1,2,1.626082453058314,1.1254628677422756,2.125,0,1.75,0,2.6,0,1.6666666666666667,0,1.75,0,1.3333333333333333,0,1.4285714285714286,0,1,0,1.5945945945945945,0,0,0,0,-0.1417821718030628,-0.5020371591262895,-0.32190966546467614,5,1,4,1,1,1,1,1,1,1.7320508075688772,1.1428571428571428,0,1,-0.8176513788914915,4,5,4,4,3,2,1,7,8,NA,3,1.3801311186847085,3.857142857142857,0,2.142857142857143,1.5,3.8333333333333335,3.2559414990859232,-1.5867162469311549,0,-0.968454681783927,2,3,2,1,2,2,5,3,2,2,1,3,1,3,4,3,4,1,5,4,1.3557637102737474,2,0,4.2,0,4,0,3.2,0,3.8,0,1,3,4,1,3,4,4,1,4,3,3,1,2,4,1,1,4,4,2,4,1.3018205875255096,3.3,0,"Asian or Asian American (e.g., Chinese, Japanese, and others)",0,21,0,1,NA,1,3,2,Unemployed,5,0,145,69,2,5,2,0,0,1,0,0,TRUE,TRUE,TRUE,TRUE,TRUE,3,0.888990909089419,0.88,0.11337387590205109,3,0.34770937499497084,0.4274999999947125,1,0.96875,9.325150706326592e-4,0.003629660645287595,3,0.48901250000158325,0.5187032258063555,1,0.96875,0.005746380483884771,0.0036924795865836105,1.6306,1.3169,0.4045,0,20.7707,0.003,ML,change,50,-29.805330983715564,1.3139341190423166,1.5163851336339627,0.45044049592190166,1.3214,4.2295,0.2777,7.5782,0.2605,0,-100.1356,0.012,ML,cueing,64,212.747849250079,4.310169120903319,0.7967175087935892,0.34085343885728653,6.575041972550329,0.630130536609258,0.3012884578442746,0.068,0.342,0.452,0.046,1.617,102.16579048966241,1962.4661200618225,0.066,0.342,0.444,0.03,1.723,131.64572402722723,1959.299356433264,278,0.8237037037037037,1,0,1,2,FALSE,FALSE,FALSE
219,2021-11-13T02:05:01Z,2021-11-13T02:30:07Z,1505,1,2021-11-13T02:30:08Z,1,Chrome,93.0.4577.107,CrOS x86_64 14092.77.0,1536,864,NA,1.7777777777777777,814,59,365,72,53,86,0.06372218091453376,-0.2798497999581739,-0.30091194881321337,-0.39704961105982484,-0.2616716161181409,-0.3272972510023432,4,4,1,1,3,1,1,4,1,4,3,1,1,1,4,4,1,1,4,4,1.465390194130093,0,1,1,3,2,1.1,0,5,5,1,5,1,1,3,1,1,1,1,4,1,4,3,2,1,1,1,1,1,1,1,5,2,0,0,4,4,5,5,5,5,5,5,5,1,5,1,1,4,1,4,1,1,1,1,1,4,1,1,1,1,1,1,2,2,2,5,1,1,1,1,1,1,2,2,2,1.7731734670201176,1.7265434778633235,1.125,0,1.75,0,1.4,0,1.2222222222222223,0,1.1666666666666667,0,1,0,1.2857142857142858,0,1,0,1.2162162162162162,0,3,0,0,-1.2498366374386316,0.10724026226325957,-0.571298187587686,5,1,3,1,1,1,1,1,1,1.5735915849388864,1.2857142857142858,0,1,-0.7321841937363471,5,4,5,3,3,2,2,3,3,3,2,1.2724180205607036,3.7142857142857144,0,2.2857142857142856,6,3.8333333333333335,3.2559414990859232,0.9547190977297628,0,0.3819339879679685,2,2,3,1,1,2,4,2,1,3,1,5,1,5,4,2,4,3,3,3,1.3557637102737474,1.8,0,4.2,0,3.8,0,4.2,0,4.066666666666666,0,1,2,1,4,1,1,2,4,1,1,1,4,2,1,1,4,1,1,1,2,1.1964860832322377,1.2,0,"White, Caucasian, Anglo, European American",0,29,1,2,NA,1,3,4,Realtor,5,0,125,61,2,5,2,0,0,1,0,0,TRUE,TRUE,TRUE,TRUE,TRUE,2,0.8063176470586263,0.68,0.03434264150623493,2,0.5305468750001164,0.6055766666668156,1,0.9375,0.007024361280265259,0.007371990312394933,2,0.649421875,0.7160000000002483,1,0.967741935483871,0.011800008860864403,0.011787045698901204,1.1426,0.6587,0.5065,0,16.7715,0.005,ML,change,50,-21.80693098371556,0.7695568086520397,0.9794881857996832,0.5772145172289196,1.1094,2.8516,0.4311,3.8871000000000002,0.3878,0,-62.174,0.009,ML,cueing,64,136.824649250079,3.181273354508789,0.8512472520678287,0.48851012403480737,3.968814349818075,1.0439225323254155,0.40314107265556953,0.08,0.444,0.378,0.012,1.264,63.332716568621535,1920.2152788625992,0.08,0.444,0.382,0.012,1.324,86.27604299691856,1909.8430227113786,410,1.2148148148148148,1,0,0,1,FALSE,FALSE,FALSE
221,2021-11-13T02:03:57Z,2021-11-13T02:32:01Z,1684,1,2021-11-13T02:32:02Z,1,Chrome,95.0.4638.69,Macintosh,1280,800,thanks!,1.6,827,97,399,76,78,115,0.09712395214284343,0.06537025594275213,-0.13722781824789776,-0.3483039849236506,0.08362987480298012,0.16255238506239597,3,3,1,1,2,1,2,2,1,3,2,1,1,1,2,2,1,1,2,2,0.7326950970650465,0,1,2,3,4,1.9,0,4,4,2,4,2,2,4,2,2,2,2,4,2,3,3,2,2,1,1,1,1,2,2,1,2,0,0,4,3,5,4,4,5,5,5,4,1,4,2,1,4,2,4,2,2,1,1,2,4,1,1,1,2,1,1,2,1,1,4,2,1,1,1,1,1,1,2,1,1.5007505629691607,0.9411239481143202,1.5,0,1.25,0,2.1333333333333333,0,1.6666666666666667,0,1.6666666666666667,0,1.1666666666666667,0,1.2857142857142858,0,1,0,1.5135135135135136,0,1,0,0,-0.6457688596580947,-0.4557470907642554,-0.5507579752111751,4,2,3,1,1,2,2,1,1,1.0690449676496976,1.8571428571428572,0,1,-0.39031545311577004,5,5,5,5,2,2,1,6,3,3,3,1.8126539343499315,4.142857142857143,0,1.8571428571428572,4.5,3.8333333333333335,3.2559414990859232,0.10757398284279028,0,-0.28065156173982786,2,2,2,3,2,2,3,2,2,3,2,3,3,4,4,4,4,2,3,3,0.7988086367179802,2.2,0,3.8,0,2.8,0,3.8,0,3.466666666666667,0,2,1,1,2,2,2,2,2,2,1,2,3,2,2,2,2,1,2,3,3,0.6048053188292994,2.05,0,"White, Caucasian, Anglo, European American",0,28,1,2,NA,1,2,6,pharmacy technician,1,0,130,68,2,5,2,0,0,1,0,0,TRUE,TRUE,TRUE,TRUE,TRUE,4,0.8456787878796458,0.66,0.030386963367030128,4,0.6322093750000931,0.6758000000000466,1,1,0.008111216360700465,0.00818516580643805,4,0.7044937500003725,0.818724999998929,1,1,0.013675219959709602,0.014701244516203896,1.1442,0.5994,0.5703,0,15.5433,0.006,ML,change,50,-19.350530983715565,0.7024888271406415,0.9442060738675203,0.6306248738783093,4.346,6.1752,0.3239,6.6364,0.3048,0,-65.8877,0.011,ML,cueing,64,144.252049250079,3.8199319304043935,1.084609569457151,0.5382693398266882,3.828608840784722,1.0821514807823367,0.4953013895406776,0.259,0.248,0.574,0.012,1.644,73.41001252529847,1883.3723448477008,0.262,0.25,0.576,0.013,1.698,94.40730408483915,1879.0654509059166,386,1.1437037037037037,1,0,0,1,FALSE,FALSE,FALSE
222,2021-11-13T01:54:50Z,2021-11-13T02:32:26Z,2255,1,2021-11-13T02:32:27Z,1,Edge,95.0.1020.44,Windows NT 10.0,1536,864,NA,1.7777777777777777,1531,80,332,105,69,88,1.90595833250669,-0.08907029538134635,-0.459781840244255,0.0051018045636124325,-0.04067866192862343,-0.293514517480637,2,3,3,4,2,2,2,3,1,3,3,1,2,3,2,3,2,2,3,3,0.7591546545162482,0,1,1,3,3,2.25,0,4,4,2,4,2,1,4,2,2,1,2,4,2,4,5,1,1,1,1,1,1,1,1,1,2,0,0,5,5,5,5,5,5,5,5,5,1,5,1,1,4,1,5,1,1,1,2,2,5,1,1,1,2,1,1,2,1,1,5,1,2,1,1,1,1,1,1,1,1.8611727388837298,1.3020130933435712,1,0,1,0,1.8,0,1,0,1.25,0,1,0,1.1428571428571428,0,1,0,1.162162162162162,0,1,0,0,-1.1548854292984765,-0.5341482934814965,-0.8445168613899865,4,2,3,2,2,2,3,1,1,0.7867957924694432,2.2857142857142856,0,1,-0.1339138976503373,5,5,5,4,3,3,1,3,3,4,3,1.4960264830861913,4.285714285714286,0,1.7142857142857142,6,3.8333333333333335,3.2559414990859232,0.9547190977297628,0,0.06324999828222155,3,2,2,2,2,2,5,2,1,3,1,2,1,5,5,1,4,1,4,3,1.5886502207249789,2.2,0,4,0,4.4,0,4.4,0,4.266666666666667,0,1,2,1,4,2,1,2,3,1,1,2,4,2,2,1,4,1,2,1,2,1.050062654772261,1.45,0,"White, Caucasian, Anglo, European American",0,21,1,2,NA,1,2,4,Student,5,0,145,64,2,5,2,0,0,0,0,0,TRUE,TRUE,TRUE,TRUE,TRUE,5,0.9347121951231142,0.82,0.08622242303413777,5,0.4781129032142701,0.5938903225852598,1,0.96875,0.006630503828754568,0.01206177124953195,5,0.680625,0.7447066666483879,1,0.9375,0.021415052255271485,0.013914624800696199,1.6296,0.9972,0.4336,0,32.326,0.005,ML,change,50,-52.91593098371556,1.1404436936754843,1.3296118850735372,0.561633010606529,1.552,2.8358,0.3305,5.1446,0.3273,0,-58.0704,0.009,ML,cueing,63,128.5702041791746,3.1923319527445164,1.075698660201322,0.43593878294795196,4.026482925815719,1.028971140006059,0.35433045954739095,0.07,0.486,0.395,0.018,1.841,48.478287291322076,1912.46681389494,0.071,0.488,0.439,0.018,1.953,56.22927094028763,1898.195556776898,380,1.125925925925926,1,0,0,1,FALSE,FALSE,FALSE
223,2021-11-13T02:09:30Z,2021-11-13T02:33:44Z,1453,1,2021-11-13T02:33:45Z,1,Chrome,91.0.4472.106,Macintosh,1440,900,"When it asked questions about not knowing if a parent would be home, or when they would get home, my answer was occasionally, but only because my dad is a pilot, so it was hard for me to keep track of when he was coming home from trips... not because there was any instability.",1.6,709,63,339,83,53,81,-0.20606135592950586,-0.24351084670544482,-0.4260821663043371,-0.26299913918534573,-0.2616716161181409,-0.4117540848066085,4,4,1,1,4,1,1,3,1,4,3,1,1,2,4,4,1,1,3,3,1.348488432516786,0,1,1,5,4,1.25,0,5,5,2,5,2,2,4,2,1,1,2,5,2,5,4,2,2,1,1,1,1,2,2,1,2,0,0,5,4,5,5,5,5,5,5,5,1,3,2,4,4,2,5,1,1,2,2,1,5,1,1,1,2,2,1,1,1,1,5,1,1,1,1,1,2,1,1,1,1.7672360122867357,1.5976172734359604,1.5,0,1.25,0,1.5333333333333334,0,1.1111111111111112,0,1.8333333333333333,0,1.1666666666666667,0,0.8571428571428571,0,1,0,1.3513513513513513,0,1,0,0,-0.9733069721415648,-0.4557470907642554,-0.7145270314529101,4,2,4,1,1,2,1,2,1,1.3451854182690985,1.5714285714285714,0,1.5,-0.3767559860388676,5,5,5,5,3,3,2,7,4,4,4,1.2909944487358056,4.285714285714286,0,1.7142857142857142,3.5,3.8333333333333335,3.2559414990859232,-0.4571894270818581,0,-0.6427042641235889,4,3,4,4,4,4,5,4,3,2,2,3,3,4,4,1,3,2,3,4,1.0600988273786194,3.8,0,3.2,0,3.6,0,3,0,3.2666666666666666,0,1,1,2,4,3,1,3,4,1,1,1,4,1,2,1,4,2,2,1,2,1.190974832912761,1.45,0,"White, Caucasian, Anglo, European American",0,24,1,2,NA,1,3,6,Teacher,2,0,165,66,2,5,2,0,0,1,0,0,TRUE,TRUE,TRUE,TRUE,TRUE,4,0.9206974999979138,0.8,0.06606923626015619,4,0.45753548387365955,0.5297374999970198,0.96875,1,0.0031529122488274325,0.004742376613315845,4,0.6019750000108034,0.6640709677434736,1,0.96875,0.005369578708845973,0.008753958780273569,1.4147,1.0427,0.5255,0,21.5991,0.005,ML,change,50,-31.46213098371556,1.1317640007438874,1.2248970281867115,0.596010455512948,1.3483,3.4782,0.3359,5.4449,0.3407,0,-75.0332,0.011,ML,cueing,64,162.543049250079,4.378380332371844,0.9462710892790634,0.4250526567273054,4.464602991434014,0.7691584696497643,0.37677958388880517,0.064,0.463,0.423,0.026,1.708,29.369237926488132,1863.6753529469274,0.063,0.464,0.421,0.031,1.787,49.78734185441053,1872.9153661256169,374,1.108148148148148,1,0,0,1,FALSE,FALSE,FALSE
224,2021-11-13T02:11:55Z,2021-11-13T02:34:15Z,1339,1,2021-11-13T02:34:17Z,1,Chrome,95.0.4638.69,Windows NT 10.0,1920,1080,NA,1.7777777777777777,619,63,347,114,57,93,-0.43730438751011125,-0.24351084670544482,-0.38756825323014515,0.11477946337000441,-0.2064233775707615,-0.20905768367637165,3,2,2,1,2,1,1,2,1,3,1,1,1,1,2,2,2,1,2,3,0.7326950970650465,0,1,1,5,4,2,0,3,4,4,4,2,1,4,1,1,1,2,3,3,3,4,3,3,1,1,1,3,2,4,1,2,0,0,5,3,5,5,5,5,2,4,3,1,4,1,1,3,1,5,4,4,4,4,4,4,1,1,1,3,1,1,2,1,1,4,3,2,2,1,2,1,1,2,2,1.5299806668193037,1.2344267996967353,2.25,0,1.5,0,2.1333333333333333,0,1.8888888888888888,0,2.5,0,1.3333333333333333,0,1.5714285714285714,0,1.6666666666666667,0,1.972972972972973,0,1,0,0,-0.12600536555755287,-0.3773458880470143,-0.2516756268022836,5,1,5,1,1,1,1,2,1,1.9518001458970664,1,0,1.5,-0.7186247266594448,5,5,5,4,4,1,1,7,7,NA,3,1.8126539343499315,4.142857142857143,0,1.8571428571428572,2,3.8333333333333335,3.2559414990859232,-1.3043345419688306,0,-0.9866058241456384,3,4,4,3,3,2,4,2,2,2,3,3,3,3,4,3,2,2,3,3,0.7037315505489968,3.4,0,3.2,0,3,0,3.6,0,3.2666666666666666,0,3,1,4,2,3,4,3,1,3,1,1,2,2,2,1,2,2,3,3,3,0.9787209698591858,2.6,0,"White, Caucasian, Anglo, European American",0,24,1,3,NA,1,2,6,unemployed,2,0,265,63,1,5,2,0,0,0,0,0,TRUE,TRUE,TRUE,TRUE,TRUE,2,0.7484000000238419,0.8,0.06706241578795664,2,0.5088000000215346,0.6006387096835721,0.96875,0.96875,0.005094416931383707,0.004418536761143591,2,0.6942125000357627,0.7608964285509927,1,0.875,0.008576504347407126,0.010430953544048282,1.2663,1.0912,0.3962,0,15.244,0.004,ML,change,50,-18.75193098371556,1.1275502325762066,1.229474591080976,0.421281644966996,1.2498,3.8992,0.4483,3.3407,0.3299,0,-63.3172,0.011,ML,cueing,64,139.11104925007902,4.10337491058896,0.8368689869462266,0.5050387837253713,3.9599271426910763,0.8671844407095548,0.4061484380267953,0.065,0.524,0.404,0.01,1.46,152.35753149857956,2037.8464125037683,0.065,0.526,0.427,0.012,1.618,185.70179032518516,2051.4109560058228,325,0.9629629629629629,1,0,0,1,FALSE,FALSE,FALSE
225,2021-11-13T02:10:48Z,2021-11-13T02:34:21Z,1413,1,2021-11-13T02:34:23Z,0.8999999761581421,Chrome,95.0.4638.69,Windows NT 10.0,1280,1024,veryyy fun!!! thank you,1.25,669,103,341,84,58,96,-0.3088360366319971,0.1198786858218457,-0.41645368803578914,-0.2508127326513022,-0.19261131793391667,-0.15838358339381242,2,2,4,4,2,2,3,2,2,2,1,2,2,2,2,2,2,2,2,2,0.6958523739384593,1,1,1,2,2,2.8,0,2,4,5,2,5,4,1,5,5,5,3,1,1,1,3,3,4,1,1,2,5,5,5,0,2,0,0,4,2,1,3,3,4,2,4,2,1,4,5,2,2,2,3,5,5,5,5,5,2,3,1,1,1,1,1,1,1,1,2,5,5,1,1,3,1,3,1,1,1.5644319887574043,1.6846647257229665,3.25,0,1.5,0,4.066666666666666,0,3.2222222222222223,0,3.6666666666666665,0,1.6666666666666667,0,2.4285714285714284,0,1.6666666666666667,0,2.891891891891892,0,0,0,0,1.5294945977749739,-0.5804383618435307,0.4745281179657216,5,2,4,2,1,1,1,1,1,1.6035674514745464,1.4285714285714286,0,1,-0.6467170085812028,5,5,5,5,3,3,1,5,7,NA,2,1.5735915849388864,4.428571428571429,0,1.5714285714285714,3,3.8333333333333335,3.2559414990859232,-0.7395711320441822,0,-0.8635661140261877,2,2,2,5,3,4,5,2,3,4,3,3,2,3,5,1,5,1,5,2,1.424279266355945,2.8,0,3.6,0,4.6,0,3.8,0,4,0,3,2,4,1,2,4,2,1,4,4,4,2,4,4,2,2,2,4,4,4,1.145931016569864,3.35,0,"White, Caucasian, Anglo, European American",0,25,1,2,NA,1,1,4,stay at home mom,1,0,180,66,2,5,2,0,0,0,0,0,TRUE,TRUE,TRUE,TRUE,TRUE,NA,NA,NA,NA,2,0.5111187499999068,0.5828281250002328,1,1,0.004038863508066193,0.00561266402218366,2,0.6698354838707995,0.7686290322580646,0.96875,0.96875,0.009922706290333493,0.01603590974807067,NA,NA,NA,NA,NA,NA,NA,NA,NA,NA,NA,NA,NA,3.9964,6.8713,0.292,8.3325,0.2713,0,-84.389,0.011,ML,cueing,64,181.254649250079,4.197785401698811,0.9869810697599831,0.4689421327645361,4.557720620186021,0.9090365714918331,0.41451024192983876,0.114,0.419,0.474,0.013,1.661,157.02073197344015,2039.005223166811,0.112,0.418,0.472,0.012,1.813,168.50158703969277,2061.2680641995535,488,1.4459259259259258,1,0,0,1,FALSE,FALSE,FALSE
226,2021-11-13T01:59:48Z,2021-11-13T02:34:45Z,2096,1,2021-11-13T02:34:47Z,1,Chrome,95.0.4638.69,Windows NT 10.0,1536,864,NA,1.7777777777777777,678,112,631,314,92,183,-0.2857117334739366,0.20164133064048606,0.9796756609036676,2.552060770178715,0.27699870971880786,1.311165324800405,2,2,1,1,2,1,1,2,1,2,1,1,1,2,2,2,1,1,2,1,0.5104177855340404,0,1,1,2,1,2.15,0,2,3,3,3,3,3,2,4,3,3,3,1,1,2,2,3,4,1,1,2,4,3,3,0,2,0,2,3,2,1,3,3,4,3,3,3,5,3,4,4,2,3,3,3,4,5,5,4,3,3,3,1,3,3,1,1,1,1,4,1,3,2,5,3,1,1,1,1,1.2105641104317713,0.8338093878327919,2.625,0,1,0,3.3333333333333335,0,3.2222222222222223,0,3.9166666666666665,0,2.5,0,1.2857142857142858,0,3.3333333333333335,0,3.027027027027027,0,0,0,2,1.0038269001101612,-0.3843414734796514,0.3097427133152549,3,3,2,3,3,4,3,3,1,0.5773502691896257,3.2857142857142856,0,2,0.8333440732100549,3,2,3,3,2,2,4,3,1,2,1,0.7559289460184544,2.4285714285714284,0,3.5714285714285716,7,3.8333333333333335,3.2559414990859232,1.5194825076544112,0,1.3813546697232235,2,3,2,4,3,2,5,2,2,5,1,5,2,4,4,1,5,2,3,2,1.5118578920369088,2.8,0,4.6,0,4.4,0,4,0,4.333333333333333,0,1,1,3,2,2,3,2,2,1,1,4,2,1,4,3,2,2,4,3,2,1.019545822516343,2.45,0,"Hispanic of Latino (e.g., Mexican American, Central American, and others) & White, Caucasian, Anglo, European American",1,25,1,2,NA,1,1,6,Student,1,0,330,62,1,5,2,0,0,1,0,0,TRUE,TRUE,TRUE,TRUE,TRUE,1,0.9855026315764377,0.76,0.0942921050172971,1,0.4936281250566244,0.6007483871675307,1,0.96875,0.004318765958518769,0.008364279350645001,1,0.7302437499910593,0.774546875,1,1,0.02344674964503584,0.022225762561946992,1.4515,0.8377,0.5106,0,29.556,0.005,ML,change,50,-47.37593098371556,0.8830988634580237,1.3052666667747057,0.6012089274349481,1.0351,3.5334,0.4601,4.5264,0.3793,0,-80.2781,0.01,ML,cueing,64,173.032849250079,3.4982728907917666,0.9816235930376288,0.4692160357470428,4.482007479942159,0.9243926398902396,0.3937280943336473,0.161,0.379,0.443,0.029,0.888,65.73997551105468,1900.016240205821,0.164,0.382,0.449,0.041,0.951,94.70230716588861,1879.109760585231,346,1.0251851851851852,1,0,0,1,FALSE,FALSE,FALSE
227,2021-11-13T02:17:50Z,2021-11-13T02:35:49Z,1078,1,2021-11-13T02:35:50Z,1,Chrome,95.0.4638.69,Macintosh,1792,1120,NA,1.6,606,50,231,58,45,55,-0.4707061587384209,-0.36161244477681426,-0.9460199928059279,-0.5676593025364346,-0.37216809321289956,-0.8509296205887885,2,3,2,3,1,2,2,2,1,1,2,2,1,2,2,2,3,1,1,1,0.6958523739384593,0,1,1,3,1,2.6,0,4,5,2,4,2,1,5,2,1,2,2,4,3,4,5,2,3,1,1,2,3,2,3,0,2,0,0,5,5,5,5,5,5,5,5,5,1,5,3,1,5,2,5,2,3,3,3,2,4,1,1,1,1,1,1,1,1,1,1,1,1,1,1,1,1,1,1,1,1.7958912064001051,1.4375905768565218,2.125,0,1,0,1.7333333333333334,0,1,0,1.9166666666666667,0,1,0,1.4285714285714286,0,1,0,1.4324324324324325,0,0,0,0,-0.5839199075668012,-0.7372407672780129,-0.6605803374224071,4,1,4,1,1,1,1,1,1,1.4638501094227998,1.2857142857142858,0,1,-0.7321841937363471,5,5,5,5,5,5,1,8,8,6,4,1.5118578920369088,5,0,1,1,3.8333333333333335,3.2559414990859232,-1.869097951893479,0,-1.747013513636583,3,3,3,4,3,4,4,4,3,2,3,3,4,NA,3,3,3,3,4,4,0.6333236937766509,3.2,0,2.8,0,3,0,2.5,1,2.7857142857142856,1,3,3,2,4,2,2,3,3,1,1,2,3,2,1,1,3,1,1,1,2,0.9445132413883326,1.75,0,"White, Caucasian, Anglo, European American",0,28,1,2,NA,1,3,6,Video producer,4,0,120,65,2,5,2,0,0,1,0,0,TRUE,TRUE,TRUE,TRUE,TRUE,2,0.7125236842105851,0.76,0.011891760918397597,2,0.4962000000001242,0.5342827586204071,0.967741935483871,0.9354838709677419,0.0036084853978364875,0.004851351957001301,2,0.6160967741937887,0.7310586206898864,0.96875,0.90625,0.030248626522096256,0.02197715934463918,1.0271,1.2267,0.4819,0,-7.5305,0.012,ML,change,50,26.79706901628444,1.4818922144044464,0.7778430163368074,0.576050071432447,1.2925,2.7556,0.3213,4.1167,0.3543,0,-55.1187,0.009,ML,cueing,62,122.61880315513527,3.5059323355800087,0.7627496464457938,0.4395390109323791,4.296584449925015,0.7916049181161829,0.41002298640862445,0.066,0.376,0.21,0.012,1.435,167.60098044013174,2097.4778963692524,0.067,0.362,0.22,0.011,1.63,163.7549907848387,2092.605135634247,440,1.3037037037037038,1,0,1,2,FALSE,FALSE,FALSE
228,2021-11-13T02:16:07Z,2021-11-13T02:37:38Z,1290,1,2021-11-13T02:37:39Z,1,Chrome,95.0.4638.69,Macintosh,1680,1050,"None at the moment, thank you!",1.6,706,45,269,64,63,86,-0.21376945698219268,-0.40703613634272556,-0.7630789057035163,-0.4945408633321733,-0.12355101974969247,-0.3272972510023432,4,4,1,1,4,1,1,4,1,4,3,1,1,2,4,4,1,1,4,4,1.4689774459950382,0,1,1,4,5,1.1,0,4,5,3,5,2,2,5,2,2,1,1,5,2,5,4,2,2,1,1,1,1,3,2,0,3,0,0,5,4,3,3,4,5,5,5,5,1,5,1,1,4,3,2,1,1,1,1,2,5,1,1,1,1,1,1,1,2,2,5,1,1,1,1,1,1,1,1,1,1.6725122711948326,1.5675276256394517,1.625,0,1,0,1.6,0,1.6666666666666667,0,1.5833333333333333,0,0.8333333333333334,0,1.1428571428571428,0,1,0,1.4054054054054055,0,0,0,0,-0.8677088395412498,-0.7372407672780129,-0.8024748034096314,5,1,4,1,1,1,1,1,1,1.7320508075688772,1.1428571428571428,0,1,-0.8176513788914915,5,5,5,5,4,3,1,6,7,5,3,1.5275252316519468,4.571428571428571,0,1.4285714285714286,2.5,3.8333333333333335,3.2559414990859232,-1.0219528370065065,0,-1.0844279639287866,2,2,1,1,1,1,5,1,1,4,1,5,1,5,5,2,5,2,5,3,1.8309508328682538,1.4,0,4.8,0,4.6,0,4.6,0,4.666666666666667,0,2,1,2,1,1,2,1,2,2,1,1,1,1,2,1,2,2,2,2,1,0.512989176042577,1.9,0,"Hispanic of Latino (e.g., Mexican American, Central American, and others)",0,19,1,2,NA,1,3,4,Substitute Teacher,6,0,141,64,2,5,2,0,0,1,0,0,TRUE,TRUE,TRUE,TRUE,TRUE,5,1.1306166666717756,0.84,0.1954200055366425,5,0.5873312499858439,0.700725806443922,1,1,0.003334253186384315,0.00785358664536801,5,0.7354718750044703,0.8964937500059604,1,1,0.012449267893556578,0.03610095931633496,1.6532,1.0297,0.586,0,33.5037,0.004,ML,change,50,-55.271330983715565,0.9984807355063239,1.6607511969298578,0.5651020935039537,2.9206,5.6499,0.4423,7.3799,0.3895,0,-79.8733,0.01,ML,cueing,63,172.17600417917458,3.8596283210216695,1.0734543281864035,0.5660096117825527,4.781485583015726,0.8664952878051804,0.4995533726413052,0.126,0.46,0.421,0.013,1.655,46.92137700484727,1840.6556582301644,0.125,0.462,0.423,0.013,1.731,63.1782510672547,1843.2760562028363,449,1.3303703703703704,1,0,0,1,FALSE,FALSE,FALSE
229,2021-11-13T02:04:49Z,2021-11-13T02:39:11Z,2062,1,2021-11-13T02:39:13Z,1,Chrome,95.0.4638.54,Macintosh,1440,900,NA,1.6,742,82,533,120,180,351,-0.12127224434995054,-0.07090081875498182,0.5078802257448167,0.18789790257426575,1.4924599577611537,4.148914940623722,2,4,2,1,2,1,3,3,2,3,2,2,1,1,2,2,2,1,2,2,0.7947194142390263,1,1,1,4,4,2.1,0,4,4,2,5,2,1,4,2,2,1,2,5,2,5,5,1,1,1,1,1,1,2,2,5,2,0,0,5,5,5,5,5,5,4,5,4,1,4,1,1,5,1,5,1,1,1,2,2,5,1,3,1,3,1,2,4,4,2,5,1,1,1,1,1,2,2,3,3,1.7612785418843047,1.533747356112131,1.25,0,2.5,0,1.6,0,1.2222222222222223,0,1.25,0,1.5,0,2,0,1,0,1.4594594594594594,0,3,0,0,-1.0056349064115053,0.3424438704149829,-0.3315955179982612,5,1,4,1,1,2,1,1,1,1.6761634196950514,1.2857142857142858,0,1,-0.7321841937363471,5,5,5,5,3,3,1,7,7,4,4,1.5735915849388864,4.428571428571429,0,1.5714285714285714,2,3.8333333333333335,3.2559414990859232,-1.3043345419688306,0,-1.145947818988512,2,3,2,2,2,2,4,2,2,3,2,4,3,4,3,3,4,1,4,3,0.9611501047232549,2.2,0,4.2,0,3.4,0,3.6,0,3.7333333333333334,0,1,1,2,2,2,2,2,2,1,2,1,3,1,2,1,2,2,2,1,1,0.5871429486123998,1.75,0,"White, Caucasian, Anglo, European American",0,22,1,2,NA,1,3,6,Student and graduate assistant,1,0,131,62,3,5,2,0,1,0,0,1,TRUE,TRUE,TRUE,TRUE,TRUE,1,0.9893949999988079,0.8163265306122449,0.11095581349782109,1,0.4568062499947846,0.5722968749981373,1,1,0.002126288991715513,0.005511995151383017,1,0.6178937500081957,0.7629172413780771,1,0.9354838709677419,0.00440095157294407,0.012453426257434164,1.6282,0.9354,0.4757,0,35.6516,0.004,ML,change,49,-59.62773910566813,1.0564917438527968,1.4118944946393754,0.5666565454122372,3.7126,6.6721,0.2941,9.8389,0.2681,0,-93.3326,0.013,ML,cueing,64,199.14184925007902,4.216822180898485,0.9825253588257185,0.4594368348387478,5.350654658426908,0.774322955017548,0.38670965335759977,0.07,0.486,0.455,0.013,1.706,118.05627441816414,2033.098926094349,0.069,0.486,0.493,0.012,1.797,126.38520126011824,1998.8822766842875,104,0.3081481481481481,1,0,0,1,FALSE,FALSE,FALSE
230,2021-11-13T02:06:42Z,2021-11-13T02:39:25Z,1962,1,2021-11-13T02:39:26Z,1,Chrome,94.0.4606.104,CrOS x86_64 14150.64.0,1366,768,no,1.7786458333333333,937,60,451,115,213,128,0.37975432407469445,-0.2707650616449916,0.11311261673434965,0.12696586990404798,1.9482579257770334,0.38214015295348597,2,2,3,3,2,4,4,1,1,1,1,3,3,3,1,1,4,3,1,1,1.1516578439248717,0,0,2,3,2,3.4,0,3,3,3,4,2,1,2,3,3,2,3,3,2,3,1,3,3,2,4,2,2,2,3,8,2,2,0,5,1,2,3,2,5,5,5,2,3,2,3,3,3,1,3,3,4,4,5,5,2,3,5,1,3,4,1,3,1,1,4,1,2,2,3,1,1,2,1,1,1.3976599920772768,0.8338093878327919,2.625,0,1.25,0,2.8,0,2.6666666666666665,0,3.4166666666666665,0,3.1666666666666665,0,1.4285714285714286,0,2,0,2.7567567567567566,0,4,2,0,0.6584793867115141,0.5667967458113412,0.6126380662614277,5,1,4,2,1,3,2,1,1,1.5118578920369088,1.7142857142857142,0,1,-0.4757826382709144,1,3,3,3,1,1,3,1,2,2,2,1.0690449676496976,2.142857142857143,0,3.857142857142857,7.5,3.8333333333333335,3.2559414990859232,1.8018642126167355,0,1.6818875170472591,3,3,3,4,2,2,5,3,3,3,2,4,3,4,5,2,5,2,4,2,1.162919151265879,3,0,4.2,0,3.8,0,3.8,0,3.933333333333333,0,3,2,3,1,3,3,1,1,3,3,3,3,3,2,1,3,2,2,2,2,0.8013147091860318,2.5,0,"White, Caucasian, Anglo, European American",0,18,1,2,NA,1,2,3,no job,2,0,100,63,1,5,2,0,0,1,0,0,TRUE,TRUE,TRUE,TRUE,TRUE,2,1.0244161290324503,0.62,0.24425956908448498,2,0.5522290322607564,0.6352700000007947,0.96875,0.9375,0.00882873168318735,0.009135435323383524,2,0.7601124999988824,0.7580531249959022,1,1,0.019128275322221774,0.01372678127898969,1.6874,0.3002,0.3262,0,56.3408,0.003,ML,change,50,-100.94553098371557,0.31091325936874054,1.5745492048575056,0.41670353109910707,1.5069,2.595,0.3723,3.0874,0.3174,0,-35.4375,0.007,ML,cueing,64,83.35164925007902,3.0151912567086963,0.8981354648985838,0.5049518103937953,3.4513280196566525,0.9949756108162587,0.4170941465258098,0.187,0.363,0.477,0.097,1.721,18.2418814899659,1807.4660621327107,0.195,0.356,0.489,0.175,1.708,32.06532781060658,1814.0406161176147,334,0.9896296296296296,1,0,0,1,FALSE,FALSE,FALSE
231,2021-11-13T02:12:17Z,2021-11-13T02:39:39Z,1642,1,2021-11-13T02:39:40Z,0.8999999761581421,Firefox,94.0,Windows NT 10.0,1366,768,NA,1.7786458333333333,775,70,358,151,65,151,-0.036483132770395235,-0.17991767851316898,-0.33461162275313133,0.5656765051296159,-0.09592690047600279,0.7706415884531067,4,4,2,1,1,1,2,3,1,4,1,1,1,1,3,3,3,1,1,2,1.1697953037312037,0,0,1,5,5,1.9,0,5,5,1,5,1,1,5,1,1,1,1,5,1,5,5,1,1,1,1,1,1,1,1,0,2,0,0,5,5,5,5,5,5,3,3,5,2,5,1,1,5,1,5,1,1,1,1,1,5,1,1,1,1,1,1,1,1,1,5,1,1,1,1,1,2,1,1,1,1.8639942259766993,2.065591117977289,1,0,1.25,0,1,0,1.4444444444444444,0,1.0833333333333333,0,0.8333333333333334,0,0.8571428571428571,0,1,0,1.135135135135135,0,0,0,0,-1.5102991258230931,-0.6588395645607719,-1.0845693451919325,5,1,2,1,1,1,1,1,1,1.4960264830861913,1.4285714285714286,0,1,-0.6467170085812028,5,5,5,5,2,2,3,3,3,2,3,1.4638501094227998,3.857142857142857,0,2.142857142857143,6,3.8333333333333335,3.2559414990859232,0.9547190977297628,0,0.30226299054653183,2,2,2,1,2,1,3,1,1,2,1,3,1,3,5,3,4,1,3,3,1.2909944487358056,1.8,0,4.4,0,3.2,0,4.2,0,3.933333333333333,0,1,1,2,1,2,3,2,1,1,1,2,2,1,3,1,2,1,3,2,1,0.7451598203705946,2.05,0,"White, Caucasian, Anglo, European American",0,20,1,2,NA,1,3,4,Student,2,0,121,68,1,5,2,0,0,1,0,0,TRUE,TRUE,TRUE,TRUE,TRUE,4,0.8106744186046512,0.86,0.019095920000000002,4,0.57525,0.7154838709677419,1,1,0.01690406451612903,0.04083399139784946,4,1.17159375,1.3179666666666667,1,0.9375,0.31962850705645157,0.33897785383064516,1.2776,1.5894,0.5048,0,-1.8935,0.004,ML,change,50,15.523069016284438,1.9148894966836216,0.9479868001689559,0.6324525166871382,1.6517,2.8732,0.428,3.9704,0.3673,0,-45.941,0.007,ML,cueing,63,104.3114041791746,2.555977556906098,1.6209589615515327,0.4083012062060385,3.1865057681536575,1.3002125299124032,0.37760703620231106,0.113,0.386,0.123,0.124,1.792,102.4196102670348,1994.6912323425063,0.125,0.378,0.142,0.182,1.835,133.5774790059532,2000.2455243091044,104,0.3081481481481481,1,0,0,1,FALSE,FALSE,FALSE
232,2021-11-13T02:08:42Z,2021-11-13T02:40:14Z,1892,1,2021-11-13T02:40:15Z,1,Chrome,87.0.4280.88,Macintosh,1440,900,My husband was admitted into an in-patient treatment earlier this week as he was suicidal. It has been a rough week which has had direct impact on my nerves and stress levels. My family life growing up was very calm but my current married life is not due to my husband's mental health issues.,1.6,851,97,494,115,92,89,0.1587887605643382,0.06537025594275213,0.32012489950813117,0.12696586990404798,0.27699870971880786,-0.27662315071978394,2,2,2,2,2,2,3,1,1,1,2,2,2,2,2,1,2,2,1,1,0.5501196042201808,0,1,1,3,1,2.75,0,4,4,3,4,3,2,4,2,3,2,2,4,2,4,4,2,3,1,1,1,2,2,2,3,2,0,0,4,4,4,4,4,5,4,5,5,1,5,3,1,4,2,4,2,2,2,3,3,4,1,1,1,3,1,1,3,3,2,4,3,2,1,1,1,1,1,2,2,1.397122740474849,0.9154754164341269,1.75,0,1.5,0,2.2,0,1.6666666666666667,0,2,0,1.3333333333333333,0,2.142857142857143,0,1,0,1.8108108108108107,0,2,0,0,-0.3819187134908551,-0.17425341425049792,-0.2780860638706765,5,2,4,2,1,2,2,1,1,1.3972762620115438,1.7142857142857142,0,1,-0.4757826382709144,5,5,5,5,3,3,2,7,7,NA,3,1.2909944487358056,4.285714285714286,0,1.7142857142857142,2,3.8333333333333335,3.2559414990859232,-1.3043345419688306,0,-1.0662768215670753,2,2,2,3,2,2,3,3,2,3,2,4,2,4,4,3,4,2,3,3,0.7988086367179802,2.2,0,4,0,3.2,0,3.6,0,3.6,0,2,2,1,4,2,2,3,3,2,3,3,2,2,4,1,2,1,4,2,3,0.9403246919632545,2.3,0,"White, Caucasian, Anglo, European American",0,29,1,2,NA,1,3,6,Office manager,4,0,95,64,3,5,2,0,0,2,0,0,TRUE,TRUE,TRUE,TRUE,TRUE,3,1.069666363632264,0.88,0.0986212675150723,3,0.554894687498745,0.61652281249917,1,1,0.0031322673699691874,0.004903464824323174,3,0.658517258065272,0.7557115624986182,1,1,0.010733075964217142,0.02526843082956429,1.7991,1.2104,0.5276,0,30.0382,0.004,ML,change,50,-48.34033098371556,1.3605333556812431,1.464447862575601,0.6606428101449746,10,9.7776,0.1051,11.6948,0.1274,0,-86.5751,0.018,ML,cueing,64,185.62684925007903,4.341969098837844,0.9542064054533389,0.5100748583289825,4.856772801702041,0.8530633191117327,0.4698170933708213,0.135,0.381,0.457,0.021,1.472,63.759160671241204,1868.574301347887,0.132,0.377,0.453,0.018,1.546,84.86917434628174,1867.5856858759976,422,1.2503703703703704,1,0,0,1,FALSE,FALSE,FALSE
233,2021-11-13T02:21:22Z,2021-11-13T02:40:21Z,1138,1,2021-11-13T02:40:22Z,1,Chrome,95.0.4638.69,Windows NT 10.0,1920,1080,N/A,1.7777777777777777,564,47,333,57,41,61,-0.5786195734760368,-0.38886665971636103,-0.454967601109981,-0.5798457090704782,-0.42741633176027893,-0.74958142002367,2,1,2,2,1,2,4,1,1,2,1,4,1,1,1,1,4,1,1,1,1.0809352675491624,0,0,5,2,1,3,0,3,4,4,3,2,1,3,1,2,1,1,2,2,3,2,3,5,5,5,3,5,3,3,3,3,0,3,4,4,4,4,2,1,5,5,1,1,3,2,1,3,3,4,1,5,5,5,3,1,5,4,1,4,3,3,3,3,3,3,2,1,1,1,3,1,4,1,2,1.429525635846921,1.0327955589886444,4,0,2,0,2.4,0,2.6666666666666665,0,2.8333333333333335,0,3.5,0,2.4285714285714284,0,1.6666666666666667,0,2.7837837837837838,0,2,0,3,1.0890990860138068,0.5118979318815265,0.8004985089476666,5,1,5,1,1,2,1,1,1,1.889822365046136,1.1428571428571428,0,1,-0.8176513788914915,5,5,5,5,4,3,1,6,5,6,4,1.5275252316519468,4.571428571428571,0,1.4285714285714286,3.5,3.8333333333333335,3.2559414990859232,-0.4571894270818581,0,-0.8020462589664623,1,1,1,2,1,1,5,1,1,1,1,5,3,5,3,5,5,1,5,3,1.8516401995451028,1.2,0,5,0,3,0,4.2,0,4.066666666666666,0,4,4,4,4,4,4,4,1,4,4,4,2,3,4,2,2,4,4,1,4,1.0894228312566052,3.45,0,"Hispanic of Latino (e.g., Mexican American, Central American, and others) & Filipino",1,28,1,3,NA,1,3,6,independent contractor,3,0,110,66,1,5,2,0,0,1,0,0,TRUE,TRUE,TRUE,TRUE,TRUE,5,0.6544822222206328,0.9,0.01555185211864936,5,0.42443870967145886,0.4910093749985099,1,1,0.0027545097848164966,0.003966044102519511,5,0.5590906249955296,0.6420166666636864,1,0.9375,0.007960774425874863,0.007670845231631474,1.3095,1.9719,0.3992,0,-11.6046,0.004,ML,change,50,34.945269016284435,2.3120387113086975,0.95034073892842,0.4900661621814836,2.7157,6.6703,0.2874,8.2757,0.2604,0,-94.7776,0.024,ML,cueing,63,201.9846041791746,4.578498851136888,0.9049111643574509,0.39527573838816066,5.015351946073019,0.8260905258374888,0.3446561534809929,0.065,0.426,0.54,0.018,1.949,61.52604407802573,1930.291306317882,0.071,0.417,0.581,0.019,2.02,73.6535309781196,1920.6104073781032,358,1.0607407407407408,1,0,1,2,FALSE,FALSE,FALSE
234,2021-11-13T02:18:59Z,2021-11-13T02:40:35Z,1295,1,2021-11-13T02:40:36Z,0.8999999761581421,Safari,14.1,Macintosh,1440,900,NA,1.6,630,108,305,84,60,66,-0.4090413503169261,0.16530237738775702,-0.5897662968696528,-0.2508127326513022,-0.16498719866022699,-0.6651245862194046,3,2,2,1,3,1,2,3,1,2,2,2,1,2,3,2,2,1,2,2,0.6863327411532597,0,1,2,3,3,2.05,0,4,5,2,5,2,1,4,2,2,2,1,4,2,5,4,2,2,1,1,1,1,1,1,0,2,0,0,5,1,4,4,4,4,4,4,3,2,4,2,1,3,2,5,1,1,1,1,1,4,1,1,1,1,1,1,1,1,1,5,1,1,1,1,1,1,1,1,1,1.5002502293786697,1.4638501094227998,1.25,0,1,0,1.6666666666666667,0,2.3333333333333335,0,1.5,0,1,0,0.8571428571428571,0,1,0,1.5135135135135136,0,0,0,0,-0.9537553472238163,-0.7372407672780129,-0.8454980572509145,5,2,4,1,1,2,1,1,1,1.6035674514745464,1.4285714285714286,0,1,-0.6467170085812028,5,5,5,5,4,4,1,7,7,3,4,1.4638501094227998,4.714285714285714,0,1.2857142857142858,2,3.8333333333333335,3.2559414990859232,-1.3043345419688306,0,-1.3052898138313853,1,1,2,3,2,2,5,2,2,3,1,4,1,4,4,4,4,1,4,4,1.3627702877384937,1.8,0,4.4,0,3.8,0,3.6,0,3.933333333333333,0,2,4,2,2,1,2,2,2,2,3,3,3,2,3,1,3,1,3,2,1,0.8335087534664907,2.2,0,"White, Caucasian, Anglo, European American",0,19,1,2,NA,1,4,3,Student,3,0,140,65,3,5,2,0,0,1,0,0,TRUE,TRUE,TRUE,TRUE,TRUE,2,0.6201081081081097,0.7551020408163265,0.026753752551019833,2,0.44229032258064516,0.480064516129036,0.96875,0.96875,0.004234435483870781,0.00683478931451541,2,0.5645806451612885,0.6789230769230702,0.96875,0.8125,0.012001361895160555,0.01785941028225734,1.0159,1.1417,0.3886,0,-3.7317,0.007,ML,change,49,19.138860894331877,1.1851649684569467,0.9500882095108335,0.4156054037147274,1.0404,3.5391,0.3409,4.0444,0.3215,0,-75.5592,0.012,ML,cueing,64,163.59504925007903,3.679421433545265,0.9332954287805968,0.36116478144456043,4.147266434034609,0.8280122001094684,0.34870320321543813,0.054,0.403,0.324,0.006,1.294,79.28691068547623,2063.6336961514853,0.054,0.403,0.34,0.006,1.304,108.08306191166851,2071.448807227145,431,1.2770370370370372,1,0,0,1,FALSE,FALSE,FALSE
235,2021-11-13T02:08:34Z,2021-11-13T02:42:25Z,2030,1,2021-11-13T02:42:25Z,1,Chrome,95.0.4638.69,Windows NT 10.0,1920,1080,"For context, most of the questions were answered about my stepfather, not my birth father. My mom and birth father split when I was under age 1, and my stepfather has been around since I was 3. That's why there were issues with custody, they had to do with my birth father. Most of them I answered with my stepfather in mind.",1.7777777777777777,695,98,590,106,97,106,-0.2420324941753778,0.07445499425593438,0.7822918563984341,0.017288211097655985,0.34605900790303207,0.010530084214718316,2,4,2,1,2,1,1,2,1,3,3,1,1,1,4,3,1,1,3,2,1.050062654772261,0,1,1,5,4,1.65,0,1,3,2,3,2,1,4,2,1,1,1,4,3,4,2,3,1,2,4,2,1,4,2,7,2,0,0,4,1,1,1,1,5,3,5,2,3,4,1,1,1,1,1,5,1,1,2,4,4,1,1,3,4,2,1,5,2,2,3,4,2,1,3,1,4,2,2,2,1.4570940680419788,1.162919151265879,2.375,0,2.5,0,2.2666666666666666,0,3.4444444444444446,0,2.5833333333333335,0,2,0,2.5714285714285716,0,1.6666666666666667,0,2.675675675675676,0,4,0,0,0.28699851327429293,0.5455363442114993,0.41626742874289613,5,1,3,1,1,2,1,1,1,1.5275252316519468,1.4285714285714286,0,1,-0.6467170085812028,3,4,5,2,1,1,2,3,3,2,2,1.5118578920369088,2.857142857142857,0,3.142857142857143,6,3.8333333333333335,3.2559414990859232,0.9547190977297628,0,0.8599599724965891,3,5,2,2,3,3,1,4,2,1,3,3,2,1,4,5,3,1,1,4,1.3557637102737474,3,0,3.4,0,1.6,0,2.6,0,2.533333333333333,0,1,1,2,3,4,2,2,2,1,1,1,2,3,3,1,2,1,2,4,3,0.998683343734455,2.15,0,"White, Caucasian, Anglo, European American",0,23,1,2,NA,1,3,6,Data entry editor,4,0,200,67,1,5,2,0,0,0,0,0,TRUE,TRUE,TRUE,TRUE,TRUE,4,0.9634609756106284,0.82,0.12097707296318083,4,0.4173193548389019,0.49880333333363136,0.96875,0.9375,0.004922165070588962,0.005967858709707,4,0.5869312499999069,0.6588899999981125,1,0.9375,0.0093539344756045709,0.007853179102718384,1.4616,1.047,0.5355,0,25.5753,0.003,ML,change,50,-39.41453098371556,1.047859694483298,1.4470901947572308,0.5215422103787486,1.2777,3.1156,0.3168,3.0971,0.2202,0,-50.2364,0.008,ML,cueing,64,112.94944925007903,3.3538415729207127,0.807447263748922,0.3934739162429736,3.9941261117595657,0.859759333681215,0.3164181373043541,0.072,0.406,0.416,0.017,1.994,84.35482746637437,1946.0773492828446,0.075,0.407,0.477,0.018,2.168,101.51013032485476,1947.1688731137208,432,1.28,1,0,1,2,FALSE,FALSE,FALSE
236,2021-11-13T02:01:44Z,2021-11-13T02:42:49Z,2464,1,2021-11-13T02:42:51Z,1,Edge,95.0.1020.44,Windows NT 10.0,1600,900,NA,1.7777777777777777,793,92,569,120,65,117,0.009765473545725838,0.01994656437684081,0.6811928345786803,0.18789790257426575,-0.09592690047600279,0.19633511858410213,2,2,2,2,1,1,3,2,1,2,4,1,1,1,2,3,1,1,2,3,0.8750939799154206,0,1,2,4,2,2.05,0,2,4,5,2,5,4,3,5,5,2,4,2,2,3,3,4,4,5,3,1,4,5,3,7,1,2,0,4,2,3,4,4,4,1,3,2,1,4,5,1,3,3,5,5,5,5,5,1,1,4,3,1,5,1,1,3,2,2,3,5,3,1,3,1,2,3,2,1,1.5082356496167217,1.2421180068162376,3.625,0,2,0,3.6666666666666665,0,3,0,3.0833333333333335,0,3,0,2.5714285714285716,0,1.6666666666666667,0,2.891891891891892,0,4,2,0,1.5187508830924488,0.8020003539630645,1.1603756185277567,5,1,3,1,1,2,2,1,1,1.4638501094227998,1.5714285714285714,0,1,-0.5612498234260587,3,4,5,3,1,1,4,3,3,1,1,1.5275252316519468,2.7142857142857144,0,3.2857142857142856,6,3.8333333333333335,3.2559414990859232,0.9547190977297628,0,0.9396309699180257,2,2,2,2,2,2,4,2,2,3,1,4,1,4,3,4,4,1,3,2,1.1751393027860062,2,0,4.4,0,3.4,0,3.8,0,3.8666666666666667,0,1,2,1,4,3,1,4,3,1,1,1,3,3,1,1,4,1,1,1,4,1.2763022245616642,1.65,0,"White, Caucasian, Anglo, European American",0,30,1,2,NA,1,2,6,Youth Justice,2,0,150,70,1,5,2,0,0,0,0,0,TRUE,TRUE,TRUE,TRUE,TRUE,6,0.7886268292636406,0.8367346938775511,0.055620091524215515,6,0.5730062500238419,0.625453125,1,1,0.0020025522190909232,0.0035778819231876255,6,0.6352937500029803,0.704393750011921,1,1,0.004009750284980689,0.00630877866434605,1.2041,1.3703,0.5362,0,3.5878,0.011,ML,change,49,4.499860894331879,1.3513237647774958,1.2092812748642383,0.487287527375234,9.9999,11.1484,0.177,14.0289,0.2166,0,-100.9895,0.023,ML,cueing,64,214.45564925007903,4.697924071589181,0.8819075539017858,0.5345248841617705,5.431459329909198,0.7628032310905284,0.5049798150241617,0.089,0.472,0.543,0.022,1.608,94.13842339131818,1924.4168587783604,0.093,0.464,0.53,0.023,1.757,127.81632145056453,1916.6093357406792,368,1.0903703703703704,1,0,0,1,FALSE,FALSE,FALSE
237,2021-11-13T01:46:18Z,2021-11-13T02:43:05Z,3407,1,2021-11-13T02:43:06Z,1,Chrome,87.0.4280.141,Macintosh,1440,900,Thank you for allowing me to participate!,1.6,1682,259,429,127,595,232,2.2939327521585944,1.537097862678279,0.007199355780321893,0.27320274831257063,7.224464707051762,2.1388422960822058,2,2,1,1,1,1,2,2,1,3,1,1,1,3,2,2,1,1,1,2,0.6863327411532597,0,1,2,3,1,2.25,0,4,4,2,4,3,1,4,1,1,1,1,4,1,4,2,2,2,1,1,1,3,1,2,2,2,0,5,4,2,2,2,3,4,2,4,2,1,4,2,1,3,2,2,1,1,1,1,1,3,3,1,1,2,1,1,1,1,1,4,1,1,1,1,1,2,3,3,1,1.0842857905901357,1.4074631010979937,1.625,0,2.25,0,1.8,0,3.2222222222222223,0,1.6666666666666667,0,1.6666666666666667,0,1,0,1,0,1.9189189189189189,0,1,0,5,-0.5610774150886396,0.7401059546006128,0.08951426975598659,4,2,2,1,2,3,2,3,1,0.9511897312113419,2.2857142857142856,0,2,0.2350737771240448,4,5,5,4,2,3,2,8,4,NA,3,1.2724180205607036,3.857142857142857,0,2.142857142857143,3,3.8333333333333335,3.2559414990859232,-0.7395711320441822,0,-0.5448821243404407,3,2,3,4,3,2,4,1,1,2,1,2,1,4,4,2,3,1,4,4,1.2983506020002016,3,0,3.8,0,3.8,0,4,0,3.8666666666666667,0,2,1,3,3,2,3,2,2,3,2,3,1,3,4,1,2,2,1,1,1,0.9119095061289915,2.3,0,Black or African American,0,25,1,2,NA,1,3,7,Direct Care Staff,1,0,240,67,2,5,2,0,0,2,0,0,TRUE,TRUE,TRUE,TRUE,TRUE,NA,NA,NA,NA,4,0.7549893548383543,0.8971538709658724,1,0.96875,0.07044758764620904,0.14273554189223062,NA,NA,NA,NA,NA,NA,NA,NA,NA,NA,NA,NA,NA,NA,NA,NA,NA,NA,NA,NA,2.0079,1.9286,0.3964,2.3641,0.3303,0,1.0929,0.01,ML,cueing,63,10.243604179174596,1.7211859203311697,1.9951285703199455,0.35379797530671464,2.230211047803283,1.8577321327828793,0.3515122925652424,NA,NA,NA,NA,NA,NA,NA,NA,NA,NA,NA,NA,NA,NA,104,0.3081481481481481,1,0,1,2,FALSE,FALSE,FALSE
238,2021-11-13T02:04:18Z,2021-11-13T02:43:18Z,2339,1,2021-11-13T02:43:18Z,1,Chrome,95.0.4638.54,Macintosh,1440,900,Thank you for letting me take part in this survey! Have a great weekend!,1.6,1129,473,387,98,74,91,0.8730727914466526,3.4812318616992832,-0.19499868785918564,-0.08020304117469244,0.028381636255600768,-0.2428404171980778,3,3,2,1,3,1,2,2,1,3,2,2,3,2,3,3,2,1,3,3,0.7863975156570492,1,1,2,4,4,1.95,0,3,4,3,4,3,3,4,3,2,2,2,4,2,4,1,2,2,1,1,2,3,3,3,0,2,0,0,4,2,3,3,2,4,4,4,2,3,3,4,1,4,1,4,3,3,4,4,4,3,1,1,1,3,3,1,1,1,1,4,3,2,1,1,2,2,2,1,1,1.2142794054394872,0.9611501047232549,2.125,0,1.5,0,2.533333333333333,0,2.888888888888889,0,2.8333333333333335,0,1.8333333333333333,0,1.4285714285714286,0,1.3333333333333333,0,2.3513513513513513,0,0,0,0,0.1547830695235775,-0.5804383618435307,-0.2128276461599766,4,1,3,1,1,1,1,1,1,1.2535663410560174,1.4285714285714286,0,1,-0.6467170085812028,4,4,4,4,2,2,3,7,6,2,3,0.9511897312113419,3.2857142857142856,0,2.7142857142857144,2.5,3.8333333333333335,3.2559414990859232,-1.0219528370065065,0,-0.3673889871358558,2,2,3,3,3,3,3,3,2,2,1,4,3,3,4,3,3,2,4,4,0.8837151016885368,2.6,0,3.8,0,3,0,3.2,0,3.3333333333333335,0,2,3,1,3,1,1,2,3,1,2,2,4,2,2,1,4,1,1,1,2,0.998683343734455,1.55,0,"White, Caucasian, Anglo, European American",0,21,1,2,NA,1,3,4,Fine Arts Center staff,2,0,160,69,3,5,2,0,1,1,0,1,TRUE,TRUE,TRUE,TRUE,TRUE,3,0.9257973684072495,0.76,0.12057794890823108,3,0.4225437499880791,0.5058406250178814,1,1,0.003116290925606605,0.002508605069581655,3,0.6113812500089407,0.6897124999985099,1,1,0.0077185377040995705,0.008285146286663584,1.7241,0.7397,0.3581,0,43.2506,0.003,ML,change,50,-74.76513098371557,0.8304455947244201,1.3880253170840136,0.4912275606625263,1.7482,6.7118,0.3756,6.8516,0.295,0,-104.7027,0.012,ML,cueing,64,221.882049250079,5.133982931357122,0.8070020453488989,0.42970254256957374,4.862985734804791,0.8519734484801743,0.3376834066492044,0.151,0.343,0.558,0.019,1.441,55.04070005500825,1854.4417467136022,0.151,0.346,0.56,0.017,1.555,84.75560891065156,1874.3951944541934,434,1.285925925925926,1,0,0,1,FALSE,FALSE,FALSE
239,2021-11-13T02:18:44Z,2021-11-13T02:44:02Z,1517,1,2021-11-13T02:44:02Z,1,Chrome,95.0.4638.69,Macintosh,1280,800,I do not have any feedback.,1.6,738,68,373,94,70,109,-0.13154971242019967,-0.1980871551395335,-0.2623980357390215,-0.12894866731086665,-0.026866602291778594,0.06120418449727754,4,4,1,2,4,1,3,4,1,2,4,1,1,1,4,4,1,1,4,4,1.4317821063276353,0,0,1,3,2,1.25,0,4,4,2,4,3,2,1,3,1,1,4,4,3,3,3,1,4,1,1,1,2,4,1,0,2,1,1,4,2,4,4,3,5,3,3,3,1,4,1,1,5,3,5,4,3,2,5,5,1,5,1,1,2,1,1,1,2,1,4,2,3,1,2,1,1,1,1,1,1.4917188827742394,1.1464230084422218,1.875,0,1,0,2.533333333333333,0,2.5555555555555554,0,2.4166666666666665,0,2.3333333333333335,0,1.5714285714285714,0,1.3333333333333333,0,2.2432432432432434,0,0,1,1,8.866159630821409e-4,-0.35415791278580844,-0.17663564841136314,4,2,2,1,1,2,1,1,1,1.0690449676496976,1.8571428571428572,0,1,-0.39031545311577004,4,4,4,4,3,3,3,7,7,NA,3,0.5345224838248488,3.5714285714285716,0,2.4285714285714284,2,3.8333333333333335,3.2559414990859232,-1.3043345419688306,0,-0.6679218344598915,2,3,3,3,2,2,5,1,3,3,1,5,1,4,3,1,4,1,5,3,1.5675276256394517,2.6,0,4.6,0,4.6,0,3.6,0,4.266666666666667,0,2,1,1,4,3,1,2,3,1,3,3,4,1,2,1,4,1,2,3,2,1.105012502906165,1.7,0,"Black or African American & White, Caucasian, Anglo, European American",1,28,1,2,NA,1,4,6,recruiter,5,0,133,63,3,5,2,0,0,1,0,0,TRUE,TRUE,TRUE,TRUE,TRUE,3,1.0176128205141195,0.78,0.0657823271676161,3,0.4940656249993481,0.5690967741930677,1,1,0.0018558849093099673,0.004032065656008508,3,0.7163656250028871,0.7935838709694724,1,0.96875,0.014094322973514577,0.012728039022174661,1.4418,0.9315,0.6469,0,26.1519,0.004,ML,change,50,-40.56773098371556,1.0484858003602024,1.2071373526436526,0.6952446409697661,10,10.7711,0.1049,13.9973,0.1369,0,-97.9907,0.021,ML,cueing,63,208.4108041791746,4.559640426568669,0.9086538276680349,0.47256960174058527,5.5357278916855,0.7484354013524398,0.4285776883407223,0.1,0.444,0.408,0.011,1.482,41.39694117022522,1866.9492682599473,0.099,0.442,0.389,0.011,1.598,51.31669930520258,1874.9698323982286,370,1.0962962962962963,1,0,0,1,FALSE,FALSE,FALSE
240,2021-11-13T02:23:21Z,2021-11-13T02:44:02Z,1240,1,2021-11-13T02:44:03Z,1,Edge,95.0.1020.44,Windows NT 10.0,1920,1080,NA,1.7777777777777777,641,68,282,58,54,94,-0.380778313123741,-0.1980871551395335,-0.7004937969579544,-0.5676593025364346,-0.24785955648129604,-0.19216631691551858,3,2,3,3,2,2,4,2,2,2,2,3,3,2,2,1,2,1,1,2,0.7677718959499145,0,0,2,2,1,2.8,0,1,2,5,2,5,5,1,5,4,5,5,2,1,1,1,5,5,4,3,5,5,5,5,3,2,0,0,1,1,3,2,2,2,3,4,3,4,3,4,2,3,4,1,5,5,5,5,5,1,1,1,1,3,1,4,2,3,3,2,5,4,2,2,4,4,5,2,2,1.3976599920772768,1.8516401995451028,4.625,0,3.25,0,4.466666666666667,0,3.6666666666666665,0,4.166666666666667,0,1.8333333333333333,0,3.4285714285714284,0,2.6666666666666665,0,3.4594594594594597,0,2,0,0,2.5362097005942914,0.3745550047701899,1.4553823526822407,3,3,1,2,2,4,4,3,2,1.1126972805283737,3.2857142857142856,0,2.5,1.017837910597246,4,4,3,1,3,1,3,4,4,2,2,1.2535663410560174,2.7142857142857144,0,3.2857142857142856,5,3.8333333333333335,3.2559414990859232,0.38995568780511447,0,0.6572492649557016,5,5,5,5,5,5,4,3,4,2,1,3,4,3,5,1,5,1,3,2,1.4375905768565218,5,0,3.8,0,3.2,0,3.4,0,3.466666666666667,0,2,4,2,3,4,3,2,3,2,3,3,2,1,2,1,3,1,3,4,2,0.9459053029269173,2.4,0,"White, Caucasian, Anglo, European American",0,21,1,1,NA,1,3,4,Agricultural Worker,3,0,134,62,3,5,2,0,0,1,0,0,TRUE,TRUE,TRUE,TRUE,TRUE,2,0.8516031249989755,0.64,0.019855455203991745,2,0.5312645161300897,0.6135806451612903,0.96875,0.96875,0.005594821925409284,0.011031281129233402,2,0.6608806451602328,0.740516129030816,1,0.96875,0.015291983612698519,0.012652952903174218,1.0765,0.6551,0.6107,0,2.7428,0.008,ML,change,50,6.250469016284438,0.6813214417301164,0.8444826621667866,0.6780762616683156,1.1158,2.7518,0.4199,4.1225,0.4057,0,-61.8772,0.007,ML,cueing,64,136.23104925007902,3.2644072122127077,1.0519481735115677,0.46252697009012483,3.86824746682079,0.887737207595834,0.4236894916183951,0.084,0.437,0.381,0.015,1.579,126.0494837423719,1988.6501049823964,0.084,0.435,0.406,0.013,1.689,125.83840766773727,1953.2364249304537,342,1.0133333333333332,1,0,0,1,FALSE,FALSE,FALSE
241,2021-11-13T02:22:28Z,2021-11-13T02:45:40Z,1392,1,2021-11-13T02:45:42Z,0.8999999761581421,Chrome,95.0.4638.69,Windows NT 10.0,1366,768,I think it was a fun and unique experience. For some reason those mini games stressed me out.,1.7786458333333333,703,68,325,65,59,90,-0.22147755803487953,-0.1980871551395335,-0.4934815141841729,-0.4823544567981297,-0.17879925829707183,-0.2597317839589309,2,2,4,3,1,2,1,1,2,1,2,3,3,4,2,1,3,2,3,1,0.9880869341680844,0,1,1,3,4,3.05,0,4,4,2,4,4,3,2,2,3,2,1,3,2,4,3,3,1,1,1,2,3,3,1,0,2,0,0,4,2,2,4,4,4,5,5,5,3,5,4,1,3,1,5,2,3,3,4,3,5,1,1,1,1,1,1,1,1,1,4,2,1,1,2,1,2,2,2,2,1.551904767828364,0.990430401872025,1.875,0,2,0,2.466666666666667,0,2.111111111111111,0,2.4166666666666665,0,0.8333333333333334,0,1.1428571428571428,0,1.3333333333333333,0,1.8108108108108107,0,0,0,0,-0.21360051679796055,-0.4236359564090485,-0.3186182366035045,5,1,3,1,1,1,1,1,1,1.5735915849388864,1.2857142857142858,0,1,-0.7321841937363471,3,3,3,3,1,1,3,3,3,1,1,0.9759000729485332,2.4285714285714284,0,3.5714285714285716,6,3.8333333333333335,3.2559414990859232,0.9547190977297628,0,1.0989729647608995,2,3,3,2,3,3,4,3,4,3,1,4,2,3,4,4,4,3,4,4,0.8997354108424374,2.6,0,3.8,0,3.4,0,2.8,0,3.3333333333333335,0,1,1,1,3,2,1,3,4,1,1,2,4,2,1,1,4,1,1,2,1,1.1367080817685316,1.35,0,"Hispanic of Latino (e.g., Mexican American, Central American, and others)",0,21,0,1,NA,1,2,5,hotel clerk,1,0,150,72,2,5,2,0,0,3,0,0,TRUE,TRUE,TRUE,TRUE,TRUE,2,0.9006148936170887,0.94,0.08731398942447088,2,0.5354906249999185,0.6131533333333209,1,0.9375,0.002633995715728666,0.004644123538317816,2,0.6784031249999826,0.7739093749999884,1,1,0.020390248699619265,0.006621515070567468,1.7971,1.7144,0.4363,0,10.8427,0.003,ML,change,50,-9.949330983715564,1.7308639096448406,1.5896889973322865,0.4965027303623067,1.0989,3.4302,0.4687,4.5851,0.4157,0,-77.5887,0.012,ML,cueing,64,167.65404925007903,3.5708469470233037,0.7583775617601504,0.5202369501355897,5.071760398564555,0.8169026927147724,0.45747289334687985,0.183,0.343,0.558,0.009,1.401,132.55269830317135,1937.5619679306783,0.18,0.341,0.564,0.009,1.495,143.7998288421654,1930.1931236749142,104,0.3081481481481481,1,1,1,2,FALSE,FALSE,FALSE
242,2021-11-13T02:06:03Z,2021-11-13T02:45:57Z,2393,1,2021-11-13T02:45:57Z,1,Chrome,95.0.4638.69,Windows NT 10.0,1536,864,"No comments, thank you.",1.7777777777777777,1227,81,668,157,104,94,1.1248707591677563,-0.07998555706816408,1.1578025088718051,0.6387949443338773,0.44274342536094596,-0.19216631691551858,3,4,1,1,3,1,1,4,1,4,3,1,1,1,3,4,1,2,4,3,1.3018205875255096,0,0,4,5,5,1.3,0,3,5,2,4,2,2,1,3,2,1,2,4,5,3,4,2,4,1,1,2,3,3,2,0,3,2,0,5,2,1,5,5,4,1,1,3,2,5,5,1,2,3,4,5,2,2,2,1,3,5,1,1,2,1,1,1,5,5,5,1,1,1,1,2,1,2,3,2,1.6725122711948326,1.3020130933435712,2.25,0,2,0,2.466666666666667,0,3,0,2.5,0,2,0,2,0,1.3333333333333333,0,2.4054054054054053,0,0,2,0,0.20308139048375845,-0.010369541223001058,0.0963559246303787,3,3,2,3,1,4,5,5,3,1.2909944487358056,3.2857142857142856,0,4,1.5713194227588192,5,5,5,5,3,3,1,3,2,3,3,1.5735915849388864,4.428571428571429,0,1.5714285714285714,6.5,3.8333333333333335,3.2559414990859232,1.237100802692087,0,0.12476985334194696,2,2,2,1,2,2,4,3,2,5,4,2,1,3,3,2,3,1,2,3,1.1126972805283737,1.8,0,3.2,0,4,0,3.2,0,3.466666666666667,0,2,4,1,3,1,1,2,1,1,1,1,3,2,1,1,3,1,1,1,2,0.9333020044867296,1.65,0,"Hispanic of Latino (e.g., Mexican American, Central American, and others)",0,19,0,1,NA,1,3,4,Full time student,3,0,145,69,3,5,2,0,0,1,0,0,TRUE,TRUE,TRUE,TRUE,TRUE,4,0.9238948717965529,0.7959183673469388,0.03817075514506781,4,0.40530645161290324,0.49132187500130386,1,1,0.0011468132904558566,0.0019122546674802778,4,0.5605906249992549,0.6586593749979511,1,1,0.009375988619329338,0.0121988779738501,1.4049,1.0646,0.5479,0,18.6468,0.004,ML,change,49,-25.61813910566812,1.2781461563665346,1.064805105704447,0.6773695531909831,2.5843,8.749,0.3436,10.8809,0.2866,0,-121.2752,0.015,ML,cueing,63,254.9798041791746,5.4944732323432595,0.7540549477978958,0.42484682818706404,6.243661000601106,0.6635745800408853,0.35382720935802114,0.146,0.28,0.554,0.015,1.69,61.654888979600244,1869.481024813392,0.151,0.274,0.546,0.017,1.81,76.92614125658991,1861.2027661855384,350,1.0370370370370372,1,0,0,1,FALSE,FALSE,FALSE
243,2021-11-13T02:27:37Z,2021-11-13T02:46:57Z,1159,1,2021-11-13T02:46:58Z,1,Chrome,95.0.4638.69,Windows NT 10.0,1536,1024,NA,1.5,756,38,221,24,15,61,-0.0853011061040786,-0.4706293045350014,-0.9941623841486678,-0.9819971246939154,-0.7865298823182448,-0.74958142002367,2,1,3,3,2,2,1,2,3,3,1,3,2,1,2,3,2,2,3,3,0.7677718959499145,0,1,2,4,2,2.5,0,4,4,3,3,4,2,2,3,3,4,2,2,3,4,4,2,3,1,1,1,2,3,1,3,2,0,0,4,3,3,3,3,4,3,4,4,3,4,2,1,4,3,4,4,4,2,4,4,3,1,1,1,3,1,1,3,4,4,4,3,2,1,2,1,3,1,3,2,1.166988372633533,0.8338093878327919,1.75,0,2.25,0,2.8666666666666667,0,2.5555555555555554,0,2.75,0,1.5,0,2.5714285714285716,0,1.3333333333333333,0,2.4054054054054053,0,2,0,0,0.16010653175365794,0.06095019390122543,0.11052836282744169,4,2,4,1,1,1,3,1,1,1.3801311186847085,1.7142857142857142,0,1,-0.4757826382709144,4,3,4,4,2,2,1,6,6,3,3,1.2149857925879117,3.4285714285714284,0,2.5714285714285716,3,3.8333333333333335,3.2559414990859232,-0.7395711320441822,0,-0.3058691320761303,3,4,3,2,2,3,3,2,2,3,4,3,3,3,5,4,4,3,3,4,0.7988086367179802,2.8,0,3,0,2.8,0,3.6,0,3.1333333333333333,0,2,3,2,2,3,3,3,3,2,2,3,4,2,3,3,2,3,2,3,4,0.6569466853317864,2.6,0,"White, Caucasian, Anglo, European American",0,19,1,2,NA,1,3,4,Student,3,0,120,65,2,5,2,0,0,1,0,0,TRUE,TRUE,TRUE,TRUE,TRUE,2,0.6879358974297841,0.78,0.03181262677965995,NA,NA,NA,NA,NA,NA,NA,2,0.46676451613826136,0.5624047619161152,0.96875,0.65625,0.0029551118941138817,0.012494103702223524,1.4463,0.9557,0.2873,0,24.5699,0.004,ML,change,50,-37.40373098371556,1.2573030785060935,1.006651773123088,0.46375566492023756,NA,NA,NA,NA,NA,NA,NA,NA,NA,NA,NA,NA,NA,NA,NA,NA,NA,NA,0.05,0.351,0.401,0.013,1.962,70.6691091349384,2126.6768457810576,0.05,0.351,0.391,0.015,2.084,93.93873998228021,2131.3016462284504,474,1.4044444444444446,1,0,0,1,FALSE,FALSE,FALSE
244,2021-11-13T02:22:29Z,2021-11-13T02:47:07Z,1478,1,2021-11-13T02:47:08Z,1,Chrome,95.0.4638.54,Macintosh,1440,900,"No, but this was an enjoyable study to participate in",1.6,758,66,357,62,48,97,-0.08016237206895403,-0.21625663176589804,-0.3394258618874053,-0.5189136764002604,-0.3307319143023651,-0.14149221663295936,3,3,1,2,3,1,2,2,1,3,3,1,1,1,3,3,1,1,3,3,0.9445132413883326,0,1,2,4,4,1.65,0,5,5,1,4,1,1,5,1,1,1,1,4,1,3,4,1,1,1,1,1,2,1,1,6,2,0,0,5,5,5,5,4,5,5,5,5,1,1,1,1,3,3,4,1,1,3,5,5,5,1,1,1,5,1,1,5,5,5,5,1,1,1,1,1,2,1,4,4,1.8995020684663937,1.7674302033770737,1.125,0,2.75,0,1.3333333333333333,0,1.1111111111111112,0,2.5833333333333335,0,1.5,0,2.5714285714285716,0,1,0,1.972972972972973,0,3,0,0,-0.953271396111991,0.420845073132224,-0.2662131614898835,5,1,5,1,1,1,1,1,1,1.9518001458970664,1,0,1,-0.9031185640466358,5,5,5,5,3,3,3,3,6,4,4,1.0690449676496976,4.142857142857143,0,1.8571428571428572,4.5,3.8333333333333335,3.2559414990859232,0.10757398284279028,0,-0.28065156173982786,1,1,1,1,1,1,5,1,1,4,1,5,1,4,5,1,5,2,5,2,1.8464895909600492,1,0,4.8,0,4.8,0,4.6,0,4.733333333333333,0,1,1,1,3,1,1,1,3,3,2,2,4,1,1,1,3,1,1,1,1,0.9880869341680844,1.35,0,"White, Caucasian, Anglo, European American",0,25,1,2,NA,1,4,5,nurse,4,0,114,65,1,5,2,0,0,1,0,0,TRUE,TRUE,TRUE,TRUE,TRUE,2,1.4943781249970198,0.6666666666666666,0.37423102934302727,2,0.6279999999841054,0.7487903225691088,0.967741935483871,1,0.20988146274622557,0.36874230690591764,2,0.891551612896304,1.053565517232336,0.96875,0.90625,0.15346636544431413,0.22681640112450918,1.8627,0.3652,0.6199,0,65.1784,0.003,ML,change,48,-118.74319696727632,0.3911166370288984,1.77222627455945,0.7391787348517107,1.5646,2.0229,0.362,2.105,0.2795,0,-5.4322,0.007,ML,cueing,62,23.245803155135274,1.4744557799825606,2.8099416629778724,-0.17430653220466075,1.5558261609577422,2.186103735116803,-0.029227920391393547,0.092,0.384,0.141,0.186,1.615,62.72810341965193,2030.5506150023134,0.098,0.371,0.148,0.018,1.65,82.20764893933566,2031.9338506421045,498,1.4755555555555555,1,0,0,1,FALSE,FALSE,FALSE
245,2021-11-13T02:26:40Z,2021-11-13T02:47:24Z,1243,1,2021-11-13T02:47:25Z,1,Firefox,94.0,Windows NT 10.0,1920,1080,none,1.7777777777777777,659,52,288,81,42,64,-0.33452970680761995,-0.3434429681504497,-0.6716083621523106,-0.28737195225343287,-0.4136042721234341,-0.6989073197411108,3,3,1,2,3,1,1,3,1,2,2,1,1,2,3,3,1,1,2,2,0.8522416262267903,0,1,2,2,2,1.8,0,2,3,5,3,5,3,2,4,4,5,4,3,2,3,2,5,2,2,2,5,3,4,5,4,2,0,5,3,3,3,2,1,2,1,2,2,5,5,4,5,3,1,2,5,5,5,4,4,2,4,5,3,5,4,4,5,5,4,2,4,5,3,2,2,3,3,2,2,1.3633997428703215,1.1126972805283737,3.5,0,2.5,0,3.7333333333333334,0,3.888888888888889,0,3.8333333333333335,0,4,0,4.285714285714286,0,2.3333333333333335,0,3.891891891891892,0,2,0,5,1.9234308028008964,1.0215996311143702,1.4725152169576332,2,4,2,3,3,3,4,3,1,0.816496580927726,3.5714285714285716,0,2,1.0042784435203436,2,2,3,1,2,2,3,1,1,1,1,0.6900655593423543,2.142857142857143,0,3.857142857142857,8,3.8333333333333335,3.2559414990859232,2.0842459175790595,0,1.8230783695284214,1,1,2,2,2,2,4,2,1,4,1,5,2,5,5,3,5,3,2,3,1.4573295865416045,1.6,0,4.4,0,3.4,0,4.4,0,4.066666666666666,0,1,1,1,2,2,1,1,3,2,2,2,2,1,1,4,3,1,3,3,1,0.9333020044867296,1.85,0,"Hispanic of Latino (e.g., Mexican American, Central American, and others)",0,29,0,1,NA,1,2,4,unemployed,1,0,220,66,2,5,2,0,0,4,0,0,TRUE,TRUE,TRUE,TRUE,TRUE,3,0.9084318181818182,0.88,0.09294160040816325,3,0.41303225806451616,0.4891935483870968,0.96875,0.96875,0.002770958669354838,0.005258813508064516,3,0.6035,0.62609375,1,1,0.012131032258064518,0.011575055443548386,1.6443,1.2699,0.4373,0,23.7706,0.003,ML,change,50,-35.805130983715564,1.3808588955467542,1.4428919356755123,0.5113608811549075,1.005,3.7986,0.3623,4.4938,0.3096,0,-84.4755,0.009,ML,cueing,64,181.427649250079,3.928609607530542,0.8740973391458188,0.3848988567131756,4.61108687742576,0.7447240305310068,0.337325727567243,0.287,0.092,0.555,0.085,1.663,72.80695603275456,1870.273795866543,0.287,0.092,0.555,0.109,1.669,86.12243877123673,1867.9716989441251,442,1.3096296296296297,1,0,2,3,FALSE,FALSE,FALSE
246,2021-11-13T02:12:08Z,2021-11-13T02:47:27Z,2119,1,2021-11-13T02:47:28Z,1,Chrome,95.0.4638.69,Windows NT 10.0,1536,864,N/A,1.7777777777777777,987,77,602,138,69,134,0.5082226749528086,-0.11632451032089314,0.840062726009722,0.40725322018704974,-0.04067866192862343,0.4834883535186044,4,2,2,2,2,3,3,1,1,2,1,2,1,1,2,2,1,4,2,1,0.9445132413883326,0,1,1,3,2,2.55,0,1,2,2,2,4,4,2,4,4,2,5,1,4,1,1,1,5,5,5,5,5,5,5,4,4,4,1,1,1,1,1,1,1,1,1,1,5,2,5,5,4,5,4,5,5,5,5,5,1,5,5,5,5,5,5,5,5,5,3,2,2,5,5,5,5,5,5,5,1.8034001919297482,1.4040757000349275,4.5,0,5,0,4.066666666666666,0,5,0,4.416666666666667,0,4.833333333333333,0,3.7142857142857144,0,5,0,4.594594594594595,0,2,4,1,2.7984144129813244,1.926345901062153,2.3623801570217386,4,2,3,4,1,1,1,5,3,1.3801311186847085,2,0,4,0.8021147563625206,2,2,2,2,1,1,5,2,4,2,2,1.3451854182690985,1.5714285714285714,0,4.428571428571429,6,3.8333333333333335,3.2559414990859232,0.9547190977297628,0,1.57699894928952,4,4,5,5,5,2,5,2,4,2,3,5,1,3,4,1,4,2,4,1,1.4074631010979937,4.6,0,4,0,4.2,0,3.6,0,3.933333333333333,0,2,1,4,1,4,4,4,1,4,2,3,2,3,4,3,1,4,4,4,4,1.234376040972246,3.45,0,"White, Caucasian, Anglo, European American",0,29,1,3,NA,1,2,5,Self-employed Author and Artist,1,0,320,61,1,5,2,0,1,0,0,1,TRUE,TRUE,TRUE,TRUE,TRUE,2,1.0056000000000807,0.7872340425531915,0.0922100787981069,2,0.6007866666674614,0.6324103448288194,0.967741935483871,0.9354838709677419,0.01754437514005336,0.010124178903333954,2,0.7362516129036103,0.8537172413817767,1,0.90625,0.05222818324723023,0.07129712451569752,1.5988,0.8946,0.5178,0,31.4558,0.003,ML,change,47,-51.361157194869826,0.9914256688032661,1.3196479179618643,0.6232740040627037,1.3017,2.8512,0.4272,2.6426,0.3639,0,-37.7801,0.007,ML,cueing,62,87.94160315513527,2.9169519352891515,0.9167613004091015,0.4955432422119911,2.893477530229857,1.1754704662911157,0.41076727814175973,0.085,0.508,0.469,0.016,1.929,94.45363700182664,2025.9917806657725,0.074,0.5,0.379,0.018,2.333,41.98637549179037,1929.0851446083188,380,1.125925925925926,1,0,0,1,FALSE,FALSE,FALSE
247,2021-11-13T02:20:02Z,2021-11-13T02:47:44Z,1661,1,2021-11-13T02:47:45Z,1,Chrome,95.0.4638.69,Macintosh,1440,900,NA,1.6,958,53,333,80,58,79,0.43371103144350237,-0.33435822983726743,-0.454967601109981,-0.29955835878747644,-0.19261131793391667,-0.4455368183283147,2,4,2,1,2,1,1,4,1,3,3,1,1,2,2,3,1,1,2,3,1.025978352085154,1,1,1,1,1,1.7,0,4,5,3,4,5,2,3,3,1,1,4,3,2,4,4,1,2,1,1,2,2,1,3,0,2,0,0,5,5,5,5,5,5,3,4,2,1,5,3,1,5,1,5,1,3,4,5,3,4,1,1,1,1,1,1,1,1,1,4,3,2,1,1,1,1,1,1,2,1.7264068119885534,1.2649110640673518,1.625,0,1.25,0,2.4,0,1.6666666666666667,0,2.0833333333333335,0,1,0,1.4285714285714286,0,1,0,1.6486486486486487,0,0,0,0,-0.4193765295461455,-0.6588395645607719,-0.5391080470534587,4,2,5,1,1,1,1,1,1,1.6761634196950514,1.2857142857142858,0,1,-0.7321841937363471,5,5,5,5,5,3,1,6,4,5,4,1.5735915849388864,4.714285714285714,0,1.2857142857142858,4,3.8333333333333335,3.2559414990859232,-0.1748077221195339,0,-0.740526403906737,1,2,3,2,2,2,5,3,1,3,5,4,2,5,5,1,4,5,5,3,1.505545305418162,2,0,2.8,0,4.4,0,4.2,0,3.8,0,2,4,4,2,4,4,4,2,3,2,2,2,3,4,1,2,4,4,3,4,1.025978352085154,3.2,0,"White, Caucasian, Anglo, European American",0,18,1,2,NA,1,4,4,Student,7,0,84,60,1,5,2,0,1,0,0,1,TRUE,TRUE,TRUE,TRUE,TRUE,NA,NA,NA,NA,3,0.6228466666678587,0.624700000005109,0.9375,0.9032258064516129,0.14848469383133264,0.040043406624840454,3,0.6208937499970197,0.7877433333257834,1,0.967741935483871,0.008932775443329311,0.02872999051670524,NA,NA,NA,NA,NA,NA,NA,NA,NA,NA,1.1756232100743804,1.5441086489976643,0.665127298108358,1.2394,2.0503,0.4352,1.8665,0.3805,0,-13.8237,0.007,ML,cueing,63,40.0768041791746,1.8455625007346113,1.2102501110734698,0.36027976126948885,1.5016777810679691,1.8033497167257069,0.09745732481690772,0.093,0.412,0.407,0.01,1.599,58.20213649136074,1894.8010926389563,0.094,0.408,0.438,0.009,1.678,63.416598877674126,1890.380822924437,424,1.2562962962962962,1,1,5,6,FALSE,TRUE,FALSE
248,2021-11-13T02:21:00Z,2021-11-13T02:48:29Z,1648,1,2021-11-13T02:48:30Z,1,Edge,95.0.1020.44,Windows NT 10.0,1536,864,Good Survey,1.7777777777777777,772,71,467,111,63,96,-0.044191233823082085,-0.1708329401999867,0.19014044288273346,0.07822024376787376,-0.12355101974969247,-0.15838358339381242,2,1,2,3,2,2,4,2,2,3,3,4,3,4,2,2,3,4,3,4,0.910465468000326,1,1,4,3,1,2.85,0,3,4,4,4,3,3,2,3,3,3,1,3,3,2,3,3,5,4,2,3,3,3,4,2,3,1,3,3,2,2,2,3,3,1,2,1,1,1,2,2,2,2,1,2,2,2,4,3,2,2,1,1,3,2,2,3,3,1,3,2,4,2,3,4,2,3,4,3,0.8767945989619056,0.7988086367179802,3.375,0,3,0,2.933333333333333,0,3.888888888888889,0,2.8333333333333335,0,2,0,2.4285714285714284,0,3,0,2.945945945945946,0,1,1,3,1.1193944256140804,0.8290434765469984,0.9742189510805395,3,2,2,4,2,3,2,5,1,0.7867957924694432,2.857142857142857,0,3,0.9459301925190042,3,3,4,4,1,1,4,3,5,2,1,1.3451854182690985,2.5714285714285716,0,3.4285714285714284,5,3.8333333333333335,3.2559414990859232,0.38995568780511447,0,0.7369202623771383,2,3,3,5,4,2,4,3,2,4,4,4,4,4,4,1,3,3,3,4,0.9611501047232549,3.4,0,3.2,0,3.6,0,3.4,0,3.4,0,3,2,2,2,2,1,2,2,2,3,3,2,3,3,3,1,2,2,2,2,0.6155870112510925,2.5,0,"White, Caucasian, Anglo, European American",0,21,1,2,NA,1,1,4,college student,1,0,135,67,5,5,2,1,0,1,0,1,TRUE,TRUE,TRUE,TRUE,TRUE,NA,NA,NA,NA,2,0.789875862022926,0.9207166666587194,0.90625,0.9375,0.23040506032202843,0.14361116258679504,2,0.9152718750238419,1.0499093750044703,1,1,0.050987878215313115,0.09416135379064212,NA,NA,NA,NA,NA,NA,NA,NA,NA,NA,NA,NA,NA,1.8629,1.754,0.4967,1.2053,0.2039,0,28.2864,0.008,ML,cueing,64,-44.09615074992099,1.514258873930487,1.7883667368400873,0.40402136386899634,1.2041212223608453,1.8840989587994288,0.1542129505167521,0.203,0.378,0.369,0.015,1.345,12.310018112144041,1800.4559875202176,0.199,0.381,0.371,0.013,1.437,17.893750573710975,1797.8787327931118,104,0.3081481481481481,1,1,0,1,FALSE,FALSE,FALSE
249,2021-11-13T02:25:45Z,2021-11-13T02:48:54Z,1388,1,2021-11-13T02:48:55Z,1,Chrome,95.0.4638.69,Macintosh,1440,900,"Interesting survey, thank you! Keep up the good work guys!",1.6,647,58,328,85,51,116,-0.36536211101836735,-0.2889345382713561,-0.479038796781351,-0.23862632611725865,-0.28929573539183057,0.17944375182324906,4,3,1,1,2,1,2,3,1,4,3,2,2,2,4,4,2,1,3,4,1.145931016569864,0,1,4,5,4,1.55,0,2,4,5,4,4,1,4,3,2,2,2,4,2,3,4,1,3,1,1,2,2,1,1,1,2,0,0,5,4,5,4,5,4,4,5,5,2,4,3,1,4,3,5,2,2,3,4,4,3,1,1,1,1,1,1,2,1,1,5,2,2,1,1,1,1,2,1,1,1.5658709882847794,1.162919151265879,1.5,0,1.25,0,2.533333333333333,0,1.4444444444444444,0,2.4166666666666665,0,1.1666666666666667,0,1.2857142857142858,0,1,0,1.7027027027027026,0,1,0,0,-0.3925656379510154,-0.4557470907642554,-0.4241563643576354,4,2,3,1,1,2,1,4,5,1.1547005383792515,1.7142857142857142,0,4.5,0.8156742234394231,5,5,5,5,4,5,2,8,8,6,4,1.1338934190276817,4.714285714285714,0,1.2857142857142858,1,3.8333333333333335,3.2559414990859232,-1.869097951893479,0,-1.5876715187937096,4,3,3,4,3,3,4,4,3,3,4,3,4,4,4,5,2,3,4,5,0.816496580927726,3.4,0,2.6,0,2.8,0,2.8,0,2.7333333333333334,0,1,1,1,4,2,2,1,3,1,1,1,3,2,2,2,3,1,2,1,2,0.8944271909999159,1.5,0,"White, Caucasian, Anglo, European American",0,25,0,1,NA,0,4,7,Lawyer,5,0,240,69,3,5,2,0,0,1,0,0,TRUE,TRUE,TRUE,TRUE,TRUE,2,1.1569317073269587,0.82,0.10081585941036716,2,0.49994062500447034,0.57203125,1,1,0.0073135482954956735,0.007437897701499999,2,0.6620812499970198,0.768484375,1,1,0.005110199637265707,0.0070479510384331995,1.5701,1.0167,0.6765,0,29.9352,0.004,ML,change,50,-48.13433098371556,1.0967223390984053,1.3826174915107945,0.7535136483429741,2.2861,5.117,0.3486,6.0573,0.3112,0,-76.8218,0.009,ML,cueing,64,166.120249250079,3.9124603033591585,1.0589589171893505,0.44092877591912616,3.9289858158534434,1.054504882576567,0.3699386788439507,0.094,0.496,0.554,0.007,1.152,74.41223243213327,1888.023537175079,0.095,0.496,0.582,0.007,1.199,104.62177044351151,1889.9271543734985,104,0.3081481481481481,1,1,0,1,FALSE,FALSE,FALSE
251,2021-11-13T02:25:53Z,2021-11-13T02:51:26Z,1533,1,2021-11-13T02:51:27Z,1,Chrome,95.0.4638.69,Macintosh,1680,1050,NA,1.6,804,57,393,78,64,99,0.03802851073891094,-0.2980192765845384,-0.1661132530535417,-0.3239311718555635,-0.10973896011284763,-0.10770948311125321,3,3,2,2,3,2,2,3,2,3,3,2,2,2,3,3,2,1,2,3,0.5982430416161189,0,1,1,3,3,2,0,4,5,3,4,2,2,1,1,3,2,3,4,3,3,2,2,3,1,2,1,3,1,2,0,2,0,0,4,4,4,4,4,5,5,5,5,3,2,3,1,2,2,5,4,4,3,3,3,3,1,2,1,2,1,1,1,1,1,3,5,3,1,1,2,2,1,1,1,1.4498627873361334,1.1464230084422218,1.875,0,1.25,0,2.533333333333333,0,1.5555555555555556,0,2.9166666666666665,0,1.5,0,2,0,1.3333333333333333,0,2.108108108108108,0,0,0,0,-0.057187517455972794,-0.6588395645607719,-0.35801354100837235,5,1,5,1,3,2,1,1,1,1.8126539343499315,1.4285714285714286,0,1,-0.6467170085812028,5,5,5,5,2,2,1,6,6,4,3,1.8126539343499315,4.142857142857143,0,1.8571428571428572,3,3.8333333333333335,3.2559414990859232,-0.7395711320441822,0,-0.7042241191833141,2,2,2,2,2,2,4,3,1,3,2,4,2,5,5,3,4,2,4,3,1.1872336794093274,2,0,4,0,3.6,0,4.2,0,3.933333333333333,0,2,3,1,4,2,1,2,3,1,2,2,3,1,2,3,3,2,2,2,2,0.812727700887249,1.85,0,"White, Caucasian, Anglo, European American",0,29,0,1,NA,1,3,5,retired military,4,0,176,74,4,5,2,0,0,1,0,0,TRUE,TRUE,TRUE,TRUE,TRUE,1,0.7664743589728307,0.8125,0.04074745339972362,1,0.4968034482773008,0.5770310344850195,0.9354838709677419,0.90625,0.008263177848882433,0.010771116088631788,1,0.7142968750009313,0.7881133333305518,1,0.9375,0.02381711192622023,0.02143123983987785,1.3746,1.137,0.3943,0,16.1211,0.003,ML,change,48,-20.628596967276323,1.3381914504909804,1.0957603026498415,0.5105878828991417,1.1312,2.3205,0.3715,2.782,0.3136,0,-40.1479,0.011,ML,cueing,63,92.7252041791746,2.589572279409524,0.8760842705018725,0.4395916443118514,3.0688979753910854,0.8713709842653689,0.3731538475672946,0.083,0.431,0.31,0.009,1.3,82.02975145451369,1944.4855237906688,0.083,0.431,0.313,0.008,1.397,101.23316822191977,1946.7351927087136,500,1.4814814814814816,1,0,0,1,FALSE,FALSE,FALSE
252,2021-11-13T02:31:30Z,2021-11-13T02:51:27Z,1197,1,2021-11-13T02:51:28Z,0.8999999761581421,Chrome,95.0.4638.69,Windows NT 10.0,2048,1152,N/a,1.7777777777777777,665,48,278,52,40,73,-0.31911350470224625,-0.3797819214031788,-0.7197507534950504,-0.6407777417406959,-0.4412283913971238,-0.5468850188934331,3,3,2,3,3,2,2,3,2,3,3,3,3,2,3,3,3,3,3,3,0.4442616583193193,0,1,1,2,3,2.25,0,5,5,2,5,2,1,5,1,2,1,1,5,5,5,5,2,2,1,2,2,2,2,2,1,2,0,0,5,5,5,5,5,5,5,5,5,5,5,1,1,5,4,5,1,1,4,1,1,5,1,1,1,2,1,4,2,1,1,5,1,1,1,1,1,2,1,1,1,1.92033530605665,1.8771812708978117,1.875,0,1.25,0,1.4666666666666666,0,1,0,1.8333333333333333,0,1,0,1.4285714285714286,0,1,0,1.4054054054054055,0,1,0,0,-0.8175715043561326,-0.4557470907642554,-0.636659297560194,5,2,3,1,1,1,1,1,1,1.5275252316519468,1.4285714285714286,0,1,-0.6467170085812028,4,5,5,5,4,4,2,7,6,6,3,1.0690449676496976,4.428571428571429,0,1.5714285714285714,2.5,3.8333333333333335,3.2559414990859232,-1.0219528370065065,0,-1.00475696650735,2,2,2,2,2,3,4,4,4,4,4,4,1,4,4,4,4,4,4,4,0.7988086367179802,2,0,3,0,3.8,0,2.8,0,3.2,0,2,3,1,3,3,2,3,3,3,1,2,3,1,1,2,4,1,1,1,2,0.9679060415469871,1.8,0,"White, Caucasian, Anglo, European American",0,22,0,1,NA,1,3,6,Software Engineer,5,0,140,70,2,5,2,0,0,1,0,0,TRUE,TRUE,TRUE,TRUE,TRUE,5,0.7921000000003137,0.7755102040816326,0.08123575581627895,5,0.46357241379289793,0.5083645161294168,0.9666666666666667,0.96875,0.012836265057435847,0.009541445806512571,NA,NA,NA,NA,NA,NA,NA,1.6073,0.8335,0.2441,0,35.7001,0.003,ML,change,49,-59.72473910566812,0.9769268156484958,1.2689700672256534,0.43422856419297046,1.2241,3.248,0.3273,3.4297,0.2981,0,-56.0074,0.01,ML,cueing,62,124.39620315513527,3.384989063436779,1.0144751253638082,0.367880985428885,3.113374818649529,1.0815581245842694,0.3014566538199548,NA,NA,NA,NA,NA,NA,NA,NA,NA,NA,NA,NA,NA,NA,104,0.3081481481481481,1,0,5,6,FALSE,FALSE,TRUE
253,2021-11-13T02:30:28Z,2021-11-13T02:52:20Z,1311,1,2021-11-13T02:52:21Z,1,Chrome,95.0.4638.69,Windows NT 10.0,1920,1080,NA,1.7777777777777777,725,58,277,56,27,66,-0.16495148364850934,-0.2889345382713561,-0.7245649926293244,-0.5920321156045217,-0.6207851666761067,-0.6651245862194046,3,4,2,3,2,1,2,2,1,3,2,1,1,1,3,3,1,1,3,2,0.9445132413883326,0,1,1,4,3,1.85,0,5,5,2,5,1,1,4,1,1,1,1,5,1,5,5,1,1,1,1,1,1,1,1,2,2,0,0,5,5,5,5,5,5,5,5,4,1,5,1,1,3,1,5,1,1,1,3,1,5,1,1,1,2,1,1,2,2,1,5,1,1,1,1,1,2,1,1,1,1.833947481081005,1.9591057240729093,1,0,1.25,0,1.1333333333333333,0,1.1111111111111112,0,1.3333333333333333,0,1,0,1.1428571428571428,0,1,0,1.2162162162162162,0,1,0,0,-1.4181548341315258,-0.4557470907642554,-0.9369509624478906,4,2,4,1,1,2,2,1,1,1.2535663410560174,1.7142857142857142,0,1,-0.4757826382709144,4,4,5,4,1,2,1,3,5,2,2,1.632993161855452,3.5714285714285716,0,2.4285714285714284,5,3.8333333333333335,3.2559414990859232,0.38995568780511447,0,0.17922328042708108,3,1,2,1,2,1,5,1,1,3,1,5,1,4,4,1,5,1,4,1,1.7674302033770737,1.8,0,5,0,4.4,0,4.6,0,4.666666666666667,0,1,1,1,3,2,1,1,3,1,1,2,4,2,1,1,3,1,1,2,1,0.9333020044867296,1.35,0,"Asian or Asian American (e.g., Chinese, Japanese, and others)",0,20,1,2,NA,1,2,4,Student,2,0,90,60,2,5,2,0,0,1,0,0,TRUE,TRUE,TRUE,TRUE,TRUE,1,0.958035897436098,0.7959183673469388,0.21512891063766404,1,0.44802812500012806,0.521222580644933,1,1,0.0035013336995772214,0.0028329284731210204,1,0.5940937499998253,0.685234374999709,1,1,0.013226061895138936,0.009654464264122961,1.6853,0.823,0.4496,0,41.8528,0.003,ML,change,49,-72.03013910566813,0.8295422528970914,1.6406356016014005,0.3727803460261362,5.8967,9.9089,0.2237,9.8194,0.1478,0,-94.4383,0.02,ML,cueing,63,201.30600417917458,4.980278070821536,0.8319083126432918,0.44031232157778744,4.723393399961766,0.8771521606532011,0.35807784099036644,0.176,0.251,0.515,0.01,1.178,180.58389225987477,2000.025676624259,0.176,0.253,0.523,0.009,1.264,205.4498284754161,1990.9176638729111,350,1.0370370370370372,1,0,1,2,FALSE,FALSE,FALSE
254,2021-11-13T02:32:45Z,2021-11-13T02:56:48Z,1443,1,2021-11-13T02:56:49Z,1,Chrome,95.0.4638.69,Windows NT 10.0,1280,720,n/a,1.7777777777777777,766,55,383,67,53,72,-0.05960743592845578,-0.31618875321090295,-0.21425564439628159,-0.45798164373004263,-0.2616716161181409,-0.5637763856542862,3,3,1,1,3,1,1,3,1,4,2,1,1,1,3,3,1,1,4,3,1.145931016569864,0,1,1,3,4,1.45,0,4,5,2,4,2,2,2,2,2,2,1,4,2,4,4,2,1,1,1,1,1,1,1,0,2,0,0,5,4,5,5,5,5,5,5,5,2,5,2,1,4,2,5,1,1,2,1,2,5,1,1,1,3,2,1,1,1,1,5,1,2,1,1,1,2,1,1,1,1.7774023627640307,1.2071217242444348,1.125,0,1.25,0,2,0,1.1111111111111112,0,1.5,0,1.3333333333333333,0,1,0,1,0,1.2972972972972974,0,0,0,0,-0.9571430050065944,-0.6588395645607719,-0.8079912847836832,5,1,4,1,1,1,1,2,1,1.7320508075688772,1.1428571428571428,0,1.5,-0.6331575415043005,5,5,5,5,2,2,1,6,7,3,3,1.8126539343499315,4.142857142857143,0,1.8571428571428572,2.5,3.8333333333333335,3.2559414990859232,-1.0219528370065065,0,-0.8454149716644763,2,3,2,2,2,2,5,3,3,3,2,2,2,3,3,1,4,2,4,3,1.01418510567422,2.2,0,3.6,0,4.2,0,3,0,3.6,0,2,1,2,3,3,2,2,3,2,1,3,2,3,2,2,3,1,2,2,3,0.6958523739384593,2.1,0,"White, Caucasian, Anglo, European American",0,21,1,2,NA,1,3,4,student,4,0,150,65,3,5,2,0,0,0,0,0,TRUE,TRUE,TRUE,TRUE,TRUE,2,0.5868974999964237,0.8163265306122449,0.009010347611068167,2,0.5219733333269755,0.5870214285424777,0.9375,0.9333333333333333,0.045545470065977874,0.07149252408954034,2,0.5673645161274941,0.6973066666603088,1,0.9375,0.004671859035337047,0.007667512858268369,1.0801,1.5477,0.3721,0,-11.1837,0.004,ML,change,49,34.04286089433188,1.9791022680657302,0.7537027776920197,0.4664306658023808,1.23,2.122,0.3261,2.235,0.2765,0,-22.2063,0.009,ML,cueing,62,56.79400315513527,1.7753569682479036,1.4864939146405804,0.2241944734391184,2.017836063972516,1.3420565968926477,0.23099342092288705,0.077,0.404,0.492,0.008,1.478,91.97086974416908,1954.835446268901,0.084,0.409,0.553,0.011,1.793,93.26296320406566,1938.9705048831745,378,1.12,1,0,0,1,FALSE,FALSE,FALSE
255,2021-11-13T02:33:12Z,2021-11-13T02:57:06Z,1434,1,2021-11-13T02:57:08Z,1,Chrome,95.0.4638.69,Windows NT 10.0,1280,720,"The study is inclusive, but there is the assumption that the parents are ""mother"" and ""father"" rather than both women or male, etc. I liked it though! attention games are interesting",1.7777777777777777,699,60,288,78,56,90,-0.23175502610512866,-0.2707650616449916,-0.6716083621523106,-0.3239311718555635,-0.22023543720760635,-0.2597317839589309,2,3,3,2,2,1,1,3,1,2,2,2,2,2,2,2,1,1,2,3,0.6863327411532597,0,1,1,4,4,2.15,0,5,5,1,5,1,1,5,1,1,1,1,5,1,5,5,1,2,1,1,1,2,1,1,1,2,0,0,5,4,5,5,5,5,5,5,5,1,5,1,1,5,1,5,1,1,1,1,1,4,1,1,1,2,2,1,2,2,1,5,1,1,1,2,1,2,2,2,2,1.8327189797835506,2.065591117977289,1.25,0,2,0,1,0,1.1111111111111112,0,1,0,1.3333333333333333,0,1.1428571428571428,0,1.3333333333333333,0,1.1891891891891893,0,1,0,0,-1.3796323256302194,-0.22054348261253207,-0.8000879041213758,5,1,5,1,1,1,1,1,1,1.9518001458970664,1,0,1,-0.9031185640466358,5,5,5,5,3,3,1,3,5,4,3,1.5735915849388864,4.428571428571429,0,1.5714285714285714,5,3.8333333333333335,3.2559414990859232,0.38995568780511447,0,-0.2988027041015393,2,2,1,1,1,1,3,2,1,4,1,3,1,5,4,2,4,1,3,2,1.3557637102737474,1.4,0,4.4,0,3.8,0,4.4,0,4.2,0,1,2,1,3,3,1,1,3,2,1,1,4,2,2,1,4,1,1,2,2,1.0208355710680808,1.5,0,"Hispanic of Latino (e.g., Mexican American, Central American, and others) & White, Caucasian, Anglo, European American",1,21,1,2,NA,1,3,4,"Student, but looking for chemical industry jobs",5,0,115,63,2,5,2,0,0,1,0,0,TRUE,TRUE,TRUE,TRUE,TRUE,5,0.9034955555703905,0.9,0.04248640156945869,5,0.6006968749761581,0.646126666688919,1,0.967741935483871,0.0838634357821709,0.062242109872497384,5,0.5938937499374152,0.6476718750149012,1,1,0.010091746419376673,0.009133236288941542,1.4612,1.6316,0.5572,0,4.8221,0.003,ML,change,50,2.0918690162844378,1.7983662495527655,1.2217892644963984,0.6317401743069255,1.312,2.4322,0.3937,2.6539,0.3535,0,-30.7662,0.008,ML,cueing,63,73.9618041791746,2.1083053650219727,1.61323754997261,0.28821890506275516,2.1351054623538754,1.9404824723851712,0.16047449995336244,0.293,0.164,0.675,0.025,1.423,119.86101896052467,1943.594036384822,0.292,0.163,0.67,0.028,1.532,154.49526712347787,1939.0280138347068,376,1.114074074074074,1,0,0,1,FALSE,FALSE,FALSE
256,2021-11-13T02:32:54Z,2021-11-13T02:57:20Z,1465,1,2021-11-13T02:57:21Z,1,Chrome,94.0.4606.81,Macintosh,1440,900,NA,1.6,657,64,304,88,52,66,-0.3396684408427445,-0.23442610839226255,-0.5945805360039267,-0.202067106515128,-0.2754836757549857,-0.6651245862194046,2,2,1,2,2,3,3,2,1,2,2,1,1,1,2,2,2,1,1,2,0.6386663736585051,0,1,3,4,3,2.35,0,1,3,2,2,3,3,3,3,3,3,4,2,2,2,2,3,4,3,3,2,4,4,4,7,2,0,8,4,2,2,3,3,3,2,3,3,3,2,3,5,2,3,3,5,5,5,3,4,1,5,4,4,4,1,3,4,3,2,4,2,3,3,2,2,4,4,4,4,1.100095545945992,0.7432233529572065,3.375,0,4,0,3.3333333333333335,0,3.2222222222222223,0,3.9166666666666665,0,3.6666666666666665,0,2.5714285714285716,0,2.3333333333333335,0,3.3783783783783785,0,4,0,6,1.4771310874754593,2.0746414419100305,1.775886264692745,2,3,1,2,2,3,3,4,1,0.7559289460184544,3.142857142857143,0,2.5,0.9323707254421016,2,4,3,4,1,1,2,6,5,2,2,1.2724180205607036,2.7142857142857144,0,3.2857142857142856,3.5,3.8333333333333335,3.2559414990859232,-0.4571894270818581,0,0.23367670751221528,2,2,2,3,2,2,4,2,2,2,4,3,3,3,4,4,3,3,4,3,0.7988086367179802,2.2,0,3,0,3,0,3.6,0,3.2,0,2,4,2,2,3,3,2,1,1,1,3,2,3,2,1,2,3,3,2,3,0.8506963092234007,2.55,0,"Black or African American & White, Caucasian, Anglo, European American",1,19,1,2,NA,1,3,3,student,3,0,100,63,2,5,2,0,0,1,0,0,TRUE,TRUE,TRUE,TRUE,TRUE,4,0.6922047619081679,0.8571428571428571,0.017605530800724422,4,0.4883968749959022,0.5578642857117312,1,0.9032258064516129,0.0040861751511048995,0.006762104452118421,4,0.6019548387104465,0.6991580645095917,1,1,0.005438590558545082,0.00792873518292825,1.1027,1.728,0.4602,0,-12.119,0.004,ML,change,49,35.91346089433188,1.9349761335303177,0.9259853070947351,0.5212935901797865,1.2466,2.5489,0.356,4.741,0.3569,0,-62.3807,0.009,ML,cueing,63,137.1908041791746,2.8789958770222244,0.7758233484576302,0.44920418034562554,4.544470093663507,0.9116870924441624,0.39122417360253725,0.161,0.35,0.632,0.011,1.349,13.643500142455702,1810.6304223946083,0.163,0.353,0.644,0.013,1.438,22.938469276591523,1804.9863709450517,348,1.031111111111111,1,0,1,2,FALSE,FALSE,FALSE
257,2021-11-13T02:37:33Z,2021-11-13T02:57:24Z,1190,1,2021-11-13T02:57:26Z,1,Chrome,95.0.4638.69,Windows NT 10.0,1536,864,NA,1.7777777777777777,567,67,323,70,64,57,-0.5709114724233499,-0.20717189345271578,-0.5031099924527209,-0.421422424127912,-0.10973896011284763,-0.8171468870670823,3,3,2,1,2,1,2,2,1,2,2,3,2,3,2,2,2,1,2,3,0.6863327411532597,0,1,1,3,3,2.25,0,2,2,4,3,5,2,3,2,2,1,2,3,3,4,1,2,2,1,2,2,2,2,2,0,2,0,0,4,1,2,3,3,3,2,3,2,5,3,1,1,2,2,3,5,2,2,5,2,4,1,1,1,3,1,1,1,1,1,2,5,3,2,2,1,1,2,1,1,1.292156983369153,1.121223821162776,1.875,0,1.25,0,3,0,3.4444444444444446,0,2.9166666666666665,0,1.3333333333333333,0,2.142857142857143,0,1.6666666666666667,0,2.5945945945945947,0,0,0,0,0.35242870359309486,-0.6588395645607719,-0.1532054304838385,5,3,4,3,1,1,2,1,1,1.4960264830861913,1.8571428571428572,0,1,-0.39031545311577004,4,4,4,3,1,1,2,6,8,4,4,1.3801311186847085,3,0,3,2,3.8333333333333335,3.2559414990859232,-1.3043345419688306,0,-0.34923784477414443,3,3,4,4,4,2,5,2,2,4,2,3,2,4,5,2,4,1,5,3,1.3345232785352157,3.6,0,4,0,4.4,0,4,0,4.133333333333334,0,2,3,1,2,4,2,3,4,1,1,4,4,2,4,2,3,1,3,3,2,1.0990426455975697,2.25,0,"Asian or Asian American (e.g., Chinese, Japanese, and others) & White, Caucasian, Anglo, European American",1,24,1,2,NA,1,3,6,Unemployed,3,0,114,64,1,5,2,0,1,0,0,1,TRUE,TRUE,TRUE,TRUE,TRUE,4,0.5630047619058972,0.84,0.012932590840708543,4,0.3986466666698456,0.45132903226344817,0.967741935483871,0.96875,0.0023157978275992743,0.002234461774631728,4,0.5090281250029802,0.5481656250003726,1,1,0.008242831764741233,0.006761710070895329,1.1162,1.6013,0.3315,0,-9.0242,0.004,ML,change,50,29.78446901628444,1.9686139623065664,0.8423327825332682,0.417525174975734,1.0558,5.2415,0.3559,3.7874,0.2646,0,-87.2785,0.008,ML,cueing,63,186.9864041791746,4.865949355066718,0.7057178268634204,0.3833453342831611,4.800422137189255,0.708520476837403,0.32961008411631076,0.168,0.204,0.565,0.054,1.907,212.89491646557306,2034.582796968715,0.178,0.195,0.56,0.041,2.013,236.81847045655485,2021.5848716090418,466,1.3807407407407408,1,0,0,1,FALSE,FALSE,FALSE
258,2021-11-13T02:02:57Z,2021-11-13T02:57:54Z,3297,1,2021-11-13T02:57:55Z,1,Chrome,95.0.4638.69,Windows NT 10.0,1920,1080,NA,1.7777777777777777,2323,104,487,89,86,100,3.940897010416017,0.12896342413502795,0.28642522556821326,-0.18988069998108442,0.19412635189773886,-0.09081811635040013,2,3,4,3,2,3,2,3,1,3,2,4,3,3,2,2,3,3,2,2,0.7539370349250519,0,0,5,2,3,2.8,0,1,2,4,2,4,4,3,4,5,3,4,2,3,2,1,5,5,4,3,5,5,4,4,6,5,0,2,3,3,2,4,3,4,3,4,3,4,3,4,5,3,5,2,5,4,4,4,5,1,3,3,2,2,5,3,5,4,3,2,5,4,3,5,4,4,4,3,3,1.0696467380140717,1.2227992865708155,4.375,0,3.5,0,4,0,2.7777777777777777,0,4.166666666666667,0,3.1666666666666665,0,3.857142857142857,0,4,0,3.6486486486486487,0,3,0,2,2.3095269998152466,1.008947975082309,1.6592374874487779,1,5,2,4,4,5,4,3,2,1.5118578920369088,4.428571428571429,0,2.5,1.7015753918384005,1,2,3,1,1,1,5,4,3,1,1,1.5275252316519468,1.4285714285714286,0,4.571428571428571,5.5,3.8333333333333335,3.2559414990859232,0.6723373927674386,0,1.5154790942297942,3,3,2,3,3,2,4,1,1,2,1,4,3,3,4,3,5,2,3,3,1.2227992865708155,2.8,0,4.4,0,3,0,4,0,3.8,0,3,4,3,1,4,2,4,2,3,1,4,2,3,4,2,2,3,2,4,3,1.0052493799000692,3.1,0,"Black or African American & Hispanic of Latino (e.g., Mexican American, Central American, and others)",1,18,1,3,NA,1,2,3,Unemployed,2,0,115,61,1,5,2,0,0,0,0,0,TRUE,TRUE,TRUE,TRUE,TRUE,2,0.8802785714268685,0.84,0.04786305116477078,2,0.6178781249988824,0.8104781249966473,1,1,0.008787328215311752,0.009418243054691442,2,0.6875258064519975,0.7407870967791926,1,1,0.010091697311350543,0.006950423828092225,1.3824,1.2888,0.5037,0,12.3528,0.004,ML,change,50,-12.969530983715563,1.4193249927614602,1.168321621235781,0.6004065525122222,3.6773,5.5138,0.477,6.5595,0.3376,0,-66.108,0.01,ML,cueing,64,144.69264925007903,3.6882471955781764,1.1233343392380855,0.6629513889305872,3.7527383236404313,1.1040297428391939,0.4753783393572942,0.147,0.438,0.572,0.018,1.148,17.835403298286312,1807.7934670694349,0.143,0.45,0.594,0.021,1.329,29.28044045361167,1810.137568423758,330,0.9777777777777777,1,0,3,4,FALSE,FALSE,FALSE
259,2021-11-13T02:06:20Z,2021-11-13T02:58:31Z,3130,1,2021-11-13T02:58:32Z,0.8999999761581421,Safari,14.0.3,Macintosh,1440,900,NA,1.6,790,803,985,290,90,92,0.0020573724930389916,6.47919550504943,2.6839163144366593,2.25958701336167,0.2493745904451182,-0.2259490504372247,3,3,2,1,2,1,1,2,1,2,2,2,3,2,2,3,1,1,2,2,0.7181848464596079,0,1,2,3,3,2.1,0,5,5,2,4,2,1,5,1,1,1,1,5,1,5,4,1,1,1,1,1,1,1,1,1,2,0,0,5,4,4,4,4,5,4,4,5,1,5,1,1,4,1,5,3,1,1,2,2,4,1,1,1,2,1,1,2,1,1,3,3,3,1,1,1,2,1,1,2,1.55673485970586,1.8464895909600492,1,0,1.5,0,1.2666666666666666,0,1.6666666666666667,0,1.4166666666666667,0,1.1666666666666667,0,1.8571428571428572,0,1,0,1.5405405405405406,0,1,0,0,-1.2214771022856596,-0.3773458880470143,-0.7994114951663369,5,1,4,2,1,2,1,3,1,1.6035674514745464,1.4285714285714286,0,2,-0.2777293338068208,5,5,5,5,3,3,1,3,8,6,4,1.5735915849388864,4.428571428571429,0,1.5714285714285714,3.5,3.8333333333333335,3.2559414990859232,-0.4571894270818581,0,-0.7223752615450256,2,2,2,3,2,2,5,2,2,3,3,3,2,4,4,1,4,2,4,2,1.1254628677422756,2.2,0,3.6,0,4.2,0,4,0,3.933333333333333,0,2,1,1,2,3,2,3,3,1,2,3,3,2,1,1,3,1,1,1,3,0.8870412083230169,1.85,0,"White, Caucasian, Anglo, European American",0,25,1,2,NA,1,3,6,Actuarial analyst,5,0,170,69,1,5,2,0,1,2,0,1,TRUE,TRUE,TRUE,TRUE,TRUE,6,0.96083870967741,0.7045454545454546,0.24368709672303598,6,0.4546896551724133,0.5010689655172409,0.9666666666666667,0.9354838709677419,0.00982857586206937,0.009692918279569704,6,0.6312666666666715,0.7590000000000011,0.9375,0.78125,0.018188673387097367,0.020529870967741063,1.8822,0.5017,0.2084,0,51.4652,0.003,ML,change,44,-91.57783109824523,0.5388759557696627,1.6126862550072125,0.3486984953334322,1.0839,2.8609,0.3274,3.3443,0.2998,0,-54.637,0.01,ML,cueing,61,121.60662159251993,2.94886973302471,0.9068385149328398,0.3671486561855291,3.3282690696051986,1.0117258429427116,0.31283251657195627,0.062,0.419,0.328,0.005,1.397,155.91965089062168,2173.2397485966944,0.062,0.42,0.3,0.005,1.513,181.23526244464568,2171.142682943521,424,1.2562962962962962,1,0,0,1,FALSE,FALSE,FALSE
260,2021-11-13T02:06:36Z,2021-11-13T02:58:40Z,3123,1,2021-11-13T02:58:40Z,1,Chrome,95.0.4638.69,Windows NT 10.0,1366,768,NA,1.7786458333333333,1381,144,870,202,136,194,1.5205532798723476,0.4923529566623185,2.130278813995151,1.1871832383658372,0.8847293337399809,1.496970359169789,3,3,1,1,3,1,1,3,1,3,2,1,1,1,4,3,1,1,3,3,1.0760551736979407,0,1,1,4,4,1.5,0,3,4,2,4,2,3,4,3,3,2,2,3,3,2,2,3,3,1,2,2,3,3,3,4,2,0,1,3,2,2,2,1,3,3,3,3,1,5,2,1,3,3,4,5,3,3,2,2,2,2,3,1,3,1,1,3,3,1,4,3,2,2,2,2,2,2,2,2,1.0433544884595018,0.7745966692414834,2.5,0,2,0,2.6666666666666665,0,3.5555555555555554,0,2.3333333333333335,0,2.1666666666666665,0,2,0,2,0,2.5675675675675675,0,2,0,1,0.4661572148720772,0.15899863808316506,0.3125779264776211,3,2,1,3,2,3,4,3,1,0.9759000729485332,3.142857142857143,0,2,0.7478768880549106,4,4,4,4,2,2,3,1,2,2,2,0.9511897312113419,3.2857142857142856,0,2.7142857142857144,7.5,3.8333333333333335,3.2559414990859232,1.8018642126167355,0,1.0445195376757652,2,2,2,2,2,2,5,1,1,2,2,4,3,4,5,2,4,3,5,3,1.3870146083619754,2,0,3.8,0,3.8,0,4.4,0,4,0,2,1,2,2,2,2,1,2,1,1,1,2,1,1,1,4,2,2,1,2,0.7451598203705946,1.65,0,"White, Caucasian, Anglo, European American",0,28,1,2,NA,1,2,2,Homemaker,3,0,180,66,1,5,2,1,0,1,0,1,TRUE,TRUE,TRUE,TRUE,TRUE,6,1.0844583333334368,0.72,0.08053174120809359,6,0.6284225806452094,0.6677031249998836,1,1,0.01704603047322086,0.0065878570866955335,6,0.7525750000000698,0.7834266666661948,1,0.9375,0.012902936128966203,0.011574754264161402,1.4075,0.7006,0.6704,0,31.1717,0.003,ML,change,50,-50.60733098371556,0.7675638973713339,1.2304664303197905,0.7317807053243217,8.0931,8.0356,0.1642,6.4394,0,0,-54.7995,0.013,ML,cueing,63,122.0284041791746,4.032983563617125,1.0273125741865445,0.5443194016912488,3.179850331873221,1.3029338786366242,0.4299514164087359,0.062,0.567,0.282,0.014,1.254,275.03905988006545,2190.49587401523,0.062,0.568,0.333,0.014,1.313,288.651936433117,2168.9588402604454,344,1.0192592592592593,0,0,0,1,FALSE,FALSE,FALSE
261,2021-11-13T02:39:10Z,2021-11-13T02:59:28Z,1218,1,2021-11-13T02:59:29Z,1,Chrome,95.0.4638.69,Macintosh,1440,900,NA,1.6,639,67,307,66,49,56,-0.3859170471588656,-0.20717189345271578,-0.5801378186011047,-0.47016805026408615,-0.31691985466552025,-0.8340382538279354,2,2,4,3,1,2,4,2,1,2,1,3,1,2,2,1,3,2,2,2,0.9119095061289915,0,1,1,3,1,2.9,0,1,3,4,3,3,4,2,4,3,3,1,1,1,3,4,4,3,5,5,2,4,4,3,6,1,3,2,4,4,1,3,3,3,4,4,3,4,3,1,1,2,3,3,5,5,1,1,4,1,5,5,4,4,1,2,5,3,1,4,1,1,1,1,1,1,3,3,2,1.4982472241738827,1.1751393027860062,3.75,0,2.25,0,3.2,0,2.7777777777777777,0,2.9166666666666665,0,3.8333333333333335,0,2,0,1,0,2.7567567567567566,0,3,3,2,1.3138459823455497,1.2368415842751745,1.2753437833103622,5,1,2,1,1,1,1,3,1,1.4960264830861913,1.4285714285714286,0,2,-0.2777293338068208,4,3,4,3,2,2,4,7,6,2,2,0.8997354108424374,2.857142857142857,0,3.142857142857143,2.5,3.8333333333333335,3.2559414990859232,-1.0219528370065065,0,-0.12837599487154566,2,2,2,2,2,2,5,2,2,2,2,4,1,4,4,4,5,1,5,1,1.533747356112131,2,0,4.4,0,3.8,0,4.2,0,4.133333333333334,0,3,2,4,1,3,4,4,2,4,4,1,1,2,4,2,1,4,4,4,4,1.2523661815266247,3.4,0,"White, Caucasian, Anglo, European American",0,22,1,2,NA,1,2,4,student,1,0,165,63,2,5,2,0,0,1,0,0,TRUE,TRUE,TRUE,TRUE,TRUE,4,0.7039823529439814,0.6938775510204082,0.014574648123611752,4,0.41607999997933703,0.46495999998251597,0.9375,0.9375,0.0026883153936577706,0.003101973538835972,4,0.6317718750014901,0.7437266666650773,1,0.9375,0.00866799111806232,0.011547492493746692,1.0589,0.8252,0.4569,0,3.0314,0.005,ML,change,49,5.612660894331879,1.0301666326768668,0.7943475332603122,0.5544860000991705,0.9496,4.6032,0.3618,4.9304,0.3104,0,-82.3477,0.017,ML,cueing,64,177.17204925007903,3.949914133898891,0.6855972330793787,0.38902194682383784,4.093804718166802,0.6614996042886163,0.34538633069120717,0.085,0.443,0.477,0.01,1.604,49.97094363197551,1899.1261520933272,0.085,0.444,0.483,0.011,1.681,59.81047881261501,1903.344449488103,478,1.4162962962962962,1,0,0,1,FALSE,FALSE,FALSE
262,2021-11-13T02:36:56Z,2021-11-13T02:59:53Z,1376,1,2021-11-13T02:59:54Z,1,Chrome,95.0.4638.69,Windows NT 10.0,2560,1440,NA,1.7777777777777777,685,54,358,92,55,84,-0.2677261643510006,-0.3252734915240852,-0.33461162275313133,-0.15332148037895377,-0.2340474968444512,-0.3610799845240493,3,3,1,1,2,1,1,2,1,2,1,3,3,3,2,2,2,1,1,1,0.8335087534664907,0,1,2,4,3,2.4,0,4,5,2,5,1,1,4,1,1,2,2,4,3,3,4,1,2,1,1,1,1,1,1,1,2,1,5,5,1,1,2,4,4,2,4,3,2,5,1,1,3,2,5,1,1,3,3,4,5,3,1,1,4,1,1,3,1,1,5,1,1,1,1,1,1,1,1,1,1.5156837721956706,1.4735767952260144,1.125,0,1,0,1.7333333333333334,0,3.111111111111111,0,1.9166666666666667,0,1.6666666666666667,0,1.1428571428571428,0,1,0,2,0,1,1,5,-0.7697571345077772,0.554733148607431,-0.10751199295017311,4,1,2,1,1,2,1,1,1,1.1126972805283737,1.7142857142857142,0,1,-0.4757826382709144,3,4,5,5,2,2,2,4,1,3,2,1.3801311186847085,3.5714285714285716,0,2.4285714285714284,6.5,3.8333333333333335,3.2559414990859232,1.237100802692087,0,0.6027958378705673,2,4,2,4,2,2,5,1,1,3,1,4,2,4,4,1,4,1,4,1,1.505545305418162,2.8,0,4.4,0,4.2,0,4.6,0,4.4,0,3,2,2,1,3,2,3,2,1,2,2,3,1,1,1,3,1,3,2,2,0.7947194142390263,2.1,0,"Hispanic of Latino (e.g., Mexican American, Central American, and others)",0,20,0,1,NA,1,2,4,Construction worker and student,1,0,165,69,3,5,2,0,0,0,0,0,TRUE,TRUE,TRUE,TRUE,TRUE,2,0.8411690476565133,0.84,0.04302850033047552,2,0.47046250002086165,0.5406000000317892,1,0.967741935483871,0.0017180753232479864,0.002248492904820596,2,0.5747625000402331,0.6590225806466995,1,0.96875,0.006204247579917024,0.0036063544793432383,1.4461,1.2925,0.4967,0,13.5006,0.01,ML,change,50,-15.265130983715563,1.4576152149623436,1.1376308778763478,0.5758078641922266,1.2013,4.4524,0.4121,6.549,0.3787,0,-98.3959,0.01,ML,cueing,63,209.2212041791746,4.835948976333477,0.7033153985509745,0.47257403297056066,5.643544376319638,0.7341369979788167,0.4074528761596442,0.074,0.431,0.535,0.014,1.624,91.00464649929278,1930.710241991803,0.08,0.419,0.57,0.013,1.682,100.78755562656087,1930.3305424389134,104,0.3081481481481481,1,1,0,1,FALSE,FALSE,FALSE
263,2021-11-13T02:40:18Z,2021-11-13T03:00:59Z,1240,1,2021-11-13T03:01:01Z,1,Chrome,95.0.4638.69,Macintosh,1440,900,n/a,1.6,751,40,246,57,34,64,-0.09814794119189,-0.45245982790863687,-0.873806405791818,-0.5798457090704782,-0.5241007492181928,-0.6989073197411108,3,3,2,2,3,1,1,2,1,3,2,1,1,1,3,3,1,1,2,3,0.8870412083230169,0,1,1,4,4,1.75,0,4,4,2,4,2,2,3,2,2,2,2,4,3,4,4,1,4,1,1,1,1,1,1,0,2,0,0,5,5,5,5,5,5,5,5,5,1,5,1,1,5,2,5,2,1,1,1,1,3,1,1,1,2,1,1,1,1,1,5,1,1,1,1,1,1,1,1,1,1.879636409796595,0.9611501047232549,1.375,0,1,0,2.1333333333333333,0,1,0,1.1666666666666667,0,1.3333333333333333,0,0.8571428571428571,0,1,0,1.135135135135135,0,0,0,0,-0.8620950066440746,-0.7372407672780129,-0.7996678869610437,5,1,5,1,1,1,1,1,1,1.9518001458970664,1,0,1,-0.9031185640466358,4,5,5,5,4,4,1,6,6,6,4,1.4142135623730951,4.571428571428571,0,1.4285714285714286,3,3.8333333333333335,3.2559414990859232,-0.7395711320441822,0,-0.9432371114476243,2,2,2,2,2,2,4,2,2,2,1,3,2,3,4,1,4,2,3,2,0.990430401872025,2,0,4,0,3.6,0,3.8,0,3.8,0,1,1,1,4,1,1,1,4,1,1,2,4,1,2,1,4,1,1,1,1,1.2182817926554552,1.1,0,"White, Caucasian, Anglo, European American",0,27,1,2,NA,1,3,6,Marketing,3,0,123,64,3,5,2,0,0,1,0,0,TRUE,TRUE,TRUE,TRUE,TRUE,2,0.9781857142857143,0.7,0.11960366973180378,2,0.7649656250029803,0.7905593750029802,1,1,0.12956397265023606,0.07480600183869254,2,0.8887999999951571,1.1334375000037253,1,1,0.084367592904661,0.13260328758387682,1.6655,0.5343,0.3255,0,49.3179,0.008,ML,change,50,-86.89973098371557,0.6287976871698395,1.3474888309478572,0.5495935427677878,2.375,2.4526,0.3064,2.1733,0.2185,0,1.8446,0.008,ML,cueing,64,8.787449250079014,2.1969915343657567,1.8858218894264436,0.37478855231083297,1.9150998860147201,2.163403985686252,0.21778852305691299,0.303,0.031,0.335,0.04,1.919,225.21717292146909,2012.2404949829124,0.29,0.004,0.332,0.009,2.071,165.49258420556535,1950.0332050432355,434,1.285925925925926,1,0,0,1,FALSE,FALSE,FALSE
264,2021-11-13T02:39:17Z,2021-11-13T03:01:46Z,1349,1,2021-11-13T03:01:47Z,0.8999999761581421,Chrome,95.0.4638.69,Macintosh,1680,1050,NA,1.6,646,65,364,90,68,77,-0.3679314780359296,-0.22534137007908028,-0.30572618794748735,-0.17769429344704088,-0.054490721565468275,-0.47931955185002084,4,4,2,3,3,1,1,3,1,3,4,1,1,1,4,4,1,1,3,3,1.2732056517228265,0,1,2,5,5,1.4,0,1,1,5,2,5,5,3,5,5,5,3,1,5,1,1,5,5,5,2,5,5,5,5,3,2,2,5,5,1,1,1,1,1,1,1,1,5,3,5,3,1,2,2,5,5,5,5,5,1,4,5,3,3,3,2,5,1,2,2,4,5,4,5,5,2,4,4,2,1.698789535488692,1.8593393604027366,4.625,0,3,0,4.666666666666667,0,4.555555555555555,0,4.333333333333333,0,3.6666666666666665,0,3.142857142857143,0,4.666666666666667,0,4.135135135135135,0,2,2,5,2.912530085149767,1.5916684517349,2.2520992684423335,3,3,2,4,3,5,3,2,1,0.9511897312113419,3.5714285714285716,0,1.5,0.8197846061331525,1,1,1,1,1,1,5,3,3,1,1,1.5118578920369088,1,0,5,6,3.8333333333333335,3.2559414990859232,0.9547190977297628,0,1.8956829389752667,1,1,2,3,2,2,5,1,1,1,1,5,1,4,5,2,5,1,5,4,1.8464895909600492,1.8,0,4.8,0,4,0,4.2,0,4.333333333333333,0,1,4,1,2,2,1,3,4,3,2,1,3,4,4,1,3,2,4,2,2,1.145931016569864,2.25,0,"Hispanic of Latino (e.g., Mexican American, Central American, and others)",0,21,1,2,NA,1,2,5,student,3,0,106,65,1,5,2,0,0,1,0,0,TRUE,TRUE,TRUE,TRUE,TRUE,2,0.717126315788611,0.76,0.02955926564856725,2,0.5149343749983236,0.5752812499995343,1,1,0.0035199371673652474,0.006556382862851871,2,0.6140218750000931,0.750737500000745,1,1,0.007426734022309718,0.011101289516186231,1.254,0.9805,0.3861,0,14.1617,0.008,ML,change,50,-16.58733098371556,1.1801976580615237,0.9766834411717638,0.5019609212717708,5.0491,7.1965,0.2245,9.0462,0.2359,0,-82.3004,0.013,ML,cueing,64,177.077449250079,4.037815006456813,1.026083344523289,0.45219261933946003,4.717140007670736,0.8783149789182026,0.4247454433105448,0.192,0.291,0.586,0.009,1.491,57.573047466623954,1850.4082434804836,0.195,0.289,0.605,0.009,1.526,68.48919696804657,1850.9152365596742,444,1.3155555555555554,1,0,0,1,FALSE,FALSE,FALSE
265,2021-11-13T02:45:24Z,2021-11-13T03:02:26Z,1021,1,2021-11-13T03:02:27Z,0.8999999761581421,Safari,14.0.3,Macintosh,1440,900,NA,1.6,567,43,236,42,25,58,-0.5709114724233499,-0.4252056129690901,-0.9219487971345579,-0.7626418070811315,-0.6484092859497964,-0.8002555203062293,1,2,3,3,2,3,2,2,2,2,1,2,2,3,1,2,2,3,2,2,0.6407232755171874,0,1,1,3,2,2.9,0,3,4,2,4,1,3,3,3,4,4,4,4,3,4,4,4,3,1,1,2,2,4,2,3,2,0,0,4,4,4,5,4,4,3,4,4,4,4,3,2,2,3,2,3,2,3,2,3,4,3,4,2,2,1,1,4,4,2,5,2,2,1,1,1,1,1,1,1,1.187396273326605,0.8997354108424374,2.375,0,1,0,2.6666666666666665,0,2,0,2.9166666666666665,0,2.1666666666666665,0,2.142857142857143,0,1,0,2.324324324324324,0,2,0,0,0.30790520130515253,-0.33105581968498016,-0.011575309189913813,5,1,4,1,1,1,1,2,1,1.7320508075688772,1.1428571428571428,0,1.5,-0.6331575415043005,5,5,5,5,5,5,1,7,7,6,5,1.5118578920369088,5,0,1,2,3.8333333333333335,3.2559414990859232,-1.3043345419688306,0,-1.464631808674259,4,4,4,3,4,2,3,3,3,4,4,4,3,4,4,4,4,3,2,4,0.7367883976130072,3.8,0,3.4,0,2.8,0,3.2,0,3.1333333333333333,0,3,1,3,3,3,4,3,3,3,3,3,3,2,1,3,2,2,3,3,3,0.7326950970650465,2.6,0,"Asian or Asian American (e.g., Chinese, Japanese, and others)",0,21,1,2,NA,1,5,3,student,6,0,100,60,3,5,2,0,0,2,0,0,TRUE,TRUE,TRUE,TRUE,TRUE,1,0.6485806451612899,0.62,0.02869295877551095,1,0.41896774193548014,0.5408620689655093,1,0.90625,0.003831832258065602,0.0069723054435468475,1,0.5978750000000018,0.713814814814817,1,0.84375,0.004742370967741169,0.011758709677419314,1.2803,0.4172,0.3205,0,24.8507,0.004,ML,change,50,-37.96533098371556,0.5310779945938695,0.9218009977857909,0.4402946290575983,1.1343,2.4854,0.3428,4.55,0.2943,0,-62.3055,0.018,ML,cueing,63,137.0404041791746,2.8870154828056247,0.78582312939785115,0.43028398297352266,4.618073833010629,0.8971564501147282,0.32486787016252894,0.062,0.466,0.477,0.011,1.722,51.891438253128975,1925.5651006177732,0.068,0.464,0.542,0.012,1.82,61.89670360057148,1924.4717414577722,104,0.3081481481481481,1,0,0,1,FALSE,FALSE,FALSE
266,2021-11-13T02:38:12Z,2021-11-13T03:02:27Z,1455,1,2021-11-13T03:02:29Z,1,Chrome,95.0.4638.69,Macintosh,1440,900,NA,1.6,652,94,389,71,71,93,-0.3525152759305559,0.038116041003205335,-0.18537020959063766,-0.4092360175938684,-0.013054542654933752,-0.20905768367637165,2,3,2,2,3,1,1,2,1,3,3,1,1,1,3,3,1,1,3,2,0.8870412083230169,0,1,5,2,3,1.75,0,3,2,2,2,2,1,4,1,4,1,1,1,5,3,5,4,3,1,1,4,4,5,3,0,2,3,0,5,3,4,5,3,5,3,5,5,2,5,5,2,3,3,5,5,5,5,5,5,2,3,1,1,4,3,1,1,1,1,1,5,5,5,5,2,1,1,1,1,1.6093756833288149,1.4573295865416045,3.125,0,1,0,2.6,0,1.7777777777777777,0,3.5,0,2.5,0,2.5714285714285716,0,4,0,2.8378378378378377,0,0,3,0,0.8222484429532494,-0.11734114449894173,0.35245364922715383,5,1,4,1,1,1,1,1,1,1.7320508075688772,1.1428571428571428,0,1,-0.8176513788914915,2,3,3,5,1,1,5,1,3,1,2,1.6761634196950514,2.2857142857142856,0,3.7142857142857144,7,3.8333333333333335,3.2559414990859232,1.5194825076544112,0,1.4610256671446602,1,1,4,2,2,1,5,1,1,5,1,5,1,5,5,1,5,1,5,3,2,2,0,5,0,5,0,4.6,0,4.866666666666666,0,3,4,2,4,2,1,4,3,1,2,4,3,2,1,1,3,1,2,1,1,1.164157703189193,1.95,0,"White, Caucasian, Anglo, European American",0,30,1,2,NA,1,3,6,k12 teacher,4,0,111,67,2,5,2,0,0,1,0,0,TRUE,TRUE,TRUE,TRUE,TRUE,6,0.9113064516130234,0.6326530612244898,0.02467341534011486,6,0.5125718750000233,0.5595387096772751,1,0.96875,0.003981614344689405,0.004752959022195262,6,0.6125156249997672,0.7455968749998138,1,1,0.007770609102836902,0.01761252869958659,1.311,0.4533,0.5549,0,25.9556,0.004,ML,change,49,-40.235739105668124,0.6107463382312341,0.8900838409663359,0.7179817620330866,1.8425,3.7472,0.3232,5.8083,0.354,0,-69.3282,0.011,ML,cueing,64,151.133049250079,4.029209036920444,0.8522732806907852,0.4603869663293676,4.574016177173122,0.9057980046218623,0.41665050273240867,0.173,0.294,0.54,0.01,1.41,43.04733398564572,1835.2677998789532,0.176,0.297,0.555,0.01,1.441,56.07984576305755,1839.897060743168,428,1.268148148148148,1,0,0,1,FALSE,FALSE,FALSE
267,2021-11-13T02:29:20Z,2021-11-13T03:02:35Z,1994,1,2021-11-13T03:02:36Z,1,Chrome,95.0.4638.69,Macintosh,1280,800,NA,1.6,960,59,447,117,109,139,0.4388497654786269,-0.2798497999581739,0.09385566019725369,0.15133868297213507,0.5118037235451701,0.5679451873228698,3,2,3,1,3,3,2,2,1,3,2,3,3,3,2,3,2,1,2,2,0.7326950970650465,0,1,2,3,2,2.4,0,2,3,4,3,4,1,2,3,3,2,4,3,2,3,3,3,4,1,1,3,2,4,3,4,1,0,1,4,2,2,3,2,3,2,3,2,3,5,3,3,3,3,3,4,3,4,5,4,3,2,3,1,2,5,1,4,4,1,3,3,3,3,3,1,4,3,2,2,1.0640169792499234,0.8618916073713346,2.625,0,2.75,0,3.066666666666667,0,3.4444444444444446,0,3.25,0,2.5,0,2.5714285714285716,0,2.3333333333333335,0,3.027027027027027,0,2,0,1,0.8892272768298931,0.39420224623488836,0.6417147615323907,3,1,1,2,2,3,2,3,1,0.816496580927726,2.5714285714285716,0,2,0.4060081474343336,3,3,3,3,2,2,3,4,4,1,2,0.4879500364742666,2.7142857142857144,0,3.2857142857142856,5,3.8333333333333335,3.2559414990859232,0.38995568780511447,0,0.6572492649557016,4,4,4,3,3,3,5,4,4,1,2,4,3,4,4,1,4,2,4,2,1.245945806357946,3.6,0,3.8,0,3.6,0,3.2,0,3.533333333333333,0,3,3,3,1,3,3,2,2,3,3,3,3,3,3,3,3,2,3,4,3,0.6155870112510925,2.9,0,"Hispanic of Latino (e.g., Mexican American, Central American, and others) & White, Caucasian, Anglo, European American",1,21,1,3,NA,1,2,3,unemployed,1,0,87,62,1,5,2,0,1,2,0,1,TRUE,TRUE,TRUE,TRUE,TRUE,5,1.0882589743589888,0.78,0.10950808063670919,5,0.5866032258064877,0.6155193548387577,0.96875,0.96875,0.017050983377028775,0.016778212741965615,5,0.7279343749998661,0.8009032258065117,1,1,0.00658135329637958,0.014887130322548583,1.8921,0.7474,0.4122,0,49.6188,0.005,ML,change,50,-87.50153098371557,0.9230565741599388,1.371168798058929,0.6723286032374709,1.697,2.6388,0.3059,2.9073,0.3164,0,-27.9738,0.006,ML,cueing,64,68.42424925007901,2.939506281936413,1.1682190392268839,0.4292286576551252,2.9276790102419956,1.1729384240799337,0.3988043296966227,0.09,0.534,0.441,0.036,1.748,21.971960417243558,1818.6700423138864,0.087,0.542,0.45,0.034,1.921,27.52193733908148,1808.9173160245934,378,1.12,1,0,0,1,FALSE,FALSE,FALSE
268,2021-11-13T02:28:25Z,2021-11-13T03:03:27Z,2101,1,2021-11-13T03:03:28Z,1,Chrome,95.0.4638.54,Macintosh,1440,900,n/a,1.6,1623,50,224,56,48,69,2.14234009812242,-0.36161244477681426,-0.9797196667458458,-0.5920321156045217,-0.3307319143023651,-0.6144504859368455,3,3,2,2,3,2,3,3,1,3,2,1,1,2,3,3,2,1,2,2,0.7677718959499145,0,1,1,2,1,2,0,2,5,3,4,3,3,3,4,4,4,5,2,3,2,3,5,5,5,1,5,5,5,5,2,2,0,0,3,3,2,4,4,5,5,5,3,2,3,2,2,1,3,2,5,5,5,5,5,1,1,5,1,3,2,1,2,2,2,5,1,1,1,1,4,2,3,1,1,1.559625734730109,0.9759000729485332,4.5,0,1.75,0,3.3333333333333335,0,2.2222222222222223,0,3.8333333333333335,0,2.6666666666666665,0,1.2857142857142858,0,2,0,2.675675675675676,0,1,0,0,1.6586127544100062,-0.2989446853297732,0.6798340345401165,5,1,5,1,1,1,1,1,1,1.9518001458970664,1,0,1,-0.9031185640466358,5,5,5,5,5,5,1,7,6,5,4,1.5118578920369088,5,0,1,2.5,3.8333333333333335,3.2559414990859232,-1.0219528370065065,0,-1.3234409561930969,2,1,2,3,3,2,5,1,1,4,1,5,4,5,5,1,5,1,4,3,1.7674302033770737,2.2,0,4.8,0,4,0,4.6,0,4.466666666666667,0,1,1,4,4,3,4,4,2,1,2,4,2,1,4,2,2,3,4,2,3,1.1821033884786185,2.65,0,"Hispanic of Latino (e.g., Mexican American, Central American, and others) & White, Caucasian, Anglo, European American",1,22,1,2,NA,1,3,6,Postgraduate Fellow (research lab),2,0,112,61,2,5,2,0,0,1,0,0,TRUE,TRUE,TRUE,TRUE,TRUE,6,0.7576388888822662,0.72,0.019576449960841798,6,0.4756838709615892,0.5515562499836087,1,1,0.0043864460664747714,0.006174737385783099,6,0.9121312500238419,0.9580566666523616,1,0.967741935483871,0.15360576931000428,0.05946586837393866,1.0941,0.9004,0.471,0,6.1564,0.004,ML,change,50,-0.5767309837155619,1.0931325515333834,0.8639955031217531,0.5837542026928797,4.3674,6.5387,0.2176,8.8287,0.2283,0,-80.181,0.011,ML,cueing,63,172.7914041791746,4.098810796234499,1.0108138512267395,0.4321038079148628,4.207579734259158,0.9846835920082754,0.3559154694111546,0.103,0.407,0.2,0.155,1.571,112.08969322590801,1964.6979712458356,0.1,0.416,0.2,0.02,1.738,119.70745174866924,1945.680932559134,104,0.3081481481481481,1,0,2,3,FALSE,FALSE,FALSE
269,2021-11-13T02:44:26Z,2021-11-13T03:03:39Z,1152,1,2021-11-13T03:03:39Z,1,Chrome,95.0.4638.69,Macintosh,1280,800,NA,1.6,601,52,269,64,48,75,-0.4835529938262323,-0.3434429681504497,-0.7630789057035163,-0.4945408633321733,-0.3307319143023651,-0.513102285371727,4,4,2,3,4,1,1,4,1,4,4,1,1,1,4,4,1,1,3,4,1.4290224851827542,0,1,2,3,2,1.2,0,2,5,4,4,1,1,5,5,1,1,4,2,1,3,3,5,5,1,1,5,5,5,5,1,2,0,0,3,1,4,2,2,4,1,1,1,4,4,5,1,2,1,5,1,5,5,5,5,4,1,1,1,2,1,1,2,1,1,5,1,1,1,1,3,1,1,1,1,1.6407901121691928,1.61245154965971,4,0,1,0,2.4,0,3.888888888888889,0,3.25,0,1.1666666666666667,0,1,0,1.6666666666666667,0,2.5675675675675675,0,1,0,0,0.9961804725433192,-0.5341482934814965,0.23101608953091135,5,1,4,1,1,3,1,1,1,1.7043362064926932,1.4285714285714286,0,1,-0.6467170085812028,5,5,5,5,4,4,1,6,7,5,3,1.4638501094227998,4.714285714285714,0,1.2857142857142858,2.5,3.8333333333333335,3.2559414990859232,-1.0219528370065065,0,-1.1640989613502233,1,1,1,1,1,1,5,1,1,3,1,5,1,2,3,1,4,2,4,3,1.505545305418162,1,0,4.6,0,4.4,0,3.6,0,4.2,0,1,4,3,3,2,3,3,2,1,3,3,3,2,2,1,3,2,3,3,3,0.8271701918685112,2.4,0,"White, Caucasian, Anglo, European American",0,24,1,2,NA,1,2,6,student,1,0,112,62,3,5,2,0,0,1,0,0,TRUE,TRUE,TRUE,TRUE,TRUE,4,0.8908052631571497,0.76,0.04793731435101328,4,0.5149322580647084,0.5807354838699103,1,0.96875,0.00627367492478991,0.016728959344628737,4,0.7609281249996275,0.8393741935486755,1,1,0.028304207248132526,0.023993796645355715,1.4882,0.8413,0.4275,0,30.0247,0.004,ML,change,50,-48.31333098371556,1.045826720708906,1.1021706436770424,0.6167977610713496,1.1531,3.1443,0.4055,4.0032,0.3709,0,-64.4622,0.009,ML,cueing,63,141.35380417917457,2.9416675206179876,1.1673607504643257,0.39471842111728606,4.082554503721017,1.0148388031599578,0.3945266284931808,0.276,0.209,0.501,0.017,1.378,22.34492858416615,1823.6235623694859,0.278,0.211,0.512,0.016,1.494,32.285296135219326,1813.9837034709324,370,1.0962962962962963,1,0,0,1,FALSE,FALSE,FALSE
270,2021-11-13T02:35:08Z,2021-11-13T03:03:38Z,1710,1,2021-11-13T03:03:40Z,1,Edge,95.0.1020.44,Windows NT 10.0,1536,864,NA,1.7777777777777777,708,97,394,118,71,151,-0.20863072294706814,0.06537025594275213,-0.1612990139192677,0.16352508950617864,-0.013054542654933752,0.7706415884531067,2,1,2,2,1,1,3,1,1,2,1,2,1,2,1,1,3,1,1,1,0.6882472016116853,0,1,1,4,4,2.8,0,4,4,2,4,2,2,4,1,2,2,2,5,2,4,5,1,2,1,1,1,2,2,2,0,2,0,1,5,5,4,5,5,4,5,5,5,3,4,1,1,3,3,5,2,2,3,1,3,4,2,1,1,2,2,1,1,1,1,4,2,2,1,3,1,2,1,3,2,1.548029843509613,1.3093073414159542,1.5,0,2,0,1.8,0,1.2222222222222223,0,2.0833333333333335,0,1.5,0,1.2857142857142858,0,1.6666666666666667,0,1.6486486486486487,0,0,0,1,-0.7309442553393755,-0.24718630950986772,-0.4890652824246216,2,4,2,3,2,4,3,3,2,0.8997354108424374,3.4285714285714284,0,2.5,1.1033050957523902,3,3,3,3,2,2,2,2,2,2,2,0.5345224838248488,2.857142857142857,0,3.142857142857143,7,3.8333333333333335,3.2559414990859232,1.5194825076544112,0,1.1423416774589132,3,2,3,3,3,3,5,3,2,3,2,3,2,4,4,4,3,3,4,3,0.8618916073713346,2.8,0,3.2,0,3.6,0,3.6,0,3.466666666666667,0,2,2,4,1,2,4,4,1,4,3,1,1,3,4,3,1,1,4,2,3,1.2354415362426845,3.1,0,"Asian or Asian American (e.g., Chinese, Japanese, and others)",0,21,0,1,NA,1,1,4,Student (& freelance graphic designer in free time),1,0,170,70,2,5,2,0,0,1,0,0,TRUE,TRUE,TRUE,TRUE,TRUE,1,1.061034782609214,0.92,0.31183377546545776,1,0.39748620689737385,0.46272333333492277,0.9666666666666667,0.9375,0.0051121577472106996,0.00610752499990271,1,0.5385250000013039,0.6537483870983124,1,0.96875,0.006733638710104314,0.008940974182908139,1.8465,1.2015,0.4645,0,35.1955,0.003,ML,change,50,-58.654930983715566,1.171207533992586,2.0853238768396323,0.3132287765404467,1.0272,3.3746,0.3256,3.1902,0.245,0,-62.5397,0.007,ML,cueing,62,137.4608031551353,3.334501088915378,0.8121305493359622,0.35616852772529106,3.9191331258022672,0.8591940416153051,0.2951785774931296,0.099,0.335,0.473,0.011,1.63,32.879148489380746,1859.3435282610146,0.099,0.335,0.513,0.011,1.709,25.88466889758682,1849.4445813386453,380,1.125925925925926,1,0,0,1,FALSE,FALSE,FALSE
271,2021-11-13T02:41:54Z,2021-11-13T03:05:05Z,1390,1,2021-11-13T03:05:08Z,1,Firefox,94.0,Windows NT 10.0,1536,864,N/A,1.7777777777777777,618,65,377,126,46,82,-0.4398737545276735,-0.22534137007908028,-0.24314107920192551,0.26101634177852706,-0.3583560335760547,-0.39486271804575546,4,4,1,1,4,1,1,3,1,3,4,1,1,1,4,4,1,2,3,3,1.348488432516786,0,1,1,5,3,1.25,0,5,5,4,4,5,5,3,3,2,4,3,2,3,2,1,1,2,3,1,1,1,1,1,1,2,0,0,4,2,4,2,1,4,3,3,3,2,5,1,1,3,1,5,3,1,2,1,1,3,1,1,1,1,1,1,2,2,2,3,4,2,1,1,1,2,2,1,1,1.2508255532105843,1.2983506020002016,1.375,0,1.5,0,3.2666666666666666,0,3.111111111111111,0,1.5,0,1.1666666666666667,0,2.142857142857143,0,1,0,1.972972972972973,0,1,0,0,-0.014986980504792623,-0.3773458880470143,-0.19616643427590347,4,1,3,1,1,1,1,1,1,1.2535663410560174,1.4285714285714286,0,1,-0.6467170085812028,3,3,3,5,2,3,4,2,3,4,2,0.9511897312113419,3,0,3,6.5,3.8333333333333335,3.2559414990859232,1.237100802692087,0,0.9214798275563144,2,3,3,3,3,3,2,4,2,4,2,4,4,5,4,2,3,2,4,5,1.1126972805283737,2.8,0,3.6,0,3.2,0,3.2,0,3.3333333333333335,0,2,1,1,4,1,1,1,4,1,1,1,4,2,1,1,4,1,1,1,1,1.2182817926554552,1.1,0,"White, Caucasian, Anglo, European American",0,29,0,1,NA,1,2,3,Electrician,6,0,215,75,3,5,2,0,0,0,0,0,TRUE,TRUE,TRUE,TRUE,TRUE,3,0.6725641025641026,0.78,0.017191257551020408,3,0.469,0.498,0.90625,1,0.0073151250000000004,0.004360193548387095,3,0.56921875,0.6542142857142857,1,0.875,0.005265595766129034,0.009644000000000002,1.055,1.295,0.4647,0,-6.1774,0.004,ML,change,50,24.090869016284437,1.4664354466671639,0.8630904116562478,0.5077663163315116,1.1873,3.9534,0.3478,2.7045,0.2828,0,-59.014,0.007,ML,cueing,64,130.504649250079,4.471323090080983,0.9266015098713195,0.397621969313832,2.85257962696298,0.7953094524950158,0.3557360398909933,0.065,0.407,0.398,0.015,1.783,138.72986493317046,2056.6417215544034,0.065,0.407,0.399,0.014,1.831,175.91533165967516,2073.1145524364906,395,1.1703703703703703,1,0,0,1,FALSE,FALSE,FALSE
272,2021-11-13T02:36:32Z,2021-11-13T03:05:48Z,1755,1,2021-11-13T03:05:49Z,1,Chrome,95.0.4638.69,Macintosh,1440,900,NA,1.6,658,74,574,107,109,75,-0.3370990738251822,-0.14357872526043994,0.7052640302500502,0.02947461763169954,0.5118037235451701,-0.513102285371727,2,3,3,3,1,1,2,2,1,2,3,3,3,3,2,3,2,1,2,1,0.812727700887249,0,1,2,3,4,2.55,0,3,2,5,3,5,3,4,4,2,1,4,1,1,2,1,5,4,5,2,3,4,4,3,3,1,1,3,2,3,5,4,3,4,2,4,2,3,5,2,1,4,2,3,5,2,2,3,5,1,3,3,5,3,2,1,3,1,1,2,4,4,2,4,1,4,2,1,1,1.2944789205219511,1.4375905768565218,3.75,0,2,0,3.4,0,2.7777777777777777,0,2.5833333333333335,0,3.3333333333333335,0,2.4285714285714284,0,2.3333333333333335,0,2.7567567567567566,0,2,1,3,1.3997956998057508,0.7185311394745503,1.0591634196401505,5,1,4,1,1,1,1,1,1,1.7320508075688772,1.1428571428571428,0,1,-0.8176513788914915,2,3,4,4,3,3,4,6,6,NA,3,0.7559289460184544,3,0,3,3,3.8333333333333335,3.2559414990859232,-0.7395711320441822,0,-0.0668561398118202,1,2,2,3,3,1,5,2,2,4,1,5,3,5,5,3,5,1,3,2,1.5976172734359604,2.2,0,5,0,3.6,0,4.4,0,4.333333333333333,0,2,3,3,4,4,2,4,3,1,2,2,3,3,2,2,2,2,2,1,3,0.8885233166386386,2.3,0,"White, Caucasian, Anglo, European American",0,26,1,2,NA,1,3,6,consultant,4,0,168,65,1,5,2,0,1,1,0,1,TRUE,TRUE,TRUE,TRUE,TRUE,5,1.1270463414637417,0.8367346938775511,0.13821157710891285,5,0.4669562499998137,0.5492419354826693,1,0.96875,0.0012484289919824391,0.004857595967768703,5,0.6350562500006054,0.6878451612901784,1,0.96875,0.009669316733809294,0.014831435766100942,1.9942,0.9407,0.4376,0,44.032,0.004,ML,change,49,-76.38853910566812,1.0762947790726443,1.518292717569874,0.6520260743321671,1.3767,4.2271,0.3937,6.4458,0.3602,0,-91.3561,0.008,ML,cueing,64,195.18884925007902,4.007333338754266,0.8569257693827508,0.4490047152560551,6.112537450005837,0.6778092993749391,0.41324469697130467,0.074,0.458,0.402,0.012,0.975,50.59955929135917,1886.0820327826127,0.074,0.457,0.398,0.012,1.026,70.08762277086304,1895.472644871791,440,1.3037037037037038,1,0,0,1,FALSE,FALSE,FALSE
273,2021-11-13T02:46:00Z,2021-11-13T03:06:13Z,1212,1,2021-11-13T03:06:13Z,1,Chrome,95.0.4638.69,Macintosh,1440,900,NA,1.6,611,45,309,75,56,67,-0.4578593236506095,-0.40703613634272556,-0.5705093403325567,-0.3604903914576942,-0.22023543720760635,-0.6482332194585516,2,2,2,2,2,1,2,2,1,3,2,1,1,2,2,2,2,1,2,2,0.5231483637805969,0,1,1,4,3,2.2,0,3,4,2,4,2,2,3,2,2,2,5,3,2,3,2,3,5,5,1,2,4,3,4,1,2,0,1,5,1,4,4,4,5,5,5,5,3,5,3,1,3,2,4,1,4,5,5,5,1,3,1,2,2,1,2,5,5,1,5,1,1,1,1,3,2,3,3,3,1.672961087054567,0.9611501047232549,3.375,0,2.75,0,2.6,0,1.7777777777777777,0,2.9166666666666665,0,2.1666666666666665,0,2.142857142857143,0,1.6666666666666667,0,2.324324324324324,0,1,0,1,0.7090038827860924,0.191109772438372,0.4500568276122322,5,1,4,1,1,1,1,1,1,1.7320508075688772,1.1428571428571428,0,1,-0.8176513788914915,5,5,5,5,4,4,4,6,6,NA,4,0.5345224838248488,4.285714285714286,0,1.7142857142857142,3,3.8333333333333335,3.2559414990859232,-0.7395711320441822,0,-0.783895116604751,1,3,3,3,3,1,5,1,1,4,1,5,2,5,5,1,5,5,5,3,1.869555587629877,2.6,0,4.2,0,4.6,0,4.6,0,4.466666666666667,0,2,2,3,3,3,3,2,3,3,3,2,1,2,3,1,2,2,3,1,4,0.8207826816681233,2.5,0,"White, Caucasian, Anglo, European American",0,27,1,2,NA,1,3,6,Teacher,2,0,125,65,2,5,2,0,0,1,0,0,TRUE,TRUE,TRUE,TRUE,TRUE,5,0.7378418604592945,0.86,0.01741979836725439,5,0.4327933333237966,0.5247781250067055,0.9375,1,0.0027255496679670075,0.005242350151118996,5,0.5665967741935484,0.6326862068895636,0.96875,0.90625,0.0077557844748360975,0.005186309989144534,1.2076,1.6315,0.4737,0,-5.3553,0.005,ML,change,50,22.44666901628444,1.9593773469815658,0.9264626690896042,0.5676211720421004,1.232,4.1067,0.3748,3.5999,0.2759,0,-69.685,0.01,ML,cueing,64,151.84664925007903,4.270030607338154,0.9702822081114483,0.4147132360697715,4.079750945635532,0.663778313232392,0.3616117793738328,0.048,0.455,0.399,0.019,1.608,64.59728065910971,2012.225048677332,0.049,0.453,0.411,0.018,1.725,83.48251895739729,2009.356933363122,372,1.1022222222222222,1,0,0,1,FALSE,FALSE,FALSE
275,2021-11-13T02:44:13Z,2021-11-13T03:07:13Z,1379,1,2021-11-13T03:07:14Z,1,Chrome,95.0.4638.69,Windows NT 10.0,1920,1080,NA,1.7777777777777777,673,69,324,83,87,96,-0.298558568561748,-0.18900241682635124,-0.49829575331844694,-0.26299913918534573,0.20793841153458367,-0.15838358339381242,3,3,2,1,3,1,1,3,1,3,3,1,1,3,3,3,2,2,3,3,0.910465468000326,0,1,1,3,4,1.75,0,2,4,4,3,3,4,2,4,3,3,3,1,3,2,2,3,4,1,2,2,3,3,3,5,2,0,5,1,1,1,1,1,1,1,3,3,2,3,2,1,3,2,4,4,4,4,5,5,2,4,1,1,4,3,1,4,3,3,4,3,3,1,4,3,4,4,4,4,1.322024110123468,0.9154754164341269,2.625,0,4,0,3.533333333333333,0,4.555555555555555,0,3.0833333333333335,0,2.6666666666666665,0,2.5714285714285716,0,2.6666666666666665,0,3.2972972972972974,0,3,0,5,1.2059248844084727,1.6950993212143333,1.450512102811403,1,4,1,3,4,4,4,3,2,1.4142135623730951,4.142857142857143,0,2.5,1.5306410215281119,3,3,4,2,1,1,3,4,4,2,2,1.1338934190276817,2.4285714285714284,0,3.5714285714285716,5,3.8333333333333335,3.2559414990859232,0.38995568780511447,0,0.8165912597985752,3,2,2,2,3,2,3,3,2,3,1,3,2,3,4,5,4,2,3,4,1.0327955589886444,2.4,0,4,0,2.8,0,3.2,0,3.3333333333333335,0,1,1,1,4,3,2,2,3,1,1,1,4,1,2,1,4,1,2,1,2,1.1192102478745307,1.4,0,"White, Caucasian, Anglo, European American",0,19,0,1,NA,1,3,4,student,4,0,190,70,3,5,2,0,0,1,0,0,TRUE,TRUE,TRUE,TRUE,TRUE,4,0.8944771428627627,0.7142857142857143,0.17088587677776026,4,0.5162466666738192,0.598018750003539,0.967741935483871,1,0.006613907612675412,0.006431478346734297,4,0.6844366666734218,0.7317666666726271,0.967741935483871,0.967741935483871,0.021376807461679435,0.025570173784610455,1.4239,0.6651,0.464,0,32.9896,0.004,ML,change,49,-54.30373910566813,0.6184764088920554,1.4815289939928464,0.38116653934035416,1.1584,4.6757,0.4741,3.302,0.3481,0,-73.1498,0.007,ML,cueing,63,158.72900417917458,4.0572782366436835,1.0211611047456466,0.476108227416273,3.6926662692549925,0.9210681750420839,0.3995769815485233,0.081,0.455,0.355,0.039,1.337,148.32913746387254,2121.0925113005123,0.08,0.456,0.344,0.018,1.426,187.2874005611813,2063.9936733142376,104,0.3081481481481481,1,0,0,1,FALSE,FALSE,FALSE
276,2021-11-13T02:43:34Z,2021-11-13T03:08:11Z,1476,1,2021-11-13T03:08:12Z,0.800000011920929,Firefox,94.0,Windows NT 10.0,1920,1080,Nothing I can think of!,1.7777777777777777,710,68,390,88,87,70,-0.20349198891194356,-0.1980871551395335,-0.18055597045636368,-0.202067106515128,0.20793841153458367,-0.5975591191759924,3,3,2,2,3,1,2,2,1,2,1,1,1,2,2,2,2,1,2,1,0.6958523739384593,0,1,1,3,3,2.2,0,5,3,3,3,3,3,5,2,1,1,1,4,2,4,3,2,1,3,1,1,1,2,1,2,1,1,1,5,2,5,5,5,5,3,3,5,3,5,1,1,5,3,5,5,4,3,3,5,1,1,3,1,3,3,1,2,2,1,3,4,2,2,4,1,2,1,1,1,1.5235883044055312,1.3020130933435712,1.5,0,1.25,0,2.066666666666667,0,1.7777777777777777,0,2.5833333333333335,0,2.5,0,2,0,2.3333333333333335,0,2.2972972972972974,0,1,1,1,-0.337588791647643,-0.07266423627205096,-0.205126513959847,4,2,1,1,1,2,1,1,1,1.1126972805283737,2,0,1,-0.3048482679606258,3,3,4,2,1,1,4,3,1,2,2,1.2724180205607036,2.2857142857142856,0,3.7142857142857144,7,3.8333333333333335,3.2559414990859232,1.5194825076544112,0,1.4610256671446602,2,3,4,3,4,3,5,1,2,2,1,4,4,4,5,4,5,2,4,4,1.3972762620115438,3.2,0,4.2,0,3,0,4,0,3.7333333333333334,0,2,1,4,1,4,4,4,1,4,3,1,1,3,3,2,1,1,4,1,2,1.3088765773505315,2.95,0,"Hispanic of Latino (e.g., Mexican American, Central American, and others) & White, Caucasian, Anglo, European American",1,22,0,1,NA,1,3,3,Student,3,0,215,68,1,5,2,0,0,1,0,0,TRUE,TRUE,TRUE,TRUE,TRUE,3,0.7314285714285714,0.84,0.0388761506122449,3,0.49023333333333335,0.5291612903225806,0.967741935483871,0.96875,0.004465873118279571,0.0033828225806451615,3,0.54996875,0.6052666666666666,1,0.9375,0.007613837701612904,0.005451290322580643,1.1813,1.4582,0.4663,0,-0.8056,0.004,ML,change,50,13.347269016284438,1.4950686380305087,1.109131737782927,0.4791961445996837,1.2946,4.2562,0.3833,3.3401,0.3049,0,-64.5223,0.008,ML,cueing,63,141.47400417917459,4.386731079794435,0.7828123361156811,0.44551283413059073,4.073596373839582,0.834937256794626,0.39436345996818895,0.088,0.338,0.454,0.013,1.676,204.6749456671466,2125.3626853674773,0.089,0.34,0.448,0.016,1.701,239.33606250734144,2114.1826879317146,314,0.9303703703703704,1,0,0,1,FALSE,FALSE,FALSE
277,2021-11-13T02:46:06Z,2021-11-13T03:08:15Z,1329,1,2021-11-13T03:08:16Z,1,Chrome,93.0.4577.82,Macintosh,1280,800,NA,1.6,646,68,348,76,58,87,-0.3679314780359296,-0.1980871551395335,-0.3827540140958712,-0.3483039849236506,-0.19261131793391667,-0.31040588424149007,2,2,3,3,2,1,2,2,1,2,2,1,1,1,2,2,2,2,1,1,0.6386663736585051,0,0,2,3,2,2.45,0,2,4,3,3,2,1,4,2,2,1,1,4,3,4,3,2,3,1,1,1,1,1,1,0,2,0,0,4,4,3,4,5,4,4,4,4,2,4,2,2,3,3,4,1,1,1,1,1,4,1,1,1,1,1,1,1,1,1,5,2,2,1,1,1,2,2,1,2,1.4347677716475786,1.121223821162776,1.375,0,1.75,0,2.2,0,2,0,1.75,0,1,0,1.1428571428571428,0,1,0,1.5675675675675675,0,0,0,0,-0.6476078738830316,-0.5020371591262895,-0.5748225165046605,5,1,3,1,1,1,1,3,1,1.5735915849388864,1.2857142857142858,0,2,-0.3631965189619651,4,4,4,4,3,3,3,5,6,2,3,0.5345224838248488,3.5714285714285716,0,2.4285714285714284,3.5,3.8333333333333335,3.2559414990859232,-0.4571894270818581,0,-0.24434927701640521,1,1,1,2,1,1,4,1,1,1,1,3,3,4,4,3,4,2,3,3,1.245945806357946,1.2,0,4.2,0,2.8,0,4.2,0,3.7333333333333334,0,2,2,2,1,3,3,3,2,2,2,2,2,2,2,1,2,3,3,1,2,0.6407232755171874,2.4,0,"White, Caucasian, Anglo, European American",0,27,1,2,NA,1,3,7,school counselor,2,0,130,64,1,5,2,0,0,1,0,0,TRUE,TRUE,TRUE,TRUE,TRUE,2,0.975070731707099,0.82,0.02978663339148163,2,0.5433903225794915,0.6387766666650772,1,0.967741935483871,0.00963447490319328,0.012553527312115861,2,0.6326451612908033,0.7581166666671634,0.96875,0.9375,0.012641774838886564,0.01800265032263755,1.325,1.2497,0.6312,0,10.4509,0.005,ML,change,50,-9.165730983715564,1.48755676995131,1.0193543668371867,0.7557894215903923,1.9119,2.9274,0.3252,4.6315,0.337,0,-45.95,0.006,ML,cueing,62,104.28140315513528,3.1460320845958396,1.0811070231342212,0.4780411503485073,3.667376366180683,1.129727170791123,0.3941796761353053,0.065,0.46,0.349,0.012,1.405,114.33993814492547,2007.9022752867074,0.064,0.461,0.355,0.01,1.526,117.1475576236989,2006.5063586588317,404,1.1970370370370371,1,0,0,1,FALSE,FALSE,FALSE
278,2021-11-13T02:39:07Z,2021-11-13T03:10:09Z,1861,1,2021-11-13T03:10:10Z,0.8999999761581421,Chrome,95.0.4638.54,Windows NT 10.0,1366,768,no feedback,1.7786458333333333,778,67,537,99,71,138,-0.028775031717708392,-0.20717189345271578,0.5271371822819126,-0.06801663464064889,-0.013054542654933752,0.5510538205620167,4,3,1,1,3,1,1,2,1,4,2,1,1,1,4,3,1,1,3,2,1.1697953037312037,0,1,1,1,1,1.5,0,3,4,2,4,2,3,2,2,1,4,4,3,1,3,1,2,2,1,1,1,1,3,1,6,2,0,0,4,1,4,2,2,2,1,1,2,1,2,1,1,2,1,1,1,1,1,1,1,3,1,5,1,1,1,1,5,5,5,4,1,1,1,1,1,2,2,3,3,1.4099602788688723,1.121223821162776,1.5,0,2.5,0,2.7333333333333334,0,3.888888888888889,0,1.8333333333333333,0,1.8333333333333333,0,2.7142857142857144,0,1,0,2.4864864864864864,0,3,0,0,0.03021405333970467,0.3424438704149829,0.1863289618773438,5,1,4,1,1,1,1,3,3,1.7320508075688772,1.1428571428571428,0,3,-0.07967602934272733,4,4,4,5,2,2,2,1,6,2,2,1.2535663410560174,3.5714285714285716,0,2.4285714285714284,5.5,3.8333333333333335,3.2559414990859232,0.6723373927674386,0,0.32041413290824317,2,2,2,2,2,2,5,2,1,3,1,2,1,4,5,1,5,1,3,2,1.5522640914238175,2,0,4.2,0,4.2,0,4.4,0,4.266666666666667,0,1,1,2,1,1,3,2,1,3,1,4,2,1,2,1,2,1,2,2,2,0.8506963092234007,2.15,0,"Black or African American & White, Caucasian, Anglo, European American",1,24,1,2,NA,0,3,6,unemployed,5,0,173,63,2,5,2,0,0,0,0,0,TRUE,TRUE,TRUE,TRUE,TRUE,3,1.0605499999962356,0.7755102040816326,0.13822577067996816,3,0.5886000000238418,0.6729548386758374,1,0.96875,0.0034208774232464445,0.01700752902701901,3,0.6361483871013888,0.7476531250178814,0.96875,1,0.008096902168713511,0.011847811596346708,1.6135,0.8323,0.5207,0,35.6085,0.004,ML,change,49,-59.54153910566812,0.8553652094429091,1.4493117948243577,0.593731635206725,1.3992,2.6512,0.4191,5.7656,0.4673,0,-65.6988,0.016,ML,cueing,64,143.87424925007903,2.929547280997651,1.1721904018274487,0.4853953975223573,4.750924361419746,0.872069183007034,0.49968919480260243,0.224,0.281,0.644,0.013,1.571,123.8243174584084,1960.9346023074152,0.226,0.283,0.645,0.014,1.686,141.0063794067136,1968.7804588085437,111,0.32888888888888884,1,0,0,1,FALSE,FALSE,FALSE
279,2021-11-13T02:49:16Z,2021-11-13T03:10:56Z,1299,1,2021-11-13T03:10:57Z,1,Chrome,95.0.4638.69,Macintosh,2048,1152,NA,1.7777777777777777,602,80,393,64,52,73,-0.48098362680867,-0.08907029538134635,-0.1661132530535417,-0.4945408633321733,-0.2754836757549857,-0.5468850188934331,2,4,2,2,3,1,1,2,1,4,3,1,1,1,3,3,1,1,3,3,1.0711528467275955,0,1,1,5,5,1.6,0,4,4,2,5,2,1,4,2,2,1,1,5,3,4,3,1,2,4,3,2,1,2,2,0,1,4,1,5,4,2,3,3,4,4,4,4,2,4,2,1,4,2,5,2,3,1,1,2,2,3,5,4,4,3,2,1,1,1,4,2,2,1,2,1,2,2,1,1,1.3094711584127063,1.4074631010979937,2.125,0,1.5,0,1.8,0,2.3333333333333335,0,1.75,0,3.6666666666666665,0,1.4285714285714286,0,1.3333333333333333,0,2.1621621621621623,0,0,4,1,-0.24166968128383745,0.42254411542774484,0.0904372170719537,5,1,4,1,1,2,2,1,1,1.6035674514745464,1.4285714285714286,0,1,-0.6467170085812028,5,5,5,5,3,3,2,6,6,2,3,1.2909944487358056,4.285714285714286,0,1.7142857142857142,3,3.8333333333333335,3.2559414990859232,-0.7395711320441822,0,-0.783895116604751,2,2,2,2,2,2,3,3,2,3,2,4,1,3,3,3,3,2,3,3,0.7237468644557459,2,0,3.8,0,3.4,0,3.2,0,3.466666666666667,0,1,2,1,1,1,1,1,3,1,1,1,4,1,2,1,3,1,1,1,1,0.8870412083230169,1.35,0,"White, Caucasian, Anglo, European American",0,18,1,2,NA,1,3,3,Student,3,0,160,62,2,5,2,0,0,0,0,0,TRUE,TRUE,TRUE,TRUE,TRUE,3,0.6414552631582084,0.76,0.023195661616318725,3,0.43176774193682976,0.48738620689639756,1,0.9354838709677419,0.003844414258025525,0.005630439591432899,3,0.677881249998929,0.6900937499993015,1,1,0.014439768024078512,0.01088006834680769,0.9974,1.1923,0.4303,0,-6.2673,0.004,ML,change,50,24.270669016284437,1.253939165993303,0.9192467555037209,0.45085259046663395,1.235,3.0844,0.3123,4.8032,0.3032,0,-68.1719,0.009,ML,cueing,62,148.72520315513526,3.377797810897137,0.7916840495305664,0.3853180388844646,4.614290678470363,0.8978920087810726,0.3375135061162319,0.124,0.412,0.462,0.138,1.507,10.172991267587363,1796.1553203952121,0.129,0.407,0.479,0.181,1.553,17.111233831225526,1797.280752783509,366,1.0844444444444443,1,0,0,1,FALSE,FALSE,FALSE
280,2021-11-13T02:44:11Z,2021-11-13T03:11:59Z,1667,1,2021-11-13T03:11:59Z,1,Chrome,95.0.4638.69,Windows NT 10.0,1366,768,no,1.7786458333333333,1010,55,356,67,41,80,0.567318116356741,-0.31618875321090295,-0.3442401010216793,-0.45798164373004263,-0.42741633176027893,-0.4286454515674616,1,1,4,4,1,4,4,1,4,1,1,4,4,4,1,1,4,4,1,1,1.538967528127731,0,1,2,4,1,4,0,5,5,5,5,5,1,1,1,1,1,1,5,2,5,5,4,4,5,1,1,4,4,2,3,1,0,0,5,5,5,5,5,5,5,5,5,1,5,3,1,5,1,5,2,1,1,1,5,1,1,5,5,5,5,1,5,5,1,5,2,1,1,5,1,4,4,4,4,1.9199443185119163,2.007130147392398,3.125,0,4,0,1.8666666666666667,0,1,0,1.5833333333333333,0,4.166666666666667,0,2.142857142857143,0,2.3333333333333335,0,2.081081081081081,0,2,0,0,0.18188433178580324,0.6097586129219131,0.3958214723538582,5,1,4,1,1,1,1,3,1,1.7320508075688772,1.1428571428571428,0,2,-0.44866370411710943,4,4,4,4,2,2,2,4,6,NA,3,1.0690449676496976,3.4285714285714284,0,2.5714285714285716,4,3.8333333333333335,3.2559414990859232,-0.1748077221195339,0,-0.023487427113806164,4,4,4,2,4,2,5,3,3,4,1,2,1,5,1,1,3,1,3,5,1.5430334996209192,3.6,0,3.8,0,4.4,0,2.6,0,3.6,0,4,1,4,1,4,4,4,1,4,4,3,1,4,4,4,2,2,4,4,4,1.268027892769755,3.65,0,"White, Caucasian, Anglo, European American",0,26,1,2,NA,1,4,6,healthcare,7,0,124,64,5,5,1,0,0,0,1,0,TRUE,TRUE,TRUE,TRUE,TRUE,NA,NA,NA,NA,5,1.1882241379310345,0.9971464285850525,0.9354838709677419,0.9655172413793104,0.9122925369441564,0.38038443605742217,5,0.8582482758554919,1.1416249999801318,0.9354838709677419,0.8275862068965517,0.3639301471614663,0.40154075891646623,NA,NA,NA,NA,NA,NA,NA,NA,NA,NA,NA,NA,NA,2.2564,1.5675,0.3103,0.9482,0.1474,0,51.6692,0.006,ML,cueing,60,-91.05536631333369,1.3275610732534482,2.510019747723535,0.11699297100865713,0.9467508314642725,2.8245537902413154,-0.111006427759061,0.076,0.383,0.153,0.011,1.991,151.49883183730637,2109.0076116759137,0.077,0.373,0.15,0.008,2.102,152.2446967860907,2098.230845087732,104,0.3081481481481481,1,0,0,1,FALSE,FALSE,FALSE
281,2021-11-13T02:52:04Z,2021-11-13T03:12:18Z,1213,1,2021-11-13T03:12:19Z,1,Chrome,95.0.4638.69,Macintosh,1440,900,NA,1.6,607,47,288,86,62,75,-0.4681367917208586,-0.38886665971636103,-0.6716083621523106,-0.2264399195832151,-0.1373630793865373,-0.513102285371727,2,2,3,2,2,1,1,2,1,2,2,1,1,3,2,2,1,1,2,2,0.6386663736585051,0,1,2,1,4,2.25,0,2,4,3,4,4,3,2,3,1,3,1,4,2,3,2,3,2,1,1,2,2,3,1,1,2,0,0,3,2,3,4,3,3,2,3,3,4,3,3,3,3,2,4,3,3,3,3,3,4,1,1,1,1,1,3,1,1,1,3,2,2,1,1,1,1,1,1,1,1.0368582714503825,1.0327955589886444,1.875,0,1,0,2.7333333333333334,0,3.111111111111111,0,2.9166666666666665,0,1,0,1.7142857142857142,0,1,0,2.324324324324324,0,1,0,0,0.12168081347471636,-0.5341482934814965,-0.20623374000339006,5,2,4,1,1,2,1,1,3,1.6035674514745464,1.4285714285714286,0,2,-0.2777293338068208,5,5,5,5,5,5,1,8,8,6,4,1.5118578920369088,5,0,1,1,3.8333333333333335,3.2559414990859232,-1.869097951893479,0,-1.747013513636583,2,3,4,4,3,4,3,4,4,4,1,3,2,2,3,3,4,2,3,2,0.9611501047232549,3.2,0,3.6,0,3.4,0,2.6,0,3.2,0,2,2,3,4,4,3,2,2,2,1,3,2,3,3,1,2,1,2,1,3,0.9233805168766387,2.3,0,"White, Caucasian, Anglo, European American",0,28,1,2,NA,1,2,6,student,2,0,140,64,2,5,2,0,0,1,0,0,TRUE,TRUE,TRUE,TRUE,TRUE,4,0.7691555555562178,0.72,0.03290322289370864,4,0.4511903225789147,0.5393124999990687,1,1,0.004851032903262608,0.005739908225766081,4,0.6309687499990687,0.6910258064491134,1,1,0.007231995121104177,0.0148101079784366,1.149,0.8646,0.5096,0,10.3014,0.004,ML,change,50,-8.866730983715561,0.9600562998701077,0.9837564827902632,0.5437245821402426,2.1711,5.6653,0.3477,6.3918,0.2814,0,-84.3027,0.011,ML,cueing,63,181.0348041791746,4.174324984080681,0.9925280715305835,0.4241427931647782,4.353654281610919,0.9516453210103097,0.34531301295620187,0.293,0.225,0.726,0.023,1.387,129.59510123658612,1957.8892469581224,0.299,0.213,0.715,0.023,1.452,160.523747768677,1944.7798428347637,404,1.1970370370370371,1,0,0,1,FALSE,FALSE,FALSE
284,2021-11-13T02:51:27Z,2021-11-13T03:13:24Z,1317,1,2021-11-13T03:13:25Z,1,Chrome,95.0.4638.69,Windows NT 10.0,2560,1440,None,1.7777777777777777,595,78,388,91,49,71,-0.498969195931606,-0.10723977200771087,-0.19018444872491164,-0.1655078869129973,-0.31691985466552025,-0.5806677524151392,3,2,2,2,3,2,3,2,1,2,1,1,2,2,2,1,2,1,2,1,0.6708203932499369,0,0,1,3,2,2.45,0,4,4,2,4,2,2,4,2,2,2,2,4,2,4,4,2,2,1,1,2,2,2,2,0,2,0,0,4,4,3,4,3,5,5,5,4,1,4,2,2,4,2,4,2,2,2,2,2,4,2,1,1,2,1,3,1,1,1,4,2,2,1,1,1,1,1,1,2,1.34566370643293,1.0327955589886444,1.75,0,1.25,0,2,0,1.8888888888888888,0,1.9166666666666667,0,1.3333333333333333,0,1.5714285714285714,0,1,0,1.7297297297297298,0,0,0,0,-0.5027129110024894,-0.6588395645607719,-0.5807762377816306,5,1,3,2,1,1,2,1,3,1.4638501094227998,1.5714285714285714,0,2,-0.19226214865167657,4,4,4,4,2,2,2,5,3,3,3,1.0690449676496976,3.4285714285714284,0,2.5714285714285716,5,3.8333333333333335,3.2559414990859232,0.38995568780511447,0,0.25889427784851804,2,2,3,4,3,2,4,3,3,2,3,3,3,3,3,4,3,3,3,3,0.5345224838248488,2.8,0,3.2,0,2.8,0,3,0,3,0,2,4,4,1,3,4,4,1,4,1,2,1,2,4,2,1,1,4,3,4,1.3138933706635727,3.2,0,"White, Caucasian, Anglo, European American",0,19,0,1,NA,1,2,3,None,1,0,170,68,2,5,2,0,0,1,0,0,TRUE,TRUE,TRUE,TRUE,TRUE,5,0.6253486486383386,0.74,0.025095121677862344,5,0.36679677418739565,0.4346333333015442,0.96875,0.9375,0.0034148141870159092,0.006638638669195907,5,0.49744062502682207,0.5514777778519524,1,0.84375,0.005953167644715058,0.008653174674274768,1.0477,1.0425,0.392,0,-0.2757,0.004,ML,change,50,12.287469016284437,1.1273689957870328,0.9277960978982589,0.4278347340924341,1.1639,2.5754,0.2305,4.4039,0.2445,0,-61.0655,0.009,ML,cueing,64,134.60764925007902,3.2657085185008956,0.8292381839225886,0.32354206370082983,4.376420539263163,0.7846565871988412,0.2827537138942496,0.051,0.364,0.347,0.014,1.392,120.18603779427012,2038.7958366847986,0.05,0.365,0.379,0.009,1.403,135.58596079967197,2037.5607145383008,420,1.2444444444444445,1,0,0,1,FALSE,FALSE,FALSE
285,2021-11-13T02:43:39Z,2021-11-13T03:14:31Z,1851,1,2021-11-13T03:14:33Z,1,Chrome,95.0.4638.69,Windows NT 10.0,1536,864,NA,1.7777777777777777,645,50,271,63,60,107,-0.3705008450534919,-0.36161244477681426,-0.7534504274349684,-0.5067272698662169,-0.16498719866022699,0.02742145097557139,4,3,2,2,3,1,2,4,1,3,3,1,1,1,4,3,2,1,3,2,1.0809352675491624,1,1,1,4,1,1.6,0,3,5,3,4,1,2,4,2,1,1,3,4,2,3,3,1,1,1,1,1,1,2,2,0,2,0,0,5,5,5,5,5,5,5,5,5,1,4,3,1,5,1,5,1,1,3,2,3,5,1,1,1,1,1,1,1,1,1,4,2,1,1,2,2,1,1,1,1,1.7896096509302533,1.2227992865708155,1.25,0,1,0,2.066666666666667,0,1,0,1.6666666666666667,0,0.8333333333333334,0,1.1428571428571428,0,1.6666666666666667,0,1.3243243243243243,0,0,0,0,-0.8631596990900906,-0.7372407672780129,-0.8002002331840518,4,1,3,1,1,3,1,1,1,1.2909944487358056,1.7142857142857142,0,1,-0.4757826382709144,4,4,5,5,2,2,3,4,6,3,3,1.2724180205607036,3.5714285714285716,0,2.4285714285714284,4,3.8333333333333335,3.2559414990859232,-0.1748077221195339,0,-0.10315842453524313,1,3,1,2,1,1,4,2,1,2,1,5,1,5,5,3,5,1,3,4,1.6846647257229665,1.6,0,5,0,3.4,0,4.2,0,4.2,0,3,4,2,3,3,2,4,1,2,3,3,2,3,2,1,3,1,2,1,2,0.9333020044867296,2.45,0,"White, Caucasian, Anglo, European American",0,18,1,2,NA,1,3,3,Student / Unemployed,3,0,135,67,1,5,2,0,0,0,0,0,TRUE,TRUE,TRUE,TRUE,TRUE,1,1.144307317074479,0.82,0.1518873960986294,1,0.42834838709908146,0.5366354838725059,1,0.96875,0.0016210285807507086,0.0036229772582377735,1,0.5858750000018627,0.6402399999996027,1,0.9375,0.008959312257505177,0.01524288887042431,1.7054,0.8947,0.5474,0,41.5016,0.004,ML,change,50,-71.26713098371557,0.9899162868509241,1.5317936572109776,0.649140223837907,1.9504,4.2645,0.317,7.3158,0.2951,0,-81.3814,0.014,ML,cueing,63,175.1922041791746,4.312155513608308,0.7963505011932347,0.45006873175600604,5.726177766271838,0.7235428056032946,0.3671442015552095,0.067,0.399,0.361,0.016,1.425,74.72350570212673,1934.2540457863752,0.066,0.399,0.361,0.016,1.507,103.72132002777423,1947.5968833500176,378,1.12,1,0,0,1,FALSE,FALSE,FALSE
288,2021-11-13T02:48:49Z,2021-11-13T03:16:33Z,1664,1,2021-11-13T03:16:35Z,0.4000000059604645,Safari,15.0,Macintosh,1440,900,NA,1.6,662,313,285,70,178,84,-0.3268216057549331,2.027673731590121,-0.6860510795551324,-0.421422424127912,1.464835838487464,-0.3610799845240493,3,3,2,1,3,1,2,3,1,4,3,1,1,1,3,3,1,1,2,4,1.0894228312566052,0,1,1,4,4,1.55,0,2,4,1,4,1,1,3,1,1,1,1,5,3,4,5,2,1,1,1,1,1,3,3,0,2,0,0,5,2,5,5,5,5,5,5,5,2,5,1,1,5,2,5,5,1,3,2,4,5,1,1,1,2,1,1,1,1,1,5,2,1,1,1,1,2,2,1,1,1.838444962428813,1.5976172734359604,1.625,0,1.5,0,1.6666666666666667,0,1.3333333333333333,0,2,0,1,0,1,0,1,0,1.4594594594594594,0,0,0,0,-0.8158292803535607,-0.5804383618435307,-0.6981338210985457,5,1,4,1,1,1,1,1,1,1.7320508075688772,1.1428571428571428,0,1,-0.8176513788914915,4,4,4,4,2,2,2,4,6,4,3,1.0690449676496976,3.4285714285714284,0,2.5714285714285716,4,3.8333333333333335,3.2559414990859232,-0.1748077221195339,0,-0.023487427113806164,1,1,1,1,1,1,4,1,1,2,1,4,1,3,1,1,5,1,4,1,1.486446705914413,1,0,4.8,0,4,0,3.8,0,4.2,0,1,2,1,3,3,1,1,3,1,1,2,4,1,1,1,4,1,1,2,1,1.0699237552766379,1.35,0,"White, Caucasian, Anglo, European American",0,20,1,2,NA,1,3,4,Fuel Clerk,4,0,165,65,2,5,2,0,1,0,0,1,TRUE,TRUE,TRUE,TRUE,TRUE,6,0.5557948717948643,0.78,0.011951871020409737,6,0.4019999999999981,0.48132142857143223,0.967741935483871,0.875,0.0027809397849462565,0.006787028225806848,6,0.5905937500000036,0.6971379310344807,1,0.90625,0.00681786189516153,0.007895353830645015,0.9706,1.3816,0.3682,0,-13.3119,0.005,ML,change,50,38.359869016284435,1.6059458116761527,0.7881127520798966,0.4183857705798909,0.9849,2.253,0.3031,4.1919,0.2929,0,-62.4088,0.011,ML,cueing,63,137.2470041791746,2.611264021169069,0.7451985449499376,0.3743045003363791,4.585711135626537,0.7416946425687707,0.3263472435588239,0.062,0.451,0.45,0.009,1.49,95.99189838002152,1954.676175138942,0.062,0.451,0.477,0.009,1.555,104.7795696421213,1961.8927574389402,104,0.3081481481481481,1,0,0,1,FALSE,FALSE,FALSE
289,2021-11-13T02:45:05Z,2021-11-13T03:17:13Z,1928,1,2021-11-13T03:17:14Z,1,Edge,95.0.1020.53,Windows NT 10.0,1280,720,Good survey,1.7777777777777777,1115,60,439,81,76,102,0.8371016532007807,-0.2707650616449916,0.05534174712306178,-0.28737195225343287,0.05600575552929045,-0.057035382828693984,4,4,1,1,4,1,1,4,1,4,2,1,1,1,4,4,1,1,4,4,1.500876936643164,1,1,3,4,4,1.1,0,3,2,3,4,3,4,3,3,2,4,1,3,2,2,3,2,3,1,3,1,2,3,2,5,2,0,0,4,1,5,3,4,4,5,5,4,1,4,2,1,3,4,3,5,2,2,3,2,1,1,5,1,3,3,1,4,3,1,4,2,3,2,3,1,2,2,2,2,1.3847084232492477,0.8618916073713346,2.125,0,2,0,2.933333333333333,0,2.111111111111111,0,2.5,0,2.8333333333333335,0,2.142857142857143,0,2,0,2.4054054054054053,0,3,0,0,0.34991215781160245,0.1856414649805007,0.2677768113960516,4,2,3,2,1,2,2,3,1,0.9511897312113419,2,0,2,0.06413940681375631,4,3,3,2,1,1,3,3,3,2,2,1.1338934190276817,2.4285714285714284,0,3.5714285714285716,6,3.8333333333333335,3.2559414990859232,0.9547190977297628,0,1.0989729647608995,3,3,4,3,4,4,3,4,3,2,3,2,3,2,3,3,2,4,3,2,0.7432233529572065,3.4,0,2.2,0,2.8,0,2.8,0,2.6,0,2,2,1,3,3,1,2,2,1,1,2,3,2,1,2,3,1,2,1,2,0.7451598203705946,1.75,0,"White, Caucasian, Anglo, European American",0,18,0,1,NA,1,3,4,Cashier,2,0,185,74,3,5,2,0,0,0,0,0,TRUE,TRUE,TRUE,TRUE,TRUE,2,0.9155102563637953,0.7959183673469388,0.042710200204252265,2,0.4585124999731779,0.5178531250208617,1,1,0.004381728866003174,0.0034631625673449615,2,0.5859937500208616,0.6876124999821186,1,1,0.005136669638296211,0.004540171446186034,1.3327,1.0762,0.5711,0,16.4804,0.004,ML,change,49,-21.285339105668122,1.2427400782455822,1.0951417572827753,0.6547376567659129,3.2751,7.7392,0.3063,7.7609,0.2475,0,-93.6738,0.009,ML,cueing,64,199.82424925007902,4.7363553104425,0.8747516718724497,0.42839449844167615,4.465819021586972,0.9277435351420107,0.3578868873672462,0.186,0.317,0.7,0.014,1.674,40.464258065279935,1832.05183129993,0.184,0.318,0.7,0.014,1.714,59.94555059230293,1841.0499778747587,346,1.0251851851851852,1,0,0,1,FALSE,FALSE,FALSE
290,2021-11-13T02:56:47Z,2021-11-13T03:17:24Z,1236,1,2021-11-13T03:17:25Z,1,Chrome,93.0.4577.82,Macintosh,1280,800,NA,1.6,619,48,302,73,54,96,-0.43730438751011125,-0.3797819214031788,-0.6042090142724746,-0.38486320452578127,-0.24785955648129604,-0.15838358339381242,4,4,1,3,4,1,1,2,1,4,2,1,1,1,4,4,1,1,3,3,1.3416407864998738,0,1,1,1,1,1.4,0,3,5,5,5,5,3,5,3,2,1,1,5,5,3,5,1,1,1,1,1,1,1,1,2,2,0,0,5,4,5,5,5,5,3,3,5,2,4,1,1,4,1,5,5,1,3,2,5,5,1,1,1,1,1,3,2,2,1,5,3,4,1,1,1,1,1,1,2,1.696135866278665,1.533747356112131,1,0,1.25,0,2.4,0,1.5555555555555556,0,2.1666666666666665,0,0.8333333333333334,0,2.142857142857143,0,1,0,1.7567567567567568,0,1,0,0,-0.6415100898740308,-0.4557470907642554,-0.5486285903191431,5,1,5,1,1,1,1,1,1,1.9518001458970664,1,0,1,-0.9031185640466358,5,5,5,5,3,3,1,6,6,6,4,1.5735915849388864,4.428571428571429,0,1.5714285714285714,3,3.8333333333333335,3.2559414990859232,-0.7395711320441822,0,-0.8635661140261877,3,2,2,3,2,2,4,2,1,4,1,5,1,5,5,2,5,2,4,5,1.65615734242165,2.4,0,4.6,0,4.2,0,4,0,4.266666666666667,0,2,2,2,4,2,1,2,4,1,1,3,4,2,1,3,2,1,2,1,3,1.0399898784932577,1.75,0,"White, Caucasian, Anglo, European American",0,30,1,2,NA,1,4,7,Financial Analyst,6,0,121,62,3,5,2,0,0,1,0,0,TRUE,TRUE,TRUE,TRUE,TRUE,6,0.9089942857197353,0.7,0.06598407265565367,6,0.4643718750104308,0.5317413793021235,1,0.90625,0.002592929828371839,0.005306323857290735,6,0.7093624999970198,0.879309374973178,1,1,0.004829001124900464,0.011695162818752314,1.3219,0.6792,0.5679,0,25.2626,0.004,ML,change,50,-38.78913098371556,0.7296041280247144,1.1613117687274137,0.5906540450000239,1.2183,2.5761,0.3331,5.2882,0.3492,0,-68.809,0.011,ML,cueing,64,150.09464925007902,3.09096990048987,0.7339714116785199,0.43527460816108376,5.091723402081613,0.8136998810064435,0.38696470876464373,0.138,0.447,0.496,0.007,1.339,97.01426269017273,1907.9010502184096,0.155,0.449,0.597,0.008,1.561,90.25912107465784,1872.1376150749754,104,0.3081481481481481,1,0,0,1,FALSE,FALSE,FALSE
292,2021-11-13T02:52:38Z,2021-11-13T03:19:47Z,1628,1,2021-11-13T03:19:47Z,1,Chrome,95.0.4638.69,Windows NT 10.0,1600,900,NA,1.7777777777777777,810,83,390,82,61,133,0.053444712844284634,-0.06181608044179956,-0.18055597045636368,-0.2751855457193893,-0.15117513902338214,0.4665969867577513,2,3,2,1,2,1,2,2,2,3,2,2,1,1,2,3,2,1,2,2,0.6407232755171874,0,1,3,5,3,2.1,0,1,3,1,4,3,2,3,2,1,1,1,4,1,4,5,1,1,1,3,1,1,1,1,0,4,0,0,4,4,4,4,3,5,5,5,5,2,5,3,1,4,2,5,2,3,1,1,3,4,1,1,1,1,1,1,1,2,1,4,1,2,1,1,1,3,3,2,2,1.5730462404120467,1.4040757000349275,1.25,0,2.5,0,2,0,1.6666666666666667,0,1.8333333333333333,0,1,0,1.2857142857142858,0,1,0,1.5405405405405406,0,0,0,0,-0.7988909914396698,-0.26683355097456624,-0.532862271207118,3,1,2,3,1,1,2,1,2,0.8997354108424374,2.142857142857143,0,1.5,-0.03488724541829051,2,4,4,4,2,3,2,7,3,3,2,1,3.2857142857142856,0,2.7142857142857144,4,3.8333333333333335,3.2559414990859232,-0.1748077221195339,0,0.056183570307630534,1,2,2,2,2,1,2,2,2,1,2,2,2,4,4,3,4,2,1,4,1.121223821162776,1.8,0,3.8,0,2.2,0,3.6,0,3.2,0,2,3,2,2,1,1,4,2,3,2,2,2,2,1,1,2,1,2,1,2,0.7880689256524124,2.1,0,"White, Caucasian, Anglo, European American",0,30,1,2,NA,1,2,7,Policy consultant,2,0,120,67,2,5,2,0,0,1,0,0,TRUE,TRUE,TRUE,TRUE,TRUE,6,0.7501138888878954,0.72,0.03686956428150865,6,0.49729000000059603,0.6590967741945097,0.967741935483871,0.96875,0.005024546924631495,0.015075232539532147,6,0.6688843749975786,0.7389193548396711,1,1,0.009384383941727683,0.007217027612927111,1.1254,0.8977,0.4941,0,6.7965,0.004,ML,change,50,-1.8569309837155625,0.9331238941021818,1.0121502780180955,0.5114820602835823,1.6196,3.4036,0.4327,2.8524,0.2318,0,-39.2441,0.01,ML,cueing,63,90.9176041791746,3.019220362585488,1.137375478464406,0.4825131891945611,3.9553085107234107,0.8599069762677224,0.3956001944329428,0.169,0.401,0.644,0.009,1.104,18.393396843564943,1811.7162323977975,0.169,0.402,0.646,0.01,1.139,29.392956872435217,1810.5735849427801,356,1.0548148148148149,1,0,0,1,FALSE,FALSE,FALSE
293,2021-11-13T02:39:44Z,2021-11-13T03:20:05Z,2421,1,2021-11-13T03:20:05Z,0.800000011920929,Chrome,95.0.4638.69,Windows NT 10.0,1920,1080,NA,1.7777777777777777,1140,255,530,66,58,69,0.9013358286398376,1.5007589094255498,0.49343750834199473,-0.47016805026408615,-0.19261131793391667,-0.6144504859368455,2,2,3,4,1,3,4,2,1,2,2,3,3,3,2,1,3,2,2,1,0.9233805168766387,0,1,1,2,2,3.1,0,3,3,5,4,2,1,4,4,1,1,1,3,1,3,3,4,1,5,1,5,4,2,4,2,2,0,0,4,1,1,4,2,2,4,5,2,1,5,5,1,2,1,1,1,5,5,5,5,5,1,1,1,4,3,1,2,1,1,4,4,3,1,1,2,1,1,2,3,1.6558205644760369,1.3522468075656264,3.25,0,1.75,0,2.3333333333333335,0,3.2222222222222223,0,3.25,0,1.6666666666666667,0,1.8571428571428572,0,1.3333333333333333,0,2.6216216216216215,0,1,0,0,0.6684487796151188,-0.2989446853297732,0.18475204714267282,4,2,2,1,1,2,3,2,1,1.0690449676496976,2.142857142857143,0,1.5,-0.03488724541829051,4,3,5,5,1,1,4,6,6,3,1,1.7043362064926932,3,0,3,3,3.8333333333333335,3.2559414990859232,-0.7395711320441822,0,-0.0668561398118202,3,1,4,5,4,1,4,2,1,2,1,4,3,5,4,5,4,1,2,5,1.5796322658258457,3.4,0,4.6,0,2.4,0,3.8,0,3.6,0,3,4,4,1,4,4,4,1,4,3,3,1,3,4,2,1,1,4,3,4,1.2523661815266247,3.5,0,"Black or African American & Hispanic of Latino (e.g., Mexican American, Central American, and others) & White, Caucasian, Anglo, European American & Native American/Alaskan Native/indigenous",1,22,0,1,NA,1,2,6,Student,5,0,212,74,1,5,2,0,1,1,0,1,TRUE,TRUE,TRUE,TRUE,TRUE,3,0.6909800000000538,0.9183673469387755,0.11626790564621277,3,0.5754093749999883,0.651900000000012,1,1,0.022906805393177226,0.022729525999990778,3,0.5961633333333303,0.6421937499999912,0.967741935483871,1,0.006840556645159035,0.013426657379045703,1.2636,1.846,0.4444,0,-6.4236,0.004,ML,change,49,24.522660894331878,1.4902313330729602,1.6241559782932913,0.23501466591185383,1.6213,3.4736,0.4185,3.5613,0.3478,0,-50.0373,0.007,ML,cueing,63,112.5040041791746,2.9591358233812906,1.400116444015514,0.4227177511787724,2.9533938269308186,1.4028385542801445,0.34533510636254605,0.071,0.414,0.358,0.03,1.361,157.16175077747394,2019.037109429111,0.071,0.416,0.367,0.031,1.422,210.13944270245827,2047.7794210434372,430,1.2740740740740741,1,0,3,4,FALSE,FALSE,FALSE
294,2021-11-13T02:47:17Z,2021-11-13T03:20:16Z,1978,1,2021-11-13T03:20:17Z,1,Chrome,95.0.4638.69,Windows NT 10.0,1366,768,The survey was easy to understand,1.7786458333333333,771,87,566,159,92,106,-0.046760600840644366,-0.025477127189070508,0.6667501171758583,0.6631677574019643,0.27699870971880786,0.010530084214718316,4,3,1,1,3,1,2,3,1,4,2,1,1,2,4,3,2,2,2,3,1.0699237552766379,0,0,4,4,5,1.65,0,4,4,2,3,3,1,5,3,3,1,2,4,1,5,3,3,4,5,1,1,2,1,1,7,1,1,2,5,2,3,4,3,4,3,3,4,2,5,2,4,2,1,5,3,2,3,1,2,1,2,5,3,4,2,1,4,4,1,4,2,2,2,3,1,3,3,1,3,1.2657417201396586,1.3345232785352157,2.25,0,2.5,0,2,0,2.5555555555555554,0,2.1666666666666665,0,3.3333333333333335,0,2.142857142857143,0,2,0,2.4864864864864864,0,4,1,2,0.03737652979472142,1.1050688456028845,0.571222687698803,3,3,2,2,2,3,3,1,1,0.5345224838248488,2.857142857142857,0,1,0.20795484297024003,3,2,3,4,1,1,3,1,1,1,2,1.1338934190276817,2.4285714285714284,0,3.5714285714285716,8,3.8333333333333335,3.2559414990859232,2.0842459175790595,0,1.6637363746855478,3,3,2,2,3,3,4,3,3,2,2,3,2,3,4,1,4,1,3,3,0.9611501047232549,2.6,0,3.8,0,3.6,0,3.2,0,3.533333333333333,0,2,2,1,3,1,1,2,2,2,1,3,3,1,1,1,3,1,1,1,2,0.8013147091860318,1.6,0,"Hispanic of Latino (e.g., Mexican American, Central American, and others)",0,19,1,2,NA,1,2,4,student,1,0,165,60,3,5,2,0,0,1,0,0,TRUE,TRUE,TRUE,TRUE,TRUE,4,0.928246874999255,0.64,0.0663067796876988,4,0.5048374999985099,0.572199999999255,1,1,0.007703482419497774,0.008934820645970606,4,0.67069062500074506,0.8625300000011921,1,0.9375,0.01578034733097878,0.056654810953467284,1.2093,0.4786,0.57,0,24.1949,0.004,ML,change,50,-36.65373098371556,0.504002319041553,1.1415902728338942,0.6111399249743514,4.5177,6.5265,0.2261,6.7109,0.1682,0,-67.6596,0.009,ML,cueing,64,147.79584925007902,3.7371543445777564,1.1086335602924224,0.4285092847506947,3.87829392919164,1.0682879642531617,0.3714149198298689,0.085,0.403,0.261,0.012,1.967,71.19218807216112,1967.1838484615096,0.084,0.417,0.274,0.013,2.046,84.62178832374089,1950.41913093769,374,1.108148148148148,1,0,0,1,FALSE,FALSE,FALSE
295,2021-11-13T02:58:53Z,2021-11-13T03:21:19Z,1345,1,2021-11-13T03:21:20Z,0.8999999761581421,Firefox,94.0,Windows NT 10.0,1280,720,NA,1.7777777777777777,661,61,312,58,43,150,-0.3293909727724954,-0.26168032333180935,-0.5560666229297347,-0.5676593025364346,-0.39979221248658925,0.7537502216922536,2,3,2,2,2,1,1,3,1,2,3,2,1,3,2,3,1,1,2,2,0.7591546545162482,0,1,1,5,5,2.05,0,5,5,1,5,1,1,5,1,1,1,1,5,1,5,5,1,1,1,1,1,1,1,1,0,1,2,NA,5,1,3,1,3,5,5,5,5,5,5,1,1,5,1,5,1,1,1,1,1,1,1,5,1,2,1,1,1,1,1,4,3,1,1,1,1,1,1,1,1,1.782884931418368,2.065591117977289,1,0,1,0,1,0,2.3333333333333335,0,1.3333333333333333,0,2.3333333333333335,0,1.2857142857142858,0,1,0,1.7567567567567568,0,0,2,NA,-1.24315811209544,-0.2694891481859902,-0.7563236301407151,5,1,1,1,1,1,1,1,1,1.5118578920369088,1.5714285714285714,0,1,-0.5612498234260587,5,5,5,5,3,5,1,5,1,2,2,1.5735915849388864,4.714285714285714,0,1.2857142857142858,6,3.8333333333333335,3.2559414990859232,0.9547190977297628,0,-0.17576299398208856,1,1,1,1,1,1,4,1,1,1,1,4,1,5,1,2,5,2,1,2,1.5522640914238175,1,0,4.6,0,3,0,4,0,3.8666666666666667,0,1,1,1,4,3,1,2,3,1,1,1,4,1,1,1,4,1,1,1,1,1.1742858972247996,1.2,0,Black or African American,0,24,1,2,NA,1,3,7,LPCA,3,0,135,63,1,5,2,0,0,1,0,0,TRUE,TRUE,TRUE,TRUE,TRUE,5,0.7008421052631579,0.7755102040816326,0.025603020408163268,5,0.76453125,0.7031612903225807,1,0.96875,0.44150135383064515,0.2600144264112903,5,0.626,0.7085806451612904,1,1,0.008463161290322579,0.015536518279569892,1.0799,1.1933,0.4347,0,-0.679,0.004,ML,change,49,13.03346089433188,1.3038452119091397,0.9507960573884477,0.4999332754277974,1.6074,2.0434,0.3249,1.6146,0.2668,0,7.5848,0.007,ML,cueing,64,-2.6929507499209873,1.4815334304612195,2.317860085962491,-0.030198411831880878,1.4095467496565814,2.9393382854459817,-0.2455395279715532,0.257,0.198,0.61,0.013,1.372,31.25234226829536,1817.9487881159384,0.256,0.205,0.614,0.015,1.465,41.48515315619022,1823.50127428439,396,1.1733333333333333,1,0,0,1,FALSE,FALSE,FALSE
296,2021-11-13T03:04:45Z,2021-11-13T03:21:22Z,997,1,2021-11-13T03:21:24Z,1,Chrome,95.0.4638.69,Windows NT 10.0,1280,720,"On the second game, I had to scroll down sometimes to see the arrows.",1.7777777777777777,570,37,195,54,41,53,-0.563203371370663,-0.47971404284818364,-1.1193326016397915,-0.6164049286726088,-0.42741633176027893,-0.8847123541104946,4,4,1,1,3,1,1,3,1,3,3,1,1,1,4,3,1,1,4,3,1.2814465510343749,0,1,1,3,4,1.3,0,5,5,2,5,2,1,4,1,1,1,1,5,1,5,4,1,1,1,1,1,1,1,1,0,2,0,0,5,4,5,5,5,5,5,5,5,1,5,1,1,4,1,5,1,1,1,1,1,5,1,1,1,5,1,1,1,1,1,5,1,1,1,3,1,2,1,1,1,1.9199443185119163,1.8464895909600492,1,0,1.25,0,1.2666666666666666,0,1.1111111111111112,0,1.0833333333333333,0,1.5,0,0.8571428571428571,0,1.6666666666666667,0,1.2162162162162162,0,0,0,0,-1.3608550224913916,-0.6588395645607719,-1.0098472935260818,5,1,3,1,1,1,1,1,1,1.5735915849388864,1.2857142857142858,0,1,-0.7321841937363471,5,5,5,5,2,2,3,5,3,2,3,1.4638501094227998,3.857142857142857,0,2.142857142857143,5,3.8333333333333335,3.2559414990859232,0.38995568780511447,0,0.019881285584207653,5,2,3,3,2,1,5,1,1,3,1,5,3,5,5,1,5,1,5,4,1.869555587629877,3,0,5,0,4.2,0,4.4,0,4.533333333333333,0,1,1,2,4,1,1,2,4,1,1,2,4,2,1,2,4,2,3,2,3,1.1367080817685316,1.55,0,"White, Caucasian, Anglo, European American",0,21,1,2,NA,1,3,6,Student,3,0,210,68,3,5,2,0,0,1,0,0,TRUE,TRUE,TRUE,TRUE,TRUE,2,0.6598052631553851,0.76,0.015740339493077352,NA,NA,NA,NA,NA,NA,NA,2,0.5466374999582767,0.6614827586206896,1,0.90625,0.008193885630162915,0.01374763281567568,1.2482,1.0484,0.3685,0,9.2167,0.004,ML,change,50,-6.6973309837155615,1.3815755373266143,0.8343224664855107,0.5027933333509633,NA,NA,NA,NA,NA,NA,NA,NA,NA,NA,NA,NA,NA,NA,NA,NA,NA,NA,0.07,0.38,0.402,0.008,1.399,46.47586459662348,1948.46258366944,0.07,0.381,0.42,0.009,1.45,56.03459522316587,1943.8611421635371,386,1.1437037037037037,1,0,0,1,FALSE,FALSE,FALSE
297,2021-11-13T02:48:57Z,2021-11-13T03:22:41Z,2023,1,2021-11-13T03:22:42Z,1,Chrome,95.0.4638.69,Macintosh,1366,768,NA,1.7786458333333333,896,79,644,89,68,120,0.2744102763546409,-0.09815503369452862,1.0422607696492294,-0.18988069998108442,-0.054490721565468275,0.24700921886666136,2,3,2,2,3,2,2,3,2,3,3,2,2,2,3,3,2,2,2,2,0.4893604849295929,0,0,2,2,2,2.15,0,1,4,4,2,3,2,4,2,4,2,2,3,2,4,3,5,5,5,1,3,3,3,5,5,1,5,2,2,1,2,3,1,4,3,3,2,2,4,5,2,1,4,2,5,5,5,5,5,1,5,5,5,5,1,2,3,3,3,5,1,1,1,4,5,3,5,5,3,1.5839851669157161,1.01418510567422,3.75,0,4,0,2.8,0,3.6666666666666665,0,4.083333333333333,0,4.166666666666667,0,1.8571428571428572,0,3.3333333333333335,0,3.5675675675675675,0,3,5,2,1.4903913479394768,2.1989164184819097,1.8446538832106931,3,2,2,3,2,2,2,7,3,0.4879500364742666,2.5714285714285716,0,5,1.51297117175748,1,1,1,1,1,1,5,4,3,1,2,1.5118578920369088,1,0,5,5.5,3.8333333333333335,3.2559414990859232,0.6723373927674386,0,1.7544920864941047,3,4,4,4,4,4,4,2,3,4,1,4,2,5,4,3,4,2,3,2,1.1254628677422756,3.8,0,3.8,0,3.6,0,4,0,3.8,0,3,4,2,3,3,1,3,2,2,2,2,3,1,2,2,2,3,2,2,2,0.7326950970650465,2.3,0,"White, Caucasian, Anglo, European American",0,28,1,2,NA,1,3,6,Online English Teacher - English as a Second Language,1,0,100,62,2,5,2,0,0,1,0,0,TRUE,TRUE,TRUE,TRUE,TRUE,3,0.7117289473602646,0.76,0.02025475071321701,3,0.781753333334128,0.73915185185715,1,0.9310344827586207,0.298926823259645,0.2900479568936517,3,1.1357281249985098,1.3257062499932946,1,1,0.13525014659919832,0.2585314077015958,1.0055,1.1637,0.5154,0,-4.2219,0.004,ML,change,50,20.179869016284435,1.297168616958426,0.8886119313009317,0.5336186391722837,1.5608,1.5883,0.4288,1.7507,0.3359,0,11.5053,0.007,ML,cueing,59,-10.77798766828284,1.2405242560294505,2.098056263546849,0.010157967246697819,1.5538935809802643,2.6662924521368194,-0.04937527309788148,0.157,0.474,0.219,0.129,1.805,77.8337932669874,1877.7799594617024,0.151,0.484,0.214,0.024,1.965,95.68339250003791,1878.6788113098858,457,1.3540740740740742,1,0,0,1,FALSE,FALSE,FALSE
298,2021-11-13T02:47:11Z,2021-11-13T03:22:42Z,2130,1,2021-11-13T03:22:42Z,1,Opera,80.0.4170.63,Windows NT 10.0,1920,1080,NA,1.7777777777777777,956,40,498,95,314,95,0.4285722974083778,-0.45245982790863687,0.33938185604522714,-0.11676226077682311,3.3432759490983623,-0.1752749501546655,2,3,4,4,2,2,3,1,1,3,3,3,3,4,3,2,4,3,2,2,0.9233805168766387,1,1,1,2,1,2.9,0,5,5,3,4,2,1,5,1,1,1,1,5,1,5,3,1,2,1,1,1,2,1,1,0,2,0,0,4,5,5,4,5,5,5,5,5,1,3,1,3,5,1,5,1,3,3,3,1,4,1,2,1,2,1,1,1,2,2,4,1,1,1,1,1,1,2,1,2,1.6675673242123632,1.8073922282301278,1.25,0,1.5,0,1.4,0,1.2222222222222223,0,1.8333333333333333,0,1.3333333333333333,0,1.2857142857142858,0,1,0,1.4864864864864864,0,0,0,0,-1.0799697971878957,-0.5804383618435307,-0.8302040795157132,5,1,5,1,1,1,1,1,1,1.9518001458970664,1,0,1,-0.9031185640466358,5,5,5,5,5,3,1,8,8,6,4,1.5735915849388864,4.714285714285714,0,1.2857142857142858,1,3.8333333333333335,3.2559414990859232,-1.869097951893479,0,-1.5876715187937096,4,4,3,3,2,2,4,1,2,3,1,4,2,3,4,2,5,2,4,1,1.2909944487358056,3.2,0,4.4,0,3.8,0,4.2,0,4.133333333333334,0,2,2,4,1,3,4,4,1,3,4,2,2,2,4,1,2,2,4,4,4,1.164157703189193,3.15,0,"White, Caucasian, Anglo, European American",0,22,1,2,NA,1,3,6,Software engineering researcher,2,0,138,64,2,5,2,0,0,0,0,0,TRUE,TRUE,TRUE,TRUE,TRUE,4,0.8704999999973704,0.6938775510204082,0.058278716122005296,4,0.4481354838686605,0.5450387096779962,1,0.96875,0.002594474365792117,0.004855128669009368,4,0.5586500000013038,0.6395500000023416,1,0.9032258064516129,0.011322626451395272,0.01277269178424357,1.3646,0.6262,0.4892,0,29.6027,0.004,ML,change,49,-47.52993910566812,0.7284999135056938,1.123281291244183,0.5715582680684455,1.5223,4.2927,0.377,5.6548,0.3135,0,-80.6324,0.008,ML,cueing,63,173.69420417917462,4.007842357443393,0.8568169349544202,0.44482694922440225,5.0909654341368755,0.8138210286422739,0.3707052663886171,0.072,0.365,0.382,0.016,1.593,99.54304903731223,2012.1940537595597,0.07,0.364,0.356,0.016,1.704,112.95061602724246,2000.3881058210416,478,1.4162962962962962,1,0,0,1,FALSE,FALSE,FALSE
299,2021-11-13T03:02:06Z,2021-11-13T03:22:58Z,1252,1,2021-11-13T03:22:59Z,1,Edge,95.0.1020.44,Windows NT 10.0,1620,1080,NA,1.5,591,63,343,77,53,75,-0.5092466640018551,-0.24351084670544482,-0.4068252097672411,-0.3361175783896071,-0.2616716161181409,-0.513102285371727,1,1,3,1,2,1,2,2,1,3,2,3,3,2,2,2,2,1,1,1,0.7677718959499145,0,1,2,4,5,2.6,0,2,3,2,3,2,1,3,2,2,2,2,3,3,3,2,2,1,1,2,1,1,1,2,1,2,0,0,1,1,5,2,2,5,1,1,1,1,5,1,1,3,1,2,3,1,1,1,3,5,1,1,1,1,1,3,1,1,1,4,1,5,1,1,1,2,1,1,1,1.460182225659569,0.6172133998483676,1.375,0,1.25,0,2.6,0,3.888888888888889,0,1.75,0,0.8333333333333334,0,1.8571428571428572,0,1,0,2.135135135135135,0,1,0,0,-0.23179707860259807,-0.4557470907642554,-0.34377208468342674,5,1,4,2,1,1,1,1,1,1.6761634196950514,1.2857142857142858,0,1,-0.7321841937363471,3,3,3,2,1,1,5,6,6,NA,3,1.3972762620115438,2,0,4,3,3.8333333333333335,3.2559414990859232,-0.7395711320441822,0,0.49084084213823703,2,2,2,1,1,3,2,2,2,2,2,3,1,2,2,4,3,3,2,4,0.8338093878327919,1.6,0,3.2,0,2.6,0,2.8,0,2.8666666666666667,0,2,3,2,1,2,3,3,1,3,2,3,2,2,3,1,1,2,2,2,2,0.7181848464596079,2.6,0,"White, Caucasian, Anglo, European American",0,27,1,2,NA,1,3,6,freelance designer,1,0,110,66,3,5,2,0,0,1,0,0,TRUE,TRUE,TRUE,TRUE,TRUE,1,0.8730020833333402,0.96,0.07627700942448605,1,0.403058064516123,0.4669225806451042,0.96875,0.96875,5.730551209693789e-4,0.0024354308770136866,1,0.541284374999981,0.5736064516128897,1,0.96875,0.006943494264114925,0.009331594838705394,1.6718,1.8843,0.4793,0,3.3473,0.003,ML,change,50,5.041469016284437,1.9371314908005506,1.640597886844823,0.4834182933156904,1.0863,3.9317,0.3339,6.7597,0.3259,0,-99.3292,0.034,ML,cueing,64,211.13504925007902,4.7623012574741885,0.7210772731136399,0.39594744625150885,6.837726370544313,0.5022118491430341,0.36862969000556806,0.165,0.21,0.509,0.085,1.71,206.07977027164625,2087.3962399324496,0.177,0.2,0.508,0.055,1.837,248.55771867938884,2071.3541611801143,422,1.2503703703703704,1,0,0,1,FALSE,FALSE,FALSE
300,2021-11-13T03:00:44Z,2021-11-13T03:23:17Z,1353,1,2021-11-13T03:23:18Z,0.8999999761581421,Safari,14.0.1,Macintosh,1440,900,NA,1.6,720,63,219,66,46,187,-0.17779831873632074,-0.24351084670544482,-1.0037908624172158,-0.47016805026408615,-0.3583560335760547,1.3787307918438174,4,4,1,1,4,2,1,4,2,4,4,2,1,1,4,4,2,1,3,3,1.3138933706635727,0,1,2,3,2,1.3,0,4,5,3,5,2,1,4,2,1,1,1,5,1,5,5,1,1,1,1,1,1,1,1,0,2,0,0,5,5,5,5,5,5,5,5,5,2,5,5,1,5,1,5,1,1,2,4,1,5,1,1,1,1,2,1,1,1,1,5,1,1,1,1,1,1,1,1,1,1.931250819994578,1.7728105208558367,1,0,1,0,1.4,0,1,0,1.75,0,1,0,0.8571428571428571,0,1,0,1.2702702702702702,0,0,0,0,-1.2803255574836354,-0.7372407672780129,-1.008783162380824,5,1,5,1,1,1,1,1,1,1.9518001458970664,1,0,1,-0.9031185640466358,5,5,5,5,3,2,2,3,6,6,3,1.4638501094227998,4.142857142857143,0,1.8571428571428572,4.5,3.8333333333333335,3.2559414990859232,0.10757398284279028,0,-0.28065156173982786,2,2,3,3,2,2,3,1,2,1,1,3,2,3,2,2,3,2,3,3,0.7745966692414834,2.4,0,3.8,0,3,0,3.4,0,3.4,0,1,1,1,2,1,2,2,3,2,2,3,2,1,1,1,3,2,2,1,2,0.7163503994113789,1.75,0,"White, Caucasian, Anglo, European American",0,28,1,2,NA,1,3,6,Teacher,5,0,220,64,2,5,2,0,0,1,0,0,TRUE,TRUE,TRUE,TRUE,TRUE,1,0.8308421052631579,0.76,0.06387174244897867,1,0.4257000000000194,0.4846333333333372,0.967741935483871,0.9375,0.0037795161290319216,0.004838450604838662,1,0.5713125000000037,0.6741200000000069,1,0.78125,0.006182221774192479,0.008098802419356928,1.2725,0.8962,0.4631,0,21.2294,0.003,ML,change,50,-30.722730983715557,0.9734215747025752,1.1841524164805797,0.5145560928239719,1.1806,2.7699,0.292,4.2415,0.2937,0,-60.909,0.008,ML,cueing,63,134.2474041791746,3.53443988134258,0.7661893516416354,0.3897928911142763,4.247129854781685,0.8008225549856629,0.3375043703263919,0.055,0.432,0.336,0.015,1.871,190.44443624577787,2195.012474150326,0.055,0.432,0.335,0.015,1.956,230.54441480284325,2205.7263512331942,104,0.3081481481481481,1,0,0,1,FALSE,FALSE,FALSE
301,2021-11-13T03:05:04Z,2021-11-13T03:23:44Z,1119,1,2021-11-13T03:23:45Z,1,Chrome,95.0.4638.69,Windows NT 10.0,1920,1080,No - thank you for the opportunity.,1.7777777777777777,610,46,232,70,44,62,-0.46042869066817177,-0.39795139802954327,-0.9412057536716539,-0.421422424127912,-0.3859801528497444,-0.732690053262817,4,4,1,1,3,1,1,4,1,4,4,1,2,1,4,3,1,1,3,4,1.3917047478769187,0,1,1,5,4,1.2,0,5,5,1,4,1,1,4,1,1,1,1,5,2,5,5,1,2,1,1,1,1,1,1,0,2,0,0,5,5,5,5,5,5,5,5,5,1,5,1,1,5,1,5,1,1,2,1,2,5,1,1,1,2,1,1,1,1,1,5,1,1,1,1,1,1,1,1,1,1.921507791343088,1.8973665961010275,1.125,0,1,0,1.2,0,1,0,1.1666666666666667,0,1,0,0.8571428571428571,0,1,0,1.0810810810810811,0,0,0,0,-1.3938604883178878,-0.7372407672780129,-1.0655506277979503,5,1,5,1,1,1,1,1,1,1.9518001458970664,1,0,1,-0.9031185640466358,5,5,5,5,4,3,1,3,4,4,4,1.5275252316519468,4.571428571428571,0,1.4285714285714286,5.5,3.8333333333333335,3.2559414990859232,0.6723373927674386,0,-0.23728284904181396,2,2,2,2,3,3,3,3,2,1,1,3,2,4,5,2,3,1,4,2,1.1832159566199232,2.2,0,3.8,0,3.2,0,4,0,3.6666666666666665,0,1,1,1,4,1,1,1,4,1,1,1,4,1,1,1,4,1,1,2,1,1.2258187382102494,1.05,0,"White, Caucasian, Anglo, European American",0,26,1,2,NA,1,3,4,services coordinator,3,0,170,65,2,5,2,0,0,1,0,0,TRUE,TRUE,TRUE,TRUE,TRUE,1,0.9834767441867396,0.86,0.10307436548612024,1,0.4343843749999069,0.49287419354819484,1,0.96875,0.0014107336188946974,0.003236709636989274,1,0.6186812499985099,0.6801516129038027,1,1,0.0041829377014133235,0.0085934059140616,1.5684,1.1868,0.5608,0,24.6678,0.004,ML,change,50,-37.59953098371556,1.2562937412459223,1.4449566268140006,0.5694140384877124,1.1519,4.4483,0.369,6.6712,0.3481,0,-102.3927,0.008,ML,cueing,64,217.26204925007903,4.435421339692316,0.774218939191775,0.4110521748600402,5.928587586693323,0.6988400973767803,0.37728803169435454,0.122,0.395,0.532,0.028,1.718,25.95266192723783,1835.986503312159,0.133,0.397,0.577,0.042,1.934,41.7469106434131,1824.2489179932159,310,0.9185185185185185,1,0,2,3,FALSE,FALSE,FALSE
303,2021-11-13T02:53:26Z,2021-11-13T03:24:42Z,1876,1,2021-11-13T03:24:43Z,0.8999999761581421,Chrome,95.0.4638.69,Macintosh,1440,900,The study made me think back to things I had forgotten. It was pleasant.,1.6,765,91,527,135,84,116,-0.06217680294601806,0.010861826063658545,0.4789947909391728,0.370694000584919,0.16650223262404917,0.17944375182324906,2,2,3,3,2,1,2,2,2,2,2,2,1,1,2,2,3,1,2,2,0.6048053188292994,0,1,1,4,4,2.45,0,5,5,1,4,1,1,4,1,1,1,1,4,1,4,4,1,2,1,1,1,1,1,1,0,2,0,0,5,5,5,5,5,5,5,5,5,1,5,2,1,4,1,1,4,2,3,2,1,5,1,1,1,3,2,1,1,2,1,4,3,2,1,2,1,2,1,2,2,1.7018802532482702,1.7265434778633235,1.125,0,1.75,0,1.3333333333333333,0,1,0,2.0833333333333335,0,1.3333333333333333,0,1.5714285714285714,0,1.3333333333333333,0,1.5945945945945945,0,0,0,0,-1.1158789696853448,-0.5020371591262895,-0.8089580644058172,4,3,3,5,2,3,1,3,1,1.2909944487358056,2.7142857142857144,0,2,0.49147533258947784,4,4,5,4,2,2,3,6,1,2,2,1.1338934190276817,3.4285714285714284,0,2.5714285714285716,5.5,3.8333333333333335,3.2559414990859232,0.6723373927674386,0,0.4000851303296801,2,2,3,3,2,1,4,1,3,1,1,4,2,4,3,1,4,2,3,3,1.245945806357946,2.4,0,4.4,0,3.4,0,3.6,0,3.8,0,1,1,2,2,3,3,3,2,3,3,1,2,1,1,1,2,3,3,2,3,0.8522416262267903,2.3,0,"Hispanic of Latino (e.g., Mexican American, Central American, and others)",0,24,1,2,NA,1,2,4,Hostess,3,0,175,63,3,5,2,0,1,1,0,1,TRUE,TRUE,TRUE,TRUE,TRUE,NA,NA,NA,NA,1,0.4724031250001863,0.5301774193554396,1,1,0.0034679299899186998,0.003814921139808876,1,0.6649687500002328,0.7574625000001397,1,1,0.0123026164113303,0.01232374370965587,NA,NA,NA,NA,NA,NA,NA,NA,NA,NA,1.4403803019825174,1.367306011998914,0.5536566265639804,2.3037,6.1165,0.3419,8.2306,0.3325,0,-97.0454,0.012,ML,cueing,63,206.52020417917458,4.6231831984245755,0.8961649470874035,0.4362854238157905,4.734726683483682,0.8750525644582989,0.3828829447988597,0.262,0.236,0.613,0.016,1.547,46.83732628416946,1842.5902669172956,0.266,0.238,0.625,0.017,1.63,58.7148082449184,1841.2079408983598,441,1.3066666666666666,1,0,1,2,FALSE,TRUE,FALSE
304,2021-11-13T03:01:53Z,2021-11-13T03:25:44Z,1431,1,2021-11-13T03:25:44Z,1,Chrome,95.0.4638.69,Windows NT 10.0,1280,720,NA,1.7777777777777777,673,82,310,74,98,120,-0.298558568561748,-0.07090081875498182,-0.5656951011982828,-0.37267679799173775,0.3598710675398769,0.24700921886666136,3,2,2,2,3,1,2,3,1,2,2,2,2,1,2,2,1,1,2,2,0.6407232755171874,0,1,4,2,2,2.1,0,4,4,3,4,2,1,4,2,2,1,2,4,1,4,4,2,1,1,1,1,2,1,2,1,2,0,0,5,3,4,5,5,5,5,5,5,2,5,3,1,5,1,5,1,1,1,2,4,4,1,1,1,4,1,1,3,3,1,4,2,1,1,2,1,1,1,1,2,1.6970208837488947,1.2649110640673518,1.375,0,1.25,0,1.8666666666666667,0,1.3333333333333333,0,1.5833333333333333,0,1.5,0,1.7142857142857142,0,1.3333333333333333,0,1.5675675675675675,0,1,0,0,-0.7908574029833673,-0.4557470907642554,-0.6233022468738113,5,1,3,1,1,1,1,1,1,1.5735915849388864,1.2857142857142858,0,1,-0.7321841937363471,4,4,4,4,2,2,3,6,7,3,4,0.9511897312113419,3.2857142857142856,0,2.7142857142857144,2.5,3.8333333333333335,3.2559414990859232,-1.0219528370065065,0,-0.3673889871358558,2,3,3,3,3,2,5,2,2,3,1,4,2,4,4,5,3,3,4,3,1.1872336794093274,2.8,0,3.8,0,3.4,0,3.8,0,3.6666666666666665,0,2,2,2,2,3,1,3,3,2,2,3,3,1,3,2,3,1,2,3,2,0.7163503994113789,2.15,0,"White, Caucasian, Anglo, European American",0,21,1,2,NA,1,3,4,Library Assistant and student,1,0,182,68,3,5,2,0,0,1,0,0,TRUE,TRUE,TRUE,TRUE,TRUE,3,0.7322000000033267,0.86,0.017356822958987782,3,0.46068437499180437,0.513615625012666,1,1,0.0018920503933943901,0.005281030389430038,3,0.5759812500067055,0.6377218749970198,1,1,0.005345581572631512,0.00410140240993621,1.2919,1.6276,0.4686,0,-3.261,0.004,ML,change,50,18.258069016284438,1.9611522261538485,0.9256242031748549,0.5622872779315384,1.8188,6.3602,0.3706,7.4513,0.3386,0,-104.8657,0.01,ML,cueing,64,222.20804925007903,4.262190215012509,0.9720670635013818,0.40314543008212367,5.5090830508986,0.7520552309908879,0.3945614378086749,0.098,0.415,0.648,0.019,1.533,10.429639070488328,1799.5372402810603,0.099,0.415,0.644,0.021,1.6,18.13472004505454,1799.333666049698,325,0.9629629629629629,1,0,0,1,FALSE,FALSE,FALSE
306,2021-11-13T02:58:35Z,2021-11-13T03:26:27Z,1671,1,2021-11-13T03:26:28Z,0.8999999761581421,Edge,95.0.1020.44,Windows NT 10.0,1366,768,NA,1.7786458333333333,674,71,466,152,109,140,-0.29598920154418573,-0.1708329401999867,0.18532620374845948,0.5778629116636594,0.5118037235451701,0.5848365540837228,3,3,1,2,3,2,2,2,1,3,2,1,2,1,3,3,2,1,3,2,0.7880689256524124,0,1,1,2,2,1.9,0,2,5,3,5,2,2,3,3,2,3,2,4,1,4,5,2,3,1,1,2,2,2,1,2,2,0,0,5,5,3,5,5,5,5,5,5,3,4,2,1,4,2,5,4,2,2,3,3,3,1,1,1,1,1,1,2,2,1,5,2,2,1,1,2,1,1,1,1,1.59013475168884,1.2798809468443688,1.75,0,1,0,2.1333333333333333,0,1.2222222222222223,0,2.25,0,1.1666666666666667,0,1.4285714285714286,0,1.3333333333333333,0,1.6486486486486487,0,1,0,0,-0.4802575794137882,-0.5341482934814965,-0.5072029364476424,5,1,4,2,1,2,2,3,1,1.5118578920369088,1.5714285714285714,0,2,-0.19226214865167657,5,5,5,5,2,2,2,7,5,4,2,1.6035674514745464,4,0,2,3,3.8333333333333335,3.2559414990859232,-0.7395711320441822,0,-0.6245531217618774,3,3,3,2,3,3,5,3,2,3,4,2,3,3,4,1,3,2,5,4,1.1254628677422756,2.8,0,2.8,0,4.2,0,3.2,0,3.4,0,1,3,2,2,3,4,4,1,3,4,4,2,3,3,3,2,1,3,3,3,0.9787209698591858,3,0,Black or African American,0,19,1,2,NA,1,2,4,Cashier,5,0,175,66,2,5,2,0,0,0,0,0,TRUE,TRUE,TRUE,TRUE,TRUE,5,0.8839972972974584,0.74,0.034065650628246326,5,0.515874999997206,0.559865625004284,1,1,0.003448039354999421,0.003922682973374857,5,0.6404483870960052,0.7130774193559923,1,0.96875,0.003288191913721358,0.0036644308771305997,1.4021,0.832,0.5085,0,24.1603,0.003,ML,change,50,-36.58453098371556,1.0444417923398146,1.0014617979231304,0.6538735764119656,10,10.8835,0.1005,11.2937,0.0732,0,-89.7358,0.015,ML,cueing,64,191.94824925007902,4.591099359508012,0.9024275891157181,0.4646567590552867,4.7415402422070025,0.873795120309485,0.4266119146325855,0.064,0.542,0.649,0.013,1.307,68.36063913169134,1902.5869694436544,0.067,0.542,0.673,0.016,1.377,78.96515125412932,1906.295263451913,344,1.0192592592592593,1,0,0,1,FALSE,FALSE,FALSE
307,2021-11-13T02:59:21Z,2021-11-13T03:27:16Z,1674,1,2021-11-13T03:27:18Z,1,Chrome,95.0.4638.69,Macintosh,1440,900,"No, that is all. Thank you.",1.6,931,62,346,99,59,101,0.36433812196932075,-0.2525955850186271,-0.3923824923644192,-0.06801663464064889,-0.17879925829707183,-0.07392674958954705,2,2,2,2,2,2,2,2,2,2,1,2,3,2,2,2,2,2,2,2,0.3244428422615251,0,1,1,3,3,2.6,0,3,3,3,2,2,3,3,3,3,2,2,1,1,2,3,3,5,1,1,3,3,3,3,0,2,0,0,4,4,4,4,4,5,5,5,5,3,3,5,1,3,2,3,3,2,4,3,3,2,2,1,1,1,1,1,1,1,1,4,1,3,1,2,3,1,1,1,1,1.4268973460049732,0.7367883976130072,2.75,0,1,0,2.933333333333333,0,1.5555555555555556,0,2.9166666666666665,0,1.5,0,1.2857142857142858,0,2,0,2.027027027027027,0,0,0,0,0.4558974513013779,-0.7372407672780129,-0.14067165798831752,3,1,2,1,1,2,2,1,1,0.7559289460184544,2,0,1,-0.3048482679606258,3,3,5,3,3,3,3,1,1,2,2,0.7559289460184544,3.2857142857142856,0,2.7142857142857144,8,3.8333333333333335,3.2559414990859232,2.0842459175790595,0,1.1857103901569273,2,2,2,2,2,2,3,3,1,3,2,2,1,2,4,3,3,3,2,4,0.9154754164341269,2,0,3.2,0,3.2,0,3.2,0,3.2,0,1,1,3,1,2,3,4,2,1,2,2,2,1,4,2,1,1,3,3,4,1.0894228312566052,2.55,0,"White, Caucasian, Anglo, European American",0,20,1,2,NA,1,2,5,Student,2,0,150,65,1,5,2,0,0,1,0,0,TRUE,TRUE,TRUE,TRUE,TRUE,2,0.8391354838667378,0.6326530612244898,0.39316286510199433,2,0.5285562499910593,0.6206900000035763,1,0.9375,0.015931488991521362,0.03184178028202896,2,0.6364906250033527,0.8436903225798761,1,0.96875,0.03503908216858431,0.06413392579947795,1.6352,0.3329,0.4092,0,53.8814,0.003,ML,change,49,-96.08733910566812,0.3056856602339838,1.778347882504129,0.06741694674042165,1.5147,2.2201,0.3102,3.1844,0.2907,0,-30.2078,0.006,ML,cueing,64,72.892249250079,2.206723101861474,1.2271816970683105,0.37739169401561956,3.2340624537256195,1.2810929861971798,0.3366832036080456,0.089,0.383,0.328,0.01,1.855,78.37208211482839,1921.1028511031877,0.092,0.388,0.367,0.011,1.895,75.72597893660178,1898.006918543038,342,1.0133333333333332,1,0,0,1,FALSE,FALSE,FALSE
308,2021-11-13T03:02:20Z,2021-11-13T03:27:28Z,1507,1,2021-11-13T03:27:29Z,1,Chrome,95.0.4638.69,Windows NT 10.0,1536,864,Nothing specific,1.7777777777777777,673,50,328,80,48,117,-0.298558568561748,-0.36161244477681426,-0.479038796781351,-0.29955835878747644,-0.3307319143023651,0.19633511858410213,2,2,3,2,1,1,3,2,1,2,1,2,1,2,1,2,2,1,1,1,0.6708203932499369,0,1,2,3,4,2.65,0,2,4,2,4,3,2,1,1,1,1,1,5,1,4,4,2,1,3,1,1,1,1,1,0,3,3,0,5,5,5,5,5,5,4,5,5,2,4,1,1,5,1,5,2,2,1,1,3,4,1,1,2,2,3,1,1,1,1,5,1,1,1,1,1,2,2,1,2,1.7646852733884628,1.4540583599999397,1.375,0,1.75,0,2,0,1.1111111111111112,0,1.5,0,1.6666666666666667,0,0.8571428571428571,0,1,0,1.3243243243243243,0,0,3,0,-0.838091031497532,0.11786246365278161,-0.36011428392237516,5,1,5,1,1,1,2,1,2,1.889822365046136,1.1428571428571428,0,1.5,-0.6331575415043005,5,5,5,5,4,3,2,7,6,5,4,1.2149857925879117,4.428571428571429,0,1.5714285714285714,2.5,3.8333333333333335,3.2559414990859232,-1.0219528370065065,0,-1.00475696650735,1,1,2,2,2,2,5,3,2,5,2,5,2,4,5,1,5,3,4,3,1.4040757000349275,1.6,0,4.2,0,4.6,0,3.8,0,4.2,0,3,2,3,2,2,2,2,3,1,1,3,2,1,2,1,3,1,2,1,2,0.7591546545162482,1.95,0,"White, Caucasian, Anglo, European American",0,18,0,1,NA,1,4,3,Student,5,0,150,71,2,5,2,0,0,0,0,0,TRUE,TRUE,TRUE,TRUE,TRUE,5,0.9109355555521117,0.9,0.04429785959233874,5,0.45922258064535354,0.5857593750013038,1,1,0.0026149324731457686,0.006187497973802546,5,0.5671968750013039,0.6735033333331346,1,1,0.0033857474093361146,0.006313238265023018,1.3433,1.6398,0.5879,0,2.0861,0.004,ML,change,50,7.563869016284437,1.7796923977271475,1.2346091831050714,0.6334473368730196,3.5584,7.2293,0.3396,8.3279,0.2456,0,-89.3323,0.008,ML,cueing,63,191.0940041791746,4.09669589718298,1.0113356788919787,0.4661835676292825,5.080978705580926,0.8154206042707344,0.3814876838704853,0.09,0.431,0.66,0.016,1.744,74.69082066276533,1875.1027436598126,0.092,0.434,0.751,0.017,1.891,76.53293306387961,1859.224329586732,338,1.0014814814814814,1,0,0,1,FALSE,FALSE,FALSE
309,2021-11-13T03:08:35Z,2021-11-13T03:28:15Z,1179,1,2021-11-13T03:28:16Z,0.8999999761581421,Chrome,95.0.4638.69,Windows NT 10.0,1536,864,NA,1.7777777777777777,605,57,293,60,54,71,-0.4732755257559832,-0.2980192765845384,-0.6475371664809406,-0.5432864894683475,-0.24785955648129604,-0.5806677524151392,2,1,4,3,2,4,4,2,3,2,1,4,3,3,1,1,4,4,1,1,1.2354415362426845,1,1,1,3,2,3.6,0,2,3,4,3,3,5,2,5,5,4,5,2,1,2,3,3,3,1,1,2,4,4,3,1,2,0,1,3,3,2,4,4,5,5,5,2,1,5,4,1,3,3,5,2,2,5,5,5,2,2,5,1,1,1,1,2,2,3,3,2,2,1,1,2,1,2,1,2,1.5002502293786697,1.3345232785352157,2.625,0,1.5,0,3.8,0,2.3333333333333335,0,2.75,0,2.1666666666666665,0,2,0,1.3333333333333333,0,2.3513513513513513,0,1,0,1,0.9140055737553562,-0.20089624114783355,0.3565546663037613,4,2,3,1,2,3,1,1,4,1.1126972805283737,2,0,2.5,0.24863324420094737,5,4,5,5,3,2,1,6,7,4,3,1.618347187425374,4.142857142857143,0,1.8571428571428572,2.5,3.8333333333333335,3.2559414990859232,-1.0219528370065065,0,-0.8454149716644763,2,3,2,2,2,2,5,2,1,3,1,5,2,3,3,1,4,1,4,2,1.4040757000349275,2.2,0,4.6,0,4.2,0,3.8,0,4.2,0,3,2,4,2,2,4,4,1,1,3,2,2,2,4,1,2,3,4,2,2,1.0513149660756937,2.8,0,"White, Caucasian, Anglo, European American",0,18,1,2,NA,1,3,4,Student: Nursing,4,0,119,64,3,5,1,0,0,1,1,0,TRUE,TRUE,TRUE,TRUE,TRUE,5,0.8634617647072848,0.6938775510204082,0.206203610161646,5,0.4390249999985099,0.5169333333412807,1,0.9375,0.002462215485776856,0.00434671797484707,5,0.5718468750044704,0.6741107142652784,1,0.9032258064516129,0.00659404386180696,0.008098450727860309,1.398,0.5971,0.4435,0,33.3388,0.004,ML,change,49,-55.00213910566812,0.5311692586314968,1.5405829878450497,0.3011467361669822,1.269,3.495,0.3515,5.1354,0.3155,0,-77.3319,0.009,ML,cueing,64,167.14044925007903,3.6304194990138585,0.7459331357816378,0.42704131204921986,5.157995747607299,0.8032450837737619,0.363594182198127,0.07,0.4,0.428,0.007,1.37,167.32891783356675,2039.807015043569,0.071,0.398,0.447,0.007,1.403,185.33277229504887,2047.498055743886,392,1.1614814814814816,1,0,0,1,FALSE,FALSE,FALSE
310,2021-11-13T02:54:02Z,2021-11-13T03:28:18Z,2055,1,2021-11-13T03:28:19Z,1,Chrome,95.0.4638.69,Windows NT 10.0,1920,1080,All instructions given were clear.,1.7777777777777777,1228,45,453,78,48,90,1.1274401261853184,-0.40703613634272556,0.12274109500289762,-0.3239311718555635,-0.3307319143023651,-0.2597317839589309,4,3,2,2,3,1,2,3,1,4,4,2,3,1,3,3,2,1,3,4,1.050062654772261,0,1,1,4,5,1.65,0,1,2,4,2,4,5,2,5,3,4,4,1,2,1,2,5,4,1,3,5,5,5,5,7,2,3,0,3,3,2,4,2,4,2,3,2,3,3,4,4,3,4,4,4,4,4,4,4,1,3,1,1,5,3,4,5,3,3,4,2,2,3,5,3,1,2,4,4,1.0759450067999097,1.424279266355945,4.125,0,2.75,0,4.133333333333334,0,3.2222222222222223,0,3.5833333333333335,0,2.8333333333333335,0,2.857142857142857,0,3.6666666666666665,0,3.2972972972972974,0,4,3,0,2.108396917740587,1.2438371697078117,1.6761170437241995,2,4,1,4,3,4,4,7,3,1.2149857925879117,4,0,5,2.367643023308923,3,3,3,3,1,1,5,4,3,1,1,1.3801311186847085,2.142857142857143,0,3.857142857142857,5.5,3.8333333333333335,3.2559414990859232,0.6723373927674386,0,1.1171241071226108,3,2,5,3,3,3,4,2,2,3,2,4,2,3,3,1,4,2,3,3,0.8837151016885368,3.2,0,3.8,0,3.8,0,3.4,0,3.6666666666666665,0,1,2,1,3,2,1,2,3,1,1,3,4,2,2,2,4,1,1,1,2,0.998683343734455,1.55,0,"Black or African American & White, Caucasian, Anglo, European American",1,26,0,1,NA,1,1,4,Content Creator,2,0,260,71,3,5,2,0,0,0,0,0,TRUE,TRUE,TRUE,TRUE,TRUE,5,1.0415558139534538,0.86,0.15114166529012005,5,0.5252968749993016,0.5793093750004191,1,1,0.024177224829085665,0.011802774425356306,5,0.6247624999999534,0.676853124999674,1,1,0.017007497257968997,0.008331142570574858,1.5793,1.1427,0.6001,0,27.7105,0.004,ML,change,50,-43.68493098371556,1.1416495581494361,1.590058835200492,0.5401574850301311,2.5298,4.3084,0.2857,3.9387,0.2041,0,-45.9801,0.01,ML,cueing,64,104.436849250079,3.485912387225518,1.1885366773916846,0.41415965545459826,2.9138076695194126,1.4218971175523327,0.2889286947933627,0.117,0.372,0.496,0.022,1.674,25.897867495358366,1820.7178553543106,0.124,0.375,0.52,0.025,1.77,37.51405112991736,1821.0414080133332,376,1.114074074074074,1,0,2,3,FALSE,FALSE,FALSE
311,2021-11-13T03:07:07Z,2021-11-13T03:29:01Z,1313,1,2021-11-13T03:29:01Z,0.8999999761581421,Chrome,95.0.4638.69,Windows NT 10.0,1920,1080,no,1.7777777777777777,779,44,255,64,43,74,-0.02620566470014611,-0.4161208746559078,-0.8304782535833521,-0.4945408633321733,-0.39979221248658925,-0.5299936521325801,4,4,2,2,3,1,3,3,1,4,3,2,3,2,4,4,1,2,3,3,1.0310954828418375,0,1,3,3,2,1.7,0,2,4,3,5,2,2,4,3,2,2,3,4,2,4,3,2,2,1,1,1,1,2,2,1,2,0,0,4,2,5,5,5,4,4,5,5,2,5,4,1,4,2,5,3,5,4,5,5,5,1,1,1,3,1,1,1,3,1,4,2,3,1,1,1,1,2,1,1,1.6562739034481113,1,1.5,0,1.25,0,2.3333333333333335,0,1.6666666666666667,0,2.9166666666666665,0,1.1666666666666667,0,1.7142857142857142,0,1,0,2,0,1,0,0,-0.3507522618892957,-0.4557470907642554,-0.40324967632677555,5,1,4,1,1,1,1,1,1,1.7320508075688772,1.1428571428571428,0,1,-0.8176513788914915,5,5,5,5,3,3,1,3,7,NA,3,1.5735915849388864,4.428571428571429,0,1.5714285714285714,4,3.8333333333333335,3.2559414990859232,-0.1748077221195339,0,-0.5811844090638635,3,3,3,4,4,4,3,4,3,3,2,4,5,3,4,1,4,3,5,4,1.0600988273786194,3.4,0,3.4,0,3.4,0,2.8,0,3.2,0,1,4,1,3,4,1,2,3,1,1,3,4,3,2,2,4,1,1,2,3,1.1742858972247996,1.9,0,"White, Caucasian, Anglo, European American",0,19,1,2,NA,1,4,3,delivery driver,6,0,95,61,2,5,2,0,0,3,0,0,TRUE,TRUE,TRUE,TRUE,TRUE,1,0.7717128205146545,0.78,0.10630283469337262,1,0.5292156250011176,0.6020625000046567,1,1,0.006528046521960115,0.004786463064511374,1,0.6494064516117496,0.8152709677392437,1,1,0.021320862624439496,0.02116500612797852,1.6183,0.8387,0.2515,0,36.7981,0.003,ML,change,50,-61.86013098371556,0.929937262322674,1.3610233986861247,0.36191468996089265,10,10.0736,0.1059,9.449,0,0,-76.7252,0.012,ML,cueing,64,165.92704925007902,4.368263385453113,0.9484626637186558,0.49689219267643453,4.042189635544184,1.024972873602888,0.40639327364833133,0.189,0.35,0.687,0.005,1.172,33.679385183068234,1833.355688460512,0.199,0.349,0.715,0.005,1.232,43.87437058026434,1827.0013832098984,304,0.9007407407407407,1,0,0,1,FALSE,FALSE,FALSE
312,2021-11-13T03:07:03Z,2021-11-13T03:29:19Z,1335,1,2021-11-13T03:29:20Z,1,Chrome,95.0.4638.54,Macintosh,1792,1120,Nope!,1.6,711,58,321,62,42,83,-0.2009226218943813,-0.2889345382713561,-0.5127384707212689,-0.5189136764002604,-0.4136042721234341,-0.3779713512849024,2,1,3,4,1,1,2,1,1,3,1,2,3,3,1,1,2,1,1,2,0.9514531821875089,0,0,4,2,2,2.9,0,2,3,3,3,4,3,3,3,2,3,4,3,3,3,2,4,4,5,4,3,3,3,5,1,2,3,1,4,3,2,4,4,5,5,5,5,4,4,5,1,5,3,4,5,5,5,5,5,1,3,1,1,3,4,5,2,1,1,4,2,2,1,3,2,2,2,2,2,1.5314520382125407,0.5936168397046637,3.875,0,2,0,3.2,0,1.8888888888888888,0,3.5833333333333335,0,2.6666666666666665,0,2,0,2,0,2.6486486486486487,0,1,3,1,1.3211052490229314,0.5758057870657198,0.9484555180443256,3,3,1,1,1,4,1,1,1,1.2909944487358056,2.5714285714285716,0,1,0.03702047265995151,2,4,5,5,2,2,2,5,5,3,3,1.4638501094227998,3.4285714285714284,0,2.5714285714285716,4,3.8333333333333335,3.2559414990859232,-0.1748077221195339,0,-0.023487427113806164,2,2,1,1,1,1,4,1,1,3,3,4,1,3,5,5,3,2,3,1,1.4474937289114918,1.4,0,3.8,0,3.2,0,4.6,0,3.8666666666666667,0,2,3,3,1,4,2,4,1,4,2,3,2,1,4,1,1,2,3,4,4,1.190974832912761,3.05,0,"White, Caucasian, Anglo, European American",0,19,1,4,Genderfluid,1,3,4,None.,3,0,125,66,1,5,2,0,0,0,0,0,TRUE,TRUE,TRUE,TRUE,TRUE,5,1.2856228571210588,0.7,0.18685730640114273,5,0.48943750001490116,0.5942937500923872,1,1,0.004284952741586085,0.005790583178998846,5,0.676056249961257,0.8540419354131145,1,1,0.006764476087249209,0.021655834511173522,1.834,0.4842,0.5308,0,58.8045,0.004,ML,change,50,-105.87293098371556,0.5624313766105458,1.506491094955239,0.7499162242393713,6.3659,8.151,0.2038,9.2456,0.1452,0,-81.3149,0.012,ML,cueing,64,175.106449250079,4.165162198667879,0.9947114971216747,0.47861677079674125,4.490823485990329,0.9225779501947797,0.38992931493043426,0.118,0.461,0.535,0.006,1.248,23.318207785751515,1810.928209938539,0.118,0.461,0.539,0.006,1.261,34.844630508839145,1817.167420015618,447,1.3244444444444445,1,0,1,2,FALSE,FALSE,FALSE
313,2021-11-13T03:02:05Z,2021-11-13T03:30:21Z,1695,1,2021-11-13T03:30:22Z,1,Chrome,92.0.4515.162,CrOS x86_64 13982.88.0,1366,768,NA,1.7786458333333333,814,87,444,98,63,112,0.06372218091453376,-0.025477127189070508,0.07941294279443173,-0.08020304117469244,-0.12355101974969247,0.11187828477983676,2,3,2,2,2,1,1,2,1,2,2,1,1,1,1,2,1,1,1,2,0.6048053188292994,0,1,2,4,3,2.15,0,2,4,1,2,1,1,5,1,1,1,1,4,4,4,4,1,3,1,1,1,1,1,1,3,2,0,1,3,3,5,4,4,4,4,4,4,1,4,1,1,5,5,5,1,1,2,2,2,5,1,1,1,1,1,1,4,1,1,5,1,2,1,1,1,1,1,1,1,1.6265440804496034,1.5491933384829668,1.25,0,1,0,1.8666666666666667,0,2.111111111111111,0,1.6666666666666667,0,0.8333333333333334,0,1.4285714285714286,0,1,0,1.5945945945945945,0,2,0,1,-0.832961149712182,-0.1546061727857994,-0.49378366124899076,5,1,4,1,1,1,1,1,1,1.7320508075688772,1.1428571428571428,0,1,-0.8176513788914915,4,3,4,4,3,3,2,4,6,3,3,0.7559289460184544,3.5714285714285716,0,2.4285714285714284,4,3.8333333333333335,3.2559414990859232,-0.1748077221195339,0,-0.10315842453524313,1,2,1,4,2,2,3,1,1,1,1,2,2,4,5,3,4,3,3,3,1.245945806357946,2,0,3.6,0,2.8,0,4.4,0,3.6,0,2,1,2,3,1,1,3,3,1,1,2,4,2,1,1,4,1,1,1,1,1.0563093645728086,1.4,0,"Hispanic of Latino (e.g., Mexican American, Central American, and others)",0,2,1,2,NA,1,4,6,stay at home mom,5,0,133,66,4,5,2,0,0,0,0,0,TRUE,TRUE,TRUE,TRUE,TRUE,3,0.9181697674418778,0.86,0.08630887171019286,3,0.5733633333333147,0.6745062499999768,1,1,0.016716961712608214,0.022460703185473968,3,0.9517125000000087,1.0053031250000348,1,1,0.1813966566128481,0.08732176160280454,1.4922,1.2153,0.4659,0,21.8917,0.02,ML,change,50,-32.04733098371556,1.3133032041793729,1.382232191973175,0.5392750936705806,1.5414,3.7552,0.4693,3.4383,0.3492,0,-53.1599,0.01,ML,cueing,62,118.70120315513527,2.9679505256027623,1.3959581504648235,0.4466833050760294,3.195384744326314,1.296599645394199,0.3768172196445152,0.15,0.324,0.252,0.017,1.57,42.784142432783185,1838.1861808066867,0.138,0.341,0.246,0.014,1.713,54.33017622437001,1833.847045301636,358,1.0607407407407408,1,0,0,1,FALSE,FALSE,FALSE
314,2021-11-13T03:11:08Z,2021-11-13T03:31:12Z,1203,1,2021-11-13T03:31:14Z,1,Chrome,94.0.4606.81,Macintosh,1440,900,NA,1.6,688,45,270,59,46,62,-0.2600180632983138,-0.40703613634272556,-0.7582646665692423,-0.555472896002391,-0.3583560335760547,-0.732690053262817,3,3,2,2,3,3,3,2,1,2,2,3,2,3,2,2,3,2,2,2,0.5871429486123998,0,1,2,4,3,2.55,0,4,4,2,4,2,2,4,2,2,2,2,5,3,4,4,1,2,1,1,1,1,2,1,0,2,0,0,5,4,4,4,5,5,4,4,5,1,5,1,1,5,1,5,2,1,1,1,3,4,1,1,1,2,1,1,1,1,1,4,2,2,1,1,1,2,1,1,1,1.6769950245341554,1.0997835284835873,1.25,0,1.25,0,2,0,1.5555555555555556,0,1.25,0,1.1666666666666667,0,1.2857142857142858,0,1,0,1.3513513513513513,0,0,0,0,-0.8801947782263467,-0.6588395645607719,-0.7695171713935594,4,1,3,1,1,2,1,1,1,1.2149857925879117,1.5714285714285714,0,1,-0.5612498234260587,5,4,5,5,3,3,2,4,3,NA,2,1.2149857925879117,4.142857142857143,0,1.8571428571428572,5.5,3.8333333333333335,3.2559414990859232,0.6723373927674386,0,0.0017301432224963165,4,3,4,5,4,4,4,3,4,3,3,3,3,3,3,3,3,2,4,3,0.560611910581388,4,0,3,0,3.4,0,2.8,0,3.066666666666667,0,2,3,4,2,4,4,3,2,3,3,4,2,2,4,1,2,3,4,4,4,0.9733285267845752,3.2,0,"White, Caucasian, Anglo, European American",0,20,1,2,NA,1,3,4,student,5,0,115,65,2,5,2,0,0,1,0,0,TRUE,TRUE,TRUE,TRUE,TRUE,2,0.6872411764772499,0.68,0.024590879689440574,2,0.43176206897250535,0.4977551724150263,0.90625,0.9666666666666667,0.008537080483751585,0.008778100644359495,2,0.6355343749988824,0.7766999999942451,1,0.9354838709677419,0.010349117167627118,0.03064303045075285,1.1975,0.6807,0.3863,0,15.4868,0.004,ML,change,50,-19.237530983715565,0.8365763690198805,0.9010197159399652,0.4933753742920825,0.9499,3.773,0.3781,2.4244,0.2676,0,-59.6332,0.009,ML,cueing,62,131.64780315513528,3.423662441789247,0.9835361655066336,0.3636930235592456,2.7445166519610034,0.8266240759360493,0.30940317178415205,0.067,0.474,0.363,0.013,1.624,39.76035259074216,1889.5789953873973,0.069,0.476,0.398,0.015,1.751,43.35505343002502,1887.383715822732,429,1.271111111111111,1,0,0,1,FALSE,FALSE,FALSE
315,2021-11-13T03:05:22Z,2021-11-13T03:33:23Z,1680,1,2021-11-13T03:33:25Z,1,Chrome,95.0.4638.69,Macintosh,1792,1120,Fun study!,1.6,695,69,504,105,83,162,-0.2420324941753778,-0.18900241682635124,0.36826729085087107,0.0051018045636124325,0.15269017298720433,0.9564466228224905,4,3,1,2,3,1,1,3,1,3,3,1,1,1,4,3,1,1,4,3,1.1964860832322377,0,1,1,4,3,1.4,0,2,5,3,5,3,1,4,2,2,1,2,5,3,4,5,2,4,1,1,2,4,2,2,9,2,0,0,5,5,5,5,5,5,5,5,5,1,4,2,1,5,2,5,2,2,2,3,3,4,1,1,1,3,1,1,5,5,1,5,1,2,1,1,1,1,2,4,4,1.7638342073763937,1.4573295865416045,2.25,0,2.75,0,1.9333333333333333,0,1,0,1.8333333333333333,0,1.3333333333333333,0,2.142857142857143,0,1,0,1.5945945945945945,0,5,0,0,-0.3745626565911081,0.8270300207252568,0.22623368206707434,5,2,4,1,1,1,1,2,2,1.6761634196950514,1.2857142857142858,0,2,-0.3631965189619651,5,5,5,5,4,4,1,3,8,6,4,1.4638501094227998,4.714285714285714,0,1.2857142857142858,3.5,3.8333333333333335,3.2559414990859232,-0.4571894270818581,0,-0.881717256387899,2,2,2,3,2,2,3,1,1,2,1,4,3,5,4,2,5,2,3,3,1.3345232785352157,2.2,0,4.4,0,3,0,4.4,0,3.933333333333333,0,1,1,1,4,1,1,1,4,1,1,1,4,1,1,1,4,1,1,1,1,1.231174022502185,1,0,"White, Caucasian, Anglo, European American",0,30,1,2,NA,0,4,6,Performance Marketing Manager,6,0,158,71,3,5,2,0,0,1,0,0,TRUE,TRUE,TRUE,TRUE,TRUE,1,0.9717444444451895,0.72,0.06831872524067656,1,0.5700062499986962,0.6713806451616748,1,1,0.005166227056489258,0.014952056946201392,1,0.7176031249989756,0.8561709677418393,1,1,0.006336608054621669,0.018011179462681673,1.3144,0.7398,0.614,0,25.1982,0.004,ML,change,50,-38.66033098371556,0.7997815349762168,1.1808994925957335,0.6469083773324535,2.685,4.6329,0.3816,6.1406,0.3514,0,-65.9633,0.032,ML,cueing,63,144.3560041791746,3.2857707466852153,1.2609323795859013,0.4854991067195671,4.285673897893655,0.9667405465515755,0.46074339813634035,0.108,0.485,0.427,0.01,1.46,62.57420255381062,1866.1111369440184,0.109,0.486,0.438,0.012,1.54,74.07381289501916,1856.6318763827112,382,1.1318518518518519,1,0,0,1,FALSE,FALSE,FALSE
316,2021-11-13T03:00:33Z,2021-11-13T03:33:33Z,1979,1,2021-11-13T03:33:34Z,1,Chrome,95.0.4638.69,Windows NT 10.0,1600,900,"The mood-oriented questions (regarding crying spells, etc) are currently affected by my pregnancy. 

Thank you!",1.7777777777777777,863,100,553,95,65,99,0.1896211647750856,0.09262447088229891,0.6041650084302965,-0.11676226077682311,-0.09592690047600279,-0.10770948311125321,4,4,1,2,4,1,1,4,1,4,2,1,1,2,4,4,1,1,4,4,1.4327007988227578,0,1,2,2,2,1.2,0,3,5,2,3,2,3,3,3,3,3,2,3,2,3,3,3,3,5,1,3,3,3,3,1,2,1,0,4,4,3,5,4,5,5,5,4,1,5,4,3,4,2,5,1,4,4,4,4,3,1,1,2,1,1,1,3,3,2,4,2,2,1,1,3,2,2,2,2,1.4529663145135578,0.7432233529572065,3,0,2,0,2.6,0,1.6666666666666667,0,2.5833333333333335,0,1.3333333333333333,0,2,0,1.6666666666666667,0,2.027027027027027,0,1,1,0,0.4200850690262941,-0.01391027501950836,0.20308739700339287,4,1,3,1,1,2,2,3,1,1.1547005383792515,1.7142857142857142,0,2,-0.10679496349653231,5,5,5,5,5,5,1,6,4,NA,4,1.5118578920369088,5,0,1,4,3.8333333333333335,3.2559414990859232,-0.1748077221195339,0,-0.8998683987496106,3,3,2,2,3,2,3,3,2,2,1,4,3,3,4,3,5,1,4,5,1.2535663410560174,2.6,0,4.6,0,3,0,3,0,3.533333333333333,0,2,1,1,3,2,1,2,4,1,2,2,4,3,1,1,4,2,2,1,2,1.050062654772261,1.55,0,"White, Caucasian, Anglo, European American & Native American/Alaskan Native/indigenous",1,30,1,2,NA,1,1,3,freelance,2,0,115,62,1,5,2,1,1,0,0,2,TRUE,TRUE,TRUE,TRUE,TRUE,6,0.8168595238129298,0.84,0.030728582383561645,6,0.44186562499869614,0.4968656250014901,1,1,0.0013731474897763262,0.0020180603930500156,6,0.5972906249994412,0.6742931034513588,1,0.90625,0.006378107973399765,0.01261604286291184,1.6207,1.2372,0.3896,0,20.2219,0.004,ML,change,50,-28.707730983715564,1.5856097735743444,1.0457983447374248,0.5926105042012626,3.2942,9.4173,0.322,10.4566,0.2844,0,-116.3694,0.021,ML,cueing,64,245.21544925007902,5.420994349925029,0.7642757876050602,0.42857629268991504,5.968747369574299,0.69413806111332,0.3855350245337372,0.062,0.441,0.399,0.011,1.404,68.4207096429746,1984.4108958686504,0.063,0.442,0.399,0.013,1.493,88.46288981355403,1975.0491840782138,444,1.3155555555555554,1,0,0,1,FALSE,FALSE,FALSE
317,2021-11-13T03:11:40Z,2021-11-13T03:34:14Z,1353,1,2021-11-13T03:34:15Z,1,Chrome,95.0.4638.69,Macintosh,1920,1080,NA,1.7777777777777777,773,47,293,75,46,62,-0.041621866805519804,-0.38886665971636103,-0.6475371664809406,-0.3604903914576942,-0.3583560335760547,-0.732690053262817,2,2,3,2,2,2,2,2,1,2,2,1,1,1,2,2,2,2,2,2,0.4893604849295929,0,1,2,2,1,2.35,0,4,5,3,3,4,1,4,2,2,1,2,4,1,3,1,1,1,1,1,1,1,1,1,0,2,0,0,3,5,3,4,2,5,5,5,5,1,4,5,1,3,1,4,1,1,2,2,3,3,1,1,1,3,3,1,1,1,1,5,2,2,1,1,2,2,2,2,2,1.5382998298011887,1.3451854182690985,1,0,2,0,2.2666666666666666,0,1.8888888888888888,0,2,0,1.8333333333333333,0,1.1428571428571428,0,1.3333333333333333,0,1.7837837837837838,0,0,0,0,-0.687195074830354,-0.4236359564090485,-0.5554155156197013,4,2,4,2,2,2,2,3,1,0.9759000729485332,2,0,2,0.06413940681375631,5,5,5,5,4,3,2,6,6,5,4,1.2149857925879117,4.428571428571429,0,1.5714285714285714,3,3.8333333333333335,3.2559414990859232,-0.7395711320441822,0,-0.8635661140261877,2,2,2,2,2,2,4,2,1,4,1,3,2,4,4,3,3,1,3,2,1.121223821162776,2,0,4,0,3.6,0,4.2,0,3.933333333333333,0,1,4,4,2,4,4,4,2,1,3,4,2,1,4,1,3,3,4,3,4,1.2096106376585989,3,0,"White, Caucasian, Anglo, European American",0,22,1,2,NA,1,4,7,Student,1,0,117,66,1,5,2,0,0,2,0,0,TRUE,TRUE,TRUE,TRUE,TRUE,6,0.8570936170201352,0.94,0.04564437761573103,6,0.429421874997206,0.5188571428571429,1,0.875,0.0031981624091378825,0.007024682540192432,6,0.5298343749972991,0.6598964285712157,1,0.875,0.003401311360868272,0.007040710282434143,1.5339,1.9735,0.5102,0,-3.7278,0.004,ML,change,50,19.191669016284436,2.0355747639578006,1.3517240249589721,0.5649114866887741,1.015,2.324,0.3519,4.5729,0.3184,0,-67.5446,0.006,ML,cueing,64,147.56584925007903,2.588892534679659,0.7516380548782005,0.40998268522570547,4.831559873768022,0.8575149298854486,0.3434540292051315,0.062,0.43,0.561,0.012,1.787,81.8523975388894,1963.0637870144674,0.065,0.428,0.652,0.013,1.85,79.44432117381038,1941.242657618538,308,0.9125925925925925,1,0,0,1,FALSE,FALSE,FALSE
318,2021-11-13T02:40:07Z,2021-11-13T03:34:47Z,3280,1,2021-11-13T03:34:48Z,0.8999999761581421,Chrome,95.0.4638.69,Windows NT 10.0,1536,864,NA,1.7777777777777777,867,379,293,47,26,179,0.1998986328453347,2.6272664602601505,-0.6475371664809406,-0.7017097744109136,-0.6345972263129516,1.2435998577569927,4,4,1,1,4,1,1,3,1,4,3,1,1,1,3,4,2,1,4,3,1.348488432516786,0,1,2,4,4,1.25,0,4,4,2,4,2,4,3,4,5,4,2,3,4,4,5,3,4,3,4,3,4,4,3,5,2,0,0,4,3,4,3,3,4,2,4,2,4,3,4,3,4,3,4,3,4,3,3,3,4,2,4,4,4,2,4,4,2,2,2,4,3,2,2,2,2,2,2,3,0.8337836621061816,0.9856107606091623,3.5,0,2.25,0,2.8,0,2.7777777777777777,0,3.0833333333333335,0,2.8333333333333335,0,3.142857142857143,0,2,0,2.945945945945946,0,3,0,0,1.115813187386572,0.2640426676977418,0.6899279275421569,4,2,3,3,4,2,4,1,1,0.8997354108424374,2.857142857142857,0,1,0.20795484297024003,2,3,4,2,4,3,3,4,3,1,2,0.816496580927726,3,0,3,5.5,3.8333333333333335,3.2559414990859232,0.6723373927674386,0,0.6390981225939902,1,3,1,3,2,2,3,2,3,4,4,2,3,4,2,4,4,2,3,2,0.8837151016885368,2,0,3.2,0,3,0,3.4,0,3.2,0,1,2,1,2,2,1,3,1,2,1,NA,3,2,1,1,4,1,2,1,2,0.8719139396343282,1.736842105263158,1,"White, Caucasian, Anglo, European American",0,30,0,1,NA,1,3,4,retail,2,0,180,65,3,5,2,0,0,1,0,0,TRUE,TRUE,TRUE,TRUE,TRUE,1,0.9782375000000466,0.6530612244897959,0.06616675444728623,1,0.7440741935486515,0.7538093750003027,1,1,0.3946244986452445,0.37453095571599065,NA,NA,NA,NA,NA,NA,NA,1.3946,0.4725,0.5241,0,34.577,0.004,ML,change,49,-57.47853910566812,0.5525235867417705,1.144788338310575,0.6611058715084144,1.9063,2.1032,0.3007,1.681,0.177,0,10.5288,0.005,ML,cueing,63,-8.628195820825404,1.4687252616028519,2.8209051990227496,-0.17650481751619862,1.4496610943538901,2.8580022893130868,-0.21086959591893106,NA,NA,NA,NA,NA,NA,NA,NA,NA,NA,NA,NA,NA,NA,216,0.64,1,0,1,2,FALSE,FALSE,FALSE
319,2021-11-13T02:57:23Z,2021-11-13T03:34:49Z,2245,1,2021-11-13T03:34:50Z,1,Chrome,95.0.4638.69,Windows NT 10.0,1366,768,I'm interested in the results of the research and I wish you all the best!,1.7786458333333333,655,58,386,76,59,98,-0.34480717487786905,-0.2889345382713561,-0.19981292699345962,-0.3483039849236506,-0.17879925829707183,-0.12460084987210628,2,2,3,2,2,1,1,3,1,2,3,1,2,1,2,4,1,1,3,3,0.9176629354822471,0,1,1,4,4,1.9,0,1,3,3,3,5,2,1,3,2,2,3,3,2,4,3,5,4,4,3,4,4,4,4,9,3,0,0,5,4,3,3,2,5,4,4,5,5,4,4,1,3,2,5,5,5,4,2,2,3,1,1,1,5,3,3,5,5,5,4,3,3,2,4,2,5,3,5,5,1.365050681609794,1.0465362369445672,4,0,4.5,0,3.066666666666667,0,2.111111111111111,0,3,0,2.1666666666666665,0,3.5714285714285716,0,2.6666666666666665,0,2.7837837837837838,0,5,0,0,1.375598144214478,1.3758384397459444,1.3757182919802111,4,3,2,2,3,3,2,2,1,0.7559289460184544,2.7142857142857144,0,1.5,0.3069814952022868,3,3,3,4,1,1,5,5,7,NA,2,1.4638501094227998,2.2857142857142856,0,3.7142857142857144,3,3.8333333333333335,3.2559414990859232,-0.7395711320441822,0,0.33149884729536355,1,2,1,2,1,1,3,1,1,3,1,5,3,5,2,2,5,2,2,3,1.4540583599999397,1.4,0,4.8,0,3,0,4,0,3.933333333333333,0,2,1,2,3,1,2,2,3,1,1,1,3,1,1,1,3,3,2,2,2,0.812727700887249,1.65,0,"Hispanic of Latino (e.g., Mexican American, Central American, and others)",0,25,1,2,NA,1,3,4,ESL Teacher,2,0,150,61,2,5,2,0,0,1,0,0,TRUE,TRUE,TRUE,TRUE,TRUE,2,0.9187676470630309,0.6938775510204082,0.10811019541619234,2,0.41706874999031424,0.4642225806636195,1,0.96875,9.093957663045292e-4,0.002217717489493758,2,0.5358124999776482,0.6472586206814338,1,0.90625,0.0026997559685179107,0.008268486087062809,1.4629,0.5691,0.4661,0,38.291,0.012,ML,change,49,-64.90653910566812,0.6242238175874992,1.3109245441427688,0.5116078543251981,1.1695,4.9951,0.3542,7.3114,0.3371,0,-110.7699,0.006,ML,cueing,64,234.01644925007903,4.875108227441098,0.7043919938342817,0.39649408486299803,6.616438230144859,0.6261880761638764,0.37122688782193775,0.079,0.388,0.52,0.012,1.659,89.54981118478575,1959.0648328238012,0.079,0.39,0.582,0.012,1.741,100.1844445433413,1957.8492672196976,384,1.1377777777777778,1,0,0,1,FALSE,FALSE,FALSE
320,2021-11-13T03:15:23Z,2021-11-13T03:35:16Z,1193,1,2021-11-13T03:35:17Z,1,Chrome,95.0.4638.69,Windows NT 10.0,1423,800,Love you,1.77875,831,63,129,24,19,76,0.10740142021309255,-0.24351084670544482,-1.4370723845018747,-0.9819971246939154,-0.7312816437708655,-0.4962109186108739,2,2,3,2,3,2,1,2,1,2,2,1,1,2,3,2,1,1,2,2,0.6708203932499369,0,1,4,3,2,2.15,0,2,3,2,3,2,2,2,3,2,2,2,3,2,3,3,3,2,3,3,2,3,2,4,2,4,1,1,2,2,3,2,3,2,3,2,3,3,2,2,3,2,3,2,3,2,3,2,2,2,2,2,3,2,3,2,2,3,2,3,2,2,2,2,3,3,2,2,3,0.4916723926983716,0.50709255283711,2.75,0,2.5,0,2.6666666666666665,0,3.5555555555555554,0,2.9166666666666665,0,2.5,0,2.142857142857143,0,2.3333333333333335,0,2.864864864864865,0,1,1,1,0.7013574552192497,0.3193417773141546,0.5103496162667022,2,3,2,3,2,2,3,2,1,0.5345224838248488,3,0,1.5,0.47791586551257526,2,3,2,2,3,2,3,3,3,2,2,0.5345224838248488,2.4285714285714284,0,3.5714285714285716,6,3.8333333333333335,3.2559414990859232,0.9547190977297628,0,1.0989729647608995,2,3,2,3,3,2,2,3,2,3,2,2,3,2,2,3,3,2,3,3,0.5163977794943222,2.6,0,3.4,0,2.8,0,2.8,0,3,0,2,2,1,2,2,2,2,2,2,1,2,2,2,3,2,2,1,2,2,2,0.44721359549995793,2.1,0,"Hispanic of Latino (e.g., Mexican American, Central American, and others)",0,22,0,1,NA,1,2,4,Retail,2,0,200,66,2,5,2,0,0,2,0,0,TRUE,TRUE,TRUE,TRUE,TRUE,6,0.9770374999996274,0.6808510638297872,0.32631797780864197,6,0.8569500000004967,0.8223866666654746,0.967741935483871,0.9375,0.2730501838074792,0.1243167231844293,6,0.8521062499987893,0.9731903225803568,1,0.96875,0.056210338669668965,0.0857983585472962,1.4929,0.4891,0.4946,0,43.3155,0.003,ML,change,47,-75.08055719486983,0.4404704631935588,1.7201736892958512,0.27075803820412003,1.6876,2.0512,0.4494,1.4542,0.2984,0,12.1037,0.007,ML,cueing,63,-11.777995820825403,1.5698739694834878,1.7250112134754354,0.34165227615652927,1.4567800054877122,2.3347364522095266,0.10731440444904361,0.091,0.542,0.306,0.03,1.583,67.89335767258439,1906.7278851881574,0.088,0.547,0.298,0.016,1.716,50.350136449240075,1872.6369036146484,104,0.3081481481481481,1,1,4,5,FALSE,FALSE,FALSE
321,2021-11-13T03:14:49Z,2021-11-13T03:35:18Z,1228,1,2021-11-13T03:35:18Z,1,Chrome,93.0.4577.107,CrOS x86_64 14092.77.0,1366,768,n/a,1.7786458333333333,633,44,300,62,44,92,-0.4013332492642393,-0.4161208746559078,-0.6138374925410226,-0.5189136764002604,-0.3859801528497444,-0.2259490504372247,4,3,1,1,4,1,1,3,1,4,3,1,1,1,4,4,1,1,4,4,1.4244112357114616,0,1,1,2,2,1.15,0,5,5,1,5,1,1,4,1,1,1,1,5,1,5,5,1,1,1,1,1,1,1,1,5,2,0,0,5,5,5,5,5,5,5,5,5,1,5,1,1,5,1,5,1,1,1,1,1,5,1,3,1,3,2,1,3,3,1,5,1,1,1,1,1,1,1,1,1,1.8768384380448209,2.007130147392398,1,0,1,0,1.0666666666666667,0,1,0,1,0,1.6666666666666667,0,1.4285714285714286,0,1,0,1.2432432432432432,0,3,0,0,-1.435189913267782,-0.12796334588846375,-0.7815766295781228,5,1,5,1,1,1,1,1,1,1.9518001458970664,1,0,1,-0.9031185640466358,5,5,5,5,4,3,1,1,5,3,3,1.5275252316519468,4.571428571428571,0,1.4285714285714286,6,3.8333333333333335,3.2559414990859232,0.9547190977297628,0,-0.09609199656065187,1,1,1,2,2,1,4,1,1,3,1,4,1,5,5,1,4,1,3,1,1.6388149028228556,1.4,0,4.6,0,4,0,5,0,4.533333333333333,0,2,1,2,4,1,2,1,4,1,1,1,4,1,1,1,4,1,2,1,1,1.1964860832322377,1.2,0,"White, Caucasian, Anglo, European American",0,26,1,2,NA,1,3,3,analyst,4,0,110,59,3,5,2,0,0,1,0,0,TRUE,TRUE,TRUE,TRUE,TRUE,3,0.7858263157894345,0.76,0.057156888412385885,3,0.6808218749999069,0.765924999999348,1,1,0.3903681733776416,0.27868003806465225,3,0.641268749999581,0.6844375000002328,1,1,0.012215178991864155,0.005156829515985426,1.3162,0.944,0.4422,0,18.0767,0.004,ML,change,50,-24.41733098371556,1.0008316113544242,1.1517217250746763,0.4866274844154198,1.7263,1.9069,0.3134,1.9902,0.2471,0,3.6623,0.006,ML,cueing,64,5.152049250079013,1.581379225038366,2.6199501427565646,-0.03656331545637237,1.4535965841320635,2.850264489899982,-0.26895805525471217,0.191,0.357,0.706,0.017,1.214,80.11399265356917,1884.5001492733652,0.191,0.354,0.698,0.016,1.31,106.3761320432428,1892.2642199754553,428,1.268148148148148,1,0,0,1,FALSE,FALSE,FALSE
322,2021-11-13T03:12:33Z,2021-11-13T03:35:17Z,1363,1,2021-11-13T03:35:18Z,0.8999999761581421,Chrome,95.0.4638.69,Windows NT 10.0,1280,720,This was an interesting survey,1.7777777777777777,742,69,262,84,59,73,-0.12127224434995054,-0.18900241682635124,-0.7967785796434342,-0.2508127326513022,-0.17879925829707183,-0.5468850188934331,2,3,2,2,1,4,3,2,1,2,2,2,1,2,1,2,3,2,1,1,0.8255779474818965,0,1,1,3,2,2.75,0,5,5,3,5,1,1,2,1,1,1,1,4,1,4,4,1,1,1,1,1,1,1,2,0,2,0,0,5,4,5,5,4,5,5,5,3,1,5,1,1,4,2,5,1,1,1,1,4,4,1,1,1,1,1,1,1,1,1,5,1,2,1,1,1,1,1,1,1,1.7735968103392739,1.7237832147426693,1.125,0,1,0,1.5333333333333334,0,1.4444444444444444,0,1.4166666666666667,0,1,0,1,0,1,0,1.2972972972972974,0,0,0,0,-1.1576923457470643,-0.7372407672780129,-0.9474665565125386,5,1,3,1,1,1,1,1,1,1.5735915849388864,1.2857142857142858,0,1,-0.7321841937363471,5,5,5,5,2,2,2,6,8,4,3,1.6035674514745464,4,0,2,2,3.8333333333333335,3.2559414990859232,-1.3043345419688306,0,-0.9069348267242017,2,2,2,3,2,2,3,3,2,3,2,4,2,4,4,3,3,2,3,3,0.7432233529572065,2.2,0,3.8,0,3.2,0,3.6,0,3.533333333333333,0,1,2,3,3,2,3,2,2,2,1,2,2,3,4,1,2,2,2,2,1,0.7880689256524124,2.2,0,"White, Caucasian, Anglo, European American",0,22,1,2,NA,1,3,6,Tutor,4,0,180,71,2,5,2,0,0,1,0,0,TRUE,TRUE,TRUE,TRUE,TRUE,2,0.7693184210626702,0.7916666666666666,0.0373532105306384,2,0.45960666666030886,0.6039709677388592,0.9375,0.96875,0.002760508998038962,0.008432056855650353,2,0.6000500000119209,0.6605516128847676,1,0.96875,0.01166651613450204,0.010742111896200142,1.1593,1.1696,0.4562,0,5.935,0.004,ML,change,48,-0.2563969672763253,1.264273203713396,1.0559434960823368,0.5257132265635075,1.1981,3.2587,0.4305,3.3023,0.2956,0,-57.883,0.008,ML,cueing,64,128.242649250079,3.491221756050153,0.9836061540731919,0.4719067744739083,4.066772565535593,0.6658966434592244,0.38797006126409767,0.08,0.394,0.365,0.07,1.862,155.67256764162116,2007.4699654676867,0.074,0.397,0.36,0.028,2.011,175.3001511556076,2000.893201735321,356,1.0548148148148149,1,0,0,1,FALSE,FALSE,FALSE
323,2021-11-13T03:08:02Z,2021-11-13T03:36:00Z,1677,1,2021-11-13T03:36:01Z,1,Chrome,95.0.4638.69,Macintosh,1440,900,NA,1.6,821,50,396,83,45,214,0.08170775003746973,-0.36161244477681426,-0.15167053565071972,-0.26299913918534573,-0.37216809321289956,1.8347976943868503,4,4,1,1,4,1,1,2,1,4,2,1,1,1,4,4,1,1,3,3,1.3611140947574412,0,1,1,3,2,1.3,0,3,4,2,4,3,2,3,3,2,2,1,3,1,4,3,2,4,5,5,1,3,3,2,2,4,0,4,3,1,3,3,2,3,3,5,3,3,4,1,5,2,1,3,3,5,2,1,1,3,5,5,1,5,1,1,2,2,2,5,1,1,1,1,1,1,3,2,2,1.4831384627537982,0.9759000729485332,3.125,0,2,0,2.2666666666666666,0,3.111111111111111,0,2.5833333333333335,0,3.1666666666666665,0,1.2857142857142858,0,1,0,2.4864864864864864,0,1,0,4,0.5280061669633707,0.4852551049841909,0.5066306359737808,4,2,3,2,2,2,1,1,1,0.9511897312113419,2,0,1,-0.3048482679606258,5,5,5,5,2,2,2,3,1,NA,3,1.6035674514745464,4,0,2,7,3.8333333333333335,3.2559414990859232,1.5194825076544112,0,0.5049736980874192,2,2,2,3,2,2,5,1,1,2,1,3,2,3,4,1,3,1,3,4,1.2983506020002016,2.2,0,4,0,3.8,0,3.8,0,3.8666666666666667,0,1,1,1,3,1,1,1,3,2,1,2,3,3,2,2,2,2,2,2,1,0.7677718959499145,1.7,0,Black or African American,0,24,1,2,NA,1,1,4,Fulfillment Associate,7,0,250,62,2,5,2,0,0,1,0,0,TRUE,TRUE,TRUE,TRUE,TRUE,2,0.9837138888883508,0.7346938775510204,0.19634297623363225,2,0.4752032258070765,0.5442068965519811,1,0.90625,0.008778378989115222,0.008976172258060515,2,0.6195483870965338,0.7535366666669647,1,0.9375,0.01223699458077558,0.014387552863178847,1.6023,0.6379,0.4295,0,44.7849,0.003,ML,change,49,-77.89433910566812,0.658093387135922,1.54775841986116,0.4317414300093031,1.2555,2.8697,0.3551,3.0036,0.2662,0,-45.9855,0.007,ML,cueing,63,104.4004041791746,2.7103190616814308,0.8370540477662123,0.4187407801405571,3.7536944019960856,1.1037485428191374,0.33277602125261874,0.084,0.394,0.356,0.005,1.085,71.35156932847859,1943.5407189587943,0.084,0.394,0.382,0.005,1.153,95.12586714790294,1939.6079425239698,431,1.2770370370370372,1,0,0,1,FALSE,FALSE,FALSE
324,2021-11-13T03:14:41Z,2021-11-13T03:36:01Z,1279,1,2021-11-13T03:36:02Z,1,Chrome,95.0.4638.69,Windows NT 10.0,1280,720,NA,1.7777777777777777,681,52,290,61,49,78,-0.27800363242124976,-0.3434429681504497,-0.6619798838837625,-0.5311000829343039,-0.31691985466552025,-0.4624281850891678,2,2,1,1,2,1,1,2,1,2,2,1,1,1,2,2,1,1,2,2,0.512989176042577,0,1,2,3,2,2,0,4,4,2,3,2,2,3,2,2,2,2,4,2,3,4,2,2,1,1,1,1,2,2,2,2,0,0,4,3,4,4,4,5,5,5,5,2,4,3,1,3,2,4,2,2,2,3,3,4,1,5,1,1,1,2,3,3,3,4,2,2,1,1,1,2,2,2,2,1.364500590641815,0.8837151016885368,1.5,0,2,0,2.2,0,1.6666666666666667,0,2.25,0,1.6666666666666667,0,2.2857142857142856,0,1,0,1.972972972972973,0,1,0,0,-0.4196669002132409,-0.22054348261253207,-0.32010519141288646,4,2,2,1,1,2,2,1,2,1,2,0,1.5,-0.12035443057343476,4,4,4,4,2,2,1,3,3,2,3,1.2909944487358056,3.5714285714285716,0,2.4285714285714284,6,3.8333333333333335,3.2559414990859232,0.9547190977297628,0,0.46160498538940525,3,3,3,3,3,3,4,2,3,3,2,3,3,2,3,2,3,2,3,2,0.6172133998483676,3,0,3.4,0,3.4,0,3.2,0,3.3333333333333335,0,2,2,2,3,2,2,2,2,2,1,3,2,1,2,1,2,1,2,2,2,0.5525062514530825,2,0,"White, Caucasian, Anglo, European American",0,28,1,2,NA,1,3,7,Student,7,0,155,64,2,5,2,0,0,1,0,0,TRUE,TRUE,TRUE,TRUE,TRUE,6,0.5973475000016392,0.8163265306122449,0.015104259685198561,6,0.4814624999985099,0.5587374999942258,1,1,0.004224755967961664,0.006363026935781111,6,0.5948387096783807,0.6998838709698569,1,0.96875,0.024467817117750926,0.01169296963685748,1.0587,1.4779,0.3772,0,-8.4096,0.003,ML,change,49,28.49466089433188,1.7393170813264833,0.8576095139824144,0.4413755699316967,6.5806,7.9214,0.1434,9.3801,0.1307,0,-79.5274,0.013,ML,cueing,64,171.53144925007902,4.068146217298327,1.0184330909184984,0.43747747096280803,4.506735678774626,0.9193205507712501,0.3826557530492636,0.324,0.059,0.607,0.007,1.132,128.63338130948472,1970.3147442258046,0.306,0.076,0.606,0.008,1.247,135.63052368372135,1960.3250944037277,340,1.0074074074074075,1,0,0,1,FALSE,FALSE,FALSE
325,2021-11-13T03:19:57Z,2021-11-13T03:36:32Z,994,1,2021-11-13T03:36:33Z,1,Chrome,94.0.4606.81,Windows NT 10.0,1366,768,No,1.7786458333333333,601,69,147,26,19,73,-0.4835529938262323,-0.18900241682635124,-1.350416080084943,-0.9576243116258283,-0.7312816437708655,-0.5468850188934331,3,3,2,2,3,1,2,2,2,2,1,1,1,2,2,2,1,1,2,2,0.6708203932499369,0,1,3,3,1,2.15,0,3,3,4,4,4,3,4,3,3,2,2,4,3,4,4,2,3,3,3,2,3,3,2,7,2,0,0,3,3,3,4,4,4,3,2,2,3,3,4,4,4,3,3,3,3,4,4,4,3,3,5,4,4,4,3,4,3,4,4,4,3,4,3,2,3,4,3,2,0.688821075805956,0.7237468644557459,2.625,0,3,0,2.6666666666666665,0,2.888888888888889,0,3.3333333333333335,0,3.6666666666666665,0,3.142857142857143,0,3,0,3.27027027027027,0,4,0,0,0.821861282063789,0.7023387496459815,0.7621000158548852,2,3,2,3,3,2,3,3,1,0.5345224838248488,3.142857142857143,0,2,0.7478768880549106,3,3,3,4,4,3,3,4,3,1,1,0.4879500364742666,3.2857142857142856,0,2.7142857142857144,5.5,3.8333333333333335,3.2559414990859232,0.6723373927674386,0,0.4797561277511168,3,4,4,3,3,3,3,4,4,3,3,3,2,3,3,4,4,4,3,3,0.5936168397046637,3.4,0,3,0,3,0,2.6,0,2.8666666666666667,0,2,3,3,2,2,2,3,3,4,3,3,2,2,2,2,2,3,3,3,4,0.6708203932499369,2.75,0,"White, Caucasian, Anglo, European American",0,19,1,2,NA,1,2,4,sales associate,1,0,208,62,2,5,2,0,0,2,0,0,TRUE,TRUE,TRUE,TRUE,TRUE,NA,NA,NA,NA,5,0.5154586206633469,0.6328366666634878,0.9354838709677419,0.9375,0.017321406441113667,0.00660034522631378,5,0.6883937499821186,0.8409096774593476,1,0.96875,0.00476761545040538,0.010525703879964122,NA,NA,NA,NA,NA,NA,NA,NA,NA,NA,NA,NA,NA,1.2175,3.1034,0.4612,2.0294,0.2424,0,-33.9141,0.008,ML,cueing,63,80.25760417917459,3.270434940342964,0.8280397716207809,0.5220662625147047,2.5504888991596353,1.0484847239710149,0.33643483177491573,0.099,0.511,0.569,0.008,1.54,34.94297386644281,1863.3648751714961,0.1,0.511,0.562,0.009,1.573,37.15764607979653,1862.7486621274627,104,0.3081481481481481,1,0,0,1,FALSE,FALSE,FALSE
326,2021-11-13T03:15:19Z,2021-11-13T03:37:26Z,1326,1,2021-11-13T03:37:27Z,1,Chrome,95.0.4638.69,Windows NT 10.0,1536,864,NA,1.7777777777777777,722,50,301,64,51,78,-0.1726595847011962,-0.36161244477681426,-0.6090232534067487,-0.4945408633321733,-0.28929573539183057,-0.4624281850891678,2,2,3,3,1,4,4,1,2,1,1,4,4,4,1,1,3,3,1,1,1.260743306232687,0,0,2,4,3,3.6,0,5,4,3,4,2,2,4,1,2,1,2,4,2,5,4,1,1,1,1,1,1,1,2,0,2,0,0,5,3,4,5,5,4,3,3,2,1,5,1,1,3,2,5,2,2,1,1,3,3,1,1,1,3,3,1,1,1,1,4,1,2,1,2,1,2,1,1,1,1.4405120877920723,1.3627702877384937,1.125,0,1.25,0,1.8,0,2.2222222222222223,0,1.5833333333333333,0,1.8333333333333333,0,1.1428571428571428,0,1.3333333333333333,0,1.7297297297297298,0,0,0,0,-0.85725549552582,-0.6588395645607719,-0.758047530043296,5,1,4,2,1,2,2,1,1,1.5118578920369088,1.5714285714285714,0,1,-0.5612498234260587,5,5,5,3,2,2,2,6,4,3,3,1.5118578920369088,3.7142857142857144,0,2.2857142857142856,4,3.8333333333333335,3.2559414990859232,-0.1748077221195339,0,-0.18282942195667984,2,2,2,2,2,2,5,2,3,3,2,4,1,3,3,1,4,2,4,2,1.162919151265879,2,0,4,0,4.4,0,3.4,0,3.933333333333333,0,3,3,3,2,4,3,3,2,3,1,2,2,3,3,1,2,3,3,1,2,0.8255779474818965,2.65,0,"White, Caucasian, Anglo, European American",0,20,1,2,NA,1,3,5,Unemployed but searching,2,0,110,61,1,5,2,0,0,1,0,0,TRUE,TRUE,TRUE,TRUE,TRUE,6,0.8342400000050664,0.8163265306122449,0.05582210255027043,6,0.4455500000044703,0.5594375,1,1,0.0016609606451505991,0.006114055322535115,6,0.6183062499966472,0.7227468750048429,1,1,0.006028754799517091,0.018254891601778605,1.3334,1.2236,0.4967,0,10.887,0.003,ML,change,49,-10.098539105668122,1.254446301600615,1.1890942441094805,0.5343929229877384,10,9.6361,0.0405,14.0582,0.0899,0,-94.3114,0.013,ML,cueing,64,201.09944925007903,4.108943346744609,1.0083212098005714,0.44057346494726546,5.691446512574768,0.7279581240441473,0.38359655538282034,0.109,0.384,0.446,0.016,1.527,19.45472562349267,1815.737572774566,0.109,0.394,0.476,0.014,1.553,26.078458383106746,1808.2570003515868,376,1.114074074074074,1,0,0,1,FALSE,FALSE,FALSE
327,2021-11-13T03:14:34Z,2021-11-13T03:39:09Z,1474,1,2021-11-13T03:39:10Z,1,Firefox,91.0,Macintosh,1280,800,N/A,1.6,660,67,402,89,73,107,-0.3319603397900577,-0.20717189345271578,-0.12278510084507581,-0.18988069998108442,0.014569576618755927,0.02742145097557139,2,3,2,2,2,2,3,2,1,2,1,2,2,2,2,1,2,2,1,2,0.5525062514530825,0,0,3,4,3,2.6,0,4,4,2,4,2,2,4,1,1,4,1,5,3,4,4,2,2,1,2,1,1,1,1,1,3,0,0,4,5,5,5,4,4,4,4,5,1,4,1,1,4,1,4,1,2,1,1,1,5,1,1,1,1,1,1,2,2,1,4,1,1,1,1,1,2,1,2,2,1.6366669418909514,1.3627702877384937,1.375,0,1.75,0,1.9333333333333333,0,1.5555555555555556,0,1.3333333333333333,0,0.8333333333333334,0,1.2857142857142858,0,1,0,1.3243243243243243,0,1,0,0,-0.8667409373175989,-0.2989446853297732,-0.5828428113236861,4,1,4,1,1,1,1,1,1,1.4638501094227998,1.2857142857142858,0,1,-0.7321841937363471,4,4,4,4,3,3,1,1,1,2,3,1.1126972805283737,3.857142857142857,0,2.142857142857143,8,3.8333333333333335,3.2559414990859232,2.0842459175790595,0,0.8670264004711803,3,3,2,2,2,2,4,2,2,2,2,2,2,2,4,3,3,2,4,3,0.828078671210825,2.4,0,3.4,0,3.4,0,3.4,0,3.4,0,1,1,1,2,1,1,2,3,1,1,1,3,2,1,1,3,1,1,1,1,0.7591546545162482,1.35,0,"Hispanic of Latino (e.g., Mexican American, Central American, and others)",0,23,1,2,NA,1,3,3,Teacher assistant,2,0,120,62,3,5,2,0,0,0,0,0,TRUE,TRUE,TRUE,TRUE,TRUE,2,1.1588125,0.64,0.07552177183673471,2,0.4820625,0.5918,1,0.967741935483871,0.0030998024193548378,0.006045382795698923,2,0.62521875,0.78503125,1,1,0.010355982862903223,0.021471128024193546,1.2903,0.4546,0.7782,0,29.7253,0.004,ML,change,50,-47.71453098371556,0.4878698458285359,1.1793394279706648,0.8203871569958725,1.2139,3.7693,0.4402,6.0313,0.3814,0,-87.9532,0.011,ML,cueing,63,188.3358041791746,3.776579565838158,0.900602601472613,0.48025737351197073,4.86943968833203,0.8508442431927348,0.3974269553224459,0.171,0.331,0.568,0.006,1.25,33.830427458033995,1835.4739608370091,0.176,0.336,0.599,0.007,1.282,40.65390011770786,1821.1985917346349,428,1.268148148148148,1,0,0,1,FALSE,FALSE,FALSE
329,2021-11-13T03:09:33Z,2021-11-13T03:40:12Z,1839,1,2021-11-13T03:40:15Z,1,Safari,13.1.3,Macintosh,1440,900,NA,1.6,879,173,433,125,59,118,0.23073103705608208,0.7558103677446041,0.026456312317417848,0.24882993524448352,-0.17879925829707183,0.2132264853449552,4,4,1,1,4,1,2,1,1,4,4,1,1,1,4,4,1,1,4,4,1.500876936643164,0,1,1,3,2,1.2,0,2,4,5,3,3,5,4,3,3,2,2,4,2,4,5,2,5,1,1,2,4,3,4,1,2,0,0,5,3,1,1,1,4,4,5,4,4,5,2,1,3,3,5,4,3,1,4,5,3,1,1,1,3,3,1,1,1,1,4,3,2,1,1,1,2,2,1,1,1.517663764904237,1.121223821162776,2.75,0,1.5,0,2.7333333333333334,0,2.888888888888889,0,2.6666666666666665,0,1.8333333333333333,0,1.4285714285714286,0,1,0,2.27027027027027,0,1,0,0,0.4744811739954753,-0.3773458880470143,0.048567642974230496,5,1,5,1,1,1,1,1,1,1.9518001458970664,1,0,1,-0.9031185640466358,5,5,5,5,3,3,3,6,8,NA,4,1.0690449676496976,4.142857142857143,0,1.8571428571428572,2,3.8333333333333335,3.2559414990859232,-1.3043345419688306,0,-0.9866058241456384,5,3,3,2,2,2,4,3,1,3,1,4,2,4,4,1,5,1,3,4,1.3732131246511903,3,0,4.6,0,3.8,0,3.6,0,4,0,1,1,1,4,1,1,1,4,1,3,2,4,1,1,1,4,1,1,2,1,1.2396943596157715,1.2,0,"White, Caucasian, Anglo, European American",0,26,1,2,NA,1,3,7,researcher studying mosquitoes,2,0,120,59,3,5,2,0,0,1,0,0,TRUE,TRUE,TRUE,TRUE,TRUE,1,1.1227187500000035,0.6666666666666666,0.10802649468085168,1,0.518612903225814,0.6280624999999891,1,1,0.0033475784946227992,0.009076124999999925,1,0.6649375000000054,0.7638666666666706,1,0.967741935483871,0.010893479838711174,0.009105769892473848,1.5126,0.4785,0.645,0,40.5465,0.003,ML,change,48,-69.47939696727633,0.5335912110596641,1.2990228590598734,0.7169702943360599,2.7294,5.2706,0.3691,7.4545,0.3355,0,-79.2745,0.009,ML,cueing,63,170.97840417917462,3.7225228925453795,1.1129910670767018,0.4832400063103266,4.776720190735662,0.8673597282141513,0.43065979909202845,0.084,0.491,0.501,0.012,1.595,92.04729904499843,1945.911668800927,0.084,0.491,0.552,0.012,1.664,103.48568446110148,1931.3312364162468,104,0.3081481481481481,1,0,0,1,FALSE,FALSE,FALSE
330,2021-11-13T02:59:35Z,2021-11-13T03:42:16Z,2560,1,2021-11-13T03:42:17Z,1,Chrome,95.0.4638.69,Macintosh,1440,900,NA,1.6,1574,58,515,116,110,122,2.016441114261868,-0.2889345382713561,0.42122392132788494,0.13915227643809153,0.525615783182015,0.2807919523883675,3,3,4,4,1,4,4,3,1,2,3,3,3,4,1,2,1,4,2,3,1.118033988749895,0,1,1,3,3,2.95,0,3,5,1,4,1,1,4,4,5,2,5,3,1,3,4,2,3,1,1,3,5,3,2,3,2,0,0,5,5,5,5,5,5,1,2,3,1,5,5,5,4,4,1,5,5,5,5,5,3,1,1,1,4,5,1,3,4,1,5,1,1,1,1,1,1,1,1,1,1.8166728655155007,1.533747356112131,2.5,0,1,0,2.4,0,2,0,4,0,2.3333333333333335,0,1.5714285714285714,0,1,0,2.5945945945945947,0,2,0,0,0.36317241827561997,-0.33105581968498016,0.016058299295319906,3,2,2,1,1,4,1,3,1,1.1547005383792515,2.2857142857142856,0,2,0.2350737771240448,1,2,5,5,1,1,4,1,1,2,1,1.889822365046136,2.4285714285714284,0,3.5714285714285716,8,3.8333333333333335,3.2559414990859232,2.0842459175790595,0,1.6637363746855478,2,4,2,3,3,3,5,5,1,5,1,5,1,4,4,1,5,1,5,5,1.8439088914585775,2.8,0,4.6,0,5,0,3,0,4.2,0,1,2,1,1,3,1,3,4,2,1,2,2,1,4,1,2,1,2,3,1,1.0208355710680808,2,0,"Asian or Asian American (e.g., Chinese, Japanese, and others)",0,25,1,2,NA,1,2,6,public health professional,3,0,130,64,1,5,2,0,1,1,0,1,TRUE,TRUE,TRUE,TRUE,TRUE,NA,NA,NA,NA,4,0.48447499999962745,0.5900259259268641,0.8571428571428571,0.9,0.017830023121893402,0.03312483862049658,4,0.6243156250012107,0.8008999999993082,1,0.875,0.00739436394148765,0.035849972863132656,NA,NA,NA,NA,NA,NA,NA,NA,NA,NA,NA,NA,NA,1.2139,1.7819,0.2959,1.6918,0.2094,0,-8.3279,0.008,ML,cueing,58,28.837129031639257,1.913824844247327,1.1480802874624343,0.3500707825053764,1.9288564914057715,0.9289231610601578,0.3124776153909829,0.076,0.429,0.339,0.005,1.263,67.76485469036186,1942.4145721938473,0.075,0.43,0.365,0.005,1.285,77.96137003627354,1938.989152764127,425,1.2592592592592593,1,0,0,1,FALSE,FALSE,FALSE
331,2021-11-13T03:17:24Z,2021-11-13T03:43:16Z,1552,1,2021-11-13T03:43:17Z,1,Chrome,95.0.4638.69,Macintosh,1440,900,N/A,1.6,724,84,390,87,75,111,-0.1675208506660716,-0.0527313421286173,-0.18055597045636368,-0.21425351304917153,0.04219369589244561,0.0949869180189837,4,3,1,1,3,2,2,2,1,3,2,1,1,2,4,3,2,1,2,2,0.9679060415469871,0,1,2,4,4,1.8,0,1,5,2,4,2,2,3,2,5,2,4,2,2,3,3,3,5,1,1,3,5,3,3,3,2,0,0,3,4,3,5,3,5,5,5,3,2,5,5,1,3,2,4,2,5,5,5,3,2,1,1,1,1,1,1,4,4,3,4,1,1,1,1,3,2,3,3,3,1.5701800742161598,1.2071217242444348,3,0,2.75,0,2.8,0,2,0,3,0,1.3333333333333333,0,2.142857142857143,0,1.6666666666666667,0,2.27027027027027,0,2,0,0,0.6105682266407941,0.21775259933570762,0.4141604129882509,5,1,4,1,1,1,1,1,1,1.7320508075688772,1.1428571428571428,0,1,-0.8176513788914915,4,4,4,4,2,2,2,7,4,NA,3,1.0690449676496976,3.4285714285714284,0,2.5714285714285716,3.5,3.8333333333333335,3.2559414990859232,-0.4571894270818581,0,-0.16467827959496828,2,2,2,3,2,3,4,3,2,3,2,3,4,4,4,3,4,3,4,4,0.7237468644557459,2.2,0,3.4,0,3.2,0,3.4,0,3.3333333333333335,0,2,1,1,4,2,2,1,3,1,2,2,3,2,2,1,3,2,2,2,1,0.8255779474818965,1.65,0,"White, Caucasian, Anglo, European American",0,25,1,2,NA,1,3,7,Teacher,3,0,140,68,4,5,2,0,0,1,0,0,TRUE,TRUE,TRUE,TRUE,TRUE,5,0.812460975609538,0.82,0.0550032674939502,5,0.5302874999999767,0.57803548387089565,1,1,0.0065204475807040035,0.0054009563655613565,5,0.7104312500006054,0.7463406249996042,1,1,0.021493762862976665,0.004174794102851127,1.3584,1.2115,0.4714,0,13.0098,0.004,ML,change,50,-14.283530983715563,1.2760913988041611,1.1882749862502588,0.5144823230173983,5.4945,7.9501,0.2325,7.6545,0.1714,0,-75.0247,0.012,ML,cueing,63,162.47880417917457,4.238330575556982,0.9775393052834396,0.46631800630381337,4.043366814966552,1.0246744646208426,0.407536654846981,0.239,0.289,0.585,0.025,1.583,122.47224091325391,1944.3417985244962,0.234,0.29,0.582,0.02,1.665,135.70952469375717,1923.3825223601093,388,1.1496296296296296,1,0,0,1,FALSE,FALSE,FALSE
332,2021-11-13T03:27:44Z,2021-11-13T03:49:12Z,1287,1,2021-11-13T03:49:14Z,1,Chrome,95.0.4638.69,Windows NT 10.0,1920,1080,NA,1.7777777777777777,647,40,339,64,65,73,-0.36536211101836735,-0.45245982790863687,-0.4260821663043371,-0.4945408633321733,-0.09592690047600279,-0.5468850188934331,4,3,2,1,4,1,1,3,1,4,3,1,1,3,2,4,1,1,3,4,1.268027892769755,0,1,2,3,4,1.45,0,1,4,2,3,1,4,2,5,2,1,3,1,1,2,3,2,5,1,1,3,4,5,3,7,2,0,0,4,1,3,1,1,2,1,2,1,1,5,3,4,3,4,3,4,5,4,5,3,2,1,4,3,3,2,1,4,5,2,2,4,3,2,4,1,2,1,1,3,1.3567758992703403,1.2909944487358056,3,0,1.75,0,3,0,4.222222222222222,0,3.3333333333333335,0,2.6666666666666665,0,3.142857142857143,0,2.3333333333333335,0,3.3783783783783785,0,4,0,0,1.172725838137246,0.31033273605977596,0.7415292870985111,2,3,1,4,1,4,3,6,1,1.2724180205607036,3.4285714285714284,0,3.5,1.472292770526772,1,3,4,2,1,1,5,1,1,1,1,1.618347187425374,1.8571428571428572,0,4.142857142857143,8,3.8333333333333335,3.2559414990859232,2.0842459175790595,0,1.9824203643712948,4,5,2,4,2,4,5,2,3,1,1,4,5,1,4,5,3,1,3,5,1.5976172734359604,3.4,0,3.8,0,2.2,0,2.6,0,2.8666666666666667,0,2,3,4,1,2,3,2,4,3,3,2,1,3,4,1,1,1,4,3,2,1.0990426455975697,2.75,0,"White, Caucasian, Anglo, European American",0,25,0,1,NA,1,1,3,Unemployed,1,0,355,72,1,5,2,0,0,1,0,0,TRUE,TRUE,TRUE,TRUE,TRUE,1,0.8436558823506621,0.68,0.09405734675890141,1,0.5032593749994412,0.6810607142868851,1,0.9032258064516129,0.006008249586639282,0.020310889462180463,1,0.6625187499984168,0.814761290321427,1,0.96875,0.011503428669180029,0.022477761935682294,1.6655,0.4889,0.2667,0,48.5241,0.004,ML,change,50,-85.31213098371556,0.5982062251351837,1.2600534242284784,0.46450634021764386,1.2913,2.0183,0.419,4.7522,0.3674,0,-51.3698,0.008,ML,cueing,63,115.16900417917459,2.1869017695761195,1.0213500453383528,0.4927419240100025,4.12691480070055,1.0039302787855542,0.3854283190483451,0.119,0.39,0.422,0.006,1.305,43.766586125147505,1868.8313743116726,0.111,0.389,0.408,0.007,1.407,49.38687625461347,1874.6781526449167,270,0.8,1,0,0,1,FALSE,FALSE,FALSE
333,2021-11-13T03:24:01Z,2021-11-13T03:52:50Z,1729,1,2021-11-13T03:52:52Z,1,Safari,14.0.3,Macintosh,1440,900,I thought the circle game was the most fun!,1.6,736,283,383,101,57,100,-0.13668844645532424,1.7551315821946532,-0.21425564439628159,-0.04364382157256178,-0.2064233775707615,-0.09081811635040013,4,4,1,1,4,1,3,4,1,4,4,2,1,1,4,4,1,1,4,4,1.460893742308382,0,1,2,5,3,1.15,0,3,4,1,4,3,1,4,4,2,1,3,3,1,3,1,3,4,1,1,3,4,3,4,2,2,0,0,4,1,3,5,5,5,5,5,5,3,4,4,1,4,2,5,3,5,5,5,5,3,1,1,1,3,2,1,3,3,3,4,3,1,2,4,3,4,1,2,2,1.4694077579620841,1.245945806357946,2.875,0,2.25,0,2.4,0,1.7777777777777777,0,3.1666666666666665,0,1.6666666666666667,0,2.142857142857143,0,3,0,2.4324324324324325,0,1,0,0,0.4546391784106317,-0.14214227989529096,0.15624844925767034,4,2,3,2,1,3,2,1,1,0.9759000729485332,2.142857142857143,0,1,-0.21938108280548152,5,5,5,5,1,1,4,6,6,4,2,1.889822365046136,3.4285714285714284,0,2.5714285714285716,3,3.8333333333333335,3.2559414990859232,-0.7395711320441822,0,-0.3058691320761303,2,3,1,4,1,2,4,1,1,3,3,3,1,3,4,1,4,1,3,4,1.245945806357946,2.2,0,3.8,0,4,0,3.8,0,3.8666666666666667,0,1,4,1,3,3,2,3,3,2,2,1,4,4,4,3,3,1,2,3,3,1.0462967275611939,2.3,0,"White, Caucasian, Anglo, European American",0,22,1,2,NA,1,2,6,after school teacher,5,0,125,62,3,5,2,0,0,1,0,0,TRUE,TRUE,TRUE,TRUE,TRUE,1,0.773880952380951,0.84,0.01758770163265368,1,0.45990625,0.53896875,1,1,0.002266668346774029,0.0022486764112901636,1,0.7221562499999945,0.7747812499999982,1,1,0.009100523185484656,0.013387466733869782,1.1574,1.5488,0.5198,0,-5.6491,0.004,ML,change,50,23.034269016284437,1.8229706354250812,0.9096296146409762,0.6042270572671576,4.1973,9.6312,0.3211,10.1495,0.2531,0,-107.685,0.014,ML,cueing,64,227.84664925007903,5.276315461276426,0.7852325655656004,0.4668830252670392,5.265813812951445,0.7867985602152043,0.3875327164605312,0.293,0.271,0.667,0.017,1.211,53.320063004146604,1859.4028056057007,0.301,0.282,0.676,0.029,1.331,68.28789104576121,1849.9973692011565,422,1.2503703703703704,1,0,1,2,FALSE,FALSE,FALSE
335,2021-11-13T03:12:45Z,2021-11-13T03:54:49Z,2523,1,2021-11-13T03:54:50Z,1,Firefox,94.0,Windows NT 6.1,1366,768,It was kind of long for me.,1.7786458333333333,790,60,1021,118,150,233,0.0020573724930389916,-0.2707650616449916,2.857228923270523,0.16352508950617864,1.0780981686558087,2.155733662843059,4,3,1,1,1,1,1,1,1,1,1,1,1,1,4,2,1,1,1,1,0.998683343734455,0,1,1,5,5,2.05,0,2,2,2,2,3,3,2,3,2,2,1,2,2,2,3,3,4,1,1,1,3,3,2,2,2,1,1,3,3,3,3,3,3,2,2,2,2,2,2,1,2,2,3,3,2,2,4,3,2,1,1,1,2,3,1,2,2,1,3,3,2,4,3,3,1,1,1,1,0.8183334709454757,0.560611910581388,2.25,0,1,0,3,0,3.3333333333333335,0,2.6666666666666665,0,1.8333333333333333,0,1.8571428571428572,0,3.3333333333333335,0,2.6486486486486487,0,1,1,1,0.5368140771985941,-0.15106543898929206,0.19287431910465103,4,2,2,2,1,2,3,1,1,0.9511897312113419,2.2857142857142856,0,1,-0.1339138976503373,2,2,2,2,1,1,4,3,3,1,2,1,1.7142857142857142,0,4.285714285714286,6,3.8333333333333335,3.2559414990859232,0.9547190977297628,0,1.497327951868083,2,1,1,1,1,1,1,1,1,1,1,1,1,1,1,1,1,1,1,1,0,1.2,0,3.4,0,2.6,0,3.4,0,3.1333333333333333,0,1,1,1,1,1,1,1,1,1,1,1,1,1,1,2,1,1,1,1,1,0.22360679774997896,1.65,0,Black or African American,0,30,1,2,NA,1,4,4,unemployed,4,0,110,66,2,5,2,1,0,1,0,1,TRUE,TRUE,TRUE,TRUE,TRUE,4,1.0322500000000001,0.72,0.11287184040816327,4,0.5451,0.6101875,0.967741935483871,1,0.013116991397849461,0.009098802419354837,4,0.5958125,0.6471612903225806,1,0.96875,0.005645512096774193,0.00266811995967742,1.5319,0.6338,0.4849,0,40.8216,0.003,ML,change,50,-69.90713098371556,0.7054397215629364,1.3388268054261958,0.6147204957906383,1.3572,3.7537,0.4294,3.5755,0.363,0,-60.4864,0.009,ML,cueing,63,133.4022041791746,3.7202012621061242,1.1136856407725566,0.4651841939305289,3.1116879061690454,1.0930393677717958,0.3807967778072948,0.059,0.47,0.501,0.021,1.71,83.70991118721724,1931.2771023539865,0.062,0.472,0.52,0.023,1.844,109.05990441732267,1932.634475578945,311,0.9214814814814816,1,0,0,1,FALSE,FALSE,FALSE
336,2021-11-13T03:24:55Z,2021-11-13T03:55:09Z,1814,1,2021-11-13T03:55:10Z,1,Chrome,95.0.4638.69,Windows NT 10.0,1920,1080,No,1.7777777777777777,870,70,476,110,94,125,0.20760673389802156,-0.17991767851316898,0.23346859509119935,0.0660338372338302,0.30462282899249754,0.3314660526709267,2,2,3,3,1,3,1,1,1,2,2,1,1,2,2,1,1,1,1,1,0.7539370349250519,0,1,1,3,2,2.6,0,5,3,5,2,5,3,2,1,3,2,2,1,1,2,1,3,2,1,3,2,1,1,1,2,2,5,3,4,1,2,2,3,4,1,1,1,4,3,2,1,1,5,1,4,1,1,1,1,1,5,3,1,4,1,1,2,2,2,4,1,3,4,4,1,2,2,2,2,1.382538032537048,1.4573295865416045,1.75,0,2,0,3.2,0,3.888888888888889,0,2.75,0,3,0,1.7142857142857142,0,3,0,2.945945945945946,0,1,5,3,0.5356525945302133,1.3419714960501288,0.938812045290171,1,3,1,2,2,4,3,3,1,1.1126972805283737,3.4285714285714284,0,2,0.9188112583651991,2,2,2,3,1,1,3,5,3,3,2,0.816496580927726,2,0,4,5,3.8333333333333335,3.2559414990859232,0.38995568780511447,0,1.0556042520628854,3,2,3,2,2,2,5,3,2,2,1,3,5,3,2,1,3,1,1,4,1.3557637102737474,2.4,0,4,0,2.8,0,2.8,0,3.2,0,2,4,3,2,1,3,3,2,3,3,3,2,4,3,2,2,1,3,3,1,0.8885233166386386,2.7,0,Black or African American,0,18,1,2,NA,1,2,3,Unemployed,2,0,135,62,2,5,2,0,0,1,0,0,TRUE,TRUE,TRUE,TRUE,TRUE,5,1.3166717948730176,0.8125,0.21100681464062102,5,0.6335687500014902,0.6826499999999068,1,1,0.023986228669028574,0.012181708386689263,5,0.9313225806466033,1.5191066666662694,1,0.967741935483871,0.042511847807218325,0.2215342844519091,1.7878,0.8528,0.687,0,42.9797,0.003,ML,change,48,-74.34579696727633,0.8870931965463535,1.6529684530353694,0.73437374142767,3.6652,5.1163,0.3245,4.6579,0.2401,0,-47.1861,0.009,ML,cueing,64,106.84884925007901,3.4584814023413535,1.1979635696715547,0.5148701172840919,2.919590904120059,1.4190805706870906,0.39813605617559733,0.183,0.302,0.23,0.005,1.888,226.28722115825101,2102.369424710858,0.181,0.309,0.229,0.005,1.943,260.70884813058797,2091.3263511779046,340,1.0074074074074075,1,0,0,1,FALSE,FALSE,FALSE
337,2021-11-13T03:33:04Z,2021-11-13T03:55:30Z,1345,1,2021-11-13T03:55:30Z,1,Chrome,95.0.4638.69,Windows NT 10.0,1920,1080,Nope. Thank you giving me the opportunity to participate!,1.7777777777777777,656,54,308,72,78,85,-0.3422378078603068,-0.3252734915240852,-0.5753235794668308,-0.39704961105982484,0.08362987480298012,-0.34418861776319626,3,3,2,2,3,1,1,3,1,2,3,1,3,1,3,4,1,1,3,3,1.0052493799000692,0,1,1,3,4,1.7,0,4,5,2,4,1,1,4,2,1,1,1,4,1,4,4,1,2,1,1,1,1,3,2,0,2,0,0,5,5,5,4,5,5,4,5,5,1,5,2,1,4,1,5,2,2,1,2,2,5,1,1,1,1,1,1,1,1,1,5,1,1,1,1,1,1,1,1,1,1.8034001919297482,1.5491933384829668,1.5,0,1,0,1.5333333333333334,0,1.2222222222222223,0,1.5,0,0.8333333333333334,0,0.8571428571428571,0,1,0,1.2162162162162162,0,0,0,0,-1.0313811055606197,-0.7372407672780129,-0.8843109364193162,5,1,4,1,1,1,1,1,1,1.7320508075688772,1.1428571428571428,0,1,-0.8176513788914915,5,5,5,5,4,3,1,6,6,5,3,1.5275252316519468,4.571428571428571,0,1.4285714285714286,3,3.8333333333333335,3.2559414990859232,-0.7395711320441822,0,-0.9432371114476243,3,3,2,4,3,2,4,2,3,4,3,3,1,4,4,2,3,2,4,2,0.990430401872025,3,0,3.4,0,4.2,0,3.8,0,3.8,0,1,1,2,3,2,3,1,3,2,2,3,3,1,2,1,2,1,3,3,2,0.8255779474818965,1.95,0,"Hispanic of Latino (e.g., Mexican American, Central American, and others) & White, Caucasian, Anglo, European American",1,25,0,1,NA,1,4,6,Grad Student,6,0,170,70,2,5,2,0,0,1,0,0,TRUE,TRUE,TRUE,TRUE,TRUE,5,1.2583472222354677,0.72,0.3335454565581729,5,0.3876593750268221,0.45849687500298025,1,1,0.0014840270052027895,0.003989824183680032,5,0.5622906250059605,0.6238838709554364,1,0.96875,0.009648511842290626,0.0036831354434551157,1.6139,0.5766,0.6002,0,49.0834,0.003,ML,change,50,-86.43073098371556,0.538043704697552,1.7553622514211127,0.5405994037200068,3.6723,7.5299,0.2146,11.4033,0.2266,0,-106.2548,0.013,ML,cueing,64,224.98624925007903,4.571661377446423,0.9062645686819764,0.3624766617341385,5.853990905104457,0.7077453302462218,0.3290986170934449,0.062,0.425,0.484,0.015,1.512,61.15508548495624,1896.2694441018516,0.064,0.425,0.516,0.016,1.604,67.40536565199409,1891.6769165783396,272,0.8059259259259259,1,0,1,2,FALSE,FALSE,FALSE
338,2021-11-13T03:24:48Z,2021-11-13T03:58:23Z,2014,1,2021-11-13T03:58:24Z,0.8999999761581421,Chrome,95.0.4638.69,Windows NT 10.0,1920,1080,NA,1.7777777777777777,787,95,525,113,89,107,-0.005650728559647855,0.047200779316387595,0.4693663126706248,0.10259305683596086,0.23556253080827336,0.02742145097557139,3,3,1,2,3,1,2,2,1,3,2,1,1,2,3,3,1,1,2,2,0.8255779474818965,0,0,4,3,3,1.85,0,4,2,4,3,5,2,4,2,3,3,2,4,3,3,3,2,1,1,1,1,2,2,4,0,2,1,0,5,3,2,3,4,4,3,3,5,3,4,3,3,3,3,5,4,2,3,3,3,4,1,2,1,3,2,1,1,1,1,3,4,4,1,1,1,1,3,2,5,1.2562157768783506,0.9154754164341269,1.75,0,2.75,0,2.8666666666666667,0,2.4444444444444446,0,2.75,0,1.6666666666666667,0,2,0,1,0,2.27027027027027,0,0,1,0,0.102032398334603,0.018200859335698566,0.06011662883515078,4,2,3,1,1,4,2,1,1,1.2724180205607036,2.142857142857143,0,1,-0.21938108280548152,5,5,5,5,2,2,1,6,6,NA,3,1.8126539343499315,4.142857142857143,0,1.8571428571428572,3,3.8333333333333335,3.2559414990859232,-0.7395711320441822,0,-0.7042241191833141,2,2,3,2,2,2,5,2,2,4,1,4,2,4,5,2,5,3,4,3,1.3201731488169053,2.2,0,4.2,0,4.2,0,4,0,4.133333333333334,0,3,1,2,3,3,2,4,3,3,2,1,2,4,3,2,3,2,2,2,4,0.8870412083230169,2.45,0,"White, Caucasian, Anglo, European American",0,19,1,2,NA,1,3,5,Cake decorator,4,0,225,66,1,5,2,0,0,1,0,0,TRUE,TRUE,TRUE,TRUE,TRUE,5,1.045263414603908,0.82,0.08452266601967862,5,0.6279812500029802,0.7442937499731779,1,1,0.012309263502842189,0.010997498677165395,5,0.7400781250298023,0.7649580644945945,1,1,0.009216111456349397,0.013139237176991041,1.4879,1.0704,0.6198,0,24.5856,0.004,ML,change,50,-37.43513098371556,1.1461345569001755,1.3230100080650102,0.675879907203322,1.7137,4.6433,0.5598,3.7681,0.4006,0,-63.1056,0.01,ML,cueing,64,138.687849250079,3.548044145379192,1.1677235560294137,0.5848774422058748,3.449486719019605,1.201087310627209,0.4593252401458372,0.114,0.511,0.527,0.054,1.594,30.414233180631282,1821.320861562131,0.115,0.521,0.537,0.074,1.658,40.93746617223835,1823.1892875460776,310,0.9185185185185185,1,0,0,1,FALSE,FALSE,FALSE
339,2021-11-13T03:25:53Z,2021-11-13T03:59:13Z,2000,1,2021-11-13T03:59:14Z,1,Edge,95.0.1020.40,Windows NT 10.0,1280,720,n/a,1.7777777777777777,1051,64,416,129,74,137,0.6726621640767946,-0.23442610839226255,-0.05538575296523996,0.2975755613806577,0.028381636255600768,0.5341624538011636,4,3,1,1,3,1,1,4,1,4,3,1,1,1,3,3,1,1,2,2,1.190974832912761,1,1,4,4,3,1.45,0,4,5,3,4,3,2,4,2,2,1,1,4,4,4,4,2,3,1,1,2,1,1,2,1,2,0,0,5,5,5,5,5,5,5,5,5,2,5,2,2,5,2,4,2,2,4,4,4,4,1,1,1,2,2,1,1,1,1,5,2,2,1,2,1,2,1,1,1,1.6666666666666667,1.245945806357946,1.625,0,1.25,0,2.066666666666667,0,1,0,2.3333333333333335,0,1.3333333333333333,0,1.1428571428571428,0,1.3333333333333333,0,1.5945945945945945,0,1,0,0,-0.5858557120141032,-0.4557470907642554,-0.5208014013891793,5,2,3,2,1,1,2,3,1,1.3801311186847085,1.7142857142857142,0,2,-0.10679496349653231,5,5,5,5,3,2,2,7,3,3,3,1.4638501094227998,4.142857142857143,0,1.8571428571428572,4,3.8333333333333335,3.2559414990859232,-0.1748077221195339,0,-0.42184241422098995,2,2,2,2,2,2,5,2,2,4,1,5,1,5,5,1,4,4,4,2,1.5976172734359604,2,0,4,0,4.6,0,4.4,0,4.333333333333333,0,1,1,1,3,1,1,2,3,2,2,1,4,2,1,1,4,1,1,2,3,1.0399898784932577,1.45,0,"White, Caucasian, Anglo, European American",0,23,1,2,NA,1,2,6,Physical Therapy Tech,1,0,140,70,3,5,2,0,1,1,0,1,TRUE,TRUE,TRUE,TRUE,TRUE,3,0.8582837837934494,0.74,0.1079353474476834,3,0.45649999999230906,0.5220499999920527,1,0.9375,0.008825129333774091,0.0030308883459422473,3,0.6755290322803682,0.7234250000081957,1,1,0.0671040028004955,0.016536787741759092,1.4422,0.7497,0.3871,0,32.5213,0.004,ML,change,50,-53.306530983715554,0.7828390656532302,1.3361220729447019,0.4486602588877908,1.3022,3.5576,0.3565,3.9203,0.2904,0,-63.8829,0.008,ML,cueing,63,140.1952041791746,3.972873093177944,0.6816352140098217,0.44698709233427214,3.748713279604113,1.105215154472703,0.3136940421826335,0.159,0.316,0.495,0.024,1.752,53.124829479209765,1856.9165834174303,0.159,0.316,0.495,0.022,1.84,75.9502016198626,1860.92696758242,340,1.0074074074074075,1,0,0,1,FALSE,FALSE,FALSE
340,2021-11-13T03:39:02Z,2021-11-13T03:59:13Z,1211,1,2021-11-13T03:59:15Z,1,Firefox,94.0,Windows NT 10.0,2560,1440,NA,1.7777777777777777,555,64,304,64,61,86,-0.6017438766340972,-0.23442610839226255,-0.5945805360039267,-0.4945408633321733,-0.15117513902338214,-0.3272972510023432,2,2,3,1,1,3,3,1,1,1,1,1,1,3,1,1,3,4,2,1,1.0052493799000692,1,1,1,3,2,3,0,4,4,2,4,2,1,4,1,2,1,1,4,5,5,5,1,1,1,1,1,1,1,1,0,2,0,0,5,3,1,5,4,5,5,5,5,1,5,2,1,3,2,4,3,1,1,2,1,5,1,1,1,1,1,1,1,1,1,4,2,2,1,3,1,1,2,1,2,1.6430762915031365,1.6035674514745464,1,0,1.5,0,1.8,0,1.7777777777777777,0,1.6666666666666667,0,0.8333333333333334,0,1.2857142857142858,0,1.6666666666666667,0,1.5405405405405406,0,0,0,0,-0.9922778557251226,-0.5804383618435307,-0.7863581087843267,4,2,2,1,2,2,3,6,4,0.9511897312113419,2.2857142857142856,0,5,1.3420368014471913,4,4,4,4,2,2,2,3,1,2,2,1.0690449676496976,3.4285714285714284,0,2.5714285714285716,7,3.8333333333333335,3.2559414990859232,1.5194825076544112,0,0.8236576877731663,1,1,2,3,1,2,5,1,1,2,1,3,3,4,4,2,3,1,4,1,1.3557637102737474,1.6,0,4,0,3.6,0,4.6,0,4.066666666666666,0,1,4,3,1,3,4,2,2,4,3,2,1,4,4,1,1,1,4,2,4,1.2763022245616642,3.05,0,"Hispanic of Latino (e.g., Mexican American, Central American, and others) & White, Caucasian, Anglo, European American",1,25,0,4,"Currently identifying as male, but questioning. Thank you for having a text box option.",1,2,6,Currently unemployed 3D artist,3,0,190,72,2,5,2,0,0,1,0,0,TRUE,TRUE,TRUE,TRUE,TRUE,4,0.6190238095238095,0.84,0.023554284081632654,4,0.4048275862068966,0.4661034482758621,0.90625,0.90625,0.0013645806451612905,0.002611866935483871,4,0.46596875,0.5522333333333334,1,0.9375,0.0013620312500000006,0.0034865443548387095,1.0548,1.604,0.4014,0,-10.865,0.003,ML,change,50,33.466069016284436,1.6945893327477364,0.9785427327780677,0.4226903836517898,0.9138,3.0601,0.3391,3.0516,0.2801,0,-66.7114,0.011,ML,cueing,64,145.89944925007902,3.6902471389807343,0.6147782129152972,0.3984240654078023,4.34053649722732,0.5226735318934815,0.355908259651904,0.063,0.361,0.601,0.021,1.939,44.04555602280484,1905.5042352415815,0.066,0.363,0.688,0.025,2.114,50.82987930273532,1898.4426385947,386,1.1437037037037037,1,0,0,1,FALSE,FALSE,FALSE
342,2021-11-13T03:36:48Z,2021-11-13T04:01:44Z,1495,1,2021-11-13T04:01:45Z,1,Firefox,94.0,Windows NT 10.0,1920,1080,"All good, thank you!",1.7777777777777777,650,62,454,90,63,88,-0.3576540099656805,-0.2525955850186271,0.1275553341371716,-0.17769429344704088,-0.12355101974969247,-0.293514517480637,3,4,2,3,3,1,3,2,1,3,3,2,2,2,3,2,2,1,2,3,0.812727700887249,0,1,2,4,4,2.05,0,2,4,4,3,3,4,2,5,3,4,5,2,1,2,4,3,4,1,2,5,5,4,5,0,2,0,2,5,4,3,4,3,4,5,5,4,2,5,5,2,2,3,5,4,5,5,5,5,1,3,1,1,5,1,3,1,1,1,4,1,1,1,3,4,1,2,2,1,1.6075086575456083,1.2071217242444348,3.625,0,1.5,0,3.466666666666667,0,1.8888888888888888,0,3.5,0,2.5,0,1.2857142857142858,0,2.6666666666666665,0,2.5135135135135136,0,0,0,2,1.2701935920588932,-0.22753906804516918,0.521327262006862,3,4,2,4,2,3,3,3,2,0.816496580927726,3.2857142857142856,0,2.5,1.017837910597246,4,3,5,5,1,1,2,6,3,1,2,1.7320508075688772,3.2857142857142856,0,2.7142857142857144,4.5,3.8333333333333335,3.2559414990859232,0.10757398284279028,0,0.19737442278879264,1,3,3,1,2,1,5,1,2,4,2,5,1,4,2,4,5,2,5,2,1.6035674514745464,2,0,4.6,0,4.2,0,3.8,0,4.2,0,1,1,3,4,3,2,3,3,2,2,2,2,3,2,3,2,1,2,3,4,0.8825799501580878,2.3,0,"White, Caucasian, Anglo, European American",0,30,0,1,NA,0,2,6,Fleet Coordinator,2,0,214,74,1,5,2,0,0,1,0,0,TRUE,TRUE,TRUE,TRUE,TRUE,4,0.9389,0.8333333333333334,0.21548596409574466,4,0.4424375,0.4929655172413793,1,0.9354838709677419,0.0014672217741935486,0.002757916129032258,4,0.5820625,0.646483870967742,1,1,0.01823025403225807,0.021981858064516125,1.6137,1.0268,0.4569,0,30.6134,0.004,ML,change,48,-49.61319696727632,0.9516224560296175,1.6912567607421087,0.346488324541222,1.0183,4.4173,0.3895,4.9492,0.3396,0,-93.3494,0.008,ML,cueing,63,199.1282041791746,4.037606231974753,0.6623104126027238,0.4215307398779091,5.870681960933887,0.705733125037565,0.38420925927518784,0.227,0.154,0.541,0.012,1.07,23.688862913575196,1819.8611012692832,0.227,0.147,0.526,0.015,1.237,29.085236163898163,1810.2045403140169,346,1.0251851851851852,1,0,1,2,FALSE,FALSE,FALSE
343,2021-11-13T03:27:35Z,2021-11-13T04:02:19Z,2084,1,2021-11-13T04:02:20Z,1,Chrome,84.0.4147.136,CrOS armv7l 13099.110.0,1280,800,Thank you for the surey. Excellent survey.,1.6,922,73,642,113,108,130,0.34121381881126023,-0.15266346357362218,1.0326322913806816,0.10259305683596086,0.49799166390832533,0.4159228864751921,3,3,1,3,3,1,1,3,1,3,3,1,1,1,4,4,1,1,3,3,1.1516578439248717,0,1,1,5,5,1.5,0,1,4,4,4,3,2,2,2,1,2,1,4,1,4,4,3,2,1,1,1,1,1,1,1,2,0,0,4,1,4,3,1,1,5,5,4,4,3,4,1,4,5,1,5,5,5,5,5,5,1,1,1,1,1,1,1,1,1,4,5,5,1,1,1,1,1,1,1,1.8129497474521423,1.2983506020002016,1.375,0,1,0,2.3333333333333335,0,2.888888888888889,0,4.083333333333333,0,0.8333333333333334,0,2.142857142857143,0,1,0,2.7027027027027026,0,1,0,0,-0.10248534152283549,-0.5341482934814965,-0.318316817502166,5,1,3,1,1,1,3,1,4,1.5735915849388864,1.5714285714285714,0,2.5,-0.007768311264485517,4,4,4,4,2,2,1,4,4,2,3,1.2909944487358056,3.5714285714285716,0,2.4285714285714284,5,3.8333333333333335,3.2559414990859232,0.38995568780511447,0,0.17922328042708108,1,1,1,3,2,1,5,3,3,5,2,4,3,3,3,3,5,3,2,4,1.162919151265879,1.6,0,4.2,0,3.6,0,2.8,0,3.533333333333333,0,3,1,4,3,4,2,2,3,1,1,1,2,4,1,2,2,1,1,3,1,1.1192102478745307,2.1,0,Black or African American,0,25,0,1,NA,1,4,3,marketing consultant,3,0,235,77,3,5,2,0,0,1,0,0,TRUE,TRUE,TRUE,TRUE,TRUE,3,0.924337105255721,0.76,0.03894705870500693,3,0.5539142187626567,0.6513481250076438,1,1,0.0051773305449158745,0.008283445332567098,3,0.6748404687677976,0.7356535483737506,1,0.96875,0.017078911337499118,0.010507762342368093,1.1704,1.012,0.6237,0,10.0393,0.004,ML,change,50,-8.342530983715564,1.1015633860672631,1.0464032524298164,0.6773564511482327,4.8986,6.6318,0.282,8.1556,0.2536,0,-74.6852,0.014,ML,cueing,64,161.847049250079,3.8085507034755612,1.0878507466398284,0.5129942611814883,4.283374245181963,0.9672595690306129,0.44453401359468636,0.073,0.449,0.373,0.009,1.352,161.92045135274657,2034.0751214072552,0.077,0.452,0.39,0.01,1.424,194.1035929578807,2019.7719515761285,410,1.2148148148148148,1,0,0,1,FALSE,FALSE,FALSE
344,2021-11-13T03:44:04Z,2021-11-13T04:05:52Z,1307,1,2021-11-13T04:05:53Z,1,Chrome,95.0.4638.69,Windows NT 10.0,1536,864,Thank you too,1.7777777777777777,647,50,345,74,53,72,-0.36536211101836735,-0.36161244477681426,-0.39719673149869317,-0.37267679799173775,-0.2616716161181409,-0.5637763856542862,4,4,2,2,4,1,2,4,1,4,3,1,1,1,4,4,2,1,4,4,1.348488432516786,0,1,1,5,5,1.25,0,1,4,5,4,2,1,5,1,2,1,1,5,3,5,5,5,3,1,1,5,1,1,5,4,2,0,0,5,1,5,4,3,3,3,4,3,2,1,1,1,3,1,4,4,3,2,4,2,5,1,1,1,3,1,1,3,3,4,4,2,2,3,2,1,1,3,2,2,1.322024110123468,1.7728105208558367,2.75,0,2,0,1.9333333333333333,0,2.5555555555555554,0,2.5,0,1.1666666666666667,0,2.2857142857142856,0,2,0,2.27027027027027,0,2,0,0,0.13068230415467,-0.01745100881601569,0.056615647669327154,5,1,1,3,1,1,1,1,1,1.5735915849388864,1.8571428571428572,0,1,-0.39031545311577004,3,3,3,3,1,1,3,1,1,1,2,0.9759000729485332,2.4285714285714284,0,3.5714285714285716,8,3.8333333333333335,3.2559414990859232,2.0842459175790595,0,1.6637363746855478,4,3,4,1,1,2,3,2,1,1,1,2,1,1,3,1,3,1,5,1,1.1872336794093274,2.6,0,3.8,0,3.8,0,3.6,0,3.7333333333333334,0,1,1,1,4,1,1,2,3,1,1,2,4,2,1,1,3,1,1,1,2,1.0310954828418375,1.3,0,"Asian or Asian American (e.g., Chinese, Japanese, and others)",0,20,0,1,NA,1,2,3,student,1,0,124,67,1,5,2,0,0,1,0,0,TRUE,TRUE,TRUE,TRUE,TRUE,3,0.7949186046518558,0.8775510204081632,0.04695125916670925,3,0.4071928571436022,0.47006206896541447,0.9655172413793104,0.90625,0.003236148817703363,0.005961934022035426,3,0.5390093750013039,0.6145468749995343,1,1,0.01170526087732522,0.00790800128019147,1.58,1.4514,0.4109,0,12.6428,0.004,ML,change,49,-13.61013910566812,1.624244596184182,1.2125271348245763,0.5130701329985791,1.0314,2.2632,0.2718,4.2546,0.2916,0,-56.4073,0.011,ML,cueing,61,125.14722159251994,3.0022470218736683,0.7556618508701207,0.3678094479521046,4.3712241096487485,0.762304660339862,0.3260105718911263,0.306,0.073,0.667,0.012,1.31,40.14791327311709,1835.2893317662813,0.308,0.078,0.668,0.013,1.361,53.224025693095015,1836.4379051746378,104,0.3081481481481481,1,1,1,2,FALSE,FALSE,FALSE
345,2021-11-13T03:44:00Z,2021-11-13T04:06:37Z,1356,1,2021-11-13T04:06:39Z,1,Edge,95.0.1020.44,Windows NT 10.0,1536,864,thanks for having me!,1.7777777777777777,687,69,307,67,51,98,-0.26258743031587606,-0.18900241682635124,-0.5801378186011047,-0.45798164373004263,-0.28929573539183057,-0.12460084987210628,4,4,1,2,2,1,1,4,1,3,3,1,1,1,4,4,2,1,2,3,1.2513150976809202,0,1,3,3,2,1.45,0,5,5,1,5,1,1,5,1,1,1,1,5,1,5,5,1,1,1,1,1,1,1,1,1,2,0,0,5,5,5,5,5,5,5,5,5,1,5,1,1,5,1,5,1,1,1,1,1,5,1,1,1,1,1,1,1,1,1,5,1,1,1,1,1,1,1,1,1,1.9666895707934864,2.065591117977289,1,0,1,0,1,0,1,0,1,0,0.8333333333333334,0,0.8571428571428571,0,1,0,1,0,1,0,0,-1.568373259242148,-0.5341482934814965,-1.0512607763618222,5,1,4,1,1,1,1,1,1,1.7320508075688772,1.1428571428571428,0,1,-0.8176513788914915,5,5,5,5,3,3,2,3,3,NA,3,1.2909944487358056,4.285714285714286,0,1.7142857142857142,6,3.8333333333333335,3.2559414990859232,0.9547190977297628,0,0.06324999828222155,1,1,1,3,3,3,3,3,3,1,1,4,1,3,4,2,4,1,3,4,1.1751393027860062,1.8,0,4.2,0,3.2,0,3,0,3.466666666666667,0,2,2,2,2,2,3,2,3,1,2,2,2,2,3,1,3,1,2,2,1,0.6488856845230502,2,0,"White, Caucasian, Anglo, European American",0,25,0,1,NA,1,3,3,Customer service,7,0,185,71,3,5,2,0,0,1,0,0,TRUE,TRUE,TRUE,TRUE,TRUE,4,0.9698625000044704,0.64,0.12312368635075824,4,0.4586379310385934,0.5531812499985099,0.9354838709677419,1,0.010034411849764346,0.010191947380106774,4,0.7676806451601367,0.90884375,1,1,0.17732693295419416,0.08392329157176032,1.5026,0.3983,0.5195,0,43.4388,0.014,ML,change,50,-75.14153098371557,0.43175424506475885,1.3326195433637555,0.5377492360273145,1.2766,3.5397,0.3729,2.9304,0.2625,0,-52.9825,0.012,ML,cueing,63,118.3944041791746,3.6161646896546094,1.1457262270837714,0.39971447266080307,2.923453868831406,0.9147223692965154,0.3223789524075188,0.108,0.421,0.374,0.008,1.389,127.02685644763913,1925.454908793788,0.108,0.421,0.372,0.008,1.453,145.70576920410483,1926.6007747722886,347,1.028148148148148,1,0,0,1,FALSE,FALSE,FALSE
346,2021-11-13T03:38:27Z,2021-11-13T04:09:25Z,1857,1,2021-11-13T04:09:27Z,1,Chrome,95.0.4638.69,Windows NT 10.0,1920,1080,Nope it was a very solid survey!,1.7777777777777777,955,64,493,68,48,77,0.4260029303908155,-0.23442610839226255,0.3153106603738572,-0.44579523719599906,-0.3307319143023651,-0.47931955185002084,4,4,2,2,2,1,1,3,1,3,4,2,1,4,3,3,1,2,4,1,1.187655806953123,0,1,1,3,3,1.8,0,4,5,1,5,1,1,3,1,1,1,1,5,3,4,5,3,1,2,1,3,2,3,3,4,2,1,0,5,1,3,5,5,5,2,2,2,1,5,1,1,3,2,5,2,2,3,2,2,1,4,2,3,2,3,1,1,1,1,5,1,3,1,3,1,2,2,2,2,1.464802254792655,1.791514389985135,2.25,0,2,0,1.4,0,2.6666666666666665,0,1.75,0,3,0,1.1428571428571428,0,1.6666666666666667,0,2.108108108108108,0,2,1,0,-0.3830801961592365,0.18918219877700804,-0.09694899869111423,5,1,3,1,1,1,1,3,3,1.5735915849388864,1.2857142857142858,0,3,0.005791155812417015,5,5,5,5,4,4,2,3,1,2,1,1.1126972805283737,4.571428571428571,0,1.4285714285714286,7,3.8333333333333335,3.2559414990859232,1.5194825076544112,0,0.18628970840167225,5,5,5,5,5,5,3,4,5,1,1,5,5,3,2,5,5,3,3,5,1.4960264830861913,5,0,3.8,0,1.8,0,1.8,0,2.466666666666667,0,3,2,4,4,2,3,1,3,1,3,2,2,3,4,4,4,3,2,2,4,1.0052493799000692,2.5,0,"White, Caucasian, Anglo, European American",0,25,0,1,NA,1,2,4,Self employed,3,0,210,74,2,5,2,0,0,1,0,0,TRUE,TRUE,TRUE,TRUE,TRUE,NA,NA,NA,NA,6,0.41782500000018624,0.47691562499990686,0.8571428571428571,1,0.007047352209008952,0.002107746522211119,6,0.6271062499994878,0.7490214285712157,1,0.9032258064516129,0.03685202899170853,0.034510305118299944,NA,NA,NA,NA,NA,NA,NA,NA,NA,NA,NA,NA,NA,1.0183,4.8713,0.3724,2.163,0.2308,0,-65.9615,0.011,ML,cueing,60,144.2060336866663,5.362383857433006,0.7726292702169344,0.40712533905411874,2.4326599169365037,0.736543343668215,0.3096918440519084,0.072,0.351,0.282,0.007,1.503,94.88529793110061,1983.8222447550086,0.076,0.37,0.314,0.008,1.552,93.3822876449914,1951.8654122872604,224,0.6637037037037037,1,0,1,2,FALSE,FALSE,FALSE
347,2021-11-13T03:47:45Z,2021-11-13T04:13:16Z,1531,1,2021-11-13T04:13:17Z,1,Chrome,94.0.4606.61,Macintosh,1440,900,no,1.6,900,48,329,83,40,76,0.28468774442489003,-0.3797819214031788,-0.474224557647077,-0.26299913918534573,-0.4412283913971238,-0.4962109186108739,3,3,2,4,1,1,2,3,1,2,2,2,2,4,2,2,3,2,2,2,0.8506963092234007,0,1,1,1,1,2.55,0,4,4,2,4,2,1,4,2,2,1,2,3,2,3,3,2,4,1,1,1,2,2,1,3,2,0,0,5,3,4,4,5,3,4,3,3,2,4,2,1,2,2,5,3,2,1,2,2,4,1,1,1,3,1,1,3,3,3,4,2,2,1,1,1,1,2,1,1,1.28224184307959,1.0555973258234952,1.75,0,1.25,0,2.066666666666667,0,2.2222222222222223,0,2,0,1.3333333333333333,0,2.142857142857143,0,1,0,1.945945945945946,0,2,0,0,-0.3811443917119342,-0.25265461696773905,-0.3168995043398366,5,2,4,1,1,2,1,1,1,1.6035674514745464,1.4285714285714286,0,1,-0.6467170085812028,5,5,5,5,4,2,1,4,7,6,4,1.6761634196950514,4.428571428571429,0,1.5714285714285714,3.5,3.8333333333333335,3.2559414990859232,-0.4571894270818581,0,-0.7223752615450256,2,2,2,5,2,2,4,2,2,4,4,5,3,4,5,1,4,4,4,2,1.2344267996967353,2.6,0,3.4,0,4,0,4.2,0,3.8666666666666667,0,2,1,3,2,3,3,2,2,2,1,3,2,2,3,1,2,2,3,3,2,0.6958523739384593,2.4,0,"White, Caucasian, Anglo, European American",0,28,0,1,NA,1,3,6,Sr Business Analyst,4,0,235,72,2,5,2,0,0,0,0,0,TRUE,TRUE,TRUE,TRUE,TRUE,6,1.0252093750238418,0.64,0.47169251902833687,6,0.5030187499821186,0.5245533332824707,1,0.967741935483871,0.0042605996364145126,0.0027443997840810586,6,0.7084500000178814,0.8568518518695125,1,0.9,0.10712231483766002,0.12190705753669315,1.7635,0.3268,0.4296,0,62.2583,0.004,ML,change,50,-112.78053098371556,0.30860806511545535,1.8643846676149203,0.17943156500957902,1.197,4.1469,0.3886,5.1498,0.3868,0,-85.1858,0.011,ML,cueing,63,182.80100417917458,4.600899493914413,0.7392461813523428,0.44939923784479324,4.497227036208416,0.9212643019874271,0.4037937402856146,0.069,0.444,0.284,0.013,1.694,149.8491116275643,2053.519974850936,0.07,0.442,0.284,0.013,1.779,146.01887594643975,2033.4311312755797,388,1.1496296296296296,1,0,0,1,FALSE,FALSE,FALSE
348,2021-11-13T03:49:54Z,2021-11-13T04:14:10Z,1456,1,2021-11-13T04:14:11Z,1,Chrome,95.0.4638.69,Windows NT 10.0,1920,1080,no,1.7777777777777777,699,64,404,100,63,78,-0.23175502610512866,-0.23442610839226255,-0.11315662257652782,-0.05583022810660534,-0.12355101974969247,-0.4624281850891678,3,2,2,2,2,2,2,1,1,2,1,2,1,2,1,1,1,1,1,1,0.6048053188292994,0,1,3,3,3,2.55,0,2,2,3,2,2,2,4,2,2,2,2,3,2,3,3,2,2,4,2,2,3,3,2,3,2,0,0,4,3,3,3,4,3,3,3,3,2,4,3,3,2,3,3,2,2,2,2,2,3,2,1,2,3,3,1,3,3,2,4,2,2,3,2,2,2,2,2,2,0.7583370458279584,0.6324555320336759,2.5,0,2,0,2.6666666666666665,0,2.7777777777777777,0,2.5,0,2.1666666666666665,0,2,0,2.3333333333333335,0,2.4594594594594597,0,2,0,0,0.41969790813683366,-0.01745100881601569,0.201123449660409,3,2,2,2,1,2,2,1,1,0.5773502691896257,2.2857142857142856,0,1,-0.1339138976503373,3,3,3,3,1,1,4,5,4,2,2,1.1338934190276817,2.2857142857142856,0,3.7142857142857144,4.5,3.8333333333333335,3.2559414990859232,0.10757398284279028,0,0.7550714047388498,2,2,3,2,2,2,3,3,2,2,3,3,3,3,4,4,4,3,3,3,0.6546536707079771,2.2,0,3.4,0,2.6,0,3.4,0,3.1333333333333333,0,2,1,3,1,2,3,3,1,3,2,3,1,2,3,1,1,1,2,2,3,0.8583950752789521,2.6,0,"White, Caucasian, Anglo, European American",0,28,0,1,NA,1,2,4,IT Analyst,3,0,200,70,2,5,2,0,0,1,0,0,TRUE,TRUE,TRUE,TRUE,TRUE,1,0.8877179487182353,0.78,0.04868439340407696,1,0.5527709677418874,0.6529968749999534,1,1,0.010181403462339606,0.00846959773183207,NA,NA,NA,NA,NA,NA,NA,1.2978,1.0247,0.5241,0,16.2442,0.004,ML,change,50,-20.75233098371556,1.130426736451281,1.11963591493293,0.6103907712265062,1.9353,4.7627,0.4498,5.4904,0.3765,0,-74.7245,0.012,ML,cueing,63,161.8784041791746,3.7874490425213923,1.0939116750817992,0.5130970475253099,3.6171005563281278,1.145429788824396,0.39938359425812786,NA,NA,NA,NA,NA,NA,NA,NA,NA,NA,NA,NA,NA,NA,104,0.3081481481481481,1,0,1,2,FALSE,FALSE,FALSE
349,2021-11-13T03:20:41Z,2021-11-13T04:14:15Z,3214,1,2021-11-13T04:14:17Z,1,Chrome,95.0.4638.69,Macintosh,1280,800,no,1.6,1203,390,530,66,69,103,1.0632059507462615,2.727198581705155,0.49343750834199473,-0.47016805026408615,-0.04067866192862343,-0.040144016067840904,3,3,2,1,3,1,2,2,1,3,2,1,1,1,2,2,1,1,2,2,0.7677718959499145,0,1,1,3,3,1.9,0,4,4,2,5,2,2,4,2,1,2,1,4,1,4,4,2,2,1,1,1,1,1,1,4,2,0,0,5,4,5,5,5,4,4,4,4,2,4,1,1,3,1,4,1,1,1,1,1,4,2,1,1,4,3,1,3,3,3,5,1,1,1,1,1,2,1,2,2,1.5716138106958624,1.3732131246511903,1.25,0,1.75,0,1.7333333333333334,0,1.5555555555555556,0,1.4166666666666667,0,2,0,1.7142857142857142,0,1,0,1.6216216216216217,0,2,0,0,-0.8786461346685052,-0.0958522115332568,-0.487249173100881,5,1,4,1,2,1,1,1,1,1.6761634196950514,1.2857142857142858,0,1,-0.7321841937363471,4,4,5,4,3,2,2,7,7,4,3,1.1338934190276817,3.7142857142857144,0,2.2857142857142856,2,3.8333333333333335,3.2559414990859232,-1.3043345419688306,0,-0.7475928318813282,1,1,1,1,1,1,4,2,4,3,1,4,2,4,2,1,3,2,4,2,1.1832159566199232,1,0,4.2,0,4,0,3.2,0,3.8,0,1,2,1,3,2,2,1,2,1,2,3,3,1,2,1,3,1,2,2,1,0.7677718959499145,1.7,0,"Asian or Asian American (e.g., Chinese, Japanese, and others)",0,20,1,2,NA,1,3,3,student,5,0,164,61,2,5,1,0,0,0,1,0,TRUE,TRUE,TRUE,TRUE,TRUE,NA,NA,NA,NA,2,0.5720200000047684,0.671090322579107,1,0.96875,0.027335914761841447,0.07493511354737199,2,1.009140625,1.117251612913224,1,1,0.24626421409370222,0.10253172458027279,NA,NA,NA,NA,NA,NA,NA,NA,NA,NA,NA,NA,NA,1.2934,2.5162,0.4241,3.0101,0.3572,0,-37.3557,0.013,ML,cueing,62,87.09280315513527,2.02203875156203,1.698279620918433,0.27739432061546976,2.82571977858794,1.4662227860619381,0.3206852189056847,0.166,0.384,0.3,0.01,1.604,191.9239090561715,2029.2157633119596,0.161,0.385,0.298,0.01,1.844,214.52904169189213,1999.3787195108046,104,0.3081481481481481,1,0,0,1,FALSE,FALSE,FALSE
350,2021-11-13T03:33:31Z,2021-11-13T04:14:54Z,2483,1,2021-11-13T04:14:54Z,0.8999999761581421,Chrome,95.0.4638.69,Windows NT 10.0,1366,768,NA,1.7786458333333333,1742,59,250,55,35,126,2.4480947732123313,-0.2798497999581739,-0.8545494492547221,-0.6042185221385653,-0.510288689581348,0.3483574194317798,4,4,4,4,4,4,4,4,4,4,4,4,4,4,4,4,4,4,4,4,0,0,0,2,3,3,2.5,0,3,4,3,3,3,2,3,2,3,2,2,3,2,3,2,3,3,3,3,3,3,3,3,5,6,0,0,2,1,2,5,2,2,3,4,5,3,2,3,2,3,2,2,3,5,3,4,3,1,1,3,2,3,5,3,NA,3,5,3,4,3,5,5,5,1,1,1,1,1.259881576697424,0.6172133998483676,3,0,1,0,2.6666666666666665,0,3.111111111111111,0,3.25,0,3,0,3.3333333333333335,1,5,0,3.388888888888889,1,3,0,0,1.0339931860806149,-0.12796334588846375,0.4530149200960756,2,3,2,3,2,3,3,8,4,0.5345224838248488,3.142857142857143,0,6,2.223827587152439,3,2,3,2,3,2,3,5,5,4,3,0.5345224838248488,2.5714285714285716,0,3.4285714285714284,4,3.8333333333333335,3.2559414990859232,-0.1748077221195339,0,0.45453855741481414,5,5,5,5,5,5,4,5,4,5,5,5,4,5,3,4,2,4,2,3,1.0690449676496976,5,0,2.2,0,3,0,2.8,0,2.6666666666666665,0,2,3,3,1,1,1,1,1,1,1,1,1,1,1,1,1,1,1,1,1,0.6386663736585051,1.85,0,Black or African American,0,25,0,1,NA,1,3,5,NA,5,0,197,69,5,5,2,0,0,1,0,0,TRUE,TRUE,TRUE,TRUE,TRUE,6,0.7897533333331347,0.6382978723404256,0.09958438346851138,6,0.5398900000008444,0.6935612903227729,0.967741935483871,1,0.009327624516048707,0.018435866451875695,6,0.7046468749991618,0.7762838709683668,1,1,0.01375740063510177,0.010325664731174024,1.4089,0.4087,0.2644,0,36.6687,0.003,ML,change,47,-61.78695719486983,0.44961911900968377,1.2632559728709096,0.4011897561120816,1.523,3.0569,0.4445,3.5275,0.3332,0,-45.2094,0.011,ML,cueing,62,102.80020315513528,3.1181471475433162,1.3287168726645149,0.4871575496577619,3.3885338356524164,1.0037371756116171,0.4013374601684369,0.212,0.382,0.656,0.017,1.424,117.02845233448558,1906.3189726865976,0.211,0.389,0.665,0.017,1.523,136.91301478820404,1922.4980881812473,316,0.9362962962962963,1,0,0,1,FALSE,FALSE,FALSE
351,2021-11-13T03:39:11Z,2021-11-13T04:16:35Z,2244,1,2021-11-13T04:16:36Z,1,Chrome,95.0.4638.69,Windows NT 6.3,1366,768,"This was fun!
",1.7786458333333333,772,88,717,135,84,166,-0.044191233823082085,-0.016392388875888245,1.3937002264512306,0.370694000584919,0.16650223262404917,1.0240120898659029,2,2,2,1,2,1,1,2,1,2,2,1,1,2,2,3,1,1,3,2,0.6569466853317864,0,1,1,3,3,2,0,5,5,3,3,4,3,3,3,2,1,2,4,2,4,3,2,1,1,2,1,1,1,1,2,2,0,0,4,3,2,3,3,4,3,3,3,2,4,1,1,4,2,1,5,2,1,1,1,5,1,1,1,3,1,2,2,1,1,3,3,3,1,1,1,2,1,1,1,1.2562157768783506,1.1254628677422756,1.25,0,1.25,0,2.3333333333333335,0,2.888888888888889,0,2.0833333333333335,0,1.1666666666666667,0,2,0,1,0,2.081081081081081,0,1,0,0,-0.42334492866311435,-0.4557470907642554,-0.43954600971368485,1,4,1,3,2,4,4,2,1,1.3801311186847085,3.857142857142857,0,1.5,0.990718976443441,4,3,4,4,1,1,3,NA,NA,2,1,1.3451854182690985,2.857142857142857,0,3.142857142857143,NA,3.8333333333333335,3.2559414990859232,NA,1,0.7652008472634154,2,3,1,2,1,2,3,2,2,1,2,5,2,4,5,2,5,1,2,5,1.505545305418162,1.8,0,4.6,0,2.8,0,3.6,0,3.6666666666666665,0,1,1,1,3,1,1,3,4,1,1,2,4,1,1,1,4,1,1,1,1,1.1742858972247996,1.2,0,"Hispanic of Latino (e.g., Mexican American, Central American, and others)",0,29,0,1,NA,1,2,3,English Tutor,1,0,240,65,2,5,2,0,0,3,0,0,TRUE,TRUE,TRUE,TRUE,TRUE,NA,NA,NA,NA,1,0.5024935483797904,0.6167562500033528,1,1,0.0016105252904474146,0.00646866834619745,1,0.731562500005588,0.726346875000745,1,1,0.02121335919185274,0.012824657410808458,NA,NA,NA,NA,NA,NA,NA,NA,NA,NA,NA,NA,NA,4.2264,7.1606,0.3216,10.6019,0.3032,0,-93.8965,0.017,ML,cueing,63,200.2224041791746,4.05143404363244,1.0226341294888452,0.494493761922207,5.735491059292561,0.7223679164626863,0.44148796822641967,0.286,0.187,0.532,0.137,1.101,16.893492813319167,1801.6201892595245,0.286,0.188,0.531,0.143,1.112,22.476570362326555,1803.6274610386415,400,1.1851851851851851,1,0,0,1,FALSE,FALSE,FALSE
352,2021-11-13T03:50:17Z,2021-11-13T04:17:20Z,1623,1,2021-11-13T04:17:21Z,0.800000011920929,Firefox,94.0,Windows NT 10.0,1920,1080,gg,1.7777777777777777,903,107,329,69,42,95,0.29239584547757685,0.15621763907457475,-0.474224557647077,-0.4336088306619555,-0.4136042721234341,-0.1752749501546655,2,2,1,2,2,1,2,2,2,2,2,2,2,2,2,2,2,2,2,2,0.30779350562554625,0,1,2,3,3,2.4,0,3,3,3,4,4,4,3,3,3,3,3,3,3,3,3,3,3,4,4,3,3,3,3,2,2,1,1,4,4,4,4,4,4,4,4,4,4,4,3,3,3,3,3,2,3,3,3,3,2,2,3,3,3,3,1,2,3,3,3,2,2,3,3,3,2,2,2,3,0.7593263966019992,0.4140393356054125,3.25,0,2.25,0,3.066666666666667,0,2,0,2.9166666666666665,0,2.8333333333333335,0,2.142857142857143,0,3,0,2.5945945945945947,0,1,1,1,0.9719829169520463,0.2409405745969135,0.6064617457744799,3,2,3,3,2,4,4,3,2,0.816496580927726,3,0,2.5,0.8469035402869574,3,3,3,3,2,2,3,7,7,3,3,0.4879500364742666,2.7142857142857144,0,3.2857142857142856,2,3.8333333333333335,3.2559414990859232,-1.3043345419688306,0,-0.189895849931271,2,2,4,4,4,2,4,2,2,4,2,2,2,4,4,3,4,4,4,4,0.990430401872025,3.2,0,3.2,0,3.8,0,3.6,0,3.533333333333333,0,2,2,2,3,3,3,3,3,2,3,3,3,3,3,2,2,2,2,3,3,0.5026246899500346,2.5,0,"Hispanic of Latino (e.g., Mexican American, Central American, and others) & White, Caucasian, Anglo, European American",1,22,0,1,NA,1,2,4,Growing Plants,4,0,150,73,4,5,2,0,0,0,0,0,TRUE,TRUE,TRUE,TRUE,TRUE,3,0.6629166666666667,0.7346938775510204,0.11049280272108841,3,0.5334333333333333,0.6893548387096774,1,0.96875,0.06820066781609196,0.1520047328629032,3,0.5719354838709677,0.6823793103448276,0.96875,0.9354838709677419,0.013252705645161289,0.02235796559139785,1.2971,0.8009,0.3195,0,23,0.003,ML,change,49,-34.32453910566812,0.7598150154276307,1.3405494236268984,0.2488438517161592,1.482,2.2081,0.3674,2.8729,0.2755,0,-24.4913,0.011,ML,cueing,62,61.36400315513527,1.694324298788321,2.026759108006022,0.12863376981086216,2.2483573456357417,1.8427385372853293,0.13644284570904597,0.078,0.367,0.366,0.009,1.524,71.25427156070515,1977.1497662359352,0.074,0.372,0.374,0.01,1.496,96.861868547409955,1987.5898259652322,104,0.3081481481481481,1,1,0,1,FALSE,FALSE,FALSE
353,2021-11-13T03:56:55Z,2021-11-13T04:20:33Z,1417,1,2021-11-13T04:20:34Z,1,Edge,95.0.1020.44,Windows NT 10.0,1920,1080,NA,1.7777777777777777,627,50,443,100,38,83,-0.41674945136961294,-0.36161244477681426,0.07459870366015774,-0.05583022810660534,-0.46885251067081346,-0.3779713512849024,4,4,1,1,4,1,1,3,1,4,3,1,1,1,4,3,1,1,3,3,1.332784974957958,0,1,1,4,3,1.25,0,5,5,1,5,1,1,5,1,1,1,1,5,1,5,5,1,3,3,1,1,1,1,1,0,2,1,0,5,5,5,5,5,5,2,4,5,1,5,1,1,5,1,5,1,1,1,1,1,3,1,1,1,2,1,1,1,1,1,5,1,1,1,1,1,1,1,1,1,1.8310796959315705,2.065591117977289,1.5,0,1,0,1,0,1.4444444444444444,0,1,0,1.3333333333333333,0,0.8571428571428571,0,1,0,1.1891891891891893,0,0,1,0,-1.2721951788049675,-0.5306075596849892,-0.9014013692449783,5,1,2,1,1,1,1,3,2,1.4960264830861913,1.4285714285714286,0,2.5,-0.09323549641962975,5,5,5,5,2,2,1,5,5,2,3,1.8126539343499315,4.142857142857143,0,1.8571428571428572,4,3.8333333333333335,3.2559414990859232,-0.1748077221195339,0,-0.42184241422098995,1,1,1,1,1,1,4,1,1,3,2,4,1,5,5,2,5,2,4,3,1.5522640914238175,1,0,4.4,0,4,0,4.6,0,4.333333333333333,0,1,1,1,4,1,1,1,4,1,1,1,4,1,1,1,4,1,1,1,1,1.231174022502185,1,0,"White, Caucasian, Anglo, European American",0,19,0,1,NA,1,4,4,Student,4,0,210,70,2,5,2,0,0,1,0,0,TRUE,TRUE,TRUE,TRUE,TRUE,5,0.6974714285717124,0.84,0.05447185724588709,5,0.30983437499962746,0.38049032257449245,1,0.96875,0.0012626565221512203,0.0016637970865659203,5,0.4367312499973923,0.5085833333353201,1,0.9375,0.00237001447602435,0.004618981128331366,1.2636,1.341,0.3938,0,7.0062,0.004,ML,change,50,-2.276330983715562,1.3741650531348637,1.2067168152913215,0.39890196905658737,1.2271,4.902,0.2605,7.8287,0.2315,0,-110.7997,0.011,ML,cueing,64,234.07604925007902,5.238244033317039,0.6555607533066049,0.3218267511261264,6.095245293014087,0.6797322383629225,0.2558176312708071,0.054,0.346,0.579,0.015,1.485,39.87207020528845,1889.682530442073,0.054,0.346,0.618,0.016,1.558,49.15648820174742,1894.212325540221,312,0.9244444444444444,1,0,0,1,FALSE,FALSE,FALSE
354,2021-11-13T03:57:24Z,2021-11-13T04:22:56Z,1532,1,2021-11-13T04:22:57Z,0.8999999761581421,Chrome,95.0.4638.69,Windows NT 10.0,1920,1080,n/a,1.7777777777777777,702,63,435,113,75,81,-0.22404692505244184,-0.24351084670544482,0.03608479058596582,0.10259305683596086,0.04219369589244561,-0.4117540848066085,3,3,2,2,3,1,1,3,1,3,2,1,2,2,3,3,1,1,3,3,0.8750939799154206,0,1,1,3,3,1.75,0,4,4,4,3,3,3,2,3,2,3,2,3,2,4,3,2,3,1,1,3,4,3,3,1,2,0,0,4,3,3,4,4,5,3,3,4,3,5,2,1,4,2,5,4,3,2,2,2,3,1,1,1,3,1,2,2,3,1,3,2,3,1,4,2,2,2,1,2,1.2167499662956562,0.7559289460184544,2.5,0,1.75,0,2.7333333333333334,0,2.3333333333333335,0,2.0833333333333335,0,1.5,0,2.142857142857143,0,2.3333333333333335,0,2.135135135135135,0,1,0,0,0.3089698937511685,-0.2989446853297732,0.005012604210697658,4,2,3,1,1,2,3,1,1,1.1126972805283737,2,0,1,-0.3048482679606258,3,4,4,3,1,1,4,4,3,2,2,1.3451854182690985,2.5714285714285716,0,3.4285714285714284,5.5,3.8333333333333335,3.2559414990859232,0.6723373927674386,0,0.8781111148583004,2,3,3,3,2,3,4,4,2,4,4,3,2,4,4,2,3,2,4,3,0.8618916073713346,2.6,0,3,0,4,0,3.4,0,3.466666666666667,0,2,4,3,2,4,4,4,3,2,1,3,2,2,3,1,3,1,2,2,3,0.998683343734455,2.55,0,"White, Caucasian, Anglo, European American",0,26,0,1,NA,1,3,7,Accountant,5,0,175,69,1,5,2,0,0,2,0,0,TRUE,TRUE,TRUE,TRUE,TRUE,3,0.8578695652173913,0.92,0.12960723135716704,3,0.46417741935291595,0.5328718750011175,0.96875,1,0.002853454153378145,0.0028615098286394022,3,0.6221656249966472,0.6628937499895692,1,1,0.010037620394636964,0.008130914151539593,1.6461,1.5034,0.3827,0,15.8024,0.005,ML,change,50,-19.868730983715565,1.4586709613091486,1.6743646100812297,0.37576417278333,1.2738,4.8226,0.4008,5.0637,0.3448,0,-89.2511,0.014,ML,cueing,64,190.978849250079,4.967795204103687,0.83399869684021255,0.45155448928274555,4.57739185048091,0.750206081684784,0.3873522070318872,0.199,0.275,0.582,0.023,1.266,73.30534948052663,1877.4152522308607,0.2,0.273,0.581,0.021,1.362,85.58221119477888,1871.216746867575,517,1.5318518518518518,1,0,0,1,FALSE,FALSE,FALSE
355,2021-11-13T03:39:39Z,2021-11-13T04:31:16Z,3097,1,2021-11-13T04:31:19Z,1,Firefox,94.0,Windows NT 10.0,1536,864,No,1.7777777777777777,1003,169,1275,198,115,243,0.5493325472338051,0.719471414491875,4.080045663376116,1.1384376122296629,0.5946760813662392,2.3246473304515893,4,4,1,1,3,1,1,4,1,4,4,1,1,1,4,3,1,1,3,3,1.3803127029389886,0,1,1,4,4,1.2,0,1,5,2,4,2,1,5,1,2,2,1,5,3,5,4,1,1,1,1,1,1,1,1,0,2,0,0,4,4,4,4,4,4,4,4,4,2,4,2,2,4,2,5,1,1,2,1,1,5,1,1,1,2,1,2,1,2,1,5,1,1,1,1,1,1,1,1,1,1.4821257357919053,1.6417180315870614,1,0,1,0,1.8,0,2,0,1.5833333333333333,0,1,0,1.1428571428571428,0,1,0,1.5135135135135136,0,0,0,0,-1.0038926824089338,-0.7372407672780129,-0.8705667248434734,5,1,3,1,1,1,2,3,1,1.5275252316519468,1.4285714285714286,0,2,-0.2777293338068208,4,5,4,5,4,4,2,6,6,4,3,1,4.285714285714286,0,1.7142857142857142,3,3.8333333333333335,3.2559414990859232,-0.7395711320441822,0,-0.783895116604751,1,1,1,1,1,1,3,2,1,3,1,4,1,4,5,1,5,2,3,4,1.4960264830861913,1,0,4.6,0,3.8,0,4,0,4.133333333333334,0,1,1,1,4,1,1,1,4,1,1,2,4,1,1,1,4,1,1,1,1,1.2258187382102494,1.05,0,Middle Eastern,0,29,0,1,NA,0,3,6,Computer engineer,5,0,225,74,2,5,2,0,0,1,0,0,TRUE,TRUE,TRUE,TRUE,TRUE,6,1.74965625,0.64,0.3265709914285715,6,0.8350344827586207,0.9238064516129032,0.9354838709677419,0.96875,0.013129049462365589,0.01075456451612903,6,1.030125,1.15396875,1,1,0.006217790322580645,0.009228998991935487,1.9716,0.3036,0.8825,0,70.2271,0.003,ML,change,50,-128.71813098371555,0.3383199575119911,1.7006509138118735,1.0459108083045492,1.4508,3.5849,0.7302,1.968,0.4969,0,-31.2359,0.01,ML,cueing,63,74.9012041791746,3.2852060166497012,1.0452882367441827,0.7746593787990275,2.6420191047828796,1.0249926642088976,0.6547683391730261,0.441,0.498,0.785,0.014,1.3,152.2404114953263,1959.6701849958636,0.429,0.484,0.77,0.011,1.388,162.1416686496265,1959.1207569768103,289,0.8562962962962963,1,0,0,1,FALSE,FALSE,FALSE
356,2021-11-13T04:06:53Z,2021-11-13T04:33:05Z,1572,1,2021-11-13T04:33:06Z,1,Chrome,95.0.4638.69,Windows NT 6.3,1440,960,NA,1.5,709,85,429,125,67,106,-0.20606135592950586,-0.04364660381543503,0.007199355780321893,0.24882993524448352,-0.06830278120231312,0.010530084214718316,3,4,1,1,3,1,1,2,1,3,2,1,1,1,3,2,1,1,3,2,0.9880869341680844,0,1,2,2,2,1.65,0,4,4,3,4,2,3,2,3,2,3,2,3,2,3,4,1,1,1,1,1,2,2,2,5,2,0,0,4,4,5,5,3,5,4,4,5,2,5,1,1,4,1,5,2,1,1,2,1,4,1,3,1,3,1,1,3,3,1,4,1,1,1,1,1,1,1,2,2,1.590606811889736,0.7988086367179802,1.375,0,1.5,0,2.533333333333333,0,1.6666666666666667,0,1.3333333333333333,0,1.6666666666666667,0,1.5714285714285714,0,1,0,1.5405405405405406,0,3,0,0,-0.5159731714665071,0.028839059546018453,-0.24356705596024433,5,1,3,1,1,2,2,4,1,1.4638501094227998,1.5714285714285714,0,2.5,-0.007768311264485517,4,5,5,5,2,2,2,6,5,4,3,1.5118578920369088,3.857142857142857,0,2.142857142857143,3.5,3.8333333333333335,3.2559414990859232,-0.4571894270818581,0,-0.40369127185927867,2,3,2,2,2,3,3,3,1,3,3,3,2,4,4,2,4,3,3,4,0.8451542547285166,2.2,0,3.2,0,3.4,0,3.6,0,3.4,0,2,1,2,3,3,3,3,2,1,1,2,3,2,1,1,2,1,3,1,3,0.8583950752789521,2,0,"White, Caucasian, Anglo, European American",0,26,0,1,NA,1,3,4,Student,1,0,315,72,2,5,2,0,0,1,0,0,TRUE,TRUE,TRUE,TRUE,TRUE,1,0.8985999999962202,0.82,0.05759747035006367,1,0.5285749999973923,0.5999413793169219,1,0.9354838709677419,0.0027609258061179237,0.004658719785375593,1,0.6537343749981374,0.743215624999255,1,1,0.00405711974779473,0.01015490781280612,1.3712,1.1402,0.5408,0,17.8381,0.004,ML,change,50,-23.940130983715562,1.2614732668609565,1.2020448860889137,0.5936752951662683,1.4131,3.1016,0.3996,5.4662,0.3993,0,-69.6432,0.015,ML,cueing,63,151.7158041791746,3.541625031216322,0.755062612743091,0.5070976743729656,5.012435652111139,0.8265711550125389,0.4486995799427587,0.077,0.521,0.517,0.026,1.962,53.965256724208004,1856.3630294076022,0.078,0.522,0.54,0.032,2.089,64.04528910635742,1846.6253301055062,104,0.3081481481481481,1,1,0,1,FALSE,FALSE,FALSE
357,2021-11-13T04:10:22Z,2021-11-13T04:34:00Z,1417,1,2021-11-13T04:34:01Z,1,Chrome,95.0.4638.69,Macintosh,1680,1050,NA,1.6,622,51,396,155,55,66,-0.42959628645742437,-0.35252770646363196,-0.15167053565071972,0.6144221312657902,-0.2340474968444512,-0.6651245862194046,3,4,2,2,3,1,4,2,1,3,2,3,1,1,2,3,2,2,2,3,0.9233805168766387,0,1,1,4,4,2.1,0,5,5,1,5,1,1,3,2,2,1,4,4,2,4,5,2,4,4,1,1,2,1,1,0,2,0,0,5,5,5,5,5,5,5,5,5,1,5,1,1,4,1,5,1,3,3,3,4,3,1,1,1,1,1,1,1,1,1,5,2,2,1,1,1,1,1,1,1,1.8050646133194952,1.647508942095828,2,0,1,0,1.6666666666666667,0,1,0,1.8333333333333333,0,1.1666666666666667,0,1.1428571428571428,0,1,0,1.3783783783783783,0,0,0,0,-0.6895180401671162,-0.7372407672780129,-0.7133794037225645,5,1,5,1,1,2,1,1,1,1.889822365046136,1.1428571428571428,0,1,-0.8176513788914915,5,5,5,5,3,3,1,8,8,4,3,1.5735915849388864,4.428571428571429,0,1.5714285714285714,1,3.8333333333333335,3.2559414990859232,-1.869097951893479,0,-1.428329523950836,2,1,2,1,2,1,5,1,1,4,1,4,1,4,5,1,4,1,4,3,1.6761634196950514,1.6,0,4.6,0,4.6,0,4.4,0,4.533333333333333,0,2,1,1,4,2,1,2,2,2,1,2,3,2,3,2,2,1,1,1,2,0.812727700887249,1.75,0,"White, Caucasian, Anglo, European American",0,24,0,1,NA,1,4,6,Student,4,0,130,69,3,5,2,0,0,1,0,0,TRUE,TRUE,TRUE,TRUE,TRUE,6,0.7071487179474953,0.78,0.048822708319217985,6,0.46639375000447036,0.5546354838801969,1,0.96875,0.01036011479551198,0.015352493140375767,6,0.8183387096620375,0.7691870967495826,1,0.96875,0.24622727242910555,0.043232969630467806,1.297,1.0405,0.3411,0,15.1344,0.004,ML,change,50,-18.53273098371556,1.1296252586846347,1.1204303051837308,0.42942786933903815,1.4057,2.7201,0.3067,4.2384,0.3006,0,-53.438,0.01,ML,cueing,64,119.35264925007903,3.005495546976911,1.1425693869149915,0.37643545272223466,3.601399935459219,1.1504233910814563,0.31166604965423794,0.092,0.357,0.221,0.125,1.568,187.32390826900695,2041.7787468503711,0.089,0.374,0.22,0.032,1.738,214.31388293211933,2039.4612603469116,408,1.208888888888889,1,0,1,2,FALSE,FALSE,FALSE
358,2021-11-13T04:13:28Z,2021-11-13T04:36:21Z,1373,1,2021-11-13T04:36:22Z,1,Edge,95.0.1020.44,Windows NT 10.0,1920,1080,nope,1.7777777777777777,681,64,329,73,57,83,-0.27800363242124976,-0.23442610839226255,-0.474224557647077,-0.38486320452578127,-0.2064233775707615,-0.3779713512849024,4,4,1,1,4,1,2,3,1,4,4,2,1,2,4,4,2,1,3,4,1.3138933706635727,0,1,1,4,4,1.3,0,3,3,4,4,3,4,4,2,2,2,2,5,3,4,4,3,3,5,3,2,2,3,2,3,2,0,0,4,4,4,5,5,5,4,5,5,2,3,2,1,5,2,5,3,3,3,2,4,3,1,4,2,4,4,2,2,2,3,4,2,2,2,2,1,2,3,4,4,1.2944789205219511,0.9611501047232549,2.875,0,3.25,0,2.466666666666667,0,1.4444444444444444,0,2.25,0,2.8333333333333335,0,2,0,1.6666666666666667,0,2.108108108108108,0,2,0,0,0.3439111640249665,0.3745550047701899,0.3592330843975782,2,3,4,3,3,3,4,4,2,0.6900655593423543,3.142857142857143,0,3,1.1168645628292926,4,4,4,4,2,2,2,6,3,2,2,1.0690449676496976,3.4285714285714284,0,2.5714285714285716,4.5,3.8333333333333335,3.2559414990859232,0.10757398284279028,0,0.11770342536735592,4,3,4,3,3,3,4,3,2,3,2,4,2,3,3,3,4,3,3,3,0.6546536707079771,3.4,0,3.6,0,3.4,0,3.2,0,3.4,0,1,1,1,4,2,2,1,3,1,1,2,3,2,2,1,3,1,2,2,2,0.8750939799154206,1.55,0,"White, Caucasian, Anglo, European American",0,30,0,1,NA,1,3,4,unemployed,3,0,215,73,3,5,2,0,0,1,0,0,TRUE,TRUE,TRUE,TRUE,TRUE,2,1.1917684210507493,0.76,0.18801290782149493,2,0.48814193548646667,0.4944781250008382,1,1,0.004829711849401184,0.0024876075706578064,2,0.6280687499986961,0.6819750000000931,1,1,0.009842872540121936,0.009728854838567707,1.8817,0.6575,0.4507,0,54.2641,0.003,ML,change,50,-96.79213098371557,0.7431581450815394,1.5510554752944454,0.6491188837408831,5.4857,10.091,0.2227,8.7862,0.176,0,-92.6478,0.025,ML,cueing,63,197.72500417917462,5.144782589758189,0.8053080288833477,0.4186593572132755,4.358451215030139,0.9505979353638084,0.38249755581462475,0.124,0.39,0.561,0.025,1.682,17.43418393717526,1808.4615317948253,0.127,0.391,0.563,0.027,1.8,29.287811360637377,1812.9167592094482,314,0.9303703703703704,1,0,0,1,FALSE,FALSE,FALSE
359,2021-11-13T04:20:27Z,2021-11-13T04:40:27Z,1199,1,2021-11-13T04:40:29Z,1,Firefox,94.0,Windows NT 10.0,2048,1152,NA,1.7777777777777777,590,52,324,78,53,59,-0.5118160310194174,-0.3434429681504497,-0.49829575331844694,-0.3239311718555635,-0.2616716161181409,-0.7833641535453761,3,4,1,1,3,1,2,3,1,3,3,1,2,2,3,3,1,1,3,4,1.0699237552766379,0,1,1,3,3,1.55,0,3,4,2,4,3,4,3,3,3,2,2,4,2,3,4,1,1,1,1,2,2,3,2,3,2,0,0,4,5,5,5,5,4,4,5,4,1,4,1,1,3,2,5,1,2,2,1,3,5,1,2,1,2,1,1,3,3,3,5,2,2,1,1,1,2,1,3,3,1.5749541201192117,0.7988086367179802,1.625,0,2.25,0,2.533333333333333,0,1.4444444444444444,0,1.6666666666666667,0,1.1666666666666667,0,2,0,1,0,1.5945945945945945,0,2,0,0,-0.38530637127363354,0.06095019390122543,-0.16217808868620406,5,2,4,2,1,2,1,2,1,1.5118578920369088,1.5714285714285714,0,1.5,-0.3767559860388676,5,5,5,5,3,2,2,7,7,4,3,1.4638501094227998,4.142857142857143,0,1.8571428571428572,2,3.8333333333333335,3.2559414990859232,-1.3043345419688306,0,-0.9866058241456384,2,2,3,2,3,2,4,3,2,2,1,4,3,4,4,2,4,3,4,4,1.0327955589886444,2.4,0,4,0,3.4,0,3.4,0,3.6,0,2,1,1,4,4,3,3,3,1,1,2,4,1,1,1,4,1,2,1,2,1.2096106376585989,1.6,0,"White, Caucasian, Anglo, European American",0,23,0,1,NA,1,4,4,Student,6,0,145,66,3,5,2,0,0,1,0,0,TRUE,TRUE,TRUE,TRUE,TRUE,6,1.0252682926829269,0.82,0.18921450979591836,6,0.3944375,0.5064333333333333,1,0.9375,0.0017014798387096773,0.007458447580645163,6,0.55309375,0.6076451612903225,1,0.96875,0.00838744254032258,0.00955482157258065,1.8711,0.8823,0.3775,0,44.9105,0.004,ML,change,50,-78.08493098371557,0.9370015183043117,1.6182977932759564,0.4725954487952596,1.2526,2.8291,0.3039,6.3296,0.2955,0,-78.2127,0.011,ML,cueing,64,168.90204925007902,3.1720137883286132,0.8537321656880712,0.3886823248532161,5.657255489383314,0.7323577190683265,0.33173293047164204,0.071,0.381,0.413,0.015,1.359,65.76116994699049,1926.316177211519,0.069,0.383,0.448,0.015,1.469,86.16535358813651,1910.636030869067,289,0.8562962962962963,1,0,1,2,FALSE,FALSE,FALSE
360,2021-11-13T04:20:20Z,2021-11-13T04:43:00Z,1360,1,2021-11-13T04:43:01Z,1,Chrome,95.0.4638.69,Windows NT 6.3,1920,1080,NA,1.7777777777777777,813,49,278,61,36,75,0.06115281389697148,-0.3706971830899965,-0.7197507534950504,-0.5311000829343039,-0.49647662994450314,-0.513102285371727,2,1,3,2,1,2,3,1,1,2,2,2,2,3,2,2,3,1,2,1,0.7181848464596079,0,1,1,4,4,2.8,0,2,3,2,4,2,1,3,3,2,2,2,2,1,3,3,4,4,3,1,2,3,3,2,1,2,0,0,4,5,4,3,3,5,4,5,4,2,4,2,2,4,2,4,2,4,3,3,3,2,1,1,2,3,1,1,3,1,2,4,2,2,1,1,1,1,3,1,1,1.2880835218102742,0.816496580927726,2.75,0,1.5,0,2.466666666666667,0,1.8888888888888888,0,2.4166666666666665,0,1.8333333333333333,0,1.7142857142857142,0,1,0,2,0,1,0,0,0.2437332838770968,-0.3773458880470143,-0.06680630208495875,4,1,3,1,1,2,1,2,1,1.2149857925879117,1.5714285714285714,0,1.5,-0.3767559860388676,5,5,5,5,2,2,2,3,4,3,3,1.6035674514745464,4,0,2,5.5,3.8333333333333335,3.2559414990859232,0.6723373927674386,0,0.081401140643933,2,3,3,3,3,3,2,2,2,3,4,3,3,4,3,4,3,2,4,3,0.7559289460184544,2.8,0,3,0,2.8,0,3.6,0,3.1333333333333333,0,1,1,1,4,1,2,2,4,2,2,1,3,1,1,1,3,1,2,1,2,1.0052493799000692,1.4,0,"Hispanic of Latino (e.g., Mexican American, Central American, and others)",0,24,0,1,NA,1,3,4,Unemployed,3,0,183,72,4,5,2,0,0,1,0,0,TRUE,TRUE,TRUE,TRUE,TRUE,6,1.0123046511772067,0.86,0.048738260222410616,6,0.49497419356530714,0.583835483874044,0.96875,0.96875,0.007502052485815152,0.007601973701675562,6,1.2056275862167622,1.0674483870998506,0.9666666666666667,1,0.6415830403656204,0.3177509046128657,1.5166,1.2757,0.6069,0,18.7605,0.003,ML,change,50,-25.78493098371556,1.5149955530554056,1.198214716193204,0.7275795264337033,1.2149,2.9157,0.3834,4.0783,0.3568,0,-60.4599,0.011,ML,cueing,64,133.396449250079,3.5828549482636465,0.9584499663178813,0.4584401139249375,3.594725995343474,0.9552848280879975,0.3704056551714753,0.111,0.32,0.146,0.108,1.574,164.12139957123816,2016.1944514214704,0.113,0.332,0.146,0.166,1.613,214.65263470028367,2042.1353118325042,104,0.3081481481481481,1,1,1,2,FALSE,FALSE,FALSE
361,2021-11-13T04:23:18Z,2021-11-13T04:44:38Z,1279,1,2021-11-13T04:44:39Z,1,Chrome,95.0.4638.69,Windows NT 10.0,1920,1080,N/A,1.7777777777777777,572,38,407,100,67,61,-0.5580646373355385,-0.4706293045350014,-0.09871390517370586,-0.05583022810660534,-0.06830278120231312,-0.74958142002367,2,2,2,2,2,2,2,1,1,2,1,1,2,1,1,1,1,1,1,1,0.5104177855340404,0,1,2,3,3,2.55,0,2,4,2,2,2,3,4,2,3,1,1,4,2,4,1,5,5,5,3,3,4,4,3,7,1,3,1,1,1,1,1,1,2,2,2,1,2,4,2,2,2,3,2,5,5,5,5,5,1,5,5,2,5,5,2,3,3,3,2,5,2,3,5,2,1,2,2,2,1.5417123197525786,1.1254628677422756,4,0,1.75,0,2.466666666666667,0,4.666666666666667,0,3.6666666666666665,0,4.333333333333333,0,3,0,3.3333333333333335,0,3.918918918918919,0,4,3,1,1.6055717125539355,1.106682005738028,1.3561268591459816,4,2,3,2,1,3,2,8,8,0.9759000729485332,2.142857142857143,0,8,2.363532640615193,4,4,4,4,1,1,5,1,3,2,1,1.6035674514745464,2.7142857142857144,0,3.2857142857142856,7,3.8333333333333335,3.2559414990859232,1.5194825076544112,0,1.22201267488035,3,3,3,2,3,5,4,3,3,2,3,2,4,3,2,2,3,3,2,3,0.8837151016885368,2.8,0,2.4,0,2.8,0,2.8,0,2.6666666666666665,0,1,4,4,1,4,4,4,1,4,3,2,1,1,4,2,2,1,2,2,4,1.3168942730211068,3.05,0,"White, Caucasian, Anglo, European American",0,27,0,1,NA,1,1,1,Unemployed,2,0,126,71,1,5,2,0,0,1,0,0,TRUE,TRUE,TRUE,TRUE,TRUE,3,0.7049871794864153,0.78,0.012970844260550528,3,0.3837187500018626,0.4708266666650772,1,0.9375,9.917454436041127e-4,0.0035033845059560856,3,0.5180062499986962,0.5381333333323399,1,0.967741935483871,0.004598684475358781,0.002650380365664284,1.0791,1.2523,0.4639,0,-3.0581,0.005,ML,change,50,17.85226901628444,1.5734313545555532,0.8043988507454071,0.5618403700901229,1.1586,3.7677,0.3328,8.0321,0.3135,0,-107.9537,0.007,ML,cueing,64,228.38404925007902,3.831556426331529,0.7067754979390961,0.3901246631076332,6.474592515660465,0.6399066375791677,0.3358462735753224,0.063,0.378,0.422,0.056,1.404,146.75032269060785,2008.2589399620597,0.063,0.378,0.429,0.044,1.502,190.1887012332552,2024.6895387597056,316,0.9362962962962963,1,0,0,1,FALSE,FALSE,FALSE
362,2021-11-13T04:24:58Z,2021-11-13T04:46:30Z,1292,1,2021-11-13T04:46:31Z,1,Chrome,95.0.4638.69,Windows NT 10.0,1920,1080,N/A,1.7777777777777777,629,48,368,79,50,86,-0.4116107173344884,-0.3797819214031788,-0.28646923141039143,-0.31174476532151996,-0.3031077950286754,-0.3272972510023432,4,4,1,1,4,1,1,3,1,4,3,1,1,1,4,4,1,1,4,4,1.465390194130093,0,1,1,1,2,1.1,0,3,4,4,3,4,1,2,3,2,2,4,3,3,3,4,4,4,5,1,4,4,2,4,0,1,2,1,5,3,2,3,3,3,3,4,4,1,5,4,2,3,3,4,4,4,4,5,3,1,2,4,2,3,1,1,1,1,1,4,1,2,1,2,1,2,4,1,1,1.3305150394754168,0.9258200997725514,3.5,0,2,0,2.8666666666666667,0,2.6666666666666665,0,3,0,2.6666666666666665,0,1.1428571428571428,0,1.3333333333333333,0,2.4324324324324325,0,0,2,1,0.9237813862142307,0.1660801056761797,0.5449307459452052,1,3,1,4,3,3,5,8,4,1.4638501094227998,4,0,6,2.736630698083305,2,3,3,2,1,1,5,2,4,3,2,1.3972762620115438,1.8571428571428572,0,4.142857142857143,6,3.8333333333333335,3.2559414990859232,0.9547190977297628,0,1.4176569544466464,2,2,3,4,3,3,3,1,1,4,4,3,1,4,5,3,3,5,4,4,1.3201731488169053,2.8,0,2.4,0,3.8,0,4.2,0,3.466666666666667,0,1,1,1,3,1,1,2,3,1,1,4,3,1,1,1,4,1,1,1,1,1.0894228312566052,1.35,0,"White, Caucasian, Anglo, European American",0,28,0,1,NA,1,2,3,Custodian,2,0,230,71,4,5,2,0,0,1,0,0,TRUE,TRUE,TRUE,TRUE,TRUE,3,0.8111766666680574,0.6122448979591837,0.05251185187056104,3,0.45229666666686535,0.5009656249997206,0.9375,1,0.006688620604519712,0.0059204597481103075,3,0.6085193548404402,0.6743218749994412,0.96875,1,0.0061099702823565845,0.011738003054080784,1.3428,0.3582,0.3894,0,31.874,0.004,ML,change,49,-52.07253910566812,0.4464087565476974,1.0966366992991525,0.4986335515655318,1.3292,3.9005,0.3306,3.2039,0.2646,0,-59.6212,0.049,ML,cueing,64,131.71904925007902,4.142129152492528,1.0002427673937688,0.383998583987778,3.25959044692846,0.8307946182791244,0.34078798132278465,0.067,0.45,0.37,0.041,1.639,120.62790071617366,1960.0374121693553,0.068,0.449,0.37,0.053,1.769,162.84236928839923,1989.2101780770613,317,0.9392592592592592,1,0,0,1,FALSE,FALSE,FALSE
363,2021-11-13T04:23:05Z,2021-11-13T04:47:27Z,1461,1,2021-11-13T04:47:28Z,0.8999999761581421,Chrome,95.0.4638.69,Windows NT 10.0,1536,864,NA,1.7777777777777777,600,63,482,86,83,94,-0.48612236084379457,-0.24351084670544482,0.2623540298968433,-0.2264399195832151,0.15269017298720433,-0.19216631691551858,3,3,1,2,2,1,1,2,1,2,3,1,1,1,3,3,1,1,3,2,0.8750939799154206,0,1,1,3,3,1.75,0,3,3,2,2,2,3,3,4,4,3,5,2,2,2,2,4,5,5,1,4,5,4,4,3,2,0,0,4,2,3,3,3,3,2,2,1,3,4,5,2,3,2,3,2,5,5,5,5,1,5,5,2,4,2,3,2,1,1,4,1,1,1,3,3,2,3,2,3,1.377642151611912,0.9411239481143202,4,0,2.5,0,3.3333333333333335,0,3.4444444444444446,0,3.5,0,3.6666666666666665,0,1.4285714285714286,0,2.3333333333333335,0,3.081081081081081,0,2,0,0,1.6179608610166674,0.13935139661846652,0.8786561288175669,4,2,3,4,2,2,2,3,1,0.9511897312113419,2.4285714285714284,0,2,0.32054096227918905,2,3,4,4,1,2,3,6,6,2,2,1.1126972805283737,2.7142857142857144,0,3.2857142857142856,3,3.8333333333333335,3.2559414990859232,-0.7395711320441822,0,0.09248585503105322,1,1,2,2,3,1,4,3,1,3,1,5,2,5,4,2,5,4,4,2,1.486446705914413,1.8,0,4.4,0,3.8,0,4.2,0,4.133333333333334,0,1,1,1,4,2,2,2,3,1,2,3,4,1,1,1,4,1,1,1,2,1.1192102478745307,1.4,0,"Asian or Asian American (e.g., Chinese, Japanese, and others) & White, Caucasian, Anglo, European American",1,24,0,1,NA,1,3,6,Chemist,4,0,220,71,3,5,2,0,0,1,0,0,TRUE,TRUE,TRUE,TRUE,TRUE,3,0.6740424999999813,0.8,0.024567845097879702,3,0.4741812500001397,0.4623548387097976,1,0.96875,0.005099315766122206,0.0044567516128844855,3,0.5798000000000466,0.6179843749998836,1,1,0.00981192774197075,0.0068713039415235575,1.0816,1.3126,0.4268,0,-2.5647,0.005,ML,change,50,16.865469016284436,1.449318817797996,0.9565144287756777,0.4760499499075982,1.1949,4.6804,0.3417,4.0998,0.3285,0,-81.7938,0.014,ML,cueing,64,176.06424925007903,4.0945502871550845,0.8386726169312965,0.3663423925029902,4.299663992557676,0.9635950003448918,0.36562827258145225,0.192,0.235,0.552,0.041,1.438,48.594483430187275,1837.5713974754224,0.186,0.242,0.556,0.029,1.525,55.421291693840715,1841.8718400277844,390,1.1555555555555557,1,0,1,2,FALSE,FALSE,FALSE
365,2021-11-13T04:12:15Z,2021-11-13T04:55:09Z,2573,1,2021-11-13T04:55:10Z,0.8999999761581421,Chrome,95.0.4638.69,Windows NT 10.0,1920,1080,"Nope, great survey!",1.7777777777777777,790,182,1053,220,128,106,0.0020573724930389916,0.8375730125632445,3.0112845755672906,1.4065385559786212,0.7742328566452221,0.010530084214718316,4,4,2,2,3,1,2,3,1,4,4,2,1,1,4,4,1,1,3,3,1.2354415362426845,0,1,1,4,4,1.4,0,4,4,3,4,5,2,4,2,2,2,2,4,2,4,4,3,3,1,1,2,3,3,2,2,2,0,0,5,3,4,5,5,4,4,4,5,3,4,2,4,5,4,5,5,3,4,4,3,4,1,1,1,3,3,2,2,2,1,4,2,2,1,3,2,2,2,2,2,1.3361456826578775,1.082325538564332,2.25,0,2,0,2.2666666666666666,0,1.6666666666666667,0,3,0,1.6666666666666667,0,1.7142857142857142,0,2,0,2.189189189189189,0,1,0,0,0.024213059553069287,-0.22054348261253207,-0.09816521152973139,4,2,2,2,1,3,4,3,4,1.1338934190276817,2.5714285714285716,0,3.5,0.9594896595959068,4,5,4,4,2,2,3,2,2,5,3,1.1338934190276817,3.4285714285714284,0,2.5714285714285716,7,3.8333333333333335,3.2559414990859232,1.5194825076544112,0,0.8236576877731663,2,3,3,3,3,2,5,3,2,3,2,4,2,4,5,2,4,2,5,2,1.245945806357946,2.8,0,4,0,4.2,0,4,0,4.066666666666666,0,2,1,3,3,3,4,2,4,1,1,3,2,2,4,3,4,1,3,4,2,1.0954451150103321,2.3,0,"White, Caucasian, Anglo, European American",0,18,0,1,NA,1,2,3,Unemployed,3,0,176,72,2,5,2,0,0,0,0,0,TRUE,TRUE,TRUE,TRUE,TRUE,4,0.959218749994412,0.6530612244897959,0.06936333341955578,4,0.5065533333301544,0.6318258064543048,0.967741935483871,1,0.01978481318121958,0.012233129977209168,4,0.7191937500108033,0.7185,1,1,0.024262177378159635,0.01051601096832014,1.7941,0.3932,0.2911,0,54.3382,0.004,ML,change,49,-97.00093910566812,0.5460448199494947,1.1583711366440839,0.6345170073704653,1.359,3.8549,0.4556,3.2508,0.3247,0,-56.8552,0.009,ML,cueing,62,126.09180315513528,3.4548412539379507,1.1992257883539628,0.4636921793095412,2.807835120691645,1.211323754944824,0.30476551699430177,0.158,0.351,0.434,0.044,0.993,51.59002424428528,1841.7682756689373,0.16,0.348,0.434,0.064,1.054,72.1755084718823,1856.5624533069624,282,0.8355555555555556,1,0,4,5,FALSE,FALSE,FALSE
366,2021-11-13T03:19:09Z,2021-11-13T04:58:34Z,5964,1,2021-11-13T04:58:36Z,1,Safari,14.1.1,Macintosh,1440,900,none,1.6,4270,133,615,79,96,485,8.94345459360978,0.3924208352173136,0.9026478347552838,-0.31174476532151996,0.3322469482661872,6.412358086578033,2,3,3,2,2,1,1,2,1,2,2,2,1,1,2,2,1,1,1,2,0.6569466853317864,0,1,1,3,2,2.2,0,3,3,3,2,4,2,3,2,2,3,3,3,2,3,3,2,3,1,1,2,2,1,2,0,2,0,1,4,3,3,3,2,5,5,5,5,2,3,2,3,3,3,3,4,3,3,3,4,3,2,4,1,1,1,1,1,2,1,1,4,2,2,3,2,2,2,1,1,1.2339053944782488,0.5936168397046637,1.75,0,1.5,0,2.8666666666666667,0,2.111111111111111,0,3,0,1.8333333333333333,0,2.142857142857143,0,2.3333333333333335,0,2.4324324324324325,0,0,0,1,0.1717213584374688,-0.40398871494434996,-0.11613367825344058,4,2,4,1,1,3,2,3,2,1.2724180205607036,1.8571428571428572,0,2.5,0.1631660590458031,3,4,4,3,1,1,3,7,6,4,2,1.2535663410560174,2.7142857142857144,0,3.2857142857142856,2.5,3.8333333333333335,3.2559414990859232,-1.0219528370065065,0,-0.04870499745010898,2,3,3,2,2,3,3,4,3,5,3,3,2,3,3,1,3,3,5,3,0.990430401872025,2.4,0,3,0,4.4,0,2.8,0,3.4,0,1,2,3,2,2,2,2,2,2,2,2,2,2,2,2,2,2,2,2,2,0.3244428422615251,2.2,0,Other & multiple,1,25,0,1,NA,1,2,6,legal intern,3,0,195,68,2,5,3,0,0,1,1,0,TRUE,TRUE,TRUE,TRUE,TRUE,NA,NA,NA,NA,NA,NA,NA,NA,NA,NA,NA,6,0.6549687500000219,0.7429333333333256,1,0.967741935483871,0.006665644153220522,0.013368122580643725,NA,NA,NA,NA,NA,NA,NA,NA,NA,NA,NA,NA,NA,NA,NA,NA,NA,NA,NA,NA,NA,NA,NA,NA,NA,NA,NA,NA,NA,NA,NA,0.071,0.494,0.405,0.017,1.485,84.5509254523269,1919.655510667931,0.071,0.493,0.432,0.015,1.575,104.87568426286647,1930.996595227248,104,0.3081481481481481,1,0,2,4,FALSE,FALSE,FALSE
367,2021-11-13T04:34:29Z,2021-11-13T04:58:39Z,1449,1,2021-11-13T04:58:40Z,0.8999999761581421,Firefox,94.0,Windows NT 10.0,1920,1080,NA,1.7777777777777777,629,57,437,79,69,111,-0.4116107173344884,-0.2980192765845384,0.0457132688545138,-0.31174476532151996,-0.04067866192862343,0.0949869180189837,4,3,1,2,4,1,1,4,1,4,4,1,1,1,4,4,1,1,4,4,1.4689774459950382,0,1,2,1,1,1.1,0,1,3,5,2,5,1,1,5,4,2,4,1,2,1,1,5,5,5,5,5,5,5,4,7,3,4,11,5,1,3,1,1,1,1,1,3,2,4,5,3,2,1,3,1,5,5,5,1,1,3,3,2,4,3,1,4,4,2,5,1,4,1,1,5,2,3,5,2,1.5673086666181797,1.6417180315870614,4.875,0,3,0,4,0,4.111111111111111,0,3.0833333333333335,0,3.1666666666666665,0,2.2857142857142856,0,2.3333333333333335,0,3.189189189189189,0,4,4,6,2.3269492398409626,2.587569461413161,2.4572593506270617,4,1,2,1,1,1,2,3,3,1.1126972805283737,1.7142857142857142,0,3,0.2621927112778498,5,5,5,5,3,1,1,3,2,2,2,1.9023794624226837,4.142857142857143,0,1.8571428571428572,6.5,3.8333333333333335,3.2559414990859232,1.237100802692087,0,0.2841118481848205,4,4,5,2,2,2,5,1,1,1,1,5,1,2,5,1,1,1,2,1,1.6035674514745464,3.4,0,4,0,3.6,0,4.4,0,4,0,2,4,3,1,4,4,2,1,1,1,4,3,2,1,2,3,2,2,2,3,1.0894228312566052,2.55,0,"Hispanic of Latino (e.g., Mexican American, Central American, and others) & Native American/Alaskan Native/indigenous",1,22,0,1,NA,1,3,3,Food service,4,0,110,64,4,5,2,0,0,1,0,0,TRUE,TRUE,TRUE,TRUE,TRUE,NA,NA,NA,NA,1,0.5343448275862069,0.60090625,0.9666666666666667,1,0.010733040229885056,0.012381442540322581,1,0.714375,0.76175,1,1,0.01438282258064516,0.018131548387096765,NA,NA,NA,NA,NA,NA,NA,NA,NA,NA,NA,NA,NA,1.917,3.9817,0.3602,3.2324,0.2501,0,-43.8255,0.012,ML,cueing,62,100.03240315513527,3.4444483968152624,1.2028441855079832,0.4317564805059565,2.75588969543933,0.9703395073655982,0.3810124189924229,0.082,0.511,0.378,0.034,1.14,22.929713911366175,1815.2203826727925,0.082,0.51,0.388,0.022,1.225,23.323775423663616,1804.1958991061713,294,0.8711111111111112,1,0,0,1,FALSE,FALSE,FALSE
368,2021-11-13T04:41:40Z,2021-11-13T04:58:41Z,1021,1,2021-11-13T04:58:42Z,1,Firefox,94.0,Windows NT 10.0,1920,1080,thanks,1.7777777777777777,607,70,183,48,22,66,-0.4681367917208586,-0.17991767851316898,-1.1771034712510793,-0.6895233678768702,-0.6898454648603309,-0.6651245862194046,4,4,1,1,4,1,1,4,1,3,3,1,1,1,3,3,1,1,3,3,1.2814465510343749,0,1,1,4,4,1.3,0,5,5,1,5,1,1,4,1,1,1,1,4,1,5,4,1,1,1,1,1,1,1,1,1,2,0,0,5,5,5,5,5,5,5,5,5,1,5,1,1,5,1,4,1,1,1,1,1,5,1,1,1,1,1,1,3,2,1,5,1,1,1,1,1,2,1,1,2,1.9081774396373994,1.8771812708978117,1,0,1.5,0,1.2,0,1,0,1.0833333333333333,0,0.8333333333333334,0,1.2857142857142858,0,1,0,1.1081081081081081,0,1,0,0,-1.4359642350467026,-0.3773458880470143,-0.9066550615468585,5,1,3,1,1,1,1,1,1,1.5735915849388864,1.2857142857142858,0,1,-0.7321841937363471,5,5,5,5,3,3,1,4,4,3,2,1.5735915849388864,4.428571428571429,0,1.5714285714285714,5,3.8333333333333335,3.2559414990859232,0.38995568780511447,0,-0.2988027041015393,1,1,1,1,1,1,4,1,1,4,1,4,1,4,4,1,4,4,4,1,1.5491933384829668,1,0,4,0,4.4,0,4.6,0,4.333333333333333,0,1,1,1,4,1,1,1,4,1,1,1,4,1,1,1,4,1,1,1,1,1.231174022502185,1,0,Black or African American,0,24,0,1,NA,1,2,3,construction,5,0,168,70,3,5,2,0,0,1,0,0,TRUE,TRUE,TRUE,TRUE,TRUE,4,0.7471951219512195,0.8367346938775511,0.03731618962585035,4,0.4255,0.4940322580645161,1,0.96875,0.0031169032258064524,0.003274337701612903,4,0.5443125,0.6341379310344828,1,0.90625,0.005536028225806451,0.010570641129032258,1.2812,1.3292,0.4307,0,7.533,0.004,ML,change,49,-3.3905391056681218,1.4931141678931275,1.0944444572047207,0.5003704469279812,1.1231,4.2737,0.3735,5.4785,0.323,0,-93.2934,0.009,ML,cueing,64,199.06344925007903,4.422623300543097,0.7764593480216716,0.4117360065749389,4.862746889844124,0.8520152951091273,0.3406313202358117,0.076,0.381,0.46,0.017,1.709,101.46983971990281,2006.0397651953965,0.066,0.389,0.448,0.014,1.8,127.5371731649453,2018.0310105205724,558,1.6533333333333333,1,0,0,1,FALSE,FALSE,FALSE
370,2021-11-13T04:03:55Z,2021-11-13T05:00:45Z,3409,1,2021-11-13T05:00:46Z,1,Firefox,94.0,Windows NT 10.0,1536,864,"nope, thanks!",1.7777777777777777,1769,64,1332,80,58,64,2.517467682686513,-0.23442610839226255,4.354457294029733,-0.29955835878747644,-0.19261131793391667,-0.6989073197411108,2,2,3,3,2,3,4,2,3,2,2,3,3,2,2,2,3,2,2,1,0.6805570473787206,0,1,2,3,2,3,0,2,3,3,3,3,3,3,3,2,2,3,3,3,3,3,2,3,1,2,2,3,3,3,6,2,0,0,4,4,4,4,3,3,3,3,3,3,4,3,1,4,2,3,3,3,4,4,4,3,1,1,1,3,3,1,2,3,1,3,3,4,1,1,2,1,2,1,2,1.0904995136125413,0.4140393356054125,2.375,0,1.5,0,2.933333333333333,0,2.5555555555555554,0,2.8333333333333335,0,1.8333333333333333,0,2.2857142857142856,0,1.3333333333333333,0,2.4324324324324325,0,3,0,0,0.46896413132066517,0.028839059546018453,0.2489015954333418,5,1,5,2,1,2,2,1,3,1.7182493859684491,1.4285714285714286,0,2,-0.2777293338068208,5,5,5,5,4,3,1,6,8,6,4,1.5275252316519468,4.571428571428571,0,1.4285714285714286,2,3.8333333333333335,3.2559414990859232,-1.3043345419688306,0,-1.2256188164099486,3,3,3,3,3,3,4,4,3,3,2,3,3,2,3,3,3,3,2,4,0.6546536707079771,3,0,3.2,0,3,0,2.4,0,2.8666666666666667,0,2,2,1,2,3,2,4,3,4,3,2,3,3,3,2,4,1,3,2,3,0.8825799501580878,2.4,0,"Asian or Asian American (e.g., Chinese, Japanese, and others)",0,25,0,1,NA,1,4,7,Unemployed,5,0,135,69,1,5,2,1,1,1,0,2,TRUE,TRUE,TRUE,TRUE,TRUE,5,1.170075,0.8,0.11399012897959185,5,0.7756774193548387,0.8929333333333334,1,1,0.39891462580645154,0.4574079264367816,5,0.9231,1.14359375,1,1,0.08787967931034484,0.20093211995967739,1.7069,0.8442,0.5791,0,42.104,0.004,ML,change,50,-72.47193098371557,0.9875040514864633,1.4038366313871211,0.743594735152287,2.0265,1.6417,0.2758,1.7103,0.1832,0,22.3282,0.008,ML,cueing,61,-32.32377840748006,1.3971292106201045,2.9654628182547524,-0.1351720428004981,1.4457476813575245,2.8657384547912415,-0.18444313414044367,0.197,0.189,0.239,0.015,1.895,96.40753013263806,1916.7396620881811,0.2,0.18,0.249,0.015,2.006,101.17088927768565,1881.1152818593257,383,1.1348148148148147,1,1,14,15,FALSE,FALSE,FALSE
371,2021-11-13T04:41:31Z,2021-11-13T05:03:42Z,1331,1,2021-11-13T05:03:43Z,1,Chrome,93.0.4577.82,Macintosh,1440,900,NA,1.6,658,56,332,82,66,89,-0.3370990738251822,-0.30710401489772066,-0.459781840244255,-0.2751855457193893,-0.08211484083915795,-0.27662315071978394,4,3,1,2,3,1,2,3,1,4,3,1,1,1,4,3,1,1,3,3,1.164157703189193,0,1,2,5,4,1.45,0,4,5,3,4,2,1,5,2,1,1,1,5,1,5,3,2,1,1,1,1,1,1,1,2,2,0,0,5,4,5,5,5,5,5,5,5,1,5,1,1,5,1,5,1,1,2,1,2,5,1,1,1,1,1,1,3,3,1,5,1,1,1,1,1,2,1,1,2,1.8740362888727669,1.6846647257229665,1.125,0,1.5,0,1.5333333333333334,0,1.1111111111111112,0,1.1666666666666667,0,0.8333333333333334,0,1.4285714285714286,0,1,0,1.1891891891891893,0,1,0,0,-1.2041516524823082,-0.3773458880470143,-0.7907487702646612,4,2,3,2,1,1,3,1,1,1.1126972805283737,2,0,1,-0.3048482679606258,4,5,5,5,3,3,2,4,6,3,3,1.2149857925879117,4.142857142857143,0,1.8571428571428572,4,3.8333333333333335,3.2559414990859232,-0.1748077221195339,0,-0.42184241422098995,1,1,2,2,2,2,4,2,1,2,1,4,2,5,5,3,4,1,3,5,1.486446705914413,1.6,0,4.4,0,3.2,0,4,0,3.8666666666666667,0,2,1,2,2,4,1,3,2,2,2,1,3,3,4,1,2,1,3,1,3,0.9880869341680844,2.25,0,"White, Caucasian, Anglo, European American",0,24,0,1,NA,1,3,6,Strength and Conditioning Coach,2,0,160,70,4,5,2,0,0,1,0,0,TRUE,TRUE,TRUE,TRUE,TRUE,5,0.9260125000089406,0.8,0.14152547857594866,5,0.5819968750067055,0.6779781249761582,1,1,0.007302947410378193,0.0067639624074519065,5,0.7791250000074506,0.7813781250081956,1,1,0.0052008412890774975,0.0017532991841419895,1.3646,1.005,0.5728,0,23.1852,0.003,ML,change,50,-34.63433098371556,0.9355069953585533,1.4818642383198466,0.450805715130152,10,9.038,0.1247,8.8938,0.0197,0,-69.4394,0.012,ML,cueing,64,151.35544925007903,4.006472794476135,1.0341102857615352,0.5529561429583724,3.930410859458624,1.0541225522062112,0.4520891810066913,0.126,0.6,0.701,0.191,1.402,32.26411020325016,1822.261659337716,0.119,0.609,0.703,0.229,1.448,51.877701604741084,1834.1682069940969,104,0.3081481481481481,1,0,0,1,FALSE,FALSE,FALSE
372,2021-11-13T04:38:23Z,2021-11-13T05:03:57Z,1533,1,2021-11-13T05:03:58Z,0.8999999761581421,Firefox,94.0,Windows NT 10.0,1920,1200,NA,1.6,625,107,435,126,61,109,-0.42188818540473755,0.15621763907457475,0.03608479058596582,0.26101634177852706,-0.15117513902338214,0.06120418449727754,2,4,2,1,1,2,3,2,1,3,1,1,2,3,1,1,2,1,2,1,0.8944271909999159,0,1,1,2,2,2.5,0,5,4,2,4,2,1,4,1,2,1,1,5,1,5,4,1,1,1,1,1,1,1,1,0,2,0,0,5,2,5,3,4,5,4,4,5,2,5,1,2,2,2,3,2,1,1,1,1,5,1,1,1,2,1,1,1,1,1,3,3,2,1,1,1,1,1,1,1,1.5102254072756096,1.65615734242165,1,0,1,0,1.4666666666666666,0,1.8888888888888888,0,1.75,0,1,0,1.5714285714285714,0,1,0,1.6216216216216217,0,0,0,0,-1.1006829047740254,-0.7372407672780129,-0.9189618360260192,4,2,3,1,1,2,3,3,1,1.1126972805283737,2,0,2,0.06413940681375631,5,5,5,5,3,2,2,6,4,4,3,1.4638501094227998,4.142857142857143,0,1.8571428571428572,4,3.8333333333333335,3.2559414990859232,-0.1748077221195339,0,-0.42184241422098995,2,2,1,3,2,2,4,2,2,1,1,3,2,2,4,3,5,1,3,1,1.2421180068162376,2,0,4.4,0,3,0,3.8,0,3.7333333333333334,0,1,3,4,1,2,4,2,1,4,3,3,2,4,3,1,1,1,3,2,3,1.142481141154959,2.9,0,"White, Caucasian, Anglo, European American",0,28,0,1,NA,1,3,6,Unemployed,4,0,160,71,2,5,2,0,0,0,0,0,TRUE,TRUE,TRUE,TRUE,TRUE,2,1.0409473684210526,0.76,0.13588492081632653,2,0.51553125,0.6131666666666666,1,0.9375,0.0015842570564516135,0.006750176411290321,2,0.62690625,0.6952258064516129,1,0.96875,0.006948926411290324,0.0075667701612903236,1.4983,0.7779,0.6064,0,35.8714,0.004,ML,change,50,-60.00673098371556,0.8060005575497421,1.4301224721761414,0.5796178578110687,1.4503,3.4673,0.4248,5.2915,0.3785,0,-72.7432,0.009,ML,cueing,64,157.96304925007902,3.2521337329279256,0.8326995208355493,0.501146045658082,5.759119390072381,0.7194042084860237,0.4550252264426314,0.066,0.481,0.459,0.02,1.729,72.67323476359687,1917.5057653422455,0.067,0.479,0.461,0.021,1.865,99.23602440124621,1924.5796226900704,244,0.7229629629629629,1,0,0,1,FALSE,FALSE,FALSE
373,2021-11-13T04:49:40Z,2021-11-13T05:09:20Z,1179,1,2021-11-13T05:09:22Z,1,Chrome,95.0.4638.69,Macintosh,1440,900,n/a,1.6,782,35,185,21,18,81,-0.018497563647459265,-0.4978835194745482,-1.1674749929825314,-1.0185563442960461,-0.7450937034077103,-0.4117540848066085,2,2,1,2,2,1,1,1,1,1,1,1,1,1,2,2,2,2,2,2,0.512989176042577,0,1,1,4,3,2.3,0,1,2,1,2,2,2,1,2,1,1,1,1,2,1,2,2,1,1,1,1,1,1,2,1,2,0,0,2,1,2,2,2,1,2,1,1,1,2,2,1,1,2,2,1,2,1,1,2,1,1,1,1,1,1,2,1,2,1,2,1,1,1,2,2,1,1,2,1,0.5022472023339226,0.5163977794943222,1.25,0,1.25,0,2.933333333333333,0,4.444444444444445,0,2.1666666666666665,0,1.5,0,1.5714285714285714,0,1.6666666666666667,0,2.5135135135135136,0,1,0,0,0.020341450658465283,-0.4557470907642554,-0.21770282005289507,1,2,2,2,1,2,1,2,1,0.5345224838248488,2.4285714285714284,0,1.5,0.13604712489199797,2,1,2,3,3,2,2,6,3,4,3,0.6900655593423543,2.4285714285714284,0,3.5714285714285716,4.5,3.8333333333333335,3.2559414990859232,0.10757398284279028,0,0.6754004073174131,1,2,1,1,2,1,2,2,1,1,1,1,2,1,2,1,1,1,1,1,0.45773770821706344,1.4,0,3.4,0,2.6,0,3.4,0,3.1333333333333333,0,1,2,1,2,2,2,1,1,2,2,1,1,1,2,1,1,2,1,2,2,0.512989176042577,2,0,"White, Caucasian, Anglo, European American",0,23,0,1,NA,1,3,6,Analyst,4,0,215,72,3,5,2,0,0,1,0,0,TRUE,TRUE,TRUE,TRUE,TRUE,NA,NA,NA,NA,1,0.5095903225781456,0.601262068964284,1,0.9354838709677419,0.01380876290303995,0.03341910000023842,NA,NA,NA,NA,NA,NA,NA,NA,NA,NA,NA,NA,NA,NA,NA,NA,NA,0.48169852796895646,1.3131087641278276,0.48537742923951915,1.3274,2.2663,0.3329,3.546,0.3224,0,-39.8023,0.008,ML,cueing,62,91.98600315513528,2.164066181641867,1.235705576895834,0.3525959918507145,3.3517668485642123,1.236104691520031,0.33095671319941,NA,NA,NA,NA,NA,NA,NA,NA,NA,NA,NA,NA,NA,NA,104,0.3081481481481481,1,1,6,7,FALSE,TRUE,TRUE
374,2021-11-13T04:35:14Z,2021-11-13T05:14:13Z,2339,1,2021-11-13T05:14:14Z,1,Chrome,95.0.4638.69,Windows NT 10.0,1366,768,Thanks,1.7786458333333333,1538,76,374,92,73,99,1.9239439016296258,-0.1254092486340754,-0.2575837966047475,-0.15332148037895377,0.014569576618755927,-0.10770948311125321,2,2,3,3,2,2,2,2,1,2,2,1,2,2,2,2,2,1,2,2,0.5104177855340404,0,0,2,1,1,2.45,0,2,4,5,4,2,3,2,4,3,3,3,2,2,2,4,4,4,4,2,3,4,4,4,1,2,1,1,4,3,3,4,4,2,2,4,1,3,3,5,2,3,2,4,1,5,5,5,5,2,2,1,5,4,3,2,4,4,1,4,1,1,2,2,4,3,5,2,2,1.3639502778182058,1,3.625,0,3,0,3.1333333333333333,0,3,0,3.4166666666666665,0,3,0,2,0,2.6666666666666665,0,2.972972972972973,0,1,1,1,1.3243961165833447,0.47614418274863685,0.9002701496659907,5,2,4,2,1,1,2,2,2,1.5118578920369088,1.5714285714285714,0,2,-0.19226214865167657,4,4,5,4,4,4,1,5,5,4,4,1.2535663410560174,4.285714285714286,0,1.7142857142857142,4,3.8333333333333335,3.2559414990859232,-0.1748077221195339,0,-0.5015134116424268,1,1,1,2,3,2,5,4,2,3,1,4,3,5,4,4,4,1,3,3,1.2649110640673518,1.6,0,4.4,0,3.2,0,3.6,0,3.7333333333333334,0,3,3,2,2,3,4,3,2,4,3,3,2,2,4,2,1,1,4,2,2,0.9403246919632545,2.9,0,"White, Caucasian, Anglo, European American",0,24,0,1,NA,1,1,4,Cook,2,0,130,72,1,5,2,1,0,1,0,1,TRUE,TRUE,TRUE,TRUE,TRUE,5,1.1542694444447341,0.72,0.16579419100342818,5,0.45021612903211383,0.5058793103450845,1,0.90625,0.00165244139787013,0.006045568387033584,5,0.5653687500003726,0.630922580644969,1,0.96875,0.00656348350797073,0.010892509828737532,1.6161,0.6039,0.585,0,45.7618,0.004,ML,change,50,-79.78753098371557,0.6407874305258399,1.473907826290868,0.6482362322796663,1.0931,2.8067,0.338,5.1188,0.3434,0,-74.2191,0.012,ML,cueing,63,160.86760417917458,2.9918094493881795,0.7582981402048538,0.4029119841601835,5.698768009732253,0.727022879211079,0.38842177163478375,0.08,0.397,0.505,0.008,1.094,78.05133056671288,1916.5825840166635,0.081,0.397,0.516,0.009,1.143,93.30769706984034,1914.8313416159392,373,1.1051851851851853,1,0,0,1,FALSE,FALSE,FALSE
375,2021-11-13T04:52:30Z,2021-11-13T05:14:15Z,1305,1,2021-11-13T05:14:16Z,1,Chrome,95.0.4638.69,Windows NT 10.0,2560,1440,No.,1.7777777777777777,662,52,233,55,30,65,-0.3268216057549331,-0.3434429681504497,-0.9363915145373799,-0.6042185221385653,-0.5793489877655722,-0.6820159529802577,3,2,2,1,3,1,2,3,2,3,1,3,3,1,2,2,3,1,2,1,0.8255779474818965,0,1,2,2,3,2.35,0,2,3,3,2,2,4,2,4,3,3,1,2,4,2,3,1,3,1,5,3,2,3,3,1,3,0,0,4,2,2,4,3,2,3,3,4,1,4,2,1,3,1,5,4,2,1,4,4,3,1,1,1,4,3,2,1,3,1,3,3,2,1,4,1,2,1,1,1,1.238763308519644,0.8997354108424374,2.625,0,1.25,0,3.3333333333333335,0,3,0,2.1666666666666665,0,2,0,2,0,2,0,2.3513513513513513,0,1,0,0,0.7134562330148865,-0.4557470907642554,0.12885457112531554,1,5,1,3,3,5,4,6,2,1.6761634196950514,4.285714285714286,0,4,2.169589718844829,2,2,4,3,1,1,5,3,6,2,2,1.5118578920369088,2,0,4,4.5,3.8333333333333335,3.2559414990859232,0.10757398284279028,0,0.9144133995817233,3,3,2,3,2,2,4,2,1,2,3,2,3,2,3,4,1,4,2,5,1.1751393027860062,2.6,0,2.4,0,2.6,0,3,0,2.6666666666666665,0,1,1,2,3,1,1,1,2,2,3,2,3,1,1,2,3,1,1,1,2,0.8013147091860318,1.6,0,"White, Caucasian, Anglo, European American",0,29,0,1,NA,1,3,3,Retail,4,0,208,73,2,5,2,0,1,1,0,1,TRUE,TRUE,TRUE,TRUE,TRUE,1,1.1167324324330767,0.74,0.08645007412404411,1,0.45191874999925497,0.4960193548394788,1,0.96875,0.0033370486697503338,0.0045561864420647115,1,0.5881968750022352,0.6643709677438582,1,0.96875,0.008210334506563693,0.010903786934265263,1.546,0.698,0.5865,0,39.5347,0.004,ML,change,50,-67.33333098371557,0.8275077520102868,1.263998497466263,0.7501381151533372,1.3324,4.1274,0.3413,5.3545,0.3275,0,-83.6315,0.008,ML,cueing,64,179.73964925007903,4.072025087509551,0.8433118978118506,0.39894174760374546,4.78048389216672,0.8666768510987883,0.36410408327924937,0.073,0.401,0.378,0.017,1.556,26.184955534432472,1862.5982733628778,0.073,0.414,0.389,0.02,1.681,28.84915330536718,1853.981421874708,392,1.1614814814814816,1,0,1,2,FALSE,FALSE,FALSE
376,2021-11-13T04:49:33Z,2021-11-13T05:14:45Z,1511,1,2021-11-13T05:14:46Z,1,Chrome,95.0.4638.69,Windows NT 10.0,1536,864,NA,1.7777777777777777,764,48,405,91,68,81,-0.06474616996358035,-0.3797819214031788,-0.10834238344225383,-0.1655078869129973,-0.054490721565468275,-0.4117540848066085,3,2,1,1,4,1,2,2,1,3,1,2,1,1,3,2,3,1,4,2,1.025978352085154,0,1,3,3,2,1.9,0,4,5,2,5,2,1,4,2,1,1,1,3,2,4,2,1,2,1,1,2,1,1,1,0,2,0,0,4,4,3,4,4,5,4,5,4,3,4,2,1,4,2,4,3,1,1,3,3,4,1,1,1,1,1,1,1,1,1,5,1,1,1,1,1,1,1,1,1,1.5017507300664965,1.4540583599999397,1.25,0,1,0,1.8,0,1.8888888888888888,0,2.0833333333333335,0,1,0,0.8571428571428571,0,1,0,1.5945945945945945,0,0,0,0,-0.861611055532249,-0.7372407672780129,-0.799425911405131,5,1,3,1,1,1,1,1,1,1.5735915849388864,1.2857142857142858,0,1,-0.7321841937363471,5,5,5,5,3,3,1,6,6,6,4,1.5735915849388864,4.428571428571429,0,1.5714285714285714,3,3.8333333333333335,3.2559414990859232,-0.7395711320441822,0,-0.8635661140261877,2,3,2,3,2,2,5,2,2,3,3,4,2,4,5,3,4,3,5,3,1.1126972805283737,2.4,0,3.6,0,4,0,4,0,3.8666666666666667,0,1,1,3,2,1,3,3,1,2,1,1,2,2,3,1,1,3,4,3,3,0.998683343734455,2.45,0,"White, Caucasian, Anglo, European American",0,21,0,1,NA,1,4,5,Dairy Clerk,5,0,125,68,2,5,2,0,0,1,0,0,TRUE,TRUE,TRUE,TRUE,TRUE,3,0.8183562500006519,0.64,0.06689531105654165,3,0.4381218749997206,0.480113333333532,1,0.967741935483871,0.0035481443447771704,0.0058581012257902165,3,0.6066531250006519,0.7102312500025145,1,1,0.00889824902214695,0.01510519576586315,1.4735,0.4188,0.3947,0,39.1704,0.004,ML,change,50,-66.60473098371557,0.5028901154069304,1.1441150407937264,0.49984510650460245,1.8329,5.1304,0.3066,5.2465,0.2712,0,-77.4577,0.018,ML,cueing,63,167.34480417917462,3.8064083063833314,0.8935450713362416,0.3703120541570471,4.707736802043458,0.8800693200590882,0.3475722978189006,0.195,0.28,0.563,0.013,1.291,78.41406285997674,1872.7033601545854,0.177,0.299,0.578,0.011,1.394,90.3473627718526,1879.8899616333947,366,1.0844444444444443,1,0,1,2,FALSE,FALSE,FALSE
377,2021-11-13T04:48:05Z,2021-11-13T05:15:08Z,1622,1,2021-11-13T05:15:09Z,0.8999999761581421,Firefox,94.0,Windows NT 10.0,1600,900,NA,1.7777777777777777,765,99,396,115,61,119,-0.06217680294601806,0.08353973256911665,-0.15167053565071972,0.12696586990404798,-0.15117513902338214,0.2301178521058083,2,2,3,3,2,2,3,2,1,2,1,2,1,2,2,2,3,3,2,1,0.6863327411532597,0,1,1,3,3,2.75,0,5,5,1,5,1,1,5,1,1,1,1,4,1,4,4,1,1,1,1,1,1,1,1,2,2,0,0,5,5,5,5,3,5,5,5,4,2,4,1,1,5,1,4,1,1,1,1,1,5,1,1,1,1,1,1,2,2,1,5,1,2,1,1,1,1,1,1,1,1.7735968103392739,1.8771812708978117,1,0,1,0,1.2,0,1.3333333333333333,0,1.25,0,0.8333333333333334,0,1.2857142857142858,0,1,0,1.2432432432432432,0,1,0,0,-1.3778901016276477,-0.5341482934814965,-0.9560191975545721,5,1,4,1,1,1,1,1,1,1.7320508075688772,1.1428571428571428,0,1,-0.8176513788914915,5,5,5,4,4,3,2,8,8,4,3,1.1547005383792515,4.285714285714286,0,1.7142857142857142,1,3.8333333333333335,3.2559414990859232,-1.869097951893479,0,-1.3486585265293993,1,3,1,1,1,1,4,1,1,3,1,4,2,4,4,4,4,1,3,3,1.3451854182690985,1.4,0,4.6,0,3.2,0,4.2,0,4,0,2,2,2,3,2,2,2,2,1,1,3,3,3,2,1,2,1,2,2,2,0.6488856845230502,2,0,"Asian or Asian American (e.g., Chinese, Japanese, and others)",0,26,0,1,NA,1,4,8,resident physician,3,0,155,65,2,5,2,0,0,1,0,0,TRUE,TRUE,TRUE,TRUE,TRUE,5,0.9158648648648648,0.74,0.06356129346938777,5,0.4293125,0.5213225806451613,1,0.96875,0.0018884798387096779,0.0036815483870967737,5,0.5753125,0.6681612903225806,1,0.96875,0.007360286290322582,0.018401773185483875,1.5166,0.7236,0.4486,0,36.6384,0.004,ML,change,50,-61.540730983715555,0.8936454155777318,1.1704514306790021,0.6015250400682967,1.39,4.0212,0.358,6.9274,0.329,0,-91.8294,0.022,ML,cueing,64,196.13544925007903,4.294901307512918,0.7995497355150385,0.43405889012285076,5.5116852167536665,0.751700172171988,0.3632519837373784,0.069,0.401,0.368,0.018,1.36,86.9613910766608,1931.7039760119087,0.08,0.388,0.437,0.01,1.366,81.79425755926735,1910.6296633861264,330,0.9777777777777777,1,0,0,1,FALSE,FALSE,FALSE
378,2021-11-13T04:44:14Z,2021-11-13T05:15:24Z,1869,1,2021-11-13T05:15:24Z,1,Chrome,95.0.4638.69,Windows NT 10.0,1536,864,Nope,1.7777777777777777,684,80,565,151,74,150,-0.2702955313685629,-0.08907029538134635,0.6619358780415844,0.5656765051296159,0.028381636255600768,0.7537502216922536,3,3,2,2,2,2,2,3,2,2,2,2,1,1,2,2,2,1,2,1,0.6048053188292994,0,1,1,2,2,2.25,0,3,4,3,3,2,2,4,2,3,2,2,2,2,3,3,3,4,4,1,2,4,2,3,1,2,0,0,4,3,2,3,3,4,3,3,3,1,5,3,1,3,3,1,2,3,4,4,5,2,1,1,2,2,1,1,2,1,1,4,2,2,2,3,2,2,2,2,1,1.1695588347184027,0.7237468644557459,2.875,0,1.75,0,2.533333333333333,0,2.888888888888889,0,2.9166666666666665,0,1.6666666666666667,0,1.4285714285714286,0,2.3333333333333335,0,2.4324324324324325,0,1,0,0,0.5119389900507657,-0.2989446853297732,0.10649715236049626,4,2,3,1,1,3,2,1,1,1.1126972805283737,2,0,1,-0.3048482679606258,4,4,4,4,2,2,3,5,3,3,2,0.9511897312113419,3.2857142857142856,0,2.7142857142857144,5,3.8333333333333335,3.2559414990859232,0.38995568780511447,0,0.3385652752699547,2,3,3,3,3,2,3,2,2,2,2,4,2,4,5,3,4,2,2,2,1.0327955589886444,2.8,0,4,0,2.8,0,4.2,0,3.6666666666666665,0,1,1,1,3,1,1,2,2,1,1,2,3,1,1,1,3,1,2,2,2,0.7539370349250519,1.5,0,"White, Caucasian, Anglo, European American",0,21,0,1,NA,1,2,4,Self Employed,1,0,140,73,1,5,2,0,0,0,0,0,TRUE,TRUE,TRUE,TRUE,TRUE,4,0.8916309523752758,0.84,0.06738224393230956,4,0.420125,0.5355624999925495,1,1,0.0035665148391166813,0.004769089516445323,4,0.5426312500014902,0.6663483870644723,1,0.96875,0.009378071241346694,0.013072897051102131,1.5199,1.1374,0.4634,0,24.0821,0.004,ML,change,50,-36.42813098371556,1.3030034872308331,1.2726198301492109,0.5595591302420181,1.3821,5.2462,0.4038,6.2013,0.3087,0,-99.1181,0.01,ML,cueing,64,210.71284925007902,4.372236301907277,0.9476008249106288,0.4305832358649767,4.701662874987558,0.881206253309367,0.3293413155258438,0.079,0.372,0.439,0.019,1.896,54.80056203620514,1922.995361396558,0.085,0.363,0.455,0.016,2.001,63.184089777049294,1887.6470099337605,388,1.1496296296296296,1,0,1,2,FALSE,FALSE,FALSE
379,2021-11-13T04:53:12Z,2021-11-13T05:22:18Z,1746,1,2021-11-13T05:22:20Z,1,Chrome,95.0.4638.69,Windows NT 10.0,1536,864,Thank you for the opportunity.,1.7777777777777777,767,101,505,115,79,102,-0.0570380689108935,0.10170920919548118,0.37308152998514504,0.12696586990404798,0.09744193443982496,-0.057035382828693984,3,3,2,1,3,1,1,4,2,3,2,1,1,2,3,3,1,1,2,3,0.9679060415469871,0,1,1,3,3,1.7,0,4,5,2,4,2,1,3,2,2,2,2,4,3,3,3,2,4,1,1,1,3,1,1,1,2,0,0,5,3,2,3,3,4,3,3,4,2,5,4,1,3,3,4,4,4,4,4,3,2,1,1,1,1,1,1,2,1,1,3,3,2,1,1,1,2,1,1,1,1.3037253160461753,1.082325538564332,1.75,0,1.25,0,2.1333333333333333,0,2.6666666666666665,0,2.9166666666666665,0,1.3333333333333333,0,1.7142857142857142,0,1,0,2.27027027027027,0,1,0,0,-0.21311656568613527,-0.4557470907642554,-0.33443182822519535,4,2,4,1,1,2,1,1,1,1.3451854182690985,1.5714285714285714,0,1,-0.5612498234260587,5,5,5,5,3,4,2,6,3,4,3,1.2149857925879117,4.428571428571429,0,1.5714285714285714,4.5,3.8333333333333335,3.2559414990859232,0.10757398284279028,0,-0.4399935565827014,2,3,3,2,2,1,5,2,2,4,3,4,2,4,4,2,5,2,4,2,1.2798809468443688,2.4,0,4.2,0,4.2,0,4,0,4.133333333333334,0,1,1,2,3,2,2,1,1,2,2,1,3,4,3,1,4,1,2,2,1,0.998683343734455,1.85,0,"White, Caucasian, Anglo, European American",0,30,0,1,NA,1,3,6,Buyer,5,0,195,71,1,5,2,0,0,1,0,0,TRUE,TRUE,TRUE,TRUE,TRUE,1,0.9425088235069724,0.6938775510204082,0.04127507795380456,1,0.4783062500655651,0.5632906249910593,1,1,0.0023660960929056136,0.005120999577424275,1,0.6704624999761581,0.7851062500029802,1,1,0.0066649101651579355,0.019333574165954555,1.3366,0.6585,0.5808,0,25.3694,0.004,ML,change,49,-39.06333910566812,0.7941179685374886,1.030464434674633,0.6909291729718192,2.9373,6.166,0.3251,9.5596,0.3247,0,-96.6711,0.013,ML,cueing,64,205.818849250079,4.295105238495675,0.9646177442307865,0.45450709259374067,5.209600250574535,0.7952884150630581,0.40436241416305313,0.423,0.164,0.838,0.007,1.067,34.520409502738126,1824.4685085332858,0.436,0.183,0.9,0.011,1.313,38.59711246616449,1820.953844531698,376,1.114074074074074,1,0,0,1,FALSE,FALSE,FALSE
380,2021-11-13T04:58:44Z,2021-11-13T05:23:00Z,1455,1,2021-11-13T05:23:02Z,1,Chrome,91.0.4472.101,Windows NT 10.0,1920,1080,i accidentally pressed the left button by mistake one time when i meant to press right button. i apologize,1.7777777777777777,734,51,352,98,55,93,-0.1418271804904488,-0.35252770646363196,-0.36349705755877526,-0.08020304117469244,-0.2340474968444512,-0.20905768367637165,3,4,2,2,3,1,2,3,1,3,3,1,1,1,3,3,1,1,3,2,0.9880869341680844,0,1,1,3,3,1.65,0,3,3,3,3,2,1,2,2,2,2,2,3,2,3,3,3,2,1,1,1,1,2,1,3,2,1,2,4,4,3,3,2,3,3,3,2,1,4,3,3,3,2,4,3,2,2,3,3,4,2,1,1,2,1,2,3,3,3,4,1,2,2,2,2,2,2,2,1,0.9291734839971293,0.6324555320336759,1.5,0,1.75,0,2.533333333333333,0,3,0,2.4166666666666665,0,1.3333333333333333,0,2.142857142857143,0,2,0,2.3513513513513513,0,2,1,2,-0.11380979753955131,0.4636802898581284,0.17493524615928857,3,2,2,3,2,3,3,2,3,0.5345224838248488,2.857142857142857,0,2.5,0.7614363551318132,3,3,3,3,1,1,3,3,3,2,2,0.9759000729485332,2.4285714285714284,0,3.5714285714285716,6,3.8333333333333335,3.2559414990859232,0.9547190977297628,0,1.0989729647608995,1,1,2,3,2,1,2,2,1,2,1,3,2,2,4,2,4,2,3,2,0.9411239481143202,1.8,0,4.2,0,3,0,3.8,0,3.6666666666666665,0,2,2,3,3,2,2,3,2,2,1,3,2,3,1,2,2,1,2,2,2,0.6407232755171874,2.2,0,"White, Caucasian, Anglo, European American",0,25,0,1,NA,1,2,7,teachers assistant,2,0,180,74,2,5,2,0,0,1,0,0,TRUE,TRUE,TRUE,TRUE,TRUE,4,1.058110256415147,0.7959183673469388,0.15869713456317064,4,0.5246548386850665,0.6333838709092909,0.96875,1,0.004584185439791447,0.00888904606916557,4,1.0098968750834465,1.0587093750089407,1,1,0.17764869062985938,0.10444602088562302,1.4053,0.9558,0.646,0,26.3631,0.004,ML,change,49,-41.05073910566812,0.8950987177947651,1.5204764860892757,0.555442885310596,1.217,4.7151,0.5043,3.4968,0.3572,0,-73.5881,0.006,ML,cueing,63,159.60560417917458,3.7419562463377476,1.1072108954898707,0.49006170405397614,4.065793081211549,0.8446045177148727,0.4272794042320983,0.211,0.234,0.286,0.04,1.627,63.861381104081126,1866.082509652134,0.209,0.227,0.278,0.022,1.724,63.98322072991514,1846.7517624500695,104,0.3081481481481481,1,0,1,2,FALSE,FALSE,FALSE
381,2021-11-13T05:08:57Z,2021-11-13T05:23:39Z,881,1,2021-11-13T05:23:40Z,1,Chrome,95.0.4638.69,Windows NT 10.0,1280,720,None.,1.7777777777777777,556,35,156,24,21,60,-0.599174509616535,-0.4978835194745482,-1.307087927876477,-0.9819971246939154,-0.7036575244971758,-0.7664727867845231,3,3,2,1,3,1,1,3,1,3,3,2,1,1,3,3,1,1,3,3,0.9679060415469871,0,1,2,5,4,1.6,0,4,4,2,4,2,2,4,2,2,2,1,5,2,4,4,2,1,1,1,2,1,2,2,3,2,1,3,4,4,5,4,4,4,4,5,4,2,4,4,4,3,3,2,3,5,2,2,3,4,4,3,2,2,2,4,3,3,2,3,4,2,3,3,2,3,3,2,4,0.9617301726185599,1.2227992865708155,1.5,0,3,0,1.8666666666666667,0,1.7777777777777777,0,3.0833333333333335,0,2.3333333333333335,0,2.857142857142857,0,2.6666666666666665,0,2.6216216216216215,0,2,1,3,-0.2841605889021127,1.0321359503435148,0.37398768072070104,3,2,4,2,2,3,3,1,1,0.7559289460184544,2.4285714285714284,0,1,-0.048446712495193056,3,4,3,3,4,3,3,5,3,3,2,0.4879500364742666,3.2857142857142856,0,2.7142857142857144,5,3.8333333333333335,3.2559414990859232,0.38995568780511447,0,0.3385652752699547,3,2,2,3,2,2,2,1,3,4,3,3,3,2,3,3,3,2,2,3,0.7367883976130072,2.4,0,3.4,0,2.8,0,3.2,0,3.1333333333333333,0,2,3,3,2,2,1,1,3,2,2,2,3,1,1,1,3,2,2,2,1,0.7591546545162482,1.85,0,"Asian or Asian American (e.g., Chinese, Japanese, and others)",0,27,0,1,NA,1,3,6,Analyst,4,0,145,68,5,5,2,0,0,1,0,0,TRUE,TRUE,TRUE,TRUE,TRUE,6,0.6614451612907071,0.6326530612244898,0.03569860147862422,6,0.446868965517858,0.5515689655203244,0.90625,0.9354838709677419,0.0012688640222404957,0.011617231613029768,6,0.584534375000745,0.6309222222235468,1,0.84375,0.00786263845831985,0.009041415474200395,1.4064,0.4109,0.2124,0,35.0549,0.004,ML,change,49,-58.43433910566813,0.5568720087125189,0.9761945978319397,0.42890482935230023,1.0241,2.4746,0.3631,3.6165,0.3291,0,-57.0743,0.009,ML,cueing,63,126.5780041791746,2.8183411630033013,0.948837807335178,0.4049566367210151,4.420174789349033,0.5132565225214719,0.39969651822532554,0.051,0.44,0.342,0.022,1.563,78.40004178613037,1994.7489002729553,0.051,0.439,0.339,0.018,1.646,102.22207779664099,2015.0227735272083,362,1.0725925925925925,1,0,0,1,FALSE,FALSE,FALSE
382,2021-11-13T04:51:25Z,2021-11-13T05:26:03Z,2078,1,2021-11-13T05:26:04Z,1,Chrome,95.0.4638.69,Windows NT 10.0,1920,1080,no,1.7777777777777777,1051,76,440,155,50,200,0.6726621640767946,-0.1254092486340754,0.060155986257335765,0.6144221312657902,-0.3031077950286754,1.5983185597349072,2,2,3,3,2,1,1,2,1,3,2,1,3,2,3,2,1,2,2,2,0.7254762501100116,0,1,2,5,4,2.3,0,3,4,2,4,3,2,4,2,2,2,2,4,2,3,2,2,2,3,2,1,2,2,2,5,2,2,2,3,4,5,4,3,3,4,4,3,3,3,3,1,3,2,4,2,2,3,3,4,3,1,3,1,2,1,2,4,3,1,3,2,2,1,1,1,2,2,3,2,1.1143346632595352,0.8837151016885368,2,0,2.25,0,2.3333333333333335,0,2.3333333333333335,0,2.5833333333333335,0,1.6666666666666667,0,2.2857142857142856,0,1,0,2.2432432432432434,0,3,2,2,-0.03134452808449325,1.0302083766821508,0.49943192429882877,4,1,3,1,1,2,1,3,3,1.2149857925879117,1.5714285714285714,0,3,0.17672552612270553,5,5,5,5,3,2,2,6,5,6,4,1.4638501094227998,4.142857142857143,0,1.8571428571428572,3.5,3.8333333333333335,3.2559414990859232,-0.4571894270818581,0,-0.563033266702152,3,3,3,2,2,3,4,3,2,2,2,3,2,3,3,3,3,2,4,3,0.6761234037828132,2.6,0,3.4,0,3.4,0,3.2,0,3.3333333333333335,0,2,2,2,2,2,3,2,3,1,3,1,3,2,1,1,3,1,2,1,3,0.7947194142390263,1.9,0,"White, Caucasian, Anglo, European American",0,20,0,1,NA,1,4,5,Student,1,0,115,68,2,5,2,0,0,0,0,0,TRUE,TRUE,TRUE,TRUE,TRUE,3,0.9112657894586262,0.76,0.060868902965406646,3,0.4458419354807946,0.49272187500447034,0.96875,1,0.005075200482594408,0.004040501761975548,3,0.5111193548402478,0.6237379310501033,0.96875,0.90625,0.012221135482674261,0.012102959021157341,1.2688,0.9072,0.5575,0,20.2453,0.003,ML,change,50,-28.75453098371556,0.9852110858625258,1.1699822773809387,0.6025041479341309,1.3223,5.6246,0.3752,3.7999,0.2803,0,-82.5134,0.007,ML,cueing,64,177.50344925007903,4.557258558812187,0.909128738895036,0.39609377562863435,3.9636702425314643,0.866365513366211,0.3433841603529012,0.075,0.325,0.423,0.008,1.371,113.82083261042679,2035.04492204077,0.077,0.314,0.402,0.009,1.501,141.76070285149103,2045.6194407380106,104,0.3081481481481481,1,1,3,4,FALSE,FALSE,FALSE
383,2021-11-13T04:57:17Z,2021-11-13T05:30:30Z,1993,1,2021-11-13T05:30:31Z,0.800000011920929,Chrome,95.0.4638.69,Windows NT 10.0,2560,1440,no,1.7777777777777777,1090,72,486,98,79,85,0.7728674777617236,-0.16174820188680444,0.2816109864339392,-0.08020304117469244,0.09744193443982496,-0.34418861776319626,4,4,3,3,3,1,1,4,2,4,4,1,1,1,4,4,1,1,3,3,1.3138933706635727,0,1,1,2,2,1.4,0,2,5,2,4,2,1,3,2,1,2,2,4,1,4,4,2,1,1,1,1,1,1,1,3,2,3,2,5,5,4,5,5,5,5,5,5,2,5,2,1,5,2,5,3,3,2,2,2,5,1,3,1,3,2,1,4,4,1,5,1,2,1,1,1,2,1,1,2,1.6562739034481113,1.2983506020002016,1.125,0,1.5,0,1.9333333333333333,0,1.1111111111111112,0,1.8333333333333333,0,1.6666666666666667,0,1.8571428571428572,0,1,0,1.6216216216216217,0,2,3,2,-0.8464149906209297,0.7985455023269348,-0.023934744146997478,5,1,3,1,1,1,1,2,2,1.5735915849388864,1.2857142857142858,0,2,-0.3631965189619651,4,4,4,4,3,2,2,6,6,1,2,0.9511897312113419,3.5714285714285716,0,2.4285714285714284,3,3.8333333333333335,3.2559414990859232,-0.7395711320441822,0,-0.3855401294975673,1,1,1,1,1,1,5,1,1,5,1,5,1,5,5,1,5,1,5,5,2.065591117977289,1,0,5,0,5,0,4.2,0,4.733333333333333,0,1,1,1,2,2,2,2,2,2,1,2,3,2,3,1,3,1,3,2,1,0.7451598203705946,1.85,0,"Hispanic of Latino (e.g., Mexican American, Central American, and others)",0,21,0,1,NA,1,3,4,student,3,0,175,72,3,5,2,0,0,1,0,0,TRUE,TRUE,TRUE,TRUE,TRUE,3,0.9097027026986754,0.7551020408163265,0.05944145246733419,3,0.3965599999984105,0.42300800000071526,0.9375,0.8064516129032258,0.005740791844718046,0.006204156129223249,3,0.4799562499979511,0.5804769230702749,1,0.8125,0.006886205120779053,0.01376526770087017,1.471,0.8056,0.4587,0,31.059,0.003,ML,change,49,-50.442539105668125,0.9707393379326901,1.159952233165089,0.6048771224764515,0.9528,1.6044,0.2534,3.5055,0.2891,0,-48.9989,0.006,ML,cueing,63,110.4272041791746,2.0946973063281624,0.6812995611961552,0.3233347208266441,3.3865245390959218,0.7996546813226874,0.2932538172025012,0.06,0.314,0.334,0.014,1.985,146.76930351929892,2052.886984265756,0.06,0.314,0.343,0.013,2.013,180.00199692197594,2081.0639781616455,380,1.125925925925926,0,0,1,2,FALSE,FALSE,FALSE
385,2021-11-13T05:15:13Z,2021-11-13T05:32:28Z,1034,1,2021-11-13T05:32:29Z,1,Edge,95.0.1020.44,Windows NT 10.0,1920,1080,"Nothing at all, good study",1.7777777777777777,637,33,206,25,30,65,-0.39105578119399015,-0.5160529961009127,-1.0663759711627776,-0.9698107181598719,-0.5793489877655722,-0.6820159529802577,3,4,1,2,3,1,2,3,2,4,3,2,1,2,3,3,1,2,3,4,0.998683343734455,0,1,2,3,3,1.65,0,1,4,2,4,2,4,1,4,3,4,4,1,2,2,3,4,4,1,1,2,5,4,2,2,3,3,6,1,2,3,3,1,2,3,2,3,2,3,2,2,3,2,3,2,4,4,5,5,1,1,2,1,2,1,1,2,3,2,4,2,2,1,1,3,1,1,2,2,1.1068989227681203,1.2227992865708155,2.875,0,1.5,0,3.4,0,3.7777777777777777,0,3.0833333333333335,0,1.8333333333333333,0,1.8571428571428572,0,1.6666666666666667,0,2.7567567567567566,0,1,3,6,1.0237656859173703,1.3012516161271415,1.162508651022256,4,3,4,2,3,2,3,3,2,0.816496580927726,2.4285714285714284,0,2.5,0.5050347996663801,5,4,3,4,3,4,2,6,6,5,4,0.9759000729485332,3.857142857142857,0,2.142857142857143,3,3.8333333333333335,3.2559414990859232,-0.7395711320441822,0,-0.5448821243404407,2,3,2,2,3,2,3,2,3,2,3,3,2,3,2,3,2,2,3,3,0.5163977794943222,2.4,0,3.2,0,3,0,3,0,3.066666666666667,0,2,3,2,3,2,3,3,2,3,3,2,2,3,4,3,2,1,3,3,4,0.7451598203705946,2.75,0,"White, Caucasian, Anglo, European American",0,26,0,1,NA,1,3,7,Analyst,3,0,245,77,3,5,2,0,0,1,0,0,TRUE,TRUE,TRUE,TRUE,TRUE,NA,NA,NA,NA,1,0.5553562500004191,0.6876724137933604,1,0.90625,0.0037686831855083553,0.00822709515125445,1,0.6268749999995343,0.7294899999996026,1,0.967741935483871,0.003640157419403104,0.00866918346246709,NA,NA,NA,NA,NA,NA,NA,NA,NA,NA,NA,NA,NA,1.4628,2.8196,0.4695,3.4859,0.3455,0,-46.0698,0.009,ML,cueing,64,104.61624925007902,2.770011576205443,0.8190159062173186,0.5675555107598446,4.637298871617338,0.8934370721174896,0.4620349882513404,0.086,0.455,0.471,0.017,1.834,122.1075715809128,1955.3678239884462,0.087,0.453,0.498,0.017,1.937,149.40723305369553,1975.2791376255059,104,0.3081481481481481,1,0,0,1,FALSE,FALSE,FALSE
386,2021-11-13T05:05:13Z,2021-11-13T05:32:44Z,1651,1,2021-11-13T05:32:45Z,1,Edge,95.0.1020.44,Windows NT 10.0,1504,1003,NA,1.4995014955134596,916,58,351,88,77,93,0.32579761670588653,-0.2889345382713561,-0.36831129669304924,-0.202067106515128,0.06981781516613529,-0.20905768367637165,4,4,2,3,4,1,1,2,1,3,2,1,1,1,4,4,1,1,4,4,1.353358395757909,0,1,1,3,4,1.4,0,3,5,1,5,1,1,5,5,1,1,1,5,3,5,3,1,3,2,1,1,1,1,1,1,2,5,30,5,5,3,5,5,5,5,5,5,2,3,1,1,3,1,5,1,1,1,1,1,3,5,1,1,3,1,1,5,5,5,5,1,1,1,1,1,4,3,2,4,1.8534927664912628,1.8516401995451028,1.375,0,3.25,0,1.6666666666666667,0,1.2222222222222223,0,1.4166666666666667,0,2.1666666666666665,0,2.5714285714285716,0,1,0,1.7297297297297298,0,1,5,6,-0.8071181603407025,2.2633264503338766,0.728104144996587,5,1,1,1,1,1,1,1,1,1.5118578920369088,1.5714285714285714,0,1,-0.5612498234260587,5,5,4,4,3,5,1,6,4,3,2,1.4638501094227998,4.428571428571429,0,1.5714285714285714,4,3.8333333333333335,3.2559414990859232,-0.1748077221195339,0,-0.5811844090638635,3,3,2,3,2,2,5,1,2,3,1,3,1,5,3,4,3,1,3,1,1.4074631010979937,2.6,0,4,0,3.6,0,4.4,0,4,0,1,1,1,4,2,2,2,4,2,1,1,4,1,2,1,4,1,1,1,1,1.1821033884786185,1.25,0,"Asian or Asian American (e.g., Chinese, Japanese, and others) & White, Caucasian, Anglo, European American",1,28,0,1,NA,1,4,6,Paralegal,3,0,185,71,1,5,2,0,0,0,0,0,TRUE,TRUE,TRUE,TRUE,TRUE,6,1.080965789474939,0.7755102040816326,0.10228046585675724,6,0.6184806451605213,0.6741781250014901,0.96875,1,0.0058794535384446905,0.002290326925558419,6,0.8018687499985099,1.1818312499988823,1,1,0.01266291189703509,0.0428753318935862,1.4397,0.8907,0.6637,0,27.749,0.003,ML,change,49,-43.82253910566812,0.9222542446305684,1.344196455744808,0.679406412541512,1.4177,4.7529,0.5324,3.9458,0.4542,0,-84.9516,0.013,ML,cueing,64,182.37984925007902,5.2521621387743735,0.7888436451351367,0.6014278689133381,3.8205560562419483,0.8988186939109993,0.508203173355747,0.434,0.06,0.589,0.004,1.666,65.66336748042013,1860.2024254631262,0.355,0.297,0.712,0.003,1.26,14.561654601207817,1844.4223104388475,104,0.3081481481481481,1,0,0,1,FALSE,FALSE,FALSE
387,2021-11-13T05:16:03Z,2021-11-13T05:39:11Z,1388,1,2021-11-13T05:39:14Z,1,Chrome,95.0.4638.69,Windows NT 10.0,1920,1080,NA,1.7777777777777777,652,81,321,94,63,109,-0.3525152759305559,-0.07998555706816408,-0.5127384707212689,-0.12894866731086665,-0.12355101974969247,0.06120418449727754,3,3,2,2,3,1,1,3,1,3,2,2,2,2,3,3,2,1,3,3,0.7863975156570492,0,1,2,3,3,1.85,0,4,4,2,4,3,2,4,2,1,2,1,4,2,4,3,3,1,1,1,1,1,2,1,2,2,0,0,5,5,5,5,5,5,5,5,2,2,4,1,1,5,1,5,3,1,1,1,2,5,1,5,1,3,1,1,2,2,1,5,1,2,1,1,1,1,1,2,2,1.8013175024810992,1.1464230084422218,1.375,0,1.5,0,2,0,1.3333333333333333,0,1.4166666666666667,0,1.8333333333333333,0,1.2857142857142858,0,1,0,1.4594594594594594,0,1,0,0,-0.780016898078477,-0.3773458880470143,-0.5786813930627457,5,1,3,1,1,1,1,1,1,1.5735915849388864,1.2857142857142858,0,1,-0.7321841937363471,5,5,5,5,2,2,1,4,7,4,3,1.8126539343499315,4.142857142857143,0,1.8571428571428572,3.5,3.8333333333333335,3.2559414990859232,-0.4571894270818581,0,-0.563033266702152,3,2,2,2,2,3,4,3,2,2,4,3,2,3,4,5,3,3,2,5,1.01418510567422,2.2,0,2.8,0,2.6,0,3,0,2.8,0,1,1,3,4,2,2,3,2,1,1,3,4,2,1,1,4,1,2,1,3,1.1192102478745307,1.7,0,"Hispanic of Latino (e.g., Mexican American, Central American, and others)",0,24,0,1,NA,1,3,4,Unemployed,5,0,210,71,2,5,2,0,0,1,0,0,TRUE,TRUE,TRUE,TRUE,TRUE,4,0.7435621621614775,0.74,0.06789574377568618,4,0.3636781249991618,0.42932258064492096,1,0.96875,0.0013591269254363163,0.0017928651612525723,4,0.6275843750010245,0.7153875000008848,1,1,0.024186089102635457,0.03304918241931183,1.2244,0.8724,0.4201,0,17.0005,0.004,ML,change,50,-22.26493098371556,0.8790281351982702,1.1899147630203701,0.41868115814165213,1.2682,5.4657,0.3185,6.2031,0.2615,0,-103.7329,0.008,ML,cueing,64,219.94244925007902,5.141311408387082,0.6679204840390026,0.3684261085147678,5.9840813695638015,0.6923593565195018,0.30763584505627073,0.111,0.312,0.32,0.094,1.117,81.65609936423982,1877.6883831257078,0.11,0.312,0.323,0.011,1.149,88.53038277227326,1865.4441467107938,312,0.9244444444444444,1,0,0,1,FALSE,FALSE,FALSE
388,2021-11-13T05:04:05Z,2021-11-13T05:39:16Z,2110,1,2021-11-13T05:39:17Z,1,Chrome,95.0.4638.69,Windows NT 10.0,1920,1080,No feedback,1.7777777777777777,723,96,609,179,119,233,-0.17009021768363392,0.05628551762956986,0.8737623999496399,0.9068958880828354,0.6499243199136185,2.155733662843059,2,4,2,1,1,1,2,3,1,3,3,2,2,1,3,3,1,1,3,3,0.9679060415469871,0,1,1,4,3,1.8,0,1,4,1,4,1,1,4,1,2,1,1,5,1,5,4,1,1,1,1,1,1,1,1,0,3,0,0,5,2,2,2,5,4,3,3,2,3,4,1,1,1,1,2,2,1,1,1,1,5,1,1,1,1,1,1,1,1,1,4,2,2,1,1,1,1,1,1,1,1.3111900011894613,1.6818357317441643,1,0,1,0,1.6,0,2.888888888888889,0,1.9166666666666667,0,0.8333333333333334,0,1.2857142857142858,0,1,0,1.837837837837838,0,0,0,0,-0.9504644796634032,-0.7372407672780129,-0.843852623470708,5,1,4,1,1,1,1,1,1,1.7320508075688772,1.1428571428571428,0,1,-0.8176513788914915,5,5,5,5,5,3,1,3,3,3,3,1.5735915849388864,4.714285714285714,0,1.2857142857142858,6,3.8333333333333335,3.2559414990859232,0.9547190977297628,0,-0.17576299398208856,1,3,1,1,1,1,5,2,2,1,1,3,1,3,3,1,5,1,3,3,1.3972762620115438,1.4,0,4.6,0,3.8,0,3.4,0,3.933333333333333,0,1,2,2,1,1,3,1,1,3,3,1,1,1,3,1,1,1,3,1,3,0.9233805168766387,2.3,0,"White, Caucasian, Anglo, European American",0,21,0,1,NA,1,3,5,Student,3,0,128,72,1,5,2,0,0,1,0,0,TRUE,TRUE,TRUE,TRUE,TRUE,2,1.0293102040814655,1,0.09859358010217167,2,0.4410468749996508,0.47717741935435803,1,0.96875,0.0032872432157684856,0.003061271925413355,2,0.575545161290635,0.6538258064517811,1,0.96875,0.00419519589254329,0.010218741683451455,2.439,2.4106,0.5234,0,-0.6988,0.003,ML,change,49,13.07306089433188,2.133447811189594,2.1538468511082938,0.5346250510124577,1.3126,4.5674,0.3392,4.9508,0.3085,0,-84.8041,0.008,ML,cueing,64,182.08484925007903,4.497646720993221,0.7635075446136451,0.3976037703465027,4.798489346458132,0.8634248046105737,0.35388998883464456,0.06,0.451,0.443,0.017,1.497,85.20042075486523,1949.2285067670866,0.061,0.453,0.497,0.016,1.604,98.32373460455001,1928.2836449676367,326,0.965925925925926,1,0,1,2,FALSE,FALSE,FALSE
389,2021-11-13T05:05:46Z,2021-11-13T05:42:35Z,2208,1,2021-11-13T05:42:37Z,1,Chrome,95.0.4638.69,Windows NT 10.0,1920,1080,All was great,1.7777777777777777,1278,56,495,92,85,138,1.2559084770634326,-0.30710401489772066,0.32493913864240515,-0.15332148037895377,0.18031429226089402,0.5510538205620167,4,4,1,1,1,1,1,4,1,3,3,2,1,1,4,4,1,1,3,2,1.3088765773505315,0,1,1,4,4,1.45,0,3,4,2,4,2,1,4,1,1,1,1,4,3,4,4,1,2,1,1,1,2,1,2,2,2,0,0,4,4,5,5,5,5,5,5,5,1,4,1,5,4,2,4,1,1,1,1,1,5,1,1,1,2,1,1,2,1,1,5,3,1,1,1,1,2,1,2,2,1.7849891277501346,1.3522468075656264,1.375,0,1.75,0,1.8,0,1.2222222222222223,0,1.6666666666666667,0,1,0,1.2857142857142858,0,1,0,1.3783783783783783,0,1,0,0,-0.9008110955901112,-0.2989446853297732,-0.5998778904599422,5,1,3,1,1,1,2,3,2,1.5275252316519468,1.4285714285714286,0,2.5,-0.09323549641962975,4,4,5,5,3,3,4,6,6,2,4,0.816496580927726,3.7142857142857144,0,2.2857142857142856,3,3.8333333333333335,3.2559414990859232,-0.7395711320441822,0,-0.465211126919004,2,2,2,2,2,2,4,3,2,2,1,4,2,2,3,1,3,2,3,3,0.9154754164341269,2,0,4,0,3.6,0,3,0,3.533333333333333,0,1,1,1,2,1,1,2,1,1,1,1,3,2,1,1,4,1,1,1,1,0.8207826816681233,1.4,0,"White, Caucasian, Anglo, European American",0,22,0,1,NA,0,3,6,student,2,0,209,75,1,5,2,0,0,1,0,0,TRUE,TRUE,TRUE,TRUE,TRUE,6,0.9160200000013624,0.7,0.06732935500430963,6,0.38051935483947874,0.4588612903241188,0.96875,0.96875,0.0013765612802592352,0.0042134138309262974,6,0.5822875000070781,0.6587000000039116,1,1,0.004372986290570565,0.005044798064375809,1.2717,0.6713,0.5656,0,25.3495,0.004,ML,change,50,-38.96293098371556,0.7259320121951075,1.167186246305772,0.5944509751621412,1.2337,3.9563,0.309,4.614,0.2519,0,-78.2964,0.008,ML,cueing,64,169.06944925007903,4.152429691054237,0.8269826246265258,0.3655067643874578,5.4923971034895205,0.6252255872583228,0.3271593212320876,0.093,0.415,0.567,0.021,1.799,11.854244520488606,1802.6170094933998,0.094,0.415,0.57,0.021,1.891,26.8217788348315,1809.1099592967382,348,1.031111111111111,1,1,2,3,FALSE,FALSE,FALSE
390,2021-11-13T05:17:40Z,2021-11-13T05:42:49Z,1509,1,2021-11-13T05:42:50Z,1,Chrome,95.0.4638.69,Windows NT 10.0,1536,864,n/a,1.7777777777777777,955,41,233,32,30,172,0.4260029303908155,-0.44337508959545463,-0.9363915145373799,-0.884505872421567,-0.5793489877655722,1.1253602904310211,1,1,3,2,1,2,3,1,2,1,1,3,2,2,1,1,2,2,1,1,0.7451598203705946,0,1,3,3,2,3.15,0,1,1,2,3,1,4,2,3,4,1,4,2,1,4,2,3,4,5,1,2,3,3,4,2,1,1,1,1,4,1,2,1,1,4,1,2,4,1,2,5,5,2,1,4,4,4,2,3,3,5,3,2,4,2,3,1,4,5,3,1,4,4,1,4,2,3,3,4,1.416865380869865,1.2344267996967353,3.125,0,3,0,3.1333333333333333,0,4.111111111111111,0,3.4166666666666665,0,3,0,2.857142857142857,0,3,0,3.4324324324324325,0,1,1,1,1.3069738765576282,0.47614418274863685,0.8915590296531325,1,4,2,3,3,2,3,3,1,0.9759000729485332,3.4285714285714284,0,2,0.9188112583651991,2,3,1,4,1,1,4,6,6,1,2,1.3801311186847085,2,0,4,3,3.8333333333333335,3.2559414990859232,-0.7395711320441822,0,0.49084084213823703,2,4,4,1,3,3,5,3,1,5,1,1,2,4,3,5,2,4,1,5,1.6035674514745464,2.8,0,2.6,0,3.2,0,3.2,0,3,0,4,1,3,4,2,4,2,1,4,2,3,1,2,3,2,4,1,3,3,4,1.1367080817685316,2.65,0,"Asian or Asian American (e.g., Chinese, Japanese, and others)",0,28,0,1,NA,1,3,6,Channel Sales Executive,5,0,175,70,2,5,2,0,0,1,0,0,TRUE,TRUE,TRUE,TRUE,TRUE,NA,NA,NA,NA,6,0.6066812500001397,0.6667843750000466,1,1,0.006226837056508379,0.006555574909363486,6,0.8616967741943174,0.9403531250008382,1,1,0.07893153432282461,0.05423691740904169,NA,NA,NA,NA,NA,NA,NA,NA,NA,NA,NA,NA,NA,6.1178,7.9104,0.2801,7.8635,0.2177,0,-73.6188,0.01,ML,cueing,64,159.714249250079,4.037939412630081,1.0260517315917164,0.5437033287775069,4.090210121206665,1.0129393365173265,0.4867259233576947,0.131,0.489,0.38,0.029,1.871,100.63529668503801,1893.4339208125937,0.127,0.48,0.367,0.024,2.04,98.87291274399595,1882.7624742210708,446,1.3214814814814815,1,0,0,1,FALSE,FALSE,FALSE
391,2021-11-13T05:25:05Z,2021-11-13T05:43:35Z,1110,1,2021-11-13T05:43:36Z,0.8999999761581421,Chrome,95.0.4638.69,Windows NT 10.0,1920,1080,NA,1.7777777777777777,610,53,248,53,41,69,-0.46042869066817177,-0.33435822983726743,-0.86417792752327,-0.6285913352066523,-0.42741633176027893,-0.6144504859368455,3,3,2,1,3,2,2,3,1,2,2,2,1,2,2,3,2,2,3,2,0.6708203932499369,0,1,1,4,4,2.05,0,5,3,2,5,1,1,5,2,1,1,1,5,1,5,5,1,2,1,1,1,2,2,2,1,2,0,0,5,5,5,5,5,5,5,5,5,1,5,1,1,4,1,3,3,2,2,2,1,4,1,1,1,2,1,1,2,2,2,4,3,3,1,1,1,1,1,1,1,1.6608004871923232,1.88477610139267,1.5,0,1,0,1.2666666666666666,0,1,0,1.6666666666666667,0,1.1666666666666667,0,2,0,1,0,1.4864864864864864,0,1,0,0,-1.0298324620027786,-0.5341482934814965,-0.7819903777421375,5,1,4,1,1,2,1,1,1,1.6761634196950514,1.2857142857142858,0,1,-0.7321841937363471,5,5,5,5,3,3,1,3,7,NA,4,1.5735915849388864,4.428571428571429,0,1.5714285714285714,4,3.8333333333333335,3.2559414990859232,-0.1748077221195339,0,-0.5811844090638635,3,3,3,3,3,3,4,4,2,3,1,3,4,3,4,5,4,2,3,5,1.1126972805283737,3,0,3.8,0,2.6,0,2.8,0,3.066666666666667,0,1,1,1,3,2,1,1,2,1,1,1,4,2,2,1,3,1,2,2,1,0.8750939799154206,1.45,0,"Asian or Asian American (e.g., Chinese, Japanese, and others)",0,18,0,1,NA,1,4,4,Student,7,0,155,66,3,5,2,0,0,1,0,0,TRUE,TRUE,TRUE,TRUE,TRUE,2,0.7696666666697233,0.78,0.031961580066280915,2,0.44071250000130385,0.5523066666672627,1,0.967741935483871,0.0019051456452254753,0.006930224924384986,2,0.6653833333333333,0.7348172413778716,1,0.90625,0.04471235178155551,0.031725883226724635,1.3594,1.0109,0.3813,0,18.8347,0.004,ML,change,50,-25.933330983715564,1.255835632153726,1.0078280476567547,0.5449622179992077,1.3642,4.3454,0.4024,5.3243,0.3126,0,-83.5166,0.008,ML,cueing,63,179.4626041791746,3.649788999254495,0.9318887701061305,0.4328796375775923,5.499591711586902,0.7533531475913936,0.3743611324814615,0.072,0.407,0.305,0.014,1.672,85.29240066068724,1954.0360188054715,0.072,0.401,0.3,0.013,1.83,101.86644650836931,1956.1030983571509,274,0.8118518518518519,1,0,0,1,FALSE,FALSE,FALSE
392,2021-11-13T05:25:51Z,2021-11-13T05:44:15Z,1103,1,2021-11-13T05:44:16Z,1,Firefox,94.0,Macintosh,1440,900,n/a,1.6,595,52,228,68,39,81,-0.498969195931606,-0.3434429681504497,-0.9604627102087498,-0.44579523719599906,-0.4550404510339686,-0.4117540848066085,4,4,1,1,3,1,1,3,1,3,3,1,1,1,4,3,1,1,3,3,1.2258187382102494,0,1,1,3,3,1.35,0,5,5,1,5,1,1,5,1,1,1,1,5,1,5,4,1,1,1,1,1,1,1,1,1,2,0,0,5,5,5,5,5,5,5,5,5,1,5,1,1,5,1,5,1,1,1,1,2,5,1,1,1,1,1,1,2,2,1,5,1,1,1,1,1,2,1,1,2,1.921507791343088,2.007130147392398,1,0,1.5,0,1.0666666666666667,0,1,0,1.0833333333333333,0,0.8333333333333334,0,1.1428571428571428,0,1,0,1.0810810810810811,0,1,0,0,-1.5048788733706477,-0.3773458880470143,-0.9411123807088311,5,2,4,2,1,1,1,1,1,1.6035674514745464,1.4285714285714286,0,1,-0.6467170085812028,5,5,5,5,3,3,1,6,6,5,3,1.5735915849388864,4.428571428571429,0,1.5714285714285714,3,3.8333333333333335,3.2559414990859232,-0.7395711320441822,0,-0.8635661140261877,2,2,2,2,2,2,4,3,2,5,1,4,3,4,4,2,4,2,3,3,1.0997835284835873,2,0,4.2,0,3.8,0,3.6,0,3.8666666666666667,0,1,1,1,4,1,1,1,4,1,1,2,4,2,1,1,4,1,1,1,2,1.2085223687584246,1.15,0,"Asian or Asian American (e.g., Chinese, Japanese, and others) & White, Caucasian, Anglo, European American",1,27,0,1,NA,1,3,6,Resident Physician,3,0,185,68,3,5,2,0,0,1,0,0,TRUE,TRUE,TRUE,TRUE,TRUE,2,0.8535227272727273,0.88,0.050933766938775514,2,0.42275,0.5110967741935484,1,0.96875,0.0018581935483870968,0.004645725806451612,2,0.54721875,0.6763225806451613,1,0.96875,0.0036418538306451607,0.01374317641129032,1.4883,1.4713,0.4968,0,10.4839,0.003,ML,change,50,-9.231730983715563,1.6049089149544085,1.241459964565532,0.5595778297529178,1.205,3.8165,0.3604,6.2489,0.3263,0,-91.1278,0.014,ML,cueing,64,194.732249250079,4.052261126250511,0.8474249554748109,0.4130699107948492,5.534007678482713,0.7486680480225638,0.3572213439464625,0.068,0.43,0.549,0.011,1.512,43.56066143071819,1884.8825035467146,0.07,0.428,0.581,0.012,1.642,50.347447473166035,1879.2086266010222,400,1.1851851851851851,1,0,0,1,FALSE,FALSE,FALSE
395,2021-11-13T05:31:44Z,2021-11-13T05:52:30Z,1245,1,2021-11-13T05:52:31Z,1,Chrome,95.0.4638.69,Windows NT 10.0,1504,1003,NA,1.4995014955134596,668,34,292,57,76,83,-0.31140540364955943,-0.5069682577877305,-0.6523514056152145,-0.5798457090704782,0.05600575552929045,-0.3779713512849024,3,3,1,1,3,1,1,2,1,3,3,1,1,1,3,3,1,1,3,2,0.9679060415469871,0,1,1,3,3,1.6,0,5,5,1,5,1,1,5,1,1,1,1,5,3,5,4,1,1,1,1,1,1,1,1,0,2,0,0,5,5,4,5,5,5,5,5,5,2,5,2,1,5,2,5,1,1,1,1,1,5,1,1,1,3,1,1,1,1,1,4,1,2,1,1,1,1,1,1,1,1.8310796959315705,1.9444671200491874,1,0,1,0,1.2,0,1.1111111111111112,0,1.25,0,1.1666666666666667,0,1.1428571428571428,0,1,0,1.2162162162162162,0,0,0,0,-1.3895049283114589,-0.7372407672780129,-1.063372847794736,4,3,3,3,2,3,2,1,1,0.6900655593423543,2.5714285714285716,0,1,0.03702047265995151,5,5,5,5,4,4,2,2,2,4,4,1.1126972805283737,4.571428571428571,0,1.4285714285714286,7,3.8333333333333335,3.2559414990859232,1.5194825076544112,0,0.18628970840167225,1,1,1,1,1,1,3,2,2,1,1,1,3,5,4,2,2,1,1,5,1.4375905768565218,1,0,3.6,0,2.4,0,3.6,0,3.2,0,1,1,1,4,1,1,3,3,1,1,1,3,2,1,1,3,1,1,1,1,0.99472291830968,1.3,0,Other & Indo-Caribbean,1,20,0,1,NA,1,4,4,Student,5,0,160,67,3,5,2,0,0,1,0,0,TRUE,TRUE,TRUE,TRUE,TRUE,NA,NA,NA,NA,4,0.4689310344837863,0.586131250000326,0.9354838709677419,1,0.0034852344730692845,0.00726943318537662,4,0.6375593750008848,0.6912800000001986,1,0.967741935483871,0.011124307006188092,0.0058501418493306385,NA,NA,NA,NA,NA,NA,NA,NA,NA,NA,0.8592897237103152,1.3797717265119283,0.31471563203112246,1.77,3.7869,0.3524,3.4214,0.2343,0,-47.7633,0.018,ML,cueing,63,107.9560041791746,3.93493313607563,1.05291108720682,0.4565219808643227,3.808125263016131,0.7022218190660395,0.3886274060777496,0.077,0.467,0.496,0.014,1.454,42.62278707122151,1872.6529135619944,0.077,0.467,0.501,0.015,1.531,57.85035932048519,1882.7384135276518,104,0.3081481481481481,1,1,6,7,FALSE,TRUE,FALSE
396,2021-11-13T05:13:28Z,2021-11-13T05:57:08Z,2619,1,2021-11-13T05:57:11Z,1,Chrome,95.0.4638.69,Windows NT 10.0,2560,1440,nope. thanks :),1.7777777777777777,740,106,778,177,104,156,-0.12641097838507512,0.1471329007613925,1.687368813641944,0.8825230750147484,0.44274342536094596,0.855098422257372,3,3,1,1,3,1,2,3,1,3,2,1,1,1,3,3,2,1,3,2,0.9176629354822471,0,1,2,3,3,1.7,0,2,3,3,3,2,1,2,3,2,1,3,3,2,3,3,3,3,1,1,1,2,3,1,7,3,0,0,4,2,2,3,3,4,4,5,3,1,4,3,1,3,2,3,5,3,3,4,4,2,2,5,1,3,1,1,5,5,3,2,4,2,3,3,2,2,1,3,3,1.2357293502329008,0.7367883976130072,1.875,0,2.25,0,2.6666666666666665,0,2.6666666666666665,0,2.8333333333333335,0,2.5,0,3.2857142857142856,0,2.6666666666666665,0,2.864864864864865,0,4,0,0,0.3253274413308691,0.4671351414942582,0.39623129141256364,4,2,3,3,1,2,2,3,1,0.9759000729485332,2.142857142857143,0,2,0.14960659196890055,2,2,3,4,1,1,5,1,3,NA,1,1.5118578920369088,2,0,4,7,3.8333333333333335,3.2559414990859232,1.5194825076544112,0,1.6203676619875336,2,2,2,2,2,2,3,4,2,1,1,4,2,3,4,5,4,2,3,4,1.2227992865708155,2,0,4.2,0,2.4,0,3,0,3.2,0,2,1,2,3,3,3,2,3,1,3,2,3,2,2,1,4,2,3,2,2,0.8013147091860318,2,0,"Hispanic of Latino (e.g., Mexican American, Central American, and others) & White, Caucasian, Anglo, European American",1,23,0,1,NA,1,1,1,I am currently unemployed,2,0,180,64,1,5,2,1,1,0,0,2,TRUE,TRUE,TRUE,TRUE,TRUE,4,0.9562176470581223,0.68,0.2793249725054637,4,0.43659000000009934,0.49006250000139695,0.967741935483871,1,0.0031457607958959833,0.007933436612976649,4,0.5595531249996275,0.6307451612891689,1,1,0.00618939740918229,0.01118383389283409,1.6643,0.4697,0.3797,0,51.2536,0.003,ML,change,50,-90.77113098371557,0.4556922765678885,1.6541245948988215,0.3028328029605274,1.1881,3.7678,0.3324,4.675,0.3147,0,-76.7705,0.007,ML,cueing,63,165.97040417917458,3.849879667417267,1.0761725259768962,0.35466318565873356,4.44654985942111,0.7649070603483469,0.3561278169179574,0.171,0.301,0.672,0.011,1.146,23.260758782195786,1817.525886382831,0.174,0.301,0.671,0.012,1.21,35.42967459427473,1815.7568659295457,356,1.0548148148148149,1,0,1,2,FALSE,FALSE,FALSE
397,2021-11-13T05:22:32Z,2021-11-13T05:58:30Z,2158,1,2021-11-13T05:58:31Z,1,Firefox,94.0,Windows NT 10.0,1920,1080,NA,1.7777777777777777,1406,42,356,66,36,126,1.5847874553114047,-0.43429035128227234,-0.3442401010216793,-0.47016805026408615,-0.49647662994450314,0.3483574194317798,2,1,3,2,1,2,3,1,2,1,1,3,2,3,1,1,3,3,2,1,0.8522416262267903,0,1,2,3,3,3.2,0,2,3,2,4,2,3,1,3,4,3,3,2,4,2,1,2,2,4,2,2,1,4,1,2,6,4,1,4,2,2,4,4,4,4,3,1,2,4,1,1,3,1,4,2,2,1,2,3,2,2,3,2,1,3,3,2,3,2,3,2,2,1,2,1,2,1,2,2,1.0368582714503825,0.9856107606091623,2.25,0,1.75,0,3.4,0,2.888888888888889,0,1.8333333333333333,0,2.3333333333333335,0,2.2857142857142856,0,1.3333333333333333,0,2.27027027027027,0,1,4,1,0.5461059385456428,0.7040377919415024,0.6250718652435726,4,2,3,2,1,4,2,3,2,1.1338934190276817,2.2857142857142856,0,2.5,0.41956761451123586,4,3,5,3,2,3,2,1,6,2,3,1.0690449676496976,3.4285714285714284,0,2.5714285714285716,5.5,3.8333333333333335,3.2559414990859232,0.6723373927674386,0,0.4000851303296801,3,4,3,2,3,2,3,4,4,2,2,4,5,3,4,5,3,2,2,4,1.0997835284835873,3,0,3.8,0,1.8,0,2.6,0,2.7333333333333334,0,2,1,3,2,3,3,2,1,3,3,2,1,2,4,2,1,2,3,2,3,0.8506963092234007,2.75,0,"White, Caucasian, Anglo, European American",0,27,0,1,NA,1,3,2,Social Media Evaluator,1,0,125,67,2,5,2,0,0,0,0,0,TRUE,TRUE,TRUE,TRUE,TRUE,4,0.659921052631579,0.76,0.05257280979591836,4,0.41396666666666665,0.492,0.9375,0.967741935483871,0.002873047379032259,0.004380836559139786,4,0.57096875,0.6762333333333334,1,0.9375,0.005478869959677419,0.012644490927419356,1.1043,1.0221,0.3779,0,7.8157,0.003,ML,change,50,-3.895330983715562,1.021969327422209,1.127900298970691,0.37297107295647786,0.9151,3.7048,0.3738,3.458,0.2929,0,-75.5589,0.009,ML,cueing,63,163.54720417917457,4.093222263984318,0.8309339591912244,0.39704726270274476,4.026349588920456,0.6725819855668052,0.34088443369434973,0.094,0.35,0.426,0.007,1.332,128.36847215589268,2015.2471827279185,0.095,0.349,0.447,0.008,1.39,147.42691941408822,2022.679856364065,404,1.1970370370370371,1,0,9,10,FALSE,FALSE,FALSE
398,2021-11-13T05:29:21Z,2021-11-13T05:59:29Z,1807,1,2021-11-13T05:59:31Z,0.800000011920929,Chrome,95.0.4638.69,Windows NT 10.0,1366,768,NA,1.7786458333333333,714,96,535,129,96,141,-0.19321452084169444,0.05628551762956986,0.5175087040133647,0.2975755613806577,0.3322469482661872,0.6017279208445759,3,3,2,1,2,1,1,2,1,2,3,1,1,1,3,2,1,1,3,2,0.8335087534664907,0,1,1,4,3,1.8,0,3,3,4,3,4,3,2,4,3,3,4,1,2,2,3,4,5,1,1,4,4,3,4,2,2,0,0,4,4,4,4,3,4,5,5,2,3,4,5,3,2,3,4,4,5,5,5,5,2,1,1,1,3,3,1,3,1,1,3,3,3,2,4,3,2,1,3,1,1.3299506640356134,0.8837151016885368,3.25,0,1.75,0,3.466666666666667,0,2.111111111111111,0,3.8333333333333335,0,2,0,2,0,3,0,2.7567567567567566,0,1,0,0,1.2135713119753146,-0.2989446853297732,0.4573133133227707,5,1,2,2,1,2,2,1,1,1.3451854182690985,1.8571428571428572,0,1,-0.39031545311577004,3,4,3,3,2,2,4,6,6,NA,2,0.816496580927726,2.7142857142857144,0,3.2857142857142856,3,3.8333333333333335,3.2559414990859232,-0.7395711320441822,0,0.09248585503105322,2,2,4,2,3,3,5,2,1,4,2,3,2,4,5,2,3,2,3,4,1.1952286093343936,2.6,0,3.4,0,4,0,4,0,3.8,0,1,1,3,4,3,3,4,2,1,2,3,1,1,4,1,1,1,3,1,2,1.1652874052533586,2.3,0,"White, Caucasian, Anglo, European American",0,24,0,1,NA,1,2,4,Facilities Associate,1,0,145,72,3,5,2,0,0,1,0,0,TRUE,TRUE,TRUE,TRUE,TRUE,5,0.8014235294136931,0.68,0.04385278122656727,5,0.47205937500111755,0.5308290322605641,1,0.96875,0.004809792167820138,0.002655889314569209,5,0.620862500000745,0.6988624999970198,1,1,0.007136965645262484,0.00993452693534001,1.2515,0.6311,0.4783,0,22.2321,0.004,ML,change,50,-32.72813098371556,0.723935415968612,1.0412141549503386,0.5425350377651689,1.3223,4.9259,0.4032,4.414,0.3223,0,-82.7625,0.007,ML,cueing,64,178.00164925007903,4.66024043696113,0.7368691059906762,0.45671109819569333,4.3629568385271575,0.9496162533182813,0.36663308046634996,0.156,0.36,0.593,0.016,1.44,22.6442424288232,1811.564972020895,0.157,0.364,0.6,0.017,1.505,36.68885960514404,1818.8149221969913,338,1.0014814814814814,1,0,0,1,FALSE,FALSE,FALSE
399,2021-11-13T05:36:48Z,2021-11-13T06:03:32Z,1603,1,2021-11-13T06:03:33Z,0.800000011920929,Safari,14.1.2,Macintosh,1440,900,no,1.6,728,151,312,112,90,96,-0.1572433825958225,0.5559461248545944,-0.5560666229297347,0.09040665030191732,0.2493745904451182,-0.15838358339381242,4,4,1,1,3,1,2,2,1,4,4,1,1,1,4,4,1,1,4,3,1.3869694338832115,0,1,1,5,5,1.25,0,5,5,2,4,1,1,5,2,1,1,1,5,1,5,4,2,2,1,1,1,1,1,1,0,2,0,0,5,3,4,5,5,5,5,5,4,2,5,2,1,3,2,5,1,1,1,2,2,4,1,1,1,1,1,1,1,1,1,5,1,2,1,1,1,1,1,1,1,1.6934780387911346,1.8464895909600492,1.25,0,1,0,1.2666666666666666,0,1.4444444444444444,0,1.5833333333333333,0,1,0,1,0,1,0,1.3513513513513513,0,0,0,0,-1.195343742247085,-0.7372407672780129,-0.966292254762549,5,1,3,1,1,1,1,1,1,1.5735915849388864,1.2857142857142858,0,1,-0.7321841937363471,4,4,5,4,2,3,2,6,6,4,3,1.1338934190276817,3.7142857142857144,0,2.2857142857142856,3,3.8333333333333335,3.2559414990859232,-0.7395711320441822,0,-0.465211126919004,2,3,3,2,2,1,5,2,1,3,1,5,2,5,5,1,5,2,4,5,1.7674302033770737,2.4,0,4.8,0,4.2,0,4,0,4.333333333333333,0,2,2,2,3,1,2,2,3,1,2,2,3,2,3,1,3,1,2,1,2,0.7254762501100116,1.8,0,"White, Caucasian, Anglo, European American",0,19,0,1,NA,1,4,4,student,5,0,180,69,4,5,2,0,0,1,0,0,TRUE,TRUE,TRUE,TRUE,TRUE,4,1.0572750000000088,0.8,0.1248585453061265,4,0.4673124999999927,0.5667096774193454,1,1,0.0017731895161293113,0.007447879569892766,4,0.6508437500000018,0.7512812499999991,1,1,0.00877091028225865,0.014374337701611704,1.6265,0.9152,0.5529,0,34.6768,0.003,ML,change,50,-57.61753098371556,0.9652751584483663,1.436164961862577,0.6109261172095897,6.0371,7.7142,0.1754,11.7819,0.2111,0,-90.8656,0.012,ML,cueing,63,194.16060417917458,3.911148745261962,1.0593140267065022,0.4355192612257534,5.599170671053479,0.739955070098266,0.4033002099421488,0.179,0.334,0.556,0.01,1.249,42.95316188130536,1849.2509751336459,0.179,0.335,0.557,0.01,1.261,67.23922913804607,1848.8760965910587,423,1.2533333333333332,1,0,0,1,FALSE,FALSE,FALSE
400,2021-11-13T05:43:40Z,2021-11-13T06:04:13Z,1233,1,2021-11-13T06:04:14Z,1,Chrome,95.0.4638.69,Windows NT 10.0,1920,1080,Not at the moment.,1.7777777777777777,574,67,308,68,58,91,-0.5529259033004139,-0.20717189345271578,-0.5753235794668308,-0.44579523719599906,-0.19261131793391667,-0.2428404171980778,3,2,4,3,2,2,2,2,3,2,2,2,3,1,2,1,2,2,2,1,0.7451598203705946,0,1,2,3,3,2.75,0,4,4,3,4,3,2,3,3,3,2,3,3,2,4,3,2,4,3,1,1,2,2,2,5,2,0,0,4,3,3,3,2,4,2,3,3,3,4,3,3,3,3,4,4,4,3,4,4,2,1,3,1,4,5,1,3,3,3,3,2,2,1,1,1,1,2,2,2,1.067539057664702,0.7037315505489968,2.125,0,1.75,0,2.533333333333333,0,3,0,3.1666666666666665,0,2.8333333333333335,0,2.2857142857142856,0,1,0,2.7837837837837838,0,3,0,0,0.3406202964645538,0.10724026226325957,0.22393027936390666,3,2,2,2,2,2,2,1,1,0.3779644730092272,2.4285714285714284,0,1,-0.048446712495193056,5,5,5,5,2,2,2,8,8,3,2,1.6035674514745464,4,0,2,1,3.8333333333333335,3.2559414990859232,-1.869097951893479,0,-1.1893165316865257,3,2,3,1,2,2,4,3,2,3,2,4,2,2,3,3,5,3,3,3,0.8837151016885368,2.2,0,4,0,3.4,0,3,0,3.466666666666667,0,2,1,1,3,1,3,2,2,3,2,1,1,1,1,3,2,1,3,3,2,0.8522416262267903,2.1,0,"Asian or Asian American (e.g., Chinese, Japanese, and others)",0,27,0,1,NA,1,1,6,Unemployed (looking for work),5,0,155,75,1,5,2,0,0,1,0,0,TRUE,TRUE,TRUE,TRUE,TRUE,4,0.657583333330495,0.84,0.033931699763547714,4,0.4494156249910593,0.5133548387173683,1,0.96875,0.001504668456669911,0.002098261775303195,4,0.530175000000745,0.5458258064485365,1,0.96875,0.00729695161271576,0.008443067006412225,1.3381,1.3508,0.3534,0,8.243,0.003,ML,change,50,-4.749930983715563,1.5467871001800153,1.072046745418647,0.4219362339980013,1.1987,4.8626,0.3949,6.5495,0.3579,0,-103.5884,0.007,ML,cueing,64,219.653449250079,4.943060199519871,0.6947087564943466,0.4474756633760776,5.8338101291478415,0.7101936186937112,0.3904490103019701,0.073,0.332,0.349,0.067,1.049,101.38833720500003,1971.4961940014362,0.071,0.333,0.344,0.064,1.107,144.40156836709994,1970.3557846803283,482,1.4281481481481482,1,0,0,1,FALSE,FALSE,FALSE
401,2021-11-13T05:28:03Z,2021-11-13T06:05:32Z,2249,1,2021-11-13T06:05:33Z,1,Chrome,95.0.4638.69,Windows NT 10.0,1366,768,"I just think the credit card screen resolution adjusting might be off, I did it and it seemed like it filled my screen up too much. Possible I could've made a mistake but the blue box seemed the same to me",1.7786458333333333,733,84,429,238,57,79,-0.1443965475080111,-0.0527313421286173,0.007199355780321893,1.625893873591405,-0.2064233775707615,-0.4455368183283147,2,2,3,3,2,1,1,1,1,2,3,1,2,1,2,3,2,1,2,3,0.7880689256524124,0,1,2,4,4,2.2,0,3,4,2,3,2,2,3,3,1,1,1,2,1,3,2,2,3,1,2,1,3,1,2,2,2,0,0,4,4,3,4,2,5,3,5,2,2,4,1,2,3,4,5,4,4,3,5,3,3,1,1,1,3,1,1,3,1,1,3,2,1,1,1,1,3,2,2,1,1.4014149863491412,0.9411239481143202,1.875,0,2,0,2.3333333333333335,0,2.4444444444444446,0,2.8333333333333335,0,1.5,0,1.5714285714285714,0,1,0,2.189189189189189,0,1,0,0,-0.10829275486474121,-0.22054348261253207,-0.16441811873863665,4,2,3,1,1,1,2,2,1,1.1547005383792515,1.7142857142857142,0,1.5,-0.2912888008837234,4,5,5,3,2,2,2,5,6,2,3,1.3801311186847085,3.5714285714285716,0,2.4285714285714284,3.5,3.8333333333333335,3.2559414990859232,-0.4571894270818581,0,-0.24434927701640521,3,4,3,4,3,2,4,3,2,3,2,3,4,4,3,4,4,2,2,3,0.8451542547285166,3.4,0,3.8,0,2.6,0,3.4,0,3.2666666666666666,0,2,3,4,2,3,4,3,1,2,3,3,3,1,4,1,2,1,4,4,3,1.0894228312566052,2.85,0,"White, Caucasian, Anglo, European American",0,20,0,1,NA,1,3,4,Social Media Marketing Consultant,3,0,145,70,2,5,2,0,0,0,0,0,TRUE,TRUE,TRUE,TRUE,TRUE,6,0.7142608695522599,0.9387755102040817,0.04606242682832435,6,0.4968593749925494,0.5627468749843538,1,1,0.006203027653393122,0.009285269022583628,6,0.5375687500014901,0.6206133333365123,1,0.967741935483871,0.004393468669031301,0.006189920367911053,1.6554,1.9471,0.3393,0,-0.6457,0.004,ML,change,49,12.966860894331878,2.02169250736758,1.350368118728264,0.4211854102036878,3.2625,5.9128,0.2869,6.2661,0.2365,0,-71.5719,0.01,ML,cueing,64,155.62044925007902,3.7013816842450202,1.1193481461333317,0.4162652893129417,4.094129400838693,1.011969657222559,0.37713360310640337,0.071,0.405,0.53,0.016,1.565,49.511398831530684,1895.1224464495035,0.072,0.404,0.543,0.016,1.706,62.843193658501264,1887.8490519328175,346,1.0251851851851852,1,0,0,1,FALSE,FALSE,FALSE
402,2021-11-13T05:47:34Z,2021-11-13T06:06:17Z,1122,1,2021-11-13T06:06:18Z,1,Chrome,95.0.4638.69,Macintosh,1440,900,NA,1.6,589,50,226,59,50,106,-0.5143853980369797,-0.36161244477681426,-0.9700911884772978,-0.555472896002391,-0.3031077950286754,0.010530084214718316,3,3,2,2,3,1,3,1,1,3,2,2,1,2,2,2,3,1,2,2,0.7591546545162482,0,1,2,4,2,2.25,0,5,4,3,4,1,2,4,3,1,1,3,5,1,3,1,1,2,1,1,1,1,2,1,0,2,0,0,5,5,5,5,3,5,4,5,3,1,5,1,1,5,1,5,2,1,1,4,3,4,1,1,1,2,1,1,1,1,1,5,2,2,1,1,1,1,1,1,2,1.7394037844978736,1.486446705914413,1.25,0,1.25,0,2.066666666666667,0,1.5555555555555556,0,1.5,0,1.1666666666666667,0,1.1428571428571428,0,1,0,1.4054054054054055,0,0,0,0,-0.8283152190386573,-0.6588395645607719,-0.7435773917997146,5,1,3,2,2,1,1,1,1,1.4638501094227998,1.5714285714285714,0,1,-0.5612498234260587,5,5,5,4,4,4,2,1,1,2,3,1.0690449676496976,4.428571428571429,0,1.5714285714285714,8,3.8333333333333335,3.2559414990859232,2.0842459175790595,0,0.5483424107854333,4,2,4,4,3,3,4,2,1,3,1,3,1,2,5,3,5,1,3,5,1.4735767952260144,3.4,0,4.2,0,3.6,0,3.4,0,3.7333333333333334,0,1,1,1,2,1,1,3,3,2,1,1,3,1,3,1,3,1,2,4,2,0.9880869341680844,1.75,0,"Hispanic of Latino (e.g., Mexican American, Central American, and others)",0,20,0,1,NA,1,3,4,Student,2,0,132,68,2,5,2,0,0,0,0,0,TRUE,TRUE,TRUE,TRUE,TRUE,2,0.9555676470521618,0.68,0.06973914989384754,2,0.443868965514775,0.5009233333309492,0.9354838709677419,0.967741935483871,0.004259775978709091,0.00417966184913946,2,0.6453000000026077,0.8535592592623499,1,0.84375,0.02115808128866165,0.10745541128122599,1.3682,0.5583,0.5597,0,33.6906,0.006,ML,change,50,-55.64513098371557,0.6446588465199999,1.169256896799593,0.6290907165639407,1.1014,3.8371,0.371,3.2815,0.3105,0,-65.245,0.006,ML,cueing,62,142.87140315513528,4.141610982445278,0.8212257008392495,0.4081764045614932,3.621783915540249,0.7383512412080593,0.35508949546536994,0.072,0.384,0.222,0.009,1.98,164.3450963912897,2074.1016684419574,0.072,0.384,0.222,0.011,2.043,172.50519112464522,2074.4504385040996,434,1.285925925925926,1,0,0,1,FALSE,FALSE,FALSE
403,2021-11-13T05:50:30Z,2021-11-13T06:08:38Z,1087,1,2021-11-13T06:08:39Z,0.8999999761581421,Chrome,95.0.4638.69,Windows NT 10.0,1920,1080,No feedback.,1.7777777777777777,601,39,219,52,63,55,-0.4835529938262323,-0.46154456622181916,-1.0037908624172158,-0.6407777417406959,-0.12355101974969247,-0.8509296205887885,3,3,2,2,3,1,1,3,1,3,3,1,1,1,3,3,1,1,3,3,0.9679060415469871,0,1,1,2,2,1.6,0,5,5,1,5,1,1,5,1,1,1,1,5,1,5,1,1,1,1,1,1,1,1,1,0,2,0,0,5,2,5,4,2,5,5,5,3,1,5,1,1,3,1,4,1,1,1,1,1,5,1,1,1,1,1,1,1,1,1,5,1,1,1,1,1,1,1,1,1,1.6970208837488947,2.02837021134844,1,0,1,0,1.2666666666666666,0,2,0,1.25,0,0.8333333333333334,0,0.8571428571428571,0,1,0,1.3243243243243243,0,0,0,0,-1.3143957157561477,-0.7372407672780129,-1.0258182415170802,5,1,3,1,1,1,1,1,1,1.5735915849388864,1.2857142857142858,0,1,-0.7321841937363471,5,5,5,5,3,3,1,4,6,NA,3,1.5735915849388864,4.428571428571429,0,1.5714285714285714,4,3.8333333333333335,3.2559414990859232,-0.1748077221195339,0,-0.5811844090638635,3,3,3,1,3,3,3,3,3,1,1,3,1,4,3,4,4,1,3,4,1.162919151265879,2.6,0,4,0,2.8,0,3,0,3.2666666666666666,0,1,1,1,4,1,1,1,3,1,1,1,4,1,1,1,4,1,1,1,1,1.145931016569864,1.05,0,"Asian or Asian American (e.g., Chinese, Japanese, and others)",0,24,0,1,NA,1,3,6,Engineer,4,0,150,68,1,5,2,0,0,1,0,0,TRUE,TRUE,TRUE,TRUE,TRUE,2,0.7124142857141793,0.7,0.039309959873567404,2,0.595386206896526,0.8112888888887785,0.90625,0.84375,0.03678772603827246,0.035974257419409954,2,0.5896406250006985,0.6788965517245233,1,0.90625,0.00668808313502301,0.014164024475889703,1.1518,0.7562,0.417,0,13.9876,0.004,ML,change,50,-16.23913098371556,0.8304651490722847,1.0202690159047885,0.46670403115514475,1.4694,1.2929,0.4071,1.5872,0.1961,0,14.372,0.008,ML,cueing,64,-16.267350749920986,1.5446015937510393,1.091801899203559,0.5683091429338382,1.9048793691547161,1.190985412543517,0.34138701320453635,0.062,0.416,0.323,0.012,1.421,231.6998443750425,2127.1463824721886,0.063,0.418,0.381,0.01,1.515,251.79157513115146,2109.1621968960144,416,1.2325925925925925,1,0,2,3,FALSE,FALSE,FALSE
404,2021-11-13T05:40:44Z,2021-11-13T06:09:28Z,1724,1,2021-11-13T06:09:30Z,1,Chrome,95.0.4638.69,Windows NT 10.0,1920,1080,NA,1.7777777777777777,752,62,405,154,142,66,-0.09557857417432772,-0.2525955850186271,-0.10834238344225383,0.6022357247317466,0.9676016915610499,-0.6651245862194046,2,2,3,3,2,2,4,2,2,2,2,2,2,3,2,2,3,2,2,2,0.5712405705774795,0,0,4,4,4,2.8,0,4,4,2,4,2,2,4,2,2,2,2,4,2,4,4,3,3,4,2,3,3,3,3,0,2,0,0,4,4,3,3,2,4,4,4,3,2,4,4,2,3,2,4,3,4,4,4,4,3,2,1,2,2,1,1,2,1,1,4,1,2,1,1,3,2,2,1,2,1.179784680309035,1.0327955589886444,3,0,1.75,0,2,0,2.5555555555555554,0,3,0,1.6666666666666667,0,1.2857142857142858,0,1.6666666666666667,0,2.2972972972972974,0,0,0,0,0.27838418348379973,-0.5020371591262895,-0.11182648782124491,5,2,4,1,1,2,2,1,1,1.5118578920369088,1.5714285714285714,0,1,-0.5612498234260587,4,4,4,4,4,4,2,6,6,6,4,0.7559289460184544,4,0,2,3,3.8333333333333335,3.2559414990859232,-0.7395711320441822,0,-0.6245531217618774,2,2,2,2,2,2,4,3,2,3,2,3,3,3,3,3,4,2,3,3,0.6399404734221844,2,0,3.8,0,3.2,0,3.2,0,3.4,0,2,2,3,1,2,3,3,2,3,4,3,2,2,3,2,2,1,3,3,3,0.7591546545162482,2.75,0,"Asian or Asian American (e.g., Chinese, Japanese, and others)",0,24,0,1,NA,1,3,4,Unemployed,5,0,140,71,1,5,2,0,0,0,0,0,TRUE,TRUE,TRUE,TRUE,TRUE,6,0.6824461538462112,0.78,0.0254157172897447,6,0.3969677419354839,0.4650322580645762,0.96875,0.96875,0.003397397903241063,0.0031957722479658583,6,0.751362500000163,0.852635483871124,1,0.96875,0.052318052742021635,0.04079592587698166,1.1844,1.1144,0.3892,0,7.9273,0.004,ML,change,50,-4.118530983715562,1.3298855549245427,0.9517107458190939,0.4820687545710787,1.346,3.9569,0.304,3.9301,0.2324,0,-67.6205,0.007,ML,cueing,64,147.71764925007903,4.449557891555023,0.7717591923014722,0.38372932186097797,4.382018565661721,0.7836541888239548,0.3131392744137454,0.079,0.468,0.265,0.031,1.49,50.25184056972174,1880.3306129037296,0.086,0.426,0.272,0.018,2.086,20.331419335338115,1843.4816543826703,312,0.9244444444444444,1,0,0,1,FALSE,FALSE,FALSE
406,2021-11-13T05:43:51Z,2021-11-13T06:17:20Z,2008,1,2021-11-13T06:17:21Z,0.8999999761581421,Chrome,95.0.4638.69,Windows NT 10.0,1920,1080,Nope.,1.7777777777777777,1003,79,477,101,71,91,0.5493325472338051,-0.09815503369452862,0.23828283422547336,-0.04364382157256178,-0.013054542654933752,-0.2428404171980778,2,2,2,1,2,2,1,2,1,2,2,1,1,1,2,2,2,1,2,2,0.4893604849295929,0,1,2,1,1,2.15,0,2,3,3,3,3,3,3,3,4,2,3,2,2,2,2,3,3,1,1,2,2,2,2,4,2,0,0,2,2,3,3,2,3,2,2,2,4,2,3,1,2,3,2,4,3,4,4,3,3,1,2,1,3,3,1,2,2,2,3,3,3,2,3,3,2,1,2,2,0.837377573858532,0.6172133998483676,2,0,1.75,0,3.2,0,3.6666666666666665,0,3.4166666666666665,0,2,0,2.142857142857143,0,2.6666666666666665,0,3,0,2,0,0,0.6663193947230869,-0.0958522115332568,0.285233591594915,3,3,2,2,1,3,3,8,8,0.7867957924694432,2.7142857142857144,0,8,2.7054013812357707,2,3,4,3,2,2,3,3,4,2,2,0.7559289460184544,2.7142857142857144,0,3.2857142857142856,5.5,3.8333333333333335,3.2559414990859232,0.6723373927674386,0,0.7984401174368636,2,2,2,3,2,3,2,3,2,3,3,2,3,3,3,4,3,3,2,3,0.560611910581388,2.2,0,2.8,0,2.4,0,3.2,0,2.8,0,1,2,1,2,2,1,2,2,2,1,3,2,1,1,1,2,1,1,1,1,0.6069769786668839,1.7,0,"Asian or Asian American (e.g., Chinese, Japanese, and others)",0,28,0,1,NA,1,2,4,Production Associate,2,0,172,63,1,5,2,0,0,1,0,0,TRUE,TRUE,TRUE,TRUE,TRUE,5,1.1143588235290611,0.85,0.1330453753595087,5,0.5862968749988359,0.8273551724144611,1,1,0.01706993515127976,0.20499692898966593,NA,NA,NA,NA,NA,NA,NA,1.7527,1.0678,0.5267,0,27.2001,0.003,ML,change,40,-43.33356163765819,1.1384429116575727,1.5236609913645363,0.6459283545816723,1.8785,2.182,0.3969,4.0483,0.3543,0,-29.693,0.008,ML,cueing,61,71.71862159251994,1.7075587528447647,2.4263497343732032,0.13908418283413104,3.178736483919048,1.3033904343286369,0.3876865954674007,NA,NA,NA,NA,NA,NA,NA,NA,NA,NA,NA,NA,NA,NA,104,0.3081481481481481,1,0,0,1,FALSE,FALSE,FALSE
407,2021-11-13T05:35:51Z,2021-11-13T06:17:27Z,2496,1,2021-11-13T06:17:29Z,1,Firefox,94.0,Windows NT 10.0,1920,1080,NA,1.7777777777777777,978,81,690,163,118,111,0.485098371794748,-0.07998555706816408,1.263715769825833,0.7119133835381386,0.6361122602767737,0.0949869180189837,2,2,1,1,2,1,2,1,1,3,1,1,2,2,3,2,1,1,2,2,0.6708203932499369,0,1,4,4,5,2.15,0,4,4,2,4,3,1,5,2,2,2,2,4,3,4,4,2,4,5,1,2,2,2,1,0,2,0,0,4,2,3,4,3,4,2,3,3,2,3,4,2,3,3,4,3,2,3,3,3,2,1,3,1,4,3,1,1,1,1,4,2,3,1,3,2,2,2,1,1,1.0126823418651703,1.162919151265879,2.375,0,1.5,0,2,0,2.888888888888889,0,2.75,0,2.5,0,1.4285714285714286,0,2,0,2.4864864864864864,0,0,0,0,0.09109510320734764,-0.5804383618435307,-0.24467162931809153,5,2,3,2,1,1,2,4,3,1.3801311186847085,1.7142857142857142,0,3.5,0.4466865486650409,5,5,5,4,2,2,3,4,4,3,3,1.3801311186847085,3.7142857142857144,0,2.2857142857142856,5,3.8333333333333335,3.2559414990859232,0.38995568780511447,0,0.09955228300564435,3,2,2,3,2,3,4,3,3,2,4,4,4,3,4,3,4,2,2,3,0.7745966692414834,2.4,0,3.4,0,2.6,0,3.2,0,3.066666666666667,0,1,2,3,1,2,4,3,1,4,3,2,2,1,3,2,1,2,3,2,3,0.9665456669582609,2.75,0,"Black or African American & White, Caucasian, Anglo, European American & Native American/Alaskan Native/indigenous",1,22,0,1,NA,1,2,4,unemployed,2,0,175,71,1,5,2,0,1,0,0,1,TRUE,TRUE,TRUE,TRUE,TRUE,3,0.9356486486486486,0.74,0.04548373918367347,3,0.4035,0.49648387096774194,1,0.96875,0.002335741935483871,0.005007354838709677,3,0.6236875,0.6479333333333334,1,1,0.007072737903225805,0.003601374712643678,1.3642,0.8199,0.5492,0,24.3483,0.004,ML,change,50,-36.96053098371556,0.9716265494098776,1.0765129419507546,0.6697408199411072,1.7127,3.7058,0.2746,6.7862,0.2773,0,-78.7984,0.008,ML,cueing,64,170.07344925007902,3.977028697770772,0.8634554752923924,0.3947132314271777,5.2264437406164195,0.7927254041201793,0.33003200021331813,0.116,0.425,0.616,0.053,1.882,37.58151182673512,1827.768061961457,0.116,0.426,0.627,0.047,2.014,47.76345440677359,1830.7070383460114,366,1.0844444444444443,1,0,2,3,FALSE,FALSE,FALSE
408,2021-11-13T05:51:41Z,2021-11-13T06:21:12Z,1771,1,2021-11-13T06:21:13Z,1,Firefox,94.0,Windows NT 10.0,1366,768,NA,1.7786458333333333,886,67,447,103,70,95,0.24871660617901806,-0.20717189345271578,0.09385566019725369,-0.019271008504474677,-0.026866602291778594,-0.1752749501546655,4,3,2,2,2,2,2,1,1,2,2,3,2,3,2,2,3,1,2,2,0.7451598203705946,0,1,3,3,4,2.45,0,2,2,3,3,2,2,1,3,2,4,2,1,1,2,4,3,4,1,1,2,3,3,3,1,2,1,3,5,5,3,5,1,5,5,5,4,2,5,5,2,3,2,4,4,4,5,5,3,1,5,1,1,2,1,3,1,2,1,4,2,2,2,3,3,2,1,2,2,1.5304712811230214,0.9611501047232549,2.5,0,1.75,0,3.066666666666667,0,1.7777777777777777,0,3.1666666666666665,0,2.3333333333333335,0,1.7142857142857142,0,2.6666666666666665,0,2.4324324324324325,0,1,1,3,0.5799825163734255,0.43703746296079277,0.5085099896671091,1,5,1,4,5,5,5,8,8,1.889822365046136,4.857142857142857,0,8,3.9874091585629348,1,1,3,3,1,3,4,4,4,1,1,1.2535663410560174,2,0,4,5,3.8333333333333335,3.2559414990859232,0.38995568780511447,0,1.0556042520628854,3,2,3,3,3,2,4,3,3,3,2,3,3,3,4,1,4,2,3,4,0.8837151016885368,2.8,0,3.8,0,3.6,0,3,0,3.466666666666667,0,2,1,3,2,2,3,2,1,4,2,1,2,1,4,2,2,1,3,4,2,1.0052493799000692,2.5,0,"Asian or Asian American (e.g., Chinese, Japanese, and others) & Black or African American",1,26,0,1,NA,1,1,6,Sofware Engineer,2,0,174,75,3,5,2,0,0,1,0,0,TRUE,TRUE,TRUE,TRUE,TRUE,4,1.0241777777777779,0.9,0.23731179959183674,4,0.44315625,0.5109032258064516,1,0.96875,0.0019271038306451615,0.0035013941532258067,4,0.58715625,0.6489354838709678,1,0.96875,0.007011039314516129,0.007971757056451612,1.7476,1.2262,0.5016,0,30.2005,0.004,ML,change,50,-48.664930983715564,1.1697977930064496,1.8782943432379218,0.38191486551476395,1.2894,4.3106,0.3671,6.0733,0.337,0,-92.1749,0.02,ML,cueing,64,196.826449250079,4.34911174329309,0.7895835764120829,0.4258014111625915,5.48385819100857,0.7555145633022912,0.3764236041413654,0.063,0.428,0.365,0.027,1.635,77.36984404579057,1921.2464453471855,0.066,0.425,0.379,0.022,1.74,94.97259327362211,1920.9935126926375,290,0.8592592592592593,1,0,2,3,FALSE,FALSE,FALSE
411,2021-11-13T06:00:24Z,2021-11-13T06:22:57Z,1353,1,2021-11-13T06:23:01Z,1,Chrome,95.0.4638.69,Windows NT 10.0,1536,864,Thanks!,1.7777777777777777,730,38,366,70,25,64,-0.15210464856069794,-0.4706293045350014,-0.2960977096789394,-0.421422424127912,-0.6484092859497964,-0.6989073197411108,3,3,1,1,3,1,2,3,1,3,2,1,1,2,3,3,1,1,2,3,0.9176629354822471,0,1,3,3,3,1.7,0,4,4,2,4,2,2,4,2,2,2,2,4,2,4,4,2,2,1,1,2,2,2,1,1,2,1,3,4,3,3,4,3,4,4,4,4,2,4,2,2,3,2,3,2,2,2,2,3,4,1,1,1,3,3,1,3,1,1,4,2,2,2,2,2,2,1,2,1,1.0419143849595252,1.0327955589886444,1.625,0,1.5,0,2,0,2.3333333333333335,0,2.25,0,1.6666666666666667,0,1.5714285714285714,0,2,0,2.081081081081081,0,1,1,3,-0.40543873752557247,0.35863626024355166,-0.023401238641010402,4,2,3,2,2,2,2,1,1,0.7867957924694432,2.142857142857143,0,1,-0.21938108280548152,4,4,4,4,2,2,2,6,3,3,3,1.0690449676496976,3.4285714285714284,0,2.5714285714285716,4.5,3.8333333333333335,3.2559414990859232,0.10757398284279028,0,0.11770342536735592,2,1,1,2,2,2,4,2,1,3,1,4,2,4,5,2,4,2,4,2,1.2649110640673518,1.6,0,4.2,0,3.8,0,4.4,0,4.133333333333334,0,2,1,2,2,1,2,3,2,2,1,1,3,1,2,1,3,1,2,1,2,0.7163503994113789,1.75,0,"White, Caucasian, Anglo, European American",0,30,0,1,NA,1,2,3,online English teacher,2,0,156,70,3,5,2,0,0,1,0,0,TRUE,TRUE,TRUE,TRUE,TRUE,4,0.8880444444815317,0.72,0.06306818393777351,4,0.4009281250089407,0.46428709674650626,1,0.96875,0.0019218633763511143,0.0016144851220517968,4,0.5431656249985098,0.5956124999970198,1,1,0.0034304281329476925,0.0025971462919820508,1.4035,0.6937,0.4728,0,31.9525,0.003,ML,change,50,-52.16893098371556,0.815931557056391,1.1575255309993817,0.5759403045968379,1.2415,5.128,0.3502,6.3702,0.3035,0,-103.0728,0.008,ML,cueing,64,218.62224925007902,5.277792419820449,0.6506484020836065,0.40649940556499775,5.4875926616436415,0.755000413086525,0.334286275360565,0.269,0.249,0.924,0.02,1.368,71.90674175581833,1878.4200178732033,0.265,0.251,0.935,0.019,1.422,83.56016258548993,1873.507243250979,370,1.0962962962962963,1,0,2,3,FALSE,FALSE,FALSE
412,2021-11-13T05:58:29Z,2021-11-13T06:24:39Z,1570,1,2021-11-13T06:24:40Z,1,Chrome,95.0.4638.69,Windows NT 10.0,1920,1080,Thank you,1.7777777777777777,708,91,394,98,85,91,-0.20863072294706814,0.010861826063658545,-0.1612990139192677,-0.08020304117469244,0.18031429226089402,-0.2428404171980778,3,3,2,3,1,1,1,2,1,2,4,1,1,1,2,2,2,1,3,2,0.9119095061289915,0,1,1,3,1,2,0,5,5,2,5,1,1,5,2,1,1,1,5,2,5,5,1,1,1,1,1,1,1,1,2,2,0,0,5,5,5,5,5,5,5,5,5,2,5,1,1,5,2,5,1,1,1,2,2,5,1,1,1,3,1,1,2,2,2,5,1,1,1,1,1,1,1,1,1,1.8318995212226723,1.9073791542572855,1,0,1,0,1.2,0,1,0,1.3333333333333333,0,1.1666666666666667,0,1.2857142857142858,0,1,0,1.2432432432432432,0,1,0,0,-1.3778901016276477,-0.5341482934814965,-0.9560191975545721,4,2,3,1,1,2,2,1,1,1.0690449676496976,1.8571428571428572,0,1,-0.39031545311577004,4,5,5,5,3,5,3,5,3,3,3,0.9511897312113419,4.285714285714286,0,1.7142857142857142,5,3.8333333333333335,3.2559414990859232,0.38995568780511447,0,-0.21913170668010262,1,1,1,3,2,1,4,1,1,3,2,3,3,5,4,3,4,1,4,1,1.3972762620115438,1.6,0,4.2,0,3.4,0,4.8,0,4.133333333333334,0,1,1,2,4,3,2,3,4,1,1,3,4,2,2,1,3,1,2,1,3,1.105012502906165,1.7,0,"White, Caucasian, Anglo, European American",0,28,0,1,NA,1,4,5,Pharmacy Technician,4,0,160,71,1,5,2,0,0,1,0,0,TRUE,TRUE,TRUE,TRUE,TRUE,6,0.8950650000000373,0.8,0.14038220096331552,6,0.5028870967742536,0.5890031250000466,0.96875,1,0.009335489667358142,0.006400432570549223,6,0.6751250000000583,0.7719312500000524,1,1,0.009164055483863232,0.010069130604860923,1.4946,0.9407,0.5099,0,30.5164,0.003,ML,change,50,-49.29673098371556,0.9374059063779766,1.478862413483573,0.42178152586521384,1.9815,4.2352,0.3551,3.7683,0.2505,0,-52.668,0.009,ML,cueing,64,117.812649250079,4.06218934528574,1.0199265406472822,0.4673871991694704,3.403506161756266,1.0089557771545656,0.36392803571671356,0.258,0.293,0.68,0.011,1.367,40.36436531887021,1821.6429417404497,0.258,0.294,0.68,0.012,1.459,53.13006871497659,1835.0002991626743,310,0.9185185185185185,1,0,0,1,FALSE,FALSE,FALSE
413,2021-11-13T06:00:49Z,2021-11-13T06:25:10Z,1460,1,2021-11-13T06:25:11Z,1,Chrome,95.0.4638.69,Windows NT 10.0,1920,1080,"I accidently clicked 'yes' for the question asking if I had color blindness. I am not color blind, I just couldn't go back and change that answer.",1.7777777777777777,684,49,383,88,49,71,-0.2702955313685629,-0.3706971830899965,-0.21425564439628159,-0.202067106515128,-0.31691985466552025,-0.5806677524151392,2,3,1,1,2,1,2,3,1,3,3,1,2,2,2,2,2,1,2,2,0.7181848464596079,0,1,1,5,5,2,0,3,3,4,2,2,1,4,4,4,2,2,2,1,2,2,2,5,5,1,1,2,3,2,1,2,0,1,4,1,2,3,2,4,5,3,2,2,2,4,3,1,1,1,4,4,5,5,2,1,2,2,1,4,4,2,1,1,1,3,4,3,2,4,3,1,1,1,1,1.3169032744413063,1.0600988273786194,2.625,0,1,0,2.933333333333333,0,3.111111111111111,0,3.6666666666666665,0,2.8333333333333335,0,2,0,3,0,3.081081081081081,0,1,0,1,0.8551571185573803,-0.35769864658231576,0.24872923598753227,3,2,1,2,2,3,3,4,2,0.7559289460184544,2.857142857142857,0,3,0.9459301925190042,3,3,3,2,1,1,5,1,1,1,1,1.3972762620115438,2,0,4,8,3.8333333333333335,3.2559414990859232,2.0842459175790595,0,1.902749366949858,2,3,2,2,2,2,5,3,2,5,1,5,1,5,3,1,4,3,3,2,1.5118578920369088,2.2,0,4.2,0,4.6,0,3.8,0,4.2,0,3,1,2,3,3,4,3,3,2,1,1,2,2,4,2,2,1,3,2,1,0.9665456669582609,2.25,0,"Asian or Asian American (e.g., Chinese, Japanese, and others)",0,20,0,1,NA,1,2,3,Student,1,1,154,69,4,5,2,0,0,1,0,0,TRUE,TRUE,TRUE,TRUE,TRUE,6,0.6738153846156902,0.78,0.009187965555135062,6,0.48978666666671633,0.550767741935628,1,0.96875,0.0015078005057652406,0.005203675554450656,6,0.6447218750002794,0.7088931034484814,1,0.90625,0.0035990901512115633,0.005903986411279873,0.9629,1.3626,0.4822,0,-12.2222,0.004,ML,change,50,36.18046901628444,1.7150825250423036,0.7379623749009148,0.5533375289118316,1.3265,3.8006,0.3838,7.0914,0.3963,0,-88.7918,0.01,ML,cueing,62,189.96500315513526,3.938975360305775,0.8717970767449971,0.4470212489155513,5.830778224404839,0.710562907203426,0.43075871277608613,0.055,0.535,0.486,0.019,1.567,52.72671771501542,1916.4564625930302,0.056,0.539,0.552,0.021,1.711,56.052386268976434,1914.128852004393,306,0.9066666666666667,1,0,0,1,FALSE,FALSE,FALSE
414,2021-11-13T05:55:54Z,2021-11-13T06:25:16Z,1761,1,2021-11-13T06:25:18Z,1,Chrome,95.0.4638.69,Windows NT 10.0,1920,1080,N/A,1.7777777777777777,657,73,564,108,66,217,-0.3396684408427445,-0.15266346357362218,0.6571216389073103,0.04166102416574309,-0.08211484083915795,1.8854717946694095,2,2,2,3,1,1,4,1,1,2,1,2,2,2,2,1,2,1,1,1,0.8013147091860318,0,1,1,3,4,2.8,0,1,3,4,4,2,2,1,4,3,3,3,1,1,2,1,4,5,2,3,4,5,4,4,3,5,2,2,5,1,3,3,1,1,2,2,1,3,4,5,4,3,2,2,3,3,4,5,5,2,1,1,1,4,2,3,3,1,1,4,2,1,1,3,2,3,4,2,3,1.34566370643293,1.1751393027860062,3.875,0,3,0,3.4,0,3.888888888888889,0,3.5833333333333335,0,2,0,1.7142857142857142,0,2,0,2.972972972972973,0,2,2,2,1.5464328866888646,1.0623195110373578,1.3043761988631113,3,5,2,4,3,4,4,8,1,0.9759000729485332,3.857142857142857,0,4.5,2.0976820007665875,3,5,4,4,2,2,3,1,1,2,2,1.1126972805283737,3.2857142857142856,0,2.7142857142857144,8,3.8333333333333335,3.2559414990859232,2.0842459175790595,0,1.1857103901569273,1,1,3,3,3,1,5,1,1,4,3,5,3,5,3,2,4,2,5,3,1.505545305418162,2.2,0,4.2,0,4.2,0,4.2,0,4.2,0,3,1,1,2,1,4,1,2,4,1,3,1,4,4,2,2,1,1,1,1,1.2139539573337679,2.3,0,"Asian or Asian American (e.g., Chinese, Japanese, and others) & White, Caucasian, Anglo, European American",1,25,0,1,NA,1,3,3,"Self employed, small business owner",5,0,250,75,2,5,2,0,0,1,0,0,TRUE,TRUE,TRUE,TRUE,TRUE,5,1.099078787878833,0.66,0.1816251681795729,5,0.4906875,0.5499838709673814,1,0.96875,0.0036766604838679635,0.005559312217738711,5,0.6733093749993714,0.7148187499997439,1,1,0.005133095715753153,0.003255679637073336,1.8127,0.37,0.5117,0,49.4664,0.003,ML,change,50,-87.19673098371557,0.44928015870759197,1.476348787176156,0.5733137360063267,1.3093,4.0893,0.3973,4.56,0.3471,0,-76.7959,0.013,ML,cueing,64,166.06844925007903,3.874409764183484,0.8863252504240074,0.4427507731735008,4.666047037466287,0.8879324818468394,0.3985126263990456,0.16,0.457,0.758,0.012,0.96,33.62083139828543,1824.578100590769,0.15,0.467,0.745,0.014,1.058,44.775551442334624,1827.7248720232649,318,0.9422222222222223,1,0,0,1,FALSE,FALSE,FALSE
415,2021-11-13T05:35:59Z,2021-11-13T06:25:22Z,2962,1,2021-11-13T06:25:23Z,0.8999999761581421,Chrome,95.0.4638.69,Windows NT 10.0,1366,768,Nothing comes to mind.,1.7786458333333333,2006,111,382,84,102,104,3.1264076658487734,0.19255659232730382,-0.21906988353055556,-0.2508127326513022,0.4151193060872563,-0.02325264930698783,2,2,1,3,1,1,1,2,1,2,2,1,1,3,2,4,1,1,2,1,0.8645047258706176,0,1,3,2,2,2.2,0,1,1,5,2,5,4,1,5,5,4,5,1,1,1,1,5,5,5,5,5,5,5,2,7,3,6,4,1,1,1,1,1,1,1,1,1,5,1,5,5,1,5,2,5,5,2,5,5,1,5,4,3,5,3,5,5,5,5,2,4,5,2,5,5,1,1,1,5,1.8277967175922056,1.8973665961010275,4.625,0,2,0,4.533333333333333,0,5,0,4.666666666666667,0,4,0,4.571428571428571,0,4,0,4.621621621621622,0,4,6,4,3.0642971538182313,2.334331771931882,2.6993144628750567,1,5,1,5,5,4,5,8,4,1.889822365046136,4.857142857142857,0,6,3.24943380901417,2,2,1,2,1,1,5,5,4,2,1,1.4142135623730951,1.4285714285714286,0,4.571428571428571,4.5,3.8333333333333335,3.2559414990859232,0.10757398284279028,0,1.2330973892674701,2,2,3,1,2,2,5,2,2,3,1,5,1,4,5,4,5,1,3,3,1.533747356112131,2,0,4.8,0,3.6,0,4,0,4.133333333333334,0,3,2,3,2,1,2,3,1,3,1,4,2,3,2,2,3,2,3,3,2,0.812727700887249,2.55,0,"Black or African American & White, Caucasian, Anglo, European American",1,21,0,1,NA,1,1,3,looking for work,1,0,320,72,3,5,2,0,0,1,0,0,TRUE,TRUE,TRUE,TRUE,TRUE,6,1.0050303030284968,0.66,0.35278047198628726,6,0.581631034488308,0.6354387096791498,0.90625,0.96875,0.04088085032164549,0.01925458410334233,6,0.6779312500003725,0.7731965517257822,1,0.90625,0.010603903507950896,0.024875241936004457,1.8387,0.3747,0.2622,0,62.4101,0.004,ML,change,50,-113.08413098371557,0.38057049283668143,1.7428944962764397,0.2722800644967299,1.2592,2.9144,0.4287,1.8276,0.2817,0,-27.0881,0.009,ML,cueing,64,66.65284925007902,2.840058470225795,1.2091255305078743,0.4358732435567199,1.855296109829508,1.2228147999118288,0.31387403880860976,0.078,0.471,0.406,0.014,1.783,70.33241407412501,1936.0425687726565,0.076,0.471,0.393,0.015,1.895,84.4799921472717,1944.198132561359,250,0.7407407407407408,1,1,4,5,FALSE,FALSE,FALSE
416,2021-11-13T05:49:27Z,2021-11-13T06:28:23Z,2336,1,2021-11-13T06:28:24Z,1,Chrome,95.0.4638.69,Windows NT 10.0,1536,864,n/a,1.7777777777777777,981,249,436,103,173,219,0.49280647284743484,1.4462504795464564,0.040899029720239816,-0.019271008504474677,1.39577554030324,1.9192545281911157,4,3,1,1,3,1,2,2,1,3,2,2,1,1,3,3,2,3,3,3,0.9514531821875089,0,1,4,4,2,1.8,0,2,4,3,3,2,3,2,4,2,2,1,3,1,3,3,2,5,1,5,3,4,4,3,3,4,0,0,5,2,5,4,2,4,1,2,2,5,4,3,2,2,2,4,3,5,5,5,5,3,1,1,1,3,1,4,5,5,5,4,2,2,1,1,2,2,3,4,4,1.5265419517099195,0.9154754164341269,3.375,0,3.25,0,2.6666666666666665,0,3,0,3.5833333333333335,0,1.5,0,3.4285714285714284,0,1.3333333333333333,0,2.945945945945946,0,2,0,0,1.0047948023338122,0.3745550047701899,0.6896749035520011,5,1,4,1,1,1,2,1,2,1.6761634196950514,1.2857142857142858,0,1.5,-0.5476903563491562,5,5,5,3,3,3,2,5,5,4,3,1.2535663410560174,4,0,2,4,3.8333333333333335,3.2559414990859232,-0.1748077221195339,0,-0.34217141679955326,3,3,2,2,3,2,2,2,2,3,3,4,4,3,4,4,4,4,4,3,0.8618916073713346,2.6,0,3.4,0,2.6,0,3.6,0,3.2,0,3,2,2,1,2,2,2,1,4,3,2,2,2,3,1,2,1,2,3,3,0.812727700887249,2.55,0,"Asian or Asian American (e.g., Chinese, Japanese, and others) & Black or African American & Filipino",1,22,0,1,NA,1,3,6,Unemployed,4,0,154,71,1,5,2,0,0,2,0,0,TRUE,TRUE,TRUE,TRUE,TRUE,1,0.9641349999999628,0.8163265306122449,0.2396209279680326,1,0.5557225806465553,0.6171225806462669,0.96875,0.96875,0.03558701982845939,0.041448591441573646,1,0.5955312499993015,0.7051241379318566,1,0.90625,0.020615922863058283,0.012352139959642681,1.897,0.8162,0.3032,0,49.3552,0.002,ML,change,49,-87.03493910566813,0.8715101241372022,1.7115749266303246,0.3428954487556415,1.2909,2.7065,0.3924,2.5532,0.3126,0,-35.3775,0.008,ML,cueing,64,83.23164925007902,2.3446788867897275,1.4645874212595786,0.32432114093381237,2.435779167546468,1.4098105650292434,0.28441362490771344,0.07,0.397,0.387,0.009,1.624,69.82232319998606,1934.2049071078313,0.074,0.388,0.42,0.01,1.778,79.8545929588522,1933.181212653243,104,0.3081481481481481,1,0,4,5,FALSE,FALSE,FALSE
417,2021-11-13T05:06:13Z,2021-11-13T06:29:12Z,4978,1,2021-11-13T06:29:13Z,1,Chrome,95.0.4638.69,Windows NT 10.0,1536,864,n/a,1.7777777777777777,1146,55,412,69,55,74,0.9167520307452114,-0.31618875321090295,-0.07464270950233591,-0.4336088306619555,-0.2340474968444512,-0.5299936521325801,2,4,1,2,2,1,2,2,2,3,4,2,1,2,2,2,1,3,3,3,0.8944271909999159,0,1,1,4,4,2,0,2,2,2,4,3,1,3,3,2,1,2,3,2,3,3,2,3,1,1,1,2,3,3,1,3,0,0,4,5,5,4,3,3,4,4,4,3,3,2,2,3,4,5,1,2,2,3,3,3,1,1,1,2,1,1,2,1,1,4,1,3,2,2,1,1,2,3,2,1.300842877595981,0.828078671210825,2,0,2,0,2.533333333333333,0,2,0,2.4166666666666665,0,1.3333333333333333,0,1.4285714285714286,0,1.6666666666666667,0,1.945945945945946,0,1,0,0,-0.07315790414621297,-0.22054348261253207,-0.1468506933793725,4,2,3,2,1,2,2,3,1,0.9511897312113419,2,0,2,0.06413940681375631,5,5,4,5,3,3,2,1,1,3,3,1.2149857925879117,4.142857142857143,0,1.8571428571428572,8,3.8333333333333335,3.2559414990859232,2.0842459175790595,0,0.7076844056283068,2,2,2,1,2,2,4,4,2,3,3,4,3,4,5,5,4,3,3,4,0.9154754164341269,1.8,0,3.6,0,2.8,0,3.4,0,3.2666666666666666,0,1,1,1,2,2,1,2,2,1,1,2,3,1,3,1,2,1,1,1,2,0.6863327411532597,1.65,0,"Asian or Asian American (e.g., Chinese, Japanese, and others)",0,24,0,1,NA,1,3,6,Student,3,0,180,70,2,5,2,0,0,1,0,0,TRUE,TRUE,TRUE,TRUE,TRUE,1,0.8029358974374258,0.78,0.10288383957514792,1,0.4724900000075499,0.6194903225879516,1,0.96875,0.003149394723406389,0.02702938641137846,1,0.5266593750044704,0.6167806451551375,1,0.96875,0.007120021845557834,0.007189200282562015,1.446,0.8995,0.38,0,28.7984,0.003,ML,change,50,-45.86073098371556,0.9375686359134172,1.3499452998427286,0.3997817501277558,1.7043,2.8659,0.3341,5.5711,0.3195,0,-57.2116,0.007,ML,cueing,62,126.80460315513527,2.609166357446579,1.3161242841739558,0.3830419043237002,4.850156145686534,0.8542270809314484,0.38718011927429735,0.083,0.354,0.486,0.015,1.703,81.84827535737845,1929.1216953667174,0.079,0.368,0.541,0.015,1.737,80.54095464740419,1908.760696147476,420,1.2444444444444445,1,0,0,1,FALSE,FALSE,FALSE
418,2021-11-13T05:31:03Z,2021-11-13T06:29:15Z,3492,1,2021-11-13T06:29:16Z,1,Chrome,93.0.4577.95,CrOS x86_64 14092.66.0,1366,768,NA,1.7786458333333333,1965,75,757,279,119,200,3.02106361812872,-0.13449398694725767,1.5862697918221902,2.125536541487191,0.6499243199136185,1.5983185597349072,3,4,2,1,2,1,1,2,1,2,2,1,1,1,3,2,1,1,4,2,0.9880869341680844,0,1,1,4,4,1.75,0,5,5,2,5,1,1,5,1,1,1,2,4,1,4,3,1,1,1,1,1,1,1,1,0,2,0,0,4,5,5,5,5,5,5,5,5,1,5,1,1,5,1,5,1,1,1,1,3,5,1,1,1,1,1,1,1,1,1,5,1,1,1,1,1,1,1,1,1,1.9234603452371197,1.7511900715418263,1,0,1,0,1.4,0,1.1111111111111112,0,1.1666666666666667,0,0.8333333333333334,0,0.8571428571428571,0,1,0,1.0810810810810811,0,0,0,0,-1.3616293442703125,-0.7372407672780129,-1.0494350557741627,5,2,3,1,1,1,1,1,1,1.5275252316519468,1.4285714285714286,0,1,-0.6467170085812028,5,5,5,5,2,2,1,6,6,3,3,1.8126539343499315,4.142857142857143,0,1.8571428571428572,3,3.8333333333333335,3.2559414990859232,-0.7395711320441822,0,-0.7042241191833141,2,2,2,1,2,2,3,5,1,1,2,2,2,5,3,2,4,2,3,4,1.2798809468443688,1.8,0,3.6,0,3,0,3.2,0,3.2666666666666666,0,3,1,2,3,2,3,2,3,1,1,2,3,2,3,1,3,1,2,1,2,0.8255779474818965,1.85,0,"White, Caucasian, Anglo, European American",0,26,0,1,NA,1,3,4,Student,3,0,120,69,3,5,2,1,0,1,0,1,TRUE,TRUE,TRUE,TRUE,TRUE,NA,NA,NA,NA,3,0.5402419354836306,0.6126464285709496,0.96875,0.875,0.01156988958670178,0.019860680393371594,3,0.6473906250004656,0.6828774193542139,1,0.96875,0.018634296361092623,0.01228533136089609,NA,NA,NA,NA,NA,NA,NA,NA,NA,NA,NA,NA,NA,0.9916,1.9919,0.4475,3.3084,0.4048,0,-48.0429,0.006,ML,cueing,64,108.56244925007903,1.9965131183009137,0.9746543266950006,0.4295795760868189,3.225733713557496,1.0645600379387727,0.385544566731061,0.081,0.441,0.402,0.036,1.509,57.671895177255784,1896.7570009103472,0.081,0.441,0.402,0.036,1.658,81.37694481578649,1905.9128262862266,444,1.3155555555555554,1,0,0,1,FALSE,FALSE,FALSE
419,2021-11-13T06:10:15Z,2021-11-13T06:31:23Z,1267,1,2021-11-13T06:31:24Z,1,Chrome,95.0.4638.69,Windows NT 10.0,1280,720,N/A,1.7777777777777777,699,61,236,63,38,74,-0.23175502610512866,-0.26168032333180935,-0.9219487971345579,-0.5067272698662169,-0.46885251067081346,-0.5299936521325801,2,3,3,2,2,1,1,2,1,3,4,2,1,1,3,3,1,1,4,3,1.0399898784932577,0,1,2,4,3,1.75,0,4,5,3,4,3,1,5,1,2,1,1,5,1,5,3,1,1,1,1,1,1,1,1,0,2,0,0,5,4,5,5,3,5,5,5,5,2,5,1,1,4,2,5,2,1,1,1,1,5,1,1,1,3,1,1,1,1,1,4,2,1,1,1,1,1,2,1,1,1.757438075321173,1.6676187756655838,1,0,1.25,0,1.6,0,1.3333333333333333,0,1.3333333333333333,0,1.1666666666666667,0,1.1428571428571428,0,1,0,1.2972972972972974,0,0,0,0,-1.182761013339623,-0.6588395645607719,-0.9208002889501974,5,2,3,2,1,3,2,1,1,1.2724180205607036,2,0,1,-0.3048482679606258,5,5,5,5,2,2,2,6,6,NA,2,1.6035674514745464,4,0,2,3,3.8333333333333335,3.2559414990859232,-0.7395711320441822,0,-0.6245531217618774,2,2,2,1,2,2,4,3,2,4,1,4,1,4,5,1,4,2,3,2,1.3201731488169053,1.8,0,4.2,0,4.2,0,4,0,4.133333333333334,0,1,1,1,4,1,1,2,4,1,1,2,4,1,1,1,4,1,1,1,2,1.2085223687584246,1.15,0,"White, Caucasian, Anglo, European American",0,18,0,1,NA,1,2,4,Student,1,0,154,70,4,5,2,0,0,1,0,0,TRUE,TRUE,TRUE,TRUE,TRUE,3,0.6864157894747822,0.76,0.020677335118759067,3,0.47674375000037256,0.503734375,1,1,0.004740496088866463,0.0030912087798055524,3,0.5707999999960884,0.6603312499951571,1,1,0.007670987097170276,0.0053720435071775655,1.0871,1.137,0.4439,0,-0.4794,0.004,ML,change,50,12.694869016284438,1.2904896240485038,0.8932109863248784,0.5064570729405843,3.4622,8.5111,0.3003,7.0294,0.2305,0,-91.4818,0.011,ML,cueing,64,195.44024925007903,4.87282045763638,0.8502539263269325,0.4192162300888335,4.378814486654115,0.9461772676186911,0.37207966445858076,0.215,0.243,0.642,0.015,1.391,87.73430282498117,1905.8338968227279,0.213,0.234,0.63,0.014,1.507,108.3637777016372,1890.6293510476817,373,1.1051851851851853,1,0,1,2,FALSE,FALSE,FALSE
420,2021-11-13T06:08:31Z,2021-11-13T06:35:50Z,1638,1,2021-11-13T06:35:51Z,1,Chrome,95.0.4638.69,Windows NT 10.0,1366,768,No,1.7786458333333333,710,91,436,103,73,127,-0.20349198891194356,0.010861826063658545,0.040899029720239816,-0.019271008504474677,0.014569576618755927,0.3652487861926329,1,2,3,3,1,1,2,1,2,1,1,2,3,3,1,1,3,3,1,1,0.8944271909999159,0,1,1,4,4,3.2,0,5,5,5,5,5,3,3,2,2,2,1,2,1,2,2,1,1,1,1,1,1,1,1,3,3,0,0,5,5,5,5,5,5,5,5,5,1,5,1,1,3,3,5,1,1,1,1,1,5,1,1,1,1,1,1,2,2,1,5,1,1,1,1,1,1,1,3,3,1.8788374144747144,1.5583874449479591,1,0,2,0,2.6,0,1,0,1.3333333333333333,0,0.8333333333333334,0,1.1428571428571428,0,1,0,1.162162162162162,0,2,0,0,-0.8110865594576713,-0.01745100881601569,-0.4142687841368435,3,3,3,2,1,4,4,4,3,1.0690449676496976,2.857142857142857,0,3.5,1.1304240299061954,5,5,5,5,5,5,1,6,3,3,2,1.5118578920369088,5,0,1,4.5,3.8333333333333335,3.2559414990859232,0.10757398284279028,0,-0.7586775462684484,4,2,4,1,4,3,2,2,4,2,2,3,2,4,4,4,4,4,2,2,0.9611501047232549,3,0,3.2,0,2.4,0,3.6,0,3.066666666666667,0,1,1,1,1,1,1,1,3,2,1,2,3,4,3,1,3,1,2,1,2,0.9665456669582609,1.75,0,"Hispanic of Latino (e.g., Mexican American, Central American, and others)",0,24,0,1,NA,1,2,4,Electrician,2,0,160,68,2,5,2,0,0,0,0,0,TRUE,TRUE,TRUE,TRUE,TRUE,4,0.7355128205143489,0.78,0.018103193469785672,4,0.5343187500033527,0.5253437499981374,1,1,0.006318385443325065,0.005184663830345921,4,0.624512499999255,0.6447625000011176,1,1,0.014636934033323043,0.01141505403108044,1.1163,1.2149,0.4766,0,-0.0088,0.004,ML,change,50,11.753669016284437,1.4476082960973664,0.8743155014677721,0.5664005398850104,1.7509,5.4502,0.3647,5.2282,0.3669,0,-83.5464,0.007,ML,cueing,64,179.56944925007903,4.281858820004189,0.9676018992114923,0.415886107971045,4.075312958042193,1.0166421006307014,0.4134848355131229,0.298,0.138,0.607,0.162,1.811,35.00588115836484,1849.612154681177,0.299,0.133,0.609,0.078,1.879,52.3567063339036,1834.0018868067987,376,1.114074074074074,1,0,0,1,FALSE,FALSE,FALSE
421,2021-11-13T06:14:26Z,2021-11-13T06:38:03Z,1417,1,2021-11-13T06:38:04Z,1,Chrome,95.0.4638.69,Windows NT 10.0,1536,864,NA,1.7777777777777777,613,59,296,77,47,76,-0.45272058961548495,-0.2798497999581739,-0.6330944490781186,-0.3361175783896071,-0.34454397393920994,-0.4962109186108739,3,2,2,2,2,2,2,1,1,1,1,2,1,3,2,1,2,1,2,1,0.6569466853317864,0,1,2,3,2,2.6,0,3,3,3,3,5,3,2,2,4,2,3,2,3,3,1,3,4,1,1,3,3,3,3,1,2,0,0,1,1,1,1,1,1,1,1,2,4,3,3,2,1,3,1,3,4,3,3,4,2,1,1,1,5,4,1,2,1,1,3,2,3,2,3,3,2,1,1,1,1.1823273226555742,0.9411239481143202,2.625,0,1.25,0,3.3333333333333335,0,4.888888888888889,0,3.5,0,2.5,0,1.7142857142857142,0,2.6666666666666665,0,3.324324324324324,0,1,0,0,1.131589993632082,-0.4557470907642554,0.3379214514339133,4,1,1,3,1,1,1,6,4,1.2535663410560174,2,0,5,1.1711024311369027,1,1,1,1,1,1,5,1,3,NA,1,1.5118578920369088,1,0,5,7,3.8333333333333335,3.2559414990859232,1.5194825076544112,0,2.178064643937591,2,2,3,2,2,2,3,2,2,3,3,4,2,3,3,4,4,3,3,2,0.7432233529572065,2.2,0,3.6,0,3,0,3.6,0,3.4,0,3,4,4,1,3,4,4,1,4,3,4,1,3,4,2,1,1,4,3,3,1.2258187382102494,3.45,0,"White, Caucasian, Anglo, European American",0,28,0,1,NA,1,1,3,Freelancer,1,0,240,69,1,5,2,0,0,1,0,0,TRUE,TRUE,TRUE,TRUE,TRUE,6,0.8768894736843037,0.76,0.04784965851428018,6,0.4332187500001164,0.5639620689654338,1,0.90625,0.0036773989919290976,0.012763782540322843,6,0.6304531250001164,0.7131000000000771,1,0.9354838709677419,0.010998278054415623,0.017029244989220656,1.5639,0.7858,0.3847,0,36.4301,0.003,ML,change,50,-61.12413098371557,1.0463053547813157,1.1016664539381074,0.6031326046068496,1.4955,2.4488,0.3011,4.3568,0.2616,0,-49.7371,0.008,ML,cueing,64,111.95084925007902,2.481980499441018,0.9140617913111357,0.41434864420090395,4.665812756871743,0.8879770668656993,0.34103461956547615,0.076,0.457,0.436,0.023,1.8,101.02391424450977,2018.6779283887308,0.073,0.454,0.421,0.02,1.962,129.6652406389753,2002.5096933271575,330,0.9777777777777777,1,0,1,2,FALSE,FALSE,FALSE
422,2021-11-13T06:12:48Z,2021-11-13T06:38:04Z,1516,1,2021-11-13T06:38:05Z,1,Chrome,95.0.4638.69,Windows NT 10.0,1920,1080,you didn't ask what sort of area I grew up in - I lived in a rural environment. this fact might change the context of my answers and you might want to think about including it in addition to the general descriptors you asked for,1.7777777777777777,730,55,358,80,63,95,-0.15210464856069794,-0.31618875321090295,-0.33461162275313133,-0.29955835878747644,-0.12355101974969247,-0.1752749501546655,4,4,2,3,3,2,1,3,1,3,3,2,1,2,4,3,2,2,3,3,0.9445132413883326,0,1,1,3,3,1.75,0,3,4,3,5,5,4,4,4,3,3,3,4,2,3,5,2,3,1,1,1,2,3,2,0,2,0,0,5,5,4,5,4,5,4,5,4,4,4,2,2,4,2,5,3,2,3,3,3,5,1,1,1,4,1,1,1,1,1,3,5,4,1,1,2,2,1,1,2,1.5456030825826172,0.8997354108424374,1.875,0,1.5,0,2.7333333333333334,0,1.4444444444444444,0,2.4166666666666665,0,1.3333333333333333,0,2.142857142857143,0,1.3333333333333333,0,1.9189189189189189,0,0,0,0,-0.05254158678244845,-0.5804383618435307,-0.3164899743129896,5,1,3,1,1,2,2,1,3,1.4638501094227998,1.5714285714285714,0,2,-0.19226214865167657,5,5,5,5,3,3,2,7,6,4,4,1.2909944487358056,4.285714285714286,0,1.7142857142857142,2.5,3.8333333333333335,3.2559414990859232,-1.0219528370065065,0,-0.9250859690859132,3,2,3,4,3,3,4,4,3,3,2,5,3,4,5,3,5,1,3,4,1.1254628677422756,3,0,4.4,0,3.2,0,3.2,0,3.6,0,2,1,1,4,3,1,2,3,2,2,2,3,1,2,2,3,1,2,1,2,0.8583950752789521,1.7,0,"White, Caucasian, Anglo, European American",0,30,0,1,NA,1,4,6,lab tech,3,0,200,72,3,5,2,0,0,1,0,0,TRUE,TRUE,TRUE,TRUE,TRUE,5,1.024551282060452,0.78,0.12727284498194968,5,0.46216874999552965,0.5212968750074506,1,1,0.002162136411175593,0.0027128699890755547,5,0.6470156249962747,0.6697687500044703,1,1,0.009070872974773648,0.0024780306057277605,1.6172,0.8247,0.4692,0,38.1292,0.003,ML,change,50,-64.52233098371556,0.8890085207072633,1.4236830624799381,0.5761514656253452,2.6865,8.0076,0.3535,8.1984,0.2983,0,-104.7677,0.011,ML,cueing,64,222.01204925007903,5.034487293171402,0.8229506770254702,0.4421196498062108,5.328337453794457,0.7775661287070119,0.39148373860905156,0.218,0.363,0.773,0.078,1.435,119.50058122099475,1937.7265123373606,0.222,0.356,0.781,0.034,1.492,135.70994250120322,1925.9057745494267,350,1.0370370370370372,1,0,0,1,FALSE,FALSE,FALSE
423,2021-11-13T06:14:48Z,2021-11-13T06:39:35Z,1486,1,2021-11-13T06:39:36Z,1,Chrome,95.0.4638.69,Windows NT 10.0,1536,864,NA,1.7777777777777777,650,68,454,141,61,74,-0.3576540099656805,-0.1980871551395335,0.1275553341371716,0.4438124397891804,-0.15117513902338214,-0.5299936521325801,4,3,2,1,4,1,1,3,1,3,3,1,1,2,3,3,1,2,3,3,1.0699237552766379,0,1,3,3,4,1.55,0,4,5,2,5,2,1,4,1,2,2,1,5,1,5,4,1,2,1,1,1,1,2,1,1,2,0,0,5,2,4,5,3,4,4,5,3,2,4,2,1,4,2,3,4,2,4,5,3,4,1,1,1,1,1,1,2,3,1,4,2,2,1,1,1,2,5,1,2,1.4184540923174116,1.6676187756655838,1.25,0,2.5,0,1.4666666666666666,0,2.111111111111111,0,2.6666666666666665,0,1,0,1.7142857142857142,0,1,0,2,0,1,0,0,-0.8306381843754198,-0.06374107717804986,-0.44718963077673485,5,1,4,1,1,2,2,1,1,1.6035674514745464,1.4285714285714286,0,1,-0.6467170085812028,4,5,5,5,4,4,2,2,4,1,4,1.0690449676496976,4.428571428571429,0,1.5714285714285714,6,3.8333333333333335,3.2559414990859232,0.9547190977297628,0,-0.01642099913921513,2,2,1,1,1,2,4,2,1,2,2,4,1,3,3,4,3,2,3,5,1.162919151265879,1.4,0,3.8,0,3.2,0,3.2,0,3.4,0,1,1,2,1,1,1,1,4,1,1,2,4,2,2,1,3,1,1,1,2,0.9880869341680844,1.45,0,"White, Caucasian, Anglo, European American",0,23,0,1,NA,1,3,3,Student,2,0,175,69,3,5,2,0,0,1,0,0,TRUE,TRUE,TRUE,TRUE,TRUE,2,1.0948484848475817,0.66,0.09997247807750388,2,0.5434656249992549,0.5771333333363136,1,0.9375,0.0026197100701820337,0.003534897086750826,2,0.7010812499998137,0.7680677419343303,1,0.96875,0.01163892931499311,0.009189492006699131,1.3902,0.4795,0.6616,0,37.1236,0.004,ML,change,50,-62.51113098371557,0.5216042634601115,1.2716426300088866,0.7047772468332835,1.2567,3.4364,0.4179,5.3942,0.427,0,-79.2162,0.007,ML,cueing,64,170.90904925007902,3.8229884267760736,0.708359508005602,0.49606918922803656,5.078660558989569,0.8157928017177496,0.4656597480869667,0.077,0.479,0.375,0.013,1.586,101.55795851815903,1934.0896950794518,0.08,0.479,0.376,0.014,1.647,121.38942317543395,1945.96891249167,104,0.3081481481481481,1,0,0,1,FALSE,FALSE,FALSE
424,2021-11-13T06:20:30Z,2021-11-13T06:42:15Z,1305,1,2021-11-13T06:42:18Z,0.8999999761581421,Chrome,95.0.4638.69,Windows NT 10.0,1920,1080,thanks homies,1.7777777777777777,715,39,317,66,48,73,-0.19064515382413216,-0.46154456622181916,-0.5319954272583648,-0.47016805026408615,-0.3307319143023651,-0.5468850188934331,3,3,1,1,3,1,1,3,1,3,3,1,2,1,3,3,1,1,3,3,0.998683343734455,0,1,1,3,3,1.55,0,5,3,3,3,3,1,4,2,2,1,1,5,1,5,5,1,1,1,1,1,1,1,1,2,3,0,1,5,3,2,3,5,5,1,1,2,1,5,1,1,3,1,5,3,1,1,1,1,1,1,5,3,4,2,1,2,1,1,5,1,1,1,1,1,2,2,2,2,1.5835111327387337,1.5796322658258457,1,0,2,0,1.7333333333333334,0,3,0,1.3333333333333333,0,3.1666666666666665,0,1,0,1,0,2,0,1,0,1,-0.8234757079204031,-0.04409383571335133,-0.43378477181687725,2,5,1,5,5,5,5,8,3,1.7320508075688772,4.857142857142857,0,5.5,3.0649399716269796,3,3,3,2,1,1,5,3,3,2,1,1.3972762620115438,2,0,4,6,3.8333333333333335,3.2559414990859232,0.9547190977297628,0,1.3379859570252095,1,1,1,1,1,1,4,1,1,5,1,5,1,5,5,1,5,1,5,3,1.9444671200491874,1,0,5,0,4.8,0,4.6,0,4.8,0,1,1,1,4,4,2,1,4,1,1,2,4,1,1,1,4,1,2,1,2,1.2763022245616642,1.35,0,"Hispanic of Latino (e.g., Mexican American, Central American, and others)",0,29,0,1,NA,1,2,6,Marriage and Family Therapist Trainee,4,0,210,70,2,5,2,0,0,1,0,0,TRUE,TRUE,TRUE,TRUE,TRUE,1,0.8424874999985099,0.8163265306122449,0.07305979612325515,1,0.4810999999960264,0.5228374999994412,1,1,0.0029253227586011213,0.0053127682261253995,1,0.836593749997206,1.0667064516082887,1,0.96875,0.14918716770493085,0.4744848692629974,1.4647,1.0709,0.4125,0,23.1868,0.003,ML,change,49,-34.698139105668126,1.1728271446898544,1.2718454578165261,0.4994544597354163,3.8471,7.1566,0.2541,9.0793,0.2692,0,-88.4226,0.01,ML,cueing,62,189.22660315513528,4.255810452610201,0.9735242611311409,0.4120358514682709,3.509468014644168,0.771641225907222,0.38490506819276876,0.123,0.208,0.17,0.116,1.478,84.18606976606102,1962.4928555210854,0.119,0.217,0.164,0.024,1.611,103.76395351676446,1928.657870588286,104,0.3081481481481481,1,0,0,1,FALSE,FALSE,FALSE
425,2021-11-13T06:22:56Z,2021-11-13T06:43:55Z,1258,1,2021-11-13T06:43:57Z,0.8999999761581421,Firefox,94.0,Macintosh,1280,800,NA,1.6,610,53,318,97,54,83,-0.46042869066817177,-0.33435822983726743,-0.5271811881240909,-0.092389447708736,-0.24785955648129604,-0.3779713512849024,3,4,2,2,3,1,1,3,1,2,2,1,1,1,3,4,1,1,3,3,1.0711528467275955,0,1,1,3,3,1.6,0,4,4,2,4,2,2,3,2,3,2,2,4,2,4,3,1,3,1,1,1,1,2,1,2,2,0,0,4,2,4,4,3,5,2,3,2,2,4,1,1,2,1,3,3,1,1,2,4,5,1,1,1,2,1,2,2,3,2,4,2,2,1,1,1,1,1,2,2,1.244205790071742,0.9154754164341269,1.375,0,1.5,0,2.2,0,2.7777777777777777,0,2.0833333333333335,0,1,0,2,0,1,0,2.027027027027027,0,1,0,0,-0.45015582025824447,-0.3773458880470143,-0.41375085415262935,5,2,3,1,1,1,1,1,1,1.5275252316519468,1.4285714285714286,0,1,-0.6467170085812028,4,5,5,5,1,1,1,7,7,NA,3,2.0354009783964297,3.7142857142857144,0,2.2857142857142856,2,3.8333333333333335,3.2559414990859232,-1.3043345419688306,0,-0.7475928318813282,4,4,4,2,4,4,4,4,3,3,2,3,1,2,2,5,3,1,2,4,1.1872336794093274,3.6,0,3.4,0,3,0,2.2,0,2.8666666666666667,0,2,2,2,3,3,2,2,3,1,2,2,2,1,4,1,2,1,1,1,2,0.8255779474818965,1.95,0,"Asian or Asian American (e.g., Chinese, Japanese, and others)",0,25,0,1,NA,1,3,6,Systems Engineer,3,0,125,69,1,5,2,0,0,1,0,0,TRUE,TRUE,TRUE,TRUE,TRUE,1,0.6924,0.8,0.01080436285714286,1,0.43253125,0.46820689655172415,1,0.9354838709677419,0.001855934475806452,0.004738879569892474,1,0.6363548387096775,0.7162413793103448,0.96875,0.90625,0.017113544354838705,0.01208618951612903,1.2726,1.2563,0.3865,0,5.3073,0.004,ML,change,50,1.121469016284438,1.7797373185042817,0.7789320068227561,0.5610999482354988,1.0045,3.4902,0.3374,5.2882,0.3376,0,-87.5999,0.012,ML,cueing,63,187.62920417917462,3.5265521275048557,0.7582898402578188,0.3745678454299622,5.535690930603533,0.7484403985574073,0.3670424388297348,0.073,0.438,0.426,0.012,1.519,117.25718251775683,2023.8667737065223,0.066,0.442,0.382,0.013,1.738,134.81040146636948,2032.6312756195805,404,1.1970370370370371,1,0,1,2,FALSE,FALSE,FALSE
426,2021-11-13T06:19:13Z,2021-11-13T06:44:15Z,1501,1,2021-11-13T06:44:16Z,1,Chrome,95.0.4638.69,Windows NT 10.0,1920,1080,"No additional comments at this time, thank you for letting me participate in your study.",1.7777777777777777,668,51,438,100,55,93,-0.31140540364955943,-0.35252770646363196,0.050527507988787794,-0.05583022810660534,-0.2340474968444512,-0.20905768367637165,3,3,1,1,3,1,1,3,1,3,3,1,1,1,3,3,1,1,3,3,1.025978352085154,0,1,1,3,2,1.5,0,3,3,2,3,2,3,3,3,2,2,3,2,1,3,1,2,3,1,3,2,3,3,2,8,2,0,0,3,1,2,2,1,2,2,3,3,2,5,3,1,3,3,2,4,3,3,3,3,4,1,1,1,4,3,3,5,5,4,2,4,4,3,3,2,2,2,4,4,1.1579468212490764,0.7367883976130072,2.375,0,3,0,2.8,0,3.888888888888889,0,2.75,0,1.8333333333333333,0,4,0,2.6666666666666665,0,3.1621621621621623,0,4,0,0,0.7252646401434276,0.7023387496459815,0.7138016948947046,3,3,2,3,2,3,3,2,2,0.4879500364742666,3,0,2,0.6624097028997663,3,4,4,3,1,1,5,5,3,2,1,1.5275252316519468,2.4285714285714284,0,3.5714285714285716,5,3.8333333333333335,3.2559414990859232,0.38995568780511447,0,0.8165912597985752,3,3,3,2,3,3,4,3,4,3,1,3,2,3,3,5,3,2,3,4,0.9611501047232549,2.8,0,3.6,0,3,0,2.6,0,3.066666666666667,0,2,1,2,3,2,2,2,3,2,2,3,3,2,1,2,3,1,2,2,2,0.6407232755171874,1.9,0,"White, Caucasian, Anglo, European American",0,25,0,1,NA,1,2,3,Lead Pharmacy Technician,3,0,180,68,3,5,2,0,0,1,0,0,TRUE,TRUE,TRUE,TRUE,TRUE,4,0.9570945945954,0.7551020408163265,0.07567686666690143,4,0.47608620689655173,0.5860249999994412,0.9666666666666667,1,0.0019588859881392996,0.006363889031505229,4,0.719515625002794,0.8421375000039115,1,1,0.011204809102974425,0.02324834242027868,1.4057,0.83,0.5876,0,27.6778,0.004,ML,change,49,-43.680139105668125,0.9138695288540621,1.2321356903847915,0.6131501700844606,1.4028,4.1977,0.4289,5.4499,0.3465,0,-81.0792,0.024,ML,cueing,62,174.53980315513527,4.068008435604689,1.0184675848086526,0.46475675677900613,4.348578167123159,0.7821401044084828,0.3845180820592658,0.087,0.503,0.36,0.019,1.722,77.62095427687183,1871.7335226738296,0.095,0.484,0.371,0.023,1.88,91.59118145956346,1876.9478919889834,298,0.882962962962963,1,0,0,1,FALSE,FALSE,FALSE
427,2021-11-13T05:44:47Z,2021-11-13T06:44:30Z,3583,1,2021-11-13T06:44:31Z,1,Chrome,94.0.4606.81,Macintosh,1440,900,NA,1.6,1868,99,770,212,120,329,2.7718350174251785,0.08353973256911665,1.648854900567752,1.3090473037062726,0.6637363795504634,3.777304871884954,2,2,1,1,2,1,1,3,1,3,2,1,1,1,3,3,1,1,2,3,0.8506963092234007,0,1,2,3,3,1.75,0,4,4,2,4,2,1,3,2,1,1,3,4,1,4,4,2,3,1,2,1,2,1,3,3,2,0,0,5,5,4,4,4,4,4,4,4,2,4,1,1,3,1,4,2,1,2,2,4,3,1,1,1,3,1,1,2,2,1,4,1,1,1,1,2,2,2,2,2,1.4062281029326207,1.2909944487358056,1.875,0,2,0,1.8666666666666667,0,1.7777777777777777,0,1.9166666666666667,0,1.5,0,1.2857142857142858,0,1.3333333333333333,0,1.7027027027027026,0,2,0,0,-0.5179089759138089,-0.01745100881601569,-0.2676799923649123,5,1,4,1,1,1,1,1,1,1.7320508075688772,1.1428571428571428,0,1,-0.8176513788914915,5,5,5,4,3,3,2,6,6,3,3,1.2149857925879117,4.142857142857143,0,1.8571428571428572,3,3.8333333333333335,3.2559414990859232,-0.7395711320441822,0,-0.7042241191833141,4,3,4,3,4,3,3,5,2,2,4,3,2,3,3,4,2,2,3,4,0.9258200997725514,3.6,0,2.8,0,2.8,0,2.6,0,2.7333333333333334,0,1,1,1,2,2,1,1,3,2,1,1,4,1,2,2,4,1,1,2,1,0.9787209698591858,1.4,0,"White, Caucasian, Anglo, European American",0,23,0,1,NA,1,2,4,Delivery Driver,2,0,130,71,3,5,2,0,1,2,0,1,TRUE,TRUE,TRUE,TRUE,TRUE,1,1.0555421052645695,0.7755102040816326,0.1856584202292594,1,0.3911517241371089,0.46788928571449856,0.90625,0.875,0.001920281895034938,0.003900813216004493,1,0.5300000000009313,0.6621499999985099,1,0.875,0.005194170967888831,0.008971347378889374,1.6102,0.7942,0.5295,0,39.018,0.003,ML,change,49,-66.36053910566812,0.7945480651268225,1.5602465619624166,0.5145253089612295,0.7309,2.459,0.3518,3.9085,0.3101,0,-78.4708,0.01,ML,cueing,64,169.41824925007901,2.9990375947392476,0.648844866922884,0.38675765017818686,3.9852169359461755,0.5692747917572849,0.33312028246943237,0.059,0.398,0.419,0.01,1.585,85.85023543858259,2010.2356225907643,0.059,0.398,0.424,0.009,1.613,111.87457308172799,2018.6656988680522,404,1.1970370370370371,1,0,3,4,FALSE,FALSE,FALSE
428,2021-11-13T06:23:10Z,2021-11-13T06:45:33Z,1342,1,2021-11-13T06:45:34Z,0.8999999761581421,Chrome,95.0.4638.69,Windows NT 10.0,1600,900,NA,1.7777777777777777,773,47,300,68,39,70,-0.041621866805519804,-0.38886665971636103,-0.6138374925410226,-0.44579523719599906,-0.4550404510339686,-0.5975591191759924,4,4,2,1,3,1,1,4,1,3,4,1,3,1,3,4,1,1,3,4,1.3168942730211068,0,1,1,3,3,1.35,0,3,5,1,4,1,1,5,1,3,1,1,4,1,4,4,1,1,1,1,3,1,2,1,1,2,0,0,3,3,5,5,5,5,5,5,5,1,5,1,1,5,1,5,3,2,2,1,1,5,1,1,1,2,2,1,1,3,1,5,1,5,1,1,1,2,2,1,2,1.8050646133194952,1.6388149028228556,1.375,0,1.75,0,1.5333333333333334,0,1.4444444444444444,0,1.3333333333333333,0,1.1666666666666667,0,1.7142857142857142,0,1,0,1.4324324324324325,0,1,0,0,-0.9921810655027575,-0.2989446853297732,-0.6455628754162653,5,1,4,1,1,1,2,2,1,1.6761634196950514,1.2857142857142858,0,1.5,-0.5476903563491562,5,5,5,5,2,1,1,4,7,3,3,1.9880595947760098,4,0,2,3.5,3.8333333333333335,3.2559414990859232,-0.4571894270818581,0,-0.48336226928071535,2,2,1,1,2,2,5,1,1,3,1,5,1,5,5,1,4,1,5,3,1.8073922282301278,1.6,0,4.6,0,4.6,0,4.6,0,4.6,0,2,1,2,3,1,3,4,4,1,2,2,3,3,2,1,4,2,2,2,1,1.019545822516343,1.85,0,"White, Caucasian, Anglo, European American",0,20,0,3,NA,1,2,4,Student/Food Service,1,0,200,76,4,5,2,0,0,1,0,0,TRUE,TRUE,TRUE,TRUE,TRUE,1,1.1096999999996275,0.8,0.2977239618325536,1,0.4853843749985099,0.5621266666685542,1,0.9375,0.0031829897480949963,0.00497261512113743,1,0.6064874999988824,0.7431333333328366,1,0.967741935483871,0.004072915967858616,0.013358504623869949,2.0479,0.7323,0.3174,0,57.2794,0.002,ML,change,50,-102.82273098371557,0.7767875387411344,1.7846506180654316,0.4204572422086189,1.241,3.1414,0.3808,5.601,0.3746,0,-77.7685,0.008,ML,cueing,64,168.01364925007903,3.5103544077659623,0.7714463802034309,0.46598030874174995,4.837307374415166,0.8564960639683231,0.39962069515072807,0.081,0.468,0.567,0.009,1.385,2.5378965331957106,1831.4227919035072,0.081,0.469,0.585,0.009,1.434,3.7185616696086092,1827.587899546726,104,0.3081481481481481,1,1,1,2,FALSE,FALSE,FALSE
429,2021-11-13T06:24:34Z,2021-11-13T06:45:36Z,1261,1,2021-11-13T06:45:37Z,0.8999999761581421,Chrome,95.0.4638.69,Windows NT 10.0,1707,960,NA,1.778125,654,51,291,98,45,78,-0.3473765418954314,-0.35252770646363196,-0.6571656447494886,-0.08020304117469244,-0.37216809321289956,-0.4624281850891678,3,3,1,1,3,1,1,3,1,3,2,1,1,1,3,3,1,1,4,2,1.050062654772261,0,1,1,3,3,1.55,0,5,5,2,5,1,2,4,2,1,1,1,4,3,4,3,1,1,1,1,1,1,1,1,1,2,0,0,4,1,4,4,3,5,3,3,4,2,4,1,1,3,1,5,1,1,1,1,1,5,1,1,1,1,1,1,1,1,1,5,1,1,1,1,1,1,2,2,2,1.5161790127814059,1.5522640914238175,1,0,1.75,0,1.6666666666666667,0,2.5555555555555554,0,1.3333333333333333,0,0.8333333333333334,0,0.8571428571428571,0,1,0,1.4864864864864864,0,1,0,0,-1.072807320732879,-0.2989446853297732,-0.6858760030313261,5,1,5,1,1,1,1,1,3,1.9518001458970664,1,0,2,-0.5341308892722537,5,5,5,5,2,2,1,7,7,4,3,1.8126539343499315,4.142857142857143,0,1.8571428571428572,2,3.8333333333333335,3.2559414990859232,-1.3043345419688306,0,-0.9866058241456384,3,3,3,3,3,2,4,3,2,3,1,3,1,3,3,2,5,2,3,3,1.0465362369445672,3,0,4.2,0,3.8,0,3.2,0,3.7333333333333334,0,2,1,1,4,2,1,1,3,1,1,2,3,1,1,1,3,1,2,1,1,0.9333020044867296,1.35,0,"White, Caucasian, Anglo, European American",0,22,0,1,NA,1,4,4,Retail shopper,5,0,130,69,2,5,2,0,0,1,0,0,TRUE,TRUE,TRUE,TRUE,TRUE,5,1.0171249999983443,0.72,0.08262335526972343,5,0.4908093749997206,0.5794999999971159,1,0.96875,0.008361904748076495,0.013263363225820928,5,0.6292499999981374,0.7481124999988824,1,1,0.010443739999673561,0.02685186435467746,1.5127,0.6597,0.5538,0,37.5224,0.003,ML,change,50,-63.308730983715556,0.7626593602966301,1.2383793578217026,0.659896762984627,1.275,3.014,0.3771,4.454,0.3477,0,-64.2888,0.008,ML,cueing,64,141.054249250079,3.117434957215287,1.101542534684549,0.4138676547453577,3.799585226032035,1.0904176324314936,0.3518018230463244,0.231,0.231,0.556,0.021,1.86,38.99434922487751,1830.6477868770749,0.232,0.229,0.557,0.02,1.791,51.073777278146686,1831.3001153197636,236,0.6992592592592592,1,0,0,1,FALSE,FALSE,FALSE
430,2021-11-13T06:25:00Z,2021-11-13T06:46:38Z,1298,1,2021-11-13T06:46:39Z,1,Chrome,95.0.4638.69,Windows NT 10.0,1920,1080,NA,1.7777777777777777,699,65,279,101,45,60,-0.23175502610512866,-0.22534137007908028,-0.7149365143607764,-0.04364382157256178,-0.37216809321289956,-0.7664727867845231,3,3,4,4,3,1,1,3,1,3,1,1,1,1,3,3,1,2,3,3,1.118033988749895,0,1,1,2,1,1.95,0,5,5,1,5,1,1,5,1,1,1,1,5,2,5,5,2,2,1,1,1,1,1,1,0,2,0,0,5,5,5,5,5,5,4,4,5,1,5,1,1,5,1,5,1,1,1,2,1,5,1,1,1,2,1,1,1,1,1,5,1,1,1,1,1,1,1,1,1,1.8800357801208292,2.016597794967223,1.25,0,1,0,1.0666666666666667,0,1.2222222222222223,0,1.0833333333333333,0,1,0,0.8571428571428571,0,1,0,1.1081081081081081,0,0,0,0,-1.3858268998615852,-0.7372407672780129,-1.061533833569799,5,1,5,1,1,1,1,1,1,1.9518001458970664,1,0,1,-0.9031185640466358,5,5,5,5,2,2,1,4,7,3,3,1.8126539343499315,4.142857142857143,0,1.8571428571428572,3.5,3.8333333333333335,3.2559414990859232,-0.4571894270818581,0,-0.563033266702152,3,3,2,3,2,2,5,1,1,5,1,4,1,5,4,1,5,1,3,1,1.7994708216848747,2.6,0,4.6,0,4.6,0,4.8,0,4.666666666666667,0,1,1,2,3,4,2,2,2,1,2,2,3,1,1,1,3,1,2,2,3,0.8870412083230169,1.85,0,"White, Caucasian, Anglo, European American",0,27,0,1,NA,1,3,6,Software Engineer,4,0,162,70,3,5,2,0,0,1,0,0,TRUE,TRUE,TRUE,TRUE,TRUE,6,0.8390552631569536,0.76,0.05533297380012391,6,0.4636718750002328,0.5057343750002329,1,1,0.0030311278931665748,0.003330558457585537,6,0.618962500001071,0.7208000000007451,1,1,0.007456317903330582,0.014605549032152382,1.3544,0.9033,0.4818,0,22.349,0.003,ML,change,50,-32.96193098371556,1.0089790661389204,1.1424216305590624,0.5446689533576777,2.4448,6.697,0.3232,8.335,0.317,0,-100.8521,0.012,ML,cueing,64,214.180849250079,4.7828111075655615,0.8662551443517863,0.4180051450330122,4.896789430638692,0.8460920742207901,0.37997910971887144,0.118,0.38,0.491,0.014,1.484,71.14136294464478,1866.2501973090612,0.109,0.403,0.513,0.014,1.569,90.70410513764911,1877.1518504338721,336,0.9955555555555555,1,0,1,2,FALSE,FALSE,FALSE
431,2021-11-13T06:27:53Z,2021-11-13T06:49:58Z,1324,1,2021-11-13T06:49:59Z,0.8999999761581421,Chrome,95.0.4638.69,Windows NT 10.0,1920,1080,No feedback,1.7777777777777777,672,43,361,73,68,72,-0.3011279355793103,-0.4252056129690901,-0.32016890535030934,-0.38486320452578127,-0.054490721565468275,-0.5637763856542862,4,3,1,2,3,1,1,3,1,3,4,1,1,1,4,3,1,1,4,4,1.3018205875255096,0,1,1,3,2,1.3,0,3,5,1,3,1,3,1,1,1,1,1,4,1,4,1,4,1,5,1,3,3,2,4,1,1,0,1,5,4,1,5,4,4,5,5,5,2,5,1,1,3,1,5,5,1,4,1,1,1,1,2,1,3,2,1,2,1,1,3,4,1,1,2,1,2,1,1,1,1.6589913357978252,1.4375905768565218,2.875,0,1.25,0,2.066666666666667,0,1.7777777777777777,0,1.8333333333333333,0,2.1666666666666665,0,1.7142857142857142,0,1.3333333333333333,0,1.864864864864865,0,1,0,1,0.06747828895026543,-0.27929744386507466,-0.10590957745740462,5,1,4,1,1,1,4,2,1,1.8126539343499315,1.5714285714285714,0,1.5,-0.3767559860388676,3,4,4,4,1,2,4,7,6,3,3,1.2149857925879117,2.857142857142857,0,3.142857142857143,2.5,3.8333333333333335,3.2559414990859232,-1.0219528370065065,0,-0.12837599487154566,1,1,1,1,1,1,5,1,1,2,1,5,1,5,5,1,5,3,5,5,1.9444671200491874,1,0,4.6,0,4.4,0,4.2,0,4.4,0,1,2,2,4,2,3,4,3,2,1,2,3,2,3,1,3,1,3,1,3,0.9787209698591858,2,0,"White, Caucasian, Anglo, European American",0,26,0,1,NA,1,3,6,Digital Advertising Strategist,5,0,208,75,3,5,2,0,0,1,0,0,TRUE,TRUE,TRUE,TRUE,TRUE,3,0.6786931818188592,0.88,0.04101521715924314,3,0.4572937500001863,0.5198903225785302,1,1,0.006947921250636234,0.0077454189032154334,3,0.5626645161269173,0.6790464285697256,1,0.875,0.016099027698432834,0.017526299959010918,1.343,1.5576,0.3625,0,3.4527,0.003,ML,change,50,4.830669016284437,1.6942035399285442,1.1760276246230958,0.41491702575226,4.2668,6.7033,0.2016,6.7503,0.1413,0,-70.07,0.007,ML,cueing,63,152.56940417917457,3.873033617096072,1.0697389013364613,0.3861050700964329,3.979685681317579,1.0410708428158677,0.3305830673308996,0.093,0.288,0.384,0.008,1.778,187.04404283350047,2086.3405687603326,0.089,0.293,0.383,0.008,1.852,213.6627691383785,2083.877834087889,104,0.3081481481481481,1,0,10,11,FALSE,FALSE,FALSE
432,2021-11-13T06:15:46Z,2021-11-13T06:50:35Z,2089,1,2021-11-13T06:50:36Z,1,Edge,95.0.1020.44,Windows NT 10.0,1366,768,I enjoyed the survey,1.7786458333333333,769,81,741,154,85,164,-0.05189933487576893,-0.07998555706816408,1.5092419656738063,0.6022357247317466,0.18031429226089402,0.9902293563441966,2,4,1,1,4,1,1,3,1,3,3,1,1,1,3,3,1,1,3,3,1.145931016569864,0,1,2,3,3,1.45,0,2,3,3,2,3,5,2,4,4,5,5,2,2,1,2,4,5,5,3,4,4,5,4,6,2,3,50,3,2,3,2,2,2,1,1,2,5,2,5,5,2,5,2,5,5,5,5,5,2,5,5,5,5,5,4,5,5,5,2,4,4,5,5,5,4,4,5,5,1.4745081126172803,1.3093073414159542,4.25,0,4.5,0,3.933333333333333,0,4,0,4.75,0,4.666666666666667,0,4.285714285714286,0,5,0,4.54054054054054,0,3,3,6,2.6104478011483163,2.6482509963270675,2.629349398737692,3,4,1,4,1,3,4,6,4,1.3451854182690985,3.4285714285714284,0,5,2.0257742826883454,1,4,3,4,2,1,5,5,3,2,2,1.5735915849388864,2.2857142857142856,0,3.7142857142857144,5,3.8333333333333335,3.2559414990859232,0.38995568780511447,0,0.8962622572200118,2,2,3,1,2,2,4,2,2,4,1,4,2,4,3,2,4,3,5,4,1.162919151265879,2,0,4,0,4.2,0,3.4,0,3.8666666666666667,0,2,1,1,4,2,2,2,3,2,2,2,3,2,1,2,3,2,2,2,2,0.7181848464596079,1.8,0,"White, Caucasian, Anglo, European American",0,21,0,1,NA,1,2,3,Factory Employee,2,0,152,74,4,5,2,0,1,3,0,1,TRUE,TRUE,TRUE,TRUE,TRUE,3,1.0842289473696758,0.7755102040816326,0.10866586583424077,3,0.6693781249988824,0.7552468750011175,1,1,0.038970809505978435,0.03610589741017762,3,1.1069249999988824,1.314828125,1,1,0.06449302645361911,0.1628523001507486,1.5168,0.858,0.5909,0,31.8831,0.003,ML,change,49,-52.09073910566812,0.9083967063554048,1.364702093539949,0.6703245929490873,2.2184,3.5261,0.4407,2.6935,0.2576,0,-25.9735,0.006,ML,cueing,64,64.42364925007902,2.6358334094227396,1.5718499930915206,0.46639522084045193,2.585994742454535,1.6021435227122756,0.36928537690722535,0.208,0.375,0.265,0.008,1.216,26.201544980712,1821.4875257396568,0.205,0.388,0.275,0.006,1.263,21.644040984101775,1802.6874545375563,346,1.0251851851851852,1,0,1,2,FALSE,FALSE,FALSE
433,2021-11-13T05:51:13Z,2021-11-13T06:53:42Z,3749,1,2021-11-13T06:53:43Z,1,Chrome,95.0.4638.69,Windows NT 10.0,1477,831,N/A,1.7773766546329723,1954,43,666,52,121,76,2.992800580935535,-0.4252056129690901,1.1481740306032573,-0.6407777417406959,0.6775484391873082,-0.4962109186108739,4,3,2,2,3,1,2,3,1,3,3,2,1,2,3,3,2,1,3,3,0.8750939799154206,0,1,1,2,3,1.75,0,2,4,4,3,3,3,3,3,3,3,3,3,3,3,3,4,4,2,3,3,3,3,4,0,2,0,0,3,3,4,4,3,3,4,4,4,2,3,3,3,4,1,4,1,3,3,3,3,3,1,1,1,3,1,1,2,1,1,3,3,3,1,1,1,1,2,3,3,1.1455620071878747,0.45773770821706344,3.25,0,2.25,0,3.066666666666667,0,2.4444444444444446,0,2.4166666666666665,0,1.5,0,1.8571428571428572,0,1,0,2.108108108108108,0,0,0,0,0.7629160366434483,-0.34523475369180734,0.2088406414758205,4,1,4,2,1,5,5,4,6,1.7728105208558367,2.5714285714285716,0,5,1.51297117175748,4,4,4,4,3,3,2,7,7,5,3,0.7867957924694432,3.7142857142857144,0,2.2857142857142856,2,3.8333333333333335,3.2559414990859232,-1.3043345419688306,0,-0.7475928318813282,2,2,2,2,2,2,4,2,2,4,2,4,2,4,2,2,4,4,4,3,1,2,0,3.6,0,4,0,3.4,0,3.6666666666666665,0,2,2,1,3,2,1,2,3,2,2,1,3,2,2,1,3,1,1,2,1,0.7451598203705946,1.65,0,"Asian or Asian American (e.g., Chinese, Japanese, and others)",0,21,0,1,NA,1,4,3,Full-time college student,6,0,170,65,2,5,2,0,0,0,0,0,TRUE,TRUE,TRUE,TRUE,TRUE,4,0.9240968749979511,0.6530612244897959,0.1367302666585981,4,0.6759750000024214,0.7976300000001987,1,0.967741935483871,0.05702553419443631,0.07526218064589452,4,0.8569741935470412,0.9006766666680575,1,0.9375,0.052953451978067854,0.06576849383224978,1.7297,0.4011,0.3363,0,51.7454,0.003,ML,change,49,-91.81533910566812,0.46083410802848346,1.3725602070765452,0.46821537160862575,1.6144,2.0664,0.4288,2.8379,0.3915,0,-18.7435,0.005,ML,cueing,63,49.9164041791746,2.0105292280057454,1.6916925823733595,0.4040641907093317,2.3512302133529857,1.7621135960494447,0.3129634291918893,0.071,0.562,0.227,0.172,1.012,116.60638297325487,1973.7306877252477,0.073,0.562,0.226,0.137,1.076,136.0020092250822,1980.0816053113142,255,0.7555555555555555,1,1,13,14,FALSE,FALSE,FALSE
435,2021-11-13T06:38:42Z,2021-11-13T06:54:51Z,969,1,2021-11-13T06:54:53Z,1,Chrome,95.0.4638.69,Windows NT 10.0,1920,1080,NA,1.7777777777777777,577,51,182,39,40,50,-0.5452178022477271,-0.35252770646363196,-1.1819177103853533,-0.7992010266832621,-0.4412283913971238,-0.9353864543930538,2,1,3,3,2,2,3,2,3,2,2,3,4,4,2,2,3,4,2,3,0.8207826816681233,0,1,2,3,2,3.1,0,5,4,3,4,1,1,4,1,1,1,1,4,1,4,4,1,1,1,1,1,1,1,1,1,4,0,0,5,4,4,4,3,4,2,5,5,2,5,3,1,5,2,5,1,1,2,2,2,5,1,1,1,1,1,1,3,3,3,5,1,2,1,1,1,1,1,1,2,1.5849328099361222,1.5946338585572373,1,0,1.25,0,1.5333333333333334,0,2,0,1.5833333333333333,0,0.8333333333333334,0,1.8571428571428572,0,1,0,1.6216216216216217,0,1,0,0,-1.072032998953958,-0.4557470907642554,-0.7638900448591067,5,1,4,1,1,1,1,1,1,1.7320508075688772,1.1428571428571428,0,1,-0.8176513788914915,5,5,5,5,4,4,1,7,8,6,5,1.4638501094227998,4.714285714285714,0,1.2857142857142858,1.5,3.8333333333333335,3.2559414990859232,-1.5867162469311549,0,-1.4464806663125476,3,3,3,3,3,3,4,2,2,4,1,4,2,3,4,1,4,1,4,2,1.2227992865708155,3,0,4.2,0,4.2,0,3.8,0,4.066666666666666,0,3,1,1,3,1,1,3,3,1,2,3,3,4,3,2,3,1,1,2,3,1.0052493799000692,2,0,"Asian or Asian American (e.g., Chinese, Japanese, and others)",0,22,0,1,NA,1,3,6,Product Development,5,0,140,69,3,5,2,0,0,1,0,0,TRUE,TRUE,TRUE,TRUE,TRUE,3,0.5801111111135946,0.72,0.01428670612236901,3,0.44328387096620375,0.5245899999986092,0.96875,0.9375,0.00684076418370719,0.004043709828460586,3,0.5391624999982305,0.5996000000007691,1,0.96875,0.004436134032236067,0.005719382248326065,0.8968,1.0627,0.4207,0,-11.3555,0.004,ML,change,50,34.44706901628444,1.1826964243819238,0.7985663855662929,0.43156529563402457,0.8554,3.2804,0.4089,4.2182,0.3572,0,-83.0583,0.008,ML,cueing,64,178.59324925007903,3.696597632329382,0.732579109345951,0.4378877423507053,3.678617748995096,0.9334993301283405,0.32433217746198073,0.087,0.359,0.489,0.025,1.787,145.5850131474527,2019.5486841369386,0.087,0.36,0.488,0.025,1.904,176.08051609843727,2003.3586911467694,240,0.7111111111111111,1,0,2,3,FALSE,FALSE,FALSE
436,2021-11-13T06:39:59Z,2021-11-13T06:58:43Z,1123,1,2021-11-13T06:58:43Z,1,Chrome,95.0.4638.69,Windows NT 10.0,1920,1080,NA,1.7777777777777777,660,34,239,49,34,63,-0.3319603397900577,-0.5069682577877305,-0.9075060797317359,-0.6773369613428266,-0.5241007492181928,-0.7157986865019639,3,3,1,1,3,1,1,3,1,2,2,2,1,3,3,3,2,2,2,3,0.8522416262267903,0,1,1,5,5,1.9,0,4,4,1,4,1,1,4,1,1,1,1,4,1,4,4,1,1,1,1,1,1,1,1,1,2,1,1,4,4,4,4,4,4,3,3,4,1,1,1,1,3,1,3,2,1,1,1,1,5,1,1,1,1,1,1,2,2,1,4,3,1,1,1,1,2,1,2,2,1.3495633817354862,1.5491933384829668,1,0,1.75,0,1.4666666666666666,0,2.2222222222222223,0,1.75,0,0.8333333333333334,0,1.5714285714285714,0,1,0,1.6756756756756757,0,1,1,1,-1.0774532514064032,0.08413816916243128,-0.496657541121986,4,1,2,2,1,1,1,1,1,1.1126972805283737,1.7142857142857142,0,1,-0.4757826382709144,4,4,4,3,3,3,1,1,1,1,2,1.0690449676496976,3.7142857142857144,0,2.2857142857142856,8,3.8333333333333335,3.2559414990859232,2.0842459175790595,0,0.946697397892617,2,2,2,2,2,2,3,3,2,3,1,2,3,2,3,3,4,1,2,3,0.8338093878327919,2,0,4,0,2.8,0,3,0,3.2666666666666666,0,1,1,1,2,1,1,1,3,2,2,1,3,1,1,1,3,1,1,1,1,0.7591546545162482,1.35,0,"Hispanic of Latino (e.g., Mexican American, Central American, and others)",0,22,0,1,NA,1,2,4,Unemployed,1,0,245,70,1,5,2,0,0,1,0,0,TRUE,TRUE,TRUE,TRUE,TRUE,6,0.8298885714279753,0.7142857142857143,0.04028388273040863,6,0.4446785714285714,0.56696666666617,0.9032258064516129,0.9375,0.004712153978600934,0.017158363941265995,6,0.5077833333303531,0.5414592592622395,0.9375,0.8709677419354839,0.00416973741925732,0.004942486516204387,1.3125,0.7415,0.4803,0,22.9862,0.004,ML,change,49,-34.29693910566812,0.8875990946696103,1.0323249960222465,0.5806628787970406,1.116,2.1377,0.3294,2.913,0.2823,0,-37.8009,0.005,ML,cueing,63,88.0312041791746,2.5755987645050946,1.051425493140647,0.38836794252156415,3.151059786360981,0.7088384140392875,0.35397196459679275,0.044,0.387,0.332,0.039,1.871,56.55370892109849,2039.971478289231,0.044,0.387,0.341,0.037,1.981,81.35191226193004,2064.69920547761,356,1.0548148148148149,1,0,0,1,FALSE,FALSE,FALSE
438,2021-11-13T06:31:52Z,2021-11-13T07:01:15Z,1763,1,2021-11-13T07:01:17Z,1,Firefox,94.0,Macintosh,1440,900,NA,1.6,804,124,460,65,45,90,0.03802851073891094,0.3106581903986732,0.15644076894281556,-0.4823544567981297,-0.37216809321289956,-0.2597317839589309,3,3,2,1,2,1,2,2,1,3,3,1,1,2,3,3,4,1,2,2,0.9119095061289915,1,1,1,4,4,2,0,4,5,2,4,2,2,4,2,2,2,2,4,2,4,5,1,2,1,1,1,1,2,2,1,3,0,0,5,3,3,4,4,4,3,3,4,2,5,2,2,3,2,5,1,2,2,3,3,4,1,1,1,1,2,1,2,1,1,5,1,3,2,2,1,2,2,2,2,1.324860466334193,1.2227992865708155,1.375,0,2,0,1.8666666666666667,0,2.3333333333333335,0,2,0,1.1666666666666667,0,1.2857142857142858,0,1.6666666666666667,0,1.837837837837838,0,1,0,0,-0.6747091361452571,-0.22054348261253207,-0.4476263093788946,4,3,3,3,2,3,3,3,1,0.5773502691896257,2.7142857142857144,0,2,0.49147533258947784,3,3,4,4,1,1,2,6,4,4,3,1.2724180205607036,2.857142857142857,0,3.142857142857143,4,3.8333333333333335,3.2559414990859232,-0.1748077221195339,0,0.2951965625719407,2,2,2,3,2,2,3,2,2,2,1,4,2,3,4,2,3,1,4,3,0.990430401872025,2.2,0,4.2,0,3.4,0,3.6,0,3.7333333333333334,0,2,1,2,3,1,2,2,2,1,1,1,3,3,2,1,2,1,2,1,2,0.7163503994113789,1.75,0,"Asian or Asian American (e.g., Chinese, Japanese, and others) & Filipino",1,19,0,1,NA,1,3,4,Student,4,0,135,66,3,5,2,0,0,0,0,0,TRUE,TRUE,TRUE,TRUE,TRUE,2,1.113658536585366,0.8367346938775511,0.1231800399659864,2,0.47090625,0.5291612903225806,1,1,0.0011783457661290325,0.0018830731182795694,2,0.5783125,0.6796875,1,1,0.008861576612903226,0.008176157258064516,1.6104,1.0601,0.6478,0,29.4205,0.003,ML,change,49,-47.165539105668124,1.1077257569556214,1.4752121766271615,0.6652125944541454,7.3323,12.6491,0.2393,14.6042,0.2199,0,-117.3231,0.017,ML,cueing,63,247.0756041791746,5.515637281646505,0.7511615639008701,0.46319540751785226,6.201465156751088,0.6680896565033829,0.41872407704744546,0.173,0.325,0.703,0.016,1.76,8.193714913533867,1797.5904919391974,0.176,0.321,0.712,0.015,1.747,18.242815068759235,1799.46241543541,432,1.28,1,0,0,1,FALSE,FALSE,FALSE
439,2021-11-13T06:44:18Z,2021-11-13T07:09:06Z,1487,1,2021-11-13T07:09:06Z,1,Chrome,95.0.4638.69,Windows NT 10.0,1536,864,NA,1.7777777777777777,929,45,234,99,53,58,0.3591993879341962,-0.40703613634272556,-0.9315772754031059,-0.06801663464064889,-0.2616716161181409,-0.8002555203062293,2,4,2,1,3,1,2,4,1,4,2,2,1,1,4,3,2,1,3,3,1.1285761872936695,0,1,1,4,4,1.6,0,5,5,2,5,2,2,5,2,1,1,1,4,1,4,1,1,5,1,1,1,3,3,1,0,2,0,0,5,3,4,4,1,5,4,5,5,1,5,4,1,4,1,4,1,1,1,2,4,2,1,1,1,2,1,1,1,1,1,5,1,1,1,1,1,1,1,1,1,1.653552005300781,1.709915063331955,2,0,1,0,1.6666666666666667,0,2,0,1.75,0,1.5,0,0.8571428571428571,0,1,0,1.5945945945945945,0,0,0,0,-0.5965994266966284,-0.7372407672780129,-0.6669200969873206,5,1,5,1,1,1,1,1,1,1.9518001458970664,1,0,1,-0.9031185640466358,5,5,5,5,3,3,1,6,7,5,3,1.5735915849388864,4.428571428571429,0,1.5714285714285714,2.5,3.8333333333333335,3.2559414990859232,-1.0219528370065065,0,-1.00475696650735,4,5,4,2,3,4,2,5,3,1,4,3,2,2,3,4,3,4,5,4,1.162919151265879,3.6,0,2.4,0,2.8,0,2.2,0,2.466666666666667,0,1,3,1,2,2,2,3,2,1,1,2,2,3,3,1,2,1,2,2,3,0.7591546545162482,2.15,0,"White, Caucasian, Anglo, European American",0,19,0,1,NA,1,4,4,Student,6,0,190,70,2,5,2,0,0,0,0,0,TRUE,TRUE,TRUE,TRUE,TRUE,3,0.911884210526306,0.76,0.03490334963674074,3,0.516737500000003,0.6010166666666589,1,1,0.027091165645160065,0.014913149712647749,3,0.6255483870967742,0.7236187499999979,0.96875,1,0.008760230554435628,0.008295118346775373,1.3574,0.9418,0.5477,0,19.2105,0.003,ML,change,50,-26.68493098371556,1.132169319194605,1.0181158333793845,0.6780763231451609,1.3051,4.0197,0.4387,4.0685,0.3563,0,-69.627,0.005,ML,cueing,62,151.63540315513526,3.2879117324993814,1.2601112996552477,0.4153771299548486,2.8320803546337876,1.4629297927979432,0.26653039792145594,0.183,0.36,0.691,0.012,1.334,165.4332985951727,2035.9597574446773,0.189,0.357,0.706,0.013,1.444,200.02840541256498,2041.567279798741,339,1.0044444444444445,1,1,2,3,FALSE,FALSE,FALSE
440,2021-11-13T06:38:51Z,2021-11-13T07:14:52Z,2160,1,2021-11-13T07:14:53Z,0.8999999761581421,Chrome,95.0.4638.69,Macintosh,1280,800,Survey went by smoothly.,1.6,1193,74,521,98,68,123,1.0375122805706387,-0.14357872526043994,0.45010935613352887,-0.08020304117469244,-0.054490721565468275,0.2976833191492206,4,1,1,1,4,1,1,4,1,4,3,1,1,1,4,3,1,1,4,4,1.446411166701189,0,1,2,3,3,1.25,0,4,5,2,4,2,1,3,2,2,1,1,5,3,5,4,1,1,1,1,1,1,1,1,1,2,0,2,5,3,4,4,3,5,5,5,5,1,4,2,2,3,2,5,1,1,1,1,1,4,2,1,1,3,1,1,3,1,1,5,1,2,1,1,1,1,1,2,2,1.5920221526519456,1.486446705914413,1,0,1.5,0,1.7333333333333334,0,1.6666666666666667,0,1.5,0,1.5,0,1.2857142857142858,0,1,0,1.5135135135135136,0,1,0,2,-1.032542588229001,-0.024446594248652788,-0.5284945912388268,5,1,3,1,1,2,2,1,1,1.4638501094227998,1.5714285714285714,0,1,-0.5612498234260587,5,5,5,3,3,3,3,1,1,NA,2,1.0690449676496976,3.857142857142857,0,2.142857142857143,8,3.8333333333333335,3.2559414990859232,2.0842459175790595,0,0.8670264004711803,1,2,2,2,2,1,5,1,1,1,1,4,2,3,5,3,5,2,3,3,1.5430334996209192,1.8,0,4.6,0,3.2,0,4.2,0,4,0,1,1,1,3,1,1,2,3,1,1,1,3,1,1,1,3,1,1,1,1,0.8255779474818965,1.25,0,"Hispanic of Latino (e.g., Mexican American, Central American, and others)",0,27,0,1,NA,1,2,6,Currently unemployed.,7,0,200,73,2,5,2,0,0,1,0,0,TRUE,TRUE,TRUE,TRUE,TRUE,5,1.3407282051280713,0.78,0.38590284016736986,5,0.48356562499981376,0.5582781250001863,1,1,0.0011865752318470238,0.003511965635078265,5,0.6606937499997438,0.8020468749998836,1,1,0.008620976088601443,0.011028099344754568,1.8294,0.6789,0.5934,0,55.6683,0.003,ML,change,50,-99.60053098371557,0.6737059265125548,1.8786629648383981,0.5599340790058204,3.7566,8.2204,0.3298,11.5385,0.3208,0,-110.1107,0.011,ML,cueing,64,232.698049250079,4.7198144977716066,0.8778172803926203,0.46819137574533226,6.190684547466868,0.6692530841499328,0.4312015511805834,0.163,0.363,0.565,0.009,1.621,19.635961174117167,1808.2980131007237,0.167,0.363,0.567,0.011,1.697,30.958588224508667,1813.1995853085918,105,0.3111111111111111,1,1,4,5,FALSE,FALSE,FALSE
441,2021-11-13T06:50:58Z,2021-11-13T07:15:24Z,1466,1,2021-11-13T07:15:25Z,1,Chrome,95.0.4638.69,Windows NT 10.0,1920,1080,NA,1.7777777777777777,807,55,331,71,57,87,0.045736611791597784,-0.31618875321090295,-0.464596079378529,-0.4092360175938684,-0.2064233775707615,-0.31040588424149007,3,2,2,2,3,1,1,1,1,3,1,1,1,1,3,1,1,1,2,2,0.812727700887249,0,1,1,5,3,2.05,0,2,3,5,2,3,4,1,5,3,3,4,2,3,1,3,4,5,2,2,4,4,3,3,0,3,0,0,4,2,4,4,4,4,5,5,2,2,4,5,3,3,3,4,5,5,3,5,5,3,1,1,1,2,1,3,1,1,1,2,4,4,3,4,5,3,1,1,1,1.4305755997312923,1.2227992865708155,3.375,0,1.5,0,3.8666666666666667,0,2.2222222222222223,0,3.5833333333333335,0,1.3333333333333333,0,2.4285714285714284,0,4,0,2.7567567567567566,0,0,0,0,1.439189320308343,-0.5804383618435307,0.42937547923240615,1,5,1,5,3,4,4,4,2,1.7043362064926932,4.428571428571429,0,3,1.8860692292255914,2,2,3,3,1,1,4,3,3,2,2,1.1126972805283737,2,0,4,6,3.8333333333333335,3.2559414990859232,0.9547190977297628,0,1.3379859570252095,1,1,2,3,2,1,5,2,1,3,1,4,1,4,4,1,5,1,4,2,1.5946338585572373,1.8,0,4.8,0,4.4,0,4.2,0,4.466666666666667,0,2,3,2,1,2,4,4,1,4,1,2,1,2,3,2,1,1,2,3,3,1.0563093645728086,2.8,0,"Hispanic of Latino (e.g., Mexican American, Central American, and others) & Native Hawaiian or other Pacific Islander",1,25,0,1,NA,1,2,6,Unemployed,1,0,140,72,2,5,2,0,0,1,0,0,TRUE,TRUE,TRUE,TRUE,TRUE,5,1.0643902439053465,0.82,0.06250767347080782,5,0.5012258064554583,0.5407187499962747,0.96875,1,0.004036219314659713,0.0033027306045624433,5,0.6283999999910593,0.6855281250104308,1,1,0.010948115484307505,0.008070254342888716,1.8096,0.966,0.5097,0,37.622,0.003,ML,change,50,-63.50793098371556,1.2359348267043408,1.226883049660051,0.7467338696302536,1.5882,4.6718,0.3707,4.5816,0.3357,0,-74.3101,0.01,ML,cueing,64,161.09684925007903,4.792854076687388,0.86443998922143,0.45335679132205475,4.197272131671908,0.8181473816226634,0.4098553703472662,0.213,0.259,0.598,0.018,1.495,31.46734388925021,1818.2938853223027,0.207,0.273,0.608,0.018,1.568,43.92043841639732,1826.3897617010034,104,0.3081481481481481,1,1,3,4,FALSE,FALSE,FALSE
443,2021-11-13T06:48:41Z,2021-11-13T07:18:30Z,1789,1,2021-11-13T07:18:31Z,0.8999999761581421,Chrome,95.0.4638.54,Windows NT 10.0,1366,768,The colored dot game was very hard for me compared to the other games; it was hard to tell when they moved a lot of the time.,1.7786458333333333,667,74,530,110,91,101,-0.3139747706671217,-0.14357872526043994,0.49343750834199473,0.0660338372338302,0.26318665008196307,-0.07392674958954705,2,3,3,3,2,2,1,2,1,2,1,1,1,3,1,2,1,1,2,1,0.7863975156570492,0,1,1,3,4,2.45,0,4,3,5,4,3,5,4,3,3,2,2,4,1,4,4,4,2,5,3,4,3,5,4,0,3,0,0,5,1,4,3,4,5,2,2,3,2,5,2,2,2,2,3,5,4,5,5,1,3,1,4,3,1,1,1,1,1,1,2,5,3,1,2,2,2,3,1,1,1.4729798605784363,1.121223821162776,3.75,0,1.75,0,2.6,0,2.7777777777777777,0,3,0,2,0,2.142857142857143,0,1.6666666666666667,0,2.5675675675675675,0,0,0,0,0.9746930431782689,-0.5020371591262895,0.23632794202598967,5,1,3,1,1,3,1,1,1,1.5735915849388864,1.5714285714285714,0,1,-0.5612498234260587,5,5,5,5,3,4,2,5,4,3,2,1.2149857925879117,4.428571428571429,0,1.5714285714285714,4.5,3.8333333333333335,3.2559414990859232,0.10757398284279028,0,-0.4399935565827014,3,3,3,3,3,3,5,4,2,3,2,3,5,4,3,5,4,3,2,4,1.0600988273786194,3,0,3.4,0,2.4,0,3,0,2.933333333333333,0,1,2,4,2,3,4,3,1,4,1,2,2,2,3,1,1,2,3,2,3,1.0310954828418375,2.7,0,"White, Caucasian, Anglo, European American",0,23,0,1,NA,1,1,3,N/A,2,0,230,69,1,5,2,0,0,0,0,0,TRUE,TRUE,TRUE,TRUE,TRUE,6,1.089739999985695,0.8,0.13091249012922296,6,0.3888071428707668,0.411977777754819,0.9032258064516129,0.84375,0.0013698809454670466,0.0033196094240203495,6,0.5540062500014901,0.6590645161136505,1,0.96875,0.003658554150272166,0.010674039023802874,1.9983,0.789,0.3766,0,51.2759,0.004,ML,change,50,-90.81573098371557,0.9539166439342892,1.4532657228857262,0.6326982661633522,0.7875,2.2368,0.2847,3.82,0.3034,0,-71.7794,0.01,ML,cueing,63,155.9882041791746,2.8024810904647475,0.6017521257531718,0.3381673624298222,4.291319058738719,0.5204908306593216,0.3399001909358155,0.075,0.425,0.59,0.017,1.746,49.44202671174617,1887.789798581325,0.077,0.423,0.579,0.018,1.848,60.16497892913149,1886.9159054281884,336,0.9955555555555555,1,0,0,1,FALSE,FALSE,FALSE
444,2021-11-13T07:00:40Z,2021-11-13T07:19:45Z,1145,1,2021-11-13T07:19:48Z,1,Chrome,95.0.4638.69,Windows NT 10.0,1920,1080,NA,1.7777777777777777,607,33,284,73,48,64,-0.4681367917208586,-0.5160529961009127,-0.6908653186894065,-0.38486320452578127,-0.3307319143023651,-0.6989073197411108,4,4,1,1,4,1,1,3,1,4,3,1,1,1,4,4,1,1,4,4,1.465390194130093,0,1,2,4,4,1.1,0,4,5,1,5,1,1,4,1,1,1,1,4,1,4,3,1,3,1,1,1,1,1,1,1,2,0,0,5,5,5,5,5,5,4,4,4,1,5,1,1,2,1,4,1,1,1,1,1,4,1,1,1,1,1,1,2,2,1,5,1,1,1,1,1,1,1,2,2,1.735514912644663,1.6846647257229665,1.25,0,1.5,0,1.4,0,1.3333333333333333,0,1.3333333333333333,0,1,0,1.1428571428571428,0,1,0,1.2702702702702702,0,1,0,0,-1.172888410658384,-0.3773458880470143,-0.7751171493526992,5,1,5,1,1,1,1,1,2,1.9518001458970664,1,0,1.5,-0.7186247266594448,5,5,5,5,3,2,1,7,6,6,4,1.7043362064926932,4.285714285714286,0,1.7142857142857142,2.5,3.8333333333333335,3.2559414990859232,-1.0219528370065065,0,-0.9250859690859132,2,2,2,2,2,2,4,2,2,5,4,4,1,4,4,1,5,4,4,4,1.3451854182690985,2,0,3.4,0,4.6,0,3.6,0,3.8666666666666667,0,1,1,1,3,2,2,2,2,2,1,1,2,1,3,1,2,1,3,1,1,0.7451598203705946,1.75,0,"White, Caucasian, Anglo, European American",0,20,0,1,NA,1,4,3,Student,6,0,170,70,3,5,2,0,0,1,0,0,TRUE,TRUE,TRUE,TRUE,TRUE,1,0.779262500000745,0.8333333333333334,0.02475863808539215,1,0.4357064516135762,0.5152366666659712,0.96875,0.9375,0.0010228929738501785,0.002855373135066533,1,0.6058812500000931,0.693467741936926,1,0.96875,0.011127475121083301,0.01669126387058847,1.2284,1.4715,0.5051,0,-1.4612,0.004,ML,change,48,14.536003032723674,1.6345105975653298,0.984660432811769,0.5784561272800745,0.7476,3.4033,0.4139,5.8613,0.3779,0,-103.853,0.007,ML,cueing,64,220.182649250079,4.032565772752172,0.6715452031558562,0.4423795719681278,5.915660855646069,0.5804908848362487,0.38970903747728625,0.08,0.384,0.335,0.019,1.936,92.52775173309618,1937.0436837252694,0.085,0.367,0.364,0.021,2.101,95.22065712696883,1920.0417019454987,326,0.965925925925926,1,1,2,3,FALSE,FALSE,FALSE
445,2021-11-13T06:52:28Z,2021-11-13T07:19:52Z,1644,1,2021-11-13T07:19:53Z,1,Chrome,94.0.4606.81,Macintosh,1920,1080,No thank you,1.7777777777777777,831,56,425,92,67,106,0.10740142021309255,-0.30710401489772066,-0.012057600756774062,-0.15332148037895377,-0.06830278120231312,0.010530084214718316,2,2,1,1,2,2,2,2,1,2,1,1,1,2,2,2,2,1,2,2,0.4893604849295929,0,1,2,3,3,2.25,0,4,4,2,3,2,1,4,2,2,1,2,3,2,3,3,2,3,1,1,1,2,1,2,2,2,0,0,5,5,3,4,4,5,5,5,4,2,4,2,2,2,2,3,3,3,4,3,3,4,1,1,1,4,2,1,2,1,1,4,3,2,1,3,1,2,2,2,2,1.364500590641815,0.990430401872025,1.625,0,2,0,2.1333333333333333,0,1.5555555555555556,0,2.75,0,1.6666666666666667,0,1.5714285714285714,0,1.6666666666666667,0,2.027027027027027,0,1,0,0,-0.3713685792530602,-0.22054348261253207,-0.29595603093279615,4,1,3,1,1,1,1,1,1,1.2535663410560174,1.4285714285714286,0,1,-0.6467170085812028,4,3,4,3,2,2,3,3,3,3,3,0.816496580927726,3,0,3,6,3.8333333333333335,3.2559414990859232,0.9547190977297628,0,0.7802889750751523,3,3,3,2,3,3,4,2,2,3,2,3,3,3,4,3,3,3,3,3,0.5936168397046637,2.8,0,3.2,0,3.2,0,3.6,0,3.3333333333333335,0,2,2,3,2,2,3,2,1,2,2,2,1,3,3,2,2,2,3,3,3,0.6386663736585051,2.65,0,"White, Caucasian, Anglo, European American & Filipino",1,19,0,1,NA,1,3,3,College student,3,0,165,70,4,5,2,0,0,1,0,0,TRUE,TRUE,TRUE,TRUE,TRUE,1,0.8736692307545588,0.78,0.05239145356835077,1,0.4346062500104308,0.5064548386681464,1,0.96875,0.0010685489928681045,0.005435951249091916,1,0.5790468750149012,0.6291812499985099,1,1,0.0037263535372033616,0.0034953944764558155,1.4646,0.9627,0.4818,0,24.1807,0.003,ML,change,50,-36.625330983715564,1.1098767392673035,1.1403666087883044,0.5859772383342867,1.1752,3.9787,0.3662,6.8087,0.3483,0,-97.7775,0.007,ML,cueing,64,208.03164925007903,3.8962061590669417,0.8813669154784953,0.40041816484658377,6.35497555784242,0.6519513236016552,0.38491464703017236,0.155,0.361,0.723,0.034,1.862,78.23068836030126,1869.2906364096646,0.152,0.368,0.731,0.032,1.844,102.20386660304514,1883.1205060210682,304,0.9007407407407407,1,0,0,1,FALSE,FALSE,FALSE
446,2021-11-13T06:48:03Z,2021-11-13T07:19:53Z,1910,1,2021-11-13T07:19:55Z,0.8999999761581421,Chrome,95.0.4638.69,Windows NT 10.0,2560,1440,NA,1.7777777777777777,777,238,493,182,87,91,-0.03134439873527067,1.3463183581014513,0.3153106603738572,0.9434551076849661,0.20793841153458367,-0.2428404171980778,4,3,1,2,3,2,3,4,1,4,4,2,3,2,3,4,2,1,3,4,1.0699237552766379,1,1,1,2,1,1.65,0,4,3,3,3,3,2,4,4,3,1,4,2,2,4,3,3,5,1,1,2,3,3,3,1,2,0,2,4,3,1,1,1,1,1,1,1,3,2,1,1,1,1,3,5,5,4,5,5,2,4,1,1,4,1,1,1,1,1,1,4,3,1,3,2,1,1,1,1,1.4876872027456622,0.9258200997725514,2.625,0,1,0,2.7333333333333334,0,4.444444444444445,0,3.5,0,2.3333333333333335,0,2.142857142857143,0,2,0,3.2162162162162162,0,1,0,2,0.8272815345162342,-0.18124899968313501,0.3230162674165496,4,2,1,1,1,2,1,1,3,1.1126972805283737,2,0,2,0.06413940681375631,2,3,3,2,1,3,5,3,1,1,1,1.2535663410560174,2.142857142857143,0,3.857142857142857,7,3.8333333333333335,3.2559414990859232,1.5194825076544112,0,1.5406966645660969,4,3,3,3,4,4,5,3,3,4,3,3,2,4,4,5,5,2,1,3,1.1832159566199232,3.4,0,3.4,0,3,0,3.4,0,3.2666666666666666,0,3,3,2,2,4,2,3,2,3,1,2,3,2,3,2,3,1,2,3,3,0.7591546545162482,2.45,0,"White, Caucasian, Anglo, European American",0,25,0,1,NA,1,2,1,Unemployed,2,0,160,67,2,5,2,0,0,0,0,0,TRUE,TRUE,TRUE,TRUE,TRUE,2,0.7530205882366966,0.6938775510204082,0.014983831249830092,2,0.7472062499942258,0.9057419354848323,1,0.96875,0.011866689637120804,0.018463897257578413,2,0.9729781249985099,1.0526281249988825,1,1,0.02432186627985378,0.015929456279693787,1.1694,0.7584,0.4592,0,11.6931,0.004,ML,change,49,-11.71073910566812,1.0230604130971666,0.7998651037983533,0.6014402069749101,2.38,2.8643,0.5067,4.0987,0.4569,0,-31.9532,0.007,ML,cueing,64,76.38304925007901,2.8699872880622372,1.196516520741704,0.7103169865902464,3.4812090059748075,1.1901424819023105,0.5816099690234408,0.315,0.391,0.536,0.022,1.678,40.51571938762794,1845.887733253263,0.314,0.393,0.534,0.021,1.763,59.04222874131061,1841.0138656598112,104,0.3081481481481481,1,0,2,3,FALSE,FALSE,FALSE
447,2021-11-13T07:01:39Z,2021-11-13T07:23:34Z,1314,1,2021-11-13T07:23:35Z,1,Chrome,95.0.4638.69,Windows NT 10.0,1920,1080,Have good day! :),1.7777777777777777,753,62,251,86,46,73,-0.09300920715676544,-0.2525955850186271,-0.8497352101204481,-0.2264399195832151,-0.3583560335760547,-0.5468850188934331,3,3,1,1,3,1,1,2,1,3,3,1,1,1,3,3,1,1,3,3,0.998683343734455,0,1,1,3,3,1.55,0,5,5,2,5,2,1,4,1,1,1,1,5,2,5,3,1,1,1,1,1,1,1,1,1,2,0,0,4,1,5,4,3,5,5,5,5,2,5,1,1,4,1,5,1,1,1,1,1,5,1,1,1,1,1,1,2,2,1,5,1,1,1,1,1,1,1,1,1,1.7514472779868562,1.7674302033770737,1,0,1,0,1.4,0,1.8888888888888888,0,1.1666666666666667,0,0.8333333333333334,0,1.1428571428571428,0,1,0,1.3243243243243243,0,1,0,0,-1.2570959041160135,-0.5341482934814965,-0.895622098798755,5,1,5,1,1,2,1,2,2,1.889822365046136,1.1428571428571428,0,2,-0.44866370411710943,5,5,5,5,2,2,1,6,7,5,3,1.8126539343499315,4.142857142857143,0,1.8571428571428572,2.5,3.8333333333333335,3.2559414990859232,-1.0219528370065065,0,-0.8454149716644763,2,3,2,2,2,1,5,2,2,3,1,5,1,4,4,1,5,2,3,4,1.5522640914238175,2.2,0,4.8,0,4.2,0,3.6,0,4.2,0,1,1,1,4,1,1,1,4,1,4,1,4,1,1,1,4,1,1,1,1,1.332784974957958,1.15,0,"White, Caucasian, Anglo, European American",0,19,0,1,NA,1,2,4,Manager at Chick-fil-A,1,0,125,69,1,5,2,1,0,1,0,1,TRUE,TRUE,TRUE,TRUE,TRUE,1,0.9516702702722034,0.7551020408163265,0.10693821558000186,1,0.4519310344858416,0.516448387096005,0.9354838709677419,1,0.006529939848622366,0.014644945247618753,1,0.6087874999977648,0.6318518518507481,1,0.8709677419354839,0.020825563709762306,0.013520757569278565,1.5402,0.7583,0.4528,0,36.6194,0.003,ML,change,49,-61.56333910566812,0.8381885988159221,1.3433865176010487,0.542811640210561,1.2008,3.3349,0.3364,3.3514,0.288,0,-57.228,0.009,ML,cueing,62,126.83740315513528,3.302862972503011,1.2544070889055798,0.33248573446794893,3.254932079117189,0.8215681877306077,0.3420117839576047,0.074,0.339,0.305,0.024,1.861,101.88165226101346,2068.245486420177,0.066,0.361,0.265,0.026,2.066,106.25382814615885,2014.7344693987225,310,0.9185185185185185,1,0,0,1,FALSE,FALSE,FALSE
448,2021-11-13T07:02:25Z,2021-11-13T07:28:50Z,1584,1,2021-11-13T07:28:50Z,1,Chrome,95.0.4638.69,Windows NT 10.0,1920,1080,NA,1.7777777777777777,723,60,392,98,76,182,-0.17009021768363392,-0.2707650616449916,-0.1709274921878157,-0.08020304117469244,0.05600575552929045,1.294273958039552,3,2,1,2,2,1,3,4,1,3,3,1,2,2,2,3,2,1,2,4,0.9514531821875089,0,0,3,4,5,1.9,0,2,5,1,3,1,2,4,2,1,1,3,5,5,5,3,1,1,1,1,1,1,1,2,1,2,0,0,4,2,3,3,2,4,2,4,3,1,5,1,1,4,2,4,2,1,1,3,3,5,1,1,1,2,1,1,3,3,1,5,1,2,1,1,1,2,1,1,1,1.3512312258920847,1.5976172734359604,1.125,0,1.25,0,2.066666666666667,0,3,0,1.6666666666666667,0,1,0,1.5714285714285714,0,1,0,1.864864864864865,0,1,0,0,-0.6845817388264964,-0.4557470907642554,-0.5701644147953759,4,1,3,1,1,2,2,3,1,1.1547005383792515,1.7142857142857142,0,2,-0.10679496349653231,5,5,5,5,3,3,1,2,2,NA,3,1.5735915849388864,4.428571428571429,0,1.5714285714285714,7,3.8333333333333335,3.2559414990859232,1.5194825076544112,0,0.265960705823109,2,2,3,1,1,1,4,2,1,3,1,4,1,4,3,2,4,5,3,4,1.3732131246511903,1.8,0,3.8,0,3.8,0,3.6,0,3.7333333333333334,0,2,1,1,2,1,3,2,3,2,1,2,2,3,3,1,2,2,3,2,2,0.7254762501100116,2.1,0,"White, Caucasian, Anglo, European American",0,19,0,1,NA,1,3,2,furniture factory worker,7,0,176,67,2,5,2,0,0,1,0,0,TRUE,TRUE,TRUE,TRUE,TRUE,2,0.8581268292687289,0.82,0.06431406050593737,2,0.4843843749999069,0.5884225806440077,1,1,0.00845003942553164,0.007383664473053891,2,0.6489999999993015,0.7477806451604251,1,0.96875,0.006752745806463361,0.014415538377184563,1.6852,1.0873,0.4025,0,25.3811,0.005,ML,change,50,-39.02613098371556,1.2271634773091284,1.2356523946532942,0.5359132256206725,2.1485,4.9019,0.3693,5.7246,0.2967,0,-73.7554,0.007,ML,cueing,63,159.9402041791746,3.91962488286372,1.0570232739630212,0.4577989460803428,3.7896387328805923,1.0932796022068942,0.3446461717975041,0.073,0.476,0.416,0.017,1.773,50.139920787763046,1883.8381114307983,0.076,0.474,0.41,0.019,1.851,70.60115397870885,1896.6266300075154,314,0.9303703703703704,1,0,1,2,FALSE,FALSE,FALSE
449,2021-11-13T07:01:36Z,2021-11-13T07:32:57Z,1880,1,2021-11-13T07:32:58Z,0.8999999761581421,Chrome,95.0.4638.69,Windows NT 10.0,1366,768,None,1.7786458333333333,714,111,677,111,83,95,-0.19321452084169444,0.19255659232730382,1.201130661080271,0.07822024376787376,0.15269017298720433,-0.1752749501546655,3,2,2,2,2,1,1,3,2,2,1,2,1,3,2,2,2,2,2,2,0.6048053188292994,0,0,2,2,2,2.35,0,4,4,2,4,2,1,4,2,2,2,1,3,1,4,4,3,3,1,2,2,3,3,3,1,3,0,0,5,3,3,3,1,4,3,3,5,2,4,3,2,2,2,4,3,2,3,2,2,4,1,5,1,1,1,2,3,3,1,4,3,2,2,1,3,2,3,3,3,1.1835965955091712,1.2344267996967353,2.5,0,2.75,0,1.8666666666666667,0,2.6666666666666665,0,2.4166666666666665,0,1.6666666666666667,0,2.142857142857143,0,2,0,2.324324324324324,0,1,0,0,0.01782490487697288,0.01466012553919125,0.016242515208082065,3,2,3,1,1,3,2,2,1,0.8997354108424374,2.142857142857143,0,1.5,-0.03488724541829051,1,2,3,3,1,2,2,1,6,1,2,0.816496580927726,2.2857142857142856,0,3.7142857142857144,5.5,3.8333333333333335,3.2559414990859232,0.6723373927674386,0,1.037453109701174,2,2,2,2,2,2,3,4,2,3,3,3,2,3,3,4,3,2,3,4,0.7037315505489968,2,0,3.4,0,3,0,2.8,0,3.066666666666667,0,1,1,2,3,3,2,2,2,2,1,2,3,3,3,1,2,1,2,3,2,0.7591546545162482,2.05,0,Black or African American,0,28,0,1,NA,0,1,6,Currently unemployed but studied Psychology,1,0,125,68,3,5,2,0,0,0,0,0,TRUE,TRUE,TRUE,TRUE,TRUE,4,0.7654424242415663,0.673469387755102,0.020721780340105807,4,0.5244281250000932,0.62023333333383,1,0.9375,0.0044449317641940085,0.0036750026512124357,4,0.6190612903230133,0.6733678571432828,0.96875,0.9032258064516129,0.005647513619019642,0.005598943333316892,0.981,0.7785,0.5514,0,-2.2386,0.004,ML,change,49,16.15266089433188,0.8403281099754789,0.8614716449837945,0.5876083650809366,1.2695,3.6553,0.4653,4.2308,0.3744,0,-70.5072,0.009,ML,cueing,64,153.49104925007902,3.7860187699213155,0.7152764858475573,0.537578311904866,4.449858690628702,0.9310710776314937,0.4230793891003389,0.047,0.513,0.413,0.007,0.966,167.87956257991456,2150.966348165864,0.046,0.515,0.407,0.008,0.981,186.0120778891301,2142.956292454027,334,0.9896296296296296,1,0,0,1,FALSE,FALSE,FALSE
450,2021-11-13T07:03:49Z,2021-11-13T07:34:48Z,1858,1,2021-11-13T07:34:50Z,1,Chrome,95.0.4638.69,Windows NT 10.0,1536,864,Some questions/ answers are a bit too vague and should account for more factors concerning more complex family dynamics.,1.7777777777777777,716,69,515,120,87,81,-0.1880757868065699,-0.18900241682635124,0.42122392132788494,0.18789790257426575,0.20793841153458367,-0.4117540848066085,2,1,3,4,1,1,4,1,2,1,1,2,3,2,1,1,3,2,1,1,1.0399898784932577,0,1,1,2,1,3.25,0,3,4,5,2,5,3,1,3,4,5,5,2,4,2,2,3,5,5,2,4,5,3,3,3,2,2,2,5,1,2,5,1,5,5,5,2,5,1,1,5,2,5,2,5,5,5,5,5,1,2,5,1,5,5,1,3,3,1,4,1,1,1,5,2,2,2,2,2,1.8079736637376023,1.3451854182690985,3.75,0,2,0,4,0,2.5555555555555554,0,4.5,0,3.6666666666666665,0,1.5714285714285714,0,2.6666666666666665,0,3.2432432432432434,0,2,2,2,1.8667117324949531,0.7487147001683933,1.3077132163316731,4,2,2,2,1,1,1,8,1,1.0690449676496976,1.8571428571428572,0,4.5,0.9011414085945675,1,4,4,3,2,2,4,2,1,NA,2,1.2149857925879117,2.5714285714285716,0,3.4285714285714284,7.5,3.8333333333333335,3.2559414990859232,1.8018642126167355,0,1.4428745247829489,1,1,1,1,1,2,5,1,1,5,2,5,1,5,5,1,5,1,5,1,1.9639610121239315,1,0,4.6,0,5,0,5,0,4.866666666666666,0,4,4,4,1,2,4,4,1,4,4,4,1,4,4,4,1,1,4,4,4,1.348488432516786,3.75,0,"Hispanic of Latino (e.g., Mexican American, Central American, and others)",0,27,0,1,NA,1,2,4,Unemployed,2,0,90,65,1,5,2,0,0,0,0,0,TRUE,TRUE,TRUE,TRUE,TRUE,6,0.911248936196591,0.94,0.04682031478414324,6,0.46906774191702566,0.54235,0.96875,0.9375,0.0034525787075830277,0.004683184153033572,6,0.6619718750119209,0.7239187500476837,1,1,0.013527470483496343,0.015585897056015386,1.5393,1.8483,0.5585,0,0.9385,0.014,ML,change,50,9.859069016284437,2.0226712344777362,1.3603472804379937,0.6153269923878304,1.2119,3.2097,0.3748,3.5715,0.3103,0,-60.0171,0.006,ML,cueing,64,132.51084925007902,3.5633777838958984,0.759967189934449,0.4490436862268896,4.36440374617233,0.7868170325664352,0.3845612421829029,0.301,0.17,0.615,0.026,1.454,54.22293402218167,1846.3940281942698,0.302,0.175,0.639,0.017,1.487,58.82687758665661,1842.5688699737623,352,1.0429629629629629,1,0,0,1,FALSE,FALSE,FALSE
451,2021-11-13T07:01:09Z,2021-11-13T07:37:09Z,2159,1,2021-11-13T07:37:09Z,0.8999999761581421,Chrome,95.0.4638.69,Windows NT 10.0,1920,1080,NA,1.7777777777777777,744,42,286,40,77,57,-0.11613351031482598,-0.43429035128227234,-0.6812368404208585,-0.7870146201492185,0.06981781516613529,-0.8171468870670823,2,2,3,3,2,3,4,1,2,2,1,3,2,4,1,1,3,2,1,1,0.9880869341680844,0,1,1,3,3,3.25,0,4,4,2,4,1,1,4,1,2,1,1,4,1,4,3,2,2,1,1,2,2,1,2,2,4,0,0,4,4,4,4,2,5,5,5,3,1,5,2,2,3,2,5,1,1,2,1,1,5,1,1,1,2,1,1,3,3,1,4,1,1,1,2,1,2,2,2,2,1.5382998298011887,1.4074631010979937,1.625,0,2,0,1.6666666666666667,0,2,0,1.5,0,1,0,1.5714285714285714,0,1.3333333333333333,0,1.5945945945945945,0,1,0,0,-0.7577551469345059,-0.22054348261253207,-0.489149314773519,2,4,2,4,4,4,4,1,1,0.9759000729485332,4,0,1,0.8916923242113942,4,3,3,3,1,1,2,4,4,NA,2,1.1338934190276817,2.7142857142857144,0,3.2857142857142856,5,3.8333333333333335,3.2559414990859232,0.38995568780511447,0,0.6572492649557016,3,3,3,3,3,3,3,3,3,2,3,3,2,3,2,4,3,3,3,3,0.5163977794943222,3,0,3,0,2.8,0,2.8,0,2.8666666666666667,0,3,2,4,1,3,4,3,1,4,2,1,2,3,3,2,2,2,3,3,4,0.99472291830968,3,0,"Black or African American & White, Caucasian, Anglo, European American",1,25,0,1,NA,1,2,3,Unemployed,2,0,190,70,1,5,2,0,0,1,0,0,TRUE,TRUE,TRUE,TRUE,TRUE,NA,NA,NA,NA,2,0.5405692307696892,0.5920148148117242,0.8125,0.9,0.04537445305523142,0.06976392409356245,2,0.7035718750003725,0.777066666668212,1,0.9,0.021017112409436992,0.008475311540262969,NA,NA,NA,NA,NA,NA,NA,NA,NA,NA,NA,NA,NA,1.1774,2.0197,0.387,1.1729,0.2459,0,-3.2283,0.005,ML,cueing,62,18.838003155135276,1.5886671141583368,1.383061660781146,0.2437828539546807,1.3026883164915237,1.1256238735161543,0.2705449617095567,0.07,0.521,0.361,0.011,1.318,148.4123644016967,2075.986638271749,0.069,0.521,0.404,0.01,1.43,154.3752724428816,2052.078591950986,104,0.3081481481481481,1,1,20,21,FALSE,FALSE,FALSE
452,2021-11-13T07:17:03Z,2021-11-13T07:40:28Z,1404,1,2021-11-13T07:40:31Z,1,Chrome,95.0.4638.69,Windows NT 10.0,1920,1080,NA,1.7777777777777777,673,73,343,85,55,111,-0.298558568561748,-0.15266346357362218,-0.4068252097672411,-0.23862632611725865,-0.2340474968444512,0.0949869180189837,3,3,2,1,3,1,3,2,2,3,3,3,2,1,3,3,3,1,3,3,0.8207826816681233,0,1,1,4,4,2,0,5,5,2,5,1,1,5,1,1,1,1,5,1,5,4,1,1,1,1,1,1,1,1,1,2,0,0,5,4,3,4,5,5,5,5,5,1,5,1,1,3,1,5,1,1,1,1,1,5,1,1,1,2,1,1,2,1,1,5,1,1,1,1,1,1,1,1,2,1.7866707005467437,1.9591057240729093,1,0,1.25,0,1.1333333333333333,0,1.4444444444444444,0,1.1666666666666667,0,1,0,1,0,1,0,1.2162162162162162,0,1,0,0,-1.4181548341315258,-0.4557470907642554,-0.9369509624478906,5,1,4,1,1,1,1,2,1,1.7320508075688772,1.1428571428571428,0,1.5,-0.6331575415043005,5,5,5,5,2,2,2,6,4,3,3,1.6035674514745464,4,0,2,4,3.8333333333333335,3.2559414990859232,-0.1748077221195339,0,-0.34217141679955326,2,2,2,3,2,2,4,4,2,2,3,3,2,4,4,1,4,3,3,4,1,2.2,0,3.4,0,3.6,0,3.2,0,3.4,0,1,2,1,4,3,2,1,2,1,2,1,3,1,2,1,2,1,2,1,2,0.8506963092234007,1.65,0,"White, Caucasian, Anglo, European American",0,22,0,1,NA,1,3,3,Unemployed,3,0,163,72,2,5,2,0,0,1,0,0,TRUE,TRUE,TRUE,TRUE,TRUE,2,0.7345714285714285,0.7,0.0172580729015323,2,0.5327193548352488,0.5801281249988824,1,1,0.0041011582796154095,0.004539739505797383,2,0.6952562499968334,0.7684906250014901,1,1,0.01546806318542994,0.008276725393623221,1.2582,0.7533,0.3849,0,16.6024,0.003,ML,change,50,-21.46873098371556,1.0202321077156973,0.8304951922012197,0.5717662814053193,9.9997,10.604,0.1086,10.6433,0.063,0,-84.1227,0.013,ML,cueing,63,180.6748041791746,4.426441826922526,0.935996651123288,0.47770423790963323,4.540313715188499,0.9125216860085457,0.4353686607231264,0.192,0.349,0.584,0.013,1.569,40.06347396528347,1840.9018945956986,0.194,0.354,0.588,0.016,1.628,51.2772635646454,1833.1901317788897,324,0.96,1,0,0,1,FALSE,FALSE,FALSE
453,2021-11-13T07:18:33Z,2021-11-13T07:41:00Z,1346,1,2021-11-13T07:41:01Z,0.8999999761581421,Chrome,95.0.4638.69,Windows NT 10.0,1536,864,No,1.7777777777777777,595,79,357,61,98,84,-0.498969195931606,-0.09815503369452862,-0.3394258618874053,-0.5311000829343039,0.3598710675398769,-0.3610799845240493,4,4,1,1,4,1,1,4,1,4,4,1,1,1,4,4,1,1,4,4,1.538967528127731,0,1,2,5,5,1,0,5,5,1,5,1,1,5,1,1,1,1,5,1,5,5,1,1,1,1,1,1,1,1,0,2,0,0,5,5,5,5,5,5,5,5,5,1,5,1,1,5,1,5,1,1,1,1,1,5,1,1,1,1,1,1,1,1,1,5,1,1,1,1,1,1,1,1,1,1.9666895707934864,2.065591117977289,1,0,1,0,1,0,1,0,1,0,0.8333333333333334,0,0.8571428571428571,0,1,0,1,0,0,0,0,-1.568373259242148,-0.7372407672780129,-1.1528070132600805,5,1,5,1,1,1,1,1,1,1.9518001458970664,1,0,1,-0.9031185640466358,5,5,5,5,5,5,5,3,3,4,3,0,4.428571428571429,0,1.5714285714285714,6,3.8333333333333335,3.2559414990859232,0.9547190977297628,0,-0.01642099913921513,1,1,3,1,1,1,4,1,1,3,1,3,2,4,4,1,3,2,2,5,1.3557637102737474,1.4,0,4,0,3.6,0,3.8,0,3.8,0,1,1,1,4,1,1,1,4,1,1,1,4,1,1,1,4,1,1,1,1,1.231174022502185,1,0,"White, Caucasian, Anglo, European American",0,29,0,1,NA,1,3,3,manufacturing,3,0,230,69,3,5,2,0,0,1,0,0,TRUE,TRUE,TRUE,TRUE,TRUE,4,0.7005538461540755,0.78,0.020963124636685863,4,0.4623866666669647,0.5075749999981906,0.967741935483871,0.875,0.0026065125807642705,0.0034554470867074727,4,0.5669096774189702,0.6466916666645557,1,0.75,0.004512048903137541,0.00693556942560671,1.3101,1.0819,0.3515,0,12.7484,0.004,ML,change,50,-13.760730983715563,1.3954872003581384,0.9069709654136956,0.5185730510234139,0.8279,2.6386,0.3857,4.2369,0.3685,0,-76.7959,0.011,ML,cueing,63,166.02120417917462,3.091324792955318,0.6294745066871527,0.43121520094193716,4.660576425039959,0.7297804115792383,0.38914488902840527,0.053,0.425,0.325,0.013,1.861,159.83544868839,2203.8527956838884,0.052,0.426,0.362,0.014,1.893,201.5498867996585,2205.932357701628,390,1.1555555555555557,1,0,0,1,FALSE,FALSE,FALSE
454,2021-11-13T07:19:27Z,2021-11-13T07:43:33Z,1446,1,2021-11-13T07:43:34Z,0.8999999761581421,Chrome,95.0.4638.69,Macintosh,1440,900,NA,1.6,812,64,332,77,39,77,0.058583446879409196,-0.23442610839226255,-0.459781840244255,-0.3361175783896071,-0.4550404510339686,-0.47931955185002084,4,4,1,1,3,1,1,3,1,3,3,1,1,1,4,4,1,1,3,3,1.2814465510343749,1,1,1,4,3,1.3,0,4,4,2,4,1,1,3,1,2,2,1,4,1,4,4,2,2,1,1,2,1,1,1,0,2,0,0,5,1,2,3,1,5,3,4,4,2,4,1,1,4,1,2,2,1,1,1,1,5,1,1,1,2,1,1,1,1,1,4,1,3,1,1,1,2,1,1,2,1.4040909769211791,1.3557637102737474,1.375,0,1.5,0,1.7333333333333334,0,2.888888888888889,0,1.5833333333333333,0,1,0,1.2857142857142858,0,1,0,1.7567567567567568,0,0,0,0,-0.7668534278368243,-0.5804383618435307,-0.6736458948401776,3,2,3,2,2,2,1,2,1,0.6900655593423543,2.142857142857143,0,1.5,-0.03488724541829051,4,4,4,4,3,2,2,3,3,3,3,0.9511897312113419,3.5714285714285716,0,2.4285714285714284,6,3.8333333333333335,3.2559414990859232,0.9547190977297628,0,0.46160498538940525,2,3,3,2,3,3,3,4,3,2,3,3,2,4,4,3,3,2,3,3,0.6546536707079771,2.6,0,3.2,0,3,0,3.2,0,3.1333333333333333,0,1,1,1,1,1,1,1,4,1,1,1,4,1,1,1,4,1,1,1,1,1.0990426455975697,1.15,0,"Hispanic of Latino (e.g., Mexican American, Central American, and others)",0,18,0,1,NA,1,3,3,University student,3,0,180,75,3,5,2,0,0,1,0,0,TRUE,TRUE,TRUE,TRUE,TRUE,5,0.7742952380955574,0.84,0.03340963028968948,5,0.48193749999953434,0.561596666666617,1,0.967741935483871,0.001734710161285254,0.006972735118131363,5,0.6426781249998603,0.7221906249995809,1,1,0.010944617893025253,0.01223361636084099,1.1634,1.5045,0.5173,0,-3.4714,0.004,ML,change,50,18.678869016284438,1.552794656794542,1.067899138722333,0.5404679863228622,1.5038,3.8895,0.3763,5.9652,0.3559,0,-79.8084,0.008,ML,cueing,63,172.0462041791746,3.644213381555958,0.9333145525660624,0.44180391319011214,5.6299658917489275,0.735907606911715,0.4186235734231283,0.246,0.251,0.653,0.016,1.747,70.4416093058946,1870.8076521099829,0.252,0.245,0.644,0.021,1.835,87.43988383879586,1871.0495404790763,444,1.3155555555555554,1,0,0,1,FALSE,FALSE,FALSE
456,2021-11-13T07:01:40Z,2021-11-13T07:52:28Z,3047,1,2021-11-13T07:52:29Z,1,Chrome,94.0.4606.81,Windows NT 10.0,1536,864,NA,1.7777777777777777,733,52,872,685,392,137,-0.1443965475080111,-0.3434429681504497,2.139907292263699,7.073217594308874,4.420616600772259,0.5341624538011636,3,2,1,1,3,1,2,1,1,3,2,1,1,1,3,1,2,1,1,2,0.812727700887249,0,1,2,5,3,2.05,0,2,5,4,5,3,1,5,1,1,1,1,5,1,5,3,2,1,1,1,1,1,1,1,1,2,0,0,5,5,5,5,4,5,5,5,5,1,4,1,1,5,1,4,3,1,2,3,2,5,1,1,1,1,1,1,2,1,1,5,2,2,1,1,1,2,1,1,1,1.7646852733884628,1.8073922282301278,1.125,0,1.25,0,1.6666666666666667,0,1.1111111111111112,0,1.6666666666666667,0,0.8333333333333334,0,1.2857142857142858,0,1,0,1.3243243243243243,0,1,0,0,-1.088777707423119,-0.4557470907642554,-0.7722623990936872,5,1,3,1,1,1,1,1,1,1.5735915849388864,1.2857142857142858,0,1,-0.7321841937363471,5,5,5,5,4,4,1,6,6,5,3,1.4638501094227998,4.714285714285714,0,1.2857142857142858,3,3.8333333333333335,3.2559414990859232,-0.7395711320441822,0,-1.022908108869061,2,2,3,3,2,2,5,3,2,4,3,4,3,5,4,1,3,4,4,3,1.1126972805283737,2.4,0,3.2,0,4.2,0,3.8,0,3.7333333333333334,0,2,2,4,4,2,3,2,3,2,2,3,1,1,4,2,2,4,4,1,4,1.0954451150103321,2.6,0,"White, Caucasian, Anglo, European American",0,19,0,1,NA,1,3,4,Student,1,0,145,68,3,5,2,0,0,0,0,0,TRUE,TRUE,TRUE,TRUE,TRUE,2,0.95174358970691,0.7959183673469388,0.17423973944445859,2,0.4054593750089407,0.4911333333333333,1,0.9375,0.002740178610545263,0.005709751514081265,2,0.5521125000119209,0.5868156249970198,1,1,0.004110212739320877,0.006101084592810694,1.4501,0.9294,0.5723,0,29.1741,0.003,ML,change,49,-46.67273910566812,0.8744327263559132,1.5564108159667087,0.4250357782308296,1.364,3.5203,0.3154,4.5504,0.2556,0,-69.2193,0.01,ML,cueing,64,150.91524925007903,3.391117787103318,0.7985715540171248,0.3881068161739494,5.02189671509395,0.8250139262997611,0.3258846359765051,0.106,0.381,0.593,0.046,1.258,14.938251790089762,1807.1899805863534,0.106,0.383,0.598,0.056,1.341,24.459428281079195,1806.0527749182456,390,1.1555555555555557,1,0,0,1,FALSE,FALSE,FALSE
457,2021-11-13T07:21:18Z,2021-11-13T07:53:12Z,1913,1,2021-11-13T07:53:13Z,0.8999999761581421,Firefox,100.0,Windows NT 10.0,1920,1080,NA,1.7777777777777777,730,105,539,149,111,133,-0.15210464856069794,0.13804816244821022,0.5367656605504606,0.5413036920615288,0.5394278428188598,0.4665969867577513,4,4,1,1,3,1,1,3,1,3,4,1,1,1,4,4,1,1,4,4,1.4244112357114616,0,1,2,4,4,1.15,0,4,5,2,4,2,1,4,1,1,1,1,5,2,5,4,1,2,1,1,1,1,1,2,0,5,0,0,5,4,5,3,3,3,4,4,5,2,5,1,1,5,1,4,1,1,1,2,2,5,1,1,1,1,1,1,1,1,1,5,1,1,1,1,1,1,1,2,2,1.6508256192660766,1.65615734242165,1.25,0,1.5,0,1.4666666666666666,0,2,0,1.3333333333333333,0,0.8333333333333334,0,0.8571428571428571,0,1,0,1.3513513513513513,0,0,0,0,-1.1093940247868836,-0.5804383618435307,-0.8449161933152072,4,1,3,1,1,3,2,1,3,1.2149857925879117,1.8571428571428572,0,2,-0.021327778341387937,5,5,5,5,3,3,1,5,7,4,4,1.5735915849388864,4.428571428571429,0,1.5714285714285714,3,3.8333333333333335,3.2559414990859232,-0.7395711320441822,0,-0.8635661140261877,2,2,2,2,2,3,2,3,2,3,2,2,2,3,2,3,3,3,4,5,0.8618916073713346,2,0,3,0,3.2,0,2.6,0,2.933333333333333,0,1,1,1,4,2,1,2,2,1,2,1,4,2,1,2,4,1,1,1,3,1.0894228312566052,1.45,0,"White, Caucasian, Anglo, European American",0,18,0,1,NA,1,4,4,I'm a student but I do a lot of IT stuff.,5,0,132,64,2,5,2,0,0,1,0,0,TRUE,TRUE,TRUE,TRUE,TRUE,1,0.8299761904761904,0.8571428571428571,0.016880308673469385,1,0.4150967741935484,0.4579375,1,1,0.0026282903225806455,0.002884447580645161,1,0.54775,0.6125483870967742,1,1,0.001379419354838709,0.0031146559139784945,1.1384,1.701,0.602,0,-10.2141,0.003,ML,change,49,32.10366089433188,1.9554323583584439,0.9162983631569899,0.6626221963508545,2.3816,6.8699,0.2846,8.6297,0.2771,0,-102.7252,0.01,ML,cueing,63,217.87980417917458,4.9578893690606956,0.8356650215405022,0.37629484630654575,5.074510557223389,0.8164599678473276,0.33716358389540085,0.1,0.425,0.776,0.032,1.825,42.35364061528716,1841.1705324420777,0.092,0.433,0.771,0.038,2.02,56.7032737166548,1846.0313477828136,312,0.9244444444444444,1,0,0,1,FALSE,FALSE,FALSE
458,2021-11-13T07:17:03Z,2021-11-13T07:53:45Z,2201,1,2021-11-13T07:53:46Z,1,Chrome,95.0.4638.69,Windows NT 10.0,1536,864,Everything was good :),1.7777777777777777,1082,93,558,125,82,157,0.7523125416212253,0.029031302690023072,0.6282362041016665,0.24882993524448352,0.1388781133503595,0.8719897890182251,3,4,2,2,3,1,2,2,1,3,2,2,2,1,3,3,3,2,3,3,0.812727700887249,0,0,3,5,3,1.95,0,2,4,3,4,2,2,4,2,3,3,2,4,2,4,3,1,2,1,1,1,3,2,2,1,2,0,0,3,2,4,4,2,4,5,5,4,2,4,2,1,3,2,5,2,1,2,1,2,3,1,3,1,2,2,1,2,1,1,5,2,2,1,1,1,1,2,2,2,1.3428712906691034,0.8837151016885368,1.625,0,1.75,0,2.4,0,2.3333333333333335,0,1.75,0,1.8333333333333333,0,1.2857142857142858,0,1,0,1.8108108108108107,0,1,0,0,-0.3496875694432797,-0.2989446853297732,-0.3243161273865265,5,1,3,1,1,2,2,1,2,1.4638501094227998,1.5714285714285714,0,1.5,-0.3767559860388676,4,5,5,4,2,2,1,4,4,2,3,1.6035674514745464,3.857142857142857,0,2.142857142857143,5,3.8333333333333335,3.2559414990859232,0.38995568780511447,0,0.019881285584207653,3,3,2,1,2,3,4,3,2,4,2,3,1,4,3,1,4,2,4,4,1.0997835284835873,2.2,0,3.6,0,4.4,0,3.2,0,3.7333333333333334,0,2,1,1,2,3,2,3,3,2,2,1,2,2,3,2,2,1,3,2,2,0.6863327411532597,2.15,0,"White, Caucasian, Anglo, European American",0,20,0,1,NA,1,3,3,Student,2,0,141,67,3,5,2,0,0,0,0,0,TRUE,TRUE,TRUE,TRUE,TRUE,6,0.8154769230767702,0.7959183673469388,0.051330464447260034,6,0.5751968750001397,0.6470709677417913,1,1,0.02671520934500982,0.030657730129410535,6,0.7462843749998137,1.0073406250001862,1,1,0.033460995554123824,0.03600689345728552,1.4382,1.0269,0.4074,0,21.8838,0.003,ML,change,49,-32.092139105668124,1.1869144245609988,1.146650950542607,0.52959693865676,2.7616,4.3534,0.3299,3.9799,0.2282,0,-43.2283,0.009,ML,cueing,63,98.88600417917459,2.745854338362629,1.5088690862101997,0.38090300193888527,2.8419919858792526,1.4578277303303984,0.3267319565952684,0.152,0.374,0.399,0.008,1.895,59.78983554107137,1858.8693653475884,0.156,0.376,0.429,0.008,1.951,67.01720585599682,1850.3756033166803,104,0.3081481481481481,1,0,0,1,FALSE,FALSE,FALSE
459,2021-11-13T07:19:40Z,2021-11-13T07:54:25Z,2085,1,2021-11-13T07:54:26Z,1,Chrome,95.0.4638.69,Windows NT 10.0,1920,1080,"The third attention game with the asterisk wasn't sized properly. With 1080p monitor and card setting set, it didn't find within the web container. I had to resize Chrome's view to 80%.",1.7777777777777777,897,45,302,273,145,257,0.27697964337220315,-0.40703613634272556,-0.6042090142724746,2.0524181022829295,1.0090378704715843,2.5611264651035324,3,3,1,1,3,1,1,2,1,3,2,1,1,1,2,2,1,1,3,2,0.8506963092234007,0,1,1,3,3,1.75,0,5,5,1,5,1,1,4,1,2,1,1,4,1,5,4,1,1,1,1,1,1,1,1,0,3,0,0,5,3,4,4,1,4,3,4,3,1,4,1,1,4,1,5,1,1,1,2,3,4,1,1,1,1,1,1,1,1,1,5,1,2,1,2,1,1,1,1,1,1.4688967484672493,1.8309508328682538,1,0,1,0,1.2666666666666666,0,2.5555555555555554,0,1.4166666666666667,0,1,0,1,0,1.3333333333333333,0,1.5945945945945945,0,0,0,0,-1.198247448918038,-0.7372407672780129,-0.9677441080980254,5,1,4,1,1,2,1,1,1,1.6761634196950514,1.2857142857142858,0,1,-0.7321841937363471,4,4,4,3,1,1,2,1,1,2,3,1.3801311186847085,3,0,3,8,3.8333333333333335,3.2559414990859232,2.0842459175790595,0,1.3450523849998008,2,1,1,1,2,2,3,2,2,2,1,4,1,3,4,4,5,2,2,4,1.2227992865708155,1.4,0,4.4,0,2.8,0,3.4,0,3.533333333333333,0,2,1,1,4,3,2,2,3,1,1,1,3,2,2,2,3,1,1,2,2,0.8870412083230169,1.65,0,"Asian or Asian American (e.g., Chinese, Japanese, and others)",0,27,0,1,NA,1,3,5,Artist,2,0,140,69,2,5,2,0,0,2,0,0,TRUE,TRUE,TRUE,TRUE,TRUE,3,0.7064217391506485,0.92,0.025886081670636257,NA,NA,NA,NA,NA,NA,NA,3,0.4608843750171363,0.5092250000089407,1,1,0.004682586521717133,0.004064649676385541,1.2211,2.0882,0.4689,0,-15.9981,0.003,ML,change,50,43.73226901628444,2.181966438854914,1.1193329979222495,0.49096477759716944,NA,NA,NA,NA,NA,NA,NA,NA,NA,NA,NA,NA,NA,NA,NA,NA,NA,NA,0.077,0.301,0.448,0.027,1.562,169.03915170643373,1971.9462652938178,0.08,0.297,0.462,0.028,1.64,215.00611815111137,2003.686824773834,382,1.1318518518518519,1,0,5,6,FALSE,FALSE,FALSE
460,2021-11-13T07:32:55Z,2021-11-13T07:56:01Z,1385,1,2021-11-13T07:56:03Z,0.8999999761581421,Chrome,95.0.4638.69,Windows NT 10.0,1536,864,no,1.7777777777777777,666,46,405,80,54,65,-0.316544137684684,-0.39795139802954327,-0.10834238344225383,-0.29955835878747644,-0.24785955648129604,-0.6820159529802577,2,2,1,1,3,1,1,3,1,3,3,1,1,1,3,3,1,1,3,3,0.9679060415469871,0,0,1,3,3,1.6,0,5,5,1,5,1,1,5,1,1,1,1,5,1,5,3,1,1,1,1,1,1,1,1,1,2,0,0,4,1,1,2,2,3,1,1,3,3,2,2,1,2,2,2,2,2,2,2,2,5,5,1,1,1,1,1,3,3,3,5,1,1,1,2,1,2,1,3,3,1.187396273326605,1.98086080374405,1,0,2.25,0,1.1333333333333333,0,4,0,2.5,0,1.5,0,1.7142857142857142,0,1.3333333333333333,0,2.5135135135135136,0,1,0,0,-0.8606431533085982,-0.14214227989529096,-0.5013927166019446,5,1,4,1,1,1,1,1,1,1.7320508075688772,1.1428571428571428,0,1,-0.8176513788914915,3,3,5,3,1,1,2,1,1,3,2,1.3972762620115438,2.857142857142857,0,3.142857142857143,8,3.8333333333333335,3.2559414990859232,2.0842459175790595,0,1.4247233824212375,1,1,2,2,2,1,5,1,1,1,1,5,1,4,5,1,2,1,5,4,1.8464895909600492,1.6,0,4.4,0,4.2,0,4.2,0,4.266666666666667,0,1,1,1,3,1,1,1,3,1,1,1,3,1,1,1,3,1,1,1,1,0.8207826816681233,1.2,0,"Hispanic of Latino (e.g., Mexican American, Central American, and others)",0,24,0,1,NA,1,3,4,military,2,0,170,68,4,5,2,0,0,1,0,0,TRUE,TRUE,TRUE,TRUE,TRUE,1,0.7017076923174735,0.78,0.0489792292923733,1,0.528617857166699,0.6535199999809265,0.9655172413793104,0.9375,0.008177040663751217,0.007479323715584971,1,0.6442406250238418,0.7254033333778381,1,0.9375,0.0044462179746330936,0.009893419912938822,1.3306,0.9952,0.3081,0,19.235,0.004,ML,change,50,-26.73393098371556,1.1287217005462846,1.1213272259394962,0.423542026581534,1.2246,3.0626,0.4803,3.1448,0.3444,0,-49.9325,0.008,ML,cueing,61,112.19762159251994,3.169798052829334,0.8543289370390735,0.535604314588612,3.467058382525856,0.9611042395391087,0.3995716903864748,0.068,0.515,0.507,0.02,1.695,49.202048904710985,1927.5675400588211,0.065,0.519,0.498,0.021,1.791,70.79494276912408,1935.1427055790225,104,0.3081481481481481,1,0,0,1,FALSE,FALSE,FALSE
463,2021-11-13T07:39:30Z,2021-11-13T08:01:51Z,1341,1,2021-11-13T08:01:52Z,0.8999999761581421,Chrome,95.0.4638.69,Windows NT 10.0,1920,1080,could've just asked for my screen resolution,1.7777777777777777,593,54,309,61,66,69,-0.5041079299667306,-0.3252734915240852,-0.5705093403325567,-0.5311000829343039,-0.08211484083915795,-0.6144504859368455,2,2,2,2,2,2,3,2,1,2,1,1,1,1,2,2,1,1,1,2,0.5871429486123998,0,1,1,2,2,2.35,0,4,3,2,3,2,2,4,2,2,2,2,3,2,3,3,2,3,3,2,2,2,2,2,0,7,0,0,4,4,3,3,3,5,4,4,3,2,4,2,2,3,2,2,4,2,2,2,2,3,1,1,1,1,1,1,1,1,1,4,2,2,1,1,2,2,2,1,1,1.179784680309035,0.7367883976130072,2.25,0,1.5,0,2.3333333333333335,0,2.3333333333333335,0,2.4166666666666665,0,1.1666666666666667,0,1.2857142857142858,0,1.3333333333333333,0,1.945945945945946,0,0,0,0,-0.051670474781162705,-0.5804383618435307,-0.3160544183123467,4,2,3,2,2,2,2,2,1,0.7867957924694432,2.142857142857143,0,1.5,-0.03488724541829051,3,3,4,4,1,1,2,5,5,2,2,1.2724180205607036,2.857142857142857,0,3.142857142857143,4,3.8333333333333335,3.2559414990859232,-0.1748077221195339,0,0.2951965625719407,2,2,2,2,2,2,5,2,2,2,1,5,1,3,3,3,5,2,2,3,1.3345232785352157,2,0,4.6,0,3.4,0,3.4,0,3.8,0,1,1,3,1,3,3,2,1,4,1,3,1,1,3,1,2,1,4,2,2,1.0760551736979407,2.5,0,"Asian or Asian American (e.g., Chinese, Japanese, and others)",0,22,0,1,NA,1,3,6,engineer,3,0,127,67,2,5,2,0,0,1,0,0,TRUE,TRUE,TRUE,TRUE,TRUE,6,0.8697849999986589,0.8,0.02924828597600922,6,0.5930866666674613,0.6939031249983236,0.967741935483871,1,0.04677260189118381,0.0678407390210682,6,0.6547366666684548,0.6985531250005588,0.967741935483871,1,0.006027819183183104,0.003264284506065785,1.3662,1.1343,0.5108,0,14.4253,0.003,ML,change,50,-17.11453098371556,1.3874923339333587,0.9991365914000607,0.6537542731330971,1.7539,2.1614,0.2882,2.7088,0.2844,0,-14.2848,0.009,ML,cueing,63,40.9990041791746,2.2513335936733445,1.840302449194776,0.29796158113574134,2.2644185708494735,1.5020179685181754,0.2828274236235897,0.218,0.372,0.759,0.027,1.257,147.11211068840646,1992.657838133603,0.22,0.377,0.786,0.025,1.303,168.77450614034257,1995.6430909685369,104,0.3081481481481481,1,1,0,1,FALSE,FALSE,FALSE
464,2021-11-13T07:41:52Z,2021-11-13T08:08:23Z,1591,1,2021-11-13T08:08:25Z,0.8999999761581421,Firefox,94.0,Windows NT 10.0,1536,864,NA,1.7777777777777777,735,63,472,101,55,90,-0.13925781347288652,-0.24351084670544482,0.2142116385541034,-0.04364382157256178,-0.2340474968444512,-0.2597317839589309,4,4,2,2,3,1,2,3,1,3,2,1,1,1,4,4,2,1,3,3,1.1367080817685316,0,1,1,4,4,1.55,0,4,3,4,3,3,2,4,1,2,1,1,4,1,4,4,1,1,2,1,1,1,2,1,3,2,0,0,5,4,4,5,4,5,5,5,5,2,4,1,4,2,2,4,2,2,1,1,1,3,1,1,2,3,2,1,3,3,3,4,2,2,2,2,2,2,3,2,3,1.3911992795553898,1.2798809468443688,1.25,0,2.5,0,2.066666666666667,0,1.3333333333333333,0,2,0,1.8333333333333333,0,2.142857142857143,0,2,0,1.8918918918918919,0,2,0,0,-0.6192483387300597,0.13935139661846652,-0.23994847105579659,3,2,2,2,1,3,2,4,2,0.6900655593423543,2.4285714285714284,0,3,0.6895286370535711,4,5,5,4,2,2,3,5,1,NA,1,1.2724180205607036,3.5714285714285716,0,2.4285714285714284,6,3.8333333333333335,3.2559414990859232,0.9547190977297628,0,0.46160498538940525,4,4,4,2,3,5,4,2,2,2,1,2,2,3,3,4,3,2,3,4,1.082325538564332,3.4,0,3,0,3,0,3.2,0,3.066666666666667,0,1,1,2,3,3,1,1,2,1,1,1,4,1,1,1,3,1,1,1,2,0.9403246919632545,1.4,0,"Hispanic of Latino (e.g., Mexican American, Central American, and others)",0,25,0,1,NA,1,2,4,Unemployed,3,0,145,64,1,5,2,0,0,0,0,0,TRUE,TRUE,TRUE,TRUE,TRUE,2,1.1273783783783784,0.74,0.09577692285714284,2,0.50259375,0.5384375,1,1,0.00288270060483871,0.0020694153225806443,2,0.66709375,0.74340625,1,1,0.00524137802419355,0.008292248991935485,1.4653,0.7124,0.7065,0,36.8165,0.003,ML,change,50,-61.896930983715556,0.8065813825505528,1.2967923359142637,0.7415150701586193,2.1772,7.9672,0.4018,7.2515,0.3525,0,-106.6334,0.009,ML,cueing,64,225.743449250079,5.387044700747638,0.7690923236290447,0.46928472422924816,4.958640344128115,0.8355384619289273,0.42097582363111635,0.128,0.461,0.605,0.018,1.485,26.918032190784594,1824.8681870351845,0.122,0.463,0.593,0.018,1.562,35.78160407064185,1818.8175960013361,359,1.0637037037037036,1,0,0,1,FALSE,FALSE,FALSE
465,2021-11-13T07:44:48Z,2021-11-13T08:09:37Z,1489,1,2021-11-13T08:09:39Z,1,Firefox,89.0,Windows NT 10.0,1920,1080,n/a,1.7777777777777777,644,58,278,61,55,69,-0.3730702120710542,-0.2889345382713561,-0.7197507534950504,-0.5311000829343039,-0.2340474968444512,-0.6144504859368455,3,3,2,1,3,1,2,3,1,4,4,2,2,1,3,3,2,1,2,3,0.9787209698591858,0,1,1,2,2,1.7,0,2,3,5,2,5,5,3,5,4,5,5,1,1,1,3,1,5,5,3,5,5,5,5,4,5,3,1,5,4,2,4,4,5,2,2,3,2,4,1,3,2,4,5,5,5,5,5,5,2,5,5,5,4,4,5,5,5,5,3,4,4,1,3,3,2,4,4,4,1.2938988268694636,1.632993161855452,4.25,0,3.5,0,4.133333333333334,0,2.5555555555555554,0,3.5,0,4.333333333333333,0,4.285714285714286,0,2.3333333333333335,0,3.5135135135135136,0,2,3,1,2.2550341046237006,1.2493054771656829,1.7521697908946918,2,5,1,3,3,3,3,4,3,1.2149857925879117,3.7142857142857144,0,3.5,1.6432271408370611,3,3,5,3,1,1,3,5,3,2,2,1.3801311186847085,2.7142857142857144,0,3.2857142857142856,5,3.8333333333333335,3.2559414990859232,0.38995568780511447,0,0.6572492649557016,2,2,2,3,2,2,5,2,4,5,1,5,1,5,5,1,3,1,5,1,1.8309508328682538,2.2,0,4.4,0,5,0,4.2,0,4.533333333333333,0,2,3,4,1,3,4,4,1,4,4,4,1,3,2,4,1,3,4,4,4,1.2139539573337679,3.6,0,"White, Caucasian, Anglo, European American",0,288,0,1,NA,1,2,3,Retail Worker,2,0,300,70,2,5,2,0,0,0,0,0,TRUE,TRUE,TRUE,TRUE,TRUE,NA,NA,NA,NA,2,0.527483870967742,0.6202333333333333,0.96875,0.967741935483871,0.003430931451612902,0.003062995698924731,2,0.6961935483870968,0.73425,1,1,0.0037615612903225807,0.008380709677419355,NA,NA,NA,NA,NA,NA,NA,NA,NA,NA,NA,NA,NA,0.9172,3.8026,0.5042,4.4533,0.4301,0,-86.765,0.011,ML,cueing,63,185.9594041791746,4.476287719646755,0.7598254613379859,0.5408366872338728,4.371271753325405,0.7855808099491348,0.44324271062727105,0.171,0.427,0.612,0.037,1.386,65.83263425722767,1895.7541328412033,0.175,0.434,0.63,0.073,1.379,92.09787972189396,1875.597680793722,104,0.3081481481481481,1,1,0,1,FALSE,FALSE,FALSE
466,2021-11-13T07:44:04Z,2021-11-13T08:10:52Z,1608,1,2021-11-13T08:10:54Z,1,Chrome,95.0.4638.69,Windows NT 10.0,2560,1440,N/A,1.7777777777777777,645,61,363,119,36,342,-0.3705008450534919,-0.26168032333180935,-0.3105404270817614,0.17571149604022218,-0.49647662994450314,3.996892639776044,2,2,2,3,2,1,1,2,1,3,2,1,1,1,2,3,1,1,2,2,0.7163503994113789,0,1,1,3,3,2.05,0,4,4,2,4,2,1,3,2,2,1,1,4,2,3,3,2,3,1,1,1,2,2,2,0,2,0,0,4,4,4,4,5,5,4,4,3,2,4,2,2,3,1,3,2,2,2,3,3,3,1,1,1,2,1,1,1,1,1,5,1,2,1,1,1,1,1,1,1,1.365050681609794,1.1254628677422756,1.75,0,1,0,2,0,1.8888888888888888,0,2.25,0,1.3333333333333333,0,1,0,1,0,1.7297297297297298,0,0,0,0,-0.5027129110024894,-0.7372407672780129,-0.6199768391402511,4,2,3,1,1,2,2,1,1,1.0690449676496976,1.8571428571428572,0,1,-0.39031545311577004,4,4,5,4,3,3,2,3,3,4,4,0.9759000729485332,3.857142857142857,0,2.142857142857143,6,3.8333333333333335,3.2559414990859232,0.9547190977297628,0,0.30226299054653183,3,2,2,2,2,2,3,3,2,2,3,3,1,2,3,3,2,3,1,3,0.7367883976130072,2.2,0,3,0,2.8,0,3,0,2.933333333333333,0,1,2,2,1,2,3,3,1,2,1,2,1,2,4,1,2,2,3,2,3,0.8583950752789521,2.5,0,"White, Caucasian, Anglo, European American",0,22,0,1,NA,1,3,4,Full Time Student,2,0,165,70,1,5,2,0,0,1,0,0,TRUE,TRUE,TRUE,TRUE,TRUE,6,0.8148642857138599,0.84,0.05217319193872678,6,0.4900843749996275,0.5542625000029803,1,1,0.009801927812360996,0.009536665645043485,6,0.6433656250019558,0.6876187500013039,1,1,0.009833351361037823,0.008964842863045839,1.4058,1.2458,0.4311,0,15.3349,0.003,ML,change,50,-18.933730983715563,1.3890570835855294,1.1937796482223755,0.5226624135288025,1.5122,3.8116,0.3559,4.4326,0.3195,0,-66.6335,0.009,ML,cueing,64,145.74364925007902,3.6767436854497784,1.1268489404870496,0.4058111794204729,3.6516119480858187,1.1346043296203396,0.339582629476547,0.18,0.336,0.585,0.035,1.714,46.76306072172888,1843.989028105319,0.182,0.336,0.608,0.035,1.828,58.24374338326256,1844.0689813714428,368,1.0903703703703704,1,0,0,1,FALSE,FALSE,FALSE
467,2021-11-13T07:44:41Z,2021-11-13T08:12:14Z,1652,1,2021-11-13T08:12:16Z,1,Chrome,95.0.4638.69,Windows NT 10.0,1920,1080,I do not.,1.7777777777777777,724,82,462,99,66,111,-0.1675208506660716,-0.07090081875498182,0.1660692472113635,-0.06801663464064889,-0.08211484083915795,0.0949869180189837,1,1,4,4,1,2,4,1,1,1,1,4,4,4,1,1,4,4,1,1,1.4823523268955432,0,1,2,2,1,3.75,0,2,3,5,2,4,3,2,5,5,4,3,1,1,1,1,5,5,5,1,5,5,5,5,1,2,1,1,1,1,2,2,2,3,2,2,1,3,2,5,2,2,3,5,5,5,5,5,5,1,1,3,3,1,1,1,3,1,1,3,3,2,3,3,5,5,5,5,5,1.4570940680419788,1.52127765851133,4.5,0,5,0,4,0,4.222222222222222,0,3.9166666666666665,0,2.1666666666666665,0,1.8571428571428572,0,3.6666666666666665,0,3.3513513513513513,0,1,1,1,2.2354824797059516,1.1033538044865656,1.6694181420962586,3,2,3,2,2,3,3,3,1,0.5345224838248488,2.5714285714285716,0,2,0.4060081474343336,3,3,3,3,1,1,3,7,6,NA,2,0.9759000729485332,2.4285714285714284,0,3.5714285714285716,2.5,3.8333333333333335,3.2559414990859232,-1.0219528370065065,0,0.11063699739276467,5,3,5,5,5,4,4,4,4,2,4,2,5,2,5,5,3,1,3,3,1.2421180068162376,4.6,0,2.8,0,2.2,0,2.8,0,2.6,0,1,4,4,1,4,4,4,1,4,4,4,1,1,4,4,1,1,4,1,4,1.5078740698501039,3.4,0,"White, Caucasian, Anglo, European American",0,21,0,1,NA,1,2,4,Student,2,0,135,67,2,5,2,0,0,0,0,0,TRUE,TRUE,TRUE,TRUE,TRUE,2,1.0018810810811214,0.7708333333333334,0.3523096134574627,2,0.40105937500006983,0.5058806451613744,1,0.96875,0.0023206179737739066,0.003509660645165922,2,0.5927906249998487,0.6448483870969184,1,0.96875,0.009733634425388495,0.011465611249995407,1.7131,0.716,0.4246,0,45.8657,0.003,ML,change,48,-80.11779696727632,0.6642803560136433,1.8260703163423675,0.2573750811687887,2.4261,4.3429,0.2379,6.4999,0.2144,0,-70.0134,0.01,ML,cueing,64,152.50344925007903,4.346548554191785,0.7900491991912594,0.4206784306908255,5.234938469797381,0.7914390494358367,0.32782961465384725,0.083,0.392,0.41,0.021,1.169,202.51717184616024,2061.499468948978,0.081,0.398,0.408,0.017,1.303,230.7885426708843,2070.9680573501414,527,1.5614814814814815,1,0,1,2,FALSE,FALSE,FALSE
468,2021-11-13T07:37:26Z,2021-11-13T08:12:21Z,2094,1,2021-11-13T08:12:22Z,1,Chrome,95.0.4638.69,Windows NT 10.0,1366,768,I do not.,1.7786458333333333,939,150,611,80,78,103,0.384893058109819,0.546861386541412,0.8833908782181878,-0.29955835878747644,0.08362987480298012,-0.040144016067840904,2,3,2,2,2,1,2,2,2,2,2,3,1,1,2,2,2,2,2,2,0.5104177855340404,0,1,2,2,2,2.35,0,2,4,3,3,3,4,4,3,2,2,3,4,2,4,2,4,3,3,3,3,4,3,3,5,2,5,1,4,1,2,1,1,3,1,1,1,1,3,3,1,2,3,4,3,3,4,4,4,2,4,5,2,3,1,3,3,3,2,3,1,2,2,3,3,2,2,2,2,1.1455620071878747,0.8451542547285166,3.25,0,2,0,2.7333333333333334,0,4.333333333333333,0,2.9166666666666665,0,3,0,2.2857142857142856,0,2.6666666666666665,0,3.189189189189189,0,3,5,1,1.0842595748955521,1.3952571498447999,1.239758362370176,2,5,3,4,3,3,4,6,4,0.9759000729485332,3.7142857142857144,0,5,2.1967086529986344,4,4,4,4,3,4,3,3,4,2,2,0.4879500364742666,3.7142857142857144,0,2.2857142857142856,5.5,3.8333333333333335,3.2559414990859232,0.6723373927674386,0,0.24074313548680643,2,2,2,2,2,2,4,2,2,3,2,4,3,4,4,1,5,2,3,2,1.1254628677422756,2,0,4.2,0,3.6,0,4,0,3.933333333333333,0,1,1,3,2,2,4,2,2,4,1,4,2,2,4,1,2,2,3,3,3,1.0462967275611939,2.6,0,Black or African American,0,29,0,1,NA,1,2,5,Unemployed,1,0,290,65,1,5,2,0,0,1,0,0,TRUE,TRUE,TRUE,TRUE,TRUE,4,0.7165305555562178,0.72,0.03659390816304017,4,0.4737874999940395,0.5092483871040806,1,1,0.0029171469352139963,0.0011465919143787838,4,0.5585749999955296,0.5830928571373224,1,0.875,0.008223620001198553,0.007398769032466526,1.1724,0.8013,0.4005,0,16.604,0.004,ML,change,50,-21.47193098371556,0.9348762204944396,1.0102531095949174,0.4787924686966176,3.7106,11.5757,0.349,8.9147,0.2657,0,-112.5027,0.01,ML,cueing,63,237.4348041791746,6.243962349559354,0.6635425543019041,0.45777411375861965,4.943936888360919,0.8380233849961465,0.39168338210711323,0.051,0.414,0.325,0.044,1.518,91.17053792445378,2026.1407515491262,0.053,0.404,0.317,0.031,1.606,113.045069991675,2042.9901999918777,348,1.031111111111111,1,0,0,1,FALSE,FALSE,FALSE
469,2021-11-13T07:46:55Z,2021-11-13T08:12:42Z,1547,1,2021-11-13T08:12:43Z,0.8999999761581421,Chrome,95.0.4638.69,Windows NT 10.0,1920,1080,NA,1.7777777777777777,662,72,466,104,56,117,-0.3268216057549331,-0.16174820188680444,0.18532620374845948,-0.007084601970431121,-0.22023543720760635,0.19633511858410213,1,2,2,3,1,3,3,1,2,1,1,2,1,3,1,1,2,3,1,1,0.8506963092234007,0,1,2,2,2,3.15,0,3,3,4,2,3,1,3,2,2,3,1,2,2,2,2,2,3,1,1,2,1,2,2,5,2,0,0,3,3,2,3,2,2,3,3,3,4,3,2,4,3,3,4,3,4,5,5,5,3,1,2,1,4,4,2,3,3,3,4,2,2,2,3,1,3,2,2,3,1.0526671402243484,0.816496580927726,1.75,0,2.5,0,2.8666666666666667,0,3.3333333333333335,0,3.5833333333333335,0,2.3333333333333335,0,2.2857142857142856,0,2,0,3,0,3,0,0,0.4156327187974994,0.3424438704149829,0.37903829460624117,3,1,2,1,1,2,1,1,2,0.7867957924694432,1.8571428571428572,0,1.5,-0.20582161572857902,3,3,3,3,1,1,4,4,6,NA,3,1.1338934190276817,2.2857142857142856,0,3.7142857142857144,4,3.8333333333333335,3.2559414990859232,-0.1748077221195339,0,0.6138805522576877,2,2,1,1,2,1,2,3,2,3,2,3,2,2,2,5,3,2,2,4,0.990430401872025,1.6,0,3.8,0,2.4,0,2.6,0,2.933333333333333,0,2,2,3,1,3,4,3,1,2,2,3,1,2,1,2,1,1,3,2,3,0.9119095061289915,2.7,0,Black or African American,0,21,0,1,NA,1,2,4,none,3,0,230,75,2,5,2,0,0,0,0,0,TRUE,TRUE,TRUE,TRUE,TRUE,3,0.7454949999999255,0.8,0.01859850040821814,3,0.42710000000020554,0.4818937500006286,0.90625,1,0.003317412096770125,0.0031608515725899257,3,0.5579343749999535,0.588153571428598,1,0.875,0.014306284909291174,0.005619544354855868,1.1556,1.2767,0.4993,0,1.3301,0.004,ML,change,50,9.075869016284438,1.553768151535798,0.8922144270685621,0.5732271311702034,0.9911,3.5911,0.3439,3.5841,0.311,0,-73.4353,0.009,ML,cueing,64,159.34724925007902,4.845755180059521,0.8550028989167056,0.3964288402447684,3.476108775732405,0.6526503304950115,0.3508252877085183,0.059,0.394,0.382,0.018,1.728,106.71169913024777,2021.9998957936236,0.057,0.395,0.378,0.019,1.817,124.67107146897783,2023.8126673545796,279,0.8266666666666667,1,0,0,1,FALSE,FALSE,FALSE
470,2021-11-13T07:50:24Z,2021-11-13T08:14:03Z,1418,1,2021-11-13T08:14:03Z,1,Chrome,93.0.4577.82,Macintosh,1280,800,NA,1.6,623,51,452,102,57,80,-0.4270269194398621,-0.35252770646363196,0.11792685586862363,-0.03145741503851823,-0.2064233775707615,-0.4286454515674616,4,4,1,1,3,1,1,2,1,3,3,1,1,1,4,4,1,1,3,2,1.2523661815266247,0,1,1,3,2,1.4,0,1,5,1,4,1,1,3,1,1,1,1,3,2,4,4,2,2,1,1,1,1,1,1,1,4,0,0,5,4,5,4,3,3,1,4,3,3,5,1,1,2,1,2,1,1,1,1,1,4,1,1,1,5,2,1,2,1,1,3,3,2,1,3,1,2,2,1,2,1.4268973460049732,1.4735767952260144,1.25,0,1.75,0,1.8,0,2.4444444444444446,0,1.6666666666666667,0,1.8333333333333333,0,1.7142857142857142,0,1.6666666666666667,0,1.945945945945946,0,1,0,0,-0.7106183086427063,-0.2989446853297732,-0.5047814969862398,5,1,3,1,1,3,2,4,3,1.4960264830861913,1.7142857142857142,0,3.5,0.4466865486650409,4,4,5,4,4,3,2,1,3,2,2,0.9511897312113419,4,0,2,7,3.8333333333333335,3.2559414990859232,1.5194825076544112,0,0.5049736980874192,4,4,4,1,4,4,2,5,3,2,5,1,1,3,3,5,1,5,2,5,1.5976172734359604,3.4,0,1.2,0,2.4,0,2.2,0,1.9333333333333333,0,1,1,1,3,2,1,1,2,1,1,3,3,1,1,1,3,1,2,1,1,0.8255779474818965,1.45,0,"Asian or Asian American (e.g., Chinese, Japanese, and others)",0,26,0,1,NA,1,2,5,Freelance Writer,2,0,120,60,3,5,2,0,0,1,0,0,TRUE,TRUE,TRUE,TRUE,TRUE,5,0.9214500000476837,0.64,0.04318328366595294,5,0.505246666653951,0.5691406249701977,0.967741935483871,1,0.002428493035036804,0.0036319128021363683,5,0.6750343750715255,0.7391354838032876,1,0.96875,0.00950159328717493,0.015543563691625288,1.2063,0.5048,0.5883,0,20.1311,0.004,ML,change,50,-28.52613098371556,0.561039066139785,1.0255331217170673,0.6655415514110299,1.474,4.8133,0.416,4.9712,0.3648,0,-80.8735,0.014,ML,cueing,63,174.1764041791746,4.680353340234037,0.8852183639161652,0.4775283867795546,4.7437345067717,0.7169872969928931,0.4345502510906285,0.062,0.507,0.319,0.042,1.823,43.056320782220936,1869.2735759105651,0.064,0.509,0.35,0.041,1.923,56.359933185123495,1880.2062041968304,428,1.268148148148148,1,0,0,1,FALSE,FALSE,FALSE
471,2021-11-13T07:37:42Z,2021-11-13T08:14:27Z,2204,1,2021-11-13T08:14:28Z,0.8999999761581421,Chrome,95.0.4638.69,Macintosh,1792,1120,Simple and easy to understand. Fun aswell.,1.6,772,49,464,87,91,119,-0.044191233823082085,-0.3706971830899965,0.1756977254799115,-0.21425351304917153,0.26318665008196307,0.2301178521058083,3,3,2,2,3,2,3,2,2,3,3,2,2,2,3,3,3,2,3,3,0.5104177855340404,0,1,4,3,3,2.15,0,3,4,4,4,2,2,4,2,2,1,2,4,2,4,3,3,2,1,1,2,1,1,3,3,2,0,0,4,3,3,5,3,3,4,3,3,2,4,3,1,4,2,3,2,3,3,1,2,4,1,2,1,3,1,2,3,2,2,3,2,3,1,1,1,2,2,2,2,1.070348375831741,1.0600988273786194,1.75,0,2,0,2.2,0,2.5555555555555554,0,2.1666666666666665,0,1.5,0,2.2857142857142856,0,1,0,2.135135135135135,0,2,0,0,-0.2425407932851232,-0.01745100881601569,-0.12999590105056946,4,2,3,2,2,2,3,1,3,0.7867957924694432,2.2857142857142856,0,2,0.2350737771240448,3,4,4,4,3,3,3,6,6,1,3,0.5345224838248488,3.4285714285714284,0,2.5714285714285716,3,3.8333333333333335,3.2559414990859232,-0.7395711320441822,0,-0.3058691320761303,3,3,2,2,2,3,4,2,2,3,2,4,1,3,3,3,3,2,3,3,0.7988086367179802,2.4,0,3.6,0,3.6,0,3.4,0,3.533333333333333,0,1,1,2,2,2,1,2,2,1,1,3,2,3,2,1,3,2,2,2,1,0.6958523739384593,1.9,0,"Asian or Asian American (e.g., Chinese, Japanese, and others)",0,21,0,1,NA,0,3,5,Student,1,0,230,68,1,5,2,0,0,0,0,0,TRUE,TRUE,TRUE,TRUE,TRUE,2,1.1446437499895692,0.6956521739130435,0.23241963420518566,2,0.5099031250029802,0.5611299999872843,1,0.967741935483871,0.004264328052748999,0.005018665161472265,2,0.654362500011921,0.7702928571403026,1,0.9032258064516129,0.011257220485668492,0.02137272606968794,1.4695,0.5519,0.6363,0,38.712,0.003,ML,change,46,-65.93807581053272,0.5204489495761804,1.5883951228216733,0.5475189809492833,1.3679,4.1162,0.4036,5.0271,0.3738,0,-78.5268,0.009,ML,cueing,63,169.4830041791746,3.956466884997383,0.859655212725079,0.4594997311801454,4.496243702201614,0.921465783619073,0.4106347092981246,0.085,0.458,0.441,0.011,1.79,20.64853010925146,1886.825937935259,0.087,0.449,0.448,0.011,1.88,28.16105596105819,1884.6505684832239,447,1.3244444444444445,1,0,4,5,FALSE,FALSE,FALSE
472,2021-11-13T07:24:43Z,2021-11-13T08:15:11Z,3028,1,2021-11-13T08:15:13Z,1,Chrome,95.0.4638.69,Windows NT 10.0,1280,720,"Thanks! I didn't start the study right away, but once I started I completed it in one sitting.",1.7777777777777777,2415,85,280,56,32,77,4.177278776031747,-0.04364660381543503,-0.7101222752265024,-0.5920321156045217,-0.5517248684918825,-0.47931955185002084,3,3,1,1,1,1,1,4,1,4,3,1,1,1,3,4,1,1,3,3,1.234376040972246,0,1,1,3,3,1.45,0,5,5,2,4,3,1,3,2,2,2,2,5,2,3,4,2,2,1,1,1,1,1,1,0,2,0,0,4,4,3,4,4,5,5,5,5,2,4,2,1,3,2,4,2,2,2,2,2,5,1,1,1,1,1,1,1,1,1,3,3,3,1,1,1,1,1,1,1,1.464802254792655,1.3093073414159542,1.25,0,1,0,1.9333333333333333,0,1.6666666666666667,0,2,0,0.8333333333333334,0,1.7142857142857142,0,1,0,1.6486486486486487,0,0,0,0,-0.781081590524493,-0.7372407672780129,-0.7591611789012529,5,1,4,1,1,2,1,1,1,1.6761634196950514,1.2857142857142858,0,1,-0.7321841937363471,5,5,5,5,5,3,1,6,8,5,3,1.5735915849388864,4.714285714285714,0,1.2857142857142858,2,3.8333333333333335,3.2559414990859232,-1.3043345419688306,0,-1.3052898138313853,2,2,3,3,3,3,3,3,3,3,3,2,3,2,3,3,3,2,3,4,0.5163977794943222,2.6,0,3,0,3,0,2.6,0,2.8666666666666667,0,2,1,1,4,2,1,2,3,1,1,2,3,1,1,1,3,1,1,1,1,0.9333020044867296,1.35,0,Black or African American,0,22,0,1,NA,1,3,4,student (studying information science),6,0,130,71,3,5,2,0,0,1,0,0,TRUE,TRUE,TRUE,TRUE,TRUE,2,1.0607588235280092,0.68,0.0673436527570011,2,0.4559481481479274,0.5149874999995033,0.84375,0.7741935483870968,0.004130404354946127,0.004700297333268484,2,0.5289677419316384,0.6183565217399078,1,0.71875,0.00436588625804471,0.005725897006246658,1.4663,0.5519,0.5527,0,36.192,0.003,ML,change,50,-60.64793098371556,0.6503167524709151,1.1590840917328085,0.7399380300928338,0.7715,1.6808,0.3881,2.3486,0.3468,0,-51.3753,0.011,ML,cueing,63,115.1800041791746,1.9813673611566796,0.6218653367608383,0.42893002946266645,2.6534829146938392,0.6355416664760424,0.37361581179054537,0.053,0.395,0.38,0.008,1.326,187.2474672516615,2117.892709250633,0.053,0.395,0.41,0.008,1.423,228.35356937573778,2114.1429665317773,374,1.108148148148148,1,0,0,1,FALSE,FALSE,FALSE
473,2021-11-13T07:55:54Z,2021-11-13T08:15:30Z,1176,1,2021-11-13T08:15:31Z,1,Chrome,94.0.4606.61,Windows NT 10.0,1536,864,NA,1.7777777777777777,704,44,223,47,27,92,-0.21890819101731726,-0.4161208746559078,-0.9845339058801198,-0.7017097744109136,-0.6207851666761067,-0.2259490504372247,4,4,1,1,4,1,1,4,1,4,4,1,1,1,4,4,1,1,4,4,1.538967528127731,0,1,1,3,3,1,0,5,5,1,5,1,1,5,1,1,1,1,5,1,5,5,1,1,1,1,1,1,1,1,0,2,0,0,5,5,5,5,5,5,5,5,5,1,5,1,1,5,1,5,1,1,1,1,1,5,1,1,1,2,1,1,1,1,1,5,1,1,1,1,1,1,1,1,1,1.9521298140264163,2.065591117977289,1,0,1,0,1,0,1,0,1,0,1,0,0.8571428571428571,0,1,0,1.027027027027027,0,0,0,0,-1.556758432558337,-0.7372407672780129,-1.146999599918175,5,1,5,1,1,1,1,1,2,1.9518001458970664,1,0,1.5,-0.7186247266594448,5,5,5,5,2,2,1,8,7,3,3,1.8126539343499315,4.142857142857143,0,1.8571428571428572,1.5,3.8333333333333335,3.2559414990859232,-1.5867162469311549,0,-1.1277966766268004,1,1,1,1,1,1,4,1,1,4,1,4,1,5,4,1,5,1,4,1,1.7265434778633235,1,0,4.8,0,4.4,0,4.8,0,4.666666666666667,0,1,1,1,1,1,1,1,4,1,1,1,4,1,1,1,4,1,1,1,1,1.0990426455975697,1.15,0,"Asian or Asian American (e.g., Chinese, Japanese, and others)",0,19,0,1,NA,1,3,4,Student,4,0,185,65,3,5,2,0,0,1,0,0,TRUE,TRUE,TRUE,TRUE,TRUE,3,0.9298878048454843,0.82,0.06760752613893951,3,0.5226249999403954,0.7073093750029802,1,1,0.01249996258653087,0.01630834087848904,3,0.8402064516159796,1.0742781250178814,1,1,0.029759411969301142,0.20338684174743982,1.5078,1.0589,0.5112,0,25.8199,0.003,ML,change,50,-39.90373098371556,1.211937273850889,1.2511765436093456,0.5995270653966447,2.1092,3.54,0.4094,4.7299,0.2997,0,-52.5484,0.008,ML,cueing,64,117.57344925007902,3.2152152214881133,1.2886026100840446,0.5131802588281156,3.4362544564164725,1.2057124345535912,0.3526675745243676,0.144,0.372,0.251,0.093,1.592,129.28741639843892,1928.4420146394948,0.133,0.399,0.239,0.013,1.693,148.84408335184642,1932.9967820416507,382,1.1318518518518519,1,0,0,1,FALSE,FALSE,FALSE
474,2021-11-13T08:05:04Z,2021-11-13T08:27:59Z,1375,1,2021-11-13T08:28:01Z,1,Chrome,95.0.4638.69,Windows NT 10.0,1500,1000,thanks,1.5,695,66,316,79,52,108,-0.2420324941753778,-0.21625663176589804,-0.5368096663926388,-0.31174476532151996,-0.2754836757549857,0.04431281773642447,4,2,1,1,4,2,3,4,1,3,3,2,1,3,4,3,1,1,3,3,1.145931016569864,0,1,1,4,3,1.65,0,5,5,1,5,2,1,4,1,1,1,2,4,1,4,4,1,1,1,1,1,1,1,1,3,2,0,0,5,5,5,3,3,4,5,5,4,2,5,1,1,5,1,5,2,2,1,1,1,5,1,1,1,3,1,1,3,3,3,5,1,1,1,1,1,2,1,2,2,1.7032031296650734,1.709915063331955,1,0,1.75,0,1.4,0,1.6666666666666667,0,1.25,0,1.1666666666666667,0,1.7142857142857142,0,1,0,1.4594594594594594,0,2,0,0,-1.1990217706969584,-0.0958522115332568,-0.6474369911151076,5,3,4,1,1,2,2,3,1,1.5118578920369088,1.7142857142857142,0,2,-0.10679496349653231,5,5,5,5,4,3,1,4,7,6,5,1.5275252316519468,4.571428571428571,0,1.4285714285714286,3.5,3.8333333333333335,3.2559414990859232,-0.4571894270818581,0,-0.8020462589664623,3,3,4,3,3,3,4,3,3,3,2,3,1,4,2,1,4,2,5,3,1.1254628677422756,3.2,0,3.6,0,4.4,0,3,0,3.6666666666666665,0,1,1,1,4,1,2,1,3,1,1,1,4,1,3,1,4,1,2,1,2,1.1516578439248717,1.3,0,"Hispanic of Latino (e.g., Mexican American, Central American, and others)",0,23,0,1,NA,1,4,6,software engineer,5,0,140,66,3,5,2,0,0,1,0,0,TRUE,TRUE,TRUE,TRUE,TRUE,2,1.0312861111097866,0.72,0.07608234093471006,2,0.563828125,0.709512903224076,1,0.96875,0.004967971118917582,0.009424340554189484,2,0.8481774193548387,1.0127593750022352,0.96875,1,0.015458947580859812,0.021252387650312416,1.6027,0.6451,0.4994,0,40.6318,0.003,ML,change,50,-69.52753098371556,0.7785479132421371,1.2131065959804495,0.688489673567098,2.0452,3.679,0.4477,5.0249,0.3603,0,-58.1328,0.008,ML,cueing,64,128.74224925007903,3.3954557420259253,1.0113479501388614,0.5698941340085084,4.327805442788297,0.9573292471581657,0.4566822839444737,0.323,0.283,0.555,0.012,1.805,114.96538457694265,1965.3281950908795,0.327,0.27,0.567,0.011,1.92,121.0439190244685,1943.992156525193,104,0.3081481481481481,1,1,1,2,FALSE,FALSE,FALSE
476,2021-11-13T08:01:27Z,2021-11-13T08:32:46Z,1878,1,2021-11-13T08:32:48Z,0.8999999761581421,Chrome,95.0.4638.69,Windows NT 10.0,1366,768,NA,1.7786458333333333,1170,62,328,86,39,103,0.9784168391667062,-0.2525955850186271,-0.479038796781351,-0.2264399195832151,-0.4550404510339686,-0.040144016067840904,3,3,1,1,3,1,1,3,1,4,3,1,1,1,4,3,1,1,3,4,1.2258187382102494,0,1,1,4,4,1.35,0,4,5,3,4,2,2,4,2,2,1,1,4,3,4,5,2,1,1,1,1,1,1,2,1,2,0,0,5,4,5,5,5,5,5,5,5,2,5,3,2,5,2,5,2,2,2,2,2,5,1,1,1,3,1,2,2,2,1,5,1,5,1,1,1,2,1,2,2,1.699673171197595,1.3345232785352157,1.25,0,1.75,0,1.8666666666666667,0,1.1111111111111112,0,1.8333333333333333,0,1.1666666666666667,0,1.8571428571428572,0,1,0,1.5405405405405406,0,1,0,0,-0.8561908030798041,-0.2989446853297732,-0.5775677442047886,5,1,5,1,1,1,2,1,1,1.889822365046136,1.1428571428571428,0,1,-0.8176513788914915,5,5,5,5,3,3,2,6,6,5,4,1.2909944487358056,4.285714285714286,0,1.7142857142857142,3,3.8333333333333335,3.2559414990859232,-0.7395711320441822,0,-0.783895116604751,2,3,2,1,2,2,4,2,1,3,2,5,2,4,4,2,4,1,4,2,1.2649110640673518,2,0,4.4,0,3.8,0,4.2,0,4.133333333333334,0,1,1,1,4,1,1,1,4,1,1,1,4,1,1,1,4,1,1,1,1,1.231174022502185,1,0,"White, Caucasian, Anglo, European American",0,26,0,1,NA,1,4,4,tech support,4,0,135,67,3,5,2,0,0,1,0,0,TRUE,TRUE,TRUE,TRUE,TRUE,6,1.0132222222222158,0.72,0.08850988850612927,6,0.6414468749999869,0.7028199999999953,1,0.967741935483871,0.01930765676411203,0.021358012580644056,6,0.6617906249999869,0.7424161290322701,1,0.96875,0.01871506216734104,0.0057102288608847345,1.4334,0.6626,0.5867,0,35.7714,0.004,ML,change,50,-59.80673098371556,0.7496496857021203,1.2598706127066144,0.6434874780051794,1.5871,2.9116,0.4515,2.9881,0.3759,0,-35.5647,0.009,ML,cueing,63,83.5588041791746,2.7546370272419707,1.2347170781580403,0.493162992488239,3.0823368751453777,1.3441537684605362,0.4302193200730568,0.312,0.176,0.638,0.015,1.597,214.48906523640753,2072.485871408217,0.311,0.183,0.645,0.017,1.628,232.76601265179255,2055.0568280218677,400,1.1851851851851851,1,0,0,1,FALSE,FALSE,FALSE
477,2021-11-13T07:10:49Z,2021-11-13T08:35:28Z,5078,1,2021-11-13T08:35:29Z,1,Chrome,95.0.4638.69,Windows NT 10.0,1920,1080,None,1.7777777777777777,593,33,193,27,37,54,-0.5041079299667306,-0.5160529961009127,-1.1289610799083394,-0.9454379050917848,-0.4826645703076583,-0.8678209873496415,2,2,1,1,1,1,1,2,1,3,1,1,1,1,2,2,1,1,1,1,0.5871429486123998,0,1,2,3,3,2.15,0,3,2,3,3,3,1,2,3,2,2,2,2,3,2,2,3,2,5,1,3,3,3,2,6,1,1,1,2,2,1,2,2,3,2,2,2,2,3,2,2,1,2,1,4,3,2,2,2,1,1,1,1,5,5,1,5,5,5,4,2,2,2,2,2,1,2,5,5,1.2769614836128107,0.6172133998483676,2.75,0,3.25,0,3,0,4,0,2.8333333333333335,0,2.8333333333333335,0,3,0,2,0,3.135135135135135,0,3,1,1,0.9607552511576953,0.9607303330589108,0.960742792108303,4,2,1,2,2,2,2,3,2,0.8997354108424374,2.4285714285714284,0,2.5,0.5050347996663801,3,3,5,5,1,1,3,3,3,2,2,1.632993161855452,3,0,3,6,3.8333333333333335,3.2559414990859232,0.9547190977297628,0,0.7802889750751523,2,1,1,1,1,2,3,2,2,1,1,4,4,4,4,4,3,2,2,3,1.0997835284835873,1.2,0,4,0,2,0,3.8,0,3.2666666666666666,0,2,1,1,1,1,3,3,2,2,1,3,2,4,2,1,1,1,1,1,3,0.9514531821875089,2.2,0,"White, Caucasian, Anglo, European American",0,29,0,1,NA,1,2,3,Computer Technician Supervisor,2,0,135,68,2,5,2,0,0,1,0,0,TRUE,TRUE,TRUE,TRUE,TRUE,3,0.9551677419408675,0.62,0.10696001225375167,3,0.5013633333563805,0.5572161290453327,0.9375,1,0.008151378712460996,0.003919305398803814,3,0.7401750000081957,0.7875870967641954,1,0.96875,0.01956386709574157,0.0222306825399176,1.5175,0.3301,0.3829,0,46.6418,0.004,ML,change,50,-81.54753098371557,0.38220536526292237,1.2808512642985568,0.5530222838045229,1.2579,5.0928,0.4337,3.0434,0.3201,0,-70.3533,0.015,ML,cueing,63,153.13600417917462,4.592088168117526,0.9022332705101269,0.4620482610942054,3.102340119535677,0.8729056443712949,0.3782639294555602,0.071,0.497,0.312,0.014,1.526,70.4389383649454,1911.0478275938412,0.074,0.496,0.318,0.017,1.591,80.8736627818605,1904.3128493226454,290,0.8592592592592593,1,0,0,1,FALSE,FALSE,FALSE
478,2021-11-13T07:56:48Z,2021-11-13T08:37:29Z,2440,1,2021-11-13T08:37:30Z,1,Opera,80.0.4170.91,Windows NT 10.0,1536,864,None,1.7777777777777777,903,84,700,131,60,355,0.29239584547757685,-0.0527313421286173,1.311858161168573,0.32194837444874486,-0.16498719866022699,4.216480407667134,3,3,3,3,3,2,2,2,2,3,2,3,3,2,3,3,3,2,3,3,0.4893604849295929,0,1,2,3,3,2.35,0,4,4,2,4,2,2,2,2,2,2,2,4,2,4,4,3,3,2,2,2,2,2,2,3,2,0,0,4,3,4,4,4,4,4,4,4,2,2,3,2,4,2,4,3,3,3,3,2,4,2,1,3,3,1,2,3,3,3,4,2,2,2,2,2,2,2,2,2,0.936417042175588,1.01418510567422,2.25,0,2,0,2.1333333333333333,0,2.111111111111111,0,2.5833333333333335,0,1.8333333333333333,0,2.2857142857142856,0,2,0,2.2972972972972974,0,2,0,0,0.013372554648178757,-0.01745100881601569,-0.002039227083918466,3,2,3,2,3,2,2,1,1,0.5345224838248488,2.4285714285714284,0,1,-0.048446712495193056,4,4,4,4,3,3,3,3,3,3,2,0.5345224838248488,3.5714285714285716,0,2.4285714285714284,6,3.8333333333333335,3.2559414990859232,0.9547190977297628,0,0.46160498538940525,3,3,3,3,3,2,4,2,3,2,3,4,3,3,3,3,3,2,3,3,0.6399404734221844,3,0,3.6,0,3,0,3.2,0,3.2666666666666666,0,2,2,2,2,2,2,2,3,1,2,2,2,2,2,2,2,1,2,2,1,0.44721359549995793,2,0,Prefer not to say,0,19,3,5,NA,1,3,3,stocks,7,0,143,63,2,5,2,0,0,0,0,0,TRUE,TRUE,TRUE,TRUE,TRUE,NA,NA,NA,NA,6,0.5430387096774216,0.6130935483871013,0.96875,0.96875,0.017042679354839493,0.015272903870969204,6,0.861765625,0.8642437500000196,1,1,0.07051352684476203,0.04466776770161948,NA,NA,NA,NA,NA,NA,NA,NA,NA,NA,NA,NA,NA,1.7533,2.7799,0.3102,2.7143,0.2327,0,-25.597,0.009,ML,cueing,64,63.670649250079016,3.0094034344867526,1.1410856933081175,0.43535602319902245,2.928035571995927,1.1727955894143498,0.3552855492322994,0.144,0.394,0.321,0.127,1.472,22.497605638638802,1817.4496675958603,0.141,0.398,0.318,0.052,1.621,28.376330094814662,1810.2212467459567,432,1.28,1,0,0,1,FALSE,FALSE,FALSE
479,2021-11-13T07:55:14Z,2021-11-13T08:38:29Z,2594,1,2021-11-13T08:38:30Z,1,Chrome,95.0.4638.69,Windows NT 10.0,1366,768,N/A,1.7786458333333333,765,289,432,106,57,88,-0.06217680294601806,1.8096400120737468,0.02164207318314386,0.017288211097655985,-0.2064233775707615,-0.293514517480637,2,2,3,2,2,1,3,1,3,1,1,4,2,4,1,1,3,2,1,1,1.025978352085154,0,1,2,2,2,3.2,0,3,4,4,3,4,3,3,4,4,3,3,2,1,2,1,2,3,4,2,1,4,3,4,2,2,0,0,4,4,3,4,4,5,4,4,5,2,4,1,1,2,2,4,5,3,3,5,5,2,1,3,1,5,5,1,4,1,1,3,5,4,1,2,1,1,1,1,1,1.5161790127814059,1.0327955589886444,2.875,0,1,0,3.3333333333333335,0,1.8888888888888888,0,2.9166666666666665,0,3,0,2.5714285714285716,0,1.3333333333333333,0,2.5405405405405403,0,1,0,0,0.902197166626815,-0.5341482934814965,0.18402443657265927,5,2,3,1,1,2,1,1,1,1.4638501094227998,1.5714285714285714,0,1,-0.5612498234260587,4,4,5,4,2,2,3,6,6,NA,2,1.1338934190276817,3.4285714285714284,0,2.5714285714285716,3,3.8333333333333335,3.2559414990859232,-0.7395711320441822,0,-0.3058691320761303,3,2,5,3,4,2,3,3,4,2,1,3,4,4,5,4,4,2,3,5,1.162919151265879,3.4,0,4,0,2.4,0,3,0,3.1333333333333333,0,3,1,3,1,3,3,4,4,4,4,2,1,1,4,2,2,1,3,3,3,1.142481141154959,2.8,0,"White, Caucasian, Anglo, European American",0,27,0,1,NA,1,4,6,Freelance artist,7,0,190,69,2,5,2,0,0,1,0,0,TRUE,TRUE,TRUE,TRUE,TRUE,2,0.9178083333348235,0.72,0.07004887218011878,2,0.4487937499987893,0.5271290322590259,1,0.96875,0.002205985120979724,0.003658209828599464,2,0.5683062499999069,0.6839290322589298,1,0.96875,0.006799052217942457,0.006414565231945262,1.2117,0.7913,0.6229,0,18.1541,0.003,ML,change,50,-24.57213098371556,0.7947966443372991,1.1883059843921997,0.588884804997255,1.1718,3.8473,0.381,5.8484,0.3486,0,-89.5817,0.011,ML,cueing,64,191.64004925007902,4.301735106728962,0.7982795591280256,0.44014237825610225,5.301659719635445,0.7814788095597399,0.3773955806710665,0.099,0.381,0.561,0.007,1.311,117.95495274217569,1966.3075841439993,0.103,0.382,0.592,0.008,1.357,156.3169261433231,1982.8553977394781,336,0.9955555555555555,1,0,1,2,FALSE,FALSE,FALSE
480,2021-11-13T08:09:44Z,2021-11-13T08:38:30Z,1725,1,2021-11-13T08:38:31Z,1,Chrome,94.0.4606.81,Macintosh,1440,900,No,1.6,691,89,568,106,103,113,-0.2523099622456269,-0.0073076505627059805,0.6763785954444064,0.017288211097655985,0.4289313657241011,0.12876965154068984,2,2,3,3,2,3,2,2,1,3,2,1,2,2,2,2,3,2,2,2,0.5871429486123998,0,1,2,4,4,2.55,0,2,4,2,4,2,3,3,4,2,2,3,3,5,3,3,3,4,5,2,3,4,3,3,7,1,3,3,5,3,3,3,4,4,3,3,3,2,4,4,2,3,2,4,2,3,3,4,4,2,2,1,2,5,1,2,4,1,1,4,1,2,1,1,2,2,2,1,1,1.1987230443004493,0.9258200997725514,3.375,0,1.5,0,2.8666666666666667,0,2.5555555555555554,0,2.75,0,2.3333333333333335,0,1.7142857142857142,0,1.3333333333333333,0,2.3783783783783785,0,4,3,3,0.8468331594339827,1.3811800968191483,1.1140066281265655,5,2,4,1,1,3,2,1,1,1.5118578920369088,1.7142857142857142,0,1,-0.4757826382709144,5,5,5,5,3,3,2,7,7,6,4,1.2909944487358056,4.285714285714286,0,1.7142857142857142,2,3.8333333333333335,3.2559414990859232,-1.3043345419688306,0,-1.0662768215670753,2,2,2,3,2,2,4,3,2,4,3,4,3,3,3,3,4,2,3,3,0.7037315505489968,2.2,0,3.8,0,3.4,0,3.2,0,3.466666666666667,0,2,2,1,1,2,2,3,2,2,2,2,2,1,3,2,3,2,2,2,1,0.6048053188292994,2.15,0,"Asian or Asian American (e.g., Chinese, Japanese, and others) & White, Caucasian, Anglo, European American",1,18,0,1,NA,1,4,4,Assistant/College student,6,0,111,68,1,5,2,0,0,1,0,0,TRUE,TRUE,TRUE,TRUE,TRUE,4,0.7891951219454044,0.8367346938775511,0.1039671439612157,4,0.4702290322588336,0.5315300000230472,1,0.9375,0.0028297561280799673,0.005198726288899415,4,0.6200593750029803,0.657696774182781,1,1,0.007601781198724721,0.005897156988337912,1.4013,1.2411,0.3962,0,14.6021,0.004,ML,change,49,-17.528739105668123,1.1556952034507173,1.4139805375545602,0.37720387889050155,1.0185,3.2757,0.3894,4.8997,0.3663,0,-80.4244,0.009,ML,cueing,63,173.27820417917462,3.4715461157724814,0.7800703521691862,0.43322199324662625,4.9816732902415035,0.83167531971786135,0.38936408798850997,0.176,0.331,0.612,0.024,1.244,26.26993495842285,1814.1987233234195,0.179,0.329,0.615,0.024,1.33,36.11037317605006,1816.902841730546,104,0.3081481481481481,1,0,0,1,FALSE,FALSE,FALSE
481,2021-11-13T08:21:03Z,2021-11-13T08:41:20Z,1217,1,2021-11-13T08:41:21Z,1,Chrome,95.0.4638.69,Windows NT 10.0,1280,720,NA,1.7777777777777777,601,45,306,58,44,114,-0.4835529938262323,-0.40703613634272556,-0.5849520577353787,-0.5676593025364346,-0.3859801528497444,0.1456610183015429,2,2,2,1,3,1,2,3,1,3,2,1,1,2,3,3,2,2,3,2,0.7591546545162482,0,0,4,4,4,1.95,0,3,3,3,3,4,2,2,4,2,2,2,2,1,3,3,2,4,4,3,2,3,3,3,4,2,3,0,3,3,3,4,4,4,3,3,3,3,3,4,3,3,3,4,3,4,4,4,4,2,4,4,4,4,4,3,3,3,1,3,2,3,2,2,2,2,2,2,2,0.775952383914182,0.828078671210825,3,0,2,0,2.8666666666666667,0,2.6666666666666665,0,3.3333333333333335,0,3.8333333333333335,0,2.4285714285714284,0,2,0,3.027027027027027,0,2,3,0,0.9644332796075691,0.6024486139630555,0.7834409467853123,2,4,2,2,3,3,3,3,1,0.7559289460184544,3.2857142857142856,0,2,0.8333440732100549,4,4,4,4,1,1,2,4,6,2,2,1.4638501094227998,3.142857142857143,0,2.857142857142857,4,3.8333333333333335,3.2559414990859232,-0.1748077221195339,0,0.13585456772906723,3,3,3,2,3,3,3,2,2,4,2,4,1,4,3,2,4,4,3,3,0.9611501047232549,2.8,0,3.4,0,3.8,0,3.6,0,3.6,0,1,1,1,1,1,1,1,3,1,1,2,3,2,1,2,3,1,1,1,2,0.7608859102526822,1.5,0,"White, Caucasian, Anglo, European American",0,29,0,1,NA,1,3,8,research associate,4,0,150,70,3,5,2,0,0,1,0,0,TRUE,TRUE,TRUE,TRUE,TRUE,6,0.6983108107914796,0.74,0.02128745792160262,6,0.46360400005340574,0.5946392857091768,0.8333333333333334,0.875,0.010269709242556735,0.027897738545736347,6,0.579551724137931,0.6349958333472411,0.90625,0.75,0.014023092104654005,0.029719468992015777,1.0479,1.0283,0.4495,0,0.9028,0.004,ML,change,50,9.930469016284437,1.174714860547579,0.8904020799525104,0.5163973044883495,1.1068,1.8103,0.3435,1.5887,0.2232,0,-14.4006,0.006,ML,cueing,62,41.182603155135276,1.8339118164945967,1.0610707295483783,0.37767055253355175,2.036713263461249,0.79021330165002,0.33427581301361453,0.05,0.384,0.226,0.01,1.42,105.19518650956869,2154.635790796682,0.05,0.385,0.257,0.011,1.531,141.69458662192034,2151.8492723439567,320,0.9481481481481481,1,0,0,1,FALSE,FALSE,FALSE
482,2021-11-13T07:58:26Z,2021-11-13T08:44:04Z,2737,1,2021-11-13T08:44:05Z,0.8999999761581421,Firefox,94.0,Windows NT 10.0,1536,864,NA,1.7777777777777777,1637,88,547,158,64,126,2.178311236368292,-0.016392388875888245,0.5752795736246525,0.6509813508679207,-0.10973896011284763,0.3483574194317798,1,2,3,3,1,3,4,1,2,1,1,3,2,2,1,1,3,2,1,1,0.9679060415469871,0,1,2,3,1,3.3,0,3,4,3,4,1,2,2,4,3,1,4,2,4,2,4,2,5,1,1,2,5,2,3,0,2,0,0,5,2,4,4,5,3,5,5,2,1,5,1,2,2,1,4,3,3,1,5,5,2,1,1,1,2,2,1,1,3,1,5,2,2,1,2,1,2,1,2,2,1.5538386062955234,1.1254628677422756,2.625,0,1.75,0,2.8666666666666667,0,2.111111111111111,0,2.4166666666666665,0,1.6666666666666667,0,1.4285714285714286,0,1.3333333333333333,0,2,0,0,0,0,0.36191414538487376,-0.5020371591262895,-0.07006150687070789,5,1,3,1,1,1,1,1,1,1.5735915849388864,1.2857142857142858,0,1,-0.7321841937363471,5,5,5,5,3,3,3,3,1,NA,3,1.0690449676496976,4.142857142857143,0,1.8571428571428572,7,3.8333333333333335,3.2559414990859232,1.5194825076544112,0,0.4253027006659825,2,2,1,1,1,2,3,2,2,2,5,4,2,3,4,4,4,3,3,2,1,1.4,0,3.2,0,2.8,0,3.8,0,3.2666666666666666,0,1,1,4,1,4,4,4,1,4,4,2,1,1,4,2,1,2,4,4,4,1.4244112357114616,3.25,0,"White, Caucasian, Anglo, European American",0,27,0,1,NA,1,3,1,unemployed,1,0,180,70,1,5,2,0,0,1,0,0,TRUE,TRUE,TRUE,TRUE,TRUE,1,0.8391025641025641,0.78,0.12811102040816327,1,0.6118387096774194,0.7431666666666666,0.96875,0.967741935483871,0.06956892641129032,0.0891898559139785,1,0.5970625,0.6565806451612903,1,0.96875,0.020989673387096768,0.012883016129032258,1.3594,0.9313,0.4828,0,24.4421,0.003,ML,change,50,-37.14813098371556,0.8875508391415025,1.4260212683202595,0.3892286667200903,1.5793,2.5242,0.4469,1.9108,0.2136,0,-10.9929,0.007,ML,cueing,63,34.415204179174594,1.9269734227034134,1.76504633721959,0.3147299377202099,2.0599514817273685,1.6670233425136707,0.23250104141931688,0.112,0.292,0.364,0.017,1.484,142.20388756838278,2028.2819408426255,0.092,0.329,0.357,0.013,1.542,156.02925775544193,1979.7384871193217,407,1.2059259259259258,1,1,1,2,FALSE,FALSE,FALSE
483,2021-11-13T08:11:10Z,2021-11-13T08:45:05Z,2035,1,2021-11-13T08:45:06Z,0.8999999761581421,Chrome,95.0.4638.69,Windows NT 10.0,1360,768,NA,1.7708333333333333,963,51,553,93,210,85,0.4465578665313138,-0.35252770646363196,0.6041650084302965,-0.14113507384491022,1.9068217468664987,-0.34418861776319626,3,3,1,1,3,1,2,2,1,3,2,1,2,1,3,3,1,1,2,2,0.8522416262267903,0,1,1,3,2,1.8,0,4,4,2,4,2,2,5,2,2,1,1,5,2,5,2,2,2,1,1,1,1,1,1,1,2,0,0,4,4,2,5,4,4,3,4,4,3,5,1,1,2,1,4,4,1,3,1,1,5,1,1,1,2,4,1,2,1,1,4,1,2,1,3,1,1,1,2,1,1.464802254792655,1.4573295865416045,1.25,0,1.25,0,1.8,0,2.2222222222222223,0,1.9166666666666667,0,1.5,0,1.2857142857142858,0,1.6666666666666667,0,1.837837837837838,0,1,0,0,-0.75707761537795,-0.4557470907642554,-0.6064123530711027,4,2,3,1,1,2,1,1,1,1.1547005383792515,1.7142857142857142,0,1,-0.4757826382709144,3,4,4,3,1,1,3,6,3,1,1,1.2535663410560174,2.7142857142857144,0,3.2857142857142856,4.5,3.8333333333333335,3.2559414990859232,0.10757398284279028,0,0.5160584124745394,2,3,1,4,1,3,2,4,3,1,2,2,4,3,3,4,3,4,2,4,0.9611501047232549,2.2,0,2.8,0,1.8,0,2.6,0,2.4,0,1,1,2,3,1,2,2,2,1,2,2,4,2,1,1,4,2,2,1,3,0.9445132413883326,1.65,0,"White, Caucasian, Anglo, European American",0,23,0,1,NA,1,1,2,unemployed,1,0,170,66,1,5,2,0,0,0,0,0,TRUE,TRUE,TRUE,TRUE,TRUE,2,0.8312674999999814,0.8163265306122449,0.034582752346970884,2,0.45093125000060535,0.517971874999348,1,1,0.00226263124999412,0.002407768538357174,2,0.5949250000003958,0.6485937500001164,1,1,0.003888285161265287,0.005962122540314511,1.3406,1.22,0.4828,0,11.5276,0.003,ML,change,49,-11.37973910566812,1.4139652437975838,1.0549445138916405,0.5952596210711443,6.6874,11.2237,0.2201,11.6091,0.1629,0,-105.5562,0.012,ML,cueing,64,223.58904925007903,5.186911171295085,0.7987672411511649,0.4433797199276057,5.2681611232774825,0.7864479899988258,0.3786221963779839,0.166,0.353,0.688,0.015,1.182,28.238514640377392,1828.3491148196542,0.166,0.353,0.692,0.016,1.224,46.80129939006641,1828.5521082240368,300,0.8888888888888888,1,0,1,2,FALSE,FALSE,FALSE
484,2021-11-13T08:06:03Z,2021-11-13T08:45:09Z,2346,1,2021-11-13T08:45:12Z,1,Chrome,95.0.4638.69,Windows NT 10.0,1920,1080,NA,1.7777777777777777,931,44,310,94,44,107,0.36433812196932075,-0.4161208746559078,-0.5656951011982828,-0.12894866731086665,-0.3859801528497444,0.02742145097557139,3,3,1,1,3,1,1,3,1,4,3,1,1,1,3,3,1,1,3,3,1.0990426455975697,0,1,4,3,3,1.45,0,2,2,4,2,4,3,1,3,4,4,4,2,1,2,2,3,3,5,1,3,3,3,3,15,3,0,1,1,4,1,4,1,4,5,5,5,2,5,5,1,2,1,5,5,5,5,5,5,1,1,5,5,5,5,2,5,5,5,3,3,4,2,2,3,3,5,5,5,1.6421622017013717,1.1126972805283737,3,0,4.5,0,3.7333333333333334,0,2.6666666666666665,0,3.3333333333333335,0,4.166666666666667,0,3.7142857142857144,0,2.3333333333333335,0,3.3513513513513513,0,6,0,1,1.4762599754741736,1.7553805604416417,1.6158202679579077,4,1,3,1,1,2,2,3,3,1.1547005383792515,1.7142857142857142,0,3,0.2621927112778498,4,4,5,5,4,4,1,6,1,5,4,1.3451854182690985,4.428571428571429,0,1.5714285714285714,5.5,3.8333333333333335,3.2559414990859232,0.6723373927674386,0,-0.15761185162037722,2,2,2,2,2,2,5,2,2,4,1,4,2,5,4,1,5,2,4,1,1.533747356112131,2,0,4.4,0,4.4,0,4.4,0,4.4,0,1,2,2,4,4,2,1,4,2,1,3,4,1,2,4,4,2,2,2,2,1.145931016569864,1.85,0,Black or African American,0,23,0,1,NA,1,2,3,IT Manager,3,0,190,73,2,5,2,0,0,0,0,0,TRUE,TRUE,TRUE,TRUE,TRUE,1,0.7818878048785576,0.82,0.021590756326738788,1,0.46468709677481845,0.5803225806451613,0.96875,0.96875,0.0021684678931149035,0.0033118044758133442,1,0.5911064516137684,0.62268387096855915,1,0.96875,0.0062450539570534,0.005954771250039111,1.1528,1.442,0.5304,0,-6.4159,0.003,ML,change,50,24.567869016284437,1.6121741001255716,0.9405606312928488,0.5951961802021232,1.1697,4.083,0.4441,4.6166,0.3473,0,-82.0103,0.007,ML,cueing,64,176.49724925007902,4.41006148725408,0.7786710490114537,0.49755682890246006,4.902556052312835,0.700448331001769,0.39771485787462607,0.255,0.219,0.679,0.041,1.745,136.33266928299255,1979.7053304522726,0.254,0.217,0.674,0.051,1.771,146.8634115965984,1971.0874799102976,322,0.9540740740740741,1,0,0,1,FALSE,FALSE,FALSE
485,2021-11-13T08:10:11Z,2021-11-13T08:45:52Z,2141,1,2021-11-13T08:45:53Z,1,Edge,95.0.1020.44,Windows NT 10.0,1920,1080,NA,1.7777777777777777,648,541,540,208,49,115,-0.362792744000805,4.098994066995677,0.5415798996847346,1.2603016775700986,-0.31691985466552025,0.16255238506239597,4,4,1,1,4,1,1,4,1,4,4,1,1,1,4,4,1,1,4,4,1.538967528127731,0,1,1,3,2,1,0,2,4,1,3,2,3,3,4,4,3,2,1,1,3,3,3,4,4,1,4,4,4,4,0,2,1,0,4,4,1,4,4,4,4,4,4,1,4,1,1,1,1,1,5,5,5,5,5,1,1,1,1,1,5,1,1,1,1,5,1,1,1,1,2,1,4,1,1,1.7419915426128034,1.0555973258234952,3.5,0,1.75,0,2.8666666666666667,0,2.3333333333333335,0,3.4166666666666665,0,2.1666666666666665,0,0.8571428571428571,0,1.3333333333333333,0,2.3513513513513513,0,0,1,0,0.8889369061627975,-0.2954039515332659,0.2967664773147658,4,1,3,1,1,1,1,1,3,1.2535663410560174,1.4285714285714286,0,2,-0.2777293338068208,5,5,5,5,1,1,1,7,1,2,3,2.138089935299395,3.857142857142857,0,2.142857142857143,5,3.8333333333333335,3.2559414990859232,0.38995568780511447,0,0.019881285584207653,2,3,3,1,1,1,4,2,3,2,2,2,1,1,3,2,2,2,1,1,0.8837151016885368,2,0,3.4,0,3.2,0,3.2,0,3.2666666666666666,0,1,1,1,2,1,1,1,1,2,1,1,3,1,1,1,3,1,1,1,1,0.6569466853317864,1.4,0,"White, Caucasian, Anglo, European American",0,21,0,1,NA,1,3,4,IT,3,0,154,70,1,5,2,0,0,0,0,0,TRUE,TRUE,TRUE,TRUE,TRUE,2,1.01570285714282,0.7,0.08332807217957132,2,0.48427499999993595,0.5732285714283851,1,0.9032258064516129,0.006650286451593352,0.009368586903211714,2,0.547903125000099,0.6171548387096714,1,0.96875,0.00762136224797981,0.00945671248989676,1.4615,0.6036,0.5475,0,36.759,0.003,ML,change,50,-61.78193098371556,0.6882547673088615,1.2310817165861632,0.6579627367511214,1.1288,2.7409,0.3993,3.3243,0.3145,0,-53.4016,0.007,ML,cueing,63,119.2326041791746,2.6536460141802154,0.8417069230679255,0.4453298422699599,4.023485182646591,1.029737786598791,0.3603080365983957,0.081,0.353,0.428,0.009,1.189,103.93479319673497,1950.6363810481278,0.082,0.351,0.428,0.01,1.275,128.61717650738925,1952.8749933958406,315,0.9333333333333332,1,0,0,1,FALSE,FALSE,FALSE
486,2021-11-13T07:58:27Z,2021-11-13T08:46:25Z,2877,1,2021-11-13T08:46:27Z,1,Chrome,95.0.4638.69,Windows NT 10.0,1366,768,I just had to go to the bathroom due to the long duration of the study,1.7786458333333333,1648,128,772,102,74,84,2.206574273561477,0.3469971436514023,1.6584833788363,-0.03145741503851823,0.028381636255600768,-0.3610799845240493,3,3,2,2,3,2,1,2,1,3,2,2,1,1,3,2,1,2,2,2,0.7254762501100116,0,1,2,2,2,2,0,4,4,3,3,3,2,4,3,2,1,2,4,3,4,3,2,2,1,1,2,2,2,2,0,2,0,0,4,3,3,3,4,4,3,4,4,4,3,3,3,3,3,4,4,4,3,4,4,3,1,1,1,2,4,1,1,1,1,4,3,3,1,3,1,2,3,3,3,1.166988372633533,0.9258200997725514,1.75,0,2.75,0,2.3333333333333335,0,2.4444444444444446,0,3.3333333333333335,0,1.8333333333333333,0,1.5714285714285714,0,1.6666666666666667,0,2.4594594594594597,0,0,0,0,-0.04586306143925698,-0.18843234825732513,-0.11714770484829105,4,2,3,2,2,3,3,4,3,0.7559289460184544,2.4285714285714284,0,3.5,0.8740224744407622,4,5,4,3,3,3,3,4,4,3,3,0.7867957924694432,3.5714285714285716,0,2.4285714285714284,5,3.8333333333333335,3.2559414990859232,0.38995568780511447,0,0.17922328042708108,2,3,2,1,2,2,4,2,2,3,1,3,4,4,3,3,4,3,3,3,0.8837151016885368,2,0,3.8,0,3,0,3.6,0,3.466666666666667,0,3,3,3,4,3,2,2,3,2,1,4,2,2,2,2,2,1,3,2,2,0.8207826816681233,2.3,0,"White, Caucasian, Anglo, European American",0,30,0,1,NA,1,3,3,Unemployed,2,0,160,66,2,5,2,1,0,1,0,1,TRUE,TRUE,TRUE,TRUE,TRUE,2,1.0388318181810055,0.88,0.09854823086253944,2,0.5750249999947846,0.6581290322657555,1,0.96875,0.0173060909690695,0.01315217208534989,2,0.7987999999970198,0.8605,1,1,0.018803703226133704,0.03328002709582036,1.6506,1.2463,0.5423,0,25.2701,0.003,ML,change,50,-38.80413098371556,1.3607853673008898,1.4641766531059783,0.6299597494844831,1.551,3.1796,0.4261,3.446,0.35,0,-47.0681,0.006,ML,cueing,64,106.61284925007902,3.124003028260025,1.099226592746862,0.4931924234696119,3.16783642950294,1.3078752071304467,0.375045592108118,0.195,0.336,0.414,0.034,1.212,75.87039641168919,1876.7348566383994,0.193,0.342,0.419,0.02,1.279,105.42961859854766,1886.1068746702822,69,0.20444444444444443,1,0,8,9,FALSE,FALSE,FALSE
487,2021-11-13T08:06:00Z,2021-11-13T08:47:05Z,2464,1,2021-11-13T08:47:06Z,1,Chrome,95.0.4638.69,Windows NT 10.0,1280,720,NA,1.7777777777777777,718,100,1176,107,138,149,-0.1829370527714453,0.09262447088229891,3.6034359890829912,0.02947461763169954,0.9123534530136705,0.7368588549314005,4,3,1,1,3,1,1,3,1,3,2,1,1,2,4,3,1,1,3,3,1.1192102478745307,0,1,1,2,2,1.5,0,4,4,3,4,3,2,5,2,2,2,3,5,3,4,4,2,2,1,1,1,1,2,2,0,2,0,0,5,4,3,3,3,3,2,3,3,2,4,2,1,4,2,3,3,3,2,3,3,5,1,2,1,3,4,2,1,2,1,4,1,2,1,1,1,1,2,1,1,1.1695588347184027,1.0465362369445672,1.5,0,1.25,0,2.1333333333333333,0,2.7777777777777777,0,2.3333333333333335,0,1.8333333333333333,0,1.4285714285714286,0,1,0,2.135135135135135,0,0,0,0,-0.3786278459304421,-0.6588395645607719,-0.5187337052456069,4,2,4,1,1,2,2,2,1,1.2535663410560174,1.7142857142857142,0,1.5,-0.2912888008837234,5,5,5,5,4,4,1,7,6,4,4,1.4638501094227998,4.714285714285714,0,1.2857142857142858,2.5,3.8333333333333335,3.2559414990859232,-1.0219528370065065,0,-1.1640989613502233,2,2,3,3,3,2,4,3,2,4,1,4,3,4,5,3,3,2,3,4,1.0600988273786194,2.6,0,4,0,3.4,0,3.6,0,3.6666666666666665,0,2,2,1,4,2,2,2,3,1,2,2,4,2,2,2,4,1,2,2,2,0.8944271909999159,1.7,0,"Asian or Asian American (e.g., Chinese, Japanese, and others)",0,20,0,1,NA,1,4,4,student studying aerospace engineering,5,0,145,70,2,5,2,0,0,3,0,0,TRUE,TRUE,TRUE,TRUE,TRUE,1,1.1532923076932247,0.78,0.37062570295891517,1,0.5858937499988824,0.6159687499990687,1,1,0.07049773157249113,0.0434886893139751,1,0.5951193548373638,0.7180419354852169,1,0.96875,0.012609034279998403,0.03705332500010964,1.7284,0.7179,0.5426,0,50.1265,0.009,ML,change,50,-88.51693098371557,0.6805436372917258,1.8597872406361622,0.38810929981080455,1.5487,2.957,0.3541,2.5266,0.2794,0,-30.6434,0.007,ML,cueing,64,73.76344925007902,2.5160450600010296,1.6466854239843531,0.29895803150180356,2.2298143634800196,1.8580626236192317,0.18227311769164517,0.071,0.42,0.426,0.013,1.595,41.667966801030914,1885.8135082347424,0.072,0.419,0.444,0.013,1.659,61.56717220305233,1884.2371838679135,360,1.0666666666666667,1,1,6,7,FALSE,FALSE,FALSE
488,2021-11-13T08:32:35Z,2021-11-13T08:52:03Z,1168,1,2021-11-13T08:52:05Z,0.8999999761581421,Chrome,94.0.4606.71,Macintosh,1440,900,The second arrow test seemed easier because it the symbols were bigger.,1.6,570,45,285,61,48,83,-0.563203371370663,-0.40703613634272556,-0.6860510795551324,-0.5311000829343039,-0.3307319143023651,-0.3779713512849024,4,4,1,1,4,1,3,4,1,4,3,2,2,1,4,4,2,1,4,4,1.3416407864998738,0,1,2,2,3,1.3,0,4,4,3,4,5,2,4,3,3,1,1,4,1,5,5,4,3,1,1,2,1,2,1,5,4,0,0,3,4,5,5,5,5,5,5,5,3,5,2,3,4,5,3,4,3,2,2,2,4,1,1,1,3,3,1,4,4,3,3,1,3,1,1,1,3,2,4,4,1.4678741957860881,1.4375905768565218,1.875,0,3.25,0,2.066666666666667,0,1.3333333333333333,0,2.6666666666666665,0,1.6666666666666667,0,2.5714285714285716,0,1,0,2.081081081081081,0,3,0,0,-0.2693516848802533,0.5776474785667063,0.1541478968432265,5,1,4,1,2,2,3,3,3,1.5118578920369088,1.7142857142857142,0,3,0.2621927112778498,3,3,4,2,1,3,3,6,6,NA,2,0.9511897312113419,2.7142857142857144,0,3.2857142857142856,3,3.8333333333333335,3.2559414990859232,-0.7395711320441822,0,0.09248585503105322,3,3,2,2,2,2,3,4,3,2,1,3,4,3,4,5,5,4,3,5,1.1832159566199232,2.4,0,3.8,0,2.2,0,2.6,0,2.8666666666666667,0,2,1,1,2,4,3,3,1,3,3,2,3,2,3,1,3,1,2,1,4,1.019545822516343,2.35,0,"Asian or Asian American (e.g., Chinese, Japanese, and others)",0,24,0,1,NA,1,2,4,student,7,0,195,71,3,5,2,0,0,1,0,0,TRUE,TRUE,TRUE,TRUE,TRUE,2,0.7766352941148421,0.6938775510204082,0.0221807263539146,2,0.4527599999944369,0.4889366666555405,0.9375,0.9375,0.003218162811099007,0.0031523891010175396,2,0.5919625000059605,0.6352406250052154,1,1,0.010405581127617747,0.006600063778295539,1.143,0.7568,0.4882,0,11.227,0.003,ML,change,49,-10.778539105668122,0.9274981616434442,0.8822770301387748,0.5922104434803432,0.8622,3.3159,0.3711,3.8359,0.3506,0,-79.7999,0.012,ML,cueing,64,172.076449250079,3.934025970442468,0.6883661219952827,0.4123840000906413,3.91376886456813,0.6919290062370694,0.3754128313945554,0.233,0.218,0.63,0.027,1.129,38.099101576699056,1832.8824011149336,0.229,0.222,0.632,0.018,1.234,52.485691315594366,1835.2308527817154,468,1.3866666666666665,1,0,0,1,FALSE,FALSE,FALSE
489,2021-11-13T08:34:54Z,2021-11-13T08:53:21Z,1106,1,2021-11-13T08:53:22Z,1,Chrome,95.0.4638.69,Macintosh,1440,900,NA,1.6,577,43,263,62,50,73,-0.5452178022477271,-0.4252056129690901,-0.7919643405091602,-0.5189136764002604,-0.3031077950286754,-0.5468850188934331,2,3,2,1,2,1,2,3,1,2,2,2,2,1,2,2,2,1,3,2,0.6407232755171874,0,1,2,3,3,2.1,0,5,5,2,5,2,1,4,2,2,1,2,5,2,4,3,2,2,1,1,2,2,2,1,0,2,0,0,4,3,5,4,3,5,4,5,3,2,5,2,1,4,2,5,1,2,2,2,2,4,1,1,1,1,1,1,1,2,1,5,1,1,1,1,1,1,1,1,1,1.5373234413627352,1.5118578920369088,1.625,0,1,0,1.6666666666666667,0,2,0,1.6666666666666667,0,1,0,1,0,1,0,1.5135135135135136,0,0,0,0,-0.7925996269859388,-0.7372407672780129,-0.7649201971319759,5,2,4,1,1,1,1,2,3,1.6761634196950514,1.2857142857142858,0,2.5,-0.17870268157477404,5,5,5,5,3,3,1,7,7,5,4,1.5735915849388864,4.428571428571429,0,1.5714285714285714,2,3.8333333333333335,3.2559414990859232,-1.3043345419688306,0,-1.145947818988512,2,2,3,1,2,2,4,2,1,5,2,3,2,5,4,3,4,2,3,3,1.1952286093343936,2,0,3.8,0,3.8,0,4.2,0,3.933333333333333,0,2,1,2,3,3,1,2,3,1,1,3,3,2,3,1,3,1,2,2,2,0.8255779474818965,1.85,0,"Asian or Asian American (e.g., Chinese, Japanese, and others)",0,23,0,1,NA,1,4,6,Medical Student,5,0,150,69,3,5,2,0,0,1,0,0,TRUE,TRUE,TRUE,TRUE,TRUE,5,0.7467069767242254,0.86,0.01824047118357775,5,0.43857741934253325,0.46017500000447037,1,1,9.391158059999505e-4,0.0018320141939454696,5,0.5693843750208616,0.6601906249970197,1,1,0.0032403774900163188,0.00618266345421201,1.2511,1.6644,0.481,0,-5.8278,0.004,ML,change,50,23.39166901628444,1.9369564241729607,0.9371867864365299,0.5725227571379701,10,13.9551,0.1019,17.6356,0.1551,0,-120.6088,0.051,ML,cueing,63,253.6470041791746,5.553672755741725,0.7460170788975832,0.39510958501086474,6.563457944518889,0.6312426713804792,0.39199249847696166,0.102,0.421,0.692,0.02,1.872,92.76239153957678,1881.6936223623827,0.103,0.422,0.709,0.021,1.937,109.37229006940422,1896.5419200704623,438,1.2977777777777777,1,0,0,1,FALSE,FALSE,FALSE
491,2021-11-13T08:33:59Z,2021-11-13T09:02:56Z,1736,1,2021-11-13T09:02:56Z,0.8999999761581421,Firefox,94.0,Windows NT 10.0,1920,1080,NA,1.7777777777777777,723,50,560,143,63,90,-0.17009021768363392,-0.36161244477681426,0.6378646823702144,0.4681852528572675,-0.12355101974969247,-0.2597317839589309,3,3,1,1,3,1,1,2,1,3,2,1,1,1,3,2,1,1,2,2,0.8506963092234007,0,1,1,3,2,1.75,0,3,4,3,3,2,2,4,2,2,3,2,3,2,2,3,1,3,1,1,1,1,2,1,0,3,0,0,5,4,2,2,2,4,4,2,2,1,5,1,1,3,1,5,3,2,2,1,1,3,1,1,1,1,1,1,1,1,1,4,1,2,1,1,1,1,1,1,1,1.3434302381608079,0.7237468644557459,1.375,0,1,0,2.533333333333333,0,3,0,1.5,0,1.1666666666666667,0,1.1428571428571428,0,1,0,1.7567567567567568,0,0,0,0,-0.42305455799601904,-0.7372407672780129,-0.580147662637016,4,2,3,1,2,3,2,1,1,0.9759000729485332,2.142857142857143,0,1,-0.21938108280548152,4,4,5,4,2,2,1,4,3,3,2,1.4638501094227998,3.7142857142857144,0,2.2857142857142856,5.5,3.8333333333333335,3.2559414990859232,0.6723373927674386,0,0.24074313548680643,2,2,2,2,2,2,2,3,2,2,2,4,2,3,4,4,4,2,3,3,0.8618916073713346,2,0,4,0,2.6,0,3.4,0,3.3333333333333335,0,1,1,2,3,1,2,1,2,3,2,2,1,1,3,1,1,1,2,2,2,0.7326950970650465,2,0,"Asian or Asian American (e.g., Chinese, Japanese, and others)",0,27,0,1,NA,1,2,2,Unemployed,4,0,132,68,1,5,2,0,0,1,0,0,TRUE,TRUE,TRUE,TRUE,TRUE,3,1.1051944444444444,0.7659574468085106,0.28986854024051806,3,0.4211875,0.49734375000000003,1,1,0.005002028225806453,0.007076361895161291,3,0.59875,0.6710625,1,1,0.004209225806451614,0.004707221774193548,1.7126,0.6944,0.5584,0,46.1243,0.002,ML,change,47,-80.69815719486982,0.6836779952569205,1.7341843292940735,0.4305797285780095,5.27,7.4277,0.1426,8.276,0.1028,0,-78.1669,0.013,ML,cueing,64,168.81044925007902,3.9615029671980038,1.045849204379619,0.36946723127314735,4.320419920497022,0.9589657493095962,0.31367502589576995,0.157,0.386,0.771,0.02,1.77,57.085665438358674,1868.9872676964856,0.168,0.378,0.774,0.023,1.846,64.05289391681733,1845.902002229595,316,0.9362962962962963,1,0,0,1,FALSE,FALSE,FALSE
492,2021-11-13T08:48:38Z,2021-11-13T09:05:30Z,1012,1,2021-11-13T09:05:32Z,0.8999999761581421,Firefox,94.0,Windows NT 10.0,1680,1050,NA,1.6,614,34,187,35,37,56,-0.4501512225979226,-0.5069682577877305,-1.1578465147139834,-0.8479466528194364,-0.4826645703076583,-0.8340382538279354,3,3,1,1,3,1,1,4,1,4,3,1,1,1,4,4,1,1,1,4,1.348488432516786,0,1,1,3,4,1.35,0,4,4,2,4,1,1,4,1,1,1,1,4,1,4,4,1,1,1,1,1,1,1,1,0,2,0,0,5,4,4,4,4,4,4,4,4,1,5,1,1,4,4,4,1,1,1,1,1,5,1,1,1,1,1,1,1,1,1,5,1,1,1,1,1,1,1,1,1,1.6508256192660766,1.505545305418162,1,0,1,0,1.5333333333333334,0,1.8888888888888888,0,1.4166666666666667,0,0.8333333333333334,0,0.8571428571428571,0,1,0,1.3513513513513513,0,0,0,0,-1.1881812657920683,-0.7372407672780129,-0.9627110165350405,4,1,3,1,1,2,2,1,1,1.1547005383792515,1.7142857142857142,0,1,-0.4757826382709144,4,4,4,4,4,4,1,3,6,5,3,1.1338934190276817,4.142857142857143,0,1.8571428571428572,4.5,3.8333333333333335,3.2559414990859232,0.10757398284279028,0,-0.28065156173982786,3,1,1,5,4,4,4,2,2,4,4,2,4,4,4,3,4,4,4,4,0.8338093878327919,2.8,0,2.4,0,3.4,0,3.6,0,3.1333333333333333,0,1,1,1,3,1,1,1,4,1,1,1,4,1,1,1,3,1,1,1,1,1.0513149660756937,1.1,0,"Asian or Asian American (e.g., Chinese, Japanese, and others)",0,21,0,1,NA,1,3,4,Scientific Researcher,5,0,145,68,1,5,2,0,0,1,0,0,TRUE,TRUE,TRUE,TRUE,TRUE,5,0.7019705882352941,0.68,0.03434441469387755,5,0.596625,0.6276875,1,1,0.04241217741935484,0.04468293145161291,5,0.922,0.97684375,1,1,0.1123251612903226,0.07753394254032259,1.1945,0.6666,0.3739,0,16.8519,0.002,ML,change,50,-21.967730983715562,0.7695468754863715,0.979500828848118,0.4728615439275914,1.3736,2.9081,0.3915,2.6694,0.3393,0,-36.9429,0.009,ML,cueing,64,86.36244925007901,2.499062282952103,1.6578757378937001,0.306353547653022,2.5318609586133225,1.6363989943036565,0.28356248360496444,0.204,0.229,0.3,0.016,1.419,42.650334051804705,1836.6588918726877,0.202,0.228,0.298,0.018,1.492,56.115561281418984,1838.5244390853693,350,1.0370370370370372,1,0,2,3,FALSE,FALSE,FALSE
493,2021-11-13T08:24:33Z,2021-11-13T09:08:00Z,2607,1,2021-11-13T09:08:01Z,1,Chrome,95.0.4638.69,Windows NT 10.0,1920,1080,"None, thank you!",1.7777777777777777,580,49,685,721,138,373,-0.5375097011950403,-0.3706971830899965,1.239644574154463,7.511928229534442,0.9123534530136705,4.520525009362489,2,3,1,1,2,1,1,3,1,3,2,2,2,2,3,3,1,1,3,3,0.8583950752789521,0,1,1,3,3,1.8,0,1,4,4,4,2,1,1,4,3,4,2,1,1,2,3,2,4,1,1,1,4,2,1,0,2,0,0,3,4,4,4,4,5,4,4,4,2,4,4,4,4,3,4,4,4,2,4,4,2,1,1,1,1,1,1,1,1,1,5,1,1,1,1,1,1,1,1,1,1.4881917600614225,1.3020130933435712,2,0,1,0,3.1333333333333333,0,2,0,3.0833333333333335,0,1.3333333333333333,0,0.8571428571428571,0,1,0,2,0,0,0,0,0.20792090160201304,-0.7372407672780129,-0.26465993283799993,4,2,3,2,4,1,3,1,1,1.1126972805283737,2.4285714285714284,0,1,-0.048446712495193056,5,5,5,5,3,3,1,1,1,6,3,1.5735915849388864,4.428571428571429,0,1.5714285714285714,8,3.8333333333333335,3.2559414990859232,2.0842459175790595,0,0.5483424107854333,2,2,2,3,2,2,4,2,4,4,2,4,2,4,4,2,3,3,4,4,0.9411239481143202,2.2,0,3.6,0,4,0,3.2,0,3.6,0,2,2,2,1,1,2,2,3,2,2,3,2,2,1,1,2,2,2,1,2,0.5871429486123998,2.05,0,"Asian or Asian American (e.g., Chinese, Japanese, and others)",0,27,0,1,NA,1,3,6,registered nurse,6,0,163,71,3,5,2,0,0,1,0,0,TRUE,TRUE,TRUE,TRUE,TRUE,NA,NA,NA,NA,6,0.3467032258029907,0.3973899999966224,0.96875,0.967741935483871,7.604088709679103e-4,0.0028300820645775545,6,0.5285562500017695,0.619679310345958,1,0.9666666666666667,0.009501079314818426,0.005954027540131798,NA,NA,NA,NA,NA,NA,NA,NA,NA,NA,1.110490065217007,1.0379917353993924,0.5810451493323432,0.7859,4.0862,0.3055,5.9396,0.2873,0,-108.005,0.012,ML,cueing,63,228.43940417917457,4.565673311587717,0.7449497915301756,0.3210717368295499,6.370874106477987,0.5390135085220761,0.30704421231490236,0.069,0.381,0.433,0.011,1.396,113.16551344938391,2008.106888330244,0.071,0.382,0.491,0.011,1.456,134.72392692976794,1969.552200717226,316,0.9362962962962963,1,0,6,7,FALSE,TRUE,FALSE
494,2021-11-13T08:37:44Z,2021-11-13T09:09:26Z,1902,1,2021-11-13T09:09:27Z,0.8999999761581421,Chrome,95.0.4638.54,Windows NT 10.0,1280,720,no,1.7777777777777777,674,34,557,77,110,51,-0.29598920154418573,-0.5069682577877305,0.6234219649673924,-0.3361175783896071,0.525615783182015,-0.9184950876322008,3,3,1,1,3,1,1,3,1,3,3,1,1,1,3,3,1,1,3,3,1.025978352085154,0,1,1,4,4,1.5,0,4,4,2,4,2,2,4,2,2,2,2,4,2,4,4,2,2,2,2,2,2,2,2,1,2,0,0,4,4,4,4,4,4,4,4,4,4,4,2,2,4,3,4,2,2,2,2,2,4,1,1,1,3,1,1,1,1,1,4,1,1,1,1,1,2,1,2,1,1.346221494521727,1.0327955589886444,2,0,1.5,0,2,0,2,0,2.25,0,1.3333333333333333,0,1,0,1,0,1.7567567567567568,0,1,0,0,-0.3836609374934269,-0.3773458880470143,-0.3805034127702206,4,2,4,2,2,2,2,2,1,0.9759000729485332,2,0,1.5,-0.12035443057343476,4,4,4,4,3,3,2,6,6,4,3,0.7867957924694432,3.7142857142857144,0,2.2857142857142856,3,3.8333333333333335,3.2559414990859232,-0.7395711320441822,0,-0.465211126919004,2,2,2,2,2,2,2,2,2,4,2,4,2,4,4,2,4,2,3,3,0.9411239481143202,2,0,4,0,3.4,0,3.8,0,3.7333333333333334,0,1,1,1,3,1,1,1,3,1,1,1,3,1,1,1,3,1,1,1,1,0.8207826816681233,1.2,0,"Asian or Asian American (e.g., Chinese, Japanese, and others)",0,28,0,1,NA,1,3,7,Engineer,5,0,130,66,2,5,2,0,0,1,0,0,TRUE,TRUE,TRUE,TRUE,TRUE,4,0.9220428571360452,0.84,0.11376379003568367,4,0.46143437500298023,0.5810343749895692,1,1,0.004027958460270453,0.013085743614080003,4,1.361237500011921,1.4467968749925495,1,1,0.13795315339438285,0.1697741699799048,1.5465,1.079,0.5186,0,28.4173,0.002,ML,change,50,-45.09853098371556,1.1430913342200026,1.450652303068186,0.4905622148829596,2.447,4.75,0.3235,6.818,0.282,0,-76.2773,0.01,ML,cueing,64,165.03124925007901,3.39713567902545,1.2195964829936055,0.4071402175976878,4.560802316597259,0.9084223429974615,0.3649563779654579,0.292,0.279,0.253,0.206,1.498,53.510252693504185,1851.8668368330511,0.314,0.274,0.278,0.317,1.317,64.04239616580925,1846.303661359749,104,0.3081481481481481,1,0,1,2,FALSE,FALSE,FALSE
495,2021-11-13T09:00:24Z,2021-11-13T09:17:35Z,1030,1,2021-11-13T09:17:36Z,1,Firefox,94.0,Linux x86_64,1920,1080,NA,1.7777777777777777,627,40,202,36,30,56,-0.41674945136961294,-0.45245982790863687,-1.0856329276998735,-0.8357602462853928,-0.5793489877655722,-0.8340382538279354,2,3,2,2,1,2,1,2,1,2,1,2,2,2,2,1,1,1,2,2,0.5712405705774795,0,1,2,3,2,2.4,0,5,5,3,4,2,1,5,2,3,1,2,5,2,4,4,2,2,1,1,1,2,2,2,0,2,0,0,3,4,4,5,4,5,4,5,5,2,4,2,1,3,2,4,2,2,2,1,1,5,1,1,1,3,1,1,1,1,1,5,1,3,1,1,1,1,1,1,1,1.55673485970586,1.4735767952260144,1.625,0,1,0,1.7333333333333334,0,1.6666666666666667,0,1.8333333333333333,0,1.1666666666666667,0,1.1428571428571428,0,1,0,1.5405405405405406,0,0,0,0,-0.7523348944820606,-0.7372407672780129,-0.7447878308800367,5,2,4,1,2,2,1,1,1,1.5118578920369088,1.5714285714285714,0,1,-0.5612498234260587,4,4,4,4,4,4,2,6,6,6,4,0.7559289460184544,4,0,2,3,3.8333333333333335,3.2559414990859232,-0.7395711320441822,0,-0.6245531217618774,3,3,3,2,2,3,2,4,2,3,3,3,2,4,3,5,3,4,4,3,0.8618916073713346,2.6,0,2.8,0,2.8,0,3.2,0,2.933333333333333,0,1,1,1,2,3,4,2,2,2,1,2,3,2,2,1,2,1,3,3,3,0.8870412083230169,2.15,0,"White, Caucasian, Anglo, European American",0,19,0,1,NA,1,4,3,None,1,0,149,72,2,5,2,0,0,1,0,0,TRUE,TRUE,TRUE,TRUE,TRUE,NA,NA,NA,NA,4,0.4977741935483871,0.595741935483871,0.96875,0.96875,0.012194951612903225,0.01376677016129032,4,0.7783125,0.8448064516129032,1,0.96875,0.06129777016129031,0.02317962802419355,NA,NA,NA,NA,NA,NA,NA,NA,NA,NA,NA,NA,NA,2.1663,3.7322,0.298,3.8478,0.2348,0,-45.2309,0.018,ML,cueing,64,102.938449250079,3.088536949678346,1.1118491572013658,0.42699559994386127,3.183580210980164,1.0786557827697663,0.33895303476952376,0.089,0.41,0.225,0.017,1.842,72.54519865411895,1900.3347559163033,0.106,0.369,0.267,0.015,2.05,63.54686825005101,1888.6397354948624,246,0.7288888888888888,1,1,5,6,FALSE,FALSE,FALSE
496,2021-11-13T08:49:09Z,2021-11-13T09:18:31Z,1761,1,2021-11-13T09:18:32Z,0.8999999761581421,Chrome,95.0.4638.69,Windows NT 10.0,1920,1080,no,1.7777777777777777,645,83,570,147,102,152,-0.3705008450534919,-0.06181608044179956,0.6860070737129543,0.5169308789934417,0.4151193060872563,0.7875329552139597,3,3,1,2,3,2,1,3,1,3,2,2,1,2,3,3,1,2,3,3,0.8335087534664907,1,1,1,4,3,1.8,0,2,3,4,2,2,4,3,4,3,4,5,1,1,3,4,2,2,1,1,1,2,4,1,4,2,0,0,5,5,4,5,5,2,3,4,3,2,4,5,1,4,2,5,2,3,2,5,5,4,1,1,1,1,1,1,3,4,3,4,4,4,1,3,3,4,2,4,5,1.4678741957860881,1.1952286093343936,1.75,0,3.75,0,3.4,0,2,0,2.6666666666666665,0,1,0,2.857142857142857,0,2.3333333333333335,0,2.2972972972972974,0,2,0,0,0.34284647157895054,0.5313574102046721,0.4371019408918113,3,2,3,1,1,2,3,4,1,0.8997354108424374,2.142857142857143,0,2.5,0.33410042935609163,2,4,3,5,2,2,3,1,3,1,2,1.1547005383792515,3,0,3,7,3.8333333333333335,3.2559414990859232,1.5194825076544112,0,1.0626706800374763,3,3,3,1,2,3,5,3,3,5,4,4,2,4,3,4,3,2,2,4,0.9856107606091623,2.4,0,3.2,0,3.6,0,3,0,3.2666666666666666,0,1,2,4,3,3,2,3,2,1,3,2,2,2,4,1,2,1,3,2,2,0.910465468000326,2.35,0,"White, Caucasian, Anglo, European American",0,21,0,1,NA,0,2,4,student,2,0,165,73,3,5,2,0,0,1,0,0,TRUE,TRUE,TRUE,TRUE,TRUE,5,0.8899200000000005,0.9,0.15973604202449368,5,0.42434666666666937,0.5486666666666744,1,0.9375,0.00285545498850638,0.008272996038306805,5,0.5844612903225822,0.6503259259259018,0.96875,0.84375,0.008520280635082929,0.013275787056451379,1.6354,1.3712,0.4921,0,20.1893,0.003,ML,change,50,-28.64253098371556,1.2914865898816423,1.7013142796454304,0.3629879225089453,1.4909,4.3601,0.3817,5.4599,0.2862,0,-75.6743,0.011,ML,cueing,62,163.73000315513528,3.09087522048506,0.8761434894409059,0.4246523505629522,4.970426598875261,0.833557169384428,0.3431153586715073,0.06,0.406,0.381,0.01,1.602,132.69234458077062,2059.7621269635456,0.059,0.41,0.375,0.011,1.712,173.02593938241466,2075.457470744658,104,0.3081481481481481,1,0,1,2,FALSE,FALSE,FALSE
497,2021-11-13T09:03:39Z,2021-11-13T09:19:54Z,975,1,2021-11-13T09:19:55Z,1,Firefox,94.0,Windows NT 10.0,1920,1080,Nope,1.7777777777777777,557,34,213,52,35,55,-0.5966051425989727,-0.5069682577877305,-1.0326762972228596,-0.6407777417406959,-0.510288689581348,-0.8509296205887885,3,2,1,1,3,1,2,3,1,4,2,1,1,2,4,4,2,1,3,3,1.105012502906165,0,1,3,2,2,1.6,0,3,5,4,5,2,1,3,3,2,1,3,4,2,3,4,2,3,4,1,1,2,1,1,0,2,0,5,5,5,4,5,5,5,5,5,5,2,5,1,3,3,5,3,5,5,4,5,5,2,5,3,1,1,1,1,1,1,1,5,1,1,1,1,2,1,2,1,1,1.7925437827883628,1.2535663410560174,1.875,0,1.25,0,2.2,0,1.1111111111111112,0,3.5,0,2.3333333333333335,0,0.8571428571428571,0,1.3333333333333333,0,2.108108108108108,0,0,0,5,-0.20043704655630842,0.22340866993513192,0.011485811689411748,5,1,5,1,1,2,2,2,4,1.8126539343499315,1.2857142857142858,0,3,0.005791155812417015,5,5,5,5,5,5,1,6,6,5,4,1.5118578920369088,5,0,1,3,3.8333333333333335,3.2559414990859232,-0.7395711320441822,0,-1.1822501037119346,2,3,3,1,2,3,5,2,3,5,4,5,1,5,4,1,4,3,5,1,1.5491933384829668,2.2,0,3.4,0,5,0,4.2,0,4.2,0,1,1,1,4,3,1,2,2,3,2,4,4,1,1,1,4,1,1,1,2,1.2139539573337679,1.6,0,"Asian or Asian American (e.g., Chinese, Japanese, and others)",0,27,0,1,NA,1,2,6,Article Writer,1,0,150,70,2,5,2,0,0,1,0,0,TRUE,TRUE,TRUE,TRUE,TRUE,2,0.6590571428571429,0.7,0.01818894734693877,2,0.41435714285714287,0.48244,0.9333333333333333,0.78125,0.002053627586206897,0.008660564516129031,2,0.53934375,0.60692,1,0.78125,0.008230039314516128,0.01382082258064516,1.1344,0.7909,0.4139,0,10.3553,0.004,ML,change,50,-8.974530983715562,1.0069204713737165,0.8414744604717949,0.49191892600794285,0.7943,1.4748000000000001,0.3099,4.3687,0.3338,0,-61.521,0.009,ML,cueing,62,135.42340315513528,1.7492672052688587,0.7277136803220612,0.36543702185343235,4.312413771727264,0.6119675590772983,0.3528635208848214,0.056,0.366,0.304,0.016,1.875,159.35504254769933,2074.0969386316087,0.055,0.368,0.33,0.016,2.005,193.2552505819851,2096.06423669122,472,1.3985185185185185,1,0,0,1,FALSE,FALSE,FALSE
498,2021-11-13T08:57:35Z,2021-11-13T09:21:32Z,1437,1,2021-11-13T09:21:34Z,1,Chrome,95.0.4638.69,Windows NT 10.0,1366,768,None,1.7786458333333333,714,64,365,108,49,93,-0.19321452084169444,-0.23442610839226255,-0.30091194881321337,0.04166102416574309,-0.31691985466552025,-0.20905768367637165,2,2,2,3,1,3,1,2,1,3,3,1,2,1,2,1,1,1,3,3,0.8522416262267903,0,1,1,4,4,2.2,0,4,5,2,5,1,1,1,1,1,1,2,4,3,4,2,3,2,2,1,1,1,1,1,3,2,0,3,5,3,4,4,4,4,3,4,4,1,4,1,1,4,1,5,1,1,1,1,1,4,1,1,1,4,1,1,4,4,1,1,1,1,1,1,1,1,2,4,3,1.543172505386673,1.5522640914238175,1.5,0,2.5,0,1.9333333333333333,0,2.111111111111111,0,1.1666666666666667,0,1.5,0,2.2857142857142856,0,1,0,1.7027027027027026,0,2,0,3,-0.6504147903316194,0.6687003373160088,0.009142773492194667,3,2,3,2,1,1,1,2,1,0.8997354108424374,1.8571428571428572,0,1.5,-0.20582161572857902,4,4,5,4,5,4,1,3,6,4,3,1.3451854182690985,4.428571428571429,0,1.5714285714285714,4.5,3.8333333333333335,3.2559414990859232,0.10757398284279028,0,-0.4399935565827014,3,4,4,3,4,2,4,2,1,4,1,4,1,5,4,3,4,1,4,1,1.486446705914413,3.6,0,4.4,0,4,0,4.6,0,4.333333333333333,0,2,2,1,3,2,1,1,3,2,1,2,3,2,1,1,3,1,1,1,1,0.8013147091860318,1.5,0,"White, Caucasian, Anglo, European American",0,28,0,1,NA,1,3,4,Technical Stage Manager,3,0,185,66,5,5,2,0,0,1,0,0,TRUE,TRUE,TRUE,TRUE,TRUE,1,0.8519292682926852,0.82,0.039393255710202,1,0.5485387096774554,0.6427548387096744,0.96875,0.96875,0.004984866764102903,0.005819197006050893,1,0.7403062499999651,0.7684781250000232,1,1,0.026266522540329528,0.02347719208670476,1.5418,1.1117,0.4029,0,22.9932,0.003,ML,change,50,-34.250330983715564,1.387150028249583,1.0931387798632977,0.5997543755756614,1.1492,3.2098,0.476,4.0662,0.4135,0,-67.0789,0.01,ML,cueing,64,146.63444925007903,3.8304081411566417,0.8965068676593323,0.5330439205179603,3.9815064911856095,0.8624843917967786,0.4469968537116873,0.133,0.374,0.345,0.098,1.691,21.873256680364527,1814.262674630231,0.143,0.36,0.368,0.086,1.812,35.97654229396,1817.4692528288415,328,0.9718518518518519,1,0,0,1,FALSE,FALSE,FALSE
499,2021-11-13T08:38:22Z,2021-11-13T09:21:58Z,2616,1,2021-11-13T09:21:59Z,1,Chrome,95.0.4638.69,Windows NT 10.0,1280,1024,N/A,1.25,576,57,279,85,79,68,-0.5477871692652894,-0.2980192765845384,-0.7149365143607764,-0.23862632611725865,0.09744193443982496,-0.6313418526976985,2,3,3,2,2,1,1,2,1,2,3,2,2,2,2,3,1,1,2,2,0.6863327411532597,0,1,3,3,2,2.15,0,5,5,2,5,1,1,4,1,1,1,1,5,1,5,5,1,1,1,1,1,1,1,1,0,2,0,0,5,5,5,5,5,5,5,5,5,1,5,1,1,5,2,5,1,1,1,1,1,5,1,1,1,1,1,1,1,1,1,5,1,1,1,1,1,1,1,1,1,1.9521298140264163,1.9591057240729093,1,0,1,0,1.1333333333333333,0,1,0,1.0833333333333333,0,0.8333333333333334,0,0.8571428571428571,0,1,0,1.027027027027027,0,0,0,0,-1.4994586209182028,-0.7372407672780129,-1.118349694098108,3,1,3,1,1,1,1,1,1,0.9759000729485332,1.5714285714285714,0,1,-0.5612498234260587,4,4,4,3,3,3,3,6,6,NA,3,0.5345224838248488,3.4285714285714284,0,2.5714285714285716,3,3.8333333333333335,3.2559414990859232,-0.7395711320441822,0,-0.3058691320761303,1,2,3,2,2,3,4,2,2,3,1,3,2,3,4,4,4,1,3,4,1.0600988273786194,2,0,4,0,3.2,0,3.4,0,3.533333333333333,0,2,1,1,3,2,1,3,3,2,1,1,3,3,2,1,3,1,1,2,3,0.8870412083230169,1.75,0,Prefer not to say,0,21,3,5,NA,1,3,4,Student,7,0,140,70,3,5,2,0,0,1,0,0,TRUE,TRUE,TRUE,TRUE,TRUE,2,0.9625249999978326,0.88,0.08410022216009373,2,0.4527129032275369,0.5458482758618635,0.96875,0.90625,0.0018128077017237438,0.012101860635823468,2,0.543587096773809,0.6092566666642825,0.96875,0.9375,0.005858051361274707,0.00899798931435611,1.5534,1.4038,0.5638,0,14.8393,0.003,ML,change,50,-17.942530983715564,1.4158021024135732,1.4072801285530179,0.5848122900516406,1.1255,2.2084,0.3222,4.7922,0.3432,0,-61.1016,0.008,ML,cueing,64,134.679849250079,2.5152443218650946,0.9019734272319511,0.4001659253929163,5.1271129194265495,0.6697701529985468,0.3914786834723021,0.058,0.394,0.347,0.017,1.361,115.59291670077559,2040.6048265031802,0.056,0.398,0.343,0.016,1.406,134.59943831355577,2028.5936171327342,295,0.874074074074074,1,0,0,1,FALSE,FALSE,FALSE
500,2021-11-13T09:02:02Z,2021-11-13T09:22:40Z,1238,1,2021-11-13T09:22:41Z,1,Chrome,94.0.4606.81,Macintosh,1440,900,No everything worked fine.,1.6,627,55,318,64,48,81,-0.41674945136961294,-0.31618875321090295,-0.5271811881240909,-0.4945408633321733,-0.3307319143023651,-0.4117540848066085,4,3,1,2,4,1,1,3,1,4,3,1,1,1,4,4,1,1,1,3,1.3218806379747876,0,1,1,5,3,1.4,0,2,3,3,4,3,3,4,4,4,3,4,2,2,3,2,4,4,4,1,3,4,4,3,2,2,3,0,3,2,2,2,2,2,2,2,2,5,3,4,3,2,3,2,4,4,4,5,5,2,3,3,1,3,1,1,1,1,1,2,4,4,3,3,3,3,4,2,2,1.179784680309035,0.7988086367179802,3.375,0,2.75,0,3.2,0,3.888888888888889,0,4,0,2.3333333333333335,0,2.142857142857143,0,3,0,3.324324324324324,0,1,3,0,1.396601622467703,0.6345597483182625,1.0155806853929827,4,2,2,2,2,1,1,1,2,1,2,0,1.5,-0.12035443057343476,4,3,4,4,2,2,2,1,3,3,3,1,3.2857142857142856,0,2.7142857142857144,7,3.8333333333333335,3.2559414990859232,1.5194825076544112,0,0.903328685194603,2,2,3,3,3,3,3,2,2,3,1,3,2,4,5,1,4,2,4,3,1.1464230084422218,2.6,0,3.8,0,3.8,0,4,0,3.8666666666666667,0,1,2,1,3,1,1,2,3,1,1,1,4,1,2,1,3,1,2,1,1,0.9333020044867296,1.35,0,"Hispanic of Latino (e.g., Mexican American, Central American, and others) & White, Caucasian, Anglo, European American",1,22,0,1,NA,1,3,4,Student,3,0,155,70,2,5,2,0,0,1,0,0,TRUE,TRUE,TRUE,TRUE,TRUE,5,0.8972794871697058,0.78,0.048861601104445415,5,0.4096451612903226,0.5300333333333334,0.96875,0.9375,0.0029323316022900796,0.00785692253371212,5,0.5511032258002989,0.6091275861920982,0.96875,0.90625,0.005784395117240318,0.009743193778444702,1.2638,1.3165,0.559,0,17.6083,0.002,ML,change,50,-23.48053098371556,1.12940040219355,1.1206533757851218,0.6194480426170059,1.2878,2.9459,0.3308,3.8132,0.2515,0,-56.645,0.007,ML,cueing,64,125.76664925007901,3.131007148126652,0.864913452121147,0.409177769164658,4.5462943072287505,0.7553376381781969,0.33176535545965824,0.062,0.375,0.318,0.025,1.936,174.00807518920524,2090.10728309009,0.059,0.38,0.328,0.023,2.058,206.65128432206387,2105.916584758859,434,1.285925925925926,1,0,0,1,FALSE,FALSE,FALSE
501,2021-11-13T09:00:15Z,2021-11-13T09:27:10Z,1614,1,2021-11-13T09:27:12Z,0.8999999761581421,Chrome,95.0.4638.69,Macintosh,1920,1080,Cheers!,1.7777777777777777,745,117,460,101,46,59,-0.11356414329726369,0.2470650222063974,0.15644076894281556,-0.04364382157256178,-0.3583560335760547,-0.7833641535453761,3,2,1,3,2,2,3,2,1,2,3,2,2,4,3,2,2,4,2,3,0.8207826816681233,0,1,2,4,5,2.5,0,5,5,1,4,1,1,4,3,1,1,3,2,3,3,3,2,3,1,1,1,2,2,2,0,2,0,0,5,2,2,5,3,4,4,5,4,2,4,2,1,3,4,5,4,4,3,4,5,3,1,1,1,3,5,1,1,1,1,5,2,3,1,1,1,3,2,3,3,1.5304712811230214,1.4474937289114918,1.75,0,2.75,0,2,0,2.2222222222222223,0,2.9166666666666665,0,2.1666666666666665,0,1.2857142857142858,0,1,0,2.2162162162162162,0,0,0,0,-0.2936460306938916,-0.18843234825732513,-0.24103918947560837,5,2,2,2,2,2,3,2,3,1.1338934190276817,2.2857142857142856,0,2.5,0.41956761451123586,5,5,4,5,3,3,1,3,3,4,3,1.4960264830861913,4.285714285714286,0,1.7142857142857142,6,3.8333333333333335,3.2559414990859232,0.9547190977297628,0,0.06324999828222155,2,2,4,4,4,3,4,2,3,4,1,4,5,4,4,1,4,3,4,4,1.1751393027860062,3.2,0,3.8,0,3.6,0,3.4,0,3.6,0,2,1,2,3,3,2,2,2,3,2,3,3,3,2,2,3,1,2,2,3,0.6569466853317864,2.2,0,"Hispanic of Latino (e.g., Mexican American, Central American, and others) & White, Caucasian, Anglo, European American",1,23,0,1,NA,1,3,3,N/A Student,5,0,220,72,2,5,2,0,0,1,0,0,TRUE,TRUE,TRUE,TRUE,TRUE,6,0.9005675675675613,0.7551020408163265,0.14784585147109253,6,0.5587700000000012,0.638296875,1,1,0.003940589068965195,0.0032384816028226343,6,0.7163374999999979,0.777158064516126,1,1,0.006911576612905116,0.0067310491827958195,1.3999,0.8149,0.523,0,28.8775,0.003,ML,change,49,-46.079539105668125,0.7729879018019712,1.4566997235419765,0.41982644410902437,10,11.2595,0.1942,11.1799,0.1115,0,-88.035,0.018,ML,cueing,62,188.45140315513527,4.816450882824987,0.8602049158573511,0.5517888286698316,3.876419315440963,0.8774069843564517,0.45289908984453775,0.084,0.56,0.532,0.016,1.244,22.325917024577887,1811.9865563034225,0.085,0.56,0.551,0.016,1.288,27.518821076202325,1808.1811676273528,105,0.3111111111111111,1,0,1,2,FALSE,FALSE,FALSE
502,2021-11-13T08:48:47Z,2021-11-13T09:27:28Z,2321,1,2021-11-13T09:27:29Z,1,Chrome,95.0.4638.69,Windows NT 10.0,1920,1080,nope,1.7777777777777777,712,62,529,112,47,97,-0.198353254876819,-0.2525955850186271,0.48862326920772076,0.09040665030191732,-0.34454397393920994,-0.14149221663295936,4,4,1,2,4,1,1,4,1,4,3,1,1,1,4,4,1,1,4,4,1.4689774459950382,0,1,2,2,1,1.1,0,4,4,2,3,3,1,4,1,1,1,1,5,1,5,3,1,1,5,1,1,1,1,1,4,1,0,1,4,3,3,1,1,5,3,4,4,5,5,1,1,3,1,5,2,1,1,1,1,3,1,1,1,3,1,1,3,1,1,3,2,3,1,1,1,1,1,1,1,1.436336681653387,1.5491933384829668,1.5,0,1,0,1.6666666666666667,0,2.888888888888889,0,1.5833333333333333,0,1.5,0,1.8571428571428572,0,1,0,1.945945945945946,0,2,0,1,-0.6604809734575887,-0.1546061727857994,-0.4075435731216941,3,2,2,1,1,2,1,1,1,0.7559289460184544,2,0,1,-0.3048482679606258,5,5,5,5,3,3,2,4,5,2,3,1.2909944487358056,4.285714285714286,0,1.7142857142857142,4.5,3.8333333333333335,3.2559414990859232,0.10757398284279028,0,-0.3603225591612647,2,1,2,2,2,1,2,1,1,1,1,5,3,4,3,5,4,1,4,4,1.5886502207249789,1.8,0,4.8,0,2.2,0,3.8,0,3.6,0,1,1,1,4,1,1,1,3,1,1,2,3,1,1,1,3,1,1,1,2,0.9445132413883326,1.25,0,"White, Caucasian, Anglo, European American",0,22,0,1,NA,1,4,3,unemployed,4,0,315,72,2,5,2,0,0,1,0,0,TRUE,TRUE,TRUE,TRUE,TRUE,6,0.6649156250003725,0.64,0.01940194653075701,6,0.46866250000102444,0.5643516129026971,1,0.96875,0.0024258224193531874,0.004734491522176696,6,0.6798593749990687,0.7594419354837267,1,0.96875,0.011769056683695546,0.022941033699509537,1.1499,0.5408,0.403,0,13.7678,0.003,ML,change,50,-15.799530983715561,0.6852683801294517,0.8396186977062503,0.49338192946247283,1.2501,4.3743,0.428,5.5839,0.3567,0,-90.7336,0.008,ML,cueing,64,193.943849250079,4.033132416192164,0.8514442002197653,0.4653926828039342,5.1772333846438725,0.8002603743305127,0.39379121450594223,0.075,0.488,0.375,0.011,1.182,32.70824821817106,1872.8305748759292,0.074,0.488,0.382,0.01,1.259,49.88545385041698,1874.454696856229,310,0.9185185185185185,1,0,0,1,FALSE,FALSE,FALSE
503,2021-11-13T09:09:52Z,2021-11-13T09:29:58Z,1205,1,2021-11-13T09:29:59Z,1,Chrome,95.0.4638.69,Macintosh,1440,900,No,1.6,614,59,285,73,50,76,-0.4501512225979226,-0.2798497999581739,-0.6860510795551324,-0.38486320452578127,-0.3031077950286754,-0.4962109186108739,3,4,1,1,3,1,4,3,2,3,3,2,1,1,3,3,3,1,3,3,1.0462967275611939,0,1,1,3,4,1.8,0,5,5,2,5,1,1,4,2,1,1,1,5,2,5,3,1,2,1,1,1,1,1,1,3,2,0,0,5,5,5,5,5,5,5,5,5,1,5,1,1,5,2,5,5,1,1,2,1,5,1,1,1,3,1,1,2,2,2,3,4,1,1,1,1,2,1,2,2,1.8335380721059111,1.7674302033770737,1.125,0,1.75,0,1.4,0,1,0,1.5,0,1.1666666666666667,0,2,0,1,0,1.4324324324324325,0,2,0,0,-1.1569180239681438,-0.0958522115332568,-0.6263851177507003,5,2,2,1,1,2,1,1,1,1.4142135623730951,1.7142857142857142,0,1,-0.4757826382709144,5,5,5,5,4,4,2,6,6,6,4,1.1126972805283737,4.571428571428571,0,1.4285714285714286,3,3.8333333333333335,3.2559414990859232,-0.7395711320441822,0,-0.9432371114476243,2,1,1,2,1,1,1,1,1,5,5,5,2,4,5,1,5,2,2,4,1.791514389985135,1.4,0,4,0,3.4,0,4.2,0,3.8666666666666667,0,1,1,1,4,1,2,1,3,2,2,1,4,1,1,1,4,1,2,1,1,1.118033988749895,1.25,0,"White, Caucasian, Anglo, European American",0,18,0,1,NA,1,4,3,Student,6,0,190,73,3,5,2,0,0,1,0,0,TRUE,TRUE,TRUE,TRUE,TRUE,2,0.9962428571428571,0.7142857142857143,0.057728816514386626,2,0.43207812500279397,0.49019642857355733,1,0.9333333333333333,0.0010961585383521082,0.003864193516779168,2,0.6113999999975785,0.6787366666644812,1,0.967741935483871,0.00726894516120803,0.006669373333502807,1.2674,0.7644,0.6437,0,19.7846,0.003,ML,change,49,-27.893739105668125,0.8112440374278486,1.1294884025026184,0.6978946192006704,1.4582,3.5253,0.3079,6.1544,0.3136,0,-78.0375,0.007,ML,cueing,62,168.45640315513526,3.6820198865745684,0.7167417371203849,0.40584379179992913,6.314575374244038,0.6561224596812317,0.38174864161355754,0.064,0.466,0.483,0.018,1.759,45.17630094083331,1892.6628703588758,0.065,0.466,0.489,0.019,1.819,57.16067831078979,1883.015094844741,430,1.2740740740740741,1,0,0,1,FALSE,FALSE,FALSE
504,2021-11-13T09:08:31Z,2021-11-13T09:35:40Z,1629,1,2021-11-13T09:35:42Z,1,Firefox,94.0,Windows NT 10.0,1536,864,No feedback,1.7777777777777777,711,117,411,163,88,72,-0.2009226218943813,0.2470650222063974,-0.0794569486366099,0.7119133835381386,0.22175047117142851,-0.5637763856542862,4,3,3,2,4,1,1,3,2,4,3,2,3,2,4,3,1,1,3,4,1.0894228312566052,0,0,3,4,3,1.65,0,5,5,5,4,5,5,3,3,5,3,1,4,2,4,4,5,5,1,1,1,5,5,3,7,2,0,0,5,2,5,5,5,5,5,5,5,4,4,4,3,5,4,4,3,5,4,3,5,4,1,1,1,5,1,1,5,5,5,5,1,3,3,1,1,3,4,4,4,1.5891902106184537,1.245945806357946,3.25,0,3.75,0,2.8,0,1.3333333333333333,0,3.3333333333333335,0,1.6666666666666667,0,2.857142857142857,0,1.6666666666666667,0,2.4054054054054053,0,4,0,0,0.7760795068851004,0.9375423577977049,0.8568109323414026,3,3,2,2,2,2,2,1,1,0.4879500364742666,2.5714285714285716,0,1,0.03702047265995151,4,5,5,5,1,1,1,3,3,NA,3,2.0354009783964297,3.7142857142857144,0,2.2857142857142856,6,3.8333333333333335,3.2559414990859232,0.9547190977297628,0,0.3819339879679685,5,5,5,5,5,4,2,3,4,3,3,4,4,4,3,3,3,3,2,2,0.7432233529572065,5,0,3,0,2.4,0,3.2,0,2.8666666666666667,0,3,1,3,2,2,2,2,2,2,2,2,3,1,3,1,4,1,1,3,1,0.8870412083230169,1.95,0,Black or African American,0,21,0,1,NA,1,3,3,None,6,0,221,65,1,5,2,0,1,0,0,1,TRUE,TRUE,TRUE,TRUE,TRUE,1,0.9535277777777778,0.72,0.058849375102040816,1,0.5139375,0.6827741935483871,1,1,0.0028992862903225816,0.016562380645161287,1,0.812875,0.92921875,1,1,0.026249725806451612,0.03549572479838709,1.3676,0.7151,0.5421,0,28.94,0.003,ML,change,50,-46.14393098371556,0.830177287987824,1.1376625481167144,0.6520430657684702,4.2224,5.4281,0.2938,8.617,0.2689,0,-72.4027,0.012,ML,cueing,63,157.2348041791746,3.2028146324182356,1.2935917940600024,0.48713891734299475,4.951533468430605,0.8367377001098418,0.4320851150621349,0.265,0.229,0.458,0.018,1.954,19.61938288969484,1825.0279601992393,0.267,0.224,0.456,0.018,2.041,32.50155349136431,1814.5428998425757,103,0.30518518518518517,1,0,2,3,FALSE,FALSE,FALSE
505,2021-11-13T09:16:35Z,2021-11-13T09:40:44Z,1448,1,2021-11-13T09:40:45Z,1,Opera,80.0.4170.63,Windows NT 10.0,1280,720,No feedback.,1.7777777777777777,811,64,287,74,39,113,0.056014079861846915,-0.23442610839226255,-0.6764226012865845,-0.37267679799173775,-0.4550404510339686,0.12876965154068984,4,4,1,1,4,1,1,3,1,4,2,1,1,1,4,4,1,1,4,3,1.4179302929937965,0,1,1,5,4,1.2,0,5,5,1,5,1,1,5,1,1,1,1,5,1,5,5,1,1,1,1,1,1,1,1,3,2,0,0,5,4,5,5,5,5,5,5,5,4,5,1,1,5,1,5,1,1,1,1,1,5,1,1,1,4,1,1,2,2,1,5,2,1,1,1,1,1,1,1,1,1.8804350656260471,2.065591117977289,1,0,1,0,1,0,1.1111111111111112,0,1.25,0,1.3333333333333333,0,1.2857142857142858,0,1,0,1.2702702702702702,0,2,0,0,-1.452224992404038,-0.33105581968498016,-0.8916404060445091,5,1,4,1,1,1,1,1,1,1.7320508075688772,1.1428571428571428,0,1,-0.8176513788914915,5,5,5,5,2,2,2,6,6,4,4,1.6035674514745464,4,0,2,3,3.8333333333333335,3.2559414990859232,-0.7395711320441822,0,-0.6245531217618774,2,1,1,1,1,2,4,2,2,4,1,5,1,3,4,1,5,1,4,3,1.4735767952260144,1.2,0,4.8,0,4.4,0,3.6,0,4.266666666666667,0,1,1,1,4,1,1,1,4,2,1,1,3,1,1,1,4,1,1,1,1,1.142481141154959,1.1,0,"White, Caucasian, Anglo, European American",0,29,0,1,NA,1,2,7,Online Map Quality Analyst,2,0,120,65,4,5,2,0,0,1,0,0,TRUE,TRUE,TRUE,TRUE,TRUE,6,0.8501955555412505,0.9,0.015538138061335579,6,0.43018387095389826,0.5031593750044704,0.96875,1,0.0035260044756003544,0.005546128298352062,6,0.6110312499925494,0.6465428571445602,1,0.875,0.010727535122936638,0.01309921603644578,1.2808,1.9308,0.5884,0,-10.7656,0.004,ML,change,50,33.26726901628444,2.3125486974832343,0.9501311603632291,0.6858520048264457,1.7545,4.4336,0.3053,4.751,0.2529,0,-69.521,0.008,ML,cueing,64,151.51864925007902,4.210319140147689,0.9840429165771505,0.38995043006441116,4.341502965826399,0.7909673750116838,0.34478350155298687,0.055,0.44,0.322,0.016,1.496,85.49303521332735,1960.7707685286757,0.054,0.441,0.327,0.018,1.578,111.68361225377019,1973.5738623073057,416,1.2325925925925925,1,0,0,1,FALSE,FALSE,FALSE
506,2021-11-13T09:25:32Z,2021-11-13T09:43:51Z,1099,1,2021-11-13T09:43:51Z,1,Chrome,95.0.4638.69,Windows NT 10.0,2560,1440,NA,1.7777777777777777,622,45,266,42,35,56,-0.42959628645742437,-0.40703613634272556,-0.7775216231063383,-0.7626418070811315,-0.510288689581348,-0.8340382538279354,3,3,2,2,2,1,2,2,1,3,2,2,2,2,2,2,2,1,2,2,0.5619514869490163,0,1,2,3,3,2.2,0,4,4,2,4,2,4,4,2,2,2,2,4,2,4,3,2,1,1,1,2,1,1,1,0,2,1,1,4,3,5,4,3,4,4,4,4,2,4,5,2,4,4,4,3,3,5,5,4,4,3,1,1,3,2,2,1,1,1,4,2,2,1,1,1,2,2,2,2,1.3639502778182058,1,1.25,0,2,0,2.2,0,2.111111111111111,0,3.25,0,1.8333333333333333,0,1.4285714285714286,0,1,0,2.27027027027027,0,0,1,1,-0.39934095351657173,-0.04055310191684401,-0.21994702771670788,4,2,4,2,2,2,2,3,2,0.9759000729485332,2,0,2.5,0.24863324420094737,5,5,5,5,3,3,2,5,6,NA,3,1.2909944487358056,4.285714285714286,0,1.7142857142857142,3.5,3.8333333333333335,3.2559414990859232,-0.4571894270818581,0,-0.6427042641235889,3,3,2,3,2,3,2,3,2,2,4,2,3,2,3,2,2,3,2,3,0.6399404734221844,2.6,0,2.4,0,2.6,0,3,0,2.6666666666666665,0,1,2,1,2,2,2,2,2,2,2,2,2,2,2,2,2,2,2,2,2,0.30779350562554625,2.1,0,"Asian or Asian American (e.g., Chinese, Japanese, and others)",0,19,0,1,NA,1,4,4,Student,6,0,120,70,2,5,2,0,0,0,0,0,TRUE,TRUE,TRUE,TRUE,TRUE,4,0.6791538461507896,0.78,0.04414924262910702,4,0.39057499999925493,0.43448709677496267,1,0.96875,0.0029764645163384176,0.002913049959994747,4,0.5683906249906868,0.6186699999948343,1,0.9375,0.0039951363609970515,0.003920888871169032,1.1509,1.1519,0.4574,0,4.4009,0.004,ML,change,50,2.9342690162844374,1.1584013289722606,1.092597480403602,0.41505945428365587,1.0629,4.0393,0.3079,5.9913,0.3019,0,-97.1417,0.009,ML,cueing,64,206.76004925007902,4.553798750435418,0.7540928777664583,0.35686376385555585,4.91911886565762,0.8422513949228692,0.3076403260144609,0.054,0.449,0.503,0.022,1.765,70.22471041054175,1926.3548317064208,0.056,0.452,0.518,0.026,1.868,86.5222414566601,1936.6303445558056,374,1.108148148148148,1,0,2,3,FALSE,FALSE,FALSE
507,2021-11-13T09:21:12Z,2021-11-13T09:53:10Z,1917,1,2021-11-13T09:53:10Z,1,Chrome,95.0.4638.69,Windows NT 10.0,1366,768,Thank you for the opportunity to do this survey,1.7786458333333333,746,159,499,137,81,185,-0.11099477627970142,0.6286240313600524,0.3441960951795011,0.39506681365300617,0.12506605371351465,1.3449480583221112,3,4,2,1,3,2,1,3,1,3,2,2,1,1,3,3,1,1,2,3,0.9679060415469871,0,1,1,5,5,1.7,0,4,4,3,4,2,2,3,2,2,2,2,5,2,4,3,2,2,1,1,2,1,1,2,1,2,0,0,4,4,4,5,4,4,5,5,4,2,4,2,2,5,2,5,3,1,2,2,3,5,1,1,1,2,1,1,2,1,1,4,2,2,1,2,3,2,1,2,2,1.4606962838433024,1.0327955589886444,1.5,0,1.75,0,2.1333333333333333,0,1.6666666666666667,0,1.9166666666666667,0,1,0,1.4285714285714286,0,2,0,1.6756756756756757,0,1,0,0,-0.5760798995552289,-0.2989446853297732,-0.437512292442501,4,3,5,2,3,5,5,1,1,1.2149857925879117,3,0,1,0.2934220281253842,4,3,5,4,2,1,3,5,7,3,2,1.3451854182690985,3.142857142857143,0,2.857142857142857,3,3.8333333333333335,3.2559414990859232,-0.7395711320441822,0,-0.14652713723325692,1,1,2,3,2,1,5,2,2,5,1,5,2,5,5,1,5,1,4,3,1.7674302033770737,1.8,0,5,0,4.6,0,4.2,0,4.6,0,1,2,1,3,2,1,2,4,1,2,1,3,2,1,1,3,1,2,1,1,0.910465468000326,1.45,0,"White, Caucasian, Anglo, European American",0,20,0,1,NA,1,3,4,Civil engineering student,3,0,117,68,2,5,2,0,0,1,0,0,TRUE,TRUE,TRUE,TRUE,TRUE,1,0.9511243243217469,0.74,0.09389765108598215,1,0.46648064516292465,0.5487437499985098,0.96875,1,0.0022780154435526733,0.0021434283467823274,1,0.6051468750000931,0.6730517241384448,1,0.90625,0.008534532247787763,0.01798947990925265,1.5364,0.7144,0.4772,0,37.7789,0.004,ML,change,50,-63.82173098371556,0.8105871810121341,1.2903837855869447,0.5690653480692829,1.3475,4.9453,0.4125,5.3108,0.3456,0,-89.7435,0.043,ML,cueing,64,191.96364925007902,5.339926162329355,0.7758786545812904,0.47836520694598267,4.842522539789686,0.7091318989780658,0.39783758260313634,0.072,0.398,0.33,0.03,1.888,93.86309186304842,2002.3948005943428,0.068,0.405,0.327,0.026,2.059,115.41555382372924,2001.115282738894,342,1.0133333333333332,1,0,0,1,FALSE,FALSE,FALSE
508,2021-11-13T09:39:12Z,2021-11-13T09:56:01Z,1009,1,2021-11-13T09:56:03Z,1,Chrome,95.0.4638.69,Windows NT 10.0,1920,1080,Excellent format and interesting gameplay!,1.7777777777777777,584,27,206,43,42,66,-0.5272322331247911,-0.5705614259800063,-1.0663759711627776,-0.7504554005470879,-0.4136042721234341,-0.6651245862194046,4,4,1,1,4,1,1,4,1,4,4,1,1,1,4,4,1,1,4,4,1.538967528127731,0,1,1,4,5,1,0,5,4,4,3,2,2,2,1,1,1,1,4,1,4,4,2,2,1,1,1,1,1,1,3,2,0,0,5,5,5,5,4,5,5,5,5,2,4,1,1,1,1,5,1,1,1,1,1,5,1,1,1,1,1,1,3,3,3,5,1,1,2,1,1,3,3,3,3,1.8034001919297482,1.4540583599999397,1.25,0,3,0,1.9333333333333333,0,1.1111111111111112,0,1.5,0,0.8333333333333334,0,1.7142857142857142,0,1.3333333333333333,0,1.3783783783783783,0,2,0,0,-0.8972298573626029,0.2961538020529488,-0.30053802765482707,4,2,3,1,1,3,2,1,1,1.1126972805283737,2,0,1,-0.3048482679606258,3,2,4,3,1,1,3,7,7,4,2,1.1338934190276817,2.4285714285714284,0,3.5714285714285716,2,3.8333333333333335,3.2559414990859232,-1.3043345419688306,0,-0.030553855088397364,1,1,1,2,1,1,4,4,1,2,1,5,1,3,4,4,5,1,4,4,1.5796322658258457,1.2,0,5,0,3.4,0,3.2,0,3.8666666666666667,0,1,1,1,4,1,1,1,4,1,1,1,4,1,1,1,4,1,1,1,1,1.231174022502185,1,0,"White, Caucasian, Anglo, European American",0,23,0,1,NA,1,4,6,Healthcare Management Specialist,6,0,160,69,4,5,2,0,0,1,0,0,TRUE,TRUE,TRUE,TRUE,TRUE,4,0.6713294117617257,0.68,0.01743479928559115,4,0.5165874999975786,0.6235612903237343,1,1,0.00667326177387362,0.005815961117579267,4,0.7445281249983237,0.8002406249949708,1,1,0.03011340982812141,0.026871134103419354,1.0659,0.7419,0.4085,0,6.143,0.004,ML,change,50,-0.5499309837155621,0.9116851294349557,0.8267896207142844,0.5080908912203099,3.1423,6.2886,0.3737,6.5996,0.2785,0,-76.9243,0.014,ML,cueing,63,166.27800417917462,4.1606110748999825,0.9957995716990033,0.5076311039019478,4.0200175958371585,1.0306260178268536,0.39240658151059793,0.214,0.278,0.45,0.036,1.586,25.536858746089862,1812.965460038136,0.217,0.279,0.46,0.043,1.718,36.97973439103019,1818.5350114169632,292,0.8651851851851852,1,0,0,1,FALSE,FALSE,FALSE
510,2021-11-13T09:33:16Z,2021-11-13T09:58:45Z,1528,1,2021-11-13T09:58:46Z,1,Chrome,95.0.4638.69,Windows NT 10.0,1920,1080,no,1.7777777777777777,708,88,436,90,40,89,-0.20863072294706814,-0.016392388875888245,0.040899029720239816,-0.17769429344704088,-0.4412283913971238,-0.27662315071978394,2,2,3,1,1,4,3,1,2,2,1,3,2,2,1,1,2,1,2,1,0.8750939799154206,0,0,1,2,1,2.95,0,1,5,3,4,3,4,2,4,3,3,4,1,3,1,1,5,5,1,1,5,5,5,5,0,2,0,0,1,1,1,1,1,1,1,1,1,1,5,5,1,3,3,1,5,5,5,5,5,1,1,1,1,2,2,1,1,5,5,3,3,3,1,1,3,1,1,1,1,1.6868151485403922,1.3201731488169053,4,0,1,0,3.6,0,5,0,3.6666666666666665,0,1.8333333333333333,0,2.857142857142857,0,1.6666666666666667,0,3.4324324324324325,0,0,0,0,1.883553231186479,-0.7372407672780129,0.5731562319542332,5,1,5,2,1,1,1,1,1,1.889822365046136,1.1428571428571428,0,1,-0.8176513788914915,5,5,5,5,3,3,1,4,6,5,3,1.5735915849388864,4.428571428571429,0,1.5714285714285714,4,3.8333333333333335,3.2559414990859232,-0.1748077221195339,0,-0.5811844090638635,5,5,5,5,5,5,3,5,5,1,5,3,5,3,1,5,3,3,1,3,1.5491933384829668,5,0,2.2,0,1.4,0,1.8,0,1.8,0,4,4,4,1,4,4,4,1,4,3,4,1,4,4,3,1,4,4,4,4,1.2182817926554552,3.9,0,"Hispanic of Latino (e.g., Mexican American, Central American, and others)",0,20,0,1,NA,1,2,3,Crew Worker,1,0,115,67,2,5,2,0,0,1,0,0,TRUE,TRUE,TRUE,TRUE,TRUE,2,1.053394444445769,0.72,0.09313455255738762,2,0.4827499999925494,0.5335187499970198,1,1,0.004285652257516461,0.003479588668757522,2,0.6175874999910593,0.6929312500059605,1,1,0.005068270163142681,0.007151191894876032,1.4219,0.6729,0.6635,0,34.4776,0.004,ML,change,50,-57.219130983715566,0.7401651000199523,1.2760147821281926,0.6741233168816148,1.2323,5.5074,0.4216,5.2416,0.3652,0,-98.4661,0.011,ML,cueing,64,209.40884925007902,4.730755657236735,0.8757870891204651,0.44384821910756167,4.4906402236373,0.9226156004623552,0.3832336929141831,0.189,0.37,0.769,0.008,0.977,38.87884207658207,1847.6600129271903,0.19,0.368,0.774,0.008,1.054,53.48607680613598,1835.828467474389,312,0.9244444444444444,1,0,1,2,FALSE,FALSE,FALSE
512,2021-11-13T09:34:18Z,2021-11-13T09:59:30Z,1511,1,2021-11-13T09:59:30Z,1,Firefox,94.0,Windows NT 10.0,1920,1080,NA,1.7777777777777777,698,49,407,132,72,89,-0.23432439312269096,-0.3706971830899965,-0.09871390517370586,0.33413478098278837,7.57516981911087e-4,-0.27662315071978394,4,3,1,1,4,1,1,2,1,2,4,1,1,1,3,2,1,1,1,2,1.1367080817685316,0,1,1,5,4,1.65,0,4,5,1,4,1,1,3,2,2,1,2,4,1,4,2,2,3,4,1,1,1,2,2,1,2,0,0,2,2,3,3,3,3,4,3,2,5,2,3,3,2,4,4,4,4,3,3,4,2,1,1,2,1,1,1,1,4,2,4,2,1,3,2,1,1,3,2,2,1.1435942496391838,1.4074631010979937,2,0,2,0,1.8,0,3.2222222222222223,0,3.5833333333333335,0,1.5,0,1.7142857142857142,0,2,0,2.72972972972973,0,1,0,0,-0.051476894336432474,-0.22054348261253207,-0.13601018847448226,2,3,3,3,2,4,3,3,2,0.6900655593423543,3.142857142857143,0,2.5,0.9323707254421016,3,4,4,4,2,2,2,3,6,2,2,1,3.2857142857142856,0,2.7142857142857144,4.5,3.8333333333333335,3.2559414990859232,0.10757398284279028,0,0.19737442278879264,1,1,1,1,1,1,5,3,1,5,2,5,1,5,4,1,5,2,1,2,1.7674302033770737,1,0,4.6,0,4.2,0,4.2,0,4.333333333333333,0,1,1,1,1,1,1,1,3,1,1,1,1,1,1,2,1,1,1,2,1,0.5231483637805969,1.6,0,Black or African American,0,23,0,1,NA,1,2,4,Resturant,1,0,140,76,2,5,2,0,0,1,0,0,TRUE,TRUE,TRUE,TRUE,TRUE,4,0.7378648648648649,0.74,0.05050151020408165,4,0.4848125,0.5414666666666667,1,0.967741935483871,0.0041824153225806454,0.0052121311827957,4,0.57665625,0.6194375,1,1,0.002933007056451613,0.002982705645161292,1.2818,0.8627,0.3904,0,19.0165,0.003,ML,change,50,-26.296930983715562,0.9465364047155427,1.105048416491732,0.4576731906336785,1.2367,4.1442,0.3997,4.7729,0.3553,0,-80.8469,0.01,ML,cueing,63,174.1232041791746,3.9192300462740004,0.8678228482392004,0.4378960331749089,4.518098607032407,0.9170084778456928,0.3865021220978557,0.082,0.462,0.73,0.034,1.697,16.45308191189422,1799.4981630785342,0.082,0.464,0.739,0.037,1.769,23.417580709178125,1806.8886378260904,317,0.9392592592592592,1,1,1,2,FALSE,FALSE,FALSE
513,2021-11-13T09:15:49Z,2021-11-13T09:59:36Z,2626,1,2021-11-13T09:59:37Z,1,Chrome,95.0.4638.69,Windows NT 10.0,1536,864,NA,1.7777777777777777,788,79,450,99,65,110,-0.0030813615420855725,-0.09815503369452862,0.10829837760007566,-0.06801663464064889,-0.09592690047600279,0.07809555125813061,2,2,3,1,2,1,1,3,1,2,1,3,2,1,2,2,2,1,1,2,0.7163503994113789,0,0,2,4,3,2.35,0,3,4,3,4,4,4,4,2,3,1,3,2,1,4,4,1,3,1,1,1,2,2,1,0,2,NA,NA,5,5,4,5,5,5,5,5,4,3,5,3,5,4,2,5,3,3,4,5,5,5,1,1,1,4,2,1,1,2,1,4,5,3,3,1,1,2,1,1,1,1.5891902106184537,1.0997835284835873,1.5,0,1.25,0,2.533333333333333,0,1.2222222222222223,0,3.0833333333333335,0,1.5,0,2,0,1.6666666666666667,0,2.108108108108108,0,0,NA,NA,-0.2183432376938503,-0.8521929756973453,-0.5352681066955978,5,2,3,1,1,2,3,1,8,1.3972762620115438,1.8571428571428572,0,4.5,0.9011414085945675,5,5,5,5,3,2,2,8,7,NA,4,1.4638501094227998,4.142857142857143,0,1.8571428571428572,1.5,3.8333333333333335,3.2559414990859232,-1.5867162469311549,0,-1.1277966766268004,1,2,2,1,2,1,4,2,2,2,3,4,2,4,4,2,5,2,3,4,1.162919151265879,1.6,0,4.2,0,3.4,0,3.6,0,3.7333333333333334,0,2,1,2,1,2,1,2,2,3,1,2,2,3,1,1,2,1,3,3,2,0.7451598203705946,2.15,0,"White, Caucasian, Anglo, European American",0,25,0,1,NA,0,4,4,Student,7,0,154,72,3,5,2,1,1,1,0,2,TRUE,TRUE,TRUE,TRUE,TRUE,2,0.9102837209320346,0.8775510204081632,0.17149172290908515,2,0.5224781250022351,0.5494000000001923,1,1,0.0039007604737379717,0.007124435333486081,2,0.605534375003539,0.6440451612905148,1,0.96875,0.014376632650777006,0.009245655150776634,1.7437,1.2609,0.4503,0,25.1086,0.004,ML,change,49,-38.54173910566812,1.1749041846987498,1.676256389341638,0.3716250639080919,1.9002,5.2575,0.36870000000000003,6.0606,0.3657,0,-84.0095,0.014,ML,cueing,63,180.4484041791746,3.9548032478905477,1.0476209476669767,0.42108985036206403,4.597536370240418,0.9011641002363352,0.4275356762861309,0.075,0.413,0.406,0.018,1.512,79.02415474165842,1906.0093301411948,0.072,0.413,0.4,0.018,1.629,99.27104699189452,1926.905295600151,406,1.202962962962963,1,0,0,1,FALSE,FALSE,FALSE
514,2021-11-13T09:41:31Z,2021-11-13T10:04:20Z,1368,1,2021-11-13T10:04:22Z,1,Firefox,94.0,Windows NT 10.0,2560,1440,NA,1.7777777777777777,641,80,363,101,61,81,-0.380778313123741,-0.08907029538134635,-0.3105404270817614,-0.04364382157256178,-0.15117513902338214,-0.4117540848066085,3,4,2,2,3,2,2,1,1,3,1,1,1,2,2,2,2,2,2,3,0.8255779474818965,0,1,1,2,2,2.15,0,5,4,1,3,2,1,5,2,2,1,1,5,2,5,3,1,1,1,1,2,2,2,2,2,2,0,0,3,5,5,4,4,5,3,5,5,2,5,1,1,4,1,5,2,1,1,1,1,5,1,1,1,3,1,1,2,2,2,4,2,3,1,1,1,1,1,1,2,1.6251588048991217,1.61245154965971,1.5,0,1.25,0,1.6,0,1.6666666666666667,0,1.25,0,1.1666666666666667,0,1.8571428571428572,0,1,0,1.4864864864864864,0,1,0,0,-0.8865829329024428,-0.4557470907642554,-0.6711650118333491,4,2,4,1,1,2,2,1,1,1.2535663410560174,1.7142857142857142,0,1,-0.4757826382709144,5,5,5,5,3,2,1,6,8,5,4,1.7043362064926932,4.285714285714286,0,1.7142857142857142,2,3.8333333333333335,3.2559414990859232,-1.3043345419688306,0,-1.0662768215670753,2,2,3,2,2,3,5,2,2,3,2,3,3,4,5,2,4,3,4,2,1.0600988273786194,2.2,0,3.4,0,3.8,0,4.2,0,3.8,0,1,2,3,2,2,3,3,1,4,1,2,2,2,3,1,2,1,2,2,3,0.8522416262267903,2.4,0,"White, Caucasian, Anglo, European American",0,24,0,1,NA,1,4,6,unemployed,5,0,180,72,2,5,2,0,0,1,0,0,TRUE,TRUE,TRUE,TRUE,TRUE,6,0.7247837837837838,0.74,0.028265520000000002,6,0.45934375,0.5147419354838709,1,0.96875,0.0018985554435483865,0.0033792862903225802,6,0.6305625,0.7022903225806452,1,0.96875,0.00434528629032258,0.004298447580645161,1.1569,0.9825,0.4709,0,6.6649,0.006,ML,change,50,-1.593730983715563,1.0943321754551927,0.9558053565843588,0.5151643549436979,1.7364,4.9736,0.3498,5.49,0.3012,0,-81.3405,0.01,ML,cueing,64,175.15764925007903,4.3878782651383466,0.7826076743669358,0.43113721238248043,5.504358011189077,0.7527008086991263,0.3931072418599928,0.079,0.493,0.584,0.019,1.817,111.15582328478608,1959.5867363627206,0.08,0.495,0.642,0.02,1.929,108.89890795084965,1936.0122362054271,366,1.0844444444444443,1,0,0,1,FALSE,FALSE,FALSE
515,2021-11-13T09:41:35Z,2021-11-13T10:06:17Z,1481,1,2021-11-13T10:06:18Z,0.8999999761581421,Chrome,95.0.4638.69,Windows NT 10.0,1536,864,NA,1.7777777777777777,816,66,324,95,54,79,0.06886091494965832,-0.21625663176589804,-0.49829575331844694,-0.11676226077682311,-0.24785955648129604,-0.4455368183283147,1,3,4,4,1,1,2,1,1,2,2,4,2,3,1,1,2,1,1,1,1.1192102478745307,0,1,1,4,4,3,0,5,4,4,4,3,2,3,3,5,2,5,1,3,1,2,4,4,1,1,1,3,5,3,5,2,0,0,2,4,1,1,2,1,4,3,3,2,3,5,5,2,5,5,5,5,3,5,5,1,1,5,3,5,5,1,3,4,4,5,1,1,1,3,1,4,5,2,3,1.6293110981806558,1.3557637102737474,2.75,0,3.5,0,3.2666666666666666,0,3.6666666666666665,0,4,0,3.8333333333333335,0,2,0,1.6666666666666667,0,3.3783783783783785,0,3,0,0,1.179888314592263,0.6560486812839473,0.9179684979381051,2,4,1,4,4,5,5,8,5,1.5118578920369088,4.428571428571429,0,6.5,3.1775260909359293,1,5,5,3,2,2,4,6,6,2,2,1.5735915849388864,2.857142857142857,0,3.142857142857143,3,3.8333333333333335,3.2559414990859232,-0.7395711320441822,0,0.012814857609616537,3,5,5,2,4,5,5,4,4,3,5,4,3,2,4,1,3,1,5,3,1.3557637102737474,3.8,0,2.8,0,4.2,0,2.6,0,3.2,0,1,1,1,4,2,1,2,3,1,1,2,3,1,2,1,3,1,2,2,2,0.8944271909999159,1.5,0,"White, Caucasian, Anglo, European American",0,24,0,1,NA,1,2,6,Salesman,2,0,183,71,2,5,2,0,0,1,0,0,TRUE,TRUE,TRUE,TRUE,TRUE,4,0.9961156250033527,0.6530612244897959,0.22244689748886984,4,1.0817548387089084,0.9763258064562275,0.96875,0.96875,0.5043141030448913,0.13845432822293233,4,1.5569206896568166,1.53411666666468,0.9666666666666667,0.9375,0.5947514680524554,0.47838362257197353,1.8716,0.3595,0.1881,0,61.7092,0.003,ML,change,49,-111.74293910566813,0.40804136554628284,1.5501432260346781,0.41463825445838565,2.4223,1.5075,0.2093,1.3908,0.2512,0,42.4838,0.008,ML,cueing,64,-72.49095074992098,1.7343397686829878,1.979996807138215,0.44118066355794106,1.2554098693707636,2.735351448373055,0.06041828344705458,0.141,0.319,0.114,0.232,1.807,129.1065157460193,2094.3884753604693,0.139,0.356,0.111,0.243,1.835,142.89473022065886,2052.894265597932,104,0.3081481481481481,1,0,1,2,FALSE,FALSE,FALSE
516,2021-11-13T09:38:27Z,2021-11-13T10:12:12Z,2024,1,2021-11-13T10:12:14Z,0.8999999761581421,Firefox,94.0,Windows NT 10.0,1920,1080,NA,1.7777777777777777,723,91,494,93,40,111,-0.17009021768363392,0.010861826063658545,0.32012489950813117,-0.14113507384491022,-0.4412283913971238,0.0949869180189837,3,3,3,2,2,1,1,3,1,3,3,1,2,2,3,3,1,1,2,2,0.8522416262267903,0,0,2,4,4,1.9,0,2,3,2,3,1,1,1,1,1,3,1,2,1,2,1,3,2,1,1,1,1,3,1,0,2,0,0,4,1,1,3,1,4,4,4,4,1,4,2,1,2,1,5,4,3,4,4,1,1,1,5,1,4,3,1,1,1,2,4,1,1,1,1,1,4,1,1,1,1.4760347823404023,0.816496580927726,1.625,0,1.75,0,2.6,0,3.111111111111111,0,2.3333333333333335,0,3,0,1.1428571428571428,0,1,0,2.3513513513513513,0,0,0,0,-0.031441318306858645,-0.5020371591262895,-0.2667392387165741,4,1,2,1,1,1,2,1,1,1.1126972805283737,1.7142857142857142,0,1,-0.4757826382709144,2,4,4,4,1,1,2,1,1,1,1,1.3972762620115438,2.857142857142857,0,3.142857142857143,8,3.8333333333333335,3.2559414990859232,2.0842459175790595,0,1.4247233824212375,2,3,3,1,1,1,3,2,1,1,3,4,2,4,3,1,2,3,2,2,1.0327955589886444,2,0,3.4,0,3,0,4,0,3.466666666666667,0,1,2,1,2,1,1,1,2,1,1,1,2,1,2,1,2,1,1,1,2,0.4893604849295929,1.55,0,"White, Caucasian, Anglo, European American",0,24,0,1,NA,0,2,6,surveyor,3,0,209,69,1,5,2,0,0,1,0,0,TRUE,TRUE,TRUE,TRUE,TRUE,3,0.64759375,0.64,0.01985289795918367,3,0.40874193548387094,0.4615806451612903,0.96875,0.96875,0.0046694989919354845,0.005060129032258065,3,0.5365625,0.6249677419354839,1,0.96875,0.0034146411290322583,0.0039770393145161275,1.0459,0.5754,0.38,0,6.6949,0.004,ML,change,50,-1.6537309837155618,0.6813433808642637,0.8444554699771644,0.4740780615569132,1.093,3.3029,0.3026,3.9598,0.2763,0,-69.1893,0.009,ML,cueing,64,150.85524925007903,3.966618371485095,0.8657216003362248,0.3592751138112522,4.047093568367469,0.8485069955697516,0.3104645797829594,0.228,0.275,0.884,0.013,1.498,85.67569639196024,1916.1638490221226,0.229,0.275,0.884,0.014,1.559,90.53662878179938,1912.5083264566376,104,0.3081481481481481,1,0,0,1,FALSE,FALSE,FALSE
517,2021-11-13T09:51:05Z,2021-11-13T10:18:25Z,1639,1,2021-11-13T10:18:25Z,1,Firefox,94.0,Windows NT 10.0,1536,864,N/A,1.7777777777777777,697,43,443,246,63,96,-0.23689376014025323,-0.4252056129690901,0.07459870366015774,1.7233851258637536,-0.12355101974969247,-0.15838358339381242,3,2,2,3,2,1,2,2,1,3,2,2,1,1,3,3,2,1,2,2,0.7254762501100116,0,1,2,3,3,2.1,0,3,4,2,4,2,3,2,3,2,2,2,2,1,2,3,2,3,2,1,2,2,3,2,0,2,0,1,5,4,4,4,4,3,4,5,4,1,3,3,2,4,2,5,4,3,3,4,4,3,2,1,1,1,1,1,1,1,1,3,3,3,1,1,2,2,2,1,1,1.367248832279395,0.8338093878327919,2.125,0,1.5,0,2.6,0,1.8888888888888888,0,2.6666666666666665,0,1.3333333333333333,0,1.7142857142857142,0,1.3333333333333333,0,2.027027027027027,0,0,0,1,0.044055055137912885,-0.40398871494434996,-0.17996682990321855,4,2,4,1,1,2,3,1,1,1.2724180205607036,1.8571428571428572,0,1,-0.39031545311577004,4,4,4,4,1,1,1,8,4,2,4,1.6035674514745464,3.2857142857142856,0,2.7142857142857144,3,3.8333333333333335,3.2559414990859232,-0.7395711320441822,0,-0.22619813465469363,3,3,2,4,3,1,4,2,2,3,1,5,3,3,3,3,4,2,4,3,1.1254628677422756,3,0,4.6,0,3.4,0,3.4,0,3.8,0,3,1,2,3,2,2,3,2,1,3,2,3,2,2,2,3,1,2,2,2,0.6708203932499369,2.05,0,"Asian or Asian American (e.g., Chinese, Japanese, and others) & White, Caucasian, Anglo, European American",1,23,0,1,NA,1,3,6,Retail Associate,1,0,185,70,3,5,2,0,0,1,0,0,TRUE,TRUE,TRUE,TRUE,TRUE,2,0.6033571428571428,0.84,0.05372363265306123,2,0.3905806451612903,0.46540625,0.96875,1,0.00404991935483871,0.005079152217741934,2,0.5145,0.58465625,1,1,0.006341483870967742,0.002996813508064515,1.1751,1.3971,0.3335,0,2.0895,0.004,ML,change,50,7.557069016284437,1.3789248642203953,1.202551436724616,0.3068453465327423,1.0486,3.9171,0.3315,4.8008,0.286,0,-86.1508,0.016,ML,cueing,64,184.77824925007903,4.303924925893242,0.9626410306243111,0.35706810348554185,4.193717993854068,0.8188407540797178,0.29905527220169303,0.125,0.336,0.719,0.007,0.942,62.11930979764939,1844.139479354409,0.126,0.333,0.726,0.007,0.981,74.14432073213374,1855.232385726255,359,1.0637037037037036,1,0,0,1,FALSE,FALSE,FALSE
518,2021-11-13T09:56:35Z,2021-11-13T10:20:09Z,1413,1,2021-11-13T10:20:11Z,0.8999999761581421,Chrome,95.0.4638.69,Windows NT 10.0,1920,1080,NA,1.7777777777777777,791,60,273,57,81,73,0.0046267395106012734,-0.2707650616449916,-0.7438219491664203,-0.5798457090704782,0.12506605371351465,-0.5468850188934331,3,2,2,2,3,1,1,2,1,3,3,1,2,1,4,3,1,2,3,3,0.9333020044867296,0,1,2,3,3,1.75,0,4,5,2,3,2,2,4,2,2,2,4,3,2,3,4,2,2,1,1,1,1,1,1,0,2,0,0,4,4,3,4,2,4,4,4,5,2,4,2,2,4,2,4,4,2,2,4,4,4,1,1,1,2,1,2,1,1,1,4,2,2,1,1,1,1,1,1,1,1.322024110123468,1.0327955589886444,1.25,0,1,0,2.2666666666666666,0,2.2222222222222223,0,2.5,0,1.1666666666666667,0,1.4285714285714286,0,1,0,1.945945945945946,0,0,0,0,-0.5100689679022363,-0.7372407672780129,-0.6236548675901246,4,2,4,2,1,2,2,3,3,1.1338934190276817,1.8571428571428572,0,3,0.34765989643299416,4,5,5,4,2,2,2,4,6,4,4,1.3972762620115438,3.7142857142857144,0,2.2857142857142856,4,3.8333333333333335,3.2559414990859232,-0.1748077221195339,0,-0.18282942195667984,2,2,2,2,3,2,4,2,2,2,2,4,2,4,4,2,4,4,2,2,1.01418510567422,2.2,0,3.6,0,3.2,0,4,0,3.6,0,1,2,1,4,1,1,2,4,2,2,2,3,1,2,1,3,1,2,2,1,0.9679060415469871,1.5,0,"White, Caucasian, Anglo, European American",0,26,0,1,NA,1,4,6,Unemployed,5,0,160,68,2,5,2,0,0,1,0,0,TRUE,TRUE,TRUE,TRUE,TRUE,5,0.9936757575756673,0.66,0.07772356448996058,5,0.5411321428572493,0.6656593749979511,0.9032258064516129,1,0.016641276515967213,0.011813155392907495,5,0.9777749999994412,1.2447677419353878,1,0.96875,0.06372144129003728,0.08330485934503105,1.5164,0.454,0.4288,0,43.5113,0.003,ML,change,50,-75.28653098371556,0.5554859381736317,1.1940792229432355,0.6497378420650155,1.476,3.1066,0.4281,2.1084,0.2402,0,-28.8655,0.008,ML,cueing,63,70.1604041791746,3.485146311751483,1.1887979315018695,0.5004370438350927,2.2986076746367448,0.9717152892827066,0.3706721354859165,0.133,0.533,0.317,0.006,1.91,18.956073603956362,1850.6759221344066,0.133,0.535,0.322,0.006,1.937,24.62082486630568,1849.477995536743,104,0.3081481481481481,1,1,2,3,FALSE,FALSE,FALSE
519,2021-11-13T09:33:17Z,2021-11-13T10:22:01Z,2923,1,2021-11-13T10:22:01Z,1,Chrome,95.0.4638.69,Windows NT 10.0,1920,1080,NA,1.7777777777777777,2126,51,410,101,63,89,3.4347317079562476,-0.35252770646363196,-0.0842711877708839,-0.04364382157256178,-0.12355101974969247,-0.27662315071978394,3,3,1,2,3,1,2,3,1,3,2,1,1,1,3,3,2,1,3,3,0.9119095061289915,0,1,1,4,4,1.7,0,1,2,4,2,3,4,2,4,3,3,4,2,3,2,2,3,4,1,1,3,3,3,3,0,2,0,0,2,3,2,4,3,4,5,5,4,2,3,2,1,3,3,4,5,3,3,2,5,4,1,3,1,3,1,1,1,2,1,2,5,4,2,5,3,2,2,2,2,1.3495633817354862,0.9611501047232549,2.625,0,2,0,3.8,0,2.4444444444444446,0,2.8333333333333335,0,1.6666666666666667,0,2.4285714285714284,0,3.3333333333333335,0,2.5675675675675675,0,0,0,0,1.0069241872258443,-0.4236359564090485,0.2916441154083979,4,2,3,2,1,1,2,3,2,1.0690449676496976,1.8571428571428572,0,2.5,0.1631660590458031,3,4,3,5,2,3,4,7,6,3,2,0.9759000729485332,3.142857142857143,0,2.857142857142857,2.5,3.8333333333333335,3.2559414990859232,-1.0219528370065065,0,-0.2877179897144191,2,3,2,2,3,2,5,3,2,3,3,4,1,4,4,5,3,2,4,2,1.1872336794093274,2.4,0,3.6,0,3.6,0,3.8,0,3.6666666666666665,0,2,1,2,2,3,2,3,1,3,2,2,3,2,3,1,2,3,3,3,3,0.7326950970650465,2.5,0,"White, Caucasian, Anglo, European American",0,29,0,1,NA,1,3,6,"Computer Scientist, looking for work",5,0,265,71,3,5,2,0,1,1,0,1,TRUE,TRUE,TRUE,TRUE,TRUE,1,0.852774418520373,0.86,0.028929447851734937,1,0.48432500003278256,0.5642218751013279,1,1,0.0028439593509300286,0.0028792966017320465,1,0.5791875001192093,0.6660968751460313,1,1,0.0036981888693354203,0.0020211861220067735,1.2564,1.5382,0.5607,0,0.0159,0.004,ML,change,50,11.704269016284437,1.7260120662605312,1.051724957271673,0.6334126932932147,3.9237,8.582,0.3356,9.1466,0.2698,0,-99.7251,0.009,ML,cueing,64,211.92684925007902,4.960105263466603,0.8352916936879496,0.4826521517508741,4.975441773976724,0.8327169555197201,0.403257369528189,0.192,0.337,0.749,0.011,1.247,162.95521350293743,1992.090504204106,0.195,0.338,0.824,0.012,1.377,169.0716322871321,1958.041988541115,194,0.5748148148148148,1,0,2,3,FALSE,FALSE,FALSE
520,2021-11-13T09:48:29Z,2021-11-13T10:22:26Z,2036,1,2021-11-13T10:22:27Z,1,Firefox,94.0,Windows NT 10.0,1920,1080,"On the exercise question, I actually exercise pretty much daily but it's very light - just walking. I chose the light option for that reason. 

Also, in the consent form, I noticed this

Signing the consent form
Clicking “Yes” below indicates that I have read (or someone has read to me) the description of this study, and I am aware that I am being asked to participate in a research study. 

By clicking ""Yes"", you also consent to the (re)use of the data recorded in this study. I have been told who to contact if I have questions about this study. I have had any questions answered to my satisfaction. I voluntarily agree to participate in this study. I am not giving up any legal rights by agreeing to participate.


Just a nitpick - should it not be I also consent, rather than you? I have been sleeping so little I hope that is actually a useful comment. Anyway, have a good day. Appreciate the opportunity for the study. Thank you.",1.7777777777777777,801,117,572,165,89,93,0.030320409686224094,0.2470650222063974,0.6956355519815023,0.7362861966062256,0.23556253080827336,-0.20905768367637165,3,3,2,2,3,2,1,3,1,3,3,2,1,2,3,3,2,1,3,2,0.7863975156570492,0,1,2,2,3,1.85,0,2,3,2,3,3,3,2,3,3,4,3,2,2,2,4,3,4,4,3,3,4,4,3,4,2,1,2,4,3,3,3,3,4,4,4,3,2,4,3,2,3,2,5,3,2,3,3,3,2,3,1,3,1,1,3,3,1,1,3,3,3,3,3,4,2,4,2,1,0.9671791123858265,0.7037315505489968,3.5,0,2.25,0,3.1333333333333333,0,2.5555555555555554,0,2.4166666666666665,0,2,0,2.2857142857142856,0,3.3333333333333335,0,2.4864864864864864,0,2,1,2,1.0616106628621211,0.6204826952926107,0.8410466790773659,4,2,4,2,2,2,2,5,2,0.9759000729485332,2,0,3.5,0.6176209189753294,4,4,4,4,4,3,2,3,4,6,4,0.7867957924694432,3.857142857142857,0,2.142857142857143,5.5,3.8333333333333335,3.2559414990859232,0.6723373927674386,0,0.16107213806536974,2,2,3,3,3,2,4,2,2,3,2,3,3,4,4,2,4,2,3,3,0.8338093878327919,2.6,0,3.8,0,3.4,0,3.8,0,3.6666666666666665,0,2,3,3,3,4,2,3,3,2,2,4,2,2,3,2,3,1,2,2,3,0.7591546545162482,2.45,0,"White, Caucasian, Anglo, European American",0,30,0,1,NA,1,2,1,Unemployed,3,0,225,72,2,5,2,0,0,1,0,0,TRUE,TRUE,TRUE,TRUE,TRUE,1,1.2956857142857143,0.7,0.18200332285714288,1,0.60578125,0.7273870967741936,1,0.96875,0.006312886088709678,0.012819963709677421,1,0.771258064516129,0.8193666666666667,1,0.9375,0.008690264516129033,0.010090931451612902,1.6502,0.5146,0.7365,0,51.8029,0.003,ML,change,50,-91.86973098371557,0.5661444218630355,1.4966108075373497,0.7669828781392807,2.0643,3.2347,0.424,5.1239,0.4043,0,-53.1192,0.011,ML,cueing,64,118.715049250079,3.1440476389564127,1.0922185662635098,0.564546862869227,4.0762002017385095,1.0164208138315864,0.48499993226940985,0.078,0.574,0.416,0.022,1.702,111.70797164141871,1997.2675869803634,0.076,0.58,0.409,0.023,1.885,135.31206366876077,2001.3981034189515,317,0.9392592592592592,1,0,0,2,FALSE,FALSE,FALSE
522,2021-11-13T10:09:20Z,2021-11-13T10:30:57Z,1296,1,2021-11-13T10:30:58Z,1,Chrome,95.0.4638.69,Macintosh,1440,900,"no, thank you",1.6,642,63,318,69,58,95,-0.3782089461061787,-0.24351084670544482,-0.5271811881240909,-0.4336088306619555,-0.19261131793391667,-0.1752749501546655,3,2,2,2,2,2,2,2,2,2,2,2,2,3,3,2,2,1,2,2,0.44721359549995793,0,0,3,3,3,2.4,0,2,4,3,3,3,4,3,3,3,3,3,3,2,3,2,3,3,1,1,3,3,3,3,4,2,0,0,4,2,4,3,2,2,1,2,2,3,2,2,1,4,2,5,3,3,2,3,3,3,1,1,1,1,1,2,4,4,4,3,2,3,1,2,1,1,2,3,3,1.1170262968022497,0.5936168397046637,2.5,0,2.25,0,3.066666666666667,0,3.5555555555555554,0,2.4166666666666665,0,1.1666666666666667,0,3,0,1.3333333333333333,0,2.5675675675675675,0,2,0,0,0.6380566497924803,0.06095019390122543,0.3495034218468529,4,2,3,3,3,3,2,2,1,0.6900655593423543,2.5714285714285716,0,1.5,0.22151431004714253,5,5,5,5,2,2,2,4,7,5,3,1.6035674514745464,4,0,2,3.5,3.8333333333333335,3.2559414990859232,-0.4571894270818581,0,-0.48336226928071535,3,2,3,3,3,3,4,4,2,3,2,2,3,3,4,3,3,3,2,3,0.7037315505489968,2.8,0,3,0,3,0,3.2,0,3.066666666666667,0,2,1,3,2,4,3,4,2,3,3,1,1,3,3,2,2,2,3,3,4,0.9445132413883326,2.85,0,"Asian or Asian American (e.g., Chinese, Japanese, and others) & White, Caucasian, Anglo, European American",1,27,0,1,NA,1,2,6,ESL(English as a second language) assistant,1,0,145,71,1,5,2,0,0,0,0,0,TRUE,TRUE,TRUE,TRUE,TRUE,4,0.7871738095255125,0.84,0.03124920068928651,4,0.46805624999478457,0.5254733333190282,1,0.967741935483871,0.0023829889906034065,0.005199822946529708,4,0.5856249999888241,0.6504433333317439,1,0.967741935483871,0.005672809033485805,0.006456455911608616,1.4848,1.2755,0.4185,0,15.2872,0.005,ML,change,50,-18.838330983715565,1.5789639592850733,1.0502000801553117,0.5610331017828988,1.1161,3.7489,0.3829,5.7846,0.3716,0,-89.2667,0.006,ML,cueing,63,190.9628041791746,3.9215472429387583,0.8673100618095172,0.4220250610316313,5.200342951652859,0.7967041337292367,0.393848920139271,0.07,0.43,0.417,0.029,1.824,156.3902034734175,1991.6391534674428,0.071,0.427,0.416,0.024,1.921,179.00410929666393,2007.8890296415557,408,1.208888888888889,1,0,0,1,FALSE,FALSE,FALSE
523,2021-11-13T10:13:52Z,2021-11-13T10:32:18Z,1106,1,2021-11-13T10:32:19Z,1,Chrome,95.0.4638.69,Windows NT 10.0,1920,1080,NA,1.7777777777777777,611,35,277,52,31,63,-0.4578593236506095,-0.4978835194745482,-0.7245649926293244,-0.6407777417406959,-0.5655369281287274,-0.7157986865019639,3,3,2,2,3,2,2,3,2,3,2,2,2,2,3,3,2,2,3,3,0.5104177855340404,1,1,2,2,1,2.05,0,3,4,2,4,2,2,4,2,2,2,2,3,2,3,3,3,2,1,1,2,2,2,2,0,2,0,0,4,3,3,3,3,2,3,3,2,2,2,3,1,3,2,2,3,3,2,3,3,4,1,1,1,2,1,1,1,1,1,4,2,2,1,1,1,2,2,2,2,0.9863939238321437,0.816496580927726,1.875,0,2,0,2.2666666666666666,0,3.111111111111111,0,2.75,0,1.1666666666666667,0,1.2857142857142858,0,1,0,2.2162162162162162,0,0,0,0,-0.12532783400099734,-0.4236359564090485,-0.2744818952050229,4,2,4,1,1,2,3,3,5,1.2724180205607036,1.8571428571428572,0,4,0.7166475712073764,4,4,4,4,3,2,1,4,3,3,3,1.2149857925879117,3.7142857142857144,0,2.2857142857142856,5.5,3.8333333333333335,3.2559414990859232,0.6723373927674386,0,0.24074313548680643,3,4,4,4,4,4,4,4,4,3,4,2,3,2,2,1,4,3,4,4,1.01418510567422,3.8,0,2.6,0,3.8,0,2,0,2.8,0,2,2,3,2,2,3,2,2,3,2,3,2,2,3,2,2,2,3,2,3,0.4893604849295929,2.55,0,"Asian or Asian American (e.g., Chinese, Japanese, and others)",0,18,0,1,NA,1,4,4,Amazon Worker,3,0,135,69,2,5,2,0,0,0,0,0,TRUE,TRUE,TRUE,TRUE,TRUE,3,0.7001736842107616,0.76,0.033431134874323226,3,0.4083935483847895,0.46065624999953436,1,1,8.453412903458553e-4,0.0026630128629211427,3,0.5731625000014902,0.6127517241388559,1,0.9354838709677419,0.004823666935482814,0.007522697849450759,1.0541,1.1026,0.4397,0,0.9022,0.004,ML,change,50,9.931669016284438,1.144433016915404,1.0072057454661771,0.4713498998996143,10,12.0875,0.047,18.0785,0.1318,0,-115.297,0.015,ML,cueing,63,243.02340417917458,5.057887651306101,0.8191432890609283,0.38220995818907305,5.817059639299237,0.7122386537695259,0.3443964272312955,0.066,0.436,0.503,0.023,1.53,85.16624996944964,1955.6841890841042,0.058,0.439,0.45,0.027,1.637,101.66941653448526,1970.8764227135316,312,0.9244444444444444,1,0,2,3,FALSE,FALSE,FALSE
524,2021-11-13T10:01:13Z,2021-11-13T10:35:34Z,2060,1,2021-11-13T10:35:36Z,1,Chrome,95.0.4638.69,Windows NT 10.0,1536,864,No.,1.7777777777777777,688,79,688,137,63,314,-0.2600180632983138,-0.09815503369452862,1.254087291557285,0.39506681365300617,-0.12355101974969247,3.523934370472158,4,4,1,1,1,1,2,3,1,3,3,1,1,1,4,3,1,1,3,4,1.268027892769755,0,1,1,5,5,1.45,0,5,5,1,4,1,1,5,1,1,1,1,5,1,5,4,2,1,1,1,1,1,1,1,0,3,0,0,4,5,4,5,4,3,5,5,4,1,5,1,1,4,1,5,1,1,1,3,1,5,1,1,1,3,1,1,1,1,1,5,1,1,1,1,1,2,1,1,1,1.7406981444322935,1.9444671200491874,1.125,0,1.25,0,1.1333333333333333,0,1.6666666666666667,0,1.25,0,1.1666666666666667,0,0.8571428571428571,0,1,0,1.2972972972972974,0,0,0,0,-1.329591780667467,-0.6588395645607719,-0.9942156726141195,4,2,3,2,1,1,1,2,1,1.1547005383792515,1.7142857142857142,0,1.5,-0.2912888008837234,4,5,5,5,4,4,1,7,7,4,3,1.4142135623730951,4.571428571428571,0,1.4285714285714286,2,3.8333333333333335,3.2559414990859232,-1.3043345419688306,0,-1.2256188164099486,2,2,2,1,2,2,5,2,1,5,1,5,2,4,4,1,4,1,3,3,1.5522640914238175,1.8,0,4.6,0,4.4,0,4,0,4.333333333333333,0,1,1,1,4,1,1,1,4,1,1,1,4,1,1,1,4,1,1,2,1,1.2258187382102494,1.05,0,"White, Caucasian, Anglo, European American",0,22,0,1,NA,1,3,7,academic assistant and department menager,4,0,175,69,3,5,2,0,0,1,0,0,TRUE,TRUE,TRUE,TRUE,TRUE,5,0.7052973684197978,0.7755102040816326,0.04536001708100948,5,0.4352580645142063,0.5011965517360588,1,0.90625,0.0033058078501532156,0.007009270604561328,5,0.5443499999996275,0.591528571422611,1,0.875,0.006146867096091894,0.007288208023997868,1.2488,1.0126,0.3926,0,14.9852,0.004,ML,change,49,-18.29493910566812,1.1301355454359046,1.096940001519777,0.43787974324683543,1.0649,3.139,0.3569,3.7139,0.2919,0,-65.967,0.009,ML,cueing,63,144.3634041791746,2.883201580352636,0.7868626171607773,0.39032572660892056,4.791738317624876,0.8646412745771899,0.3478554165371944,0.051,0.415,0.388,0.018,1.541,145.51326030102015,2059.359186879897,0.05,0.413,0.408,0.017,1.592,167.40004905522554,2065.0873722083597,378,1.12,1,0,0,1,FALSE,FALSE,FALSE
525,2021-11-13T10:13:58Z,2021-11-13T10:49:13Z,2114,1,2021-11-13T10:49:13Z,1,Firefox,94.0,Windows NT 10.0,1280,720,N/A,1.7777777777777777,801,76,680,124,83,237,0.030320409686224094,-0.1254092486340754,1.215573378483093,0.23664352871043995,0.15269017298720433,2.223299129886471,4,3,1,1,2,1,1,2,1,3,3,1,1,2,3,3,1,1,3,3,1.025978352085154,0,1,1,4,3,1.6,0,3,4,3,4,3,2,4,2,2,2,2,3,2,4,3,3,3,4,3,3,2,2,3,3,3,0,4,4,3,2,3,1,4,4,4,4,3,3,1,3,2,2,4,4,3,2,3,3,2,3,4,1,3,4,3,3,2,1,4,2,2,2,2,1,2,3,2,2,1.0178585540417864,0.8338093878327919,2.875,0,2.25,0,2.3333333333333335,0,2.7777777777777777,0,2.75,0,3,0,2,0,1.6666666666666667,0,2.6216216216216215,0,2,0,4,0.5072930593772413,0.7667487814979485,0.637020920437595,3,3,2,3,3,3,3,3,3,0.3779644730092272,3.142857142857143,0,3,1.1168645628292926,1,4,3,3,2,3,2,4,1,1,1,0.9759000729485332,2.857142857142857,0,3.142857142857143,6.5,3.8333333333333335,3.2559414990859232,1.237100802692087,0,1.0011508249777512,2,2,2,1,2,2,2,3,2,3,4,5,3,3,3,4,4,3,3,5,0.9611501047232549,1.8,0,3.6,0,2.6,0,2.8,0,3,0,2,1,2,3,3,2,2,3,2,2,2,2,3,1,1,2,1,3,2,2,0.6863327411532597,2.05,0,"Hispanic of Latino (e.g., Mexican American, Central American, and others) & White, Caucasian, Anglo, European American",1,28,0,1,NA,1,1,4,online task worker,1,0,155,70,4,5,2,0,0,1,0,0,TRUE,TRUE,TRUE,TRUE,TRUE,6,1.1098536585365855,0.82,0.17086066326530613,6,0.4898709677419355,0.6120625,1,1,0.005897649462365592,0.008815028225806449,6,0.65390625,0.8079999999999999,1,0.96875,0.013315119959677421,0.025285232862903222,2.1792,0.8038,0.2427,0,56.032,0.004,ML,change,50,-100.32793098371556,0.961210224662299,1.5775399079850871,0.5846690968216046,3.1022,5.4793,0.329,6.6174,0.2555,0,-71.1108,0.01,ML,cueing,63,154.6510041791746,3.749786727583153,1.1048987655524354,0.4693382923463547,4.146128475513424,0.9992779410624701,0.37312946888083326,0.096,0.439,0.468,0.014,1.82,32.96164665865247,1865.4694387794639,0.097,0.44,0.472,0.014,1.96,41.156387077768365,1866.7024693883382,104,0.3081481481481481,1,1,1,2,FALSE,FALSE,FALSE
526,2021-11-13T10:21:14Z,2021-11-13T10:51:36Z,1821,1,2021-11-13T10:51:38Z,0.8999999761581421,Chrome,95.0.4638.69,Windows NT 10.0,1920,1080,None.,1.7777777777777777,656,78,431,102,49,92,-0.3422378078603068,-0.10723977200771087,0.01682783404886987,-0.03145741503851823,-0.31691985466552025,-0.2259490504372247,4,4,2,1,4,1,2,4,1,4,3,2,2,1,3,4,2,1,3,4,1.231174022502185,0,1,2,4,4,1.4,0,5,5,2,5,1,1,5,1,1,2,1,5,2,4,4,2,1,1,1,1,1,2,1,1,2,0,0,5,4,5,3,3,5,4,5,4,1,4,1,1,5,2,5,1,1,1,1,1,5,1,1,1,1,1,1,2,2,1,5,1,2,1,1,1,2,2,2,2,1.6908160334166633,1.791514389985135,1.25,0,2,0,1.3333333333333333,0,1.7777777777777777,0,1.1666666666666667,0,0.8333333333333334,0,1.2857142857142858,0,1,0,1.3243243243243243,0,1,0,0,-1.1783086631108288,-0.22054348261253207,-0.6994260728616805,4,1,3,1,1,1,1,1,1,1.2535663410560174,1.4285714285714286,0,1,-0.6467170085812028,5,5,5,5,3,2,2,4,4,4,3,1.4638501094227998,4.142857142857143,0,1.8571428571428572,5,3.8333333333333335,3.2559414990859232,0.38995568780511447,0,-0.13946070925866577,2,2,1,1,2,1,4,3,1,3,2,5,2,3,4,2,5,2,3,2,1.2649110640673518,1.6,0,4.6,0,3.6,0,3.8,0,4,0,1,1,1,4,2,1,2,3,1,1,1,4,2,1,1,4,1,1,1,2,1.118033988749895,1.25,0,"White, Caucasian, Anglo, European American",0,19,0,1,NA,1,3,4,Full-time student,5,0,140,70,3,5,2,0,0,1,0,0,TRUE,TRUE,TRUE,TRUE,TRUE,1,0.8735868421047926,0.76,0.11288076749515487,1,0.35712580645372793,0.4305333333313465,0.96875,0.967741935483871,0.0017526438607130344,0.0032256453120345302,1,0.5274354838728905,0.587063333333532,0.96875,0.9375,0.00612425410280567,0.010660965161078267,1.3681,0.8615,0.4852,0,25.8011,0.004,ML,change,50,-39.866130983715564,0.8442540841300967,1.3653229893771666,0.4531162943030228,1.0142,3.8449,0.3049,4.858,0.2579,0,-86.5379,0.009,ML,cueing,63,185.5052041791746,4.418760240088735,0.7697175671142219,0.3490559131826777,5.170557806405938,0.6641425031996916,0.2969162874751069,0.059,0.358,0.32,0.019,1.637,100.80700135407231,2048.5544403847653,0.06,0.358,0.322,0.02,1.728,127.08526029080701,2033.813817728562,292,0.8651851851851852,1,0,0,1,FALSE,FALSE,FALSE
528,2021-11-13T10:34:58Z,2021-11-13T10:59:14Z,1455,1,2021-11-13T10:59:16Z,1,Chrome,95.0.4638.69,Windows NT 10.0,1360,768,The study was great and interesting.,1.7708333333333333,772,56,351,54,40,89,-0.044191233823082085,-0.30710401489772066,-0.36831129669304924,-0.6164049286726088,-0.4412283913971238,-0.27662315071978394,3,3,1,1,3,1,1,3,1,3,3,1,1,1,3,3,1,1,3,3,1.025978352085154,0,0,4,5,5,1.5,0,4,4,1,4,1,1,4,1,1,1,1,4,1,4,4,1,1,1,1,1,1,1,1,2,2,1,1,4,4,4,4,4,4,4,4,4,1,4,1,1,4,1,4,1,1,1,1,1,4,1,1,1,1,1,1,1,1,1,4,1,1,1,1,1,1,1,1,1,1.475017178095115,1.5491933384829668,1,0,1,0,1.4666666666666666,0,2,0,1.25,0,1,0,1,0,1,0,1.3783783783783783,0,1,1,1,-1.2052163449283244,-0.15106543898929206,-0.6781408919588082,4,3,3,2,2,2,4,3,2,0.8997354108424374,2.5714285714285716,0,2.5,0.5905019848215247,4,4,4,4,3,3,2,3,3,1,3,0.7867957924694432,3.7142857142857144,0,2.2857142857142856,6,3.8333333333333335,3.2559414990859232,0.9547190977297628,0,0.3819339879679685,1,1,1,1,1,1,4,1,1,4,1,4,1,1,4,1,4,1,4,4,1.5491933384829668,1,0,4.6,0,4.4,0,3.4,0,4.133333333333334,0,1,1,1,3,1,1,1,3,1,1,1,3,3,1,1,3,1,1,1,1,0.8885233166386386,1.3,0,Black or African American,0,26,0,1,NA,1,3,7,Information technology,1,0,130,69,3,5,2,0,0,1,0,0,TRUE,TRUE,TRUE,TRUE,TRUE,3,0.7329135135162521,0.7551020408163265,0.0347596118110335,NA,NA,NA,NA,NA,NA,NA,3,0.7301281250016763,0.8164645161292245,1,1,0.008608104021571892,0.02854434836493401,1.2008,0.9723,0.4431,0,12.3251,0.004,ML,change,49,-12.974739105668123,1.1100850478467046,1.0143468421995345,0.49981250018161355,NA,NA,NA,NA,NA,NA,NA,NA,NA,NA,NA,NA,1.4081633921830186,2.3405216214965847,0.19458412427404914,1.1808332799109493,2.791111092543801,-0.04798546052821928,0.081,0.552,0.411,0.048,1.82,54.229002591306745,1842.688806402678,0.081,0.55,0.407,0.053,1.982,56.846548431912126,1841.5814501693053,406,1.202962962962963,1,1,4,5,TRUE,FALSE,FALSE
529,2021-11-13T09:43:19Z,2021-11-13T11:03:38Z,4819,1,2021-11-13T11:03:39Z,1,Chrome,95.0.4638.69,Windows NT 10.0,1680,1050,"Thanks for the opportunity
",1.6,776,84,492,103,1380,85,-0.033913765752832954,-0.0527313421286173,0.3104964212395832,-0.019271008504474677,18.06693152197496,-0.34418861776319626,1,1,3,4,2,2,1,1,1,1,1,3,3,1,1,1,1,1,1,1,0.9445132413883326,0,1,1,2,2,2.95,0,4,1,4,2,4,4,3,2,2,1,3,2,1,4,3,3,1,1,3,1,4,3,3,2,2,0,1,4,2,1,1,1,1,1,1,2,4,3,4,1,3,5,3,5,5,5,5,5,3,1,5,1,3,3,1,2,1,1,2,2,4,1,3,1,2,2,1,1,1.5538386062955234,1.1751393027860062,2.375,0,1.5,0,2.933333333333333,0,4.444444444444445,0,4,0,2.5,0,2,0,1.6666666666666667,0,3.3513513513513513,0,1,0,1,0.8638682385702389,-0.20089624114783355,0.33148599871120266,4,1,4,1,1,2,3,2,2,1.3801311186847085,1.7142857142857142,0,2,-0.10679496349653231,3,4,4,4,2,3,3,7,6,6,4,0.7559289460184544,3.2857142857142856,0,2.7142857142857144,2.5,3.8333333333333335,3.2559414990859232,-1.0219528370065065,0,-0.3673889871358558,3,1,3,3,4,3,4,3,2,1,1,3,3,5,3,4,5,2,3,4,1.2227992865708155,2.8,0,4,0,2.6,0,3.4,0,3.3333333333333335,0,1,1,1,3,4,1,1,3,1,1,3,3,1,1,2,3,1,1,1,2,1.019545822516343,1.55,0,Black or African American,0,26,0,1,NA,1,2,6,Pharmacy Technician,2,0,220,72,2,5,2,1,0,1,0,1,TRUE,TRUE,TRUE,TRUE,TRUE,6,1.3626944444444444,0.72,0.1626742942857143,6,0.5521875,0.5818125,1,1,0.003928866935483873,0.006110608870967743,6,0.6866129032258065,0.8198125,1,1,0.013050445161290317,0.009290415322580644,1.6645,0.5812,0.7937,0,49.2223,0.003,ML,change,50,-86.70853098371556,0.6438379602727934,1.4669243926541455,0.8614450831188486,2.8603,5.9359,0.3409,7.3,0.3563,0,-83.4575,0.007,ML,cueing,64,179.391649250079,4.1095225967159665,1.0081790837948978,0.46298197109540234,4.589291716360371,0.9027830398363361,0.4569036170073706,0.147,0.4,0.526,0.009,1.581,39.09176455545226,1832.155384767354,0.148,0.401,0.54,0.009,1.55,43.307584439386815,1824.1747877754847,136,0.40296296296296297,1,0,0,1,FALSE,FALSE,FALSE
530,2021-11-13T10:41:39Z,2021-11-13T11:03:44Z,1325,1,2021-11-13T11:03:45Z,1,Chrome,95.0.4638.69,Windows NT 10.0,1397,786,None.,1.77735368956743,655,50,355,74,62,71,-0.34480717487786905,-0.36161244477681426,-0.34905434015595327,-0.37267679799173775,-0.1373630793865373,-0.5806677524151392,3,3,2,2,3,1,3,2,2,3,1,2,2,3,3,3,2,1,2,2,0.7163503994113789,0,1,1,2,2,2.25,0,2,3,3,3,3,5,2,4,4,5,3,1,3,2,2,2,4,1,3,2,2,3,2,0,5,0,0,4,2,1,3,2,3,2,3,2,3,4,2,2,2,3,3,5,4,3,3,3,3,1,1,1,3,4,1,1,3,3,1,4,4,4,5,3,3,3,3,3,1.146217175675628,1.1338934190276817,2.375,0,3,0,3.8,0,3.5555555555555554,0,3.0833333333333335,0,2,0,2.857142857142857,0,4,0,3.108108108108108,0,0,0,0,1.131783574076812,-0.11003114554008399,0.510876214268364,2,4,2,4,3,4,4,3,3,0.9511897312113419,3.857142857142857,0,3,1.5442004886050142,1,1,3,3,1,1,4,3,4,1,1,1.2909944487358056,1.7142857142857142,0,4.285714285714286,5.5,3.8333333333333335,3.2559414990859232,0.6723373927674386,0,1.3561370993869208,3,3,3,3,3,2,5,3,2,4,2,5,3,4,4,1,4,3,5,2,1.2798809468443688,3,0,4,0,4.4,0,3.8,0,4.066666666666666,0,2,3,2,1,4,3,3,1,3,2,3,1,4,3,2,1,1,3,1,3,1.0310954828418375,2.9,0,"White, Caucasian, Anglo, European American",0,22,0,1,NA,1,3,5,Student,3,0,160,70,3,5,2,0,0,1,0,0,TRUE,TRUE,TRUE,TRUE,TRUE,2,0.8123411765098572,0.68,0.038760504349230535,2,0.48360645162674687,0.540640625,1,1,0.004012407959207309,0.003591003779355941,2,0.700531249947846,0.9045937499627471,1,1,0.011947471254966162,0.09595734835036045,1.3019,0.6277,0.4644,0,23.5741,0.004,ML,change,50,-35.412130983715564,0.7466236701214183,1.009573942725121,0.5689477281599415,3.3903,8.0211,0.3293,7.338,0.2526,0,-90.0894,0.01,ML,cueing,63,192.6082041791746,4.693626517193671,0.8827150416025691,0.44954579742690914,4.276018187392714,0.9689235510286248,0.3674025113921107,0.104,0.436,0.354,0.016,1.562,79.75729387105821,1867.7924706230006,0.105,0.433,0.343,0.016,1.671,90.33729410000879,1872.650016393086,104,0.3081481481481481,1,0,0,1,FALSE,FALSE,FALSE
532,2021-11-13T10:40:30Z,2021-11-13T11:07:07Z,1596,1,2021-11-13T11:07:08Z,0.8999999761581421,Chrome,95.0.4638.69,Windows NT 10.0,1366,768,great survey,1.7786458333333333,799,68,385,94,38,112,0.02518167565109953,-0.1980871551395335,-0.2046271661277336,-0.12894866731086665,-0.46885251067081346,0.11187828477983676,4,4,1,1,4,1,1,4,1,4,4,1,1,1,4,4,1,1,4,4,1.538967528127731,0,1,1,5,5,1,0,5,5,1,5,1,1,5,1,1,1,1,5,1,5,5,1,1,1,1,1,1,1,1,0,2,0,0,5,5,5,5,5,5,5,5,5,1,5,1,1,5,1,5,1,1,1,1,1,5,1,1,1,1,1,1,1,1,1,5,1,1,1,1,1,1,1,1,1,1.9666895707934864,2.065591117977289,1,0,1,0,1,0,1,0,1,0,0.8333333333333334,0,0.8571428571428571,0,1,0,1,0,0,0,0,-1.568373259242148,-0.7372407672780129,-1.1528070132600805,4,2,4,1,1,1,2,1,1,1.3451854182690985,1.5714285714285714,0,1,-0.5612498234260587,5,5,5,5,4,5,1,7,7,2,3,1.4960264830861913,4.857142857142857,0,1.1428571428571428,2,3.8333333333333335,3.2559414990859232,-1.3043345419688306,0,-1.3849608112528222,1,1,1,1,1,1,3,1,1,1,1,5,1,5,5,1,5,1,1,3,1.7994708216848747,1,0,5,0,3,0,4.6,0,4.2,0,1,1,1,1,1,1,1,4,1,1,1,4,1,1,1,4,1,1,1,1,1.0990426455975697,1.15,0,"Hispanic of Latino (e.g., Mexican American, Central American, and others)",0,30,0,1,NA,1,2,4,student,1,0,145,69,2,5,2,0,0,1,0,0,TRUE,TRUE,TRUE,TRUE,TRUE,NA,NA,NA,NA,3,0.6491166666666667,0.7785107142850757,1,0.875,0.06620758557475173,0.0656594643450716,3,0.8875000000018627,1.0595343749998138,1,1,0.0987689638741757,0.10534146490713554,NA,NA,NA,NA,NA,NA,NA,NA,NA,NA,NA,NA,NA,1.7744,1.2269,0.2264,2.9254,0.3458,0,3.4179,0.008,ML,cueing,62,5.545603155135274,1.4806293872300738,1.3142452566713374,0.44565093485455354,2.265090490203627,1.8291254783463744,0.25796997411471606,0.159,0.297,0.24,0.104,1.628,56.92651518039714,1855.1876165069366,0.159,0.292,0.24,0.017,1.851,47.35350133197092,1829.3951995527261,365,1.0814814814814815,1,0,0,1,FALSE,FALSE,FALSE
533,2021-11-13T10:13:53Z,2021-11-13T11:08:07Z,3254,1,2021-11-13T11:08:09Z,1,Chrome,95.0.4638.69,Windows NT 10.0,1536,864,none,1.7777777777777777,1472,94,1266,87,88,142,1.7543656784705153,0.038116041003205335,4.03671751116765,-0.21425351304917153,0.22175047117142851,0.618619287605429,4,4,2,1,4,1,1,4,1,4,4,1,2,1,4,4,1,1,4,4,1.465390194130093,0,1,1,5,5,1.1,0,3,3,1,3,2,1,4,1,1,1,1,1,1,1,1,1,1,1,1,1,1,1,1,4,7,0,0,5,4,2,4,4,4,4,4,4,2,4,4,1,1,3,4,1,4,1,1,1,4,1,1,1,1,1,1,4,4,4,2,3,1,2,2,1,2,2,2,2,1.4247912233130966,1.0465362369445672,1,0,2,0,2.3333333333333335,0,2.111111111111111,0,2.25,0,1,0,2.857142857142857,0,1.6666666666666667,0,2.135135135135135,0,2,0,0,-0.5075524221207439,-0.01745100881601569,-0.2625017154683798,4,1,1,3,2,2,3,5,5,1.1126972805283737,2.5714285714285716,0,5,1.51297117175748,2,2,3,4,1,1,4,6,6,1,2,1.2724180205607036,2.142857142857143,0,3.857142857142857,3,3.8333333333333335,3.2559414990859232,-0.7395711320441822,0,0.41116984471680035,1,1,1,1,1,1,4,1,1,1,1,4,1,4,4,1,4,4,5,1,1.6417180315870614,1,0,4,0,4,0,4.6,0,4.2,0,1,1,1,1,1,3,4,4,2,3,3,3,1,3,2,2,1,3,3,1,1.0894228312566052,2.15,0,Black or African American,0,26,0,1,NA,0,2,8,teaching assistant,2,0,180.77,67,3,5,3,0,0,1,1,0,TRUE,TRUE,TRUE,TRUE,TRUE,1,0.9624674999989569,0.8,0.049179669943517426,1,0.615409677420893,0.6292125000022352,0.96875,1,0.010029258065462112,0.011856746289832533,1,0.6586387096778039,0.7351032258051057,0.96875,1,0.006691510232155584,0.013888733655659595,1.1714,1.1696,0.661,0,8.0418,0.004,ML,change,50,-4.347530983715563,1.2184544402429098,1.1377482122708835,0.6823384673424556,1.466,4.0591,0.4486,2.9941,0.3798,0,-53.9487,0.008,ML,cueing,64,120.37404925007903,3.4819386325685664,1.1898930922097306,0.46368561186350843,3.343055720290941,1.027200110259093,0.4713797563036806,0.084,0.479,0.39,0.043,1.612,164.26382904193494,1989.0039960100576,0.079,0.477,0.379,0.042,1.695,181.2958846951851,2012.5595327680674,382,1.1318518518518519,1,0,0,1,FALSE,FALSE,FALSE
534,2021-11-13T10:49:59Z,2021-11-13T11:12:13Z,1333,1,2021-11-13T11:12:14Z,0.8999999761581421,Chrome,95.0.4638.69,Windows NT 10.0,1920,1080,NA,1.7777777777777777,602,46,385,75,51,97,-0.48098362680867,-0.39795139802954327,-0.2046271661277336,-0.3604903914576942,-0.28929573539183057,-0.14149221663295936,4,4,1,1,4,1,1,3,1,3,3,1,1,1,4,4,1,1,4,3,1.3803127029389886,0,1,1,4,4,1.2,0,2,3,4,3,3,4,3,4,3,2,3,3,2,3,2,4,4,4,2,4,5,5,5,1,3,0,0,5,4,4,2,3,3,2,4,2,2,5,5,1,2,2,4,4,4,5,5,5,1,1,5,1,1,1,1,2,1,1,4,1,2,1,1,4,2,1,1,1,1.5749541201192117,0.7037315505489968,4.125,0,1.25,0,3.2,0,2.7777777777777777,0,3.3333333333333335,0,2.1666666666666665,0,1.2857142857142858,0,2,0,2.5675675675675675,0,1,0,0,1.3936979157967502,-0.4557470907642554,0.4689754125162474,5,1,3,1,1,2,1,2,3,1.5275252316519468,1.4285714285714286,0,2.5,-0.09323549641962975,3,5,4,5,1,1,3,1,1,2,2,1.6761634196950514,3.142857142857143,0,2.857142857142857,8,3.8333333333333335,3.2559414990859232,2.0842459175790595,0,1.265381387578364,3,3,3,1,2,2,4,2,2,4,3,4,1,4,3,2,4,1,2,5,1.245945806357946,2.4,0,4,0,3.8,0,3.2,0,3.6666666666666665,0,2,1,1,3,1,1,1,4,1,1,1,3,3,2,1,4,1,2,2,2,1.0399898784932577,1.45,0,"White, Caucasian, Anglo, European American",0,24,0,1,NA,1,2,4,Student,1,0,165,71,3,5,2,0,0,1,0,0,TRUE,TRUE,TRUE,TRUE,TRUE,6,0.8059785714285653,0.8571428571428571,0.03684016407312645,6,0.4467266666666682,0.5477600000000055,0.967741935483871,0.9375,0.0011563132903225205,0.0031754596370969783,6,0.6181624999999876,0.6541290322580721,1,1,0.004791517903227793,0.0041360921290341445,1.2563,1.5007,0.5226,0,1.3295,0.004,ML,change,49,9.016460894331878,1.6088201781063869,1.1137102167235313,0.5587454410621893,1.2967,3.0018,0.3578,5.2974,0.3314,0,-69.3081,0.014,ML,cueing,63,151.04560417917457,3.9268609907988243,0.6896221199190764,0.47092772145193784,4.54027238879825,0.5964510428456904,0.38925272922432486,0.196,0.35,0.733,0.025,1.278,52.89694053195973,1857.0518786274506,0.203,0.357,0.777,0.029,1.33,69.17146248982866,1853.4280626288696,308,0.9125925925925925,1,0,0,1,FALSE,FALSE,FALSE
535,2021-11-13T10:48:22Z,2021-11-13T11:15:15Z,1612,1,2021-11-13T11:15:16Z,1,Chrome,95.0.4638.69,Windows NT 10.0,2560,1080,NA,2.3703703703703702,794,381,189,31,14,77,0.012334840563288119,2.645435936886515,-1.1482180364454353,-0.8966922789556105,-0.8003419419550897,-0.47931955185002084,4,3,3,2,3,2,3,3,3,3,3,3,2,2,3,3,3,3,2,3,0.5231483637805969,0,0,2,2,2,2.3,0,4,3,3,3,4,3,4,4,4,3,3,3,3,3,3,2,3,3,4,3,3,4,3,2,3,2,1,4,3,3,4,3,3,3,4,3,4,4,4,3,3,3,4,4,3,3,3,3,4,4,4,3,4,4,2,2,3,3,4,4,3,3,3,3,4,3,4,2,0.5876609101729886,0.4879500364742666,3.125,0,3.25,0,3.066666666666667,0,2.6666666666666665,0,3.0833333333333335,0,3.3333333333333335,0,2.5714285714285716,0,3,0,2.972972972972973,0,1,2,1,1.080871917112774,0.7611785930589017,0.9210252550858379,4,3,3,2,3,3,2,4,4,0.6900655593423543,2.5714285714285716,0,4,1.143983496983098,2,2,2,2,3,3,4,5,5,3,3,0.7867957924694432,2.2857142857142856,0,3.7142857142857144,4,3.8333333333333335,3.2559414990859232,-0.1748077221195339,0,0.6138805522576877,1,2,2,4,2,2,2,3,4,3,2,3,4,3,2,1,3,3,3,2,0.816496580927726,2.2,0,3.4,0,3,0,2.8,0,3.066666666666667,0,2,2,2,2,2,2,2,2,3,2,3,2,2,2,3,3,3,2,2,2,0.4442616583193193,2.35,0,"White, Caucasian, Anglo, European American",0,19,0,1,NA,1,3,4,student,4,0,154,71,2,5,2,0,0,1,0,0,TRUE,TRUE,TRUE,TRUE,TRUE,6,0.8169333333333333,0.9,0.03595283813877463,6,0.5107903225806452,0.5546645161290278,1,0.96875,0.015686420903225414,0.024750686280241657,6,0.7687533333333286,0.837877419354826,0.9375,1,0.05533375254032383,0.07148489647311453,1.3189,1.6789,0.5163,0,-0.1281,0.004,ML,change,50,11.992269016284437,1.875026180117087,1.171836745873603,0.5669449847332243,1.5611,2.8182,0.2887,3.347,0.2776,0,-39.7305,0.008,ML,cueing,63,91.8904041791746,2.667251729989226,1.2874627339726263,0.32840234905861543,3.246620513453418,1.2761376666053574,0.32039875088307457,0.075,0.452,0.207,0.051,0.948,116.18112054471744,1993.5540216207457,0.077,0.455,0.217,0.015,1.033,127.18351194255264,1993.2853854307352,390,1.1555555555555557,1,0,1,2,FALSE,FALSE,FALSE
536,2021-11-13T10:35:00Z,2021-11-13T11:19:22Z,2662,1,2021-11-13T11:19:23Z,1,Chrome,95.0.4638.69,Windows NT 10.0,1360,768,I enjoyed it.,1.7708333333333333,644,36,225,55,37,66,-0.3730702120710542,-0.48879878116136594,-0.9749054276115718,-0.6042185221385653,-0.4826645703076583,-0.6651245862194046,3,3,1,1,3,1,1,3,1,3,3,1,1,1,3,3,1,1,3,3,1.025978352085154,0,0,4,5,5,1.5,0,4,4,1,4,1,1,4,1,1,1,1,4,1,4,4,1,1,1,1,1,1,1,1,2,2,0,0,4,4,4,4,4,4,4,4,4,1,4,4,1,4,4,4,1,1,4,1,1,4,1,1,1,1,1,1,1,1,1,4,1,1,1,1,1,1,1,1,1,1.5156837721956706,1.5491933384829668,1,0,1,0,1.4666666666666666,0,2,0,2,0,1,0,1,0,1,0,1.6216216216216217,0,1,0,0,-1.1006829047740254,-0.5341482934814965,-0.817415599127761,4,3,3,3,3,3,3,3,3,0.3779644730092272,2.857142857142857,0,3,0.9459301925190042,4,4,4,4,3,3,1,3,3,1,3,1.1126972805283737,3.857142857142857,0,2.142857142857143,6,3.8333333333333335,3.2559414990859232,0.9547190977297628,0,0.30226299054653183,1,1,1,1,1,1,4,1,1,1,1,4,1,4,4,1,4,1,4,1,1.52127765851133,1,0,4.6,0,3.8,0,4.6,0,4.333333333333333,0,1,1,1,3,1,1,1,3,1,1,1,3,3,1,1,3,1,1,1,1,0.8885233166386386,1.3,0,Black or African American,0,20,0,1,NA,1,3,7,Information technology,1,0,130,69,3,5,2,0,0,1,0,0,TRUE,TRUE,TRUE,TRUE,TRUE,5,0.6962414634147795,0.8367346938775511,0.021101112959049505,5,0.5854093749970197,0.6400387096760735,1,1,0.014892542167086967,0.010623521784911778,5,0.7050468749990687,0.8353875000029802,1,1,0.005777120635170682,0.009876189516448591,1.025,1.5866,0.4752,0,-11.0824,0.004,ML,change,49,33.84026089433188,1.721832887315184,0.9490645329539128,0.5106352078201408,2.9722,5.6709,0.378,4.8183,0.277,0,-60.2023,0.01,ML,cueing,63,132.8340041791746,3.578865409409145,1.157667096253152,0.4833563716721425,3.289048554197341,1.259675756718229,0.3998981444371248,0.117,0.501,0.584,0.006,1.172,48.49224065882266,1866.7788388232632,0.12,0.502,0.605,0.007,1.222,63.291781588537546,1847.3319903790375,376,1.114074074074074,1,0,1,2,FALSE,FALSE,FALSE
537,2021-11-13T11:03:58Z,2021-11-13T11:24:02Z,1204,1,2021-11-13T11:24:03Z,1,Chrome,95.0.4638.69,Windows NT 10.0,1366,768,no comment,1.7786458333333333,690,65,232,40,26,91,-0.2548793292631892,-0.22534137007908028,-0.9412057536716539,-0.7870146201492185,-0.6345972263129516,-0.2428404171980778,2,2,1,2,1,2,3,2,3,3,2,3,3,2,3,3,2,3,2,3,0.6708203932499369,0,0,4,3,2,2.55,0,1,3,3,4,4,2,2,4,4,3,2,4,3,4,3,4,3,4,2,3,2,3,4,1,2,0,0,3,4,3,3,4,2,4,3,4,2,4,3,4,3,4,4,3,2,3,4,3,4,2,4,3,4,4,3,2,4,3,2,3,4,2,3,2,1,1,1,1,0.775952383914182,0.9611501047232549,3.125,0,1,0,3.066666666666667,0,2.6666666666666665,0,2.9166666666666665,0,3,0,3.142857142857143,0,2.3333333333333335,0,2.918918918918919,0,1,0,0,1.0576422637451524,-0.5341482934814965,0.2617469851318279,3,2,4,4,3,4,3,3,2,0.7559289460184544,3,0,2.5,0.8469035402869574,5,5,5,5,3,3,1,6,6,3,3,1.5735915849388864,4.428571428571429,0,1.5714285714285714,3,3.8333333333333335,3.2559414990859232,-0.7395711320441822,0,-0.8635661140261877,3,4,3,2,3,2,4,3,4,3,2,3,4,2,4,3,3,5,3,2,0.9154754164341269,3,0,3,0,3,0,3,0,3,0,2,2,3,2,3,1,2,4,3,2,3,2,2,1,2,3,2,3,2,3,0.7451598203705946,2.25,0,"White, Caucasian, Anglo, European American",0,23,0,1,NA,1,4,6,welder,3,0,220,70,2,5,2,0,0,1,0,0,TRUE,TRUE,TRUE,TRUE,TRUE,3,0.6947552631277787,0.76,0.018808014132922643,3,0.41355000003178916,0.47814285714285715,0.967741935483871,0.875,0.001469401399802136,0.004983106412033918,3,0.5827870967926517,0.6116433332602182,0.96875,0.967741935483871,0.007350578300222254,0.005824233160141011,1.2252,1.0468,0.4033,0,8.7206,0.005,ML,change,50,-5.705130983715561,1.3214247081095403,0.8723005577725533,0.5231237326826379,0.9689,2.2012,0.309,5.3256,0.3271,0,-71.9954,0.011,ML,cueing,63,156.42020417917462,2.8209517528109527,0.689806249651842,0.38644425103884267,5.378602855246255,0.6323570401455928,0.35855804136987574,0.062,0.432,0.432,0.013,1.264,110.51002695569048,1990.2139526989922,0.062,0.432,0.447,0.015,1.298,139.92532208727386,2013.3748465263386,346,1.0251851851851852,1,0,0,1,FALSE,FALSE,FALSE
538,2021-11-13T11:02:35Z,2021-11-13T11:36:33Z,2038,1,2021-11-13T11:36:36Z,1,Firefox,94.0,Windows NT 10.0,1536,864,NA,1.7777777777777777,681,59,615,418,81,97,-0.27800363242124976,-0.2798497999581739,0.9026478347552838,3.819447049719245,0.12506605371351465,-0.14149221663295936,4,4,1,1,4,1,1,3,1,3,4,1,1,1,4,3,1,1,3,3,1.332784974957958,0,0,1,3,4,1.25,0,4,4,3,4,2,1,3,2,2,1,2,4,1,4,5,2,2,1,1,1,1,1,2,0,2,0,0,5,5,2,5,5,5,4,5,4,1,5,2,1,3,2,5,2,2,3,3,3,4,1,1,1,2,1,1,1,2,1,4,2,2,1,1,1,1,1,2,2,1.5673086666181797,1.3201731488169053,1.375,0,1.5,0,1.8666666666666667,0,1.5555555555555556,0,2,0,1.1666666666666667,0,1.4285714285714286,0,1,0,1.6216216216216217,0,0,0,0,-0.7676277496157452,-0.5804383618435307,-0.6740330557296379,3,2,2,2,2,2,2,3,1,0.3779644730092272,2.4285714285714284,0,2,0.32054096227918905,5,5,5,5,1,1,2,7,4,4,3,1.9880595947760098,3.7142857142857144,0,2.2857142857142856,3.5,3.8333333333333335,3.2559414990859232,-0.4571894270818581,0,-0.3240202744378419,2,2,2,1,2,1,4,2,1,3,1,5,3,3,3,3,4,2,3,5,1.3020130933435712,1.8,0,4.6,0,3.2,0,3.2,0,3.6666666666666665,0,1,2,1,4,1,1,1,4,1,1,1,4,1,2,1,2,1,1,1,1,1.0954451150103321,1.2,0,Black or African American,0,22,0,1,NA,1,3,4,Cybersecurity Analyst,4,0,115,69,1,5,2,1,0,1,0,1,TRUE,TRUE,TRUE,TRUE,TRUE,1,1.0398863636363636,0.88,0.19203139142857142,1,0.382125,0.4494,1,0.9375,0.004019983870967742,0.004958064516129033,1,0.5505,0.6360645161290323,1,1,0.005283032258064516,0.0026567956989247306,1.759,1.1761,0.5041,0,31.1536,0.003,ML,change,50,-50.57113098371556,1.1517514865815106,1.7299132563778115,0.4691321296872626,1.0787,3.7356,0.3192,4.2062,0.2539,0,-78.4302,0.019,ML,cueing,64,169.33704925007902,3.512927068120338,0.7708814184267158,0.3533944143383124,4.563062493610366,0.907972383063599,0.28574255429335466,0.258,0.275,0.956,0.01,1.217,29.34792185824721,1828.9567682509364,0.258,0.278,0.956,0.01,1.255,41.266080857940125,1827.0908255152017,385,1.1407407407407408,1,0,0,1,FALSE,FALSE,FALSE
539,2021-11-13T11:04:56Z,2021-11-13T11:40:37Z,2141,1,2021-11-13T11:40:38Z,1,Chrome,95.0.4638.69,Windows NT 10.0,1536,864,Great study. Really made me think over my childhood and just how.....interesting it was.,1.7777777777777777,778,63,862,193,40,100,-0.028775031717708392,-0.24351084670544482,2.091764900920959,1.0775055795594453,-0.4412283913971238,-0.09081811635040013,4,3,1,1,4,1,1,3,1,3,3,1,1,1,4,3,1,1,3,3,1.2258187382102494,0,1,1,5,5,1.35,0,2,4,1,4,1,1,1,3,2,1,2,3,2,3,4,1,3,1,4,1,2,1,1,6,3,4,5,5,1,1,2,1,3,2,2,1,2,5,3,1,1,1,2,1,1,1,3,3,1,3,2,1,4,3,1,3,3,3,5,1,1,1,1,1,2,2,2,2,1.2681120250624975,1.162919151265879,1.75,0,2,0,2.2666666666666666,0,4,0,2.1666666666666665,0,2.8333333333333335,0,1.7142857142857142,0,1,0,2.5945945945945947,0,3,4,5,-0.016438833840269056,1.8944225298484991,0.9389918480041151,1,5,2,5,5,5,5,5,3,1.7320508075688772,4.857142857142857,0,4,2.5114584594654064,3,5,3,5,2,3,3,4,6,1,2,1.1338934190276817,3.4285714285714284,0,2.5714285714285716,4,3.8333333333333335,3.2559414990859232,-0.1748077221195339,0,-0.023487427113806164,2,2,2,1,1,2,4,2,3,1,1,3,1,3,3,1,3,1,3,2,1.01418510567422,1.6,0,4,0,3.6,0,3.4,0,3.6666666666666665,0,1,1,1,4,1,1,1,4,1,1,1,4,1,1,1,4,1,1,1,1,1.231174022502185,1,0,Black or African American,0,30,0,1,NA,1,2,6,self employed,2,0,134,66,1,5,2,0,0,1,0,0,TRUE,TRUE,TRUE,TRUE,TRUE,5,0.8794022727273405,0.88,0.06056987561141217,5,0.4630366666699449,0.5250843750010245,0.9375,1,0.005294561250218902,0.0089502478127288735,5,0.5763281250004657,0.6392531250012107,1,1,0.014669730473774567,0.010128626441645854,1.5467,1.4243,0.4784,0,13.9296,0.004,ML,change,50,-16.123130983715562,1.5368718934297116,1.2964191571256225,0.5588555298180446,1.3961,3.1002,0.2999,3.6228,0.2871,0,-51.9343,0.009,ML,cueing,64,116.34524925007901,3.735542908567197,1.1091118018988761,0.3812696626033488,3.45572904105577,0.7836407799712403,0.3638266773553097,0.158,0.27,0.496,0.026,1.306,93.89110383490868,1893.2361120081787,0.149,0.271,0.492,0.016,1.409,95.67497841244699,1883.1773664632622,388,1.1496296296296296,1,0,0,1,FALSE,FALSE,FALSE
540,2021-11-13T11:37:47Z,2021-11-13T11:56:56Z,1149,1,2021-11-13T11:56:59Z,1,Edge,95.0.1020.44,Windows NT 10.0,1920,1080,NA,1.7777777777777777,598,38,300,76,43,59,-0.49126109487891917,-0.4706293045350014,-0.6138374925410226,-0.3483039849236506,-0.39979221248658925,-0.7833641535453761,3,4,1,1,3,2,2,3,1,4,3,1,1,1,3,3,1,1,3,3,1.105012502906165,0,0,2,4,4,1.5,0,3,4,1,4,1,1,4,1,1,2,1,4,1,3,4,1,2,1,1,1,1,1,1,0,2,0,0,4,3,5,5,4,5,4,4,5,1,4,1,1,4,1,4,1,1,1,2,2,5,1,1,1,3,3,1,1,1,1,4,1,1,1,1,1,2,1,1,1,1.6065743310164897,1.3972762620115438,1.125,0,1.25,0,1.6666666666666667,0,1.6666666666666667,0,1.4166666666666667,0,1.5,0,1,0,1,0,1.4324324324324325,0,0,0,0,-1.0423184006878752,-0.6588395645607719,-0.8505789826243235,4,1,4,1,1,1,3,1,1,1.4638501094227998,1.5714285714285714,0,1,-0.5612498234260587,4,4,5,5,3,3,4,6,5,2,3,0.816496580927726,3.7142857142857144,0,2.2857142857142856,3.5,3.8333333333333335,3.2559414990859232,-0.4571894270818581,0,-0.3240202744378419,2,3,2,1,2,1,4,2,1,4,1,4,1,4,2,1,4,2,3,1,1.3451854182690985,2,0,4.4,0,4.2,0,4,0,4.2,0,2,1,2,3,1,3,1,2,1,1,1,2,3,2,1,3,1,2,1,1,0.8013147091860318,1.7,0,"White, Caucasian, Anglo, European American",0,29,0,1,NA,1,3,6,Chemistry Technician,4,0,230,67,3,5,2,0,0,1,0,0,TRUE,TRUE,TRUE,TRUE,TRUE,5,0.8440447368621826,0.76,0.03579383764840281,5,0.43527499997615815,0.530375,1,1,0.0025598561352040694,0.005917362573828543,5,0.6560062499940396,0.7028419355115583,1,0.96875,0.012318906404774649,0.0055682243519408455,1.3799,0.9334,0.4533,0,20.3214,0.006,ML,change,50,-28.906730983715562,1.1250610581258067,1.0245484026072214,0.6072730676679494,2.1915,5.3767,0.3266,8.088,0.2998,0,-93.5925,0.006,ML,cueing,64,199.66164925007902,4.142671048416517,1.0001119272975325,0.41343855751564945,5.108090755075357,0.8110926224783591,0.3583630953427881,0.092,0.409,0.38,0.016,1.572,195.42023988685762,2041.0089144337417,0.082,0.436,0.39,0.015,1.636,210.8381783484763,2039.5050762270346,297,0.88,1,0,0,1,FALSE,FALSE,FALSE
541,2021-11-13T11:35:07Z,2021-11-13T11:57:59Z,1372,1,2021-11-13T11:58:00Z,1,Chrome,95.0.4638.69,Windows NT 10.0,1280,800,NA,1.6,702,70,352,75,61,78,-0.22404692505244184,-0.17991767851316898,-0.36349705755877526,-0.3604903914576942,-0.15117513902338214,-0.4624281850891678,3,3,2,1,2,1,1,2,1,2,3,1,1,1,2,2,1,1,3,2,0.7863975156570492,0,0,2,4,4,1.85,0,1,3,2,4,1,1,4,2,1,3,3,3,1,3,2,1,3,1,1,2,3,2,2,0,3,0,3,3,1,3,3,2,3,1,1,2,1,4,1,1,4,3,5,2,3,4,4,4,1,4,2,1,1,1,1,1,1,1,5,1,1,1,2,1,2,4,1,1,1.3439889531935545,1.0997835284835873,1.875,0,2,0,2.4,0,3.888888888888889,0,2.3333333333333335,0,2.1666666666666665,0,0.8571428571428571,0,1.3333333333333333,0,2.3783783783783785,0,0,0,3,0.0016609377420030566,0.10571298428849377,0.05368696101524841,4,2,2,1,1,2,2,3,1,1,2,0,2,0.06413940681375631,3,3,3,3,3,3,2,1,1,NA,2,0.3779644730092272,3.142857142857143,0,2.857142857142857,8,3.8333333333333335,3.2559414990859232,2.0842459175790595,0,1.265381387578364,3,3,3,5,4,3,5,2,1,5,1,5,5,3,3,3,3,2,3,3,1.3557637102737474,3.6,0,4,0,3.4,0,3.6,0,3.6666666666666665,0,1,4,2,1,1,2,1,2,1,1,1,2,2,3,1,3,2,2,3,2,0.8750939799154206,2.05,0,"Hispanic of Latino (e.g., Mexican American, Central American, and others)",0,23,0,1,NA,1,3,6,Teacher,7,0,158,67,2,5,2,0,0,1,0,0,TRUE,TRUE,TRUE,TRUE,TRUE,3,0.8901621621613567,0.74,0.14720522950538478,3,0.43219999999646097,0.509875,1,1,0.002145769677564675,0.0054525929032289595,3,0.6063967741929716,0.6382718750024214,0.96875,1,0.012489445766731362,0.009962725957679275,1.4986,0.697,0.4638,0,38.9214,0.004,ML,change,50,-66.10673098371556,0.7244069423388513,1.4438963710171369,0.41179136145467826,2.5923,5.9024,0.2903,8.5983,0.2815,0,-94.2993,0.01,ML,cueing,64,201.07524925007903,4.228260401150619,0.9798674474410513,0.39762474816472937,5.338468916866967,0.7760904467011582,0.3617830291430478,0.069,0.419,0.343,0.06,1.509,68.53157076059122,1912.2496026430897,0.068,0.419,0.342,0.07,1.619,93.80904863186746,1920.5585040263527,395,1.1703703703703703,1,0,0,1,FALSE,FALSE,FALSE
542,2021-11-13T11:43:29Z,2021-11-13T12:08:56Z,1526,1,2021-11-13T12:08:57Z,0.8999999761581421,Edge,95.0.1020.53,Macintosh,1440,900,NA,1.6,886,51,336,53,55,70,0.24871660617901806,-0.35252770646363196,-0.44052488370715903,-0.6285913352066523,-0.2340474968444512,-0.5975591191759924,3,3,2,2,3,1,1,3,1,3,3,1,1,1,4,4,1,1,4,4,1.2182817926554552,0,0,1,3,3,1.4,0,4,4,2,4,2,1,4,2,1,1,1,5,2,4,4,1,1,1,1,1,1,1,1,4,2,0,0,4,4,4,4,4,4,4,4,4,1,5,1,1,4,2,4,2,3,1,2,2,5,1,1,1,3,2,1,2,2,1,5,1,2,1,1,1,2,1,2,2,1.4451950001949871,1.4375905768565218,1,0,1.75,0,1.6666666666666667,0,2,0,1.6666666666666667,0,1.3333333333333333,0,1.2857142857142858,0,1,0,1.6216216216216217,0,2,0,0,-1.0147331873138241,-0.0958522115332568,-0.5552926994235404,4,2,3,1,1,2,1,3,1,1.1547005383792515,1.7142857142857142,0,2,-0.10679496349653231,5,5,5,5,3,3,2,6,6,3,2,1.2909944487358056,4.285714285714286,0,1.7142857142857142,3,3.8333333333333335,3.2559414990859232,-0.7395711320441822,0,-0.783895116604751,3,3,3,3,3,3,3,3,2,4,2,3,3,3,3,2,3,3,3,3,0.5163977794943222,3,0,3.2,0,3.4,0,3.2,0,3.2666666666666666,0,1,1,1,2,1,1,1,3,1,1,2,3,2,1,1,3,1,2,1,2,0.7591546545162482,1.45,0,"Asian or Asian American (e.g., Chinese, Japanese, and others)",0,28,0,1,NA,1,3,6,Engineering Specialist,5,0,149,65,4,5,2,0,0,0,0,0,TRUE,TRUE,TRUE,TRUE,TRUE,4,1.0602454545457254,0.88,0.2848381536159569,4,0.4614483870960051,0.5481312499996275,1,1,0.004376727246985211,0.005405173830341796,4,0.6409709677441466,0.7346533333331347,1,0.9375,0.027072118129495344,0.0165335573284663,1.8,1.1091,0.4076,0,36.0239,0.004,ML,change,50,-60.311730983715556,1.0436438018147123,1.9091093735484483,0.36512173447287977,1.9987,4.9968,0.3481,7.3163,0.3249,0,-87.6542,0.007,ML,cueing,63,187.7378041791746,4.237503578910522,0.9777300831110443,0.4363701623243521,4.467094332934561,0.9274786735183606,0.3608802215273294,0.085,0.42,0.361,0.007,1.231,113.15384595265225,1990.8739119433308,0.085,0.42,0.44,0.006,1.288,96.86988110945414,1939.9565810553156,412,1.2207407407407407,1,0,1,2,FALSE,FALSE,FALSE
543,2021-11-13T11:51:58Z,2021-11-13T12:12:50Z,1251,1,2021-11-13T12:12:51Z,1,Chrome,95.0.4638.69,Windows NT 10.0,1366,768,NA,1.7786458333333333,701,40,255,68,37,88,-0.2266162920700041,-0.45245982790863687,-0.8304782535833521,-0.44579523719599906,-0.4826645703076583,-0.293514517480637,4,4,1,1,3,1,1,3,1,4,3,1,1,1,3,3,1,1,3,3,1.2258187382102494,0,0,2,3,4,1.35,0,4,5,2,5,2,1,5,1,1,1,1,5,2,5,5,1,1,1,1,1,1,1,1,1,2,0,0,5,5,5,5,5,5,5,5,5,2,5,1,1,5,1,5,1,1,1,1,1,5,1,1,1,1,1,1,2,2,2,5,1,1,1,2,1,1,1,2,2,1.88880056320607,1.8516401995451028,1,0,1.5,0,1.2666666666666666,0,1,0,1.0833333333333333,0,0.8333333333333334,0,1.2857142857142858,0,1.3333333333333333,0,1.135135135135135,0,1,0,0,-1.3956995025428247,-0.3773458880470143,-0.8865226952949194,5,1,5,1,1,1,1,1,1,1.9518001458970664,1,0,1,-0.9031185640466358,5,5,5,5,5,4,1,6,7,6,5,1.4960264830861913,4.857142857142857,0,1.1428571428571428,2.5,3.8333333333333335,3.2559414990859232,-1.0219528370065065,0,-1.2437699587716602,2,3,2,1,2,2,4,1,1,2,3,4,1,4,4,1,4,1,5,2,1.4540583599999397,2,0,4,0,4.2,0,4.4,0,4.2,0,1,1,1,4,2,1,1,4,1,1,2,4,1,1,1,4,1,1,1,1,1.2182817926554552,1.1,0,"White, Caucasian, Anglo, European American",0,28,0,1,NA,1,5,6,Senior Finance Manager,6,0,180,76,3,5,2,0,0,1,0,0,TRUE,TRUE,TRUE,TRUE,TRUE,2,1.4079619047611598,0.875,0.337430857123051,2,0.5520000000004657,0.6295299999992052,1,0.967741935483871,0.003359498709608788,0.005821607569914303,2,0.675268750000745,0.6953870967739532,1,1,0.005533164153221068,0.004019208494626728,2.1515,0.9246,0.6033,0,51.4452,0.003,ML,change,48,-91.27679696727633,0.9833870842533269,1.978783512834946,0.6533823203887159,1.981,3.713,0.3736,5.8782,0.3835,0,-65.8333,0.007,ML,cueing,63,144.0960041791746,3.8123596007888443,0.8921502003531852,0.5200712644252641,4.772477336644313,0.8681308331376401,0.46389044124524015,0.226,0.408,0.835,0.059,0.912,79.29445318637033,1882.8049176169661,0.224,0.41,0.835,0.048,0.988,108.04473998976887,1893.8823149525356,364,1.0785185185185184,1,0,0,1,FALSE,FALSE,FALSE
544,2021-11-13T11:51:07Z,2021-11-13T12:18:32Z,1644,1,2021-11-13T12:18:33Z,1,Chrome,95.0.4638.69,Windows NT 10.0,1920,1080,very proactive,1.7777777777777777,714,133,399,87,63,107,-0.19321452084169444,0.3924208352173136,-0.13722781824789776,-0.21425351304917153,-0.12355101974969247,0.02742145097557139,2,2,1,3,2,2,4,1,2,3,2,3,1,2,2,3,3,2,3,2,0.7863975156570492,0,1,1,3,4,2.55,0,2,3,4,2,3,3,2,4,2,2,3,2,1,2,2,3,4,1,1,3,4,3,3,1,2,0,0,3,3,4,3,3,4,3,2,2,2,2,3,3,2,2,3,3,3,2,2,3,3,1,1,1,3,2,1,1,1,1,3,1,2,1,3,2,1,2,1,1,0.9021162972775815,0.8338093878327919,2.75,0,1.25,0,3.2666666666666666,0,3,0,2.8333333333333335,0,1.6666666666666667,0,1.2857142857142858,0,2,0,2.3783783783783785,0,1,0,0,0.750139727291256,-0.4557470907642554,0.1471963182635003,3,2,2,3,2,4,3,2,2,0.7559289460184544,3,0,2,0.6624097028997663,5,5,5,5,3,3,4,3,1,NA,2,0.9511897312113419,4,0,2,7,3.8333333333333335,3.2559414990859232,1.5194825076544112,0,0.5049736980874192,4,4,3,4,4,3,4,3,2,3,1,4,4,3,3,2,4,4,3,4,0.9154754164341269,3.8,0,3.6,0,3.2,0,3,0,3.2666666666666666,0,2,2,3,2,2,3,3,3,4,3,2,2,2,1,2,2,3,2,2,3,0.6805570473787206,2.5,0,"Asian or Asian American (e.g., Chinese, Japanese, and others)",0,28,0,1,NA,1,2,4,investor,7,0,120,60,2,5,2,0,0,1,0,0,TRUE,TRUE,TRUE,TRUE,TRUE,2,1.0237947368420857,0.76,0.102978205881785,2,0.6684468750006054,0.6790645161285516,1,1,0.015218304506107078,0.008935555032250832,2,0.7168312499995809,0.7941875000001164,1,1,0.021000371250078725,0.014908065000044194,1.419,0.822,0.5847,0,30.4172,0.004,ML,change,50,-49.09833098371556,0.8638569434689767,1.3343407362214266,0.6221905198007602,2.785,5.9736,0.446,4.5038,0.3593,0,-61.8271,0.009,ML,cueing,63,136.08360417917459,3.737077555853996,1.108656340273555,0.535367895763046,3.2713041675584056,1.2665085587207359,0.4809176659426086,0.239,0.331,0.641,0.011,1.26,44.7344630007845,1838.0984423787029,0.236,0.328,0.634,0.011,1.316,56.453976876077675,1839.4650577569373,512,1.517037037037037,1,0,5,6,FALSE,FALSE,FALSE
545,2021-11-13T11:52:32Z,2021-11-13T12:20:57Z,1705,1,2021-11-13T12:20:58Z,1,Chrome,95.0.4638.69,Windows NT 10.0,1920,1080,NA,1.7777777777777777,682,82,518,87,72,152,-0.2754342654036875,-0.07090081875498182,0.4356666387307069,-0.21425351304917153,7.57516981911087e-4,0.7875329552139597,3,3,2,2,3,1,2,2,1,3,2,2,1,1,3,2,2,1,2,2,0.7254762501100116,0,1,1,3,2,2,0,4,4,2,4,3,1,5,2,2,1,2,4,2,3,3,1,2,1,1,1,2,2,1,0,2,0,0,5,5,2,4,3,4,3,4,3,1,4,2,1,3,2,3,3,3,2,3,3,4,1,1,1,2,1,1,1,1,1,4,1,2,1,1,1,1,1,1,1,1.2956383286545203,1.2071217242444348,1.375,0,1,0,2,0,2.3333333333333335,0,2.3333333333333335,0,1.1666666666666667,0,1.1428571428571428,0,1,0,1.864864864864865,0,0,0,0,-0.6057944978213119,-0.7372407672780129,-0.6715176325496623,5,1,3,1,1,2,1,2,2,1.5275252316519468,1.4285714285714286,0,2,-0.2777293338068208,5,5,5,5,3,3,1,6,7,NA,3,1.5735915849388864,4.428571428571429,0,1.5714285714285714,2.5,3.8333333333333335,3.2559414990859232,-1.0219528370065065,0,-1.00475696650735,2,2,2,2,3,2,4,2,2,2,3,4,2,4,4,2,3,2,3,3,0.8618916073713346,2.2,0,3.6,0,3.4,0,3.8,0,3.6,0,1,1,2,3,2,2,1,2,1,1,2,2,2,2,1,2,1,2,2,2,0.5712405705774795,1.8,0,"White, Caucasian, Anglo, European American",0,19,0,1,NA,0,3,3,student,7,0,158,70,2,5,2,0,0,1,0,0,TRUE,TRUE,TRUE,TRUE,TRUE,4,0.8587318181829019,0.88,0.02931388336732563,4,0.48665483870813925,0.5813199999978145,1,0.9375,0.003279467892545811,0.0044111038305952735,4,0.5402312500015832,0.6458357142859271,1,0.9032258064516129,0.004094620927437499,0.007000309999802904,1.2401,1.6698,0.5892,0,-3.6348,0.004,ML,change,50,19.005669016284436,1.8426103223891281,1.081308478781787,0.6357344665755854,0.9556,3.0759,0.4394,5.2719,0.396,0,-83.3664,0.009,ML,cueing,63,179.16220417917458,3.61709867700752,0.7486802111084845,0.49076466225100274,4.097961591419441,0.8379744728880416,0.3908021750353662,0.077,0.382,0.52,0.014,1.905,161.43078919186513,2028.4302364487887,0.078,0.38,0.524,0.014,2.005,194.90008494300352,2055.381993779781,314,0.9303703703703704,1,0,1,2,FALSE,FALSE,FALSE
546,2021-11-13T12:12:12Z,2021-11-13T12:34:01Z,1308,1,2021-11-13T12:34:02Z,1,Chrome,95.0.4638.69,Windows NT 10.0,1536,864,none,1.7777777777777777,680,49,287,94,61,62,-0.28057299943881203,-0.3706971830899965,-0.6764226012865845,-0.12894866731086665,-0.15117513902338214,-0.732690053262817,2,2,3,3,2,3,3,2,2,1,2,3,2,2,1,1,2,2,1,1,0.7254762501100116,0,1,2,2,2,3,0,4,4,3,4,2,3,3,2,3,4,2,3,2,2,2,2,2,1,1,1,1,2,2,2,2,0,0,2,3,3,3,2,4,5,5,3,2,4,3,1,3,2,4,2,2,2,4,3,4,2,1,1,1,1,1,2,1,1,2,3,3,1,1,2,1,2,2,2,1.1892915598853018,0.8338093878327919,1.5,0,1.75,0,2.7333333333333334,0,2.6666666666666665,0,2.3333333333333335,0,1.1666666666666667,0,2,0,1.3333333333333333,0,2.135135135135135,0,1,0,0,-0.12077869354983783,-0.2989446853297732,-0.20986168943980552,4,2,3,1,1,3,2,1,1,1.1126972805283737,2,0,1,-0.3048482679606258,4,4,4,4,2,2,2,7,6,6,3,1.0690449676496976,3.4285714285714284,0,2.5714285714285716,2.5,3.8333333333333335,3.2559414990859232,-1.0219528370065065,0,-0.4470599845572925,2,2,2,3,3,2,4,2,1,2,2,3,3,2,3,4,5,4,3,3,1.0600988273786194,2.4,0,3.6,0,2.8,0,3.4,0,3.2666666666666666,0,2,4,4,3,4,3,4,2,2,1,3,2,3,3,2,2,1,3,3,3,0.9233805168766387,2.8,0,"Asian or Asian American (e.g., Chinese, Japanese, and others) & Filipino",1,19,0,2,NA,1,3,4,Student,6,0,185,67,2,5,2,0,0,1,0,0,TRUE,TRUE,TRUE,TRUE,TRUE,5,0.7958432432435252,0.7551020408163265,0.05624046252540531,5,0.4797874999997439,0.49769375000032595,1,1,0.007745146290288202,0.003276753508044278,5,0.5913548387096774,0.6956812499999069,1,1,0.012920134559127829,0.024543887378926047,1.237,0.9438,0.4874,0,14.9532,0.004,ML,change,49,-18.23093910566812,0.9842666305095399,1.144010401199221,0.4993388418803042,3.1351,8.4554,0.3123,5.6677,0.2032,0,-84.8148,0.01,ML,cueing,64,182.10624925007903,4.802325036107226,0.8627351741584667,0.41067603528067687,3.873067697314059,1.0697294884013422,0.34600460193583116,0.266,0.189,0.669,0.013,1.407,9.834724796525219,1795.9589240168154,0.266,0.188,0.669,0.013,1.402,12.777135929576682,1794.4080555352596,384,1.1377777777777778,1,0,0,1,FALSE,FALSE,FALSE
547,2021-11-13T12:18:35Z,2021-11-13T12:40:03Z,1288,1,2021-11-13T12:40:04Z,0.8999999761581421,Safari,14.0.2,Macintosh,1440,900,No.,1.6,646,146,243,90,26,74,-0.3679314780359296,0.510522433288683,-0.88824912319464,-0.17769429344704088,-0.6345972263129516,-0.5299936521325801,3,4,1,1,3,1,1,4,1,4,3,1,1,1,4,4,1,1,3,3,1.332784974957958,0,0,3,4,4,1.25,0,5,5,1,5,1,1,5,1,1,1,1,5,2,5,5,1,1,1,1,1,1,1,1,0,2,0,0,5,5,5,5,5,5,5,5,5,1,5,1,1,5,1,5,1,1,1,1,1,5,1,1,1,3,1,1,1,2,1,5,1,1,1,1,1,1,1,1,1,1.935910056729844,2.016597794967223,1,0,1,0,1.0666666666666667,0,1,0,1,0,1.1666666666666667,0,1,0,1,0,1.0810810810810811,0,0,0,0,-1.5048788733706477,-0.7372407672780129,-1.1210598203243303,5,1,4,1,1,1,1,2,1,1.7320508075688772,1.1428571428571428,0,1.5,-0.6331575415043005,5,5,5,5,3,3,1,6,4,5,3,1.5735915849388864,4.428571428571429,0,1.5714285714285714,4,3.8333333333333335,3.2559414990859232,-0.1748077221195339,0,-0.5811844090638635,1,1,1,1,1,1,4,1,1,4,1,5,1,5,4,1,5,3,5,3,1.7511900715418263,1,0,4.6,0,4.6,0,4.4,0,4.533333333333333,0,1,1,1,1,1,1,1,4,1,1,1,3,1,1,1,4,1,2,2,1,1,1.3,0,"White, Caucasian, Anglo, European American",0,26,0,1,NA,1,3,8,Physical Therapist,5,0,181,72,3,5,2,0,0,1,0,0,TRUE,TRUE,TRUE,TRUE,TRUE,3,0.853222222222219,0.72,0.05047873632653007,3,0.673656249999991,0.6919677419354802,1,0.96875,0.11250365221773906,0.04634904737903334,3,0.6349999999999977,0.7778750000000013,1,1,0.008516451612903424,0.025245016129032394,1.2901,0.7454,0.4761,0,24.3673,0.005,ML,change,50,-36.99853098371556,0.8626392072269059,1.0948512436351887,0.5740008842841388,1.6511,2.2039,0.3326,1.9669,0.2539,0,-3.7563,0.009,ML,cueing,64,19.989249250079013,2.280082775194647,1.5060800607083191,0.3823408125373768,1.9839048496520704,2.088373707599001,0.16377493447436542,0.121,0.352,0.413,0.009,1.37,15.438453486610179,1813.4811724249942,0.124,0.355,0.436,0.009,1.394,30.978566361678094,1813.6774810466907,370,1.0962962962962963,1,0,0,1,FALSE,FALSE,FALSE
548,2021-11-13T12:25:19Z,2021-11-13T12:47:50Z,1351,1,2021-11-13T12:47:52Z,1,Chrome,95.0.4638.69,Windows NT 10.0,1536,864,NA,1.7777777777777777,552,61,447,74,78,81,-0.6094519776867842,-0.26168032333180935,0.09385566019725369,-0.37267679799173775,0.08362987480298012,-0.4117540848066085,1,3,2,2,1,2,2,2,1,1,1,1,2,1,1,1,1,1,1,1,0.5982430416161189,0,0,4,4,3,2.6,0,2,5,4,4,3,1,2,4,4,3,4,2,2,2,4,2,4,1,1,3,4,4,3,3,2,0,2,4,4,2,3,2,3,3,4,2,2,4,3,1,3,3,2,5,5,3,4,4,2,4,1,1,2,1,1,4,4,1,4,1,1,1,1,4,2,2,1,1,1.313478292635712,1.162919151265879,2.75,0,1.5,0,3.066666666666667,0,3,0,3.25,0,2,0,1.8571428571428572,0,2,0,2.675675675675676,0,2,0,2,0.7919531033529758,0.1786458795478636,0.4852994914504197,5,1,5,2,1,1,1,8,5,1.889822365046136,1.1428571428571428,0,6.5,1.2117808323676102,5,5,5,5,2,2,1,7,7,6,4,1.8126539343499315,4.142857142857143,0,1.8571428571428572,2,3.8333333333333335,3.2559414990859232,-1.3043345419688306,0,-0.9866058241456384,3,3,3,3,3,3,5,4,3,3,1,3,2,2,2,1,4,1,5,1,1.3972762620115438,3,0,4,0,4.4,0,2.8,0,3.7333333333333334,0,1,1,3,2,2,3,3,2,3,3,3,1,1,4,1,1,1,4,3,1,1.0894228312566052,2.55,0,"Asian or Asian American (e.g., Chinese, Japanese, and others)",0,22,0,1,NA,0,4,4,Student/Freelance Worker,6,0,178,71,2,5,2,0,0,0,0,0,TRUE,TRUE,TRUE,TRUE,TRUE,1,0.5347031250009313,0.64,0.017482915203942465,1,0.3884238095219646,0.45026666666788084,0.8076923076923077,0.84375,0.005704336246295274,0.005045020715512337,1,0.5294774193576267,0.5708318181823601,0.96875,0.6875,0.008620769677208033,0.007715100876867076,1.0957,0.5504,0.257,0,11.3678,0.004,ML,change,50,-10.999530983715564,0.7033452454076544,0.818039431787279,0.37187338925168234,0.84,1.9887,0.2979,1.9559,0.2429,0,-39.5658,0.009,ML,cueing,58,91.31292903163927,2.5240543348729236,0.6681310026771403,0.35927415949515784,2.1490702986271337,0.6677699311214164,0.2928161082543334,0.051,0.355,0.257,0.005,1.088,188.63092047715193,2272.2700562590703,0.052,0.356,0.27,0.003,1.106,216.5160466731941,2282.073814692644,378,1.12,1,0,0,1,FALSE,FALSE,FALSE
549,2021-11-13T12:30:30Z,2021-11-13T12:49:37Z,1147,1,2021-11-13T12:49:39Z,1,Chrome,95.0.4638.69,Windows NT 10.0,2560,1080,NA,2.3703703703703702,625,40,272,25,31,61,-0.42188818540473755,-0.45245982790863687,-0.7486361883006943,-0.9698107181598719,-0.5655369281287274,-0.74958142002367,4,3,1,2,3,1,1,3,2,3,4,2,1,2,3,3,1,2,3,3,0.9880869341680844,0,1,1,4,4,1.65,0,4,3,2,3,4,2,4,2,2,1,1,5,1,4,4,1,2,3,1,1,1,1,1,1,2,0,1,5,5,5,5,4,4,5,4,4,3,4,2,2,4,4,2,2,3,4,2,3,2,4,1,1,2,1,1,2,1,1,4,3,1,1,1,1,1,1,1,1,1.4555475322429765,1.3201731488169053,1.375,0,1,0,2,0,1.4444444444444444,0,2.75,0,2,0,1.4285714285714286,0,1,0,1.972972972972973,0,1,0,1,-0.5593351910860681,-0.35769864658231576,-0.45851691883419193,5,1,3,1,1,2,1,1,1,1.5275252316519468,1.4285714285714286,0,1,-0.6467170085812028,5,5,5,5,2,2,1,7,7,4,4,1.8126539343499315,4.142857142857143,0,1.8571428571428572,2,3.8333333333333335,3.2559414990859232,-1.3043345419688306,0,-0.9866058241456384,2,2,2,1,3,2,3,3,4,2,3,3,4,2,4,3,3,2,4,4,0.7988086367179802,2,0,3.4,0,2.8,0,2.6,0,2.933333333333333,0,2,2,3,2,2,1,3,3,1,2,2,3,2,1,2,3,1,1,1,1,0.7880689256524124,1.8,0,"White, Caucasian, Anglo, European American",0,27,0,1,NA,1,4,7,Architect,3,0,175,70,3,5,2,0,0,1,0,0,TRUE,TRUE,TRUE,TRUE,TRUE,NA,NA,NA,NA,1,0.426227586203608,0.4650607142874173,0.90625,0.9032258064516129,0.007057502732157948,0.008650555161548263,1,0.5261580645192054,0.6384379310320164,1,0.90625,0.0064960525166728135,0.014459484827592706,NA,NA,NA,NA,NA,NA,NA,NA,NA,NA,0.8464517782847745,1.3302721923958158,0.384901291323673,0.9759,2.597,0.3043,2.5599,0.2686,0,-48.8197,0.007,ML,cueing,63,110.06880417917459,2.7070764246448773,0.8250938913924838,0.3421609148114279,2.878262837450393,0.7882127760534883,0.3149759534113167,0.058,0.376,0.391,0.009,1.274,149.3199802773183,2058.3287531822716,0.059,0.372,0.423,0.007,1.374,177.99582159183205,2038.8830198411047,104,0.3081481481481481,1,0,4,5,FALSE,TRUE,FALSE
550,2021-11-13T12:42:45Z,2021-11-13T13:05:18Z,1352,1,2021-11-13T13:05:18Z,1,Chrome,95.0.4638.69,Windows NT 10.0,1920,1080,NA,1.7777777777777777,657,46,388,93,58,65,-0.3396684408427445,-0.39795139802954327,-0.19018444872491164,-0.14113507384491022,-0.19261131793391667,-0.6820159529802577,4,1,1,1,4,1,1,1,1,4,2,1,1,1,4,1,1,1,1,2,1.2182817926554552,0,1,2,3,1,1.8,0,5,5,1,5,1,1,5,1,1,2,1,5,1,5,1,1,1,1,1,1,1,1,1,4,1,1,1,1,3,2,3,1,5,1,5,3,1,5,2,1,3,1,5,1,1,2,2,2,3,1,1,1,3,1,1,3,3,3,5,1,1,1,1,1,1,1,2,2,1.404625563263382,1.9880595947760098,1,0,1.5,0,1.3333333333333333,0,3.3333333333333335,0,1.5,0,1.5,0,1.7142857142857142,0,1,0,2,0,2,1,1,-0.9953751428408057,0.20882944024170652,-0.3932728512995496,5,1,3,1,1,3,1,1,1,1.5735915849388864,1.5714285714285714,0,1,-0.5612498234260587,5,5,5,5,4,4,1,6,4,2,3,1.4638501094227998,4.714285714285714,0,1.2857142857142858,4,3.8333333333333335,3.2559414990859232,-0.1748077221195339,0,-0.740526403906737,3,2,3,2,3,3,3,3,3,2,5,1,3,3,3,5,3,5,2,3,1.1254628677422756,2.6,0,1.8,0,2.2,0,3,0,2.3333333333333335,0,1,1,3,1,4,4,4,1,2,1,2,1,1,2,1,2,1,4,1,4,1.2763022245616642,2.55,0,Black or African American,0,23,0,1,NA,1,1,4,Student,1,0,215,75,1,5,2,0,0,1,0,0,TRUE,TRUE,TRUE,TRUE,TRUE,NA,NA,NA,NA,6,0.45246875,0.4718206896553266,1,0.9354838709677419,0.0026143989920432526,0.002882104322530447,6,0.596581250000745,0.6666187499999069,1,1,0.003449082217791571,0.0033481725403485124,NA,NA,NA,NA,NA,NA,NA,NA,NA,NA,NA,NA,NA,0.9986,3.883,0.3554,4.9667,0.3519,0,-89.2917,0.009,ML,cueing,63,191.01280417917462,3.9933906939742263,0.6696436322801195,0.3987952775426875,5.081237885485887,0.8153790119187365,0.37474178310748824,0.142,0.403,0.72,0.024,1.777,60.27512246402152,1873.8474222926275,0.138,0.4,0.717,0.024,1.867,85.4700668182262,1873.912206886981,356,1.0548148148148149,1,1,4,5,FALSE,FALSE,FALSE
551,2021-11-13T12:42:32Z,2021-11-13T13:09:33Z,1621,1,2021-11-13T13:09:35Z,1,Chrome,95.0.4638.69,Macintosh,1280,800,"In the last game, there were times when the arrow was not visible. I think it was off the screen, so I had to guess the direction blindly. If this was not intended, you should probably disregard arrows that were either placed very high or very low.",1.6,750,78,382,87,70,124,-0.1007173082094523,-0.10723977200771087,-0.21906988353055556,-0.21425351304917153,-0.026866602291778594,0.31457468591007365,2,2,3,3,1,2,3,2,1,2,2,3,2,2,2,2,3,2,2,2,0.5871429486123998,0,0,4,4,2,2.75,0,4,4,3,4,4,1,4,1,2,1,2,4,3,5,3,2,3,1,1,2,1,2,2,0,2,0,0,5,5,5,5,3,5,4,5,4,2,5,3,1,4,2,5,2,3,4,3,5,5,1,1,1,3,2,1,1,1,1,5,2,2,1,2,1,2,2,1,1,1.624234631492057,1.3093073414159542,1.75,0,1.5,0,2.066666666666667,0,1.4444444444444444,0,2.4166666666666665,0,1.3333333333333333,0,1.1428571428571428,0,1.3333333333333333,0,1.7297297297297298,0,0,0,0,-0.47406300518242234,-0.5804383618435307,-0.5272506835129765,4,1,3,1,1,2,1,1,1,1.2149857925879117,1.5714285714285714,0,1,-0.5612498234260587,4,4,4,3,1,2,5,4,6,3,3,1.3801311186847085,2.7142857142857144,0,3.2857142857142856,4,3.8333333333333335,3.2559414990859232,-0.1748077221195339,0,0.3748675599933774,2,2,2,2,2,2,5,3,2,2,2,4,3,4,5,4,4,2,3,3,1.082325538564332,2,0,4,0,3,0,3.8,0,3.6,0,3,3,4,2,4,4,4,2,1,4,1,2,2,3,2,2,1,3,2,4,1.0894228312566052,2.85,0,"White, Caucasian, Anglo, European American",0,29,0,1,NA,1,3,6,Student/English Teacher,1,0,165,73,2,5,2,0,0,0,0,0,TRUE,TRUE,TRUE,TRUE,TRUE,1,0.9535911764701938,0.6938775510204082,0.06839352474464175,NA,NA,NA,NA,NA,NA,NA,1,0.7346096774188261,0.794953125,1,1,0.004798773569899081,0.006278752247980209,1.3125,0.676,0.5572,0,22.8744,0.004,ML,change,49,-34.073339105668126,0.6999278138396491,1.1691353127187245,0.6297447929439713,NA,NA,NA,NA,NA,NA,NA,NA,NA,NA,NA,NA,NA,NA,NA,NA,NA,NA,0.177,0.513,0.825,0.023,1.61,10.691732042345752,1810.7179194862056,0.182,0.508,0.831,0.025,1.674,23.228231892595275,1806.7337757845646,382,1.1318518518518519,1,1,1,2,FALSE,FALSE,FALSE
552,2021-11-13T12:53:12Z,2021-11-13T13:11:00Z,1067,1,2021-11-13T13:11:01Z,1,Chrome,95.0.4638.69,Macintosh,1680,1050,NA,1.6,566,27,228,51,24,55,-0.5734808394409122,-0.5705614259800063,-0.9604627102087498,-0.6529641482747395,-0.6622213455866413,-0.8509296205887885,4,4,1,1,4,1,1,4,1,4,4,1,1,1,4,4,1,1,4,4,1.538967528127731,0,0,2,2,2,1,0,4,5,3,4,2,2,4,2,2,2,2,4,2,4,4,2,3,1,1,1,2,3,2,1,2,0,0,4,4,4,4,4,4,3,4,4,2,4,2,1,4,1,5,3,2,2,2,3,4,1,1,1,1,1,1,2,2,1,4,1,2,1,1,1,1,1,2,2,1.34566370643293,1.0997835284835873,1.875,0,1.5,0,2,0,2.111111111111111,0,1.9166666666666667,0,1,0,1.4285714285714286,0,1,0,1.7027027027027026,0,1,0,0,-0.46060916427367454,-0.3773458880470143,-0.41897752616034445,4,2,3,2,2,2,2,1,1,0.7867957924694432,2.142857142857143,0,1,-0.21938108280548152,5,5,5,5,3,3,1,6,7,6,4,1.5735915849388864,4.428571428571429,0,1.5714285714285714,2.5,3.8333333333333335,3.2559414990859232,-1.0219528370065065,0,-1.00475696650735,2,3,3,2,2,3,5,2,2,3,2,4,2,4,4,2,4,2,4,2,1.0690449676496976,2.4,0,3.8,0,4,0,4,0,3.933333333333333,0,1,1,1,4,1,1,1,4,1,1,2,4,1,1,1,4,1,1,1,1,1.2258187382102494,1.05,0,"White, Caucasian, Anglo, European American",0,30,0,1,NA,1,5,7,entrepreneur,6,0,125,69,3,5,2,0,0,1,0,0,TRUE,TRUE,TRUE,TRUE,TRUE,3,0.620389999999851,0.8163265306122449,0.023464337840232028,3,0.4382741935479064,0.4765740740740741,0.96875,0.8709677419354839,0.0019534101613117123,0.003204230473135126,3,0.5744937499995576,0.6431032258066679,1,0.96875,0.005924385120974626,0.00264020028232135,1.1505,1.3992,0.3788,0,-2.5635,0.004,ML,change,49,16.80246089433188,1.5579429391193667,0.9574515467305116,0.42598793404370805,0.8001,2.7452,0.3568,4.0202,0.3432,0,-78.2859,0.009,ML,cueing,63,169.00120417917458,3.106978112965506,0.6145979905413124,0.4031921510416064,5.03225286992468,0.6823955976076664,0.374709634165305,0.097,0.402,0.61,0.016,1.768,131.13571082863047,1975.9746529244119,0.098,0.403,0.612,0.017,1.839,150.103082143967,1971.401887138615,396,1.1733333333333333,1,0,0,1,FALSE,FALSE,FALSE
553,2021-11-13T12:32:44Z,2021-11-13T13:12:16Z,2371,1,2021-11-13T13:12:16Z,1,Chrome,95.0.4638.69,Windows NT 10.0,1920,1080,everything was ok,1.7777777777777777,773,101,838,305,148,155,-0.041621866805519804,0.10170920919548118,1.9762231616983832,2.4423831113723233,1.050474049382119,0.838207055496519,4,4,2,2,3,1,2,3,1,2,3,2,2,3,3,3,3,1,2,2,0.8825799501580878,0,1,1,2,3,2,0,2,4,2,3,2,1,5,2,2,3,1,4,3,4,3,2,2,1,1,1,1,1,2,1,2,0,0,4,3,3,5,3,5,3,5,5,1,5,1,1,3,2,3,1,2,1,3,3,4,1,1,1,1,1,1,1,1,1,4,1,2,1,1,1,2,1,1,1,1.4881917600614225,1.162919151265879,1.375,0,1.25,0,2.2,0,2,0,1.8333333333333333,0,1,0,1.1428571428571428,0,1,0,1.5945945945945945,0,1,0,0,-0.6359930471992205,-0.4557470907642554,-0.545870068981738,5,2,3,1,1,1,1,1,1,1.5275252316519468,1.4285714285714286,0,1,-0.6467170085812028,4,3,3,4,3,3,2,7,7,2,3,0.6900655593423543,3.4285714285714284,0,2.5714285714285716,2,3.8333333333333335,3.2559414990859232,-1.3043345419688306,0,-0.5882508370384546,1,3,1,2,3,2,2,2,1,1,2,3,1,4,4,2,3,4,3,2,1.0555973258234952,2,0,3.2,0,3,0,4.2,0,3.466666666666667,0,2,2,1,1,1,1,1,3,1,1,3,3,2,1,2,3,1,2,1,1,0.812727700887249,1.65,0,"White, Caucasian, Anglo, European American",0,21,0,1,NA,1,3,3,chemistry,2,0,154,72,2,5,2,0,0,2,0,0,TRUE,TRUE,TRUE,TRUE,TRUE,2,0.8295718750000014,0.6666666666666666,0.05659983913120998,2,0.4134218750000182,0.4512066666666884,1,0.967741935483871,0.0032892998286300577,0.002219417784945034,2,0.6321749999999774,0.7075624999999891,1,1,0.008266066451609428,0.009483995967740827,1.373,0.5252,0.3806,0,31.6147,0.005,ML,change,48,-51.615796967276324,0.6271731239213045,1.1051927356614835,0.5358749956993722,0.9928,4.9432,0.3572,4.9363,0.3129,0,-98.5253,0.008,ML,cueing,63,209.4800041791746,4.851709898513162,0.7010306578108628,0.38362195043737063,4.797739114636279,0.8635598200311122,0.32623772891931146,0.249,0.281,0.7,0.014,1.263,45.61020605760519,1849.9689645334818,0.248,0.28,0.698,0.014,1.289,58.448740312049416,1840.0386573483108,104,0.3081481481481481,1,1,4,5,FALSE,FALSE,FALSE
554,2021-11-13T12:53:12Z,2021-11-13T13:13:25Z,1213,1,2021-11-13T13:13:26Z,1,Chrome,95.0.4638.69,Windows NT 10.0,1920,1080,"Very interesting survey, I enjoyed participating!",1.7777777777777777,634,40,287,65,49,63,-0.39876388224667697,-0.45245982790863687,-0.6764226012865845,-0.4823544567981297,-0.31691985466552025,-0.7157986865019639,4,4,1,1,4,1,1,4,1,4,3,1,1,1,4,4,1,1,3,4,1.465390194130093,0,1,1,4,4,1.1,0,3,3,4,3,4,3,2,3,3,3,3,2,2,2,2,2,3,1,1,2,2,2,2,2,2,0,0,3,2,2,2,3,4,3,3,3,2,3,4,1,3,4,4,4,4,4,4,4,2,1,1,1,3,1,1,3,3,3,2,4,3,1,1,2,1,1,2,2,1.1109609508143095,0.6761234037828132,1.875,0,1.5,0,3.3333333333333335,0,3.2222222222222223,0,3.25,0,1.6666666666666667,0,2.857142857142857,0,1.3333333333333333,0,2.810810810810811,0,1,0,0,0.5885968461639186,-0.3773458880470143,0.10562547905845215,5,1,5,2,1,1,1,3,2,1.889822365046136,1.1428571428571428,0,2.5,-0.2641698667299184,5,5,5,5,4,4,1,6,6,3,3,1.4638501094227998,4.714285714285714,0,1.2857142857142858,3,3.8333333333333335,3.2559414990859232,-0.7395711320441822,0,-1.022908108869061,2,2,2,2,2,2,4,2,2,4,3,3,1,4,4,1,3,3,4,2,1.082325538564332,2,0,3.2,0,4.4,0,4,0,3.8666666666666667,0,2,2,1,4,3,1,2,3,1,1,2,3,1,1,1,3,1,1,1,2,0.9514531821875089,1.5,0,"Hispanic of Latino (e.g., Mexican American, Central American, and others)",0,28,0,1,NA,1,3,6,IT Department Manager,3,0,200,63,2,5,2,0,0,1,0,0,TRUE,TRUE,TRUE,TRUE,TRUE,1,0.7694214285725639,0.84,0.056477901730050725,1,0.4450093750003725,0.53235172413752,1,0.90625,0.0014056299092707056,0.005308950604895392,1,0.6472066666662692,0.6919281250019558,1,1,0.0020768234023330976,0.007300171119098916,1.3788,1.2466,0.4117,0,14.7727,0.003,ML,change,50,-17.80933098371556,1.3617967928876509,1.217676591150804,0.4654039399475709,1.2393,2.4425,0.3165,6.6423,0.3517,0,-75.6299,0.01,ML,cueing,64,163.73644925007903,3.09058749418827,0.7340622278400257,0.4358610793585619,5.933961810319666,0.6982071774014905,0.38801640599175863,0.086,0.506,0.566,0.026,1.169,34.894244006574,1824.4295671720104,0.083,0.51,0.579,0.032,1.215,45.940559207923414,1829.4977877520691,284,0.8414814814814815,1,0,0,1,FALSE,FALSE,FALSE
555,2021-11-13T12:49:21Z,2021-11-13T13:21:51Z,1949,1,2021-11-13T13:21:52Z,1,Chrome,95.0.4638.69,Macintosh,1280,800,n/a,1.6,816,100,527,130,73,87,0.06886091494965832,0.09262447088229891,0.4789947909391728,0.3097619679147013,0.014569576618755927,-0.31040588424149007,2,1,1,2,1,2,3,1,2,1,1,3,2,2,3,2,1,2,1,2,0.7163503994113789,0,1,2,3,2,2.75,0,1,2,2,3,2,2,3,4,3,3,3,4,3,1,2,2,3,1,3,4,2,3,2,0,6,3,2,4,2,1,2,3,2,2,1,3,2,2,2,1,1,2,2,3,4,3,2,1,2,1,1,1,1,1,1,1,1,1,3,2,2,3,3,2,2,1,1,1,0.8937554468638492,0.9154754164341269,2.5,0,1.25,0,3.2,0,3.7777777777777777,0,2.75,0,1.3333333333333333,0,1.4285714285714286,0,2.6666666666666665,0,2.5675675675675675,0,0,3,2,0.6953564614326144,0.3139593520166609,0.5046579067246377,3,2,3,2,3,3,2,3,3,0.5345224838248488,2.5714285714285716,0,3,0.7749958222087157,4,3,3,2,1,1,1,1,3,NA,2,1.2149857925879117,2.7142857142857144,0,3.2857142857142856,7,3.8333333333333335,3.2559414990859232,1.5194825076544112,0,1.22201267488035,4,3,3,2,2,1,2,1,3,2,1,4,2,3,3,1,3,2,3,4,1.0465362369445672,2.8,0,4.2,0,3.2,0,3.2,0,3.533333333333333,0,2,1,2,1,2,3,2,2,1,2,2,1,2,1,1,2,1,1,1,3,0.6708203932499369,2.05,0,"Asian or Asian American (e.g., Chinese, Japanese, and others)",0,25,0,1,NA,1,2,6,retail worker,1,0,135,65,3,5,2,0,0,1,0,0,TRUE,TRUE,TRUE,TRUE,TRUE,1,0.6256727272730433,0.6875,0.033821862907753734,NA,NA,NA,NA,NA,NA,NA,1,0.8166481481481481,1.0871312499996275,0.84375,0.5161290322580645,0.22685538684484682,0.3263969162365287,1.2501,0.6647,0.2664,0,20.3928,0.005,ML,change,48,-29.17199696727633,0.8060166038855737,0.9782147868460086,0.39811504217147786,NA,NA,NA,NA,NA,NA,NA,NA,NA,NA,NA,NA,NA,NA,NA,NA,NA,NA,0.075,0.304,0.048,0.215,1.6,175.15866875170926,2398.7317336015863,0.076,0.303,0.048,0.328,1.71,203.95918416845373,2391.460074589146,386,1.1437037037037037,1,0,1,2,FALSE,FALSE,FALSE
556,2021-11-13T13:03:48Z,2021-11-13T13:26:34Z,1365,1,2021-11-13T13:26:36Z,1,Firefox,91.0,Windows NT 10.0,1366,768,NA,1.7786458333333333,847,42,215,32,24,90,0.14851129249408906,-0.43429035128227234,-1.0230478189543117,-0.884505872421567,-0.6622213455866413,-0.2597317839589309,3,3,3,2,4,1,2,3,1,3,2,2,2,2,3,3,2,2,4,3,0.8271701918685112,0,0,5,4,4,1.9,0,4,3,3,3,3,1,3,4,3,3,3,3,3,3,4,3,3,3,3,3,3,4,3,5,2,4,5,4,3,5,3,4,3,3,4,4,3,4,3,3,4,4,3,3,3,3,3,3,3,4,3,1,4,3,4,4,4,4,4,3,3,3,3,3,2,3,3,3,0.6811490027622179,0.7037315505489968,3.125,0,2.75,0,2.8,0,2.3333333333333335,0,2.9166666666666665,0,2.8333333333333335,0,3.2857142857142856,0,3,0,2.891891891891892,0,3,4,5,0.9314278137810728,2.1296261380002224,1.5305269758906475,4,1,4,1,1,3,3,1,1,1.3972762620115438,1.8571428571428572,0,1,-0.39031545311577004,3,3,3,3,3,2,3,4,4,2,3,0.3779644730092272,2.857142857142857,0,3.142857142857143,5,3.8333333333333335,3.2559414990859232,0.38995568780511447,0,0.5775782675342649,3,3,2,2,2,3,3,3,3,3,3,3,2,3,3,3,3,3,3,3,0.2581988897471611,2.4,0,3,0,3.2,0,3,0,3.066666666666667,0,2,2,2,2,2,2,2,2,2,2,2,2,2,2,2,2,2,2,2,2,0,2.2,0,"White, Caucasian, Anglo, European American",0,27,0,1,NA,1,2,2,Mturker,1,0,200,65,2,5,2,0,0,1,0,0,TRUE,TRUE,TRUE,TRUE,TRUE,3,0.8822758620689655,0.6304347826086957,0.13927399855072467,3,0.5918064516129032,0.6290967741935484,1,0.96875,0.023001294623655914,0.011381419354838707,3,0.64925,0.7821333333333333,1,0.967741935483871,0.011209999999999998,0.010897346236559139,1.3434,0.3994,0.4874,0,32.3507,0.004,ML,change,46,-53.21547581053272,0.3894787763213986,1.3712749407673301,0.42304172745172636,1.2406,3.1779,0.4415,3.4011,0.4095,0,-55.0118,0.007,ML,cueing,63,122.4530041791746,3.239005686552662,1.0601979548050768,0.4756645670880979,2.9503560105249456,1.4042829786003894,0.361258149871332,0.094,0.451,0.506,0.01,1.659,61.791457149596724,1911.5560807409308,0.095,0.452,0.548,0.011,1.792,81.27315884755862,1911.209401269393,350,1.0370370370370372,1,1,2,3,FALSE,FALSE,FALSE
557,2021-11-13T13:10:55Z,2021-11-13T13:42:41Z,1906,1,2021-11-13T13:42:44Z,1,Chrome,95.0.4638.69,Windows NT 10.0,1366,768,no,1.7786458333333333,866,76,588,105,49,83,0.1973292658277724,-0.1254092486340754,0.7726633781298861,0.0051018045636124325,-0.31691985466552025,-0.3779713512849024,4,4,1,1,1,1,1,3,1,4,4,1,1,1,4,4,1,4,4,4,1.5035046776746235,0,0,3,3,4,1.35,0,1,2,2,2,3,1,5,1,1,1,2,3,3,3,3,1,1,1,2,1,1,1,1,1,1,4,0,2,3,2,5,1,5,5,5,5,1,4,5,1,2,1,1,3,1,1,1,1,1,4,5,1,3,3,2,1,1,1,5,1,1,2,3,1,3,2,4,2,1.6251588048991217,1.1464230084422218,1.125,0,2.75,0,2.466666666666667,0,2.3333333333333335,0,2.1666666666666665,0,3.3333333333333335,0,1,0,2,0,2.2162162162162162,0,1,4,0,-0.36168955701655103,0.8411929559112861,0.23975169944736752,2,4,1,5,2,3,5,8,4,1.5735915849388864,4,0,6,2.736630698083305,1,3,3,2,1,1,5,1,2,1,1,1.4960264830861913,1.7142857142857142,0,4.285714285714286,7.5,3.8333333333333335,3.2559414990859232,1.8018642126167355,0,1.9209005093115694,2,2,3,2,2,1,4,3,1,1,1,3,1,4,3,5,4,1,4,5,1.5796322658258457,2.2,0,4.4,0,3,0,3.2,0,3.533333333333333,0,1,1,1,4,1,1,1,4,1,1,1,3,1,2,1,3,1,1,1,1,1.050062654772261,1.15,0,Black or African American,0,22,0,1,NA,1,2,5,Unemployed,1,0,230,69,1,5,2,0,0,2,0,0,TRUE,TRUE,TRUE,TRUE,TRUE,5,1.3422696969716839,0.66,0.2534461520660866,5,0.6191656249994412,0.7142548387108311,1,1,0.009546255876275455,0.011792842559204183,5,0.8351656249966473,1.064777419356569,1,1,0.04604045458633045,0.12031538580424916,1.8591,0.3597,0.6025,0,65.8445,0.004,ML,change,50,-119.95293098371556,0.41337082479467524,1.6045985290319609,0.7211911175324199,1.9723,4.1436,0.4763,4.7765,0.4127,0,-61.7638,0.008,ML,cueing,63,135.9570041791746,3.4866461095266463,1.188286564292013,0.549174619354389,3.6758199171658794,1.127132128275196,0.4706396806016431,0.127,0.433,0.294,0.008,1.444,88.85484586969261,1892.5606739603252,0.127,0.433,0.294,0.009,1.495,107.79873497522307,1889.714974374185,332,0.9837037037037036,1,0,0,1,FALSE,FALSE,FALSE
558,2021-11-13T13:16:23Z,2021-11-13T13:44:48Z,1704,1,2021-11-13T13:44:50Z,1,Chrome,95.0.4638.69,Windows NT 10.0,1920,1080,none,1.7777777777777777,712,109,546,107,77,86,-0.198353254876819,0.1743871157009393,0.5704653344903786,0.02947461763169954,0.06981781516613529,-0.3272972510023432,4,4,1,1,4,1,2,2,1,4,4,1,1,2,4,4,1,1,2,3,1.348488432516786,0,0,1,5,5,1.35,0,5,5,2,4,3,1,1,4,1,1,1,5,1,5,3,1,1,1,1,1,1,1,1,4,2,0,0,5,5,5,3,1,5,5,5,5,1,5,3,1,2,2,5,1,1,1,1,1,1,1,1,1,1,1,1,1,1,5,5,1,1,1,1,1,1,1,2,2,1.8137777674758806,1.740279123753264,1,0,1.5,0,1.8666666666666667,0,1.6666666666666667,0,1.5,0,1.5,0,1.4285714285714286,0,1,0,1.5405405405405406,0,2,0,0,-0.9636279499050556,-0.17425341425049792,-0.5689406820777768,3,3,1,3,1,1,5,8,4,1.5118578920369088,3,0,6,2.1383604019972946,4,4,4,4,1,1,1,3,3,1,1,1.6035674514745464,3.2857142857142856,0,2.7142857142857144,6,3.8333333333333335,3.2559414990859232,0.9547190977297628,0,0.6209469802322789,3,3,3,3,3,1,5,1,1,5,5,5,1,5,5,3,3,1,1,4,1.869555587629877,3,0,3.8,0,3.8,0,4.4,0,4,0,2,1,1,4,4,1,2,1,4,1,1,1,1,2,4,1,1,1,1,4,1.2937094768634556,2.2,0,Black or African American,0,29,0,1,NA,1,1,3,photographer,1,0,188,65,2,5,2,0,0,1,0,0,TRUE,TRUE,TRUE,TRUE,TRUE,6,0.8211657142864807,0.7142857142857143,0.07651404833346265,6,0.42269375000032594,0.48782580645166096,1,0.96875,0.004048174798430775,0.003991598991879243,6,0.7119624999994412,0.7818375000008382,1,1,0.016932219193666682,0.015945316612640682,1.4334,0.6881,0.3519,0,30.4899,0.004,ML,change,49,-49.30433910566812,0.7560741434219731,1.2119059219867587,0.4776886513563155,1.2379,4.1499,0.3448,4.9322,0.2972,0,-83.2462,0.01,ML,cueing,64,178.96904925007902,4.208953141755236,0.8158767961605508,0.3969618231000263,4.555097529761251,0.9095600476876484,0.32597394428371895,0.084,0.513,0.466,0.016,1.471,55.808823897537806,1862.763423599276,0.085,0.513,0.472,0.016,1.485,63.60882880361934,1847.4172910601765,452,1.3392592592592591,1,0,1,2,FALSE,FALSE,FALSE
559,2021-11-13T13:19:06Z,2021-11-13T13:47:02Z,1676,1,2021-11-13T13:47:03Z,1,Chrome,95.0.4638.69,Windows NT 10.0,1536,864,No the survey worked as intended.,1.7777777777777777,645,102,311,126,62,100,-0.3705008450534919,0.11079394750866343,-0.5608808620640088,0.26101634177852706,-0.1373630793865373,-0.09081811635040013,2,2,3,3,2,2,3,2,3,2,3,3,3,2,2,2,3,3,3,3,0.5104177855340404,1,0,3,3,3,2.75,0,2,4,3,4,2,1,4,2,2,2,2,4,2,4,3,2,2,1,1,1,1,1,1,0,2,0,0,4,4,5,4,3,5,4,5,5,2,4,2,1,4,2,5,2,2,2,2,3,5,1,1,1,3,2,1,1,1,1,4,1,1,1,2,1,2,2,2,2,1.5156837721956706,1.0327955589886444,1.25,0,2,0,2.2,0,1.6666666666666667,0,1.9166666666666667,0,1.3333333333333333,0,1,0,1.3333333333333333,0,1.5945945945945945,0,0,0,0,-0.6897116206118464,-0.4236359564090485,-0.5566737885104475,5,1,4,1,1,1,3,1,1,1.7043362064926932,1.4285714285714286,0,1,-0.6467170085812028,4,4,4,4,3,3,3,7,3,4,3,0.5345224838248488,3.5714285714285716,0,2.4285714285714284,4,3.8333333333333335,3.2559414990859232,-0.1748077221195339,0,-0.10315842453524313,2,4,3,2,3,2,5,2,2,4,3,4,2,3,4,1,3,2,3,2,1.082325538564332,2.8,0,3.6,0,4.2,0,3.8,0,3.8666666666666667,0,2,1,2,3,2,1,2,3,1,3,2,3,2,2,1,4,1,2,2,2,0.8255779474818965,1.75,0,"White, Caucasian, Anglo, European American",0,21,0,1,NA,1,3,4,Student,5,0,170,70,3,5,2,0,0,1,0,0,TRUE,TRUE,TRUE,TRUE,TRUE,2,0.8799583333200879,0.72,0.14146444222085017,2,0.5211718750037253,0.6205375000089407,1,1,0.005005209184304422,0.011835861776351085,2,0.5718249999955297,0.6960064516221324,1,0.96875,0.00436858838653403,0.01135866774196663,1.669,0.5961,0.3369,0,47.4748,0.004,ML,change,50,-83.21353098371557,0.666721543884377,1.4165758066528595,0.4125267941381548,1.3852,3.4257,0.4184,5.9702,0.4052,0,-78.5426,0.01,ML,cueing,64,169.561849250079,3.4834735974037616,1.1893687753165167,0.4551564559346275,4.319733318175878,0.959118172633185,0.4136252209280109,0.163,0.327,0.652,0.014,1.668,137.59055736892154,1983.428580422867,0.164,0.326,0.655,0.014,1.687,158.82403268792595,1985.929851741528,104,0.3081481481481481,1,0,1,2,FALSE,FALSE,FALSE
560,2021-11-13T13:24:53Z,2021-11-13T13:49:55Z,1502,1,2021-11-13T13:49:57Z,0.699999988079071,Safari,15.1,Macintosh,1440,900,N/A,1.6,715,102,418,108,44,74,-0.19064515382413216,0.11079394750866343,-0.04575727469669198,0.04166102416574309,-0.3859801528497444,-0.5299936521325801,3,3,2,2,3,1,1,3,1,3,3,1,2,1,3,3,1,1,2,3,0.9119095061289915,0,0,2,4,4,1.7,0,1,4,2,3,2,2,1,3,1,1,2,1,1,1,1,3,3,1,1,3,5,3,4,2,2,0,0,4,4,1,5,4,5,5,5,2,2,4,5,1,3,2,3,3,5,5,5,5,4,1,1,1,3,1,1,2,2,1,4,2,3,1,1,4,1,1,1,1,1.572091432287407,0.9611501047232549,2.875,0,1,0,2.933333333333333,0,2.111111111111111,0,3.4166666666666665,0,1.3333333333333333,0,1.7142857142857142,0,2,0,2.3783783783783785,0,1,0,0,0.6606087716035466,-0.5341482934814965,0.06323023906102504,5,1,1,1,1,1,1,1,2,1.5118578920369088,1.5714285714285714,0,1.5,-0.3767559860388676,5,5,5,5,1,4,1,6,6,5,3,1.889822365046136,4.285714285714286,0,1.7142857142857142,3,3.8333333333333335,3.2559414990859232,-0.7395711320441822,0,-0.783895116604751,1,1,1,2,1,2,4,1,1,2,1,4,3,4,5,1,5,2,3,4,1.4735767952260144,1.2,0,4.4,0,3.4,0,4.2,0,4,0,1,1,2,4,2,2,2,4,1,1,1,4,2,2,1,4,1,2,1,2,1.1239029738980326,1.4,0,"White, Caucasian, Anglo, European American",0,23,0,1,NA,1,4,6,IT Engineer,5,0,304,71,1,5,2,0,0,1,0,0,TRUE,TRUE,TRUE,TRUE,TRUE,5,0.87185,0.8163265306122449,0.048046950680275424,5,0.479709677419352,0.52309375,0.96875,1,0.005103338709677058,0.002525571572580675,5,0.6705937500000037,0.7121935483870968,1,1,0.005940119959677378,0.0032768946236564653,1.4329,1.1276,0.4707,0,18.7031,0.004,ML,change,49,-25.73073910566812,1.3023783419432051,1.1453314514982667,0.5936676064622145,1.1155,5.1023,0.4138,4.1712,0.353,0,-89.4811,0.008,ML,cueing,64,191.43884925007902,5.125338745711834,0.8083631018257921,0.44669862825815165,3.9581952971681043,0.867563863496578,0.3769682686503168,0.218,0.369,0.732,0.025,1.319,33.27280836778104,1824.311090000887,0.219,0.376,0.75,0.022,1.386,42.79932356393962,1825.1617787550645,370,1.0962962962962963,1,0,0,1,FALSE,FALSE,FALSE
561,2021-11-13T13:34:29Z,2021-11-13T13:56:58Z,1348,1,2021-11-13T13:56:59Z,1,Chrome,95.0.4638.69,Windows NT 10.0,1366,768,"Thank you so much guys, have a great day",1.7786458333333333,704,43,354,66,31,101,-0.21890819101731726,-0.4252056129690901,-0.35386857929022725,-0.47016805026408615,-0.5655369281287274,-0.07392674958954705,3,3,1,1,3,1,1,2,1,4,2,1,1,1,2,3,1,1,2,4,1.0711528467275955,0,1,1,4,3,1.6,0,4,3,2,4,3,2,4,1,1,1,1,5,2,5,3,2,1,1,1,1,1,1,1,4,2,0,0,5,4,4,2,1,5,3,4,5,2,4,1,1,5,1,5,1,1,1,2,2,5,1,1,1,4,3,2,5,5,1,4,2,1,1,1,1,2,1,3,3,1.6558205644760369,1.4375905768565218,1.125,0,2.25,0,1.8,0,2.3333333333333335,0,1.3333333333333333,0,1.6666666666666667,0,2.4285714285714284,0,1,0,1.864864864864865,0,2,0,0,-0.799181362106765,0.06095019390122543,-0.3691155841027698,5,1,2,1,1,1,3,1,1,1.5275252316519468,1.7142857142857142,0,1,-0.4757826382709144,3,5,5,5,1,2,4,8,6,NA,2,1.618347187425374,3.2857142857142856,0,2.7142857142857144,2,3.8333333333333335,3.2559414990859232,-1.3043345419688306,0,-0.5085798396170178,1,1,2,2,2,2,4,1,1,1,1,5,1,4,5,1,5,1,4,1,1.7674302033770737,1.6,0,4.8,0,3.8,0,4.8,0,4.466666666666667,0,1,1,1,4,1,1,1,3,1,1,1,4,1,1,1,4,1,1,1,1,1.145931016569864,1.05,0,"Hispanic of Latino (e.g., Mexican American, Central American, and others)",0,21,0,1,NA,1,4,6,Medical assistant,6,0,138,65,2,5,2,0,0,1,0,0,TRUE,TRUE,TRUE,TRUE,TRUE,5,0.8798441176453934,0.68,0.0709745258118037,5,0.40597142856993845,0.48372083333320914,0.9032258064516129,0.75,0.0058583976126168474,0.008445787812231657,5,0.5562499999980132,0.6595888888896615,0.9375,0.84375,0.02134461350833954,0.025871508780151337,1.5553,0.5211,0.3764,0,42.221,0.004,ML,change,50,-72.70593098371556,0.64183513028878,1.1744009743393709,0.5504882357291521,0.9356,1.3137,0.2786,2.7004,0.263,0,-38.059,0.008,ML,cueing,63,88.54740417917459,1.5468186401302275,0.7102398821465049,0.36893040740345867,2.9841235540677276,0.7484918707412207,0.30483243994103293,0.062,0.33,0.286,0.01,1.759,99.50410088371882,2103.4049294502406,0.062,0.33,0.287,0.01,1.812,132.82368484040012,2117.634870733689,370,1.0962962962962963,1,0,0,1,FALSE,FALSE,FALSE
562,2021-11-13T13:47:23Z,2021-11-13T14:17:42Z,1818,1,2021-11-13T14:17:43Z,0.8999999761581421,Chrome,95.0.4638.69,Windows NT 10.0,1920,1080,.,1.7777777777777777,823,115,484,105,98,119,0.0868464840725943,0.22889554558003286,0.27198250816539127,0.0051018045636124325,0.3598710675398769,0.2301178521058083,4,4,1,1,3,1,1,4,1,4,3,1,1,1,4,2,1,1,4,3,1.3717065820970682,0,1,1,5,5,1.25,0,4,4,2,4,1,2,5,2,1,1,1,4,3,4,1,2,1,1,1,2,1,3,1,1,2,0,1,4,3,3,3,2,5,5,4,4,1,5,1,1,2,1,1,1,1,1,1,1,5,1,1,1,3,2,1,2,1,1,5,1,1,1,1,1,2,1,2,2,1.5052460814650095,1.4540583599999397,1.5,0,1.75,0,1.9333333333333333,0,2.3333333333333335,0,1.5833333333333333,0,1.3333333333333333,0,1,0,1,0,1.6216216216216217,0,1,0,1,-0.6852592703830522,-0.12249503843059244,-0.4038771544068223,2,2,1,2,1,2,1,4,2,0.5345224838248488,2.4285714285714284,0,3,0.6895286370535711,3,3,4,4,1,1,3,1,1,1,2,1.2535663410560174,2.7142857142857144,0,3.2857142857142856,8,3.8333333333333335,3.2559414990859232,2.0842459175790595,0,1.5043943798426742,1,2,2,1,1,3,4,1,1,2,1,4,1,4,2,3,3,2,3,4,1.1872336794093274,1.4,0,3.8,0,3.4,0,3.6,0,3.6,0,1,1,1,3,1,1,2,3,1,1,2,4,1,1,1,3,1,1,1,1,0.9445132413883326,1.25,0,"White, Caucasian, Anglo, European American",0,21,0,1,NA,1,3,1,IT Techican,1,0,140,66,2,5,2,0,0,1,0,0,TRUE,TRUE,TRUE,TRUE,TRUE,2,0.8421472222222688,0.72,0.11268741092242825,2,0.48650322580634947,0.5712612903226587,0.96875,1,0.005167779425388478,0.0091632744516272,2,0.5863437500001164,0.6916999999998661,1,1,0.010310910282267634,0.01784381032257291,1.4503,0.6852,0.4109,0,33.4658,0.004,ML,change,50,-55.195530983715564,0.7057281834901843,1.3382795684451894,0.42495897333885624,1.6139,3.9939,0.3692,3.8358,0.287,0,-58.435,0.007,ML,cueing,63,129.2994041791746,3.7136401692088374,1.1156532506147991,0.42574516096065046,3.945797785281869,0.8702897085335148,0.38311518539617845,0.427,0.022,0.77,0.011,1.38,25.202135706595506,1816.4433239358673,0.431,0.025,0.773,0.012,1.449,31.937766421704602,1814.381785038832,278,0.8237037037037037,1,0,3,4,FALSE,FALSE,FALSE
563,2021-11-13T13:51:07Z,2021-11-13T14:31:28Z,2421,1,2021-11-13T14:31:31Z,1,Chrome,94.0.4606.81,Windows NT 10.0,1366,768,Everything went well!,1.7786458333333333,883,147,803,157,122,153,0.2410085051263312,0.5196071716018653,1.8077247919987938,0.6387949443338773,0.6913604988241531,0.8044243219748128,3,3,1,1,3,1,2,4,1,3,3,2,1,2,3,3,2,1,1,2,0.9679060415469871,0,0,1,5,5,1.8,0,2,4,1,4,3,4,3,3,2,2,2,4,1,4,3,1,3,1,1,1,1,1,1,0,2,0,1,4,3,5,3,3,5,3,3,5,4,5,2,1,4,2,5,3,1,1,2,3,5,1,1,1,1,1,1,1,1,1,4,1,3,1,2,1,3,1,1,1,1.5206289199907754,1.082325538564332,1.25,0,1.5,0,2.4,0,2.2222222222222223,0,1.9166666666666667,0,0.8333333333333334,0,1.2857142857142858,0,1.3333333333333333,0,1.7027027027027026,0,0,0,1,-0.5573025964164013,-0.40398871494434996,-0.48064565568037565,4,2,2,2,1,2,2,3,8,0.8997354108424374,2.142857142857143,0,5.5,1.4410634536792382,4,4,4,4,2,2,3,4,4,2,2,0.9511897312113419,3.2857142857142856,0,2.7142857142857144,5,3.8333333333333335,3.2559414990859232,0.38995568780511447,0,0.3385652752699547,2,3,3,1,2,3,3,2,2,3,3,3,2,4,3,2,4,2,3,4,0.7432233529572065,2.2,0,3.4,0,3.4,0,3.4,0,3.4,0,2,1,1,3,2,2,2,4,2,1,2,4,2,2,1,3,1,1,1,2,0.9445132413883326,1.55,0,"White, Caucasian, Anglo, European American",0,24,0,1,NA,1,1,6,Skilled Laborer,1,0,200,71,4,5,2,0,0,0,0,0,TRUE,TRUE,TRUE,TRUE,TRUE,NA,NA,NA,NA,1,0.4738718750178814,0.4987218749821186,1,1,0.0023315995095441813,0.0027306217627982555,1,0.6317312500327825,0.7131482758522034,1,0.90625,0.010625648013318317,0.013268004652575063,NA,NA,NA,NA,NA,NA,NA,NA,NA,NA,NA,NA,NA,10,12.083,0.0849,12.4333,0.0717,0,-99.7877,0.017,ML,cueing,64,212.05204925007902,5.02628496852613,0.8242936388078359,0.4192860224990821,5.22876358014293,0.7923736965514663,0.4004690516956181,0.072,0.433,0.355,0.015,1.629,82.89621545756802,1996.842217898843,0.07,0.438,0.365,0.016,1.769,120.96938687223262,2010.6755730735338,336,0.9955555555555555,1,0,0,1,FALSE,FALSE,FALSE
564,2021-11-13T13:40:36Z,2021-11-13T14:35:21Z,3285,1,2021-11-13T14:35:22Z,0.8999999761581421,Chrome,95.0.4638.69,Windows NT 10.0,1920,1080,This was a very interesting survey.,1.7777777777777777,630,37,232,65,29,72,-0.4090413503169261,-0.47971404284818364,-0.9412057536716539,-0.4823544567981297,-0.593161047402417,-0.5637763856542862,4,4,1,1,4,1,1,4,1,4,4,1,1,1,4,4,1,1,4,4,1.538967528127731,0,0,2,5,5,1,0,5,5,2,5,1,1,5,1,1,1,1,5,2,5,3,1,1,1,1,1,1,1,1,1,2,0,0,5,4,4,5,4,5,5,5,5,1,5,1,1,5,1,5,1,1,1,1,2,5,1,1,1,2,2,1,2,2,1,5,1,1,1,1,1,2,1,1,2,1.8034001919297482,1.88477610139267,1,0,1.5,0,1.2666666666666666,0,1.3333333333333333,0,1.0833333333333333,0,1.1666666666666667,0,1.1428571428571428,0,1,0,1.2162162162162162,0,1,0,0,-1.3608550224913916,-0.3773458880470143,-0.869100455269203,5,1,4,1,1,1,1,1,1,1.7320508075688772,1.1428571428571428,0,1,-0.8176513788914915,4,3,5,5,2,3,2,6,5,3,3,1.2724180205607036,3.7142857142857144,0,2.2857142857142856,3.5,3.8333333333333335,3.2559414990859232,-0.4571894270818581,0,-0.3240202744378419,1,2,2,2,2,2,4,3,1,4,1,5,2,5,5,1,5,1,4,2,1.647508942095828,1.8,0,4.8,0,4.2,0,4.4,0,4.466666666666667,0,1,1,1,4,1,1,1,4,1,1,1,4,1,1,1,4,1,1,1,1,1.231174022502185,1,0,"White, Caucasian, Anglo, European American",0,30,0,1,NA,1,3,6,Communications Director,4,0,158,73,3,5,2,0,0,1,0,0,TRUE,TRUE,TRUE,TRUE,TRUE,1,0.895434883720653,0.86,0.022624625698157708,1,0.4915937500055879,0.5697741935483871,1,0.96875,0.0021118980241960432,0.00241716160265523,1,0.6402906250040978,0.6464468750003726,1,1,0.006727498941655854,0.005067250313043982,1.2188,1.5692,0.6312,0,-2.289,0.019,ML,change,50,16.31406901628444,1.8354117722384464,0.9890368984744731,0.7014439282106686,1.0185,3.9915,0.4473,7.0587,0.4195,0,-105.3445,0.009,ML,cueing,64,223.165649250079,4.77127441366671,0.7197211702284249,0.49906576865079105,5.3597466116354,0.7730094399233834,0.421734766998807,0.285,0.271,0.773,0.233,1.046,32.2025610286133,1834.551174285146,0.291,0.275,0.795,0.246,1.088,48.16410137541229,1832.3987304169493,354,1.0488888888888888,1,0,0,1,FALSE,FALSE,FALSE
