id,meta_start,meta_captcha,meta_resolution_ratio,meta_resolution_height,dems_edu,dems_class_current,chaos01,chaos02,chaos03,chaos04,chaos05,chaos06,chaos07,chaos08,chaos09,chaos10,chaos11,chaos12,chaos13,chaos14,chaos15,unp01,unp02,unp03,unp04,unp05,unp06,unp07,unp08,unp_moving,unp_household_size,unp_partners_mother,unp_partners_father,quic01,quic02,quic03,quic04,quic05,quic06,quic07,quic08,quic09,quic10,quic11,quic12,quic13,quic14,quic15,quic16,quic17,quic18,quic19,quic20,quic21,quic22,quic23,quic24,quic25,quic26,quic27,quic28,quic29,quic30,quic31,quic32,quic33,quic34,quic35,quic36,quic37,change_env01,change_env02,change_env03,change_env04,unp_mean,unp_missing,change_env_mean,change_env_missing,chaos_mean,chaos_missing,quic_monitoring_mean,quic_monitoring_missing,quic_par_predict_mean,quic_par_predict_missing,quic_par_env_mean,quic_par_env_missing,quic_phys_env_mean,quic_phys_env_missing,quic_safety_mean,quic_safety_missing,quic_total_mean,quic_total_missing,unp_moving_binned,unp_partners_mother_binned,unp_partners_father_binned,unp_quic_punp,unp_subj,unp_obj,unp_comp,violence01,violence02,violence03,violence04,violence05,violence06,violence07,violence_mean,violence_missing,fighting_mean,vio_comp,ses01,ses02,ses03,ses04,ses05,ses06,ses07,ses_subj_mean,ses_subj_missing,ses_subj_mean_recoded,ses_obj_mean,ses_obj_missing,impuls01,impuls02,impuls03,impuls04,impuls05,fos01,fos02,fos03,fos04,fos05,fos06,fos07,fos08,fos09,fos10,fos11,fos12,fos13,fos14,fos15,impuls_mean,impuls_missing,fos_pa_mean,fos_pa_missing,fos_tp_mean,fos_tp_missing,fos_fc_mean,fos_fc_missing,fos_fo_mean,fos_fo_missing,depression01,depression02,depression03,depression04,depression05,depression06,depression07,depression08,depression09,depression10,depression11,depression12,depression13,depression14,depression15,depression16,depression17,depression18,depression19,depression20,depression_mean,depression_missing,dems_ethnicity,dems_ethnicity_mixed,dems_age,dems_sex,dems_gender,dems_gender_4_text,att_check01,att_check02,att_getup,att_interrupted,att_noise,attention_check_sum,attention_interrupt_sum,ex_narb_NA_selfreport_pass,ex_narb_attention_checks_pass,ex_narb_suspect_responses_pass,ex_narb_resolution_ratio,ex_narb_resolution_height,dems_colorblind,counterbalance.x,rt_change,acc_change,rt_var_change,counterbalance.y,rt_cueing_cued,rt_cueing_neutral,acc_cueing_cued,acc_cueing_neutral,rt_var_cueing_cued,rt_var_cueing_neutral,counterbalance,rt_flanker_congruent,rt_flanker_incongruent,acc_flanker_congruent,acc_flanker_incongruent,rt_var_flanker_congruent,rt_var_flanker_incongruent,change_ml_a,change_ml_v,change_ml_t0,change_ks_a,change_ks_v,change_ks_t0,change_ks_st0,change_hddm_a,change_hddm_v,change_hddm_t,cueing_ml_a,cueing_cued_ml_v,cueing_cued_ml_t0,cueing_neutral_ml_v,cueing_neutral_ml_t0,cueing_ml_fit,cueing_ks_a,cueing_cued_ks_v,cueing_cued_ks_t0,cueing_neutral_ks_v,cueing_neutral_ks_t0,cueing_ks_fit,cueing_fixed_hddm_a,cueing_neutral_hddm_v,cueing_cued_hddm_v,cueing_neutral_hddm_t,cueing_cued_hddm_t,flanker_ks_a,flanker_con_ks_v,flanker_con_ks_t0,flanker_incon_ks_v,flanker_incon_ks_t0,flanker_ks_fit,flanker_ssp_a,flanker_ssp_t0,flanker_ssp_p,flanker_ssp_rd,flanker_ssp_sda,flanker_ssp_interference,final_width_px,scale_factor,fullscreenenter,fullscreenexit,blur_event,focus_event,event_during_cueing,event_during_change,event_during_flanker
1,2021-11-12T18:09:54Z,1,1.7777777777777777,720,6,3,4,5,2,2,2,1,5,4,2,1,1,5,2,4,4,2,4,4,1,2,2,1,3,5,1,2,3,4,4,5,5,4,5,4,5,5,2,4,2,1,5,1,5,3,3,3,3,3,1,1,5,4,3,1,3,3,3,3,5,2,1,1,1,3,2,2,2,2,2.375,0,2,0,1.8666666666666667,0,1.4444444444444444,0,2.0833333333333335,0,3,0,2.142857142857143,0,1.6666666666666667,0,2.108108108108108,0,3,2,3,0.144539757260731,-0.1288122820061409,1.1282568208640904,0.49972226942897474,4,2,2,3,2,4,4,3,0,2.5,0.8469035402869574,5,5,5,5,2,2,1,4.142857142857143,0,1.8571428571428572,-0.4571894270818581,0,3,4,4,2,2,2,3,2,2,2,1,4,1,3,3,3,4,1,3,4,3,0,4.4,0,3.2,0,3.2,0,3.6,0,2,1,1,4,2,1,1,3,1,1,2,4,2,2,2,4,1,2,1,2,1.45,0,"White, Caucasian, Anglo, European American",0,26,1,2,NA,5,2,0,0,1,0,0,TRUE,TRUE,TRUE,TRUE,TRUE,0,1,0.9689083333317604,0.72,0.18178143326077806,1,0.43045312499953436,0.5180600000013907,1,0.9375,0.0018699774092332136,0.006123577973863204,1,0.5644843749981373,0.6408548387096774,1,0.96875,0.007203311683837731,0.0076763203127120155,1.4271,0.6613,0.5237,1.1783,0.5677,0.5853,0.0534,1.4632006,0.7404313273333334,0.5133131866666667,1.3424,5.9454,0.3176,2.986,0.3113,-74.7244,0.6985,6.7674,0.3824,4.4588,0.4471,0.9727,1.3675532033333333,3.1262266833333334,5.610252956666667,0.3099559886666667,0.31278848466666664,0.8137,3.2552,0.4736,4.9955,0.5567,0.9961,0.081,0.383,0.502,0.016,1.812,113.25,357,1.0577777777777777,1,0,0,1,FALSE,FALSE,FALSE
2,2021-11-12T18:29:39Z,1,1.7777777777777777,864,4,4,4,5,3,4,4,2,4,1,1,2,1,5,3,4,3,2,1,1,1,1,1,3,1,0,2,0,0,4,3,4,4,4,5,4,4,5,3,5,3,1,5,1,5,2,1,2,3,3,5,1,1,1,1,1,1,1,1,1,5,1,2,1,1,1,1,1,2,1,1.375,0,1.25,0,2,0,1.8888888888888888,0,1.8333333333333333,0,0.8333333333333334,0,1,0,1,0,1.5135135135135136,0,0,0,0,-0.8473115880114084,-0.756787244710855,-0.6588395645607719,-0.7078134046358134,4,1,5,2,1,2,1,1.4285714285714286,0,1,-0.6467170085812028,5,4,5,5,4,4,2,4.428571428571429,0,1.5714285714285714,-0.1748077221195339,0,2,2,3,1,2,1,4,3,2,3,1,5,2,4,4,2,5,2,4,5,2,0,4.8,0,3.8,0,3.2,0,3.933333333333333,0,1,2,1,3,2,1,2,3,1,2,1,4,1,2,1,4,1,2,1,1,1.4,0,"White, Caucasian, Anglo, European American",0,18,1,2,NA,5,2,0,0,0,0,0,TRUE,TRUE,TRUE,TRUE,TRUE,0,5,0.7139536585342593,0.82,0.04087522292360682,5,0.429609677416663,0.4857483870925442,0.96875,0.96875,0.001390286360862519,0.0026939386187109986,5,0.5176093749981373,0.565940625006333,1,1,0.006477084103693077,0.003834502489063209,1.4835,1.1292,0.3229,0.8639,1.7583,0.5841,0.2938,1.48092733,1.049334323,0.319797303,0.9093,6.0256,0.3585,3.7334,0.3726,-99.9974,0.7418,7.4161,0.3773,7.7264,0.4389,0.9936,0.9951518116666667,3.88762018,5.69266162,0.36653919333333335,0.351521811,0.8492,4.6747,0.435,6.2013,0.4971,0.9625,0.206,0.263,0.828,0.022,1.452,66,388,1.1496296296296296,1,0,0,1,FALSE,FALSE,FALSE
3,2021-11-12T20:05:45Z,1,1.6,1200,4,2,4,5,1,5,1,1,4,2,1,1,2,5,2,4,5,1,2,1,1,1,2,2,1,0,2,0,0,5,2,1,4,4,5,4,5,5,1,5,3,1,4,1,5,1,2,3,3,2,5,1,1,1,1,1,1,1,1,1,5,1,1,1,1,1,1,1,1,1,1.375,0,1,0,1.4,0,2.111111111111111,0,1.75,0,0.8333333333333334,0,0.8571428571428571,0,1,0,1.5135135135135136,0,0,0,0,-0.8473115880114084,-1.014636397091459,-0.7372407672780129,-0.8759385821847359,5,1,5,1,1,1,3,1.2857142857142858,0,2,-0.3631965189619651,5,5,5,5,4,4,1,4.714285714285714,0,1.2857142857142858,-0.1748077221195339,0,1,3,2,4,2,2,5,2,3,3,1,1,3,4,4,1,5,1,5,3,2.4,0,4,0,4.2,0,3.6,0,3.933333333333333,0,2,1,3,3,1,3,3,4,3,3,2,3,3,3,1,2,1,3,2,3,2.25,0,"White, Caucasian, Anglo, European American",0,30,1,2,NA,5,2,0,0,1,0,0,TRUE,TRUE,TRUE,TRUE,TRUE,0,2,0.9792903225792031,0.62,0.06825520449297964,2,0.5632875000005588,0.6372724137927951,1,0.90625,0.0069835624193429514,0.013751682540539246,2,0.884878125003539,1.4514379310376686,1,1,0.03535617789282836,0.25000669243792767,1.5002,0.3439,0.463,1.037,0.4521,0.7204,0.6062,1.5150378066666668,0.51247278436,0.4563487846666667,1.1888,3.4956,0.3932,2.4509,0.4279,-49.7157,1.1192,5.8441,0.4687,2.5863,0.4423,0.9819,1.387756452,2.7143219266666665,3.8881287666666666,0.40644335966666667,0.3802180826666667,2.115,3.175,0.5479,1.5316,0.8255,0.9907,0.149,0.381,0.273,0.004,1.873,468.25,104,0.3081481481481481,1,0,0,1,FALSE,FALSE,FALSE
4,2021-11-12T20:10:50Z,1,1.7777777777777777,1080,6,4,3,4,4,5,2,1,5,3,2,2,3,4,2,3,3,3,4,1,3,2,1,2,5,2,4,0,0,4,5,3,4,5,5,4,5,5,2,4,2,4,4,4,5,2,2,1,3,3,5,1,1,1,2,1,3,4,5,5,5,3,1,1,1,1,3,3,3,5,2.625,0,3.5,0,2.2666666666666666,0,1.5555555555555556,0,2.3333333333333335,0,1,0,3,0,1,0,2,0,1,0,0,0.2327977159502012,0.10406499300426954,0.24986373369091455,0.17696436334759205,5,3,2,1,1,2,3,2.142857142857143,0,2.5,0.33410042935609163,5,4,5,4,3,4,5,3.7142857142857144,0,2.2857142857142856,-1.0219528370065065,0,4,3,4,5,4,4,4,3,5,5,5,3,3,4,3,5,3,2,4,5,4,0,2.6,0,3.4,0,2.4,0,2.8,0,2,3,1,2,3,2,4,2,1,1,3,1,2,1,1,3,1,2,1,1,2.05,0,"White, Caucasian, Anglo, European American",0,23,0,1,NA,5,2,0,0,0,0,0,TRUE,TRUE,TRUE,TRUE,TRUE,0,2,0.7565170731733485,0.82,0.020608396146742692,2,0.47689666666686537,0.582609374997206,0.967741935483871,1,0.007027707225293465,0.020265348619957296,2,0.6721593750026077,0.7561483870965819,1,1,0.01767298700535223,0.026144731913724486,1.2143,1.3358,0.4566,0.8996,1.8156,0.594,0.3668,1.261374892,1.1691625763333333,0.44842317233333334,1.6462,3.4146,0.2454,4.0791,0.3808,-54.2693,1.1542,4.7016,0.3509,4.6782,0.4429,0.9983,1.6789280033333334,4.0208061866666664,3.5915726433333335,0.374508122,0.24574963933333333,1.0601,4.7451,0.5595,2.8434,0.5787,0.9895,0.127,0.404,0.481,0.013,1.259,96.84615384615384,104,0.3081481481481481,1,1,11,12,FALSE,FALSE,FALSE
5,2021-11-12T19:50:08Z,0.8999999761581421,1.7777777777777777,1080,6,4,5,5,2,5,2,1,5,1,1,1,1,5,1,5,3,1,1,1,1,1,1,1,1,4,2,0,0,4,5,5,5,5,5,5,5,5,1,5,1,1,5,1,5,1,1,1,1,1,5,1,1,1,5,1,1,5,5,1,5,1,1,1,1,1,1,1,3,3,1,0,2,0,1.2666666666666666,0,1.1111111111111112,0,1,0,1.5,0,2,0,1,0,1.3513513513513513,0,2,0,0,-1.1814310030501165,-1.3027808890723365,-0.01745100881601569,-0.6601159489441761,4,3,4,2,3,3,3,2.5714285714285716,0,8,2.619934196080626,4,4,4,4,2,2,1,3.5714285714285716,0,2.4285714285714284,0.38995568780511447,0,4,5,2,3,3,4,3,4,4,4,3,4,1,5,4,4,2,5,4,4,3.4,0,2.4,0,3.6,0,3,0,3,0,1,1,1,4,1,1,4,4,1,1,1,3,1,1,1,4,1,1,1,1,1.2,0,"White, Caucasian, Anglo, European American",0,23,0,1,NA,5,2,0,0,0,0,0,TRUE,TRUE,TRUE,TRUE,TRUE,0,NA,NA,NA,NA,6,0.4833451612918608,0.5990677419367336,1,0.96875,0.008427499892490739,0.023712034989482954,6,0.8268968750010245,0.8990187499998137,1,1,0.10725188031256856,0.12237486866959332,NA,NA,NA,NA,NA,NA,NA,NA,NA,NA,1.4176,4.1763,0.3136,3.0074,0.3742,-56.1129,0.8965,4.2604,0.3801,3.6162,0.4588,0.9118,1.5421811166666666,3.1861234166666668,4.3628657466666665,0.36314544033333335,0.305464539,1.9852,1.4598,0.3176,1.4976,0.3745,0.4614,0.19,0.059,0.234,0.225,1.541,6.848888888888888,104,0.3081481481481481,1,1,6,7,FALSE,FALSE,FALSE
6,2021-11-12T20:40:27Z,1,1.6,900,4,2,5,4,3,4,3,1,4,2,3,1,3,5,3,4,4,1,3,1,1,2,3,2,2,1,2,0,0,5,5,5,5,5,5,4,5,5,2,4,1,1,4,3,5,2,1,1,1,1,5,1,1,1,3,2,1,5,1,1,3,3,2,1,3,1,2,2,2,2,1.875,0,2,0,2.066666666666667,0,1.1111111111111112,0,1.5,0,1.3333333333333333,0,2.142857142857143,0,1.6666666666666667,0,1.5675675675675675,0,1,0,0,-0.5026852731287158,-0.4900333918726625,-0.22054348261253207,-0.3552884372425973,4,2,5,2,1,2,1,1.5714285714285714,0,1.5,-0.3767559860388676,5,4,5,4,1,1,3,3.2857142857142856,0,2.7142857142857144,-1.0219528370065065,0,1,3,2,3,2,1,5,1,1,3,1,5,2,4,5,1,3,2,4,2,2.2,0,4.4,0,4.2,0,4.6,0,4.4,0,2,1,2,3,3,2,3,3,2,3,1,3,1,2,1,3,3,3,2,2,2.05,0,"White, Caucasian, Anglo, European American",0,20,1,2,NA,5,2,0,1,1,0,1,TRUE,TRUE,TRUE,TRUE,TRUE,0,2,1.02324999998297,0.84,0.07472284746013637,NA,NA,NA,NA,NA,NA,NA,2,1.1711187499687077,1.3209483870767778,1,1,0.15261331963155408,0.20588094791120307,1.4705,1.2037,0.6199,1.2593,1.1734,0.6881,0.109,1.49474122,1.104366796,0.60779243,NA,NA,NA,NA,NA,NA,NA,NA,NA,NA,NA,NA,NA,NA,NA,NA,NA,2.5548,1.452,0.4268,1.3698,0.522,0.7343,0.226,0.237,0.243,0.02,1.909,95.45,104,0.3081481481481481,1,0,0,1,FALSE,FALSE,FALSE
7,2021-11-12T20:50:28Z,0.8999999761581421,1.6,900,4,3,4,3,2,4,1,3,4,2,1,1,3,5,1,5,4,3,1,1,1,3,1,1,1,5,2,0,0,3,5,5,5,5,5,4,5,4,1,5,2,1,5,1,5,4,3,2,2,3,4,1,1,1,3,1,1,4,4,1,4,3,2,1,1,1,2,1,3,3,1.5,0,2.25,0,1.8,0,1.4444444444444444,0,1.8333333333333333,0,1.3333333333333333,0,2.2857142857142856,0,1,0,1.7297297297297298,0,3,0,0,-0.6350722111629208,-0.6960997752879425,0.2640426676977418,-0.21602855379510036,5,2,4,1,1,1,1,1.2857142857142858,0,2,-0.3631965189619651,5,5,5,5,2,1,3,3.7142857142857144,0,2.2857142857142856,-1.3043345419688306,0,2,3,3,4,3,2,5,1,1,4,1,5,3,5,4,1,3,2,4,3,3,0,4.2,0,4.2,0,4.4,0,4.266666666666667,0,3,2,4,2,4,4,4,2,4,4,1,3,3,2,2,2,3,3,4,4,3.1,0,"Asian or Asian American (e.g., Chinese, Japanese, and others)",0,19,1,2,NA,5,2,0,0,0,0,0,TRUE,TRUE,TRUE,TRUE,TRUE,0,5,1.127168750008568,0.64,0.2276926481612541,5,0.5036870967707326,0.6003551724183148,1,0.90625,0.003578048495075049,0.009642999353870502,5,0.8239687500018626,1.0438566666662692,1,0.9375,0.0553570086672784,0.10097657611776177,1.5852,0.3632,0.5607,1.4393,0.267,0.65,0.2025,1.5951191,0.5050545949566667,0.55009396,1.2016,4.3195,0.3646,2.5193,0.3964,-58.3806,0.9005,7.2879,0.4423,3.5221,0.4736,0.9994,1.3598739103333333,2.7759274466666666,4.595060893333334,0.38215961833333334,0.355223449,1.4245,3.1041,0.5678,1.3602,0.7003,0.9658,0.081,0.535,0.21,0.017,2.001,117.70588235294116,104,0.3081481481481481,1,0,1,2,FALSE,FALSE,FALSE
8,2021-11-12T21:14:28Z,0.8999999761581421,1.6,900,4,2,4,4,2,3,1,1,5,1,1,1,2,3,2,4,5,1,2,1,1,1,2,2,2,0,2,0,0,5,5,4,5,5,4,5,5,5,1,3,1,1,3,1,4,2,2,3,3,4,3,1,1,1,3,3,3,1,4,1,2,4,2,1,3,1,2,1,2,4,1.5,0,2.25,0,1.6666666666666667,0,1.2222222222222223,0,2.1666666666666665,0,1.8333333333333333,0,2.5714285714285716,0,1.6666666666666667,0,1.972972972972973,0,0,0,0,-0.4837728534095438,-0.6488661467737779,-0.34523475369180734,-0.4970504502327926,2,4,2,5,5,5,4,4.428571428571429,0,2,1.5170815544512093,5,5,5,4,2,3,3,3.857142857142857,0,2.142857142857143,-0.4571894270818581,0,1,2,2,1,1,1,5,2,1,2,3,4,2,5,4,2,4,1,4,1,1.4,0,4.2,0,3.8,0,4.6,0,4.2,0,2,3,3,4,3,4,4,2,1,2,3,1,4,2,1,1,3,3,2,4,2.8,0,"White, Caucasian, Anglo, European American",0,19,1,2,NA,5,2,0,0,1,0,0,TRUE,TRUE,TRUE,TRUE,TRUE,0,NA,NA,NA,NA,6,0.45028275861822326,0.5163833333333333,0.9666666666666667,0.9375,0.0035171796437376236,0.0038664351534692556,6,0.6012903225806452,0.6385310344901578,0.96875,0.90625,0.00784758103946578,0.008346833830926773,NA,NA,NA,NA,NA,NA,NA,NA,NA,NA,1.0609,3.9948,0.3228,3.2571,0.3704,-68.9227,0.8802,5.8345,0.3715,5.4189,0.4295,0.9871,1.1701058316666666,3.487297703333333,4.267036293333334,0.36359013566666665,0.3166731816666667,0.6433,3.5035,0.5414,3.0738,0.576,0.956,0.056,0.419,0.308,0.03,2.024,67.46666666666667,368,1.0903703703703704,1,0,0,1,FALSE,FALSE,FALSE
9,2021-11-12T21:05:27Z,1,1.7777777777777777,720,3,3,3,4,4,3,3,2,3,4,3,2,5,3,2,3,4,4,5,1,1,3,4,2,3,0,2,0,0,5,4,5,4,4,5,4,4,5,2,5,5,2,4,3,5,2,5,5,5,3,1,1,1,1,1,1,1,1,1,1,5,1,2,1,1,2,1,1,1,1,2.875,0,1,0,2.933333333333333,0,1.5555555555555556,0,3,0,1.5,0,1,0,1.3333333333333333,0,1.945945945945946,0,0,0,0,0.3546777541404215,0.4747715446625703,-0.7372407672780129,-0.1312346113077213,5,2,2,1,1,1,1,1.5714285714285714,0,1,-0.5612498234260587,5,5,5,4,2,2,3,3.7142857142857144,0,2.2857142857142856,0.38995568780511447,0,3,3,3,5,4,4,3,3,2,2,1,3,4,4,4,4,3,4,3,3,3.6,0,3,0,2.4,0,3.6,0,3,0,2,2,3,2,3,3,4,2,2,2,1,2,1,3,1,2,2,3,1,3,2.4,0,"White, Caucasian, Anglo, European American",0,20,1,2,NA,5,2,0,0,1,0,0,TRUE,TRUE,TRUE,TRUE,TRUE,0,1,0.9724891891898335,0.74,0.11390051086141297,1,0.4799218749997672,0.6022833333328367,1,0.9375,0.0026409495061828735,0.009795786088605736,1,0.6559374999993015,0.8810516129030336,1,0.96875,0.009115615967729272,0.04722352861881764,1.5403,0.7126,0.5142,1.227,0.6206,0.666,0.3375,1.5528335566666667,0.7721532363333333,0.5067284106666666,1.2955,4.9896,0.3501,2.9381,0.4013,-68.0203,0.7528,5.1167,0.413,3.8821,0.5053,0.7128,1.4394943553333333,3.157330663333333,5.091249796666666,0.38878430033333333,0.34091475,1.3233,5.4061,0.533,1.8519,0.6127,0.9771,0.101,0.416,0.372,0.008,1.548,193.5,345,1.0222222222222224,1,0,0,1,FALSE,FALSE,FALSE
10,2021-11-12T21:02:28Z,1,1.7786458333333333,768,6,2,5,5,2,4,1,1,5,1,2,5,2,5,1,4,5,1,1,1,1,1,1,1,1,1,2,0,0,4,5,5,5,4,5,5,4,5,1,5,1,1,5,2,5,1,1,2,2,3,5,1,3,1,3,1,1,1,2,1,5,1,2,1,1,1,2,2,1,2,1,0,1.75,0,1.6,0,1.3333333333333333,0,1.4166666666666667,0,1.5,0,1.1428571428571428,0,1,0,1.3783783783783783,0,1,0,0,-1.1646199632997414,-1.14791653328819,-0.2989446853297732,-0.7234306093089816,4,2,2,2,1,2,2,2.142857142857143,0,2.5,0.33410042935609163,4,5,5,3,3,3,1,4,0,2,1.5194825076544112,0,1,1,3,2,3,2,3,1,1,1,1,3,3,4,3,5,2,1,1,5,2,0,3.8,0,1.8,0,3.6,0,3.066666666666667,0,1,1,1,3,2,1,1,2,1,1,2,3,2,1,1,4,1,1,1,1,1.35,0,"Hispanic of Latino (e.g., Mexican American, Central American, and others)",0,27,0,1,NA,5,2,0,0,0,0,0,TRUE,TRUE,TRUE,TRUE,TRUE,0,2,0.9162511627906283,0.86,0.06616325993461322,2,0.4577937499994878,0.5143593749995343,1,1,0.0017245935081051178,0.00221258507058204,2,0.5518562500001862,0.7028266666675608,1,0.967741935483871,0.00456476124987975,0.01368023516125704,1.4727,1.3009,0.5414,0.9296,2.1107,0.7424,0.4902,1.4823341166666666,1.1630438383333332,0.5317738563333333,4.6728,11.3467,0.2519,9.9384,0.2793,-110.735,0.7188,6.5751,0.4033,6.0437,0.4617,0.8125,1.4575716433333334,5.336345213333333,6.32596985,0.38478941733333333,0.349233313,1.0691,5.8403,0.4704,3.1159,0.5523,0.7885,0.098,0.365,0.545,0.012,1.912,159.33333333333331,342,1.0133333333333332,1,0,0,1,FALSE,FALSE,FALSE
11,2021-11-12T21:07:52Z,1,1.7786458333333333,768,6,2,2,5,2,3,4,2,2,2,3,2,3,5,1,4,4,3,4,1,1,2,3,3,1,1,2,0,0,5,2,4,3,5,5,2,4,4,4,5,2,1,3,2,5,1,3,3,4,1,3,1,1,1,3,2,1,1,1,1,4,2,1,1,3,1,2,1,1,1,2.25,0,1.25,0,2.4,0,2.2222222222222223,0,2.1666666666666665,0,1.6666666666666667,0,1.1428571428571428,0,1.6666666666666667,0,1.9189189189189189,0,1,0,0,-0.05088857983738084,-0.034635395644906565,-0.4557470907642554,-0.245191243204581,5,1,2,1,1,1,1,1.4285714285714286,0,1.5,-0.4622231711940119,2,2,2,4,1,2,3,2.2857142857142856,0,3.7142857142857144,0.38995568780511447,0,4,4,2,2,2,1,3,3,2,1,1,5,1,4,3,1,4,2,2,3,2.8,0,4.6,0,3.2,0,3.4,0,3.7333333333333334,0,1,1,1,4,1,1,2,3,1,1,1,3,1,1,1,4,1,1,1,2,1.2,0,"White, Caucasian, Anglo, European American",0,23,1,2,NA,5,2,0,0,1,0,0,TRUE,TRUE,TRUE,TRUE,TRUE,0,4,0.8690575000286103,0.8,0.06632701064763906,4,0.4583500000834465,0.5489225806574668,1,0.96875,0.007580701290978461,0.006242672249080944,4,0.6149718751311303,0.6701531249880791,1,1,0.017071703400719167,0.02549168775148461,1.3768,1.0197,0.4977,1.0492,1.1916,0.6554,0.4853,1.4118440633333333,0.986889621,0.48826966666666666,1.6831,4.1467,0.2554,3.9605,0.3498,-60.6926,0.9147,3.6585,0.3472,3.7415,0.4452,0.9831,1.67788601,3.9073698766666665,4.19750554,0.34773611433333335,0.25575465633333333,1.2708,5.2041,0.4929,2.6713,0.4798,0.661,0.201,0.157,0.417,0.06,1.61,26.833333333333336,360,1.0666666666666667,1,0,0,1,FALSE,FALSE,FALSE
12,2021-11-12T21:02:45Z,1,1.6,900,6,3,2,4,2,4,2,2,3,4,3,2,5,3,2,3,2,4,4,1,1,4,4,4,4,7,2,0,3,4,4,4,3,3,3,3,3,3,2,4,4,3,4,2,4,2,4,4,4,4,2,4,1,1,3,1,1,4,4,4,5,1,1,1,1,1,3,2,4,4,3.25,0,3.25,0,2.8666666666666667,0,2.6666666666666665,0,2.9166666666666665,0,2.1666666666666665,0,2.142857142857143,0,1,0,2.4864864864864864,0,4,0,3,0.9241517256843829,0.8395738927566005,1.3100888930607648,1.0748313929086826,4,2,3,2,2,2,2,2.142857142857143,0,2.5,0.33410042935609163,4,4,4,4,3,3,2,3.7142857142857144,0,2.2857142857142856,0.9547190977297628,0,2,3,3,3,2,3,3,3,2,2,2,3,3,3,3,2,3,2,3,4,2.6,0,3.4,0,3,0,3,0,3.1333333333333333,0,3,1,2,4,2,2,3,3,2,1,2,3,3,3,2,3,2,2,1,2,2,0,"White, Caucasian, Anglo, European American",0,26,1,2,NA,5,2,0,0,1,0,0,TRUE,TRUE,TRUE,TRUE,TRUE,0,3,1.0447829268292819,0.8367346938775511,0.05851560933677633,3,0.5256750000001048,0.5831290322580345,1,1,0.0025811567741905205,0.0027844161290262806,3,0.7734468750000233,0.8307375000000174,1,1,0.005957691602836485,0.006307882419359183,1.5352,1.1668,0.6009,1.1589,1.5982,0.7577,0.4842,1.5409775833333332,1.0723922583333334,0.5899801943333334,10,12.1844,0.1153,12.3001,0.1766,-97.759,0.7324,6.4728,0.4755,6.6698,0.529,0.872,1.9895139366666668,5.731629563333334,5.52479324,0.41720272566666666,0.34949610466666664,1.6872,9.2675,0.6889,10.6639,0.7482,0.9491,0.396,0.329,0.887,0.018,1.271,70.61111111111111,378,1.12,1,0,0,1,FALSE,FALSE,FALSE
13,2021-11-12T21:12:43Z,0.8999999761581421,1.7777777777777777,1080,3,2,5,5,2,5,1,1,5,1,1,1,1,5,3,5,4,2,1,1,1,2,2,1,2,3,1,0,0,5,4,4,5,3,5,4,4,3,1,5,1,1,5,1,5,1,1,1,1,2,3,1,1,3,3,1,1,2,1,1,5,1,1,1,1,1,1,1,1,2,1.5,0,1.25,0,1.2666666666666666,0,1.8888888888888888,0,1.0833333333333333,0,1.8333333333333333,0,1,0,1,0,1.4324324324324325,0,2,0,0,-0.8199936484170486,-1.0530621153704003,-0.25265461696773905,-0.6528583661690697,5,1,3,1,1,2,1,1.4285714285714286,0,2,-0.2777293338068208,5,5,5,5,2,2,2,4,0,2,-1.0219528370065065,0,3,2,3,3,3,2,4,2,2,3,2,4,1,3,4,2,4,3,3,3,2.8,0,3.8,0,3.8,0,3.6,0,3.7333333333333334,0,2,2,2,2,3,3,3,1,2,2,2,2,2,3,2,2,1,2,4,2,2.5,0,"Hispanic of Latino (e.g., Mexican American, Central American, and others) & White, Caucasian, Anglo, European American",1,30,0,1,NA,5,2,0,1,0,0,1,TRUE,TRUE,TRUE,TRUE,TRUE,0,5,1.4878534883718157,0.8775510204081632,0.5048131320833759,5,0.5844812500001862,0.6618354838709197,1,1,0.010016456411251838,0.01750726169897229,5,0.8221406249997671,0.9486687499999534,1,1,0.032586169586893095,0.06833836092750596,2.2116,0.8548,0.5262,2.6327,0.881,0.2997,0.0376,1.98675169,0.814558482,0.5504974986666666,1.7962,4.4165,0.3811,3.8131,0.4263,-58.7509,1.0895,5.0299,0.4592,3.756,0.5149,0.8315,1.9699568033333332,3.86187567,4.4634072,0.4073517016666667,0.3630068513333333,1.763,2.58,0.5152,2.1078,0.5427,0.9264,0.172,0.345,0.337,0.014,1.391,99.35714285714286,326,0.965925925925926,1,0,1,2,FALSE,FALSE,FALSE
14,2021-11-12T21:23:40Z,0.8999999761581421,1.7786458333333333,768,6,1,2,5,3,5,2,3,4,4,3,1,3,3,2,3,4,2,3,4,1,1,4,3,1,7,2,1,2,5,4,3,5,4,5,5,5,3,1,4,1,1,3,1,5,2,2,2,1,3,2,2,1,1,1,1,1,2,1,1,4,2,1,1,1,1,1,2,1,1,2.375,0,1.25,0,2.466666666666667,0,1.6666666666666667,0,1.6666666666666667,0,1.5,0,1.2857142857142858,0,1,0,1.5675675675675675,0,4,1,2,-0.19168103774677378,-0.1032596633017564,0.713062832016679,0.3049015843574613,5,1,5,1,1,1,1,1,0,1,-0.9031185640466358,5,5,5,5,4,3,1,4.571428571428571,0,1.4285714285714286,-1.3043345419688306,0,2,2,2,2,2,2,5,2,2,3,1,4,1,4,4,2,4,2,5,3,2,0,4.2,0,4.4,0,3.8,0,4.133333333333334,0,1,1,1,3,1,2,1,3,2,3,2,4,2,2,2,4,1,3,2,1,1.65,0,"White, Caucasian, Anglo, European American",0,30,1,2,NA,5,2,1,1,0,0,2,TRUE,TRUE,TRUE,TRUE,TRUE,0,4,0.7646774193856024,0.62,0.07912295564796706,4,0.42638064509053386,0.510173333311081,0.96875,0.9375,0.0034786586987303352,0.005321731837819333,4,0.5285187499672175,0.6206499999682108,1,0.9375,0.00918655577071163,0.00943996587942089,1.4592,0.3443,0.2709,1.3004,0.2824,0.3976,0.358,1.4667654633333334,0.52290963561,0.2705328696666667,0.8426,3.9829,0.3273,3.1483,0.3878,-79.205,0.8839,5.0985,0.3402,4.2651,0.4051,0.9122,0.9457493336666667,3.408253986666667,4.313353413333333,0.37961630166666666,0.32123069033333335,1.737,6.6263,0.3868,7.8489,0.5068,0.9358,0.074,0.363,0.475,0.016,1.987,124.1875,326,0.965925925925926,1,0,0,1,FALSE,FALSE,FALSE
15,2021-11-12T21:44:46Z,1,1.6,900,7,3,4,4,2,4,3,2,4,2,2,2,3,5,2,4,5,2,3,1,1,1,3,2,3,0,2,0,0,5,3,5,4,4,5,5,5,5,2,4,1,1,5,2,5,2,3,3,3,1,5,1,1,1,1,1,1,1,2,1,4,3,2,1,1,1,1,1,1,2,2,0,1.25,0,2,0,1.4444444444444444,0,1.8333333333333333,0,0.8333333333333334,0,1.5714285714285714,0,1,0,1.5135135135135136,0,0,0,0,-0.4585562937839808,-0.4881943776477256,-0.6588395645607719,-0.5735169711042487,4,2,4,1,2,2,1,1.7142857142857142,0,1.5,-0.2912888008837234,5,5,5,5,3,2,1,4.285714285714286,0,1.7142857142857142,-1.869097951893479,0,2,2,3,3,3,2,4,2,2,3,1,2,2,4,5,2,5,1,4,3,2.6,0,4.2,0,3.8,0,4,0,4,0,2,1,1,3,2,2,2,2,1,3,2,4,2,1,2,4,2,2,2,1,1.75,0,"White, Caucasian, Anglo, European American",0,29,1,2,NA,5,2,0,0,1,0,0,TRUE,TRUE,TRUE,TRUE,TRUE,0,1,0.9518543478302334,0.92,0.016351335685178818,1,0.4511933332125346,0.5524129032627229,0.9375,1,0.0022516503220970396,0.003915803825280631,1,0.5787593750059604,0.7037499999701977,1,1,0.004875701847163053,0.003494584518905762,1.3887,2.0299,0.6733,0.6149,3.0987,0.895,0.2812,1.3649154733333333,1.507674351,0.6629479353333333,1.5231,3.8554,0.2746,4.4238,0.3803,-65.4942,0.6136,5.9534,0.4023,4.5013,0.5017,0.9557,1.5754345966666667,4.35394488,4.007471583333333,0.373918555,0.2711354463333333,0.9633,4.2348,0.4729,5.7973,0.617,0.9984,0.151,0.363,0.731,0.011,1.584,144.00000000000003,437,1.2948148148148149,1,0,0,1,FALSE,FALSE,FALSE
16,2021-11-12T21:58:52Z,0.8999999761581421,1.7708333333333333,768,4,2,4,4,2,4,3,1,4,2,3,1,2,4,2,4,3,1,1,1,1,1,1,1,1,2,4,0,0,4,4,5,3,2,4,4,5,4,3,4,1,1,4,4,1,1,1,1,1,2,5,1,1,1,1,1,1,2,1,1,4,1,2,1,1,1,1,1,2,1,1,0,1.25,0,2.066666666666667,0,2.111111111111111,0,2,0,0.8333333333333334,0,1.2857142857142858,0,1,0,1.6756756756756757,0,1,0,0,-0.9796985260456136,-0.8196040990257993,-0.4557470907642554,-0.6376755948950273,2,3,1,3,1,4,3,3.2857142857142856,0,3,1.202331747984437,3,3,4,3,1,1,3,2.5714285714285716,0,3.4285714285714284,0.6723373927674386,0,2,3,3,2,3,3,4,2,3,2,4,3,3,4,3,4,3,1,4,3,2.6,0,3.2,0,3,0,3.4,0,3.2,0,2,2,3,2,3,3,3,2,2,1,2,2,3,3,2,2,1,1,1,2,2.3,0,"Hispanic of Latino (e.g., Mexican American, Central American, and others)",0,26,0,1,NA,5,2,0,0,1,0,0,TRUE,TRUE,TRUE,TRUE,TRUE,0,6,0.7918545454545793,0.8979591836734694,0.07293664807853319,6,0.5004677419358444,0.5766033333331346,0.96875,0.9375,0.010441729032231615,0.008766817247975399,6,0.6216586206890643,0.6261599999999007,0.9354838709677419,0.9375,0.01728918262363172,0.007168919314474632,1.4399,1.6201,0.4391,1.3961,2.2032,0.4615,0.1222,1.42244991,1.3245311926666667,0.4331235563333333,0.9605,3.8327,0.3833,2.8924,0.4277,-68.7786,1.082,5.8115,0.3945,5.5441,0.465,0.8642,1.0939429526666666,3.1503943166666666,4.127415403333333,0.415941281,0.374015687,0.853,2.6042,0.4905,3.9717,0.5251,0.9078,0.057,0.428,0.303,0.018,1.405,78.05555555555556,104,0.3081481481481481,1,0,0,1,FALSE,FALSE,FALSE
17,2021-11-12T22:07:46Z,0.4000000059604645,1.6,800,4,3,4,4,2,4,2,1,3,3,2,1,2,4,3,2,4,4,3,5,1,1,2,2,2,0,1,0,1,5,4,4,5,5,4,4,5,5,2,3,1,1,4,3,4,5,3,3,2,2,1,2,5,1,5,2,1,1,1,1,5,2,3,1,3,2,3,2,1,1,2.5,0,1.75,0,2.2,0,1.4444444444444444,0,2.4166666666666665,0,3.1666666666666665,0,1.2857142857142858,0,2,0,2.108108108108108,0,0,0,1,0.22229081610621654,0.06815582050682095,-0.32558751222710886,-0.12871584586014395,5,1,5,1,1,2,1,1.1428571428571428,0,1.5,-0.6331575415043005,4,3,4,4,4,3,2,3.7142857142857144,0,2.2857142857142856,1.5194825076544112,0,3,2,2,3,3,4,5,4,3,3,1,4,4,4,3,2,5,1,4,5,2.6,0,4.2,0,3.6,0,2.6,0,3.466666666666667,0,3,2,1,2,3,1,2,3,2,3,2,3,2,2,1,2,1,1,1,2,1.95,0,"Hispanic of Latino (e.g., Mexican American, Central American, and others) & White, Caucasian, Anglo, European American",1,21,0,1,NA,5,2,0,0,2,0,0,TRUE,TRUE,TRUE,TRUE,TRUE,0,4,0.8236190476190379,0.84,0.050091154693875005,4,0.40571875,0.4669333333333333,1,0.967741935483871,0.0013853054435491604,0.006540703225807003,4,0.6704062500000013,0.7580666666666701,1,0.9375,0.010106700604839033,0.016929661290322546,1.3998,1.3136,0.4848,1.0047,1.8901,0.6313,0.2325,1.41804604,1.1723443466666668,0.47716168966666667,1.2845,5.838,0.2957,3.9241,0.3105,-85.7524,0.8128,7.4949,0.3573,3.8441,0.3734,0.8983,1.279277497,3.9008961533333335,5.47774148,0.3104176733333333,0.292878766,1.1276,3.4761,0.5166,2.5737,0.5723,0.9745,0.07,0.497,0.386,0.017,1.813,106.6470588235294,418,1.2385185185185186,1,0,0,1,FALSE,FALSE,FALSE
19,2021-11-12T22:02:26Z,1,1.7777777777777777,720,3,3,4,5,4,5,4,1,4,2,2,2,1,4,3,5,4,2,2,1,2,2,2,2,2,1,2,1,1,4,5,4,4,4,4,4,4,4,1,5,3,1,4,4,3,2,3,3,4,4,3,3,1,1,1,1,1,2,1,1,4,2,2,1,1,1,2,2,1,1,1.875,0,1.5,0,2,0,1.8888888888888888,0,2.5833333333333335,0,1.5,0,1.4285714285714286,0,1,0,1.945945945945946,0,1,1,1,-0.2673307166234623,-0.35607572411937555,0.005736966445190152,-0.1751693788370927,4,2,3,1,1,1,2,1.7142857142857142,0,1,-0.4757826382709144,4,4,4,4,2,3,2,3.5714285714285716,0,2.4285714285714284,0.10757398284279028,0,2,4,3,3,3,2,4,2,2,4,1,5,2,2,3,2,4,2,5,4,3,0,4.4,0,4.2,0,3,0,3.8666666666666667,0,2,2,3,1,3,2,2,1,1,1,3,3,3,3,2,3,1,3,3,3,2.45,0,"Asian or Asian American (e.g., Chinese, Japanese, and others)",0,21,1,2,NA,5,2,1,0,1,0,1,TRUE,TRUE,TRUE,TRUE,TRUE,0,5,1.0950250000001862,0.8163265306122449,0.24057081266145336,5,0.4422857142859804,0.5767035714286779,0.9333333333333333,0.9655172413793104,0.020525805471291198,0.054881940049376333,5,0.546512499999837,0.6515218749999767,1,1,0.0068864514516115615,0.011847543054418225,1.9876,0.8302,0.3872,1.4828,0.7166,0.6353,0.1875,1.84765118,0.8089462193333333,0.394004627,1.0708,3.1339,0.3278,2.189,0.3433,-39.0535,0.9303,4.3556,0.3427,3.4232,0.4021,0.9901,1.166605544,2.4589540863333332,3.43210159,0.33500820033333334,0.31967820166666666,1.0188,4.8132,0.4398,3.3851,0.5118,0.9047,0.118,0.333,0.549,0.013,1.544,118.76923076923077,368,1.0903703703703704,1,0,3,4,FALSE,FALSE,FALSE
20,2021-11-12T22:09:08Z,1,1.7777777777777777,864,7,3,5,4,3,4,5,2,3,2,2,2,2,4,2,4,4,2,2,1,2,1,1,1,1,3,2,0,0,4,5,5,4,4,5,3,5,5,3,4,1,2,5,2,3,4,1,1,1,1,5,1,1,1,3,1,1,2,1,1,5,2,2,1,2,1,2,1,1,1,1.375,0,1.25,0,2.2666666666666666,0,1.5555555555555556,0,1.8333333333333333,0,1.1666666666666667,0,1.2857142857142858,0,1.3333333333333333,0,1.5675675675675675,0,2,0,0,-0.8136895085106579,-0.6189579680629647,-0.25265461696773905,-0.43580629251535186,3,4,3,2,3,3,2,2.857142857142857,0,1,0.20795484297024003,4,5,5,3,3,3,2,3.857142857142857,0,2.142857142857143,0.6723373927674386,0,1,2,2,1,1,2,4,2,2,3,1,4,3,4,4,2,4,2,3,3,1.4,0,4.2,0,3.4,0,3.8,0,3.8,0,2,1,1,3,1,1,2,2,2,1,1,3,1,1,1,3,1,1,1,2,1.45,0,"Hispanic of Latino (e.g., Mexican American, Central American, and others)",0,22,1,2,NA,5,2,1,1,0,0,2,TRUE,TRUE,TRUE,TRUE,TRUE,0,3,0.9916636363737511,0.673469387755102,0.05409282938603563,3,0.5515612903218116,0.62767666665713,1,1,0.012858842452420286,0.007681085985795044,3,0.608018750000745,0.6681312499940395,1,1,0.017231462857402804,0.016045314477288568,1.4585,0.5385,0.5524,0.9642,0.4736,0.8028,0.4451,1.48818693,0.6622926697666667,0.543113682,2.2189,4.8548,0.323,5.129,0.4114,-65.0592,0.9636,4.6404,0.4365,4.5499,0.5245,0.9481,1.9382401133333333,4.46397604,4.51816722,0.41418025,0.3359234446666667,1.03,3.6458,0.479,2.4983,0.5246,0.9783,0.131,0.271,0.388,0.017,1.509,88.76470588235293,330,0.9777777777777777,1,0,0,1,FALSE,FALSE,FALSE
21,2021-11-12T22:19:45Z,0.8999999761581421,1.7786458333333333,768,4,2,3,3,5,1,5,5,2,5,3,5,4,2,2,1,1,5,5,2,1,5,5,5,5,1,4,0,0,5,1,1,1,2,5,1,2,3,1,1,5,2,2,3,4,5,5,5,5,4,2,1,5,1,3,1,1,1,1,1,1,5,5,2,5,3,2,1,1,1,4.125,0,1.25,0,4.2,0,3.6666666666666665,0,3.8333333333333335,0,2.3333333333333335,0,2.5714285714285716,0,3.3333333333333335,0,3.324324324324324,0,1,0,0,1.9895513698644145,2.1486616502444646,-0.4557470907642554,0.8464572797401047,5,1,5,1,1,2,4,1.5714285714285714,0,1,-0.5612498234260587,3,3,3,3,1,1,5,2.142857142857143,0,3.857142857142857,-0.1748077221195339,0,2,3,3,3,3,1,5,1,1,1,1,5,2,4,5,3,5,3,4,4,2.8,0,4.6,0,3.4,0,4.2,0,4.066666666666666,0,3,4,4,2,3,4,4,3,2,2,3,2,1,4,2,2,4,4,1,4,3,0,"White, Caucasian, Anglo, European American",0,26,1,2,NA,5,2,0,0,1,0,0,TRUE,TRUE,TRUE,TRUE,TRUE,0,5,1.1427500000012418,0.72,0.24515518605829242,5,0.4589624999994412,0.5209666666651765,1,0.9375,0.0020326069354378363,0.005592460877136473,5,0.6563312499998137,0.766737500000745,1,1,0.011822138347119836,0.017611547580263502,1.9952,0.4515,0.5583,1.3498000000000001,0.4959,0.7151,0.1831,1.7783538133333334,0.6146417411666667,0.482033452,1.3961,6.2593,0.3474,3.0351,0.3142,-76.0975,0.7879,6.3617,0.3983,4.6098,0.4415,0.988,1.4183146653333334,3.1358515133333333,5.7864643566666665,0.312984823,0.341169551,1.1538,4.983,0.5439,2.7445,0.5924,0.9651,0.169,0.34,0.536,0.011,1.419,129,104,0.3081481481481481,1,1,0,1,FALSE,FALSE,FALSE
22,2021-11-12T22:29:16Z,1,1.7777777777777777,864,8,3,3,4,2,4,4,2,1,2,2,2,1,4,2,4,4,2,3,1,1,1,2,2,3,6,2,0,0,4,4,4,3,2,4,3,4,3,4,4,2,1,3,2,4,1,1,3,4,2,4,1,1,1,4,4,1,3,3,1,5,1,2,1,2,1,3,1,2,1,1.875,0,1.75,0,2.3333333333333335,0,2.5555555555555554,0,2.25,0,2,0,1.5714285714285714,0,1.3333333333333333,0,2.135135135135135,0,3,0,0,-0.1496534383708357,-0.13152240823236297,0.10724026226325957,-0.0121410729845517,4,2,3,1,1,2,1,1.7142857142857142,0,2,-0.10679496349653231,4,3,3,3,2,2,3,2.857142857142857,0,3.142857142857143,-1.3043345419688306,0,2,3,3,4,3,2,4,4,3,2,1,4,2,4,4,2,4,2,3,4,3,0,4.2,0,3.4,0,3,0,3.533333333333333,0,1,3,3,3,3,4,3,3,1,2,4,3,4,4,2,3,3,3,1,2,2.55,0,"Hispanic of Latino (e.g., Mexican American, Central American, and others) & White, Caucasian, Anglo, European American",1,27,1,2,NA,5,2,0,1,1,0,1,TRUE,TRUE,TRUE,TRUE,TRUE,0,3,1.0055894736843674,0.7916666666666666,0.04085619283241332,3,0.46871875,0.5428906249997671,1,1,0.004450998991880109,0.0038870002317387873,3,0.6698687499994412,0.7561312499991618,1,1,0.006790331249905847,0.004374800927467103,1.3402,1.0797,0.6616,1.0989,1.1212,0.7565,0.047,1.3928824033333334,1.0277613123333333,0.6489708133333333,2.8381,7.1611,0.2706,7.1381,0.3441,-91.3813,0.8492,5.8153,0.3918,5.5857,0.4673,0.9511,1.7774294933333332,5.24521851,5.395781706666667,0.37959404933333335,0.30760003533333335,0.8754,4.6208,0.5899,4.5618,0.6691,0.9703,0.19,0.38,0.648,0.014,1.447,103.35714285714286,392,1.1614814814814816,1,0,0,1,FALSE,FALSE,FALSE
23,2021-11-12T22:27:46Z,1,1.7777777777777777,864,3,2,5,5,2,5,2,1,5,2,1,2,1,4,1,5,4,1,2,1,1,1,1,1,1,0,2,0,0,4,5,3,5,5,5,3,5,4,1,5,1,2,3,2,3,2,1,1,2,2,4,1,1,1,2,1,1,1,1,1,5,1,2,1,1,1,2,1,2,2,1.125,0,1.75,0,1.4,0,1.6666666666666667,0,1.75,0,1.1666666666666667,0,1,0,1,0,1.4864864864864864,0,0,0,0,-1.0196247454527547,-1.1336883706005216,-0.5020371591262895,-0.8178627648634056,3,2,3,1,1,2,2,2,0,1,-0.3048482679606258,5,5,5,4,3,3,1,4.285714285714286,0,1.7142857142857142,0.9547190977297628,0,2,2,2,3,2,2,3,2,2,1,1,4,3,3,5,2,5,2,3,3,2.2,0,4.4,0,2.8,0,3.8,0,3.6666666666666665,0,1,1,1,3,3,1,1,2,1,1,1,3,1,2,1,3,1,2,1,2,1.5,0,"Asian or Asian American (e.g., Chinese, Japanese, and others)",0,20,0,1,NA,5,2,0,0,1,0,0,TRUE,TRUE,TRUE,TRUE,TRUE,0,4,0.8770547619047742,0.8571428571428571,0.25828227500001,4,0.47334193548386644,0.5223062500000014,1,1,0.0043476191827964365,0.0026575025403204875,4,0.5698718749999753,0.6431812500000087,1,1,0.011832676925406781,0.01860986415322154,1.6873,1.1125,0.361,1.2901,1.6094,0.4675,0.1425,1.6380477566666667,1.0292495186666666,0.36105304066666666,1.98,6.2353,0.3146,7.2168,0.3851,-97.5608,0.9244,4.8654,0.3799,6.3665,0.4479,0.973,1.5605115193333334,5.68601595,5.25195407,0.39262890933333333,0.3279199253333333,0.869,3.5149,0.4702,3.5004,0.5321,0.973,0.241,0.143,0.563,0.023,1.745,75.86956521739131,386,1.1437037037037037,1,0,0,1,FALSE,FALSE,FALSE
24,2021-11-12T22:39:01Z,1,1.6,900,4,2,1,4,2,4,3,3,4,3,2,3,3,4,2,3,3,2,5,5,2,2,2,4,2,1,3,2,6,3,4,4,4,4,4,4,4,4,1,5,2,1,4,2,5,3,3,2,2,2,1,4,5,5,5,1,1,2,2,2,4,2,3,1,1,1,2,2,2,2,3,0,2,0,2.6666666666666665,0,2.111111111111111,0,1.8333333333333333,0,4,0,1.8571428571428572,0,1,0,2.2432432432432434,0,1,2,6,0.6173502502400353,0.5416535883168487,1.2514208139685998,0.8965372011427243,4,2,3,2,2,2,2,2.142857142857143,0,6.5,1.8100511284536203,3,4,4,4,1,1,3,2.857142857142857,0,3.142857142857143,-0.7395711320441822,0,3,3,3,3,3,3,5,3,2,5,2,3,3,2,4,1,4,1,5,2,3,0,3.8,0,4.6,0,3.4,0,3.933333333333333,0,2,3,3,3,3,4,3,1,3,3,4,2,3,3,2,2,3,3,3,3,3,0,"Hispanic of Latino (e.g., Mexican American, Central American, and others)",0,20,1,3,NA,5,2,0,0,1,0,0,TRUE,TRUE,TRUE,TRUE,TRUE,0,4,1.5061000000019558,0.6666666666666666,0.43405604040769585,4,0.5911406250018626,0.6670516129025529,1,0.96875,0.008561564425707708,0.011679715444033909,4,0.8263406249987892,1.0022516129021684,1,1,0.027641856683509092,0.01588851991351925,2.2482,0.333,0.3583,1.9247,0.3343,0.6276,0.5547,2.03640568,0.41203402333333333,0.37564348,1.486,4.1433,0.4118,2.931,0.4343,-53.2203,1.0492,4.2395,0.4686,3.5994,0.5429,0.8224,1.7943899333333333,3.22458671,4.43003719,0.406102002,0.38730774533333334,1.2243,2.8338,0.6219,3.5723,0.8537,0.9278,0.264,0.336,0.552,0.004,1.084,271,104,0.3081481481481481,1,0,0,1,FALSE,FALSE,FALSE
25,2021-11-12T22:39:18Z,1,1.7777777777777777,720,3,3,5,4,2,4,4,1,2,1,3,3,1,4,2,5,4,1,2,1,1,1,1,1,2,1,2,0,0,3,5,4,1,3,2,1,4,4,3,4,1,1,4,1,4,5,1,3,4,4,3,1,1,1,3,1,1,3,3,1,5,1,1,1,1,1,4,4,2,3,1.25,0,3.25,0,2.066666666666667,0,3,0,2.4166666666666665,0,1.5,0,1.4285714285714286,0,1,0,2.1621621621621623,0,1,0,0,-0.5215976928478879,-0.5031000718919498,0.1714625309736735,-0.16581877045913818,5,1,3,1,1,1,1,1.2857142857142858,0,1.5,-0.5476903563491562,5,5,5,3,3,2,1,4,0,2,-1.3043345419688306,0,1,2,2,4,2,1,3,1,2,1,2,3,3,4,3,4,1,1,4,2,2.2,0,3.6,0,2.6,0,4,0,3.4,0,1,3,1,1,1,2,1,3,3,2,1,4,3,2,1,3,2,2,2,1,1.85,0,Middle Eastern,0,20,1,2,NA,5,2,0,0,1,0,0,TRUE,TRUE,TRUE,TRUE,TRUE,0,3,1.6458677419354357,0.6326530612244898,0.4137756466670948,NA,NA,NA,NA,NA,NA,NA,NA,NA,NA,NA,NA,NA,NA,2.3779,0.2444,0.4333,2.0769,0.155,0.7467,0.6156,2.12674151,0.32471295687333335,0.45070698866666664,NA,NA,NA,NA,NA,NA,NA,NA,NA,NA,NA,NA,NA,NA,NA,NA,NA,NA,NA,NA,NA,NA,NA,NA,NA,NA,NA,NA,NA,104,0.3081481481481481,1,0,0,1,FALSE,FALSE,FALSE
26,2021-11-12T22:38:41Z,1,1.7786458333333333,768,5,1,2,2,5,2,5,3,1,5,4,3,4,2,3,2,1,3,3,1,2,2,4,5,3,5,2,0,0,4,5,1,4,5,5,5,5,4,3,4,3,1,1,3,5,5,3,3,5,5,1,2,5,1,5,3,1,3,1,2,2,5,4,1,2,1,2,2,2,1,2.875,0,1.75,0,4.133333333333334,0,1.7777777777777777,0,3.25,0,3.3333333333333335,0,2.7142857142857144,0,1.3333333333333333,0,2.7027027027027026,0,3,0,0,0.8253868671509286,1.3156849965704867,0.10724026226325957,0.7114626294168731,3,3,2,3,3,5,2,3.2857142857142856,0,1,0.4643563984356728,4,4,2,2,1,1,5,2.142857142857143,0,3.857142857142857,0.6723373927674386,0,3,2,3,3,2,1,5,2,1,4,1,5,1,5,5,1,5,1,5,2,2.6,0,5,0,4.8,0,4.6,0,4.8,0,2,1,4,2,3,4,4,2,4,2,4,2,3,4,2,2,1,4,4,4,3.1,0,"White, Caucasian, Anglo, European American",0,22,1,2,NA,5,2,0,0,0,0,0,TRUE,TRUE,TRUE,TRUE,TRUE,0,5,1.0152051282052237,0.78,0.22102502866935056,5,0.5971156249998603,0.6701093750001164,1,1,0.010192976844729376,0.014367682167323486,5,0.6564875000002212,0.7219812500000699,1,1,0.018941939838805093,0.014262549314493351,1.6257,0.7875,0.4517,1.3177,0.9978,0.5902,0.3763,1.6099896333333332,0.816253205,0.448653284,1.5575,3.7298,0.3883,3.9964,0.4752,-60.1127,1.3932,5.0524,0.4549,3.5551,0.474,0.9768,1.9655842066666667,4.166649586666667,4.173819043333333,0.4354914386666667,0.359279004,1.211,4.0162,0.5062,3.7204,0.5857,0.8781,0.228,0.246,0.561,0.018,1.519,84.38888888888889,365,1.0814814814814815,1,0,0,1,FALSE,FALSE,FALSE
27,2021-11-12T22:43:50Z,1,1.7777777777777777,864,4,3,2,3,4,3,5,3,3,3,2,3,3,3,2,3,2,1,3,1,1,2,2,3,2,2,2,0,0,5,4,3,4,5,5,3,3,4,3,4,2,2,3,2,5,4,3,3,4,4,3,1,1,1,2,1,2,2,3,2,3,3,3,1,1,1,2,1,2,2,1.875,0,1.75,0,3.2,0,2,0,2.75,0,1.3333333333333333,0,2.4285714285714284,0,1,0,2.189189189189189,0,1,0,0,-0.11603135887008498,0.2641560207961311,-0.2989446853297732,-0.01739433226682105,4,1,3,1,1,2,2,1.7142857142857142,0,1,-0.4757826382709144,5,4,5,4,3,1,2,3.7142857142857144,0,2.2857142857142856,-0.7395711320441822,0,4,3,3,4,4,3,5,3,3,3,3,3,5,2,4,3,3,2,3,3,3.6,0,3.2,0,3,0,3,0,3.066666666666667,0,2,4,4,3,4,3,4,1,1,1,3,2,2,3,1,3,3,3,2,4,2.75,0,"White, Caucasian, Anglo, European American",0,18,1,2,NA,5,2,0,0,1,0,0,TRUE,TRUE,TRUE,TRUE,TRUE,0,1,0.8565363636369054,0.66,0.08779950628873678,1,0.42161562500102445,0.4971866666674614,1,0.9375,0.002205771038216012,0.006072185876910743,1,0.6324281249986962,0.8615032258072207,1,0.96875,0.017245356280493392,0.036395634152822834,1.4818,0.4723,0.3723,1.0814,0.5057,0.5759,0.4117,1.4958987633333334,0.6093733861,0.368434172,1.3822,5.3412,0.2922,3.2562,0.3131,-72.5264,0.6733,6.5006,0.374,4.0644,0.4251,0.9735,1.4156214863333334,3.361777226666667,5.2340965,0.3113470016666667,0.288419073,1.395,4.2868,0.4688,2.3166,0.5874,0.9807,0.108,0.385,0.429,0.005,1.364,272.8,382,1.1318518518518519,1,0,0,1,FALSE,FALSE,FALSE
28,2021-11-12T22:54:46Z,1,1.7777777777777777,864,4,3,1,2,4,1,4,4,1,2,1,4,2,3,2,1,1,3,4,5,1,3,2,4,5,0,2,0,8,1,1,3,2,3,1,1,1,3,4,2,1,1,3,1,5,3,5,5,5,5,1,1,5,4,2,1,1,1,1,1,5,1,1,3,5,1,1,1,1,1,3.375,0,1,0,3.6666666666666665,0,4.222222222222222,0,3.1666666666666665,0,2.8333333333333335,0,0.8571428571428571,0,3,0,2.972972972972973,0,0,0,6,1.3045015000366231,1.4461582163186295,0.32145711411707156,0.8838076652178506,3,3,2,3,3,3,2,3,0,1,0.2934220281253842,2,2,2,2,1,1,5,1.5714285714285714,0,4.428571428571429,0.6723373927674386,0,4,4,4,4,4,2,4,3,1,4,1,4,1,3,4,5,4,2,2,4,4,0,4.2,0,3.2,0,3.4,0,3.6,0,2,4,4,4,4,4,4,1,2,3,3,1,4,4,2,1,3,3,3,3,3.25,0,"Black or African American & Hispanic of Latino (e.g., Mexican American, Central American, and others) & White, Caucasian, Anglo, European American",1,21,1,2,NA,5,2,0,0,1,0,0,TRUE,TRUE,TRUE,TRUE,TRUE,0,NA,NA,NA,NA,6,0.5425266666667226,0.5799481481482378,0.9375,0.8709677419354839,0.014538096088717579,0.008632234903221856,6,0.7395406249999069,0.750846666666648,1,0.967741935483871,0.022694410876999707,0.022931051569929493,NA,NA,NA,NA,NA,NA,NA,NA,NA,NA,1.1772,2.1826,0.2967,2.0986,0.3556,-25.354,0.9176,3.2793,0.4088,3.3707,0.4522,0.9548,1.269965088,2.3598851733333333,2.5113695633333335,0.3475473416666667,0.2910460443333333,1.2848,2.9379,0.5389,3.568,0.5638,0.9948,0.071,0.52,0.374,0.035,1.77,50.57142857142857,104,0.3081481481481481,1,1,1,2,FALSE,FALSE,FALSE
29,2021-11-12T22:16:03Z,0.8999999761581421,1.7786458333333333,768,4,2,2,4,2,4,3,1,4,3,3,1,4,3,1,3,4,4,4,1,1,3,4,3,3,7,2,0,0,5,4,4,5,4,5,5,5,5,1,4,4,1,4,2,5,5,4,4,5,5,4,1,1,1,5,3,2,4,4,4,3,3,2,1,3,1,4,2,4,4,2.875,0,3.5,0,2.4,0,1.3333333333333333,0,3,0,2,0,3,0,1.6666666666666667,0,2.3783783783783785,0,4,0,0,0.623654390146426,0.4314095250430094,0.8591411550804637,0.6452753400617366,4,1,1,1,1,1,2,1.8571428571428572,0,1,-0.39031545311577004,3,5,4,4,1,1,4,2.857142857142857,0,3.142857142857143,0.9547190977297628,0,3,3,3,2,3,2,4,5,2,2,1,4,1,4,5,2,4,1,4,3,2.8,0,4.4,0,3.8,0,3.4,0,3.8666666666666667,0,3,3,3,1,4,4,2,2,3,3,3,2,3,3,4,2,3,3,3,4,3.2,0,"Hispanic of Latino (e.g., Mexican American, Central American, and others) & White, Caucasian, Anglo, European American",1,23,1,2,NA,5,2,0,0,1,0,0,TRUE,TRUE,TRUE,TRUE,TRUE,0,NA,NA,NA,NA,3,0.4888931034484814,0.6664266666630904,0.9666666666666667,0.967741935483871,0.003378235172406928,0.018910169848988308,3,0.65516451612884,0.9473133333355188,1,0.967741935483871,0.006084081699383791,0.23955729724643765,NA,NA,NA,NA,NA,NA,NA,NA,NA,NA,1.4773,4.1214,0.3202,2.6803,0.4058,-46.6632,1.1059,5.075,0.3821,2.932,0.4866,0.9314,1.6024837666666667,2.8492230566666668,4.317291293333334,0.392778066,0.3121400523333333,1.4186,4.328,0.5051,2.0015,0.5297,0.7893,0.08,0.463,0.324,0.014,1.684,120.28571428571428,104,0.3081481481481481,1,0,0,1,FALSE,FALSE,FALSE
30,2021-11-12T22:44:26Z,0.8999999761581421,1.7777777777777777,864,6,3,5,4,3,3,3,2,4,2,3,2,2,4,3,3,4,2,2,1,1,2,2,2,2,0,2,0,0,5,4,4,3,4,5,4,4,5,1,5,1,2,4,3,5,4,3,3,3,3,5,1,1,1,1,1,1,1,1,1,3,3,2,1,2,1,1,2,1,2,1.75,0,1.5,0,2.3333333333333335,0,1.7777777777777777,0,2.25,0,0.8333333333333334,0,1.5714285714285714,0,1.3333333333333333,0,1.7567567567567568,0,0,0,0,-0.46275905372157444,-0.34784855521834285,-0.5804383618435307,-0.46414345853093675,5,2,3,1,1,3,2,1.8571428571428572,0,1.5,-0.20582161572857902,4,4,4,4,1,1,2,3.142857142857143,0,2.857142857142857,-0.7395711320441822,0,2,2,2,1,1,2,5,2,2,3,2,5,2,4,5,1,4,2,4,3,1.6,0,4.2,0,4.2,0,4,0,4.133333333333334,0,2,1,3,1,3,3,2,2,3,2,4,3,2,1,1,2,1,2,2,3,2.35,0,"White, Caucasian, Anglo, European American",0,29,1,3,NA,5,2,0,0,1,0,0,TRUE,TRUE,TRUE,TRUE,TRUE,0,3,0.7434126923109989,0.78,0.015627711677323703,NA,NA,NA,NA,NA,NA,NA,3,0.605275483869557,0.6260481249992154,0.96875,1,0.013686476220208469,0.005812443415646874,0.9661,1.3667,0.5495,0.909,1.1489,0.5661,0.006,1.0302190793333332,1.1632755876666667,0.5408055256666666,NA,NA,NA,NA,NA,NA,NA,NA,NA,NA,NA,NA,NA,NA,NA,NA,NA,1.2005,4.2506,0.4576,5.7373,0.5256,0.9658,0.069,0.415,0.335,0.049,1.743,35.57142857142857,376,1.114074074074074,1,1,6,7,TRUE,FALSE,FALSE
31,2021-11-12T23:07:24Z,0.8999999761581421,1.6,900,6,3,4,3,2,4,2,2,4,2,3,2,3,3,2,4,2,2,3,1,1,2,3,2,1,0,2,0,0,4,2,1,3,3,4,3,4,4,2,5,1,1,3,3,4,3,2,2,4,4,4,2,1,1,1,1,1,1,1,1,4,2,4,1,3,1,2,1,1,1,1.875,0,1.25,0,2.4,0,2.888888888888889,0,2.3333333333333335,0,1.1666666666666667,0,1.5714285714285714,0,1.6666666666666667,0,2.135135135135135,0,0,0,0,-0.1496534383708357,-0.10287250241229595,-0.6588395645607719,-0.3808560334865339,4,2,3,1,2,2,2,2,0,2,0.06413940681375631,5,5,5,5,3,2,3,4,0,2,0.38995568780511447,0,3,2,2,5,2,2,3,2,2,4,1,5,3,4,4,3,4,1,2,4,2.8,0,4.6,0,3,0,3.6,0,3.7333333333333334,0,2,2,3,2,3,3,3,1,2,2,3,2,4,2,1,2,2,3,1,3,2.6,0,"White, Caucasian, Anglo, European American & Filipino",1,23,1,2,NA,5,2,0,0,0,0,0,TRUE,TRUE,TRUE,TRUE,TRUE,0,3,0.6859794871797547,0.78,0.02386811592235382,3,0.4522709677418874,0.49578965517313317,1,0.90625,0.007105520129125845,0.003944887086769305,3,0.6004093750005122,0.7348749999992017,1,0.875,0.007444306038311978,0.013341118991725107,1.2004,1.1332,0.3955,0.8889,1.2934,0.5169,0.2175,1.250743501,1.061355547,0.38886694866666666,1.1037,3.7868,0.3066,2.8899,0.3304,-61.9999,0.8492,4.4607,0.3528,5.1368,0.4101,0.8504,1.2157418306666667,3.1526245233333334,4.10398218,0.3233557696666667,0.30044061266666666,1.0414,4.9275,0.489,2.1848,0.5608,0.915,0.071,0.445,0.454,0.007,1.369,195.57142857142856,104,0.3081481481481481,1,0,0,1,FALSE,FALSE,FALSE
32,2021-11-12T23:04:49Z,1,1.6,900,3,2,1,1,2,1,2,5,1,5,3,5,5,1,1,1,1,2,5,1,1,4,5,4,4,0,2,0,0,1,1,4,1,1,3,2,2,1,1,5,5,3,2,2,5,5,5,5,5,5,1,1,1,1,3,1,1,1,4,3,1,5,4,3,4,5,2,1,3,3,3.25,0,2.25,0,4.2,0,4.222222222222222,0,3.5,0,1.8333333333333333,0,3.142857142857143,0,4,0,3.4324324324324325,0,0,0,0,1.512538116947517,1.8190909430913276,-0.34523475369180734,0.7369280946997601,2,5,2,5,5,5,5,4.714285714285714,0,4.5,2.6104851116974532,2,2,3,3,1,1,5,1.8571428571428572,0,4.142857142857143,0.6723373927674386,0,1,1,2,2,1,1,1,2,1,3,3,4,4,5,5,4,4,5,4,3,1.4,0,3.4,0,2.4,0,4.4,0,3.4,0,3,3,4,1,4,4,4,1,3,2,4,1,3,4,4,1,4,4,4,4,3.7,0,"White, Caucasian, Anglo, European American",0,22,1,2,NA,5,2,0,0,1,0,0,TRUE,TRUE,TRUE,TRUE,TRUE,0,1,0.8895833333333333,0.72,0.08669979591836734,1,0.50303125,0.5674516129032258,1,1,0.0018409989919354844,0.003644855913978494,1,0.641258064516129,0.6873333333333334,0.96875,0.9375,0.021554822580645158,0.014142887096774196,1.545,0.6579,0.3925,1.141,0.7515,0.5982,0.245,1.5464224266666666,0.7326995713333333,0.3882470473333333,9.9976,14.1673,0.1502,11.0406,0.1147,-99.6639,0.7596,6.3007,0.4466,5.8432,0.5036,0.9176,1.82148197,4.9838846666666665,6.416953266666667,0.3900233006666667,0.36761594566666667,1.2591,4.4271,0.4772,4.4954,0.5456,0.8205,0.065,0.446,0.349,0.02,1.885,94.25,400,1.1851851851851851,1,0,0,1,FALSE,FALSE,FALSE
33,2021-11-12T23:08:17Z,1,1.7777777777777777,1080,4,2,2,4,3,3,4,4,3,4,4,2,2,2,4,3,1,5,5,5,4,5,5,5,4,7,2,4,0,2,1,2,2,2,4,2,2,2,3,2,4,5,2,3,4,4,5,5,5,5,1,5,5,1,5,4,1,5,3,3,3,4,2,5,5,4,4,4,3,2,4.75,0,3.25,0,3.4,0,3.888888888888889,0,4.083333333333333,0,4,0,2.857142857142857,0,4.666666666666667,0,3.891891891891892,0,4,4,0,2.7313384988497216,2.3173670078268196,1.6072727827353175,1.9623198952810685,4,3,2,1,1,2,3,2.2857142857142856,0,2.5,0.41956761451123586,2,2,2,2,1,1,5,1.5714285714285714,0,4.428571428571429,0.9547190977297628,0,4,4,4,4,4,3,3,4,3,2,3,4,2,3,5,4,4,3,3,3,4,0,3.4,0,2.8,0,3.2,0,3.1333333333333333,0,3,2,3,2,4,4,4,2,3,3,3,2,3,2,2,2,3,3,2,4,3,0,"White, Caucasian, Anglo, European American",0,24,1,2,NA,5,2,0,0,0,0,0,TRUE,TRUE,TRUE,TRUE,TRUE,0,6,0.646543902439088,0.8367346938775511,0.020018925646219512,6,0.45315483870940104,0.47112499999976715,0.96875,1,0.0030073049092729986,0.002993490322596182,6,0.5437249999999767,0.586859375,1,1,0.004248900645133172,0.004076435393120124,1.0601,1.6079,0.4428,0.9425,1.5434,0.4666,0.1424,1.1688568153333334,1.271702973,0.40875707666666666,1.149,4.5364,0.3324,5.1451,0.3595,-92.0296,0.8359,5.4025,0.377,6.0048,0.4046,0.8651,1.239045129,4.971069253333333,4.650119276666667,0.3518366886666667,0.326361463,0.8024,4.8112,0.4644,6.6493,0.5272,0.9742,0.126,0.363,0.732,0.014,1.085,77.5,276,0.8177777777777777,1,1,0,1,FALSE,FALSE,FALSE
34,2021-11-12T23:09:09Z,1,1.6,900,6,4,5,5,1,5,1,1,5,1,1,1,1,5,1,5,5,5,1,1,1,1,1,1,1,4,2,0,0,5,5,5,5,5,5,5,5,5,1,5,1,1,5,1,5,1,1,1,1,1,5,1,1,1,1,1,1,4,1,1,5,1,1,1,1,1,1,1,1,1,1.5,0,1,0,1,0,1,0,1,0,0.8333333333333334,0,1.2857142857142858,0,1,0,1.0810810810810811,0,2,0,0,-1.0385371651719268,-1.3186544855402116,-0.33105581968498016,-0.8248551526125959,5,1,5,1,1,1,1,1,0,1,-0.9031185640466358,5,5,5,5,5,5,1,5,0,1,0.38995568780511447,0,1,3,1,3,1,1,5,3,1,4,1,3,3,5,4,1,4,3,5,3,1.8,0,4,0,4.4,0,4,0,4.133333333333334,0,1,1,1,4,3,2,2,4,1,1,1,4,1,2,1,4,1,2,2,2,1.4,0,"White, Caucasian, Anglo, European American",0,23,1,2,NA,5,2,0,0,1,0,0,TRUE,TRUE,TRUE,TRUE,TRUE,0,4,0.9663125000223517,0.64,0.1380754632886694,4,0.6313656249940396,0.683050000011921,1,1,0.007505101037733517,0.004980950320489636,4,0.818090624988079,0.9828125,1,1,0.02123556991022056,0.048311502414092704,1.414,0.4166,0.5477,1.3022,0.3021,0.5929,0.0803,1.4535721433333333,0.57318385071,0.5364557626666666,10,9.279,0.0925,9.4878,0.1561,-73.8739,0.7929,4.4276,0.5382,6.3477,0.6332,0.6503,2.4459039066666666,4.484471796666667,5.106920393333334,0.413345695,0.39383663533333335,0.9183,3.7988,0.7129,2.4731,0.8332,0.6437,0.326,0.257,0.587,0.007,1.371,195.85714285714286,104,0.3081481481481481,1,0,0,1,FALSE,FALSE,FALSE
35,2021-11-12T23:07:21Z,0.8999999761581421,1.6,900,6,3,4,5,3,4,2,2,3,2,2,2,2,4,3,3,3,1,2,1,1,1,2,2,1,0,2,2,2,4,4,3,3,4,5,4,4,3,2,4,2,1,3,2,4,1,1,2,2,3,4,2,1,1,1,1,1,1,1,1,5,2,2,1,1,1,1,1,1,1,1.375,0,1,0,2.2666666666666666,0,2.2222222222222223,0,1.9166666666666667,0,1.1666666666666667,0,1.1428571428571428,0,1,0,1.7027027027027026,0,0,2,2,-0.7296343097587817,-0.5608838346439097,0.028924941706396007,-0.2659794464687568,5,2,4,1,1,1,1,1.2857142857142858,0,1,-0.7321841937363471,5,5,5,5,3,2,2,4.142857142857143,0,1.8571428571428572,-0.1748077221195339,0,3,3,3,3,3,3,4,2,2,2,1,3,1,4,3,2,4,2,3,3,3,0,3.8,0,3.6,0,3.6,0,3.6666666666666665,0,1,1,1,1,1,2,3,3,2,1,1,3,1,2,1,3,1,2,1,2,1.65,0,"White, Caucasian, Anglo, European American",0,24,1,2,NA,5,2,0,0,0,0,0,TRUE,TRUE,TRUE,TRUE,TRUE,0,6,0.6942499999999935,0.7346938775510204,0.023051395408162794,NA,NA,NA,NA,NA,NA,NA,6,0.7298125000000073,0.9487187499999873,1,1,0.028278608870965928,0.05329298286290684,1.1106,0.9749,0.4238,1.0546,1.0696,0.4597,0.2278,1.1725067533333333,0.964591533,0.416157269,NA,NA,NA,NA,NA,NA,NA,NA,NA,NA,NA,NA,NA,NA,NA,NA,NA,1.3312,2.8778,0.51,2.0003,0.6842,0.9988,0.192,0.271,0.406,0.009,1.79,198.88888888888891,104,0.3081481481481481,1,1,0,1,FALSE,FALSE,FALSE
36,2021-11-12T23:11:33Z,1,1.7777777777777777,900,5,2,4,4,2,4,1,2,4,2,1,1,1,4,1,4,4,1,1,1,1,1,1,1,1,2,2,0,0,5,3,4,4,3,4,4,4,4,2,5,4,1,4,1,2,1,1,1,1,1,5,1,1,1,1,1,1,1,1,1,5,1,1,1,1,1,2,1,2,1,1,0,1.5,0,1.6666666666666667,0,2.111111111111111,0,1.6666666666666667,0,0.8333333333333334,0,0.8571428571428571,0,1,0,1.4864864864864864,0,1,0,0,-1.0973758042982402,-1.072807320732879,-0.3773458880470143,-0.7250766043899466,3,3,2,3,1,2,1,2.4285714285714284,0,1,-0.048446712495193056,5,5,5,3,2,2,2,3.7142857142857144,0,2.2857142857142856,0.6723373927674386,0,1,1,1,4,1,1,4,1,1,1,1,4,3,2,4,2,5,1,3,2,1.6,0,4.8,0,3,0,4,0,3.933333333333333,0,1,1,2,3,3,2,2,2,1,2,3,3,2,3,1,3,2,3,1,1,1.95,0,"White, Caucasian, Anglo, European American",0,20,1,2,NA,5,2,0,0,0,0,0,TRUE,TRUE,TRUE,TRUE,TRUE,0,1,0.8493604651051898,0.86,0.03093137900661594,1,0.5197903225806452,0.5434064516405905,1,1,0.0027705922350472474,0.005921758621036756,1,0.6670750000476837,0.7022812499552965,1,1,0.019004117400558847,0.008531419632610315,1.3947,1.4183,0.4807,0.935,1.8931,0.6853,0.2775,1.4128466433333333,1.2249370826666666,0.4723168996666667,2.924,8.1853,0.3412,6.3728,0.314,-88.3561,0.6796,6.9419,0.4702,5.3854,0.4873,0.7493,1.7435160553333333,4.686922406666667,5.925212176666666,0.362063947,0.37801456466666666,1.1515,2.9465,0.5057,4.6154,0.5916,0.9397,0.289,0.197,0.629,0.023,1.383,60.130434782608695,446,1.3214814814814815,1,0,0,1,FALSE,FALSE,FALSE
38,2021-11-12T23:13:03Z,1,1.7777777777777777,864,4,3,4,5,3,4,3,3,4,1,1,1,1,4,1,4,5,1,1,1,2,1,1,2,2,1,2,1,0,3,5,5,5,5,4,4,4,4,1,5,2,1,5,1,5,2,1,3,2,3,5,1,1,1,1,1,1,2,1,1,5,1,1,1,1,1,1,3,2,3,1.375,0,2.25,0,1.7333333333333334,0,1.6666666666666667,0,1.5833333333333333,0,0.8333333333333334,0,1,0,1,0,1.3783783783783783,0,1,1,0,-0.9313667867632848,-0.9294610014101783,0.06449092769773276,-0.43248503685622275,5,1,5,1,1,2,1,1.1428571428571428,0,1,-0.8176513788914915,5,5,5,5,4,3,2,4.428571428571429,0,1.5714285714285714,-0.7395711320441822,0,5,5,4,2,3,4,4,2,3,3,1,2,5,1,1,4,4,4,3,5,3.8,0,3,0,2.6,0,2,0,2.533333333333333,0,3,1,1,4,3,2,4,3,1,1,4,3,1,2,2,3,1,3,3,1,2,0,"Asian or Asian American (e.g., Chinese, Japanese, and others) & White, Caucasian, Anglo, European American",1,22,1,2,NA,5,2,0,0,2,0,0,TRUE,TRUE,TRUE,TRUE,TRUE,0,5,1.0165937500004656,0.64,0.10158691102023713,5,0.5401967741928755,0.5967379310336607,0.96875,0.90625,0.018697195957340523,0.00956741286301729,5,0.7532156249987892,0.8521225806445845,1,1,0.017307860716193682,0.024564331140271966,1.3644,0.435,0.5869,1.3414,0.3847,0.6016,0.2207,1.41117253,0.6012172785166666,0.575379438,1.1055,2.7526,0.348,2.3465,0.3898,-40.7095,1.2006,3.0954,0.3414,3.4273,0.4215,0.8967,1.2289238386666668,2.6113741,3.0861243033333334,0.37911598166666666,0.337618217,1.3994,4.2426,0.583,2.8206,0.6182,0.9073,0.153,0.417,0.466,0.012,1.383,115.25,374,1.108148148148148,1,0,0,1,FALSE,FALSE,FALSE
39,2021-11-12T23:21:40Z,1,1.4995014955134596,1003,3,2,4,5,2,4,1,1,5,1,1,1,3,4,1,4,4,1,4,5,2,1,4,1,1,0,2,0,1,5,3,1,5,5,5,3,2,1,2,5,3,2,1,1,3,1,4,4,5,2,1,5,4,1,2,1,1,1,1,1,5,2,2,2,3,3,2,3,1,1,2.375,0,1.75,0,1.5333333333333334,0,2.6666666666666665,0,2.75,0,2.8333333333333335,0,1.1428571428571428,0,2.6666666666666665,0,2.4864864864864864,0,0,0,1,0.37989431376598426,-0.10945423753312258,-0.32558751222710886,-0.21752087488011573,4,3,2,1,2,4,5,3,0,1,0.2934220281253842,5,3,4,5,2,2,1,3.7142857142857144,0,2.2857142857142856,2.0842459175790595,0,5,3,5,5,5,4,5,5,4,2,1,5,4,4,3,5,5,2,5,3,4.6,0,4.2,0,3,0,2.6,0,3.2666666666666666,0,1,1,2,1,2,2,3,2,1,3,1,2,3,4,1,2,3,3,2,1,2.3,0,"Asian or Asian American (e.g., Chinese, Japanese, and others)",0,20,1,2,NA,5,2,0,0,1,0,0,TRUE,TRUE,TRUE,TRUE,TRUE,0,2,0.8322604651340219,0.86,0.09776715347690806,2,0.49092187501490114,0.5950064516067505,1,1,0.001163773379426099,0.006293711960180323,2,0.6675437500327825,0.7097343749850988,1,1,0.007554708350978476,0.0063789145869093365,1.3344,1.3602,0.5636,1.088,1.1384,0.6088,0.0828,1.3713329933333334,1.198430422,0.5516500936666666,3.7502,11.4157,0.3267,7.054,0.3292,-101.358,0.6473,7.1724,0.4511,5.0705,0.5264,0.5147,1.7745345466666667,4.628849643333333,6.939366986666666,0.4073525826666667,0.370621047,1.0295,3.8687,0.54,4.0126,0.5879,0.9757,0.131,0.439,0.593,0.013,0.985,75.76923076923077,104,0.3081481481481481,1,1,0,1,FALSE,FALSE,FALSE
40,2021-11-12T23:26:24Z,1,1.6,900,6,4,4,4,1,4,1,1,5,1,1,1,1,5,3,4,4,1,3,3,1,1,1,1,1,5,2,0,3,5,3,3,4,4,5,5,5,5,1,5,1,1,3,1,4,1,1,1,1,1,3,1,1,3,4,1,1,3,1,1,5,1,1,1,1,1,2,1,1,1,1.5,0,1.25,0,1.4666666666666666,0,1.6666666666666667,0,1.25,0,2,0,1.1428571428571428,0,1,0,1.4864864864864864,0,3,0,3,-0.7863715689162981,-0.9438827445425771,0.4797867975263196,-0.23204797350812878,5,1,3,1,1,1,1,1.2857142857142858,0,1,-0.7321841937363471,5,5,5,5,2,2,2,4,0,2,-1.0219528370065065,0,2,2,2,3,2,1,4,2,1,2,1,4,2,4,5,2,4,2,4,3,2.2,0,4.4,0,3.6,0,4.2,0,4.066666666666666,0,1,1,1,4,1,1,1,4,1,1,1,4,1,1,1,4,2,1,2,2,1.15,0,"White, Caucasian, Anglo, European American",0,24,1,2,NA,5,2,0,0,1,0,0,TRUE,TRUE,TRUE,TRUE,TRUE,0,4,0.6423829268304313,0.82,0.02645736661655393,4,0.4011093750009313,0.46980344827627313,1,0.90625,0.0012374447479533007,0.0044235359576019284,4,0.49753124999860304,0.6050166666681568,1,0.9375,0.0053823912499923595,0.006363234475789165,1.1473,1.3669,0.3496,0.9988,1.9228,0.4315,0.2658,1.193944288,1.181871279,0.34211716566666667,0.953,5.5705,0.3156,3.022,0.3362,-88.2518,0.67,7.7854,0.3614,4.4002,0.3949,0.9664,1.0283403763333334,3.22687324,5.447535236666667,0.330775228,0.310244192,0.6292,4.2657,0.4423,3.5658,0.5441,0.9891,0.065,0.349,0.422,0.014,1.806,129,398,1.1792592592592592,1,0,0,1,FALSE,FALSE,FALSE
41,2021-11-12T23:21:04Z,1,1.6,900,4,2,1,3,4,3,4,3,2,4,5,4,4,2,3,2,2,4,4,4,2,2,4,4,4,9,1,5,2,4,2,1,2,1,2,2,2,2,3,2,4,2,1,4,2,3,4,5,5,1,1,5,5,4,5,5,5,5,5,5,4,1,2,2,4,1,4,4,4,4,3.5,0,4,0,3.8666666666666667,0,4,0,3.6666666666666665,0,4.666666666666667,0,3.4285714285714284,0,2.3333333333333335,0,3.810810810810811,0,5,5,2,1.9033947911437412,1.945886134389598,2.6051013660749422,2.27549375023227,3,4,2,4,2,2,3,3.142857142857143,0,5,1.854839912378057,1,2,4,2,1,1,4,1.8571428571428572,0,4.142857142857143,1.5194825076544112,0,1,1,1,3,1,2,5,1,1,3,1,4,2,4,4,3,4,1,4,1,1.4,0,4.4,0,3.8,0,4.6,0,4.266666666666667,0,2,2,2,1,2,2,3,2,3,3,3,2,3,3,1,2,1,2,3,3,2.55,0,"Hispanic of Latino (e.g., Mexican American, Central American, and others)",0,25,1,2,NA,5,2,0,0,0,0,0,TRUE,TRUE,TRUE,TRUE,TRUE,0,3,0.7259413513505982,0.74,0.03746064051581908,3,0.5253724193110341,0.5636268749949522,1,1,0.0036234140064492736,0.003470739015349525,3,0.6374042187671876,0.71544953128614,1,1,0.014577951601736052,0.010868396690462441,1.252,0.8977,0.4043,1.035,0.8504,0.4895,0.0402,1.29834353,0.9188426493333334,0.39739987266666665,6.0433,10.1066,0.2264,9.1767,0.2344,-91.338,0.7681,6.3014,0.462,6.2519,0.5093,0.9618,1.9115556866666668,4.99792641,5.86465536,0.37786125833333334,0.367410585,1.094,3.9609,0.5035,3.7609,0.5765,0.95,0.25,0.268,0.697,0.016,1.58,98.75,432,1.28,1,0,0,1,FALSE,FALSE,FALSE
42,2021-11-12T23:18:18Z,1,1.7777777777777777,900,3,3,1,4,4,3,2,4,3,4,2,3,2,3,3,3,3,3,4,5,1,2,5,5,4,4,1,0,5,3,2,3,4,3,3,2,2,3,2,4,2,1,4,2,4,2,3,3,2,3,2,3,3,2,3,1,2,2,5,5,3,2,1,1,1,2,2,3,2,2,3.625,0,2.25,0,3.066666666666667,0,3.2222222222222223,0,2.1666666666666665,0,2.5,0,2.7142857142857144,0,1.3333333333333333,0,2.5675675675675675,0,2,0,5,1.2078380214719655,1.121523810506113,0.9431984283971292,1.0323611194516211,4,1,3,2,1,2,2,1.8571428571428572,0,1,-0.39031545311577004,3,4,5,5,3,2,2,3.7142857142857144,0,2.2857142857142856,-0.4571894270818581,0,3,4,4,5,3,3,5,2,3,3,2,4,2,4,5,5,4,2,3,2,3.8,0,3.8,0,3.2,0,4,0,3.6666666666666665,0,2,3,3,2,3,3,3,3,2,3,2,3,3,4,3,3,1,3,3,3,2.65,0,"White, Caucasian, Anglo, European American",0,19,1,2,NA,5,2,0,0,1,0,0,TRUE,TRUE,TRUE,TRUE,TRUE,0,4,1.1108970588235294,0.68,0.08561965962297319,NA,NA,NA,NA,NA,NA,NA,NA,NA,NA,NA,NA,NA,NA,1.5462,0.5081,0.5665,1.2067,0.6659,0.7764,0.64,1.5646295966666666,0.6256202592,0.5557945973333334,NA,NA,NA,NA,NA,NA,NA,NA,NA,NA,NA,NA,NA,NA,NA,NA,NA,NA,NA,NA,NA,NA,NA,NA,NA,NA,NA,NA,NA,104,0.3081481481481481,1,1,7,8,TRUE,FALSE,FALSE
43,2021-11-12T23:18:00Z,1,1.7777777777777777,1440,6,3,4,4,2,4,3,2,4,2,1,1,1,4,3,5,4,1,2,1,1,1,2,1,2,0,2,0,0,5,3,4,3,3,5,2,5,5,1,5,2,1,4,1,5,1,3,3,3,1,5,1,1,1,1,1,1,1,1,1,5,2,2,1,1,1,1,1,1,1,1.375,0,1,0,1.8666666666666667,0,2.111111111111111,0,1.6666666666666667,0,0.8333333333333334,0,1.1428571428571428,0,1,0,1.5405405405405406,0,0,0,0,-0.8305005482610333,-0.8024722296671781,-0.7372407672780129,-0.7698564984725955,5,1,5,1,1,1,1,1,0,1,-0.9031185640466358,5,5,5,5,3,2,1,4.285714285714286,0,1.7142857142857142,-0.4571894270818581,0,1,2,2,3,2,1,5,1,1,1,2,5,3,4,5,2,5,2,2,2,2,0,4.6,0,3,0,4.6,0,4.066666666666666,0,1,1,1,2,2,2,2,3,4,1,1,3,1,3,1,3,1,1,1,2,1.7,0,"White, Caucasian, Anglo, European American",0,29,0,1,NA,5,2,0,1,0,0,1,TRUE,TRUE,TRUE,TRUE,TRUE,0,5,0.9184565217391304,0.92,0.10328742897959187,5,0.41225,0.46950000000000003,1,0.9375,0.002253741935483871,0.00402154435483871,5,0.52515625,0.6189655172413793,1,0.90625,0.0017918135080645153,0.003957353830645161,1.5497,1.5595,0.5538,1.3379,1.7432,0.6026,0.269,1.5200363266666668,1.3108250566666666,0.5464581193333333,1.1248,5.0354,0.3006,3.4236,0.3273,-80.6277,0.8589,6.7692,0.3494,7.0712,0.4091,0.8113,1.2095854676666666,3.5933613033333334,5.066741746666667,0.322024866,0.295435793,0.5289,4.6279,0.4812,5.9069,0.576,0.8982,0.05,0.449,0.671,0.02,1.936,96.8,380,1.125925925925926,1,0,0,1,FALSE,FALSE,FALSE
44,2021-11-12T23:37:12Z,1,1.7777777777777777,720,4,3,2,4,2,4,1,1,3,1,1,1,2,5,3,4,4,1,1,2,1,1,1,1,1,0,2,0,1,5,5,5,5,5,5,4,4,5,1,5,1,1,4,1,5,2,2,2,2,3,4,2,1,1,4,2,1,1,2,2,5,1,1,1,1,1,2,2,2,3,1.125,0,2.25,0,1.8666666666666667,0,1.2222222222222223,0,1.5833333333333333,0,1.8333333333333333,0,1.1428571428571428,0,1,0,1.4594594594594594,0,0,0,1,-1.0364357852031298,-0.9447538565438629,-0.1687851067926266,-0.5567694816682447,5,1,4,1,1,2,1,1.2857142857142858,0,1,-0.7321841937363471,5,5,5,5,3,3,2,4.285714285714286,0,1.7142857142857142,-0.7395711320441822,0,2,2,2,2,2,2,5,3,2,4,1,5,2,4,4,1,4,2,3,2,2,0,4.4,0,4.2,0,3.8,0,4.133333333333334,0,1,1,1,3,2,1,1,4,1,1,2,3,2,1,2,4,2,2,1,1,1.4,0,"White, Caucasian, Anglo, European American",0,19,1,2,NA,5,2,0,0,0,0,0,TRUE,TRUE,TRUE,TRUE,TRUE,0,3,0.8148774999979883,0.8,0.05646608637102879,3,0.535746874999255,0.6370800000001987,1,1,0.014206722570445878,0.014461858896272889,3,0.6561906249979511,0.7123566666687529,1,0.9375,0.009228459586622216,0.006435049102890453,1.4441,1.0405,0.3927,1.2117,1.3771,0.4988,0.3536,1.4580416733333332,0.999548353,0.38799264066666667,1.8895,4.0465,0.3023,4.3483,0.4198,-57.5599,0.9811,4.1227,0.4128,3.8289,0.5046,0.9632,1.8771544766666666,4.1258285,4.070816323333333,0.41125447866666665,0.30207071133333335,1.2194,3.9189,0.5044,4.8158,0.5871,0.9107,0.058,0.496,0.382,0.012,1.362,113.5,360,1.0666666666666667,1,0,0,1,FALSE,FALSE,FALSE
45,2021-11-12T23:38:20Z,1,1.778125,960,7,3,3,2,4,2,5,4,3,2,4,2,3,3,2,3,2,2,3,3,1,1,3,3,3,1,2,0,0,3,2,4,5,5,5,4,5,3,3,4,4,1,3,2,5,5,4,4,5,4,2,1,1,1,3,3,1,3,1,1,3,2,3,1,3,1,2,1,2,2,2.375,0,1.75,0,3.3333333333333335,0,2,0,3.1666666666666665,0,2,0,1.8571428571428572,0,1.6666666666666667,0,2.3783783783783785,0,1,0,0,0.312650154764484,0.617633912873446,-0.2989446853297732,0.15934461377183642,5,1,3,1,1,1,1,1.2857142857142858,0,1,-0.7321841937363471,2,3,4,2,1,2,4,2.2857142857142856,0,3.7142857142857144,0.6723373927674386,0,1,1,2,4,2,1,5,2,2,4,1,5,4,4,5,2,5,4,2,4,2,0,4.4,0,3.4,0,3.8,0,3.8666666666666667,0,2,1,2,3,4,1,2,4,1,1,2,4,1,1,1,3,1,1,1,4,1.6,0,"Black or African American & White, Caucasian, Anglo, European American",1,26,1,2,NA,5,2,0,0,1,0,0,TRUE,TRUE,TRUE,TRUE,TRUE,0,6,0.9000581395347971,0.86,0.08658228000001983,6,0.36774062500020954,0.4189310344826302,1,0.90625,8.736231350623663e-4,0.0015720185483967765,6,0.48892812500009314,0.5640222222222774,1,0.84375,0.005251881441572614,0.0057332961190106335,1.6094,1.2509,0.4772,1.1803,1.1792,0.6165,0.1832,1.5751363133333334,1.121525786,0.47243922633333335,0.8446,6.6764,0.3045,3.4221,0.3129,-106.2503,0.5593,8.8874,0.3363,6.3522,0.3744,0.9618,0.8901906306666667,3.5706562633333334,6.087852633333333,0.3098834426666667,0.2999808483333333,0.6587,3.8484,0.4111,4.1509,0.4978,0.6032,0.06,0.368,0.576,0.011,1.55,140.90909090909093,419,1.2414814814814816,1,0,0,1,FALSE,FALSE,FALSE
47,2021-11-12T23:43:35Z,1,1.7786458333333333,768,3,2,5,5,1,5,1,1,5,1,1,1,1,5,1,5,5,1,1,1,1,1,1,1,1,0,2,0,0,5,5,5,5,5,5,5,5,5,1,5,1,1,4,1,5,1,1,1,1,1,5,1,1,1,2,1,1,1,3,1,5,1,1,1,1,1,1,1,1,1,1,0,1,0,1,0,1,0,1.0833333333333333,0,1,0,1.1428571428571428,0,1,0,1.1081081081081081,0,0,0,0,-1.3327303608034937,-1.5219139525069039,-0.7372407672780129,-1.1295773598924583,4,1,2,2,1,3,2,2.142857142857143,0,1,-0.21938108280548152,5,5,5,5,1,1,3,3.5714285714285716,0,2.4285714285714284,0.9547190977297628,0,2,2,3,3,3,2,3,2,2,1,1,3,2,3,4,3,4,2,2,3,2.6,0,4,0,2.6,0,3.6,0,3.4,0,2,2,4,1,2,4,4,1,1,1,1,2,1,2,1,3,2,4,2,4,2.5,0,"White, Caucasian, Anglo, European American",0,22,1,2,NA,5,2,0,0,1,0,0,TRUE,TRUE,TRUE,TRUE,TRUE,0,2,1.0122142857142857,0.84,0.05238965551020408,2,0.5271875,0.59071875,1,1,0.004263318548387096,0.01204278931451613,2,0.66196875,0.84553125,1,1,0.008293966733870964,0.03458774092741935,1.3595,1.2398,0.6605,1.1276,1.2653,0.7592,0.3079,1.4096493166666666,1.1221013033333334,0.6451846863333334,1.7136,4.9163,0.3675,3.9752,0.3787,-73.277,1.0975,5.6585,0.4357,3.99,0.4481,0.9646,2.07720908,4.3496382633333335,4.8035039133333335,0.3547030723333333,0.31208701066666666,1.2321,3.4975,0.506,2.6391,0.6155,0.8824,0.318,0.151,0.605,0.007,1.385,197.85714285714286,268,0.794074074074074,1,0,0,1,FALSE,FALSE,FALSE
48,2021-11-12T23:48:28Z,1,1.6,900,6,3,2,3,5,3,5,3,3,3,4,2,2,3,3,3,2,3,3,1,1,2,2,4,3,0,2,0,0,2,3,3,2,2,4,3,5,4,5,3,2,1,4,3,4,5,4,2,2,3,4,1,1,1,1,1,1,1,1,1,2,5,4,1,3,2,2,2,2,2,2.375,0,2,0,3.3333333333333335,0,2.888888888888889,0,2.8333333333333335,0,1,0,2.2857142857142856,0,2,0,2.4324324324324325,0,0,0,0,0.3462722342652341,0.6408635662410679,-0.4236359564090485,0.10861380491600969,5,2,3,1,1,1,1,1.4285714285714286,0,2,-0.2777293338068208,3,3,3,3,2,2,3,2.7142857142857144,0,3.2857142857142856,-1.3043345419688306,0,3,3,3,3,3,2,5,3,2,3,1,4,2,3,4,2,4,2,4,3,3,0,4.2,0,4,0,3.4,0,3.8666666666666667,0,2,3,3,3,3,4,4,3,1,4,2,3,2,3,2,4,3,3,1,3,2.5,0,"White, Caucasian, Anglo, European American",0,22,1,2,NA,5,2,0,0,1,0,0,TRUE,TRUE,TRUE,TRUE,TRUE,0,2,0.7427257142858846,0.7,0.03616631617969496,2,0.5646625000010245,0.6679161290338924,1,0.96875,0.020994414032177812,0.0100915641831699,2,0.7430906249992549,0.8749531249990686,1,1,0.011883863457845893,0.013261038054329743,1.0788,0.801,0.5039,0.9232,0.722,0.559,0.1219,1.1465758633333334,0.8646908593333333,0.49450743766666666,1.4247,3.1145,0.336,3.2894,0.4611,-47.466,1.171,3.5133,0.4002,3.7022,0.5184,0.9982,1.6829176633333334,3.4927203766666666,3.5128764766666665,0.43531924466666666,0.3185777003333333,0.9819,4.0656,0.6254,2.465,0.7347,0.9247,0.182,0.407,0.549,0.009,1.473,163.66666666666669,104,0.3081481481481481,1,0,0,1,FALSE,FALSE,FALSE
49,2021-11-12T23:24:53Z,1,1.6,1050,4,3,3,2,3,3,2,3,3,3,5,2,1,2,1,2,3,5,5,3,4,3,4,4,4,6,2,0,0,2,2,1,1,1,2,1,3,2,1,2,3,3,4,5,3,5,5,4,3,3,1,2,3,1,2,3,1,4,3,2,1,4,3,3,3,1,5,4,4,4,4,0,4.25,0,2.933333333333333,0,4.333333333333333,0,3.4166666666666665,0,2.5,0,3,0,2.3333333333333335,0,3.3783783783783785,0,3,0,0,1.9454223905196797,1.5738245196181855,0.8912522894356707,1.232538404526928,3,1,2,2,1,1,1,1.8571428571428572,0,1,-0.39031545311577004,1,2,3,2,1,2,3,2,0,4,2.0842459175790595,0,2,2,3,4,5,2,5,4,3,2,1,5,4,3,5,3,2,2,3,2,3.2,0,4,0,3,0,3.4,0,3.466666666666667,0,4,4,4,2,2,2,3,2,1,2,2,2,4,4,2,2,2,4,4,3,2.95,0,"Hispanic of Latino (e.g., Mexican American, Central American, and others)",0,24,1,2,NA,5,2,0,0,1,0,0,TRUE,TRUE,TRUE,TRUE,TRUE,0,NA,NA,NA,NA,3,0.48237500000000366,0.5238709677419392,1,0.96875,0.006835983870966455,0.003540378024193993,3,0.6565312500000055,0.7787187499999991,1,1,0.006970773185484743,0.014036466733870535,NA,NA,NA,NA,NA,NA,NA,NA,NA,NA,1.2232,4.1897,0.3364,4.3791,0.3947,-78.8819,0.8608,5.4514,0.3995,6.2714,0.4518,0.9881,1.370874485,4.403901103333333,4.431199886666667,0.38308046533333334,0.32679659233333336,0.9649,5.8671,0.581,3.1954,0.6543,0.9922,0.248,0.305,0.699,0.005,0.926,185.20000000000002,438,1.2977777777777777,1,0,0,1,FALSE,FALSE,FALSE
50,2021-11-12T23:38:41Z,1,1.7777777777777777,1080,3,2,1,1,3,1,5,3,1,3,1,1,2,1,1,1,1,3,4,5,1,2,1,3,2,10,2,3,0,2,1,2,2,1,2,2,2,2,3,2,2,2,3,2,3,3,2,2,2,2,1,2,2,3,3,2,1,5,4,4,3,3,2,1,4,1,1,1,1,3,2.625,0,1.5,0,3.6,0,4.222222222222222,0,2.5,0,2.6666666666666665,0,3,0,2,0,3.054054054054054,0,5,3,0,0.8884282662148361,1.1300413500742408,1.0549236299181224,1.0924824899961816,2,3,1,2,2,3,3,3.142857142857143,0,3,1.1168645628292926,3,3,3,3,1,1,3,2.4285714285714284,0,3.5714285714285716,1.8018642126167355,0,2,2,2,3,3,3,2,2,3,2,1,3,3,3,2,2,1,2,3,1,2.4,0,3.2,0,2.8,0,3.4,0,3.1333333333333333,0,1,2,2,1,2,3,1,1,2,1,1,3,2,2,1,2,1,1,2,3,2,0,"Hispanic of Latino (e.g., Mexican American, Central American, and others) & White, Caucasian, Anglo, European American",1,23,1,2,NA,5,2,0,0,0,0,0,TRUE,TRUE,TRUE,TRUE,TRUE,0,6,1.03671875,0.64,0.17094897306122447,6,0.5362903225806451,0.659125,0.96875,1,0.005041813508064517,0.006188822580645162,6,0.66471875,0.6750625,1,1,0.005526724798387099,0.007426383064516128,1.5745,0.38,0.5213,1.3228,0.1868,0.6308,0.2269,1.58515717,0.5272655305666667,0.512878737,1.5384,4.1291,0.3612,4.066,0.4699,-65.1987,0.9399,4.7731,0.4405,4.1562,0.5565,0.9939,1.7442257633333333,4.164745533333333,4.33043904,0.451446975,0.34459159833333336,0.894,4.5054,0.5602,3.7552,0.5688,0.5637,0.224,0.327,0.665,0.123,1.489,12.10569105691057,317,0.9392592592592592,1,0,0,1,FALSE,FALSE,FALSE
52,2021-11-12T23:55:11Z,1,1.7777777777777777,1080,4,3,5,5,2,5,2,2,5,2,2,2,2,5,2,5,2,2,3,1,1,1,2,2,1,0,2,0,0,5,1,1,1,1,5,4,4,4,1,5,1,1,4,2,4,3,2,2,2,2,4,1,1,1,2,2,1,1,1,1,3,4,1,1,1,1,2,1,1,1,1.625,0,1.25,0,1.7333333333333334,0,3.111111111111111,0,1.75,0,1.3333333333333333,0,1.5714285714285714,0,1,0,1.972972972972973,0,0,0,0,-0.4060217945640583,-0.5664976675410849,-0.6588395645607719,-0.6126686160509284,5,2,2,3,2,2,2,2.2857142857142856,0,1.5,0.050579939736853735,4,5,5,5,2,2,3,3.7142857142857144,0,2.2857142857142856,-0.1748077221195339,0,1,1,1,1,1,1,5,2,1,4,2,5,1,5,4,1,5,3,3,3,1,0,4.4,0,4.4,0,4.2,0,4.333333333333333,0,1,3,1,4,4,1,1,3,1,1,3,3,1,1,2,4,1,1,3,1,1.6,0,"White, Caucasian, Anglo, European American",0,21,0,1,NA,5,2,0,0,0,0,0,TRUE,TRUE,TRUE,TRUE,TRUE,0,4,0.7399743589774156,0.78,0.071688108265939507,4,0.3601225806436231,0.4448538461510952,0.96875,0.8125,0.0017063835380264872,0.0036642185377830914,4,0.5061093750018626,0.5713129032331128,1,0.96875,0.0071996924897162785,0.007354714668189193,1.2552,1.0023,0.4094,1.1742,1.1805,0.4338,0.3733,1.3037326233333333,0.980735271,0.40107337233333334,0.9077,3.9323,0.2502,2.0793,0.296,-66.2381,0.5458,5.3994,0.32,3.5897,0.3753,0.9971,0.9718884403333333,2.4159066823333335,4.20552695,0.29247761033333336,0.24744192566666667,1.1914,4.0325,0.368,4.4442,0.4378,0.9946,0.066,0.362,0.454,0.025,1.945,77.8,310,0.9185185185185185,1,0,1,2,FALSE,FALSE,FALSE
53,2021-11-12T23:47:17Z,1,1.7777777777777777,864,6,2,4,4,5,3,4,3,3,3,3,2,1,4,3,4,3,3,4,2,3,2,2,2,3,0,4,0,0,4,4,4,4,4,4,4,4,4,1,4,1,3,4,4,4,4,3,1,1,1,4,1,1,1,4,4,2,1,1,1,4,2,1,1,1,1,3,2,1,1,2.625,0,1.75,0,2.7333333333333334,0,2,0,2.0833333333333335,0,2,0,1.2857142857142858,0,1,0,1.864864864864865,0,0,0,0,0.14874251719832501,0.24654020032568483,-0.5020371591262895,-0.12774847940030237,4,1,1,1,1,1,1,1.7142857142857142,0,1,-0.4757826382709144,3,2,3,2,1,1,4,2,0,4,1.5194825076544112,0,2,4,3,4,4,3,4,4,2,3,2,4,3,4,3,2,3,2,4,2,3.4,0,3.6,0,3.6,0,3.4,0,3.533333333333333,0,2,2,1,2,2,1,2,3,2,1,1,3,1,2,1,3,1,2,1,2,1.65,0,"White, Caucasian, Anglo, European American",0,30,1,2,NA,5,2,0,0,1,0,0,TRUE,TRUE,TRUE,TRUE,TRUE,0,3,0.9018787878715631,0.66,0.09536663714670683,3,0.6519781250059604,0.7917937499955296,1,1,0.016587829505509594,0.0270801702829205,3,0.8165062499959022,0.9725870967718863,1,0.96875,0.017733615443774633,0.043840710232521715,1.4164,0.4854,0.4408,1.1544,0.4843,0.5773,0.4703,1.4480803066666668,0.6232277076666667,0.4335148993333333,3.4348,5.3722,0.3323,3.6455,0.3207,-40.6326,1.1282,3.6118,0.4838,2.4366,0.6044,0.8839,2.37885016,2.9156771233333334,4.493872376666666,0.37630437433333336,0.38567772133333333,1.347,4.0208,0.634,2.3009,0.7099,0.9593,0.103,0.557,0.406,0.008,1.43,178.75,104,0.3081481481481481,1,0,0,1,FALSE,FALSE,FALSE
54,2021-11-12T23:51:15Z,1,1.7777777777777777,1080,7,3,2,2,4,3,2,3,1,4,2,1,5,2,3,3,5,2,1,1,1,1,4,4,3,0,2,0,0,5,4,5,5,5,5,5,5,5,1,5,5,2,5,1,5,5,5,5,5,5,4,1,1,1,2,1,1,1,1,1,3,5,4,1,3,3,1,2,2,2,2.125,0,1.75,0,3.2,0,1.1111111111111112,0,3.0833333333333335,0,1.1666666666666667,0,2.142857142857143,0,2.3333333333333335,0,2.108108108108108,0,0,0,0,-0.010962360430240004,0.33674868756994975,-0.5020371591262895,-0.0826442357781699,3,3,2,4,1,3,2,2.857142857142857,0,1.5,0.3924486803574311,5,4,4,3,2,4,5,3.2857142857142856,0,2.7142857142857144,-0.7395711320441822,0,2,2,2,3,2,2,5,2,2,4,1,4,2,5,5,2,5,2,5,2,2.2,0,4.4,0,4.4,0,4.4,0,4.4,0,2,2,4,1,3,4,4,2,3,4,3,2,2,4,4,3,3,4,4,3,3.25,0,"White, Caucasian, Anglo, European American",0,27,1,2,NA,5,2,0,0,0,0,0,TRUE,TRUE,TRUE,TRUE,TRUE,0,1,0.8644117647128947,0.68,0.07607939877499204,1,0.4668374999947846,0.5523099999944369,1,0.967741935483871,0.002843435966943177,0.004561914644226802,1,0.5748718750048428,0.6955677419343302,1,0.96875,0.00944902724620155,0.009736782568988267,1.4437,0.5469,0.4202,1.0969,0.5088,0.6016,0.4735,1.46781375,0.6686617966666667,0.41433071066666666,1.7733,5.4729,0.3048,4.4087,0.3596,-74.245,0.7585,5.8954,0.4089,5.1638,0.4827,0.8936,1.70468919,4.190062,5.14561706,0.35938607666666667,0.302968811,1.0435,4.7673,0.4549,3.0205,0.5556,0.8313,0.095,0.393,0.552,0.014,1.946,139,349,1.0340740740740741,1,0,0,1,FALSE,FALSE,FALSE
57,2021-11-12T23:53:14Z,0.699999988079071,1.6,900,4,3,2,3,2,5,2,3,3,3,1,4,3,2,2,2,3,2,4,1,1,1,2,3,2,1,2,0,0,4,4,4,5,5,5,5,5,3,3,5,3,1,3,2,5,3,2,3,3,5,2,1,1,1,3,1,2,2,2,1,3,2,4,1,1,2,2,1,2,2,2,0,1.75,0,2.8,0,1.5555555555555556,0,2.5,0,1.6666666666666667,0,2.142857142857143,0,1.3333333333333333,0,2.027027027027027,0,1,0,0,-0.13914653852685102,0.07628619918548828,-0.2989446853297732,-0.11132924307214245,4,2,3,1,1,2,2,1.8571428571428572,0,1.5,-0.20582161572857902,4,4,4,4,2,2,1,3.5714285714285716,0,2.4285714285714284,-1.5867162469311549,0,3,3,4,3,4,3,5,2,3,2,2,3,2,3,4,2,5,2,4,3,3.4,0,3.8,0,3.8,0,3.4,0,3.6666666666666665,0,2,3,4,4,4,4,4,2,3,2,1,1,2,4,1,1,2,4,2,3,2.85,0,"White, Caucasian, Anglo, European American",0,21,1,2,NA,5,2,0,1,1,0,1,TRUE,TRUE,TRUE,TRUE,TRUE,0,NA,NA,NA,NA,4,0.51865625,0.6203793103448236,1,0.9354838709677419,0.004310232862903826,0.00863549462365673,4,0.8501874999999995,0.907321428571426,1,0.9032258064516129,0.016765770161290088,0.028239090322580408,NA,NA,NA,NA,NA,NA,NA,NA,NA,NA,1.58,4.0968,0.3258,3.0244,0.3857,-51.353,0.87,5.4501,0.4457,3.5706,0.5075,0.9973,1.6785745833333334,3.14821599,4.251191,0.3759037416666667,0.319244183,1.1309,3.0442,0.6725,2.6164,0.6895,0.9631,0.059,0.653,0.298,0.016,1.476,92.25,422,1.2503703703703704,1,0,0,1,FALSE,FALSE,FALSE
58,2021-11-12T23:56:06Z,1,1.7777777777777777,864,4,3,4,5,5,4,5,1,4,2,3,1,1,5,3,5,4,1,3,1,1,1,2,2,1,1,2,0,0,5,5,3,5,2,5,3,3,3,2,5,2,1,5,2,5,2,1,1,1,2,5,1,1,1,3,2,1,2,2,2,5,1,1,1,1,1,2,2,2,2,1.5,0,2,0,2.1333333333333333,0,2.2222222222222223,0,1.4166666666666667,0,1.3333333333333333,0,1.2857142857142858,0,1,0,1.5945945945945945,0,1,0,0,-0.7191274099147971,-0.6109243796066618,-0.22054348261253207,-0.41573393110959694,4,1,3,1,1,1,1,1.4285714285714286,0,1,-0.6467170085812028,5,5,5,5,2,2,1,4.142857142857143,0,1.8571428571428572,0.10757398284279028,0,2,2,3,4,3,2,5,3,2,2,2,4,2,4,4,1,5,1,4,5,2.8,0,4.4,0,4,0,3.2,0,3.8666666666666667,0,1,1,3,1,3,3,2,2,3,3,1,2,4,3,2,2,2,4,4,3,2.75,0,"Hispanic of Latino (e.g., Mexican American, Central American, and others)",0,20,1,2,NA,5,2,0,0,1,0,0,TRUE,TRUE,TRUE,TRUE,TRUE,0,6,0.7234405406230204,0.74,0.038229965715789786,6,0.3831225806820777,0.4575192307875707,1,0.8125,0.0020888138069012955,0.006254063186612552,6,0.49268387097697103,0.5421586206699239,0.96875,0.90625,0.011973963835913594,0.014282000223766625,1.3113,0.8549,0.3407,0.9866,1.372,0.5135,0.3959,1.34799865,0.8866108753333334,0.33574267,0.8855,5.1492000000000004,0.2971,1.8615,0.2925,-72.3285,0.6744,6.0852,0.3278,2.9745,0.3646,0.9937,0.9430818836666667,2.187353697,5.1282291466666665,0.2885967173333333,0.2933466043333333,0.6735,13.2443,0.4544,3.1607,0.4693,0.769,0.066,0.27,0.275,0.032,2.061,64.40625,386,1.1437037037037037,1,0,0,1,FALSE,FALSE,FALSE
59,2021-11-13T00:07:49Z,1,1.5,912,6,3,5,5,2,4,1,1,3,1,1,1,1,5,2,4,3,1,1,1,1,1,1,1,1,0,2,0,0,5,3,5,5,4,4,4,5,5,2,4,1,1,4,1,5,1,1,1,1,2,5,1,1,1,1,1,1,1,1,1,5,1,1,1,1,1,1,1,1,1,1,0,1,0,1.5333333333333334,0,1.5555555555555556,0,1.3333333333333333,0,0.8333333333333334,0,0.8571428571428571,0,1,0,1.2432432432432432,0,0,0,0,-1.2486751620516177,-1.234640572527312,-0.7372407672780129,-0.9859406699026625,5,1,4,1,1,2,1,1.2857142857142858,0,1,-0.7321841937363471,5,5,5,5,2,2,1,4.142857142857143,0,1.8571428571428572,-0.7395711320441822,0,1,1,1,1,1,1,5,1,1,1,1,4,1,4,4,3,5,2,4,1,1,0,4.6,0,3.6,0,4.6,0,4.266666666666667,0,1,1,2,3,1,1,2,1,2,1,1,3,2,3,1,2,1,2,2,2,1.8,0,"White, Caucasian, Anglo, European American",0,22,1,2,NA,5,2,0,0,1,0,0,TRUE,TRUE,TRUE,TRUE,TRUE,0,5,0.9045418604652635,0.8775510204081632,0.10710586593541711,5,0.4151437500001048,0.47052580645151676,1,1,0.0011058180241830453,0.0018090986451667391,5,0.577603124999965,0.6363129032259026,1,0.96875,0.009194512570612766,0.0077204099898932205,1.3572,1.3967,0.5849,1.2185,1.4821,0.5932,0.0375,1.3999754533333333,1.2229078286666666,0.5705421896666667,9.9987,16.5437,0.113,14.27,0.1202,-118.8504,0.7247,8.011,0.3718,6.6076,0.4188,0.9592,1.44082976,5.677072133333334,6.569656913333334,0.351711187,0.31282901766666665,1.0679,3.9373,0.4493,5.0999,0.5307,0.9995,0.068,0.395,0.392,0.016,1.6,100,430,1.2740740740740741,1,0,0,1,FALSE,FALSE,FALSE
60,2021-11-12T23:58:37Z,1,1.7786458333333333,768,3,3,2,1,3,1,4,4,3,3,2,4,1,1,2,1,2,5,5,1,2,3,5,4,5,9,2,6,10,2,2,3,1,2,4,4,4,4,1,1,3,1,1,2,1,4,3,1,5,4,2,5,5,3,5,1,4,5,5,4,4,1,4,1,3,3,1,2,5,5,3.75,0,3.25,0,3.6,0,3.111111111111111,0,3.25,0,3.6666666666666665,0,3.4285714285714284,0,2.3333333333333335,0,3.2972972972972974,0,5,6,6,1.7394871535775827,1.7180419509421723,3.282329553112966,2.500185752027569,4,2,2,1,1,2,3,2.142857142857143,0,2.5,0.33410042935609163,3,3,3,3,4,4,3,3.2857142857142856,0,2.7142857142857144,0.6723373927674386,0,4,4,4,5,4,2,3,4,2,3,2,2,3,2,4,3,1,2,2,2,4.2,0,3,0,2.8,0,3.2,0,3,0,1,1,1,2,1,2,2,2,3,3,2,3,3,3,1,2,2,3,3,3,2.25,0,"Hispanic of Latino (e.g., Mexican American, Central American, and others) & White, Caucasian, Anglo, European American",1,19,1,2,NA,5,2,0,1,0,0,1,TRUE,TRUE,TRUE,TRUE,TRUE,0,5,1.107406666658322,0.6122448979591837,0.1857327301522096,NA,NA,NA,NA,NA,NA,NA,5,0.7611517241391642,0.857779166671137,0.90625,0.75,0.031319036843246835,0.04890713189926922,1.8164,0.2659,0.45,1.495,0.1378,0.7006,0.4956,1.7563963166666667,0.4071064382933333,0.44869983733333335,NA,NA,NA,NA,NA,NA,NA,NA,NA,NA,NA,NA,NA,NA,NA,NA,NA,0.9648,2.2648,0.5933,1.2793,0.6451,0.9559,0.066,0.497,0.212,0.002,0.913,456.5,308,0.9125925925925925,1,0,0,1,FALSE,FALSE,FALSE
61,2021-11-13T00:08:35Z,1,1.6,900,7,3,5,5,2,5,2,1,5,2,1,1,1,4,2,4,4,1,1,1,1,1,1,1,1,0,2,0,0,5,5,5,5,5,5,5,5,5,1,5,1,1,5,1,5,1,1,1,1,1,5,1,1,1,2,1,1,1,1,1,5,1,1,1,1,1,1,1,1,1,1,0,1,0,1.4666666666666666,0,1,0,1,0,1,0,0.8571428571428571,0,1,0,1.027027027027027,0,0,0,0,-1.3831634800546193,-1.356209091817867,-0.7372407672780129,-1.04672492954794,5,1,4,2,1,1,1,1.2857142857142858,0,1,-0.7321841937363471,5,5,5,5,3,3,1,4.428571428571429,0,1.5714285714285714,-1.0219528370065065,0,1,1,1,1,1,1,5,1,1,3,1,5,1,4,5,1,5,1,5,1,1,0,5,0,4.6,0,4.8,0,4.8,0,1,1,1,2,2,1,1,4,1,1,2,2,1,3,1,3,1,2,1,2,1.55,0,"White, Caucasian, Anglo, European American",0,28,1,2,NA,5,2,0,0,0,0,0,TRUE,TRUE,TRUE,TRUE,TRUE,0,4,0.7025911764677834,0.68,0.027831511628053814,4,0.4604875000193715,0.5499593750163912,1,1,0.0017961830646547581,0.004696828942004317,4,0.6242406250052154,0.6744500000067055,1,1,0.005499767006397732,0.0040986735496946316,1.0696,0.7263,0.4542,0.8846,0.6535,0.5211,0.1314,1.1375632963333333,0.8224389614333333,0.445145736,2.9433,9.1967,0.3005,6.7355,0.3315,-98.8617,0.8117,6.8922,0.4037,4.8644,0.4695,0.9727,1.5681481236666666,4.698398296666666,6.25524417,0.38831772233333334,0.34158670533333335,0.8934,4.7707,0.5318,4.9873,0.5842,0.8597,0.079,0.496,0.602,0.029,1.546,53.310344827586206,382,1.1318518518518519,1,0,0,1,FALSE,FALSE,FALSE
62,2021-11-13T00:12:53Z,0.8999999761581421,1.7786458333333333,768,6,2,3,4,2,4,2,2,5,2,2,2,4,4,1,4,5,2,4,1,1,1,2,2,1,2,2,0,0,5,3,5,5,5,4,5,5,4,3,4,2,1,5,5,5,2,2,2,4,3,3,1,1,1,2,2,2,3,1,1,4,4,3,3,4,1,2,2,2,2,1.75,0,2,0,2,0,1.4444444444444444,0,2.3333333333333335,0,1.5,0,2.142857142857143,0,2.6666666666666665,0,2.027027027027027,0,1,0,0,-0.29464865621782205,-0.3749498174805686,-0.22054348261253207,-0.2977466500465503,3,2,4,2,1,2,1,1.8571428571428572,0,1,-0.39031545311577004,4,5,4,5,3,2,2,3.857142857142857,0,2.142857142857143,-0.7395711320441822,0,3,2,4,4,3,3,4,2,2,3,1,3,4,2,3,5,3,2,2,3,3.2,0,3.6,0,2.4,0,3.2,0,3.066666666666667,0,3,4,3,2,3,4,3,1,2,2,4,3,4,3,1,2,1,2,1,4,2.8,0,"Asian or Asian American (e.g., Chinese, Japanese, and others) & Filipino",1,24,1,2,NA,5,2,0,0,2,0,0,TRUE,TRUE,TRUE,TRUE,TRUE,0,6,0.7254444444444444,0.7346938775510204,0.050971701238056916,6,0.4236433333158493,0.5012566666682561,0.967741935483871,0.9375,0.00329592761208767,0.003791499962449304,6,0.5211093749925494,0.5926892857381276,1,0.9032258064516129,0.005877547329066022,0.008462406793369712,1.1715,0.9127,0.4431,0.8131,1.0601,0.5672,0.211,1.2308757433333333,0.9358560156666667,0.43442016933333333,1.0594,4.9103,0.3201,3.002,0.3433,-75.0577,0.6579,7.9202,0.3744,6.6113,0.4476,0.8649,1.1426825203333333,3.21501996,4.929444166666666,0.338343049,0.3141698683333333,0.8492,4.5969,0.4384,3.5664,0.4808,0.9751,0.07,0.344,0.41,0.016,1.834,114.625,348,1.031111111111111,1,0,0,1,FALSE,FALSE,FALSE
63,2021-11-13T00:10:34Z,1,1.7777777777777777,720,4,3,3,4,2,4,3,2,4,2,1,1,4,4,1,4,3,1,2,3,1,1,2,3,3,0,2,0,0,5,4,4,5,4,5,3,3,3,2,5,1,1,4,2,5,3,2,1,4,2,4,1,1,1,3,1,1,1,3,1,4,2,2,1,1,1,3,2,2,2,2,0,2.25,0,2.1333333333333333,0,2,0,1.8333333333333333,0,1.3333333333333333,0,1.5714285714285714,0,1,0,1.7297297297297298,0,0,0,0,-0.3240679757809788,-0.33797595253710344,-0.34523475369180734,-0.3416053531144554,5,2,3,1,1,1,1,1.4285714285714286,0,2,-0.2777293338068208,3,4,4,5,2,2,3,3.2857142857142856,0,2.7142857142857144,1.5194825076544112,0,2,2,2,2,2,2,3,2,2,3,4,4,2,4,4,2,3,2,4,2,2,0,3.4,0,3.6,0,4,0,3.6666666666666665,0,1,1,1,3,3,1,3,1,1,1,1,4,2,2,1,4,1,2,1,2,1.6,0,Native American/Alaskan Native/indigenous,0,21,0,1,NA,5,2,0,0,1,0,0,TRUE,TRUE,TRUE,TRUE,TRUE,0,6,0.9433666666646798,0.72,0.09967656491554432,6,0.5061156249940395,0.566456666670243,1,0.967741935483871,0.0020398194252397557,0.002177332258386548,6,0.6687033333321413,0.7254281250108033,0.9375,1,0.006163326521906345,0.00808563434556498,1.6254,0.599,0.3008,1.2618,0.9284,0.5713,0.649,1.59728751,0.684231141,0.3047413133333333,1.4681,5.9282,0.3823,5.1053,0.4317,-91.4442,0.7835,5.4832,0.4397,5.7304,0.4992,0.9471,1.513393921,4.773605056666667,5.602692906666666,0.4220278436666667,0.37502661266666665,1.0821,3.3487,0.521,3.4441,0.586,0.9826,0.063,0.53,0.432,0.026,1.522,58.53846153846154,350,1.0370370370370372,1,0,1,2,FALSE,FALSE,FALSE
64,2021-11-13T00:21:15Z,1,1.6,900,6,4,4,5,2,5,2,1,4,1,1,1,1,5,1,5,4,2,3,1,1,1,2,1,1,1,2,0,0,5,5,5,5,5,5,5,5,5,1,4,1,1,5,1,5,1,1,2,3,1,4,1,1,1,3,2,1,2,2,1,5,1,1,1,1,1,1,1,1,1,1.5,0,1,0,1.3333333333333333,0,1,0,1.3333333333333333,0,1.5,0,1.1428571428571428,0,1,0,1.2702702702702702,0,1,0,0,-0.9208598869193001,-1.0941011696531993,-0.5341482934814965,-0.8141247315673479,5,1,5,1,1,1,1,1,0,1,-0.9031185640466358,5,5,5,5,3,2,1,4.285714285714286,0,1.7142857142857142,-1.0219528370065065,0,2,2,2,3,2,2,4,2,2,2,1,4,3,4,3,2,5,3,4,3,2.2,0,4.2,0,3.4,0,3.6,0,3.7333333333333334,0,2,1,1,3,2,1,1,2,1,2,2,4,2,2,1,4,2,2,2,2,1.65,0,Prefer not to say,0,22,1,2,NA,5,2,0,0,0,0,0,TRUE,TRUE,TRUE,TRUE,TRUE,0,NA,NA,NA,NA,6,0.4675906249999534,0.5547099999999627,1,0.9375,0.004580473780235238,0.00668766611897372,6,0.6511516129032618,0.727343333333296,1,0.967741935483871,0.011695599247325588,0.014382498494638409,NA,NA,NA,NA,NA,NA,NA,NA,NA,NA,1.2691,4.6755,0.3319,3.251,0.3795,-70.345,0.8729,5.5231,0.3887,5.1504,0.4596,0.9942,1.387241343,3.4478844533333333,4.800088776666667,0.370807958,0.3238290266666667,1.0167,2.6215,0.5036,3.4565,0.5786,0.9611,0.064,0.497,0.422,0.02,1.689,84.45,104,0.3081481481481481,1,1,5,6,FALSE,FALSE,FALSE
65,2021-11-13T00:08:00Z,1,1.7777777777777777,1080,7,3,2,3,3,3,2,2,4,2,2,1,1,5,1,4,3,2,2,5,1,2,2,2,3,1,4,0,0,4,3,4,4,4,3,3,5,3,2,3,1,1,4,4,5,3,5,1,5,2,3,1,3,1,2,1,2,2,1,1,5,1,2,1,1,1,3,3,2,2,2.375,0,2.5,0,2.1333333333333333,0,2.3333333333333335,0,2.5,0,1.6666666666666667,0,1.2857142857142858,0,1,0,2.027027027027027,0,1,0,0,0.09410663800960553,-0.0490571387773049,-0.06374107717804986,-0.05639910797767738,5,1,1,1,1,1,1,1.5714285714285714,0,1.5,-0.3767559860388676,4,4,5,4,1,1,2,3.2857142857142856,0,2.7142857142857144,-1.869097951893479,0,2,2,3,3,3,3,4,2,3,3,4,3,2,4,4,1,3,3,3,4,2.6,0,2.8,0,3.8,0,3.4,0,3.3333333333333335,0,1,3,2,2,3,2,3,1,1,1,2,2,1,1,1,2,1,3,1,3,2.1,0,"White, Caucasian, Anglo, European American",0,22,0,1,NA,5,2,0,0,1,0,0,TRUE,TRUE,TRUE,TRUE,TRUE,0,2,0.9394512195143758,0.82,0.08001829381210249,2,0.4517593750022352,0.5119838709715874,1,0.96875,0.004085450231647294,0.010013242862749764,2,0.8318733333359162,1.220229032259795,0.9375,0.96875,0.028881059355110043,0.20017350692142483,1.5389,1.0872,0.5196,1.3529,1.1142,0.5586,0.0975,1.57804506,0.9879207966666667,0.463419107,1.5009,5.1353,0.3056,3.4739,0.3043,-69.7033,1.1433,5.3753,0.3465,3.4984,0.3548,0.9479,1.5106893166666666,3.53154691,5.011050843333333,0.3042414256666667,0.30249140366666666,1.9496,2.8038,0.48,1.1906,0.6079,0.9963,0.096,0.471,0.163,0.015,2.004,133.6,310,0.9185185185185185,1,1,0,1,FALSE,FALSE,FALSE
66,2021-11-12T23:57:52Z,1,1.7786458333333333,768,4,1,2,3,4,4,3,4,2,4,3,4,4,2,3,2,4,5,5,5,2,5,5,5,4,7,2,20,15,4,3,3,4,4,4,4,5,2,2,2,5,3,2,4,4,2,5,5,5,5,1,4,5,4,4,2,4,3,4,4,4,2,2,2,2,5,3,5,5,4,4.5,0,4.25,0,3.466666666666667,0,2.3333333333333335,0,3.8333333333333335,0,3.8333333333333335,0,2.857142857142857,0,3,0,3.27027027027027,0,4,6,6,2.1891824669001205,1.9714387530939819,3.3928418901854136,2.6821403216396975,4,2,4,2,1,1,1,1.5714285714285714,0,5.5,1.099194713058661,3,3,3,3,1,2,3,2.5714285714285716,0,3.4285714285714284,1.237100802692087,0,4,4,3,2,3,3,4,2,1,2,1,3,4,4,4,4,2,2,4,2,3.2,0,3.4,0,2.8,0,4.2,0,3.466666666666667,0,2,4,3,1,3,4,3,2,3,3,4,2,3,4,3,1,4,4,4,3,3.4,0,"White, Caucasian, Anglo, European American",0,30,1,2,NA,5,2,0,1,2,0,1,TRUE,TRUE,TRUE,TRUE,TRUE,0,NA,NA,NA,NA,5,0.5874343750011176,0.6548000000012107,1,1,0.029133753941519586,0.013628842580329661,5,0.6054531250009313,0.7220218749996274,1,1,0.0043332574092732265,0.013088323054601796,NA,NA,NA,NA,NA,NA,NA,NA,NA,NA,1.7764,3.3006,0.3183,3.7479,0.4178,-46.6979,1.2832,2.7459,0.3612,4.0165,0.4911,0.9604,1.8788349433333333,3.75285818,3.499129793333333,0.40359806233333334,0.311008795,1.1308,5.9938,0.5116,3.0843,0.5544,0.9819,0.096,0.421,0.498,0.015,1.608,107.20000000000002,392,1.1614814814814816,1,0,0,1,FALSE,FALSE,FALSE
68,2021-11-13T00:28:58Z,1,1.6,900,4,3,4,5,2,5,1,1,5,1,1,1,1,5,2,4,5,1,1,1,1,1,1,1,1,0,2,0,0,5,5,5,5,5,5,5,5,5,1,5,1,1,4,1,5,1,1,1,1,1,5,1,1,1,1,1,1,1,1,1,5,1,1,1,1,1,1,1,1,1,1,0,1,0,1.2666666666666666,0,1,0,1.0833333333333333,0,0.8333333333333334,0,0.8571428571428571,0,1,0,1.027027027027027,0,0,0,0,-1.3831634800546193,-1.4421588092780684,-0.7372407672780129,-1.0896997882780406,5,1,3,1,1,2,1,1.4285714285714286,0,1,-0.6467170085812028,5,5,5,5,3,3,1,4.428571428571429,0,1.5714285714285714,-1.3043345419688306,0,2,2,2,3,2,3,4,3,2,2,2,4,3,3,3,4,4,3,3,3,2.2,0,3.6,0,2.8,0,3.2,0,3.2,0,1,1,2,4,1,2,1,3,1,1,2,3,2,1,2,4,1,2,2,1,1.45,0,"White, Caucasian, Anglo, European American",0,21,1,3,NA,5,2,0,0,1,0,0,TRUE,TRUE,TRUE,TRUE,TRUE,0,3,0.7934558823529412,0.6938775510204082,0.03729466588285492,3,0.4442000000106877,0.5149935483874813,1,0.96875,0.003646572857310007,0.005945992569507244,3,0.6106656250059604,0.6949419354834864,1,0.96875,0.0176954500718404,0.017014306088015182,1.3174,0.6663,0.4004,0.9489,0.9616,0.58,0.3656,1.36188998,0.7742803256666667,0.39370444066666666,1.5204,4.522,0.2761,4.1712,0.3414,-67.4062,0.898,6.5087,0.377,4.3569,0.4157,0.97,1.543000075,4.098720936666667,4.53457997,0.337600858,0.27371731666666665,1.142,2.3799,0.4218,3.97,0.5513,0.903,0.079,0.361,0.303,0.014,1.775,126.78571428571428,434,1.285925925925926,1,0,0,1,FALSE,FALSE,FALSE
69,2021-11-13T00:17:39Z,1,1.7777777777777777,864,6,3,4,4,3,3,4,3,3,2,2,3,2,3,3,3,2,3,4,5,1,2,3,3,3,7,2,1,1,3,1,3,3,2,2,1,1,3,3,4,2,1,3,2,4,5,5,4,3,3,1,1,1,2,3,3,1,5,5,5,5,1,4,1,3,1,3,4,4,4,3,0,3.75,0,2.8,0,3.888888888888889,0,2.9166666666666665,0,2.3333333333333335,0,3,0,1.6666666666666667,0,3.027027027027027,0,4,1,1,1.1048704030009173,0.9357833737875021,1.3206252122899094,1.1282042930387057,4,2,4,1,1,1,1,1.4285714285714286,0,1,-0.6467170085812028,4,3,5,5,1,1,3,3.142857142857143,0,2.857142857142857,-0.1748077221195339,0,3,2,2,3,2,3,4,4,2,4,2,2,1,3,4,1,5,1,5,2,2.4,0,3.8,0,4.6,0,3.4,0,3.933333333333333,0,3,4,2,3,2,2,3,3,3,1,2,3,3,3,2,3,1,2,2,3,2.3,0,"White, Caucasian, Anglo, European American",0,27,1,2,NA,5,2,0,0,1,0,0,TRUE,TRUE,TRUE,TRUE,TRUE,0,2,1.3508108695797298,0.92,0.17821716056586864,2,0.5335499999523163,0.5685718750208616,1,1,0.0036574477425243006,0.0018312330512520382,2,0.6140031250566244,0.7716599999427796,1,0.9375,0.008059516428429022,0.015498375708348363,2.0297,1.2538,0.6662,1.8789,1.4815,0.7732,0.7412,1.85839034,1.0928167063333334,0.665157548,5.5767,9.1896,0.2301,11.5037,0.3262,-101.7411,0.7836,4.4555,0.4575,5.9672,0.5077,0.9977,1.7902246196666667,6.07234436,5.3641243733333335,0.4298226493333333,0.36948698566666666,1.3204,5.9832,0.5015,3.4127,0.5838,0.9617,0.086,0.452,0.551,0.01,1.742,174.2,376,1.114074074074074,1,0,0,1,FALSE,FALSE,FALSE
70,2021-11-13T00:27:47Z,0.8999999761581421,1.6,900,3,4,3,3,3,3,3,1,3,2,2,2,3,5,4,4,4,2,2,1,1,1,1,1,1,2,2,0,0,4,4,4,4,4,5,5,4,4,2,4,3,3,3,3,3,3,2,4,4,4,5,5,1,1,1,1,1,1,1,1,5,1,1,1,1,1,1,1,1,1,1.25,0,1,0,2.466666666666667,0,1.7777777777777777,0,3,0,1.5,0,0.8571428571428571,0,1,0,1.945945945945946,0,1,0,0,-0.6560860108508899,-0.42411925044203497,-0.5341482934814965,-0.47913377196176576,5,1,3,2,1,3,3,2,0,2.5,0.24863324420094737,5,5,5,5,3,3,1,4.428571428571429,0,1.5714285714285714,-0.1748077221195339,0,1,2,2,4,4,2,4,3,3,3,3,3,3,3,3,4,3,4,4,3,2.6,0,3,0,3.2,0,3,0,3.066666666666667,0,3,1,1,3,2,1,2,3,1,2,2,3,1,2,1,3,1,2,2,2,1.7,0,"White, Caucasian, Anglo, European American",0,18,0,1,NA,5,3,0,0,2,1,0,TRUE,TRUE,TRUE,TRUE,TRUE,0,2,1.045731818179995,0.7333333333333333,0.1981721780430064,2,0.4263118749968271,0.5225154838671217,1,0.96875,0.0019436104355094708,0.010823585382358232,2,0.7554538709678567,0.8769028124934266,1,1,0.17193776667564417,0.11310529960628485,1.487,0.6885,0.517,1.4278,0.807,0.5314,0.5031,1.5127294233333333,0.762188761,0.5066503476666666,1.3412,7.2563,0.3339,3.0878,0.3136,-84.3361,1.3169,8.2652,0.3422,4.6202,0.3726,0.9039,1.3448611166666666,3.16710341,6.3864824,0.313398229,0.32737155333333334,1.5349,3.0983,0.4213,2.2364,0.5149,0.6491,0.125,0.311,0.329,0.004,1.027,256.75,440,1.3037037037037038,1,0,0,1,FALSE,FALSE,FALSE
71,2021-11-13T00:34:17Z,1,1.7777777777777777,720,4,3,2,5,3,5,3,3,4,3,2,2,2,4,2,3,3,2,2,1,3,2,1,4,2,1,2,0,0,4,4,5,4,4,5,5,5,5,2,4,1,1,5,2,5,1,2,2,2,2,4,1,1,1,3,1,1,3,1,1,5,1,1,1,3,1,2,2,1,1,2.125,0,1.5,0,2.4,0,1.4444444444444444,0,1.5833333333333333,0,1.3333333333333333,0,1.1428571428571428,0,1.6666666666666667,0,1.4864864864864864,0,1,0,0,-0.39761627468887056,-0.2741911959985085,-0.3773458880470143,-0.3257685420227614,5,2,4,1,1,1,1,1.2857142857142858,0,1,-0.7321841937363471,4,5,5,5,2,3,3,3.857142857142857,0,2.142857142857143,-1.3043345419688306,0,2,2,2,3,3,2,4,2,2,3,1,4,4,4,5,2,4,2,4,3,2.4,0,4.2,0,3.4,0,4,0,3.8666666666666667,0,2,1,2,4,2,2,2,3,1,1,3,3,2,2,1,3,2,2,1,2,1.75,0,"White, Caucasian, Anglo, European American",0,22,1,2,NA,5,2,0,0,0,0,0,TRUE,TRUE,TRUE,TRUE,TRUE,0,6,0.8102540540542151,0.74,0.03912425387767074,6,0.47694193548252506,0.5965655172415848,0.96875,0.9666666666666667,0.006830527701881968,0.009846476091575747,6,0.6439812499973923,0.6538419354856014,1,1,0.013102251895646604,0.004608145849591081,1.4163,0.7853,0.3954,0.9921,0.9406,0.6167,0.2976,1.4425091333333333,0.834923047,0.3898363343333333,1.309,3.6414,0.3045,3.2409,0.4027,-55.8512,1.2005,4.8957,0.3569,4.4647,0.455,0.9292,1.439738687,3.42606916,3.929501166666667,0.392912386,0.2968408696666667,1.0249,4.3379,0.5167,5.1363,0.5622,0.9823,0.123,0.439,0.638,0.036,1.476,41,362,1.0725925925925925,1,0,0,1,FALSE,FALSE,FALSE
72,2021-11-13T00:27:03Z,1,1.5,1024,3,2,3,5,3,4,4,1,2,1,1,1,1,4,1,4,4,1,2,1,1,1,1,1,2,2,2,1,4,4,3,5,5,5,5,5,5,5,2,5,1,1,5,1,1,1,2,2,3,3,5,4,1,1,2,1,1,3,3,1,5,1,1,1,1,1,1,1,2,2,1.25,0,1.5,0,1.9333333333333333,0,1.3333333333333333,0,1.9166666666666667,0,1.5,0,1.4285714285714286,0,1,0,1.5945945945945945,0,1,1,4,-0.8746295276057681,-0.8043112438921151,0.5350859071427324,-0.13461266837469132,5,1,4,1,1,1,1,1.1428571428571428,0,2,-0.44866370411710943,5,5,5,5,4,4,2,4.571428571428571,0,1.4285714285714286,0.6723373927674386,0,2,2,2,2,2,2,5,2,2,3,1,4,3,4,5,3,4,2,4,2,2,0,4.2,0,3.6,0,4.2,0,4,0,2,2,3,2,1,3,3,2,3,2,3,2,2,2,1,2,3,3,1,3,2.45,0,"White, Caucasian, Anglo, European American",0,30,1,2,NA,5,2,0,1,2,0,1,TRUE,TRUE,TRUE,TRUE,TRUE,0,5,0.8898217391301271,0.9387755102040817,0.037532288418429,5,0.5991531250004191,0.6713968750002095,1,1,0.0072620032157143044,0.004783530635104136,5,0.7343781250003958,0.7715968750001629,1,1,0.009577992086679952,0.014504240957706823,1.4895,2.0421,0.5712,1.4934,5.5131,0.7295,0.3776,1.4225869633333332,1.5094745236666667,0.564219398,1.6727,5.1875,0.4379,5.5042,0.5195,-85.5806,0.9505,4.5687,0.49370000000000003,6.0663,0.587,0.9193,1.9859381866666668,5.1923352933333335,5.17596669,0.48623828566666666,0.40932869466666666,1.0116,4.0091,0.6248,3.3718,0.6324,0.8271,0.276,0.273,0.586,0.039,1.349,34.58974358974359,519,1.5377777777777777,1,0,0,1,FALSE,FALSE,FALSE
73,2021-11-13T00:37:31Z,1,1.7777777777777777,1080,6,4,4,5,3,4,1,1,4,1,1,1,2,3,1,4,3,2,1,1,1,1,1,1,2,0,2,0,0,5,1,2,4,4,5,5,5,5,2,5,1,1,4,2,5,1,1,2,3,3,4,1,1,1,1,1,1,1,1,1,4,2,2,1,1,1,1,1,1,1,1.25,0,1,0,1.7333333333333334,0,2,0,1.6666666666666667,0,1,0,1.2857142857142858,0,1,0,1.5675675675675675,0,0,0,0,-0.8914405673561434,-0.9018757880361272,-0.7372407672780129,-0.81955827765707,5,1,5,1,1,1,1,1,0,1,-0.9031185640466358,5,5,5,5,3,2,1,4.285714285714286,0,1.7142857142857142,-1.0219528370065065,0,2,2,2,1,2,1,4,3,1,5,1,4,1,4,4,1,4,2,3,4,1.8,0,4.4,0,4.4,0,3.6,0,4.133333333333334,0,1,2,1,4,1,1,2,1,1,1,1,3,1,2,2,2,1,1,1,1,1.5,0,"White, Caucasian, Anglo, European American",0,24,0,1,NA,5,2,0,0,0,0,0,TRUE,TRUE,TRUE,TRUE,TRUE,0,6,0.9425463414642868,0.8367346938775511,0.042435825349207784,6,0.38460937500000003,0.4423766666680574,1,1,0.001639010554375649,0.0035681721958764076,6,0.5709624999975785,0.6194387096791498,1,0.96875,0.016095947580796605,0.00418458031282337,1.3903,1.2792,0.5811,1.0089,1.8289,0.725,0.273,1.4189825466666666,1.143913151,0.5710441943333333,2.0656,8.7521,0.2666,6.7902,0.2903,-106.9036,0.8829,7.8693,0.3283,6.1465,0.3716,0.9412,1.3058038313333333,5.042429246666667,6.2606958666666666,0.31874891,0.2863900266666667,1.1667,3.4653,0.4041,6.0989,0.5198,0.985,0.074,0.38,0.411,0.028,2.111,75.39285714285715,320,0.9481481481481481,1,0,2,3,FALSE,FALSE,FALSE
74,2021-11-13T00:31:43Z,0.8999999761581421,1.7777777777777777,864,4,4,2,5,2,5,2,2,4,2,2,2,2,5,3,4,4,1,1,1,1,1,1,1,1,0,2,0,0,4,3,4,4,4,5,5,5,5,2,5,1,1,4,2,5,3,2,2,2,2,5,1,1,1,1,1,1,1,1,1,5,2,2,1,1,1,1,1,1,1,1,0,1,0,2,0,1.6666666666666667,0,1.75,0,0.8333333333333334,0,1.1428571428571428,0,1,0,1.4594594594594594,0,0,0,0,-1.1141868440486153,-0.9411726183163546,-0.7372407672780129,-0.8392066927971837,5,1,4,1,1,1,1,1.1428571428571428,0,2,-0.44866370411710943,5,5,5,5,3,3,1,4.428571428571429,0,1.5714285714285714,0.6723373927674386,0,3,3,2,2,2,2,4,2,2,3,2,3,2,3,3,3,3,2,3,3,2.4,0,3.6,0,3.4,0,3.4,0,3.466666666666667,0,2,2,2,3,2,1,2,2,2,1,3,3,2,2,1,3,1,2,1,2,1.85,0,"White, Caucasian, Anglo, European American",0,20,1,2,NA,5,2,0,0,0,0,0,TRUE,TRUE,TRUE,TRUE,TRUE,0,NA,NA,NA,NA,5,0.5752468750011176,0.7099258064521897,1,1,0.009828738699806744,0.015339177978505106,5,0.7413125000009313,0.9027677419344263,1,1,0.016946477903233413,0.013334888924898697,NA,NA,NA,NA,NA,NA,NA,NA,NA,NA,1.7368,4.4456,0.3799,4.0901,0.4976,-63.5463,0.9128,4.1566,0.4626,2.7335,0.5727,0.9809,2.03688517,4.067180016666667,4.66943485,0.4614258943333333,0.35710783733333334,1.1371,4.1874,0.5958,2.8339,0.7355,0.9458,0.187,0.385,0.546,0.005,1.189,237.8,104,0.3081481481481481,1,1,2,3,FALSE,TRUE,FALSE
76,2021-11-13T00:39:07Z,0.8999999761581421,1.7777777777777777,1080,5,2,4,4,3,4,3,2,4,2,3,2,2,3,2,4,4,1,1,1,1,2,1,2,1,0,2,0,0,5,4,5,4,3,4,3,5,4,2,4,1,1,3,2,5,2,3,1,2,2,5,1,1,1,2,1,2,1,1,1,5,2,2,1,1,1,1,1,2,2,1.25,0,1.5,0,2.2666666666666666,0,1.8888888888888888,0,1.8333333333333333,0,1,0,1.2857142857142858,0,1,0,1.5945945945945945,0,0,0,0,-0.8746295276057681,-0.6610617147917793,-0.5804383618435307,-0.620750038317655,4,2,3,2,2,3,2,2.2857142857142856,0,2,0.2350737771240448,4,4,5,2,4,4,2,3.857142857142857,0,2.142857142857143,1.5194825076544112,0,2,2,3,2,2,3,2,2,2,3,2,3,2,3,3,4,3,2,2,3,2.2,0,3.4,0,2.6,0,3.4,0,3.1333333333333333,0,2,2,3,2,2,4,2,2,1,3,2,3,3,4,1,2,2,3,1,3,2.45,0,"White, Caucasian, Anglo, European American",0,21,1,2,NA,5,2,0,0,1,0,0,TRUE,TRUE,TRUE,TRUE,TRUE,0,3,0.882141463407656,0.82,0.07336217814352806,3,0.38114374996721745,0.4675612903333479,1,0.96875,0.0014788651201080886,0.0038309250696132555,3,0.5500906249955296,0.6184899999856949,1,0.967741935483871,0.004377387973885603,0.006386075292158874,1.3388,1.1551,0.5838,1.0744,0.9598,0.6644,0.1497,1.38897022,1.0804767926666667,0.5711317406666667,1.3864,6.9063,0.2808,3.9247,0.3015,-90.6182,0.8439,6.6264,0.3202,4.6767,0.3876,0.9354,1.3192315203333334,3.800958596666667,6.122902213333333,0.30395649533333335,0.27889918366666666,1.0593,6.4396,0.4668,4.5459,0.5081,0.9942,0.073,0.41,0.554,0.015,1.585,105.66666666666667,284,0.8414814814814815,1,0,0,1,FALSE,FALSE,FALSE
77,2021-11-13T00:39:37Z,1,1.6,900,7,3,2,2,4,2,3,3,3,3,2,3,2,2,2,2,3,2,2,1,3,2,2,3,3,1,3,0,0,4,2,3,4,3,4,4,4,4,2,3,2,1,3,2,4,5,3,3,4,4,4,1,1,1,4,4,2,1,2,1,2,4,4,1,5,2,3,2,1,1,2.25,0,1.75,0,3.2,0,2.4444444444444446,0,2.8333333333333335,0,2,0,2.4285714285714284,0,2.6666666666666665,0,2.5675675675675675,0,1,0,0,0.3525763741716248,0.5879193146073626,-0.2989446853297732,0.1444873146387947,3,5,3,5,3,3,3,3.5714285714285716,0,3,1.3732661182947257,3,3,4,2,1,1,5,2.142857142857143,0,3.857142857142857,-1.3043345419688306,0,3,2,3,3,3,3,3,4,2,3,4,4,2,3,3,3,4,2,4,4,2.8,0,3.4,0,3.4,0,2.8,0,3.2,0,2,1,2,2,3,3,3,2,3,3,3,3,3,3,1,2,1,2,2,3,2.45,0,"White, Caucasian, Anglo, European American",0,25,1,2,NA,5,2,0,0,0,0,0,TRUE,TRUE,TRUE,TRUE,TRUE,0,5,0.6829249999978476,0.72,0.0561116908735381,5,0.44126666666617,0.5145406250003726,0.9375,1,0.002672198054442193,0.003440372167123275,5,0.6484312499999069,0.7319448275848709,1,0.90625,0.008678188669534695,0.006696637812609755,1.3099,0.7432,0.2991,1.2537,0.6878,0.3463,0.2262,1.3445625866666666,0.815429445,0.294766421,1.0495,4.127,0.3251,4.4792,0.3974,-86.3234,0.8107,5.8731,0.367,5.7088,0.4428,0.9624,1.151621022,4.52504543,4.3400204533333335,0.390646019,0.3188500046666667,0.9046,3.2972,0.5329,4.2128,0.6203,0.9267,0.059,0.505,0.44,0.014,1.73,123.57142857142857,406,1.202962962962963,1,0,0,1,FALSE,FALSE,FALSE
78,2021-11-13T00:28:17Z,1,1.7777777777777777,720,4,2,3,3,4,2,4,3,3,4,4,3,3,2,4,2,3,3,5,1,3,4,3,4,4,5,4,0,0,4,2,3,3,2,4,4,5,2,3,3,2,1,3,3,5,4,3,3,3,5,4,1,1,1,3,3,2,4,3,3,3,4,3,2,3,1,2,1,3,3,3.375,0,2.25,0,3.533333333333333,0,2.7777777777777777,0,2.8333333333333335,0,1.6666666666666667,0,3,0,2,0,2.6486486486486487,0,3,0,0,1.1027690230321205,1.2494804844727638,0.2640426676977418,0.7567615760852529,4,3,4,1,2,3,2,2.142857142857143,0,1.5,-0.03488724541829051,3,2,4,3,2,1,4,2.4285714285714284,0,3.5714285714285716,0.38995568780511447,0,1,2,1,1,1,1,5,2,1,3,1,5,2,5,5,2,5,2,4,2,1.2,0,4.8,0,4,0,4.6,0,4.466666666666667,0,3,4,1,4,3,2,3,3,1,1,3,3,2,2,1,3,1,2,1,2,1.95,0,"White, Caucasian, Anglo, European American",0,23,1,4,Genderqueer,5,2,0,1,1,0,1,TRUE,TRUE,TRUE,TRUE,TRUE,0,5,0.8013880952341216,0.8571428571428571,0.11003504041828142,5,0.5652281249966472,0.6403200000007947,1,1,0.007929395634900412,0.0032616451027136666,5,0.6990593750011176,0.7426161290330272,1,1,0.008016668942586931,0.0069288173970388925,1.4617,1.2865,0.4484,0.9931,1.4159,0.5795,0.0105,1.4660407566666667,1.1499945923333332,0.44188571866666665,2.419,5.8255,0.3576,6.7392,0.4608,-82.4171,0.9434,4.5715,0.4627,6.0176,0.5651,0.9997,1.9680925633333333,5.34055336,5.007389616666667,0.462872023,0.370731117,1.0513,3.4246,0.5593,4.6038,0.6379,0.9646,0.202,0.364,0.603,0.03,1.589,52.96666666666667,348,1.031111111111111,1,0,0,1,FALSE,FALSE,FALSE
79,2021-11-13T00:43:12Z,1,1.6,800,6,1,2,2,3,3,4,3,2,4,3,3,5,2,2,3,2,3,3,1,3,3,4,4,5,2,4,2,5,4,1,1,3,1,1,2,2,1,5,2,5,4,3,5,2,5,5,5,5,5,2,5,1,1,1,1,3,3,1,1,4,3,3,2,2,3,2,2,3,3,3.25,0,2.5,0,3.533333333333333,0,4.222222222222222,0,4.583333333333333,0,2,0,2.142857142857143,0,2.3333333333333335,0,3.4864864864864864,0,1,2,5,1.546160196448267,1.5558215382582787,1.2317735725039012,1.39379755538109,4,2,4,1,1,2,2,1.7142857142857142,0,1,-0.4757826382709144,3,2,3,3,2,2,3,2.5714285714285716,0,3.4285714285714284,0.6723373927674386,0,5,3,4,4,4,4,3,3,3,4,2,4,4,4,4,5,3,2,2,5,4,0,3.4,0,2.4,0,3,0,2.933333333333333,0,2,3,2,2,2,4,2,2,2,2,4,2,3,3,1,2,1,3,2,2,2.5,0,"Asian or Asian American (e.g., Chinese, Japanese, and others)",0,23,1,2,NA,5,2,0,0,1,0,0,TRUE,TRUE,TRUE,TRUE,TRUE,0,6,0.7758952380943867,0.84,0.03575496816214319,6,0.4068375000059605,0.4757793103374284,1,0.90625,0.001060592096865408,0.0040188977321996555,6,0.6730343750044704,0.7356656249966472,1,1,0.008704773941302828,0.007771834587381108,1.1331,1.4622,0.5107,1.0826,1.394,0.5233,0.1125,1.190985095,1.2271487286666667,0.5002269486666666,1.1093,7.3825,0.3317,2.5874,0.2884,-87.3855,0.615,7.0373,0.3646,4.6294,0.4138,0.9957,1.1319541226666667,2.7599259633333335,6.4733418233333335,0.2871373133333333,0.32587786333333335,0.829,2.9815,0.569,3.8612,0.6355,0.9213,0.143,0.432,0.615,0.02,1.583,79.14999999999999,292,0.8651851851851852,1,0,0,1,FALSE,FALSE,FALSE
80,2021-11-13T00:21:16Z,1,1.7777777777777777,864,4,2,1,2,5,2,5,5,1,5,3,2,5,1,1,1,1,5,5,3,1,3,5,5,5,0,2,3,2,3,3,2,3,1,5,2,3,2,3,5,5,3,2,3,5,3,5,5,5,5,1,5,1,1,3,3,1,2,1,1,3,3,3,2,5,5,1,1,1,1,4,0,1,0,4.266666666666667,0,3.3333333333333335,0,3.5833333333333335,0,2.8333333333333335,0,1.8571428571428572,0,4,0,3.1621621621621623,0,0,3,2,1.8109340725166776,2.0539040225490397,0.2355581492994198,1.1447310859242297,1,5,1,1,3,5,5,4.142857142857143,0,2,1.3461471841409207,1,2,4,2,1,1,5,1.7142857142857142,0,4.285714285714286,1.237100802692087,0,3,3,3,3,3,3,3,3,3,3,3,3,3,3,3,3,3,3,3,3,3,0,3,0,3,0,3,0,3,0,2,2,2,2,2,2,3,2,2,2,3,2,2,3,2,3,1,2,2,3,2.3,0,"Hispanic of Latino (e.g., Mexican American, Central American, and others) & White, Caucasian, Anglo, European American",1,20,1,2,NA,5,2,0,0,1,0,0,TRUE,TRUE,TRUE,TRUE,TRUE,0,6,1.2711225806451703,0.62,0.2941272780612195,6,0.6917709677419175,0.7986965517241363,1,1,0.02081915279569645,0.025331151059107656,6,0.8192562499999912,0.8898533333333054,1,1,0.019885488346772656,0.0281661018850461,1.8146,0.2854,0.5847,1.5578,0.1686,0.7371,0.0525,1.77101261,0.41941954289333333,0.5762590323333333,2.2318,3.8585,0.4026,3.5278,0.4824,-38.9585,1.092,2.5105,0.5115,3.3204,0.6362,0.9255,2.3802548133333334,3.42204153,3.8692641633333333,0.4465392733333333,0.3785666166666667,1.2343,2.8954,0.6199,1.9416,0.6569,0.7549,0.085,0.591,0.372,0.017,1.091,64.17647058823529,386,1.1437037037037037,1,0,0,1,FALSE,FALSE,FALSE
81,2021-11-13T00:33:51Z,1,1.7777777777777777,1080,6,2,2,2,4,2,4,3,3,3,2,3,3,3,3,3,1,3,4,5,3,2,3,3,4,4,2,3,1,1,2,2,2,1,4,3,2,3,1,3,2,3,3,2,5,4,4,3,4,5,2,4,1,3,4,1,3,3,1,1,4,2,3,1,4,2,3,3,1,2,3.375,0,2.25,0,3.4,0,3.7777777777777777,0,2.9166666666666665,0,2.6666666666666665,0,2,0,2.3333333333333335,0,2.918918918918919,0,2,3,1,1.2708794205358729,1.3083289396707392,0.8572994635794774,1.0828142016251083,4,2,3,1,2,2,3,2.142857142857143,0,2,0.14960659196890055,3,3,3,2,1,1,4,2.142857142857143,0,3.857142857142857,0.10757398284279028,0,4,4,3,4,3,3,4,3,2,4,1,3,2,3,4,1,3,1,3,2,3.6,0,3.8,0,4,0,3.6,0,3.8,0,2,3,1,2,4,1,4,2,4,3,3,3,2,2,1,2,1,1,2,4,2.45,0,"White, Caucasian, Anglo, European American",0,27,1,2,NA,5,2,0,0,0,0,0,TRUE,TRUE,TRUE,TRUE,TRUE,0,3,0.7321384615370861,0.78,0.029901084592617436,3,0.4524714285710028,0.5535766666581233,0.875,0.9375,0.0035127882254439324,0.004683449678121574,3,0.63171875,0.6678906250018627,1,1,0.008398788024459999,0.004026260877816713,1.1026,1.1814,0.489,0.9358,1.2692,0.5543,0.1575,1.1681234923333332,1.0800419286666667,0.47974918233333336,1.0641,2.2147,0.2659,3.0342,0.396,-46.6699,0.5586,3.533,0.3954,5.0163,0.5044,0.9818,1.1562947033333333,3.2522853733333332,2.60741618,0.38914181966666667,0.261676395,0.7842,5.1207,0.558,4.9292,0.5943,0.9864,0.161,0.4,0.721,0.03,1.67,55.666666666666664,430,1.2740740740740741,1,0,0,1,FALSE,FALSE,FALSE
82,2021-11-13T00:28:35Z,1,1.6,900,6,3,2,4,4,3,3,2,2,3,4,2,3,2,4,3,3,3,4,2,2,3,4,3,4,4,2,0,0,4,3,2,3,2,3,2,3,2,3,4,2,2,2,3,1,2,4,4,4,5,3,2,3,1,3,1,1,3,2,1,4,5,3,1,1,2,2,2,2,1,3.125,0,1.75,0,3.2,0,3.3333333333333335,0,3.3333333333333335,0,2,0,2.2857142857142856,0,1.3333333333333333,0,2.810810810810811,0,2,0,0,1.0481331438434005,1.0684827686500429,-0.0958522115332568,0.486315278558393,3,3,2,2,2,4,3,3,0,3,1.0313973776741485,4,4,4,4,2,2,3,3.2857142857142856,0,2.7142857142857144,-0.7395711320441822,0,2,3,3,3,2,2,3,2,3,2,2,2,2,3,4,5,3,3,2,3,2.6,0,3.2,0,2.4,0,3.4,0,3,0,2,1,3,2,4,4,4,2,4,4,3,3,2,3,2,3,3,4,3,4,3,0,Filipino,0,27,1,2,NA,5,2,0,0,0,0,0,TRUE,TRUE,TRUE,TRUE,TRUE,0,4,0.914159459463648,0.74,0.06918372237053995,4,0.42484062500298025,0.49160645161328775,1,0.96875,0.0019410902322693603,0.0015234198279785345,4,0.5854218749944121,0.6331781250014901,1,1,0.009701985633831891,0.0066710617628430455,1.2961,0.8417,0.5704,1.123,0.7258,0.6379,0.1139,1.34751566,0.8730859596666667,0.5594036573333333,1.2686,5.6293,0.3122,5.4641,0.3846,-99.2851,0.6504,6.0361,0.3789,7.2281,0.4468,0.7424,1.2832530883333333,5.020877416666667,5.359429283333333,0.3790408086666667,0.308497327,1.0858,3.979,0.4693,5.6893,0.5479,0.9896,0.258,0.193,0.671,0.013,1.161,89.30769230769232,440,1.3037037037037038,1,0,0,1,FALSE,FALSE,FALSE
83,2021-11-13T00:45:41Z,1,1.6,900,4,3,5,5,1,5,1,1,5,1,1,1,1,5,4,4,5,2,2,1,1,1,1,1,1,1,2,0,0,5,5,5,5,5,5,3,4,5,2,5,1,1,4,1,5,1,1,1,3,3,3,1,1,1,2,2,1,1,2,1,4,1,1,1,2,1,2,1,1,2,1.25,0,1.5,0,1.2666666666666666,0,1.3333333333333333,0,1.5,0,1.5,0,1.1428571428571428,0,1.3333333333333333,0,1.4324324324324325,0,1,0,0,-0.9754957661080196,-1.160499262195652,-0.3773458880470143,-0.7689225751213331,5,1,3,1,1,2,1,1.4285714285714286,0,1,-0.6467170085812028,5,5,5,5,2,1,1,4,0,2,-1.0219528370065065,0,1,1,2,1,2,1,4,1,1,1,1,4,1,4,4,3,5,1,1,5,1.4,0,4.8,0,2.8,0,3.8,0,3.8,0,1,3,4,3,4,4,4,1,2,2,4,1,2,4,1,1,1,4,3,4,3.05,0,"White, Caucasian, Anglo, European American",0,20,1,2,NA,5,2,0,0,1,0,0,TRUE,TRUE,TRUE,TRUE,TRUE,0,5,1.018165853658691,0.82,0.1311688012898051,5,0.41051935483875773,0.4869593750000931,0.96875,1,0.0017756645161407549,0.0032720411996115797,5,0.5918781250000466,0.7022031250000582,1,1,0.008946688215764437,0.007280659022170328,1.6405,0.9842,0.482,1.4838,1.0541,0.5258,0.0644,1.61522491,0.9481661186666667,0.476510752,1.4049,5.8786,0.2962,4.4164,0.3279,-87.2364,0.6187,5.3607,0.3568,4.7979,0.4382,0.9673,1.392247749,4.27704617,5.48860194,0.32631114,0.29314039166666667,1.0748,4.1029,0.4631,4.0395,0.5771,0.9952,0.245,0.232,0.686,0.006,1.083,180.5,426,1.2622222222222224,1,0,0,1,FALSE,FALSE,FALSE
84,2021-11-13T00:46:18Z,1,1.7786458333333333,768,6,3,1,4,4,4,1,3,3,3,1,2,5,2,3,2,2,3,3,1,1,4,3,3,5,2,2,0,0,3,1,5,2,1,5,3,3,1,3,5,5,1,2,5,2,2,5,5,5,5,4,1,1,1,1,1,1,1,3,3,3,2,2,1,1,4,2,4,1,1,2.875,0,2,0,3.066666666666667,0,3.3333333333333335,0,3.75,0,1,0,2,0,2,0,2.7837837837837838,0,1,0,0,0.8758199864020546,0.8921309835008454,-0.22054348261253207,0.33579375044415666,5,1,4,1,1,2,1,1.2857142857142858,0,5,0.7437665053611813,5,5,5,5,5,5,1,5,0,1,-1.0219528370065065,0,4,4,4,5,4,3,5,3,3,2,1,4,4,2,3,1,4,1,5,2,4.2,0,4.2,0,3.8,0,3,0,3.6666666666666665,0,3,1,2,2,2,2,2,3,1,2,1,4,3,4,3,3,2,3,3,3,2.25,0,"Asian or Asian American (e.g., Chinese, Japanese, and others)",0,24,1,2,NA,5,2,0,0,1,0,0,TRUE,TRUE,TRUE,TRUE,TRUE,0,3,0.7676315789473194,0.76,0.01621852981224349,3,0.42627666666659836,0.4924322580645582,0.967741935483871,0.96875,0.0022679959784980305,0.003975354798366624,3,0.5740625000000582,0.6222,1,0.9375,0.0019518533870954318,0.0045699219354752895,1.1455,1.1076,0.4912,0.8873,1.5875,0.594,0.2475,1.2058532906666666,1.0477655073333334,0.483018371,1.9589,5.2101,0.2513,4.6948,0.2966,-67.2575,0.8491,5.9347,0.3646,4.9535,0.4111,0.8235,1.5925421333333334,4.22690226,3.66416303,0.3139675333333333,0.214748699,0.7677,6.6253,0.5178,4.1647,0.54,0.9882,0.048,0.495,0.59,0.029,1.648,56.82758620689655,326,0.965925925925926,1,0,0,1,FALSE,FALSE,FALSE
85,2021-11-13T00:40:18Z,1,1.7777777777777777,864,4,3,5,5,2,5,1,1,5,1,1,1,1,5,1,4,5,2,2,5,1,1,1,2,1,5,1,1,1,5,4,4,5,4,5,5,5,5,1,4,1,1,5,1,5,1,1,1,1,2,4,2,1,1,2,1,1,3,1,1,5,1,1,1,1,1,1,2,2,1,1.875,0,1.5,0,1.1333333333333333,0,1.3333333333333333,0,1.1666666666666667,0,1.3333333333333333,0,1.1428571428571428,0,1,0,1.2702702702702702,0,3,1,1,-0.6876067103828436,-1.018895166875523,0.4119219140382229,-0.3034866264186501,5,1,5,1,1,1,1,1,0,1,-0.9031185640466358,5,5,5,5,4,3,1,4.571428571428571,0,1.4285714285714286,-0.1748077221195339,0,1,2,2,3,3,2,3,2,1,2,1,5,2,4,5,2,5,2,4,2,2.2,0,4.6,0,3.4,0,4.4,0,4.133333333333334,0,1,1,2,3,2,2,4,4,1,2,3,4,1,1,1,4,2,2,1,1,1.6,0,"White, Caucasian, Anglo, European American",0,23,1,2,NA,5,2,0,0,0,0,0,TRUE,TRUE,TRUE,TRUE,TRUE,0,2,0.7888125000953674,0.8,0.03355692983891913,2,0.4828612901626095,0.5108103446960449,1,0.90625,0.012638407126005523,0.00646423990310446,2,0.6602322580891271,0.7833857142584665,1,0.875,0.07767181216858281,0.07056614947280854,1.2604,1.1786,0.4897,0.9483,1.2213,0.6041,0.216,1.3082919933333332,1.0813516466666666,0.480235205,1.0243,3.791,0.3478,2.8105,0.3586,-64.059,0.9187,4.4742,0.3707,4.1273,0.3981,0.9536,1.137990028,3.0883982653333333,4.075989066666667,0.351100995,0.339710067,1.1697,4.4258,0.4644,2.134,0.5052,0.9134,0.064,0.441,0.383,0.01,1.525,152.5,357,1.0577777777777777,1,0,0,1,FALSE,FALSE,FALSE
86,2021-11-13T00:52:57Z,1,1.7777777777777777,864,7,4,4,2,5,2,4,4,4,4,4,5,5,2,1,1,2,1,1,1,1,1,4,4,3,1,2,0,0,2,1,1,2,4,5,2,2,1,2,5,5,1,1,5,5,5,5,5,5,5,5,1,1,1,1,1,1,2,1,1,2,5,5,1,1,1,1,3,1,1,2,0,1.5,0,3.8,0,3.7777777777777777,0,3.75,0,0.8333333333333334,0,2.5714285714285716,0,1,0,2.891891891891892,0,1,0,0,0.3988067334851569,0.8777092403684471,-0.3773458880470143,0.2501816761607164,5,1,5,1,1,1,1,1,0,7,1.310807484599657,5,5,5,5,5,5,1,5,0,1,-0.7395711320441822,0,2,2,1,1,1,1,4,3,1,5,1,4,1,5,5,1,4,4,5,2,1.4,0,4,0,4.8,0,4.4,0,4.4,0,3,3,3,1,3,4,3,2,4,4,3,3,3,4,2,3,2,3,4,2,3.05,0,"White, Caucasian, Anglo, European American",0,23,1,2,NA,5,2,0,0,1,0,0,TRUE,TRUE,TRUE,TRUE,TRUE,0,2,0.9638187500052154,0.64,0.13837517877656724,2,0.46085862068883304,0.5190199999928474,0.9666666666666667,0.9375,0.004104750861544034,0.0014743634576560513,2,0.5676781250033528,0.679087096773809,1,0.96875,0.007492773376877459,0.014747736773361619,1.5462,0.3857,0.3998,1.3416,0.4619,0.5213,0.4576,1.54771051,0.54128724767,0.3968461246666667,0.9942,3.4612,0.3242,4.3842,0.4199,-77.9371,0.732,4.989,0.3902,5.6678,0.4586,0.9065,1.1056703243333332,4.41365314,3.81901305,0.41168405933333335,0.317960238,1.0215,3.7593,0.4513,2.3669,0.521,0.9417,0.096,0.341,0.427,0.012,1.714,142.83333333333331,104,0.3081481481481481,1,1,0,1,FALSE,FALSE,FALSE
87,2021-11-13T00:48:10Z,0.8999999761581421,1.5,800,4,1,2,2,5,2,4,5,2,5,5,5,5,1,2,1,1,5,5,5,2,5,5,5,5,11,2,7,0,2,1,3,1,2,3,2,3,2,5,2,4,4,1,2,3,5,4,4,5,5,1,5,5,4,5,3,1,5,5,5,1,5,4,4,3,5,3,3,5,5,4.625,0,4,0,4.466666666666667,0,3.888888888888889,0,4.166666666666667,0,4.333333333333333,0,4.142857142857143,0,4,0,4.162162162162162,0,6,6,0,2.8216978375079886,2.8381951943733776,2.661927753666121,2.7500614740197493,2,4,2,4,4,4,3,3.857142857142857,0,5,2.2821758381537784,3,3,3,3,2,1,4,2.4285714285714284,0,3.5714285714285716,-1.0219528370065065,0,5,5,5,5,5,5,5,5,5,2,2,3,5,3,3,1,3,2,3,2,5,0,3,0,3.2,0,2.4,0,2.8666666666666667,0,3,4,4,1,3,4,4,1,4,4,4,1,2,4,3,1,3,4,4,3,3.65,0,"White, Caucasian, Anglo, European American",0,22,1,2,NA,5,2,0,0,2,0,0,TRUE,TRUE,TRUE,TRUE,TRUE,0,4,0.9541705882338917,0.68,0.08232556949001775,4,0.5980906249992549,0.7088774193539735,1,0.96875,0.013612221522250601,0.03255648447570016,4,0.7804281250007916,0.8010482758625314,1,0.9666666666666667,0.017278173699364723,0.01380585178146131,1.4425,0.5557,0.5061,1.1694,0.6155,0.6477,0.2133,1.4725316133333333,0.6754665483333333,0.498445415,1.5047,3.7174,0.3957,2.6079,0.4379,-43.4203,1.2823,3.8218,0.4263,3.0938,0.4842,0.9347,1.7737710566666667,2.8468816833333332,4.01159186,0.40829463633333335,0.373924004,1.0554,3.352,0.6476,2.8214,0.6411,0.9797,0.072,0.575,0.358,0.041,1.754,42.78048780487805,370,1.0962962962962963,1,0,0,1,FALSE,FALSE,FALSE
88,2021-11-13T00:41:28Z,1,1.7777777777777777,864,7,3,4,4,3,4,3,3,4,2,2,2,3,5,4,4,4,2,2,1,1,2,2,2,2,1,2,0,0,5,5,5,5,5,5,5,5,5,2,5,3,1,5,1,5,1,1,2,2,3,5,1,1,1,2,1,2,2,2,1,5,3,2,1,2,2,2,1,2,2,1.75,0,1.75,0,2.3333333333333335,0,1,0,1.5833333333333333,0,1,0,1.7142857142857142,0,1.6666666666666667,0,1.4324324324324325,0,1,0,0,-0.6644915307260776,-0.48722647542407477,-0.2989446853297732,-0.393085580376924,5,1,3,1,1,3,2,1.7142857142857142,0,1,-0.4757826382709144,5,5,5,5,3,3,2,4.285714285714286,0,1.7142857142857142,-0.1748077221195339,0,2,3,2,2,2,2,4,3,3,3,1,3,2,3,4,1,4,2,4,2,2.2,0,4,0,4,0,3.4,0,3.8,0,2,1,3,3,3,2,1,2,1,2,2,1,2,2,1,2,2,2,1,2,2.05,0,"White, Caucasian, Anglo, European American",0,29,1,2,NA,5,2,0,0,0,0,0,TRUE,TRUE,TRUE,TRUE,TRUE,0,3,0.9186418604649776,0.86,0.03857472459185775,3,0.5025225806451372,0.5489906249999185,1,1,0.01447804313977957,0.010187011844743145,3,0.7125374999999186,0.8725031249999884,1,1,0.013716223709653733,0.02507247063505934,1.4142,1.407,0.5732,1.0975,1.448,0.6876,0.1372,1.4302610366666666,1.2131194583333333,0.5634895536666666,2.2954,4.4363,0.2438,4.8057,0.3102,-59.1243,1.0834,3.8105,0.3522,4.197,0.4196,0.9244,1.7884895033333332,4.135089266666666,4.02134873,0.33437368566666664,0.276508877,1.1429,4.1804,0.5721,2.9436,0.6929,0.9242,0.163,0.379,0.473,0.008,1.409,176.125,382,1.1318518518518519,1,0,0,1,FALSE,FALSE,FALSE
89,2021-11-13T00:10:54Z,0.8999999761581421,1.7786458333333333,768,6,3,5,5,1,5,1,1,5,1,1,1,1,5,1,5,5,1,1,3,1,1,1,1,1,0,1,3,4,5,3,5,5,3,5,5,5,5,1,5,1,1,5,1,5,1,1,1,1,1,5,3,3,1,2,1,1,1,1,1,5,1,1,1,1,1,1,1,1,1,1.25,0,1,0,1,0,1.4444444444444444,0,1,0,1.6666666666666667,0,0.8571428571428571,0,1,0,1.2432432432432432,0,0,3,4,-1.0931730443606464,-1.3564026722625975,0.5884574430977813,-0.3839726145824081,5,1,3,1,1,1,1,1.2857142857142858,0,2,-0.3631965189619651,5,5,5,5,2,2,2,4,0,2,-0.7395711320441822,0,1,1,1,1,1,1,1,1,1,3,1,5,1,5,5,1,4,1,3,3,1,0,4.8,0,3.4,0,4.6,0,4.266666666666667,0,2,1,1,1,2,1,1,4,1,1,1,4,1,1,1,4,1,1,1,1,1.25,0,"White, Caucasian, Anglo, European American",0,26,1,2,NA,5,2,0,0,1,0,0,TRUE,TRUE,TRUE,TRUE,TRUE,0,1,0.8879972222232156,0.72,0.07573795887741991,1,0.5925321428594845,0.6511370370376993,0.9655172413793104,1,0.03224542290683175,0.015275852420379817,1,0.6261625000014901,0.6844193548377483,1,1,0.012074341128689823,0.009126016279815345,1.4385,0.6863,0.4612,1.1049,0.7556,0.6267,0.0979,1.4632984133333333,0.7608851466666666,0.45348757666666667,2.012,2.4584,0.2005,4.2925,0.4168,-29.7955,1.2416,2.9805,0.3748,5.925,0.5293,0.9796,1.9308474966666667,4.00857074,2.59293777,0.41102489733333336,0.214010041,0.9157,3.2471,0.5026,3.7052,0.5868,0.9055,0.114,0.399,0.497,0.032,1.856,58,292,0.8651851851851852,1,0,0,1,FALSE,FALSE,FALSE
90,2021-11-13T00:46:08Z,1,1.6,900,4,3,4,5,2,5,1,1,4,2,1,1,2,5,1,5,3,2,2,1,1,1,2,2,2,5,2,3,2,3,2,4,5,5,4,5,5,5,1,5,2,1,5,2,4,1,2,1,2,2,5,1,1,1,1,1,1,5,5,2,5,1,1,1,1,1,2,1,1,1,1.625,0,1.25,0,1.4666666666666666,0,1.7777777777777777,0,1.5,0,0.8333333333333334,0,2.142857142857143,0,1,0,1.5945945945945945,0,3,3,2,-0.6413763510693116,-0.8437048643947072,0.92323677340621,0.03976595450575143,5,1,3,1,1,1,1,1.2857142857142858,0,1,-0.7321841937363471,3,4,5,3,2,1,1,3.2857142857142856,0,2.7142857142857144,-1.0219528370065065,0,1,1,1,1,1,1,3,1,1,3,1,5,2,5,5,1,5,3,3,2,1,0,4.6,0,3.6,0,4.8,0,4.333333333333333,0,1,1,1,4,1,1,1,4,1,1,1,4,1,1,1,4,1,1,1,1,1,0,"White, Caucasian, Anglo, European American",0,23,0,1,NA,5,2,0,0,0,0,0,TRUE,TRUE,TRUE,TRUE,TRUE,0,3,1.046291666669978,0.72,0.14369522075104382,3,0.5025741935545398,0.5571999999973923,1,1,0.0023034499790864685,0.004975488386465964,3,0.8018093750122934,0.9262937499955296,1,1,0.019954940231629872,0.03276245867034475,1.6318,0.5965,0.5605,1.3737,0.4353,0.6916,0.2776,1.6273360166666666,0.6812042403333334,0.551330891,6.3193,11.2548,0.2218,8.5922,0.1895,-91.6834,0.8365,6.2562,0.4361,4.7162,0.4748,0.9373,1.83548027,4.71612417,6.10619814,0.3674234476666667,0.3580012166666667,1.5064,3.3936,0.5882,2.847,0.6732,0.9891,0.239,0.323,0.495,0.015,1.658,110.53333333333333,104,0.3081481481481481,1,0,3,4,FALSE,FALSE,FALSE
91,2021-11-13T00:54:06Z,0.8999999761581421,1.6,800,7,3,1,3,4,2,5,3,1,4,4,3,1,1,3,2,2,4,4,4,1,1,5,5,5,1,2,0,NA,3,1,1,1,1,4,3,4,2,5,3,5,3,4,3,4,5,5,5,5,5,1,1,4,1,4,5,1,1,1,1,3,3,1,3,4,4,3,3,1,1,3.625,0,2,0,3.8,0,3.7777777777777777,0,4,0,3.1666666666666665,0,1.4285714285714286,0,3.6666666666666665,0,3.3513513513513513,0,1,0,NA,1.6953581742328474,1.7735027483573693,-0.13158132221341223,0.8209607130719785,4,1,4,1,1,1,1,1.2857142857142858,0,1,-0.7321841937363471,3,3,3,3,1,1,3,2.4285714285714284,0,3.5714285714285716,-1.3043345419688306,0,3,3,4,4,4,4,4,3,3,3,3,4,4,3,4,1,4,2,5,1,3.6,0,3.4,0,3.8,0,3.6,0,3.6,0,2,3,3,2,4,4,3,2,3,3,3,2,1,3,1,2,1,3,3,4,2.8,0,"White, Caucasian, Anglo, European American",0,29,1,2,NA,5,2,0,0,0,0,0,TRUE,TRUE,TRUE,TRUE,TRUE,0,3,0.8579323529408258,0.6938775510204082,0.056785637253419584,3,0.5379258064512283,0.649220689664627,1,0.90625,0.007133421978164435,0.0084466657960672,3,0.8198218749985099,1.0118074074100565,1,0.84375,0.02678248305584184,0.026830280715044966,1.5044,0.6159,0.442,1.0101,0.7285,0.6522,0.2378,1.5305572033333332,0.6898782709,0.391058268,1.3185,3.4945,0.3493,2.5119,0.4223,-45.0752,0.6989,4.5574,0.4725,3.6016,0.569,0.9973,1.515733245,2.734780499,3.9019247166666666,0.401772888,0.338697001,1.0075,2.4411,0.6499,2.1211,0.8201,0.9742,0.105,0.532,0.389,0.007,1.869,267,104,0.3081481481481481,1,0,0,1,FALSE,FALSE,FALSE
93,2021-11-13T00:48:54Z,1,1.6,900,4,2,2,4,3,4,4,3,2,5,3,3,4,2,3,2,4,4,5,5,1,4,5,5,5,3,2,0,2,5,3,3,3,2,4,2,4,1,4,2,4,4,1,3,5,3,5,5,5,5,1,4,3,2,3,2,2,5,1,1,3,2,3,2,2,3,3,4,2,1,4.25,0,2.5,0,3.3333333333333335,0,3,0,4,0,3,0,2.2857142857142856,0,2.3333333333333335,0,3.189189189189189,0,2,0,2,1.983247229958024,1.7718573145771632,0.49225069041682806,1.1320540024969956,5,1,4,2,1,3,2,1.7142857142857142,0,1.5,-0.2912888008837234,5,5,5,5,3,3,2,4.285714285714286,0,1.7142857142857142,0.6723373927674386,0,3,4,4,2,5,2,4,2,2,3,4,4,2,4,5,2,4,3,5,3,3.6,0,3.4,0,4,0,4,0,3.8,0,2,2,3,3,3,3,3,1,1,1,1,2,2,3,2,2,2,3,3,3,2.45,0,"White, Caucasian, Anglo, European American",0,20,1,2,NA,5,2,0,0,2,0,0,TRUE,TRUE,TRUE,TRUE,TRUE,0,5,0.6303258064533434,0.6326530612244898,0.10004827158928349,5,0.4697593750013038,0.5258741935491562,1,0.96875,0.003993187006143249,0.009107462580131063,5,0.5987156250020489,0.7325193548423629,1,1,0.006497912329145065,0.007232902945438902,1.2297,0.4359,0.2974,0.9407,0.5736,0.4393,0.5302,1.2712554066666666,0.6228840311133333,0.292108953,1.2462,4.6212,0.3349,3.2259,0.3404,-69.3404,0.9923,5.7187,0.3874,3.9117,0.4055,0.9918,1.3864932473333333,3.44734076,4.791528616666667,0.3312427846666667,0.32531703133333334,1.0021,4.2412,0.4915,3.5067,0.6047,0.9794,0.152,0.364,0.66,0.011,1.678,152.54545454545456,447,1.3244444444444445,1,0,1,2,FALSE,FALSE,FALSE
94,2021-11-13T00:49:46Z,1,1.6,900,4,4,3,4,3,3,3,2,1,2,1,5,3,4,4,3,3,3,2,1,1,1,3,3,2,2,2,0,0,2,2,3,3,3,5,5,5,5,2,5,1,1,3,1,5,2,2,1,2,3,5,1,1,1,3,2,1,2,2,1,4,2,2,1,2,1,2,1,1,1,2,0,1.25,0,2.933333333333333,0,2.3333333333333335,0,1.6666666666666667,0,1.3333333333333333,0,1.5714285714285714,0,1.3333333333333333,0,1.7837837837837838,0,1,0,0,-0.2904458962802283,0.029052570671323868,-0.4557470907642554,-0.21334726004646576,5,1,4,1,1,1,1,1.1428571428571428,0,1,-0.8176513788914915,5,5,5,4,3,3,1,4.285714285714286,0,1.7142857142857142,0.9547190977297628,0,3,5,4,4,4,4,5,3,1,2,2,4,3,3,3,1,3,3,3,2,4,0,3.2,0,3.6,0,3.6,0,3.466666666666667,0,3,3,3,2,4,4,4,4,4,3,3,2,2,2,1,2,2,2,3,4,2.85,0,"White, Caucasian, Anglo, European American",0,21,1,2,NA,5,2,1,1,1,0,2,TRUE,TRUE,TRUE,TRUE,TRUE,0,2,0.9447189189485602,0.74,0.12163573724501794,2,0.4679374999925494,0.5491406250074505,1,1,0.013338999833208477,0.015804134749682324,2,0.637549999974668,0.6974290322411445,1,0.96875,0.015241419355823915,0.01820794974336264,1.8512,0.6183,0.209,1.56,0.7781,0.4264,0.2925,1.7567725266666667,0.6727267393333334,0.21692627833333333,2.1583,4.5021,0.2282,3.9643,0.2769,-54.5344,1.0241,4.2894,0.3425,4.1699,0.4265,0.977,1.7023621066666668,3.515118106666667,4.142533473333334,0.305119943,0.25962660633333334,1.1495,4.4838,0.5148,3.7646,0.5408,0.9995,0.077,0.411,0.346,0.013,1.373,105.61538461538461,336,0.9955555555555555,1,0,0,1,FALSE,FALSE,FALSE
95,2021-11-13T00:55:13Z,1,1.6,900,4,2,2,2,4,3,4,4,3,4,2,3,5,2,2,2,2,3,4,5,2,3,2,4,2,2,2,2,1,3,3,2,3,3,5,5,5,3,1,5,2,1,4,3,5,5,2,3,2,3,1,2,5,1,3,3,1,2,2,2,1,4,3,1,3,1,1,2,1,1,3.125,0,1.25,0,3.6,0,2.4444444444444446,0,2.1666666666666665,0,3,0,2.5714285714285716,0,1.6666666666666667,0,2.4594594594594597,0,1,2,1,0.8295896270885226,1.0893894566809024,0.13396897132097274,0.6116792140009375,4,2,2,2,1,2,2,2.142857142857143,0,2,0.14960659196890055,2,4,3,3,1,1,3,2.4285714285714284,0,3.5714285714285716,0.10757398284279028,0,4,5,4,4,3,3,4,3,3,5,2,2,4,3,3,2,3,3,2,2,4,0,3,0,3.4,0,3.2,0,3.2,0,2,2,2,3,2,2,3,4,1,2,3,3,2,2,1,3,2,2,2,3,2,0,"White, Caucasian, Anglo, European American",0,18,1,2,NA,5,2,0,0,0,0,0,TRUE,TRUE,TRUE,TRUE,TRUE,0,3,0.7798595237958998,0.84,0.009895812874816988,3,0.46983437505364417,0.5182862068866861,1,0.90625,0.004962372012351137,0.0057345045037441485,3,0.6323843750208616,0.6461322580614397,1,0.96875,0.01159675555351448,0.016696792731441607,1.0764,1.6592,0.5737,0.6329,2.0837,0.713,0.2272,1.132815537,1.3061603053333333,0.56370298,1.1112,3.831,0.3248,3.0659,0.3634,-65.6416,0.7315,6.0296,0.4095,3.1983,0.4249,0.9918,1.237510235,3.2898065433333334,4.142236626666667,0.35416190433333333,0.3179175206666667,1.0848,5.6321,0.5452,4.2294,0.5069,0.9397,0.081,0.382,0.328,0.038,1.49,39.21052631578947,426,1.2622222222222224,1,0,0,1,FALSE,FALSE,FALSE
97,2021-11-13T00:59:08Z,1,1.7777777777777777,1080,4,2,2,2,4,3,4,5,2,5,5,5,5,2,2,2,1,4,5,1,1,5,5,5,5,5,2,0,1,3,4,4,4,2,5,4,4,2,3,3,5,1,4,5,5,5,5,5,5,5,2,2,1,1,2,1,1,3,3,2,4,2,4,1,1,2,1,4,2,2,3.875,0,2.25,0,4.2,0,2.4444444444444446,0,3.75,0,1.6666666666666667,0,2.2857142857142856,0,1.3333333333333333,0,2.675675675675676,0,3,0,1,1.4305842981644374,1.762468663007749,0.44049231459692256,1.1014804888023357,5,1,4,1,1,1,1,1.1428571428571428,0,1.5,-0.6331575415043005,5,5,5,5,3,2,1,4.285714285714286,0,1.7142857142857142,0.10757398284279028,0,3,5,4,4,4,4,4,3,4,3,2,3,4,3,5,5,3,1,3,2,4,0,3.4,0,2.6,0,3.4,0,3.1333333333333333,0,2,4,2,3,4,3,3,2,1,1,3,3,2,3,2,3,3,3,3,3,2.55,0,"White, Caucasian, Anglo, European American",0,27,3,3,NA,5,2,0,0,0,0,0,TRUE,TRUE,TRUE,TRUE,TRUE,0,3,0.7203170731707317,0.8367346938775511,0.012774693027210885,3,0.44106451612903225,0.48848387096774193,1,0.96875,0.0031887956989247314,0.002119403225806452,3,0.60340625,0.6724375,1,1,0.008576313508064513,0.00815677016129032,1.0865,1.6855,0.4928,0.8113,2.2786,0.5843,0.0646,1.130446292,1.313624854,0.48536034666666666,1.682,5.6586,0.2924,5.1711,0.3352,-84.3987,0.6115,4.7288,0.3861,6.3182,0.4425,0.999,1.5782330466666668,4.7151335,5.215735146666667,0.3350230573333333,0.2922210453333333,0.9074,5.2348,0.518,4.889,0.5949,0.6756,0.202,0.293,0.658,0.013,1.262,97.07692307692308,326,0.965925925925926,1,0,0,1,FALSE,FALSE,FALSE
98,2021-11-13T00:53:30Z,1,1.7777777777777777,1440,6,3,4,5,2,4,2,2,4,2,2,2,2,4,2,4,3,2,3,1,1,1,2,2,2,3,2,0,0,4,2,4,3,4,5,3,4,5,2,4,1,1,4,2,4,2,2,2,3,3,5,1,1,1,1,1,1,2,2,2,4,3,2,1,1,1,1,2,2,2,1.75,0,1.75,0,2,0,2.2222222222222223,0,2,0,0.8333333333333334,0,1.8571428571428572,0,1,0,1.8108108108108107,0,2,0,0,-0.4291369742208243,-0.4678684309510564,-0.0958522115332568,-0.2818603212421566,5,1,3,1,1,1,1,1.2857142857142858,0,1,-0.7321841937363471,5,5,5,5,3,3,1,4.428571428571429,0,1.5714285714285714,-0.7395711320441822,0,3,2,2,4,2,3,4,2,2,3,1,3,2,3,4,2,3,4,3,3,2.6,0,3.2,0,3.6,0,3.6,0,3.466666666666667,0,1,1,1,2,2,2,2,2,1,1,1,3,2,2,1,3,1,2,1,2,1.65,0,"Asian or Asian American (e.g., Chinese, Japanese, and others) & White, Caucasian, Anglo, European American",1,25,1,2,NA,5,2,0,0,1,0,0,TRUE,TRUE,TRUE,TRUE,TRUE,0,5,0.6840428571454116,0.7142857142857143,0.025407884192731607,5,0.32774193548098685,0.41630312499683353,0.96875,1,6.822083871490341e-4,0.00422933902237129,5,0.45360000000242146,0.5027645161324932,1,0.96875,0.00263126387134102,0.0018074289918236458,1.1402,0.8559,0.4178,0.6118,1.398,0.6027,0.364,1.2035046680000001,0.900808035,0.409545534,1.1652,7.3351,0.252,4.0555,0.2726,-100.3722,0.8562,8.0052,0.2782,6.5192,0.3501,0.609,1.142304374,3.951994076666667,6.34206154,0.272289956,0.24820175966666666,0.5776,4.4468,0.4102,7.4848,0.4661,0.9852,0.073,0.328,0.638,0.023,1.775,77.17391304347827,362,1.0725925925925925,1,0,0,1,FALSE,FALSE,FALSE
99,2021-11-13T00:49:10Z,1,1.7777777777777777,864,3,4,4,4,5,3,3,1,4,3,1,1,3,4,2,4,2,2,4,1,1,1,2,2,3,1,2,0,0,3,4,4,4,4,4,2,3,4,3,4,2,2,4,2,4,3,2,2,2,3,4,1,1,1,2,1,1,2,2,1,5,1,1,1,2,1,2,1,2,2,2,0,1.75,0,2.4,0,2.4444444444444446,0,2.25,0,1.1666666666666667,0,1.1428571428571428,0,1.3333333333333333,0,1.8918918918918919,0,1,0,0,-0.22320173727872722,-0.1536873691539693,-0.2989446853297732,-0.22631602724187125,5,1,5,1,1,1,1,1,0,2,-0.5341308892722537,3,4,4,4,2,2,3,3.142857142857143,0,2.857142857142857,-1.0219528370065065,0,2,3,3,3,2,2,4,2,3,2,1,2,3,3,4,1,3,2,4,2,2.6,0,3.6,0,3.6,0,3.6,0,3.6,0,2,3,1,2,3,1,2,3,1,1,2,3,2,1,2,3,2,1,1,1,1.75,0,"White, Caucasian, Anglo, European American",0,18,1,2,NA,5,2,0,0,1,0,0,TRUE,TRUE,TRUE,TRUE,TRUE,0,1,0.8529151515151854,0.66,0.12116349830219614,1,0.4428379310346369,0.49851333333334574,0.9354838709677419,0.967741935483871,0.04151703529041307,0.008712086924753263,1,0.9383406249998371,1.4270038461536885,1,0.9629629629629629,0.2918079528124654,0.4009418419944996,1.4986,0.4534,0.415,1.4625,0.2278,0.4472,0.1355,1.5109413766666666,0.5918097973,0.41023043,1.2414,2.176,0.2252,3.2563,0.3168,-37.599,1.2455,3.6252,0.2478,4.0135,0.3419,0.8493,1.3004889003333333,3.40046128,2.4701299066666667,0.313137263,0.223982246,2.4212,1.9469,0.2643,0.8229,0.5015,0.9322,0.134,0.225,0.156,0.005,1.707,341.40000000000003,376,1.114074074074074,1,0,1,2,FALSE,FALSE,FALSE
100,2021-11-13T00:45:09Z,1,1.7777777777777777,1080,3,3,1,4,1,4,2,2,4,2,2,4,2,5,1,5,3,2,2,3,3,1,1,3,1,1,2,0,3,2,2,5,5,5,3,3,4,3,4,3,2,3,4,3,2,4,4,3,2,4,3,1,2,2,3,1,3,2,4,3,2,3,4,1,1,1,1,1,1,1,2,0,1,0,2.1333333333333333,0,2.4444444444444446,0,3.1666666666666665,0,1.8333333333333333,0,3.142857142857143,0,1,0,2.6486486486486487,0,1,0,3,0.24750737573177983,0.05692815471246996,-0.00479935278395429,0.026064400964257835,5,1,3,2,1,1,2,1.5714285714285714,0,1,-0.5612498234260587,4,4,5,3,3,4,2,3.857142857142857,0,2.142857142857143,0.9547190977297628,0,2,2,3,3,4,4,2,3,1,3,3,2,2,3,3,3,2,2,3,4,2.8,0,2.6,0,3,0,3.2,0,2.933333333333333,0,3,2,3,3,2,3,3,3,1,2,2,3,3,2,2,2,3,2,3,3,2.4,0,"White, Caucasian, Anglo, European American & Native American/Alaskan Native/indigenous",1,21,0,1,NA,5,2,0,0,1,0,0,TRUE,TRUE,TRUE,TRUE,TRUE,0,3,0.9439594594614731,0.7708333333333334,0.21366242737606375,3,0.428880000000447,0.5564593750000931,0.967741935483871,1,0.002559224924714439,0.009215067651291355,3,0.6348687500003726,0.7349250000009779,1,1,0.01256044737912635,0.03836104709663325,1.5151,0.8192,0.4368,1.3949,1.0088,0.4571,0.0376,1.5201313933333334,0.845302264,0.43134174533333336,1.155,5.1763,0.3223,3.3591,0.3845,-76.5325,0.8223,5.7291,0.3544,4.4954,0.4618,0.9885,1.2900164183333334,3.5883458033333335,5.16880975,0.375394338,0.312122018,1.4824,5.2235,0.4917,2.2368,0.441,0.8484,0.111,0.361,0.366,0.047,1.991,42.361702127659576,314,0.9303703703703704,1,1,5,6,FALSE,FALSE,FALSE
101,2021-11-13T01:07:39Z,0.8999999761581421,1.7777777777777777,864,3,3,3,4,2,4,1,1,4,2,2,1,1,3,4,3,5,3,4,1,1,1,1,1,2,3,2,0,2,4,2,3,3,4,4,4,4,4,1,4,2,1,1,2,5,5,5,4,2,3,2,4,3,2,3,2,4,3,2,2,2,3,2,2,3,2,3,2,2,2,1.75,0,2.25,0,2,0,2.4444444444444446,0,2.75,0,2.8333333333333335,0,2.7142857142857144,0,2.3333333333333335,0,2.7027027027027026,0,2,0,2,0.12562733754155897,-0.08457915038529361,0.41384948769958696,0.16463516865714667,4,1,3,1,1,1,1,1.4285714285714286,0,1,-0.6467170085812028,3,4,4,3,1,1,2,2.857142857142857,0,3.142857142857143,0.10757398284279028,0,3,3,2,4,3,2,4,2,4,4,2,2,3,2,4,3,2,3,3,4,3,0,3,0,3.4,0,2.8,0,3.066666666666667,0,3,2,3,2,2,3,2,2,2,2,2,3,2,2,1,2,3,2,1,1,2.2,0,"White, Caucasian, Anglo, European American",0,22,1,2,NA,5,2,0,0,0,0,0,TRUE,TRUE,TRUE,TRUE,TRUE,0,NA,NA,NA,NA,NA,NA,NA,NA,NA,NA,NA,3,0.6463531250357628,0.7085548387650521,1,1,0.005418067732207775,0.0045102158826363665,NA,NA,NA,NA,NA,NA,NA,NA,NA,NA,NA,NA,NA,NA,NA,NA,NA,NA,NA,NA,NA,NA,NA,NA,NA,NA,NA,0.8786,4.8088,0.5711,5.8832,0.6454,0.8795,0.179,0.393,0.723,0.013,1.327,102.07692307692308,104,0.3081481481481481,1,0,0,1,FALSE,FALSE,FALSE
102,2021-11-13T01:00:48Z,1,1.7786458333333333,768,6,3,1,4,5,2,5,5,2,5,5,5,5,1,1,3,4,5,5,5,5,3,5,5,5,25,4,7,10,4,1,1,5,1,3,2,4,2,5,1,5,3,2,3,1,5,5,5,5,5,2,3,5,1,5,3,3,5,5,1,5,1,1,3,5,3,1,3,4,4,4.75,0,3,0,4.066666666666666,0,3.4444444444444446,0,4.583333333333333,0,3.3333333333333335,0,2.2857142857142856,0,3.6666666666666665,0,3.6486486486486487,0,6,6,6,2.5800391410963455,2.4993326258731914,3.407020824192241,2.953176725032716,2,5,1,5,5,5,5,4.857142857142857,0,5.5,3.0649399716269796,2,2,2,1,1,1,5,1.4285714285714286,0,4.571428571428571,0.10757398284279028,0,3,2,5,5,3,3,4,1,1,5,1,5,2,5,5,1,5,1,5,2,3.6,0,4.6,0,4.6,0,4.8,0,4.666666666666667,0,2,3,1,4,2,1,1,3,1,2,3,1,1,1,1,2,1,2,2,1,1.75,0,"White, Caucasian, Anglo, European American",0,22,1,2,NA,5,2,0,0,0,0,0,TRUE,TRUE,TRUE,TRUE,TRUE,0,1,1.0384195122137303,0.82,0.09270006183882341,1,0.46728666671117147,0.5874593750238418,1,1,0.0014253660126571656,0.005181423787446328,1,0.6104281250238418,0.6573333333015442,1,0.967741935483871,0.012136122734656644,0.013115483240477734,1.5024,1.0808,0.6133,1.2114,1.054,0.7116,0.1081,1.5207248766666666,1.0194338776666667,0.601263708,10,15.2689,0.1398,9.9169,0.0833,-95.8931,0.7733,7.4937,0.4199,5.3275,0.5169,0.9513,1.96799743,4.404897246666667,6.917452963333333,0.36688346233333335,0.33304712066666664,1.0894,4.2678,0.4994,5.2816,0.5412,0.8775,0.088,0.342,0.338,0.021,1.915,91.19047619047619,362,1.0725925925925925,1,0,0,1,FALSE,FALSE,FALSE
103,2021-11-13T00:53:40Z,1,1.6,800,3,4,3,5,2,5,1,1,3,2,1,2,4,4,1,4,3,3,3,1,1,2,3,2,3,1,2,0,0,3,3,5,5,5,5,5,5,4,1,5,3,1,4,2,5,1,3,4,5,5,4,1,1,1,2,1,1,2,1,1,5,1,1,1,1,2,1,3,1,2,2.25,0,1.75,0,1.9333333333333333,0,1.5555555555555556,0,2.4166666666666665,0,1.1666666666666667,0,1,0,1.3333333333333333,0,1.7027027027027026,0,1,0,0,-0.1853768978403831,-0.32810334985586437,-0.2989446853297732,-0.3135240175928188,5,1,5,1,1,1,1,1,0,2,-0.5341308892722537,5,5,5,4,4,4,1,4.571428571428571,0,1.4285714285714286,-0.1748077221195339,0,3,2,2,3,3,2,5,1,2,3,1,5,3,3,4,1,5,3,5,1,2.6,0,4.4,0,4.2,0,4.2,0,4.266666666666667,0,4,3,2,3,2,1,2,2,1,2,3,3,2,2,3,4,1,2,1,2,2.05,0,"White, Caucasian, Anglo, European American",0,20,1,2,NA,5,2,0,1,4,0,1,TRUE,TRUE,TRUE,TRUE,TRUE,0,1,0.8391162790725397,0.8775510204081632,0.10474905783811077,1,0.3886437500081956,0.468629999991258,1,0.967741935483871,0.001582991572878159,0.002486410902875531,1,0.6070499999970198,0.632522580642854,1,0.96875,0.007751764514473946,0.012574257247234481,1.5909,1.3166,0.4178,1.084,1.7249,0.5749,0.4057,1.55658426,1.162352295,0.4142447303333333,1.0024,5.8646,0.3032,4.8483,0.3697,-104.6912,0.8232,7.6415,0.3362,6.4928,0.4025,0.918,1.0679515653333334,4.64884091,5.62937784,0.363460384,0.29775858,1.2006,4.314,0.4761,3.2416,0.4563,0.9655,0.078,0.401,0.36,0.095,1.764,18.568421052631578,388,1.1496296296296296,1,0,0,1,FALSE,FALSE,FALSE
104,2021-11-13T01:08:23Z,0.800000011920929,1.6,900,3,3,2,3,4,3,5,4,1,5,5,4,3,1,2,2,1,3,5,2,1,4,5,5,5,7,3,0,0,5,2,2,1,3,2,1,3,1,4,2,5,1,3,5,4,5,5,5,5,5,2,1,1,1,5,3,1,5,5,2,3,5,4,2,3,5,3,4,4,3,3.75,0,3.5,0,4.066666666666666,0,3.7777777777777777,0,4.083333333333333,0,2.3333333333333335,0,3.4285714285714284,0,3.3333333333333335,0,3.5945945945945947,0,4,0,0,1.9244085908317106,2.0463543852045625,0.8591411550804637,1.452747770142513,3,2,3,1,1,3,2,2.142857142857143,0,2,0.14960659196890055,4,3,3,2,3,2,2,3,0,3,-1.3043345419688306,0,3,2,2,4,3,2,5,3,2,1,4,3,4,2,3,5,3,2,4,3,2.8,0,3.2,0,2.6,0,3,0,2.933333333333333,0,3,4,3,2,3,3,4,3,3,4,4,3,2,3,2,3,1,3,3,2,2.8,0,"White, Caucasian, Anglo, European American",0,19,1,3,NA,5,2,0,1,0,0,1,TRUE,TRUE,TRUE,TRUE,TRUE,0,3,0.6881388888888873,0.7346938775510204,0.055719308673470976,3,0.48166666666665586,0.5349374999999964,1,1,0.016019769230767946,0.004486383064517314,3,0.6424374999999991,0.6807419354838743,1,1,0.013384705645161605,0.01690273118279549,1.1745,0.8811,0.3722,0.8957,0.9813,0.4896,0.3159,1.2304440773333334,0.9092906909666667,0.3644780223333333,5.3543,6.0142,0.0365,8.4395,0.2177,-64.5885,0.8184,4.3551,0.3858,5.6734,0.4674,0.8644,2.071110586666667,5.2017291766666665,3.73582233,0.34193660366666667,0.19815691,2.0792,13.5448,0.5629,8.6471,0.5581,0.9615,0.168,0.268,0.435,0.039,1.495,38.333333333333336,424,1.2562962962962962,1,0,0,1,FALSE,FALSE,FALSE
105,2021-11-13T00:40:01Z,0.8999999761581421,1.6,900,6,2,3,1,2,1,3,4,2,3,3,2,4,3,4,2,1,4,2,2,3,3,5,3,5,4,5,2,1,2,1,1,1,1,3,3,3,3,2,5,5,2,1,2,3,5,5,5,5,5,3,5,3,4,3,1,3,4,3,1,1,5,5,4,5,3,3,3,3,2,3.375,0,2.75,0,3.6,0,4,0,3.75,0,3,0,3.5714285714285716,0,4,0,3.72972972972973,0,2,2,1,1.7752106130471301,1.7427234576452704,0.8074686614209358,1.2750960595331031,4,1,4,3,1,1,3,1.8571428571428572,0,3,0.34765989643299416,3,4,3,3,1,1,5,2.2857142857142856,0,3.7142857142857144,0.38995568780511447,0,4,4,4,4,4,3,5,4,3,5,1,3,3,3,5,1,5,3,5,5,4,0,3.8,0,4.6,0,2.8,0,3.7333333333333334,0,2,2,2,2,3,1,4,4,2,3,3,3,1,3,2,4,2,1,3,3,2.2,0,"White, Caucasian, Anglo, European American",0,22,1,2,NA,5,2,1,1,1,0,2,TRUE,TRUE,TRUE,TRUE,TRUE,0,2,0.73394102564072,0.78,0.03822378496400457,2,0.47863750000763683,0.5571600000013908,1,0.9375,0.004779921128823358,0.00718250963761583,2,0.6682656249990687,0.7785620689690113,1,0.90625,0.010267068780060977,0.029481759959736724,1.5666,0.9201,0.2623,0.8809,1.4573,0.5715,0.3521,1.5505316433333334,0.915450332,0.26112183733333333,0.9975,3.9751,0.3532,3.247,0.4178,-73.1052,0.8891,5.5971,0.399,3.7278,0.4439,0.9918,1.1714258413333334,3.4866065733333333,4.342994583333334,0.40284876333333336,0.342634224,0.9794,3.7729,0.5463,2.5583,0.6077,0.9341,0.06,0.521,0.389,0.014,1.568,112,104,0.3081481481481481,1,0,0,1,FALSE,FALSE,FALSE
106,2021-11-13T01:01:52Z,1,1.7777777777777777,720,4,2,3,3,2,4,1,2,4,3,2,1,1,3,4,4,3,2,2,1,1,1,3,1,3,1,2,2,3,5,2,2,3,3,4,3,2,2,2,4,2,1,1,1,1,1,2,4,4,4,4,2,1,1,2,1,1,2,2,2,5,1,2,1,1,1,3,2,2,3,1.75,0,2.5,0,2.2666666666666666,0,3.111111111111111,0,2.75,0,1.3333333333333333,0,1.4285714285714286,0,1,0,2.27027027027027,0,1,2,3,-0.143349298464445,-0.15581675404600126,0.8788742787055398,0.36152876232976927,4,2,2,4,2,3,3,2.857142857142857,0,2,0.5769425177446221,5,5,5,5,2,2,2,4,0,2,2.0842459175790595,0,3,2,3,2,2,2,5,2,2,3,2,4,2,3,4,1,4,3,3,2,2.4,0,3.8,0,4,0,3.8,0,3.8666666666666667,0,3,2,4,2,2,4,2,2,2,2,1,2,1,3,2,2,3,4,1,2,2.5,0,"Hispanic of Latino (e.g., Mexican American, Central American, and others)",0,19,1,2,NA,5,2,0,0,0,0,0,TRUE,TRUE,TRUE,TRUE,TRUE,0,2,1.1501857142857144,0.7142857142857143,0.27543416791707126,NA,NA,NA,NA,NA,NA,NA,2,0.740590624999255,0.8235741935487717,1,1,0.01509942023182017,0.0337829706450145,1.6472,0.5456,0.6684,1.6069,0.2836,0.6801,5e-4,1.65769792,0.629493224,0.6515620276666667,NA,NA,NA,NA,NA,NA,NA,NA,NA,NA,NA,NA,NA,NA,NA,NA,NA,1.216,3.2792,0.5653,2.8225,0.6104,0.989,0.184,0.352,0.479,0.011,1.169,106.27272727272728,366,1.0844444444444443,1,0,0,1,FALSE,FALSE,FALSE
107,2021-11-13T00:54:55Z,0.8999999761581421,1.5,912,6,2,4,4,2,5,2,1,4,1,2,2,2,5,1,5,5,1,3,1,1,1,1,1,1,0,2,0,0,5,5,4,4,5,5,5,5,5,1,5,1,2,5,3,5,2,2,2,4,4,5,1,1,1,5,2,1,1,1,1,5,2,1,1,3,1,1,1,1,1,1.25,0,1,0,1.5333333333333334,0,1.2222222222222223,0,2,0,1.6666666666666667,0,1,0,1.6666666666666667,0,1.5945945945945945,0,0,0,0,-0.8746295276057681,-0.9762106788125177,-0.7372407672780129,-0.8567257230452653,5,2,3,1,1,1,1,1.4285714285714286,0,1,-0.6467170085812028,4,4,5,4,5,4,3,4.142857142857143,0,1.8571428571428572,-0.4571894270818581,0,5,5,5,3,4,5,4,3,4,3,4,3,3,4,5,4,3,2,5,4,4.4,0,2.6,0,3.4,0,3.2,0,3.066666666666667,0,3,1,2,3,4,1,4,4,1,2,1,4,2,3,1,4,3,3,1,2,1.95,0,"Asian or Asian American (e.g., Chinese, Japanese, and others)",0,26,1,3,NA,5,2,0,0,0,0,0,TRUE,TRUE,TRUE,TRUE,TRUE,0,6,0.7072242424226168,0.66,0.17060721959289915,6,0.36121199999928477,0.39425925925815547,0.8620689655172413,0.84375,0.0024627716749243468,0.005273612097032463,6,0.550375,0.6158600000023842,1,0.9375,0.010059782580729914,0.006058048225350566,1.2979,0.5019,0.4265,1.1592,0.2511,0.4463,0.0781,1.3420226833333333,0.6500585355033334,0.41867536333333333,0.805,2.9153,0.2549,1.9898,0.2472,-54.3419,0.6679,4.0509,0.2825,2.4708,0.3075,0.9421,0.853253771,2.316551765333333,3.34434774,0.24435100066666668,0.2524397526666667,0.9058,3.0006,0.4303,4.5168,0.5148,0.9978,0.073,0.376,0.475,0.013,1.602,123.23076923076924,476,1.4103703703703703,1,0,0,1,FALSE,FALSE,FALSE
108,2021-11-13T01:06:32Z,1,1.6,900,5,3,1,4,3,3,2,1,3,3,2,2,3,3,2,4,4,2,2,1,1,1,1,1,1,3,2,0,0,4,3,4,4,4,4,4,4,4,2,4,2,1,4,1,5,2,2,3,3,3,4,1,1,1,3,1,1,3,3,1,4,1,1,1,1,1,2,1,2,1,1.25,0,1.5,0,2.533333333333333,0,2.111111111111111,0,2,0,1.3333333333333333,0,1.5714285714285714,0,1,0,1.8108108108108107,0,2,0,0,-0.7401412096027664,-0.4535434780410229,-0.17425341425049792,-0.3138984461457604,4,2,4,1,1,1,1,1.4285714285714286,0,1,-0.6467170085812028,4,4,4,4,4,4,1,4.142857142857143,0,1.8571428571428572,0.10757398284279028,0,2,3,3,3,2,3,3,3,2,2,2,4,4,4,3,2,4,3,3,3,2.6,0,3.6,0,2.8,0,3.4,0,3.2666666666666666,0,3,3,3,2,2,3,3,2,3,3,2,2,3,3,3,2,2,3,3,2,2.8,0,"Hispanic of Latino (e.g., Mexican American, Central American, and others)",0,21,1,2,NA,5,2,0,0,1,0,0,TRUE,TRUE,TRUE,TRUE,TRUE,0,NA,NA,NA,NA,2,0.561916129031489,0.7156499999985099,1,1,0.004185088064388799,0.009190049677267111,2,0.679961290324888,0.8969299999992053,0.96875,0.967741935483871,0.00693418064508193,0.07116477982895782,NA,NA,NA,NA,NA,NA,NA,NA,NA,NA,8.4143,9.7871,0.1321,7.9751,0.1881,-72.3481,0.8932,5.3899,0.486,3.0811,0.599,0.9979,2.2460874066666667,4.386941373333333,5.2413159333333335,0.462137365,0.350218932,1.5726,5.3379,0.528,2.9436,0.5903,0.9418,0.079,0.496,0.352,0.013,1.727,132.84615384615387,268,0.794074074074074,1,0,0,1,FALSE,FALSE,FALSE
109,2021-11-13T00:54:00Z,0.800000011920929,1.7786458333333333,768,3,1,4,4,1,4,1,1,5,1,2,1,1,5,1,4,2,1,1,1,1,1,2,1,1,3,2,0,2,5,5,5,5,5,5,2,4,3,2,4,1,1,2,1,4,1,1,1,2,1,1,2,5,1,4,4,1,2,3,2,5,1,2,1,1,1,1,1,1,2,1.125,0,1.25,0,1.5333333333333334,0,1.6666666666666667,0,1.5833333333333333,0,3.3333333333333335,0,1.5714285714285714,0,1,0,1.8918918918918919,0,2,0,2,-0.7674591491971259,-0.9021661587032226,0.10024467683062248,-0.4009607409363001,5,1,2,1,1,2,1,1.5714285714285714,0,1,-0.5612498234260587,1,3,4,2,1,1,2,2.2857142857142856,0,3.7142857142857144,0.6723373927674386,0,4,4,4,2,2,2,2,3,4,2,2,2,3,4,4,3,3,2,1,4,3.2,0,3.4,0,2.2,0,3,0,2.8666666666666667,0,2,2,3,1,2,3,3,1,2,1,2,1,2,3,1,2,2,3,1,2,2.45,0,"Asian or Asian American (e.g., Chinese, Japanese, and others) & Hispanic of Latino (e.g., Mexican American, Central American, and others)",1,20,1,2,NA,5,2,0,0,0,0,0,TRUE,TRUE,TRUE,TRUE,TRUE,0,2,1.1390314515559905,0.6458333333333334,0.1939662576902275,2,0.580947580416837,0.6437465000897646,0.96875,0.967741935483871,0.03863139058503473,0.012774767661201475,2,0.7058076667909821,0.8714398441952653,1,1,0.02285706692575302,0.023676719128934248,1.6695,0.3789,0.5657,1.4271,0.3566,0.6959,0.2251,1.65792209,0.51521978874,0.556162015,1.6041,2.2641,0.2425,3.1578,0.4017,-26.6295,1.2327,2.4292,0.3382,3.1279,0.4607,0.9038,1.68915695,3.24865017,2.529016573333333,0.391335487,0.24112917666666667,1.3177,3.7135,0.5353,2.7477,0.6599,0.938,0.332,0.126,0.596,0.005,1.258,251.6,344,1.0192592592592593,1,0,0,1,FALSE,FALSE,FALSE
110,2021-11-13T01:06:57Z,1,1.6,900,4,4,4,4,2,5,1,1,4,3,1,1,1,4,2,4,5,2,3,5,1,1,1,2,1,2,2,1,2,5,4,4,3,3,5,5,4,4,2,4,1,1,3,1,5,2,2,1,1,1,3,1,2,3,2,1,1,2,1,1,5,1,1,1,1,1,1,2,1,1,2,0,1.25,0,1.6,0,1.8888888888888888,0,1.5,0,1.8333333333333333,0,1,0,1,0,1.5675675675675675,0,1,1,2,-0.4249342142832303,-0.6368641592005065,0.10378541062712981,-0.2665393742866884,5,1,5,1,1,2,1,1.1428571428571428,0,1,-0.8176513788914915,5,5,5,5,2,2,1,4.142857142857143,0,1.8571428571428572,-0.1748077221195339,0,2,2,3,3,2,2,4,2,2,1,2,3,2,3,5,1,3,2,4,3,2.4,0,3.6,0,3.6,0,3.8,0,3.6666666666666665,0,1,1,1,4,2,1,1,4,1,1,1,3,2,1,1,3,1,1,1,1,1.2,0,"White, Caucasian, Anglo, European American",0,21,1,2,NA,5,2,0,0,1,0,0,TRUE,TRUE,TRUE,TRUE,TRUE,0,3,0.7896675675753001,0.74,0.03064934041421359,3,0.43976249999552963,0.5793096774162785,1,0.96875,0.003950130160861132,0.003289109508710302,3,0.6575093749985099,0.7409593750163913,1,1,0.020675486681151878,0.025717867637156663,1.4261,0.8222,0.3768,0.8661,1.2223,0.6285,0.3276,1.4508701,0.8642757396666667,0.3710241303333333,1.8143,4.861,0.2531,4.6009,0.3942,-70.7086,0.6409,5.5542,0.394,4.7344,0.523,0.9818,1.7348434166666666,4.2765536766666665,4.701405386666667,0.39158025533333335,0.25566861533333335,1.2591,3.3068,0.4767,4.7326,0.5953,0.9826,0.21,0.25,0.529,0.018,1.723,95.72222222222223,448,1.3274074074074074,1,0,1,2,FALSE,FALSE,FALSE
111,2021-11-13T01:09:48Z,0.8999999761581421,1.7777777777777777,864,3,4,4,5,2,4,3,1,5,1,1,1,1,4,2,5,5,1,1,1,1,1,1,1,2,3,2,0,0,5,4,5,4,5,5,2,5,3,1,4,1,1,3,1,4,4,1,1,2,1,5,1,1,1,3,1,1,2,1,1,4,3,1,1,1,1,1,1,2,1,1.125,0,1.25,0,1.4666666666666666,0,1.7777777777777777,0,1.6666666666666667,0,1.1666666666666667,0,1.4285714285714286,0,1,0,1.5675675675675675,0,2,0,0,-0.9691916262016289,-1.0701939847290214,-0.25265461696773905,-0.6614243008483802,5,1,5,1,1,1,1,1,0,1,-0.9031185640466358,5,5,5,5,4,3,1,4.571428571428571,0,1.4285714285714286,-1.0219528370065065,0,2,3,3,2,2,3,4,1,1,1,1,3,1,4,2,1,4,1,4,3,2.4,0,4,0,3.8,0,3.8,0,3.8666666666666667,0,1,3,1,4,2,1,1,4,1,1,1,4,1,1,1,4,1,1,1,1,1.15,0,"White, Caucasian, Anglo, European American",0,19,1,2,NA,5,2,0,1,0,0,1,TRUE,TRUE,TRUE,TRUE,TRUE,0,NA,NA,NA,NA,NA,NA,NA,NA,NA,NA,NA,6,0.8094250000001048,0.8933333333332713,1,0.967741935483871,0.020396151612911907,0.02283140397853056,NA,NA,NA,NA,NA,NA,NA,NA,NA,NA,NA,NA,NA,NA,NA,NA,NA,NA,NA,NA,NA,NA,NA,NA,NA,NA,NA,1.2975,4.0523,0.6334,2.6448,0.6785,0.9611,0.075,0.592,0.342,0.018,1.724,95.77777777777779,104,0.3081481481481481,1,1,1,2,TRUE,FALSE,FALSE
112,2021-11-13T01:14:19Z,1,1.7779690189328743,1162,7,3,2,4,2,3,3,4,3,2,2,1,1,4,1,3,2,2,3,5,1,2,2,2,1,5,2,1,2,4,3,4,4,3,2,3,2,3,1,3,3,1,2,1,5,3,3,1,1,1,3,1,1,3,2,1,1,3,3,1,3,2,1,1,1,1,2,2,2,2,2.25,0,2,0,2.466666666666667,0,2.888888888888889,0,1.9166666666666667,0,1.6666666666666667,0,1.8571428571428572,0,1,0,2.081081081081081,0,3,1,2,0.04997765866487016,0.06370347027802684,0.7451739663718859,0.40443871832495637,4,1,2,1,1,2,2,1.8571428571428572,0,1.5,-0.20582161572857902,5,5,5,5,2,2,2,4,0,2,0.10757398284279028,0,2,2,2,2,2,1,4,1,1,1,1,4,1,4,1,2,1,1,3,4,2,0,4,0,3.4,0,3.4,0,3.6,0,1,1,1,1,1,2,2,3,1,1,1,3,1,2,1,3,1,2,1,1,1.5,0,"White, Caucasian, Anglo, European American",0,26,0,1,NA,5,2,0,0,1,0,0,TRUE,TRUE,TRUE,TRUE,TRUE,0,2,0.6655787878795103,0.66,0.0648259567714906,NA,NA,NA,NA,NA,NA,NA,2,0.5247218749993481,0.603261290322869,1,0.96875,0.002169203699700842,0.0035008670565580577,1.2655,0.5412,0.3144,1.0918,0.4356,0.3848,0.0736,1.3045908533333332,0.6850452341,0.30949119833333333,NA,NA,NA,NA,NA,NA,NA,NA,NA,NA,NA,NA,NA,NA,NA,NA,NA,0.6043,6.1318,0.4793,5.5948,0.5609,0.9546,0.073,0.419,0.704,0.025,2.152,86.08,105,0.3111111111111111,1,1,3,4,FALSE,FALSE,FALSE
113,2021-11-13T01:05:07Z,1,1.6,900,4,3,5,4,2,4,2,1,5,2,2,1,1,4,3,4,4,2,2,1,1,2,1,1,3,0,2,0,0,5,2,3,4,4,5,2,3,4,1,4,1,2,4,2,5,2,1,2,2,1,5,1,1,1,2,1,1,1,1,1,5,1,1,1,3,2,1,1,1,1,1.625,0,1,0,1.7333333333333334,0,2.4444444444444446,0,1.5833333333333333,0,1,0,0.8571428571428571,0,2,0,1.6486486486486487,0,0,0,0,-0.6077542715685611,-0.7058755877468168,-0.7372407672780129,-0.7215581775124149,4,2,3,1,1,3,2,2,0,1,-0.3048482679606258,5,5,5,5,3,2,1,4.285714285714286,0,1.7142857142857142,-0.7395711320441822,0,1,3,1,1,1,1,4,1,1,3,2,5,2,4,3,3,5,1,5,1,1.4,0,4.8,0,3.8,0,4.4,0,4.333333333333333,0,2,3,4,1,3,4,4,1,2,3,4,1,2,1,1,1,2,4,4,3,3.1,0,"White, Caucasian, Anglo, European American",0,20,1,2,NA,5,2,0,0,0,0,0,TRUE,TRUE,TRUE,TRUE,TRUE,0,2,1.1700358974322294,0.7959183673469388,0.24580718831063444,2,0.48373749999329446,0.5667062500081956,1,1,0.00292126822640917,0.007214141250998484,2,0.6506656250059605,0.709806451628285,1,0.96875,0.008036759101702436,0.015484387893903122,1.6273,0.8086,0.6093,1.6014,0.8086,0.5687,0.038,1.6312093233333333,0.83478967066666665,0.5968637313333334,6.3161,9.9439,0.1662,7.9642,0.1702,-83.9407,0.9028,7.0608,0.4222,5.3319,0.4784,0.9984,1.8931724366666667,4.682463036666666,5.43451076,0.369250639,0.313053093,0.9167,6.0806,0.5839,2.5123,0.5782,0.9474,0.079,0.438,0.367,0.02,1.606,80.3,378,1.12,1,0,0,1,FALSE,FALSE,FALSE
115,2021-11-13T01:05:17Z,0.8999999761581421,1.6,900,6,3,4,5,2,5,2,2,4,2,2,1,1,4,2,4,3,2,4,5,1,1,3,2,2,3,3,1,6,4,5,3,4,4,4,3,3,3,3,5,2,1,3,4,4,5,4,4,4,1,2,4,5,2,1,1,1,4,4,2,4,2,2,1,1,1,1,2,1,2,2.5,0,1.5,0,1.8,0,2.3333333333333335,0,2.8333333333333335,0,2.6666666666666665,0,2.2857142857142856,0,1,0,2.4864864864864864,0,2,1,6,0.4576453726114698,0.058863959159771675,1.0910776747376103,0.574970816948691,5,1,3,1,2,2,1,1.5714285714285714,0,1,-0.5612498234260587,5,5,5,5,4,4,1,4.714285714285714,0,1.2857142857142858,-1.0219528370065065,0,1,1,3,3,1,2,5,1,1,4,1,5,2,5,5,1,5,1,5,3,1.8,0,4.8,0,4.6,0,4.6,0,4.666666666666667,0,2,4,2,2,1,2,2,3,1,1,4,3,2,3,2,3,2,3,2,4,2.3,0,"White, Caucasian, Anglo, European American",0,21,1,2,NA,5,2,0,0,1,0,0,TRUE,TRUE,TRUE,TRUE,TRUE,0,6,1.3234999999999948,0.7083333333333334,0.22919291489361468,6,0.44387499999999724,0.5529062499999982,1,1,0.0025310806451611994,0.006360732862903239,6,0.6250624999999964,0.71453125,1,1,0.004109415322581272,0.0037916118951618425,2.0524,0.4656,0.4902,1.6723,0.3669,0.8042,0.6126,1.92322077,0.5333256128,0.4930215413333333,1.5802,6.3099,0.3187,5.5132,0.4096,-96.657,0.7863,6.4345,0.3815,3.6606,0.4577,0.8999,1.5185517433333333,4.9818894333333335,5.72559885,0.405516527,0.3157223493333333,0.9077,5.3587,0.5393,5.7263,0.6383,0.9699,0.189,0.383,0.801,0.014,1.552,110.85714285714286,408,1.208888888888889,1,0,0,1,FALSE,FALSE,FALSE
116,2021-11-13T01:10:06Z,1,2.3703703703703702,1080,3,3,4,4,2,4,2,1,4,2,2,1,2,4,2,4,5,2,3,1,1,2,1,1,1,1,2,0,0,5,4,5,5,5,5,4,4,4,1,5,2,1,3,3,5,4,3,3,3,3,4,1,1,1,2,1,1,2,1,1,5,2,2,1,1,1,1,1,1,1,1.5,0,1,0,1.8,0,1.4444444444444444,0,2.3333333333333335,0,1.1666666666666667,0,1.2857142857142858,0,1,0,1.6756756756756757,0,1,0,0,-0.6686942906636716,-0.7193294286555646,-0.5341482934814965,-0.6267388610685305,5,1,4,1,1,1,2,1.2857142857142858,0,1,-0.7321841937363471,5,5,5,4,2,2,1,4,0,2,0.6723373927674386,0,2,2,2,1,1,2,5,1,1,3,2,5,2,3,4,1,5,3,4,5,1.6,0,4.2,0,4.2,0,3.6,0,4,0,1,2,1,4,1,1,1,3,1,1,1,3,1,1,2,3,1,1,1,2,1.3,0,"White, Caucasian, Anglo, European American",0,20,0,1,NA,5,2,0,0,1,0,0,TRUE,TRUE,TRUE,TRUE,TRUE,0,3,0.7945051282046315,0.78,0.05198038041231931,3,0.42882187499979046,0.4853166666665425,1,0.9375,0.0012905714415548503,0.004074016411291552,3,0.5623000000005047,0.6002718750002095,1,1,0.004169228000011489,0.004400536925421816,1.376,0.9659,0.3933,1.0707,1.1677,0.5342,0.2949,1.4029310633333334,0.952781781,0.38728096666666667,0.9719,6.2848,0.3515,3.4252,0.3605,-96.7403,0.6923,5.8465,0.3735,5.2694,0.4189,0.9908,1.0449377033333334,3.5771340633333333,5.900636246666667,0.3549116056666667,0.3454571143333333,0.8593,5.3521,0.4857,5.7916,0.526,0.9253,0.271,0.276,0.943,0.015,0.921,61.400000000000006,328,0.9718518518518519,1,0,0,1,FALSE,FALSE,FALSE
118,2021-11-13T01:09:46Z,0.8999999761581421,1.6,900,6,2,2,2,2,4,4,4,4,4,4,4,2,4,2,4,4,2,2,1,1,2,3,3,2,2,2,0,0,4,4,2,4,4,4,4,4,4,1,5,1,1,4,2,4,4,4,4,4,4,2,1,4,1,1,1,1,1,1,1,5,1,1,1,1,2,1,1,1,1,2,0,1,0,2.933333333333333,0,2.2222222222222223,0,2.5,0,1.8333333333333333,0,0.8571428571428571,0,1.3333333333333333,0,1.972972972972973,0,1,0,0,-0.1727686180276017,0.11035635745800056,-0.5341482934814965,-0.21189596801174798,2,4,1,3,3,4,4,3.857142857142857,0,2,1.175212813830632,2,4,4,3,1,1,4,2.4285714285714284,0,3.5714285714285716,0.38995568780511447,0,4,4,4,5,4,4,4,4,4,2,4,4,2,4,4,2,4,2,5,4,4.2,0,3.2,0,3.8,0,2.8,0,3.2666666666666666,0,3,1,1,3,3,1,2,3,2,1,3,3,1,1,3,3,1,2,1,1,1.75,0,"Hispanic of Latino (e.g., Mexican American, Central American, and others)",0,28,1,1,NA,5,2,1,1,3,0,2,TRUE,TRUE,TRUE,TRUE,TRUE,0,4,0.8241142857142807,0.7142857142857143,0.0675774396258514,4,0.4462258064516185,0.5480625000000082,1,1,0.0023791139784948715,0.005282512096774333,4,0.5738750000000027,0.6566666666666662,1,0.9375,0.005319983870967932,0.012520129032257535,1.3933,0.6709,0.3565,1.1452,0.942,0.5041,0.475,1.41927707,0.7580093677666667,0.351707148,9.6286,12.6128,0.0645,10.0042,0.0668,-90.3873,0.8372,7.3392,0.3915,5.6058,0.4749,0.9706,1.9589405766666668,4.975951843333333,5.7206279533333335,0.356510267,0.279485855,1.004,6.0178,0.4948,3.0155,0.4975,0.9624,0.063,0.438,0.397,0.029,1.787,61.620689655172406,442,1.3096296296296297,1,0,0,1,FALSE,FALSE,FALSE
119,2021-11-13T01:16:49Z,1,1.4995014955134596,1003,5,4,2,4,3,3,4,2,3,4,4,2,3,2,4,2,2,3,5,1,1,4,4,3,4,0,3,0,0,4,3,4,4,4,5,4,4,3,2,2,3,1,4,3,4,4,5,4,4,4,2,2,3,1,3,3,2,1,1,1,4,2,2,1,1,4,2,4,1,3,3.125,0,2.5,0,3.3333333333333335,0,2.111111111111111,0,3.1666666666666665,0,2.5,0,1.4285714285714286,0,2,0,2.4324324324324325,0,0,0,0,0.8127785873381472,0.9631750067168229,-0.26683355097456624,0.34817072787112835,5,2,5,1,1,2,3,1.5714285714285714,0,3.5,0.3612193635098966,5,5,5,5,4,3,1,4.571428571428571,0,1.4285714285714286,-1.0219528370065065,0,2,3,3,2,2,2,4,3,2,4,1,4,3,3,3,2,5,2,3,4,2.4,0,4.4,0,3.6,0,3,0,3.6666666666666665,0,2,2,2,3,3,3,3,3,2,2,4,3,2,3,2,3,1,3,2,2,2.3,0,"White, Caucasian, Anglo, European American",0,20,1,1,NA,5,2,0,0,2,0,0,TRUE,TRUE,TRUE,TRUE,TRUE,0,6,1.1638809523809523,0.84,0.13362795469387753,6,0.4783125,0.538625,1,1,0.0032206088709677413,0.003394435483870967,6,0.59053125,0.66596875,1,1,0.005114450604838711,0.0062408054435483876,1.7339,0.9989,0.6005,1.6824,1.0566,0.6278,0.416,1.69649169,0.9541340153333333,0.5915337356666667,4.9653,9.3059,0.2115,8.9781,0.2621,-94.5763,0.8534,5.962,0.4095,6.2766,0.471,0.8904,1.8072653966666667,5.299788116666667,5.60569221,0.3741938123333333,0.3211047873333333,0.6489,4.6759,0.5382,3.9815,0.606,0.9652,0.303,0.203,0.783,0.019,1.62,85.26315789473685,456,1.3511111111111112,1,0,0,1,FALSE,FALSE,FALSE
120,2021-11-13T01:09:40Z,1,1.7777777777777777,864,5,2,2,3,3,3,3,3,3,3,3,3,4,3,4,2,3,3,3,3,2,2,2,3,3,7,2,0,0,4,4,4,4,4,5,5,5,5,1,5,1,1,4,4,5,5,4,4,3,4,3,1,2,1,4,5,1,5,4,1,5,1,2,1,2,1,3,2,3,3,2.625,0,2.75,0,3.2666666666666666,0,1.5555555555555556,0,2.5833333333333335,0,2.5,0,2,0,1.3333333333333333,0,2.1621621621621623,0,4,0,0,0.3336639544524528,0.6035025404081422,0.6239375469287404,0.6137200436684414,5,1,3,1,1,2,1,1.4285714285714286,0,1,-0.6467170085812028,3,3,3,3,1,1,3,2.4285714285714284,0,3.5714285714285716,1.237100802692087,0,1,1,1,1,1,2,5,1,1,3,3,4,3,5,5,1,3,3,5,1,1,0,3.4,0,4.2,0,5,0,4.2,0,3,1,3,2,4,4,4,3,2,1,2,2,2,3,2,2,2,2,2,4,2.6,0,"White, Caucasian, Anglo, European American",0,22,1,2,NA,5,2,0,0,0,0,0,TRUE,TRUE,TRUE,TRUE,TRUE,0,4,0.6154060606089505,0.66,0.026868070677941884,4,0.4510093750040978,0.5202535714230367,1,0.9032258064516129,0.00488994345809344,0.005861238581555424,4,0.6249124999959021,0.7357499999981374,1,1,0.01313320951519023,0.01425917741831791,1.1725,0.6233,0.3431,0.8055,0.6574,0.4783,0.0693,1.2259140206666668,0.7609369036666667,0.33795739233333333,1.2442,3.8341,0.2888,2.6291,0.3236,-53.9246,0.6735,6.0299,0.3996,4.2824,0.4468,0.9498,1.345192767,2.87585194,4.08070878,0.318143662,0.283507372,1.0314,3.8174,0.5045,3.5929,0.5944,0.9922,0.26,0.214,0.636,0.017,1.769,104.05882352941175,298,0.882962962962963,1,0,0,1,FALSE,FALSE,FALSE
121,2021-11-13T01:08:41Z,1,1.6,900,6,3,3,4,2,4,2,1,2,2,3,1,2,4,1,3,4,2,2,1,1,1,1,1,1,0,2,0,0,5,4,4,3,2,5,4,5,5,5,4,2,2,4,3,3,3,5,2,4,3,2,1,1,1,2,1,2,1,1,1,5,1,1,1,3,2,2,1,1,1,1.25,0,1.25,0,2.1333333333333333,0,1.8888888888888888,0,3,0,1.5,0,1,0,2,0,2.081081081081081,0,0,0,0,-0.5720308120990136,-0.5092946461233157,-0.6588395645607719,-0.5840671053420438,4,2,3,1,1,2,2,1.8571428571428572,0,2,-0.021327778341387937,5,4,4,4,2,2,2,3.5714285714285716,0,2.4285714285714284,-0.4571894270818581,0,1,2,1,2,1,1,4,1,1,4,2,5,2,4,5,1,4,1,3,2,1.4,0,4.6,0,4,0,4.6,0,4.4,0,2,4,1,3,2,2,1,4,1,1,1,4,4,2,2,4,1,2,1,1,1.65,0,Black or African American,0,23,1,2,NA,5,2,0,0,0,0,0,TRUE,TRUE,TRUE,TRUE,TRUE,0,2,0.9075682926832176,0.82,0.029051874860606782,2,0.5484031250048429,0.6258600000023842,1,0.9375,0.015251782894425822,0.026975135485103444,2,0.7225968750026077,0.9010612903275798,1,0.96875,0.019513166117059506,0.054803381253901565,1.3797,1.2092,0.5591,0.8124,1.6153,0.7761,0.2932,1.41108259,1.100496422,0.550126233,1.4173,3.2603,0.331,2.3035,0.3523,-35.522,1.2579,3.6817,0.3752,2.59,0.396,0.9974,1.5424443633333333,2.52903421,3.5175592166666667,0.34224288633333333,0.32183745766666666,1.4025,3.8301,0.5296,2.2017,0.601,0.9327,0.088,0.462,0.303,0.008,1.362,170.25,104,0.3081481481481481,1,0,0,1,FALSE,FALSE,FALSE
122,2021-11-13T01:17:20Z,1,1.6,900,4,3,5,5,1,5,1,1,5,1,1,1,1,5,1,5,5,1,1,1,1,1,1,1,1,0,2,0,0,5,5,5,5,5,5,5,5,5,1,5,1,1,5,1,5,1,1,1,1,1,5,1,1,1,1,1,1,1,1,1,5,1,1,1,1,1,1,1,1,1,1,0,1,0,1,0,1,0,1,0,0.8333333333333334,0,0.8571428571428571,0,1,0,1,0,0,0,0,-1.3999745198049947,-1.568373259242148,-0.7372407672780129,-1.1528070132600805,5,1,5,1,1,1,1,1,0,1,-0.9031185640466358,5,5,5,5,5,5,1,5,0,1,-0.1748077221195339,0,1,1,1,1,1,1,5,2,1,1,1,4,1,3,4,1,4,1,4,3,1,0,4.6,0,4,0,3.8,0,4.133333333333334,0,1,2,2,3,4,1,2,4,1,1,1,4,2,1,1,4,2,2,1,3,1.6,0,"White, Caucasian, Anglo, European American",0,20,1,2,NA,5,2,0,1,2,0,1,TRUE,TRUE,TRUE,TRUE,TRUE,0,3,1.0880162790715695,0.8775510204081632,0.07076196093425587,3,0.46643225806374705,0.5150933333337306,1,0.9375,0.0041754389245313595,0.002691952096944322,3,0.7378250000020489,0.7389419354834864,1,0.96875,0.027193083225284173,0.012482081128477204,1.7981,1.2144,0.5348,1.0508,1.8026,0.8805,0.5865,1.7063698666666667,1.087735722,0.5319148083333334,1.0943,3.8823,0.3255,4.2164,0.3986,-77.4267,0.7151,5.1928,0.4024,5.8086,0.4514,0.9087,1.2372707613333334,4.2532554566666665,4.231855786666666,0.38734754233333335,0.31827927533333333,1.158,2.9387,0.5418,3.3537,0.5844,0.9401,0.069,0.511,0.353,0.025,1.645,65.8,422,1.2503703703703704,1,0,0,1,FALSE,FALSE,FALSE
123,2021-11-13T01:04:40Z,1,1.7777777777777777,1080,6,2,3,4,3,3,4,3,2,3,2,3,2,3,2,2,2,4,5,4,1,2,2,3,2,5,2,0,0,4,2,4,2,3,5,4,4,4,2,5,5,1,4,1,4,3,4,5,5,5,2,1,1,1,3,1,1,4,3,1,3,3,1,2,3,3,2,2,3,1,2.875,0,2,0,3,0,2.4444444444444446,0,3,0,1.6666666666666667,0,2.142857142857143,0,2.6666666666666665,0,2.5135135135135136,0,3,0,0,0.7077095888983023,0.7473328108426686,0.1856414649805007,0.46648713791158464,5,2,3,2,1,1,1,1.5714285714285714,0,2.5,-0.007768311264485517,3,3,3,3,1,1,3,2.4285714285714284,0,3.5714285714285716,-0.7395711320441822,0,2,2,2,5,3,2,2,2,1,2,1,4,3,3,5,4,4,3,3,3,2.8,0,4,0,2.4,0,4,0,3.466666666666667,0,3,1,4,2,3,4,4,1,4,2,3,2,3,3,2,2,2,4,2,4,3.05,0,"White, Caucasian, Anglo, European American",0,29,1,3,NA,5,2,0,1,0,0,1,TRUE,TRUE,TRUE,TRUE,TRUE,0,6,0.8229190476190332,0.84,0.056290972346935496,6,0.44769999999997673,0.4697928571428638,0.967741935483871,0.9032258064516129,0.0024327874623629037,0.006673919698921166,6,0.5708687500000306,0.6307366666667008,1,0.9375,0.007286731250001905,0.003705720796373577,1.4104,1.2828,0.4535,1.1158,1.2409,0.5585,0.1295,1.4244628466666667,1.1426659966666666,0.44688949733333333,0.9507,4.2896,0.3419,2.4778,0.3072,-66.4232,0.8954,5.8274,0.372,4.3627,0.3678,0.7922,1.0361334406666667,2.7654766066666667,4.479817736666667,0.301598461,0.336267515,1.0214,3.6776,0.4423,6.2503,0.548,0.9881,0.065,0.428,0.517,0.015,1.657,110.46666666666667,316,0.9362962962962963,1,0,0,1,FALSE,FALSE,FALSE
124,2021-11-13T01:02:41Z,1,1.7777777777777777,720,6,2,3,4,1,4,3,2,1,3,1,2,1,4,1,4,3,3,3,5,1,1,1,1,1,7,3,0,5,3,4,3,1,1,5,5,5,5,1,3,1,3,3,3,4,2,4,3,5,5,2,4,1,1,5,3,4,5,5,1,4,3,2,1,2,1,5,5,5,5,2,0,5,0,2.2,0,2.4444444444444446,0,2.9166666666666665,0,2.8333333333333335,0,3,0,1.3333333333333333,0,2.72972972972973,0,4,0,5,0.29794049498290537,0.12042254058397016,2.211796605879814,1.166109573231892,4,1,2,1,1,1,1,1.5714285714285714,0,1,-0.5612498234260587,3,3,4,4,2,2,3,3,0,3,0.6723373927674386,0,2,3,3,2,1,2,5,2,3,5,2,4,1,3,4,1,3,2,5,1,2.2,0,3.8,0,5,0,3.8,0,4.2,0,2,2,1,3,1,1,4,3,1,2,2,4,1,1,2,4,2,2,3,1,1.7,0,"White, Caucasian, Anglo, European American",0,21,1,2,NA,5,2,0,1,3,0,1,TRUE,TRUE,TRUE,TRUE,TRUE,0,1,1.0632261904705138,0.84,0.33394923551327743,1,0.4938687500059605,0.5983387096697285,1,0.96875,0.003307913182982244,0.011498738059272536,1,0.65224062500149,0.7955499999895692,1,1,0.003946805715123329,0.007421165159963945,1.7181,0.9532,0.4743,1.3035,1.3241,0.6107,0.4876,1.67355936,0.9272637446666666,0.4734267363333333,2.1659,5.2702,0.2884,3.6854,0.3211,-58.036,1.0571,6.74,0.4206,3.7382,0.4659,0.9115,1.9328266466666666,3.48287742,4.81563573,0.33391646033333333,0.29413112166666666,0.8323,5.7036,0.5835,3.1473,0.6932,0.9523,0.119,0.474,0.682,0.013,1.791,137.76923076923077,104,0.3081481481481481,1,1,0,1,FALSE,FALSE,FALSE
125,2021-11-13T01:11:57Z,1,1.6,800,6,3,4,5,2,5,2,1,4,2,1,1,3,4,3,4,5,2,4,1,1,1,3,2,1,0,2,0,0,5,5,5,5,5,5,5,5,5,2,5,2,1,5,1,5,3,3,3,3,4,3,1,1,1,3,1,1,1,1,1,4,2,1,1,1,1,1,2,1,1,1.875,0,1.25,0,1.7333333333333334,0,1,0,2.0833333333333335,0,1.5,0,1.1428571428571428,0,1,0,1.5135135135135136,0,0,0,0,-0.5363073526294663,-0.6565125743406198,-0.6588395645607719,-0.6576760694506958,5,2,4,2,1,1,2,1.5714285714285714,0,2,-0.19226214865167657,5,5,5,5,3,3,1,4.428571428571429,0,1.5714285714285714,-0.7395711320441822,0,2,3,3,2,2,3,4,3,2,2,1,4,2,4,4,2,4,1,4,3,2.4,0,4.2,0,3.6,0,3.6,0,3.8,0,1,1,1,4,2,2,1,4,1,1,2,4,2,1,1,4,1,1,1,1,1.2,0,"White, Caucasian, Anglo, European American",0,23,1,2,NA,5,2,0,0,2,0,0,TRUE,TRUE,TRUE,TRUE,TRUE,0,3,0.7717184210576509,0.76,0.04075718171782819,3,0.41561875003576276,0.4985699999888738,1,0.9375,0.0015135699591259809,0.007214683184410372,3,0.6394687500223517,0.7216343750581146,1,1,0.005274575767736031,0.007153998463449968,1.2277,0.9992,0.4869,0.8075,1.1714,0.6211,0.0975,1.281436503,0.9779479156666666,0.4785190026666667,1.2729,7.1338,0.3264,2.8875,0.303,-83.7894,0.556,5.6812,0.3729,5.6643,0.443,0.9831,1.2763097966666668,2.98489392,6.3137148,0.30256674133333333,0.320809296,0.8502,4.5867000000000004,0.5513,4.7381,0.6322,0.8655,0.095,0.462,0.543,0.007,1.047,149.57142857142856,104,0.3081481481481481,1,1,0,1,FALSE,FALSE,FALSE
126,2021-11-13T01:17:49Z,0.8999999761581421,1.7777777777777777,1080,6,3,5,5,3,4,1,2,1,1,1,1,1,4,2,4,4,1,1,1,1,1,1,1,1,1,2,0,0,5,3,1,5,5,5,5,5,5,1,5,2,1,4,1,5,3,1,1,1,2,5,1,1,1,2,3,1,2,2,1,5,2,1,1,1,1,2,1,2,2,1,0,1.75,0,1.8,0,1.6666666666666667,0,1.4166666666666667,0,1.3333333333333333,0,1.2857142857142858,0,1,0,1.4594594594594594,0,1,0,0,-1.1141868440486153,-1.0271223357765558,-0.2989446853297732,-0.6630335105531645,5,1,4,1,1,1,1,1.1428571428571428,0,1,-0.8176513788914915,5,5,5,5,3,3,1,4.428571428571429,0,1.5714285714285714,-0.4571894270818581,0,3,2,3,2,2,2,5,4,1,2,2,4,1,3,4,4,4,3,3,2,2.4,0,3.8,0,3.4,0,3.6,0,3.6,0,3,1,2,3,4,2,4,2,1,1,1,3,3,3,1,1,2,3,1,4,2.35,0,"White, Caucasian, Anglo, European American",0,22,1,2,NA,5,2,0,1,1,0,1,TRUE,TRUE,TRUE,TRUE,TRUE,0,6,0.8815081081084303,0.74,0.10898544367344591,6,0.47759333333174386,0.5299500000001862,1,1,0.0011451937472487064,0.0054588361283562465,6,0.5764062500009314,0.6820354838707755,1,1,0.0022950328629937748,0.008099651032522644,1.3494,0.7706,0.5105,1.2361,0.6952,0.5128,0.0412,1.3957570766666667,0.8273079153333334,0.5000830073333333,9.9807,16.3409,0.1722,9.4167,0,-96.4634,0.7788,7.026,0.4252,5.6293,0.47,0.9647,1.98142136,4.0887467866666665,7.023200336666667,0.289886731,0.3448589286666667,0.6471,8.6292,0.5408,3.9503,0.6248,0.9923,0.123,0.403,0.691,0.013,1.498,115.23076923076924,396,1.1733333333333333,1,0,0,1,FALSE,FALSE,FALSE
127,2021-11-13T01:11:06Z,1,1.7777777777777777,864,6,2,4,4,3,4,2,2,4,2,2,2,1,4,1,4,3,2,2,1,1,1,1,2,3,4,4,0,0,5,4,5,3,1,3,3,2,2,2,4,1,1,2,1,5,2,2,1,3,1,5,1,1,1,1,1,1,5,3,1,3,2,3,2,3,1,2,2,2,1,1.625,0,1.75,0,2,0,2.888888888888889,0,1.75,0,0.8333333333333334,0,2.4285714285714284,0,2,0,2.081081081081081,0,2,0,0,-0.33877763556255713,-0.40543873752557247,-0.0958522115332568,-0.25064547452941466,3,2,3,1,2,2,2,2.142857142857143,0,1,-0.21938108280548152,4,3,3,3,1,1,2,2.7142857142857144,0,3.2857142857142856,2.0842459175790595,0,1,1,2,3,2,2,4,2,1,1,3,3,3,4,5,1,4,2,4,3,1.8,0,3.6,0,3.4,0,4.2,0,3.7333333333333334,0,2,2,2,2,3,3,3,2,3,1,3,3,2,1,2,3,2,3,1,3,2.3,0,"Hispanic of Latino (e.g., Mexican American, Central American, and others)",0,24,1,2,NA,5,2,0,0,1,0,0,TRUE,TRUE,TRUE,TRUE,TRUE,0,NA,NA,NA,NA,3,0.5402812499995343,0.5855935483848856,1,0.96875,0.007850403507915238,0.005326355121117399,3,0.7294718750002794,0.8157656249976717,1,1,0.006746998215658644,0.021228156522241914,NA,NA,NA,NA,NA,NA,NA,NA,NA,NA,1.5001,3.9229,0.3491,4.2222,0.4194,-65.8104,0.9201,3.4983,0.4262,5.0908,0.4947,0.9939,1.6577890933333332,4.23334476,4.159303933333334,0.404149032,0.338905018,1.0837,5.1623,0.6279,2.3295,0.6457,0.9161,0.244,0.305,0.56,0.019,1.356,71.36842105263159,104,0.3081481481481481,1,1,5,6,FALSE,FALSE,FALSE
128,2021-11-13T01:19:06Z,1,1.7786458333333333,768,5,2,3,2,4,2,5,3,2,4,5,3,2,3,1,3,3,3,5,1,1,2,3,4,4,2,2,0,0,5,3,5,4,5,4,3,4,2,3,4,5,1,2,3,3,5,4,5,4,5,3,1,1,1,3,1,1,3,3,3,2,5,4,1,4,3,2,2,2,2,2.875,0,2,0,3.4,0,2.111111111111111,0,3.6666666666666665,0,1.5,0,3.142857142857143,0,2.6666666666666665,0,2.810810810810811,0,1,0,0,0.8926310261524294,1.046995339284992,-0.22054348261253207,0.41322592833622995,5,1,3,1,1,2,1,1.4285714285714286,0,3.5,0.27575217835475235,2,3,4,2,1,1,5,2,0,4,-0.4571894270818581,0,2,2,2,3,3,2,5,1,1,2,1,5,1,4,5,3,3,2,3,3,2.4,0,4.2,0,3.6,0,4.4,0,4.066666666666666,0,1,1,2,3,4,2,2,3,1,3,3,3,1,4,1,3,1,2,2,3,2.05,0,"White, Caucasian, Anglo, European American",0,21,1,2,NA,5,2,0,0,1,0,0,TRUE,TRUE,TRUE,TRUE,TRUE,0,4,0.8102488371937774,0.86,0.015462355617607858,4,0.4374125000536442,0.4924034483021703,1,0.90625,0.0020680366139170427,0.006341246123387835,4,0.5677531250715255,0.6189137931034483,1,0.90625,0.005830396768437816,0.00954001119540626,1.1015,1.6772,0.5836,0.5564,2.5246,0.7607,0.3382,1.1605622766666666,1.320730599,0.571375204,1.2154,4.529,0.3032,2.8875,0.3128,-66.9589,0.6741,6.0743,0.3889,3.6598,0.4184,0.994,1.2934024356666667,3.0961852366666665,4.659980446666666,0.3083923453333333,0.29931493433333334,0.8845,6.0721,0.5096,4.0067,0.5028,0.8221,0.061,0.4,0.353,0.019,1.585,83.42105263157895,324,0.96,1,0,0,1,FALSE,FALSE,FALSE
129,2021-11-13T00:57:02Z,1,1.7786458333333333,768,3,3,5,4,3,4,4,4,4,2,2,3,1,3,2,3,2,3,2,1,1,2,1,4,3,0,2,0,0,4,4,4,5,5,5,4,4,4,2,4,2,1,4,2,5,2,2,2,3,3,4,1,1,1,1,1,1,1,1,1,4,2,2,1,2,1,2,2,3,3,2.125,0,2.5,0,2.533333333333333,0,1.6666666666666667,0,2,0,1,0,1.2857142857142858,0,1.3333333333333333,0,1.6216216216216217,0,0,0,0,-0.3135610759369941,-0.15881725093931895,-0.26683355097456624,-0.21282540095694258,4,2,4,1,1,1,3,1.7142857142857142,0,1,-0.4757826382709144,4,4,4,4,3,3,2,3.7142857142857144,0,2.2857142857142856,0.6723373927674386,0,3,3,3,3,4,2,5,2,2,1,2,4,4,3,4,2,3,2,4,2,3.2,0,3.8,0,3.2,0,3.8,0,3.6,0,3,1,3,2,4,3,4,1,1,1,3,2,3,4,2,2,2,3,3,3,2.8,0,"Hispanic of Latino (e.g., Mexican American, Central American, and others) & White, Caucasian, Anglo, European American",1,19,1,2,NA,5,2,0,0,0,0,0,TRUE,TRUE,TRUE,TRUE,TRUE,0,4,1.0617880952273095,0.84,0.13354148019133322,4,0.503966666650772,0.6105031249970198,1,1,0.00972373816186949,0.015755524829769923,4,0.6414781249836087,0.7188612903279643,1,0.96875,0.026740332080950144,0.05489218673486908,1.7354,1.0304,0.4717,1.5896,1.3029,0.5667,0.1668,1.6783622533333333,0.972965148,0.469466806,1.5635,4.6388,0.3354,4.0237,0.4162,-67.4714,1.0828,4.5519,0.3845,4.0997,0.4773,0.9908,1.71108878,4.057406496666666,4.720124416666667,0.4008698983333333,0.323514019,1.6105,3.5871,0.4101,2.9273,0.4138,0.8915,0.081,0.365,0.263,0.039,1.806,46.30769230769231,338,1.0014814814814814,1,0,0,1,FALSE,FALSE,FALSE
130,2021-11-13T01:10:03Z,NA,1.7777777777777777,720,6,3,4,4,3,3,4,2,3,3,2,3,2,3,2,3,3,2,3,1,1,1,2,2,2,4,2,0,0,4,3,3,4,2,4,2,2,2,2,4,3,2,3,3,3,3,2,3,2,3,4,1,1,1,3,3,3,4,2,1,4,2,2,2,3,1,2,2,2,2,1.75,0,2,0,2.6666666666666665,0,3.111111111111111,0,2.5833333333333335,0,1.6666666666666667,0,2.142857142857143,0,2,0,2.4864864864864864,0,2,0,0,-0.008860980461443293,0.10900129434488952,-0.01745100881601569,0.045775142764436914,3,3,2,2,2,3,3,2.857142857142857,0,1,0.20795484297024003,1,3,4,3,1,1,4,2.142857142857143,0,3.857142857142857,0.10757398284279028,0,2,2,3,3,3,3,5,3,2,4,1,4,2,4,4,2,3,2,3,3,2.6,0,3.8,0,4,0,3.6,0,3.8,0,2,1,2,2,2,2,3,1,2,2,1,2,2,3,1,2,1,3,2,3,2.25,0,"Asian or Asian American (e.g., Chinese, Japanese, and others)",0,25,1,2,NA,5,2,0,0,3,0,0,TRUE,TRUE,TRUE,TRUE,TRUE,0,4,1.1225285714297069,0.84,0.18788050681119772,4,0.5303129032249412,0.5762374999998138,1,1,0.007684635161259829,0.00791157661296242,4,0.6309000000013039,0.7038687500003725,1,1,0.0046819987097615964,0.005084182217834904,1.5588,1.0387,0.6285,1.5085,1.0904,0.6142,0,1.5792008666666666,0.9919856176666667,0.6147365426666667,1.1003,5.0941,0.4223,4.2987,0.4483,-90.1069,0.9857,5.9998,0.4323,4.9682,0.4709,0.7734,1.3921795733333333,4.59121708,5.224524946666667,0.4286163823333333,0.399942511,0.9663,4.4119,0.5322,6.5788,0.6315,0.9692,0.233,0.332,0.761,0.01,1.083,108.3,409,1.211851851851852,1,0,0,1,FALSE,FALSE,FALSE
131,2021-11-13T01:23:24Z,1,1.6,900,6,4,5,5,2,4,2,1,4,3,2,1,1,4,1,4,5,1,1,1,1,1,3,3,3,1,2,0,0,5,4,4,5,5,4,5,5,5,1,4,3,1,5,1,5,1,2,2,3,3,5,1,4,1,2,1,1,2,2,1,5,1,1,1,1,1,2,1,1,2,1.75,0,1.5,0,1.6,0,1.3333333333333333,0,1.75,0,1.5,0,1.1428571428571428,0,1,0,1.4864864864864864,0,1,0,0,-0.6308694512253271,-0.779145786077191,-0.3773458880470143,-0.5782458370621026,5,1,5,1,1,1,1,1,0,1,-0.9031185640466358,5,5,5,5,3,2,1,4.285714285714286,0,1.7142857142857142,-1.5867162469311549,0,2,3,2,2,2,1,5,2,2,3,1,4,1,5,5,1,4,1,4,3,2.2,0,4.6,0,4.4,0,4.2,0,4.4,0,1,2,1,4,2,1,2,4,1,2,2,3,1,2,1,3,1,2,2,2,1.55,0,"White, Caucasian, Anglo, European American",0,22,1,2,NA,5,2,0,0,1,0,0,TRUE,TRUE,TRUE,TRUE,TRUE,0,3,0.7540449999991804,0.8,0.016082268852969497,3,0.46019687499967404,0.5025741935482909,1,0.96875,9.49164828636135e-4,0.0023237295867105223,3,0.5864499999999534,0.6647399999993543,1,0.9375,0.006579915483808292,0.006743255312561892,1.0488,1.3904,0.5472,0.8678,1.2367,0.6096,0.126,1.1116989603333334,1.1784272913333333,0.5372281153333334,1.0654,6.4546,0.3777,5.282,0.4099,-111.5742,0.7237,7.7708,0.4158,5.9347,0.4396,0.9379,1.11932744,4.931639396666666,5.985440633333333,0.4027629973333333,0.37152020366666666,0.8954,4.6041,0.4909,4.0583,0.562,0.9673,0.066,0.429,0.407,0.015,1.574,104.93333333333334,412,1.2207407407407407,1,0,0,1,FALSE,FALSE,FALSE
132,2021-11-13T01:05:20Z,1,1.7777777777777777,864,6,5,1,5,4,2,2,3,2,4,3,2,5,2,2,3,3,4,5,3,2,4,5,5,5,4,2,0,2,4,3,3,4,3,4,3,5,3,2,4,5,2,3,3,4,1,5,5,5,5,2,2,2,1,2,1,2,3,3,1,5,2,1,1,1,3,2,3,2,2,4.125,0,2.25,0,3.2666666666666666,0,2.4444444444444446,0,3.3333333333333335,0,1.8333333333333333,0,1.7142857142857142,0,1.6666666666666667,0,2.4864864864864864,0,2,0,2,1.4684091376027815,1.3875033415653846,0.41384948769958696,0.9006764146324857,5,2,5,2,1,2,1,1.4285714285714286,0,2,-0.2777293338068208,5,5,5,5,4,4,1,4.714285714285714,0,1.2857142857142858,-1.3043345419688306,0,4,4,5,5,5,5,4,4,4,2,2,5,4,2,3,4,2,3,3,4,4.6,0,3,0,2.6,0,2.2,0,2.6,0,3,2,4,2,4,4,4,2,4,3,4,2,3,4,2,2,3,3,4,4,3.35,0,"White, Caucasian, Anglo, European American",0,23,1,2,NA,5,2,0,0,1,0,0,TRUE,TRUE,TRUE,TRUE,TRUE,0,4,0.9979216216230714,0.74,0.12763910019889385,4,0.4416124999993481,0.5532967741941252,1,0.96875,0.002215337257961956,0.005811617893067038,4,0.6269968750001863,0.6671925925949106,1,0.84375,0.010868273860214276,0.010118938992167793,1.5049,0.7161,0.5329,1.3333,0.6571,0.6072,0.2444,1.5256980233333333,0.7714363626666667,0.5234586573333333,1.8076,5.8459,0.287,3.9888,0.3366,-73.151,1.0832,7.4595,0.3733,5.2691,0.4527,0.7062,1.6655953366666667,3.7866045033333333,5.325147796666666,0.342583575,0.288357471,0.8559,3.9098,0.5243,2.8473,0.5435,0.9609,0.05,0.493,0.42,0.023,1.946,84.6086956521739,104,0.3081481481481481,1,1,1,2,FALSE,FALSE,FALSE
133,2021-11-13T01:18:27Z,1,1.7777777777777777,864,3,4,1,4,3,3,2,1,2,3,3,1,4,2,1,1,2,5,5,1,1,4,5,4,5,0,2,3,4,4,2,4,3,2,4,4,4,3,3,3,4,2,2,5,4,5,5,5,4,4,2,1,1,1,3,2,3,1,1,1,3,3,1,1,1,3,2,4,1,1,3.75,0,2,0,3,0,2.6666666666666665,0,3.8333333333333335,0,1.8333333333333333,0,1.7142857142857142,0,1.6666666666666667,0,2.7027027027027026,0,0,3,4,1.3696442790693273,1.2046666115177265,0.9020622539667457,1.053364432742236,4,1,4,1,1,1,1,1.2857142857142858,0,1,-0.7321841937363471,2,1,2,3,3,3,1,2.7142857142857144,0,3.2857142857142856,0.10757398284279028,0,2,2,2,3,2,4,4,2,2,3,2,3,2,3,4,2,3,1,4,3,2.2,0,3.4,0,3.8,0,3.6,0,3.6,0,3,3,3,2,2,3,1,2,2,3,2,2,2,3,2,1,1,3,3,2,2.55,0,"White, Caucasian, Anglo, European American",0,21,1,2,NA,5,2,0,1,2,0,1,TRUE,TRUE,TRUE,TRUE,TRUE,0,6,0.6915390243902803,0.82,0.026789197636824948,6,0.41517931034493033,0.4777548387098697,0.9354838709677419,0.96875,0.002305113957000395,0.003280991249911918,6,0.5150124999994877,0.6113919999998808,1,0.78125,0.0057007333869603105,0.009652127378937437,1.1628,1.3472,0.4102,0.9598,1.7509,0.5016,0.2244,1.2110762373333332,1.1777698853333334,0.4018491866666667,1.0311,3.9451,0.2957,3.5451,0.3377,-73.9408,0.716,4.9437,0.3452,5.6269,0.4151,0.9482,1.1247345326666667,3.749226166666667,4.212501216666666,0.332507125,0.29045933933333334,0.7445,6.4183,0.4514,2.6081,0.4958,0.8692,0.061,0.379,0.481,0.011,1.781,161.9090909090909,338,1.0014814814814814,1,0,0,1,FALSE,FALSE,FALSE
134,2021-11-13T01:21:55Z,0.8999999761581421,1.7777777777777777,1080,6,3,3,3,2,4,2,1,4,3,2,1,2,3,3,3,3,2,3,5,2,2,2,2,2,3,3,2,1,5,2,2,3,5,2,2,3,3,1,4,3,3,3,2,4,2,2,3,5,3,2,3,4,3,4,1,2,4,4,3,4,2,1,1,1,1,2,3,3,3,2.5,0,2.75,0,2.3333333333333335,0,3,0,2.5833333333333335,0,3,0,2.4285714285714284,0,1,0,2.6486486486486487,0,2,2,1,0.5585116111137219,0.3577521658231747,0.8074686614209358,0.5826104136220552,3,2,1,2,2,2,1,2.4285714285714284,0,1,-0.048446712495193056,2,3,3,4,2,2,2,2.857142857142857,0,3.142857142857143,-0.7395711320441822,0,2,3,2,2,2,2,5,2,1,2,3,4,2,3,4,1,4,2,3,3,2.2,0,3.8,0,3.8,0,3.8,0,3.8,0,2,1,2,3,2,3,2,3,2,1,1,2,3,2,1,2,2,2,1,1,1.9,0,Filipino,0,23,0,1,NA,5,2,0,0,1,0,0,TRUE,TRUE,TRUE,TRUE,TRUE,0,5,0.9251049999998883,0.8,0.08471427443262812,5,0.4701419354837027,0.5435379310344057,0.96875,0.9666666666666667,0.0020605283870883968,0.006737599816136939,5,0.5146281249998137,0.6098531249999068,1,1,0.008844542086662046,0.007977699344728506,1.4227,1.0163,0.5158,1.2796,1.2457,0.5721,0.2502,1.45223143,0.9894633096666666,0.5061632903333333,1.1919,4.9353,0.3541,3.3325,0.3746,-73.4568,0.7,6.3886,0.4195,3.1555,0.4617,0.9368,1.3102350136666667,3.5502136766666665,4.986244313333334,0.36660475833333334,0.3454684633333333,0.9954,3.4891,0.3933,6.9616,0.5463,0.5179,0.147,0.21,0.477,0.017,1.803,106.05882352941175,104,0.3081481481481481,1,0,0,1,FALSE,FALSE,FALSE
135,2021-11-13T01:27:15Z,1,1.6,900,6,2,4,4,4,3,4,3,3,3,2,3,3,3,2,3,2,2,3,1,1,1,3,3,2,0,2,0,0,3,4,4,5,5,5,5,5,4,5,4,4,1,4,2,3,2,3,4,3,4,2,1,1,1,2,1,1,1,1,1,3,3,2,1,1,1,1,2,1,1,2,0,1.25,0,2.933333333333333,0,1.5555555555555556,0,2.9166666666666665,0,1.5,0,1.5714285714285714,0,1,0,2,0,0,0,0,-0.15595757827722637,0.12197118414181142,-0.6588395645607719,-0.26843419020948023,5,1,5,1,1,1,1,1,0,1,-0.9031185640466358,5,5,5,5,4,3,1,4.571428571428571,0,1.4285714285714286,-1.0219528370065065,0,1,1,1,1,1,1,5,2,1,2,1,2,3,4,5,2,5,1,4,2,1,0,4.4,0,3.6,0,4.4,0,4.133333333333334,0,2,3,3,2,4,3,2,2,2,1,3,2,1,3,1,2,3,4,2,2,2.55,0,"White, Caucasian, Anglo, European American",0,25,1,2,NA,5,2,0,0,1,0,0,TRUE,TRUE,TRUE,TRUE,TRUE,0,4,0.852991304350936,0.9387755102040817,0.05064196837226682,4,0.6611937500238418,0.6643000000044703,1,1,0.003341834153460225,0.0019004535491863367,4,0.7127562500163913,0.7519249999672174,1,1,0.0062721076976840155,0.006466056129853493,1.6539,1.8605,0.4617,1.4606,2.0311,0.5287,0.2228,1.5344386433333332,1.43263397,0.46069976733333334,9.6691,11.5032,0.2409,13.6514,0.3102,-102.2623,0.8367,5.3046,0.5893,7.1573,0.6096,0.9375,2.20265624,6.116817936666667,5.70129206,0.49242148966666666,0.4719605746666667,1.1166,4.1613,0.5812,4.4654,0.6342,0.9669,0.072,0.557,0.474,0.03,1.638,54.6,434,1.285925925925926,1,0,0,1,FALSE,FALSE,FALSE
136,2021-11-13T01:13:55Z,1,1.7786458333333333,768,4,1,1,1,5,1,5,5,1,5,5,5,5,1,3,1,1,5,5,5,5,5,5,5,5,20,5,50,2,1,1,1,1,1,3,1,1,1,5,1,5,5,1,5,3,5,5,5,5,5,1,5,5,5,5,5,5,5,5,5,3,5,5,5,5,5,5,5,5,5,5,0,5,0,4.866666666666666,0,4.777777777777778,0,4.833333333333333,0,4.833333333333333,0,4.571428571428571,0,5,0,4.837837837837838,0,6,6,2,3.475227007803827,3.461621016626932,3.3284318583334467,3.3950264374801895,1,5,1,5,5,5,5,5,0,5.5,3.1504071567821237,1,1,1,1,1,1,5,1,0,5,0.6723373927674386,0,4,5,5,5,5,4,5,4,3,5,2,4,3,5,5,1,4,2,5,4,4.8,0,3.6,0,4.6,0,3.4,0,3.8666666666666667,0,2,4,4,1,3,4,4,3,2,4,4,2,4,4,2,1,4,4,4,4,3.5,0,"White, Caucasian, Anglo, European American",0,22,1,2,NA,5,2,1,0,0,0,1,TRUE,TRUE,TRUE,TRUE,TRUE,0,6,0.744245945946993,0.74,0.03629902719981122,6,0.42874687499832365,0.47093548387096773,1,0.96875,0.0022864832158404663,0.0036387191935252374,6,0.5362749999994412,0.6120964285720671,1,0.9333333333333333,0.005339475484094955,0.004058551310399796,1.3084,0.8506,0.3689,1.0619,1.0563,0.4917,0.3075,1.3468255566666667,0.8855815,0.362425292,1.4853,5.2767,0.288,4.7898,0.3238,-84.5183,0.7895,5.9994,0.3644,4.7576,0.3974,0.793,1.444160398,4.55267064,5.024627833333334,0.3236136413333333,0.2870192463333333,0.7651,3.1774,0.4503,5.3162,0.5422,0.7698,0.064,0.409,0.585,0.016,1.873,117.0625,339,1.0044444444444445,1,0,0,1,FALSE,FALSE,FALSE
137,2021-11-13T01:17:39Z,0.8999999761581421,1.7786458333333333,768,6,2,1,1,4,1,4,4,4,4,4,4,4,2,2,2,2,5,5,1,1,4,4,4,5,2,3,0,0,3,4,4,4,4,2,2,2,2,5,3,5,4,1,3,3,4,4,4,4,4,1,1,3,2,2,3,4,2,3,1,1,5,5,4,4,4,3,3,3,3,3.625,0,3,0,3.933333333333333,0,3,0,4,0,2.5,0,3.4285714285714284,0,4,0,3.4594594594594597,0,1,0,0,1.7626023332343488,1.877261866732748,0.0930613282564324,0.9851615974945902,1,4,2,4,4,3,3,3.857142857142857,0,6,2.6511635129281608,3,3,3,3,1,1,5,2.142857142857143,0,3.857142857142857,0.38995568780511447,0,5,5,5,5,5,4,4,3,4,4,3,4,4,3,3,4,3,4,4,4,5,0,2.8,0,3.2,0,2.6,0,2.8666666666666667,0,4,4,3,2,3,4,4,3,3,3,3,3,4,4,4,2,4,4,4,4,3.45,0,"Hispanic of Latino (e.g., Mexican American, Central American, and others)",0,25,1,2,NA,4,2,0,0,2,1,0,TRUE,TRUE,TRUE,TRUE,TRUE,0,2,0.9473945945944838,0.7551020408163265,0.13541700397958553,2,0.5792999999999627,0.665729629629671,0.9259259259259259,0.8709677419354839,0.047703710284895916,0.03086394146233623,NA,NA,NA,NA,NA,NA,NA,1.3243,0.8499,0.5655,0.9785,1.1338,0.6768,0.4198,1.38332614,0.8704598283333334,0.5521613343333334,1.2737,1.8641,0.2898,1.6315,0.397,-4.7218,1.0117,2.4875,0.386,1.5591,0.4711,0.9973,1.3634404566666667,1.830564969,2.184865996666667,0.38384738133333335,0.283605592,NA,NA,NA,NA,NA,NA,NA,NA,NA,NA,NA,NA,446,1.3214814814814815,1,0,0,1,FALSE,FALSE,FALSE
138,2021-11-13T01:23:22Z,1,1.7786458333333333,768,7,3,5,4,2,4,2,1,5,2,2,1,2,4,2,5,4,2,1,1,1,3,1,1,3,4,2,0,0,4,3,4,4,4,4,4,3,4,1,3,4,3,5,3,5,1,4,5,5,3,5,1,2,1,1,1,4,3,5,4,4,3,3,2,2,1,3,4,4,5,1.625,0,4,0,1.6666666666666667,0,2.2222222222222223,0,2.8333333333333335,0,1,0,3.2857142857142856,0,1.6666666666666667,0,2.4324324324324325,0,2,0,0,-0.12023411880767895,-0.397695519736365,0.6097586129219131,0.10603154659277406,4,2,3,2,1,2,2,2,0,3.5,0.6176209189753294,3,4,4,3,2,1,2,3,0,3,-1.3043345419688306,0,2,2,3,3,3,2,3,2,1,1,2,4,2,4,2,2,4,3,4,3,2.6,0,3.8,0,3.2,0,3.6,0,3.533333333333333,0,2,2,2,3,2,1,3,3,1,2,3,3,4,4,1,3,2,2,1,2,2.1,0,"White, Caucasian, Anglo, European American",0,30,0,1,NA,5,2,0,0,1,0,0,TRUE,TRUE,TRUE,TRUE,TRUE,0,2,0.8575315789486233,0.76,0.04937483514230103,NA,NA,NA,NA,NA,NA,NA,2,0.6404531250037253,0.6661875000037253,1,1,0.003205453538440327,0.006260782419372316,1.1725,0.9767,0.5548,1.1568,0.9368,0.565,0.0376,1.2382346256666668,0.9641504816666666,0.543007531,NA,NA,NA,NA,NA,NA,NA,NA,NA,NA,NA,NA,NA,NA,NA,NA,NA,0.9077,6.2037,0.5659,3.5612,0.5553,0.8898,0.078,0.511,0.607,0.116,1.695,14.612068965517242,496,1.4696296296296296,1,0,5,6,TRUE,FALSE,FALSE
139,2021-11-13T01:13:49Z,1,1.7777777777777777,864,3,2,1,3,2,3,1,1,4,3,1,1,1,3,2,4,3,3,1,1,3,1,1,1,1,4,3,0,2,4,1,1,2,4,2,1,1,2,5,3,1,1,1,2,3,4,4,1,3,4,2,4,1,1,3,1,1,4,2,1,4,1,1,1,3,2,4,3,2,4,1.5,0,3.25,0,2.2,0,4,0,3,0,2.1666666666666665,0,1.5714285714285714,0,2,0,2.810810810810811,0,2,0,2,0.03736937885208878,-0.0596072730150998,0.7274542985685514,0.3339235127767258,3,3,2,1,1,2,3,2.4285714285714284,0,2.5,0.5050347996663801,3,3,5,3,2,2,3,3,0,3,1.5194825076544112,0,2,2,2,3,3,1,4,1,1,2,1,4,2,3,5,3,4,2,3,3,2.4,0,4.4,0,3.2,0,4.2,0,3.933333333333333,0,1,1,1,3,2,2,2,4,1,1,3,4,2,2,1,4,3,2,1,1,1.55,0,"Hispanic of Latino (e.g., Mexican American, Central American, and others) & White, Caucasian, Anglo, European American",1,21,0,1,NA,5,2,0,0,3,0,0,TRUE,TRUE,TRUE,TRUE,TRUE,0,4,0.902473684209546,0.76,0.09439784365724617,4,0.4806161290332675,0.6007218750000466,1,1,0.005817080731145739,0.007545368860846275,4,0.680425000000745,0.6302870967743859,1,0.96875,0.007923347096802225,0.010960435766086227,1.3262,0.8626,0.4888,1.3914,0.848,0.4556,0.0811,1.3727299533333333,0.8901398976666667,0.47869175966666666,2.8996,6.9937,0.2733,5.2462,0.3244,-73.9973,0.833,4.8786,0.3886,3.5294,0.5009,0.921,1.8532020233333333,3.9892938,5.525070403333333,0.369141234,0.3168606523333333,0.9635,5.1317,0.5812,2.715,0.5035,0.983,0.271,0.201,0.594,0.32,1.309,4.090624999999999,104,0.3081481481481481,1,0,4,5,FALSE,FALSE,FALSE
140,2021-11-13T01:23:15Z,1,1.6,900,4,4,2,4,3,3,4,2,4,3,2,2,4,3,2,3,2,2,3,4,1,2,3,2,2,2,2,0,0,4,4,2,4,2,3,2,2,3,3,4,2,2,3,3,4,3,2,2,3,1,2,1,3,2,3,2,2,2,2,1,4,2,2,1,1,2,2,2,1,2,2.375,0,1.75,0,2.8666666666666667,0,3.111111111111111,0,2.3333333333333335,0,2.3333333333333335,0,1.7142857142857142,0,1.3333333333333333,0,2.3783783783783785,0,1,0,0,0.312650154764484,0.41708457213297584,-0.2989446853297732,0.05906994340160132,4,1,2,1,1,2,1,1.7142857142857142,0,1,-0.4757826382709144,4,5,5,5,2,3,1,4.142857142857143,0,1.8571428571428572,-0.7395711320441822,0,3,4,3,3,2,2,4,2,3,3,2,4,4,4,3,4,4,2,2,4,3,0,4,0,2.6,0,3.2,0,3.2666666666666666,0,2,2,3,4,3,3,2,2,1,2,2,3,4,2,1,2,1,2,2,4,2.25,0,"Black or African American & White, Caucasian, Anglo, European American",1,20,1,2,NA,5,2,0,0,1,0,0,TRUE,TRUE,TRUE,TRUE,TRUE,0,2,1.2602605263143778,0.76,0.2849639336140553,2,0.6909199999988079,0.7417799999992053,1,1,0.030024365102553675,0.014744062344499976,2,0.9227709677440504,0.9961968750022352,1,1,0.13937109479518783,0.06946798160268683,1.8548,0.67,0.5623,1.3779,0.7049,0.805,0.2926,1.79175909,0.7111051786666667,0.5566834156666667,1.7513,3.7864,0.4597,3.5432,0.4947,-47.7068,1.1786,3.4736,0.5116,3.5123,0.5749,0.9598,2.2443557833333334,3.7916945,4.00572294,0.44588315666666667,0.4064480326666667,1.4934,3.8228,0.6294,2.1167,0.661,0.5361,0.083,0.61,0.271,0.109,1.836,16.844036697247706,104,0.3081481481481481,1,0,0,1,FALSE,FALSE,FALSE
141,2021-11-13T01:25:24Z,1,1.7777777777777777,1080,5,3,4,5,2,5,1,1,4,1,3,1,1,4,1,4,2,1,1,5,1,1,1,1,2,2,2,1,0,5,1,2,3,2,4,5,5,4,1,5,1,1,2,3,4,5,2,1,2,2,2,1,1,1,1,1,1,4,1,1,2,2,4,1,1,1,1,2,2,1,1.625,0,1.5,0,1.6666666666666667,0,2.5555555555555554,0,2.0833333333333335,0,1.3333333333333333,0,2.2857142857142856,0,1,0,2.081081081081081,0,1,1,0,-0.33877763556255713,-0.5486882666259079,-0.1707126804539906,-0.3597004735399492,3,2,4,1,1,2,2,1.8571428571428572,0,1,-0.39031545311577004,5,5,5,5,2,2,1,4.142857142857143,0,1.8571428571428572,-0.7395711320441822,0,2,1,1,3,1,3,5,1,2,5,3,2,1,4,5,1,3,5,4,3,1.6,0,2.4,0,4.8,0,4.2,0,3.8,0,1,1,2,2,3,4,4,2,3,1,3,1,1,2,3,1,2,4,4,2,2.7,0,"White, Caucasian, Anglo, European American",0,23,0,2,NA,5,2,0,0,1,0,0,TRUE,TRUE,TRUE,TRUE,TRUE,0,4,0.7515263157894737,0.76,0.08799991673469389,4,0.404625,0.5230967741935484,1,0.96875,0.006039919354838712,0.009251447580645163,4,0.6358709677419355,0.7259310344827586,0.96875,0.9354838709677419,0.01768317641129032,0.022318490322580643,1.2491,0.9488,0.4226,1.0834,1.1365,0.4528,0.1883,1.2960850666666666,0.9494788193333333,0.41492561533333333,1.4508,4.5631,0.2457,3.5478,0.3266,-66.7672,1.0904,6.5137,0.3156,3.9656,0.3834,0.9776,1.4790590173333333,3.6018493966666667,4.611796473333333,0.32387695833333335,0.24427703966666667,1.0868,4.1727,0.5041,2.0331,0.5246,0.9827,0.063,0.436,0.29,0.022,1.768,80.36363636363637,272,0.8059259259259259,1,1,7,9,FALSE,FALSE,FALSE
143,2021-11-13T01:32:07Z,0.8999999761581421,1.7777777777777777,720,4,3,5,5,2,4,2,1,4,2,1,1,3,4,5,5,3,1,2,1,1,1,1,1,1,2,2,0,0,4,5,2,5,5,5,2,3,5,1,5,1,1,4,1,5,3,1,1,3,3,5,1,1,1,1,1,1,1,1,1,4,3,4,1,3,1,2,1,2,1,1.125,0,1.5,0,1.9333333333333333,0,2,0,1.5833333333333333,0,0.8333333333333334,0,1.7142857142857142,0,1.6666666666666667,0,1.6486486486486487,0,1,0,0,-0.9187585069505032,-0.8348001639371186,-0.3773458880470143,-0.6060730259920665,4,2,3,1,1,2,1,1.7142857142857142,0,1,-0.4757826382709144,2,3,4,4,3,3,2,3.2857142857142856,0,2.7142857142857144,0.10757398284279028,0,1,1,1,3,4,1,4,3,2,3,1,4,3,3,3,1,4,4,4,1,2,0,4,0,3.8,0,3.6,0,3.8,0,1,2,1,3,2,1,2,2,1,3,2,4,1,2,1,3,1,1,1,2,1.6,0,"Asian or Asian American (e.g., Chinese, Japanese, and others)",0,21,1,2,NA,5,2,0,0,0,0,0,TRUE,TRUE,TRUE,TRUE,TRUE,0,5,0.6224722222222222,0.72,0.022480585408164878,5,0.44078124999953433,0.5147612903238304,1,0.96875,0.003676951895116223,0.008745112096642752,5,0.6011258064522859,0.6537483870978317,1,0.96875,0.025562091978523455,0.006809769516540815,0.9975,0.9371,0.4128,0.9692,0.778,0.4403,0.1576,1.0646654473333332,0.9542169113333333,0.4041544776666667,1.6792,4.9869,0.2724,3.8067,0.3033,-67.2682,0.9314,5.7964,0.3656,4.9573,0.4139,0.9951,1.6166282966666667,3.74900094,4.81623505,0.30673207,0.2736638866666667,1.329,3.0281,0.3853,4.927,0.5167,0.9927,0.073,0.395,0.418,0.017,1.853,108.99999999999999,104,0.3081481481481481,1,1,1,2,FALSE,FALSE,FALSE
144,2021-11-13T01:24:09Z,1,1.7777777777777777,864,6,2,2,3,4,3,4,3,3,2,4,2,3,5,2,4,4,2,2,1,2,2,3,3,3,4,2,0,0,5,5,2,5,5,5,4,5,5,1,4,2,1,4,2,5,3,2,2,3,3,4,1,1,1,2,1,1,4,4,1,4,2,2,1,1,1,1,1,3,3,2.25,0,2,0,2.8,0,1.4444444444444444,0,2,0,1.1666666666666667,0,2.142857142857143,0,1,0,1.7297297297297298,0,2,0,0,-0.16856585809000774,0.05596025248881939,-0.01745100881601569,0.01925462183640185,3,2,3,2,1,3,3,2.4285714285714284,0,4.5,1.2430101492151444,5,5,5,5,3,3,2,4.285714285714286,0,1.7142857142857142,0.10757398284279028,0,2,3,3,4,3,2,3,2,3,3,2,4,3,4,4,3,4,2,2,4,3,0,4,0,2.8,0,3.4,0,3.4,0,1,2,2,4,2,1,2,4,1,1,3,4,1,2,1,4,1,2,1,1,1.4,0,"White, Caucasian, Anglo, European American & Other & Greek",1,22,1,2,NA,5,2,0,0,0,0,0,TRUE,TRUE,TRUE,TRUE,TRUE,0,1,0.6682780487788159,0.82,0.02447871905684279,1,0.4077406249996275,0.5171258064527665,1,0.96875,0.0018966270060264995,0.008406948669113873,1,0.5344031250006519,0.636744827583946,1,0.90625,0.014573673215545221,0.01035451861878529,1.2376,1.3617,0.4061,0.9558,1.1463,0.4988,0.0825,1.271926959,1.177870417,0.399337292,2.0317,5.7871,0.2322,4.0202,0.2763,-68.5355,0.8192,6.168,0.3532,3.8653,0.4174,0.9177,1.7243818133333333,3.74029887,5.062379776666667,0.297140631,0.23919282233333333,1.0336,4.3919,0.4089,3.0459,0.494,0.9245,0.068,0.365,0.441,0.011,1.678,152.54545454545456,354,1.0488888888888888,1,0,0,1,FALSE,FALSE,FALSE
145,2021-11-13T01:28:59Z,1,1.6,800,4,2,1,4,4,2,5,4,5,5,4,5,2,1,1,1,1,5,5,NA,4,5,5,5,5,0,1,0,NA,4,2,1,1,1,3,1,1,4,5,2,1,5,2,2,5,4,4,1,1,4,5,1,2,1,2,2,2,1,1,1,4,5,3,1,2,5,1,2,1,2,4.857142857142857,1,1.5,0,3.8,0,4,0,3,0,1.3333333333333333,0,2,0,2.6666666666666665,0,2.810810810810811,0,0,0,NA,2.1255406735594145,2.0707178668913184,-0.6114411611880771,0.7296383528516206,5,1,5,1,1,2,2,1.2857142857142858,0,5.5,0.9282603427483724,5,5,5,4,2,3,3,3.857142857142857,0,2.142857142857143,-1.3043345419688306,0,4,2,2,1,2,2,4,3,1,4,2,3,1,4,5,2,3,2,4,2,2.2,0,3.6,0,4.2,0,4.2,0,4,0,1,1,2,3,3,1,2,2,2,1,3,3,1,3,2,2,1,1,4,3,2.05,0,"Asian or Asian American (e.g., Chinese, Japanese, and others)",0,19,1,3,NA,5,2,0,0,1,0,0,TRUE,TRUE,TRUE,TRUE,TRUE,0,1,0.7894499999992549,0.8163265306122449,0.07043677458127207,1,0.4067000000002208,0.48059032258006834,0.8709677419354839,0.96875,0.006868205247530776,0.0042980341937549444,1,0.6144812500011176,0.6729124999968334,1,1,0.009277068669380877,0.010695655322463903,1.1983,1.2523,0.4863,1.0834,1.5252,0.5095,0.2788,1.2527493553333333,1.1239648403333333,0.475917819,0.9548,2.0694,0.23,4.028,0.3676,-59.2296,0.8019,3.1043,0.2977,4.3655,0.3947,0.9894,1.0231791246666666,4.07081186,2.477894516666667,0.3619492343333333,0.226746633,0.9077,3.2467,0.5052,3.7123,0.5566,0.9393,0.164,0.299,0.521,0.02,1.461,73.05,375,1.1111111111111112,1,0,0,1,FALSE,FALSE,FALSE
146,2021-11-13T01:29:41Z,0.800000011920929,1.6,900,4,2,5,4,2,3,3,2,4,2,2,2,1,4,2,3,4,2,2,1,1,1,1,2,1,5,2,0,0,4,3,4,3,4,5,4,3,5,3,5,1,1,5,1,5,2,1,2,2,2,5,1,1,1,4,1,2,2,2,1,4,3,2,2,2,1,2,1,2,2,1.375,0,1.75,0,2.066666666666667,0,2.111111111111111,0,1.5,0,1.3333333333333333,0,1.8571428571428572,0,1.6666666666666667,0,1.7567567567567568,0,3,0,0,-0.696012230258031,-0.6236038987364887,0.10724026226325957,-0.25818181823661457,3,3,2,1,2,2,2,2.4285714285714284,0,1.5,0.13604712489199797,3,3,4,4,2,2,4,2.857142857142857,0,3.142857142857143,0.9547190977297628,0,2,4,2,3,3,3,4,2,2,3,1,4,3,4,4,4,4,1,3,2,2.8,0,4.2,0,3,0,4,0,3.7333333333333334,0,1,1,2,2,4,2,3,3,1,3,2,4,1,2,2,3,3,3,1,2,2.05,0,"White, Caucasian, Anglo, European American",0,18,1,2,NA,5,2,0,0,0,0,0,TRUE,TRUE,TRUE,TRUE,TRUE,0,4,0.8310000000000013,0.8775510204081632,0.03064388520408205,4,0.50396875,0.526300000000002,1,0.9375,0.006450482862902757,0.0034916129032252475,4,0.6494687499999959,0.7832333333333323,1,0.9375,0.00963206350806465,0.020946564516129154,1.4788,1.5488,0.4775,1.142,2.2869,0.6026,0.3439,1.4590813166666667,1.2773848086666666,0.47116152133333333,1.3264,4.3981,0.3532,3.378,0.3492,-67.2609,0.7988,4.4415,0.4145,5.6148,0.4562,0.9351,1.4369423093333333,3.5507754633333333,4.536879956666667,0.3422290823333333,0.34521270433333334,1.1746,5.7014,0.5369,3.6818,0.6127,0.9903,0.077,0.458,0.425,0.01,1.597,159.7,336,0.9955555555555555,1,0,0,1,FALSE,FALSE,FALSE
147,2021-11-13T01:27:40Z,1,1.7786458333333333,768,4,2,2,4,3,2,4,3,2,2,4,2,3,5,2,4,3,1,3,1,1,1,1,1,2,0,2,0,0,5,3,5,5,5,5,5,5,5,3,4,1,1,2,2,4,2,1,3,3,3,5,1,1,1,3,1,1,1,1,1,4,2,2,1,1,1,2,1,1,1,1.375,0,1.25,0,2.8666666666666667,0,1.2222222222222223,0,2.25,0,1.1666666666666667,0,1.2857142857142858,0,1,0,1.5945945945945945,0,0,0,0,-0.7968784687602826,-0.3494939889985495,-0.6588395645607719,-0.5041667767796607,5,1,2,1,1,1,1,1.4285714285714286,0,1,-0.6467170085812028,5,5,5,5,2,2,2,4,0,2,-0.4571894270818581,0,1,3,1,1,1,1,5,1,2,3,2,4,1,2,5,1,4,5,5,2,1.4,0,3.6,0,4.6,0,4,0,4.066666666666666,0,2,1,2,2,3,3,2,2,3,3,3,2,3,4,2,2,2,3,3,3,2.7,0,"White, Caucasian, Anglo, European American",0,21,1,2,NA,5,2,0,0,2,0,0,TRUE,TRUE,TRUE,TRUE,TRUE,0,4,0.6948352941175758,0.68,0.019724662648976193,4,0.4900718750000233,0.5987678571429902,1,0.875,0.0014567240221762,0.006116559314520564,4,0.6890500000000175,0.838386206896526,1,0.9666666666666667,0.009201423225806775,0.016298797747120918,1.0318,0.7783,0.4581,0.8615,0.8395,0.5173,0.07,1.0973292593333333,0.862730675,0.450558463,1.1463,5.5019,0.3859,2.2821,0.3974,-69.7326,0.8005,8.3423,0.4447,3.3333,0.4903,0.9745,1.2618074616666666,2.5349635466666665,5.435650953333333,0.386974779,0.3772927523333333,0.9876,4.0178,0.5797,2.4366,0.7034,0.9807,0.087,0.481,0.392,0.012,1.737,144.75,104,0.3081481481481481,1,0,0,1,FALSE,FALSE,FALSE
148,2021-11-13T01:22:38Z,1,1.6,900,6,4,4,4,3,4,2,3,3,2,2,3,3,3,2,3,3,2,3,1,1,1,1,2,2,1,2,0,0,5,4,3,4,3,4,4,4,5,2,4,3,1,4,2,5,3,3,2,3,3,5,1,1,1,3,1,1,5,5,5,3,3,4,1,1,1,2,1,2,2,1.625,0,1.75,0,2.533333333333333,0,2,0,2.25,0,1.1666666666666667,0,3.5714285714285716,0,1,0,2.2162162162162162,0,1,0,0,-0.25472243681068096,-0.11816535754598059,-0.2989446853297732,-0.2085550214378769,5,2,5,2,2,3,3,2,0,1,-0.3048482679606258,5,5,5,5,4,4,2,4.571428571428571,0,1.4285714285714286,-1.5867162469311549,0,1,1,2,1,3,2,4,1,3,4,2,4,1,4,4,2,3,2,3,2,1.6,0,3.8,0,4,0,4,0,3.933333333333333,0,2,1,1,2,3,1,2,2,2,3,1,2,4,3,1,2,1,2,1,2,2.1,0,"White, Caucasian, Anglo, European American & Middle Eastern",1,22,0,1,NA,5,2,1,1,1,0,2,TRUE,TRUE,TRUE,TRUE,TRUE,0,5,1.169850000038743,0.64,0.14804557706067978,5,0.6059161290199526,0.6974281249791384,1,1,0.012842339390691591,0.021103617574197077,5,0.5860093750655652,0.620462962909981,1,0.84375,0.007593833780311423,0.013565826678269699,1.4442,0.4103,0.7123,1.306,0.2745,0.733,0.0375,1.4931906133333332,0.56610626217,0.694112194,2.1701,4.7457,0.3773,3.7641,0.4092,-53.5124,1.1298,4.2403,0.4689,3.3703,0.5368,0.9643,2.113196626666667,3.6099711466666666,4.52435625,0.403785196,0.371453391,0.721,3.7447,0.5169,2.5869,0.5068,0.9972,0.055,0.42,0.342,0.026,2.058,79.15384615384615,466,1.3807407407407408,1,0,2,3,FALSE,FALSE,FALSE
149,2021-11-13T01:31:37Z,1,1.6,800,5,3,4,5,1,4,1,1,3,2,2,3,2,3,3,3,4,1,2,1,1,1,1,2,2,0,2,0,0,5,5,5,5,5,5,5,5,4,1,5,1,1,3,1,5,1,3,3,4,3,3,1,1,1,1,1,1,1,1,1,5,1,2,1,1,2,1,1,1,1,1.375,0,1,0,2.066666666666667,0,1.1111111111111112,0,1.9166666666666667,0,1.1666666666666667,0,1,0,1.3333333333333333,0,1.4324324324324325,0,0,0,0,-0.8977447072625341,-0.7629818189422206,-0.7372407672780129,-0.7501112931101168,4,2,2,2,1,2,2,2.142857142857143,0,1,-0.21938108280548152,5,5,5,4,3,4,1,4.428571428571429,0,1.5714285714285714,1.237100802692087,0,1,1,1,3,1,2,4,2,1,2,2,2,3,3,4,3,5,2,4,2,1.4,0,3.8,0,3.2,0,4,0,3.6666666666666665,0,2,1,2,2,2,2,2,2,2,2,2,2,1,2,1,2,1,2,2,2,2,0,"White, Caucasian, Anglo, European American",0,25,1,2,NA,5,2,0,0,1,0,0,TRUE,TRUE,TRUE,TRUE,TRUE,0,2,1.2533151515148806,0.673469387755102,0.19200580353758606,2,0.5353187499998603,0.5727645161292486,1,0.96875,0.027342140282108088,0.01705230902213674,2,0.7056874999996507,0.7682633333332837,1,0.967741935483871,0.009090897257994847,0.00630842866668411,1.5225,0.4947,0.7162,1.3593,0.5139,0.7482,0.2326,1.5578188266666666,0.6173329669333333,0.698578712,1.2591,3.1265,0.3339,3.414,0.3954,-54.8308,1.0523,2.9575,0.3634,4.4016,0.4364,0.8779,1.4134272553333334,3.613264436666667,3.4328673833333334,0.3826466453333333,0.3217175566666667,1.1191,3.6369,0.5643,4.3944,0.6392,0.8839,0.076,0.536,0.492,0.013,1.5,115.38461538461539,346,1.0251851851851852,1,0,0,1,FALSE,FALSE,FALSE
150,2021-11-13T01:24:48Z,0.8999999761581421,1.6,900,4,4,3,4,2,4,2,2,3,2,2,3,3,3,2,4,3,2,3,1,2,2,3,2,1,2,4,0,0,4,5,5,5,4,5,5,5,2,3,4,2,2,3,3,2,4,2,1,3,3,4,1,1,1,3,3,2,2,2,1,5,1,1,2,2,2,2,1,2,2,2,0,1.75,0,2.4,0,1.5555555555555556,0,2.6666666666666665,0,1.6666666666666667,0,1.2857142857142858,0,2,0,1.972972972972973,0,1,0,0,-0.1727686180276017,-0.11884288910253611,-0.2989446853297732,-0.20889378721615465,3,2,4,1,2,3,3,2.2857142857142856,0,2,0.2350737771240448,4,3,3,4,2,2,3,3,0,3,2.0842459175790595,0,2,2,2,3,3,2,3,2,2,3,2,4,3,4,4,2,5,2,4,3,2.4,0,4.2,0,3.4,0,3.8,0,3.8,0,1,1,1,4,2,1,2,4,1,1,2,4,1,1,1,4,1,1,1,1,1.15,0,"Hispanic of Latino (e.g., Mexican American, Central American, and others)",0,25,0,1,NA,5,2,0,0,0,0,0,TRUE,TRUE,TRUE,TRUE,TRUE,0,4,0.7362571428571362,0.7,0.04532672489796584,4,0.42046874999999634,0.4644999999999982,1,1,0.004616257056451497,0.0021914838709664332,4,0.5536562499999986,0.5792333333333357,1,0.9375,0.006208039314516044,0.011077544354838242,1.3358,0.6816,0.3779,0.9855,0.7481,0.5351,0.2597,1.3709218133333334,0.774546299,0.37234034,1.5099,5.878,0.292,6.4776,0.348,-102.1861,0.766,5.6175,0.3507,5.8427,0.4055,0.9889,1.3135523853333333,5.443231273333334,5.2573064233333335,0.350726093,0.2981047276666667,0.874,5.5693,0.4844,2.0922,0.4541,0.7064,0.065,0.36,0.333,0.039,1.944,49.84615384615385,442,1.3096296296296297,1,0,0,1,FALSE,FALSE,FALSE
151,2021-11-13T01:07:46Z,1,1.7777777777777777,1080,3,3,2,4,2,3,1,1,4,2,1,1,1,5,2,5,4,1,1,1,1,1,1,1,1,1,3,0,0,5,5,4,5,5,5,5,5,5,2,3,2,1,4,2,5,1,1,1,2,2,5,1,1,1,3,2,1,1,1,1,5,1,2,1,2,1,1,2,2,2,1,0,1.75,0,1.7333333333333334,0,1.1111111111111112,0,1.6666666666666667,0,1.3333333333333333,0,1,0,1.3333333333333333,0,1.3783783783783783,0,1,0,0,-1.1646199632997414,-1.0906167216480558,-0.2989446853297732,-0.6947807034889145,4,3,2,1,1,1,2,2,0,1.5,-0.12035443057343476,4,5,5,5,2,3,2,4,0,2,0.6723373927674386,0,2,2,1,1,3,2,2,1,1,2,1,1,2,1,5,1,4,1,3,5,1.8,0,3.8,0,3.2,0,3.4,0,3.466666666666667,0,2,1,1,3,2,2,3,3,1,1,2,4,1,2,2,4,1,2,1,2,1.6,0,"Hispanic of Latino (e.g., Mexican American, Central American, and others)",0,21,0,1,NA,5,2,1,0,1,0,1,TRUE,TRUE,TRUE,TRUE,TRUE,0,1,1.5219707317076079,0.8723404255319149,0.16117337215513527,1,0.42459333333373067,0.49615312499925496,1,1,0.0023555413340088024,0.005007572893657382,1,0.535156250005588,0.7139517241428638,1,0.90625,0.005363852863150917,0.011790059193797343,1.8078,1.0981,0.9424,0.9445,1.9788,1.3513,0.8471,1.8047451633333333,0.9965608123333334,0.899315614,5.4181,10.5261,0.1672,8.1874,0.1653,-89.8091,0.7624,6.0464,0.3646,5.169,0.4239,0.9833,1.68753173,4.66524001,5.912243966666667,0.3201097156666667,0.28724075466666665,0.9399,4.6422,0.4447,2.9098,0.5828,0.9785,0.087,0.331,0.451,0.01,2.088,208.8,104,0.3081481481481481,1,0,0,1,FALSE,FALSE,FALSE
153,2021-11-13T01:22:20Z,0.8999999761581421,1.6,1120,6,3,4,4,2,3,2,2,4,1,2,4,2,4,3,4,3,3,4,5,2,2,3,2,4,4,2,2,1,4,2,3,4,4,2,2,3,3,2,4,2,1,3,3,3,5,3,2,2,2,2,3,2,2,3,1,2,3,3,1,4,1,1,1,2,1,2,2,2,2,3.125,0,2,0,2.2666666666666666,0,3,0,2.5,0,2.3333333333333335,0,1.7142857142857142,0,1.3333333333333333,0,2.4054054054054053,0,2,2,1,0.7959675475877719,0.49316168691193807,0.5722650532692125,0.5327133700905753,4,2,3,1,1,1,1,1.5714285714285714,0,1,-0.5612498234260587,3,3,5,4,2,2,2,3.2857142857142856,0,2.7142857142857144,-0.7395711320441822,0,2,2,3,4,3,3,5,2,1,2,1,3,4,4,5,1,3,1,5,2,2.8,0,3.8,0,3.8,0,4.4,0,4,0,2,1,3,1,2,3,3,2,3,1,3,1,1,3,1,2,3,2,1,3,2.45,0,"White, Caucasian, Anglo, European American",0,30,1,2,NA,5,2,0,0,0,0,0,TRUE,TRUE,TRUE,TRUE,TRUE,0,6,1.1206249999999869,0.8163265306122449,0.12007762925169585,6,0.5636451612903226,0.6022580645161328,1,0.96875,0.015039969892473724,0.010495587701613077,6,0.7400625000000054,0.8208965517241359,1,0.9354838709677419,0.018413931451612887,0.017161569892471112,1.5803,0.9692,0.6536,1.2713,0.9587,0.799,0.4388,1.5926990366666667,0.9342007993333333,0.6395335863333333,1.4581,3.3517,0.3461,3.3744,0.3948,-50.117,1.0715,3.1643,0.4071,4.2929,0.4733,0.9764,1.64249274,3.5751479766666665,3.659091526666667,0.37931582966666666,0.333119462,1.157,2.5426,0.5422,3.0074,0.6452,0.9067,0.073,0.518,0.332,0.017,1.98,116.4705882352941,448,1.3274074074074074,1,0,0,1,FALSE,FALSE,FALSE
154,2021-11-13T01:26:53Z,0.8999999761581421,1.6,900,3,3,4,4,3,4,2,2,3,2,2,2,1,4,1,3,3,2,1,1,1,1,1,1,1,0,2,3,2,5,2,4,4,5,5,3,4,5,2,4,2,1,4,2,4,2,1,2,1,3,3,3,1,1,1,1,1,1,1,1,5,1,1,1,2,1,2,3,4,4,1.125,0,3.25,0,2.1333333333333333,0,1.8888888888888888,0,1.8333333333333333,0,1.5,0,0.8571428571428571,0,1.3333333333333333,0,1.6216216216216217,0,0,3,2,-0.9355695467008782,-0.7604652731607284,0.9411689737545899,0.09035185029693071,5,1,2,1,1,2,1,1.5714285714285714,0,1.5,-0.3767559860388676,5,5,5,5,2,3,1,4.285714285714286,0,1.7142857142857142,-0.7395711320441822,0,2,3,3,3,2,2,4,2,1,2,1,3,1,3,2,2,4,2,4,2,2.6,0,4,0,3.8,0,3.6,0,3.8,0,3,1,1,3,3,1,1,2,1,3,3,3,1,2,2,3,2,2,1,1,1.85,0,"Asian or Asian American (e.g., Chinese, Japanese, and others)",0,18,1,2,NA,5,2,0,1,2,0,1,TRUE,TRUE,TRUE,TRUE,TRUE,0,NA,NA,NA,NA,5,0.4456357142840113,0.5226137930935827,0.9032258064516129,0.90625,0.0026703322798492884,0.007883607731792648,5,0.596506451602905,0.6926099999904632,1,0.9375,0.007057545294279032,0.008518031448605756,NA,NA,NA,NA,NA,NA,NA,NA,NA,NA,0.9821,2.5798,0.297,2.696,0.3731,-50.5067,0.5479,3.9159,0.3918,5.0438,0.4597,0.9875,1.07532717,2.9447496933333333,3.0046366466666665,0.365512008,0.29271912233333336,1.0297,5.6698,0.5071,3.7843,0.557,0.9841,0.076,0.397,0.389,0.013,1.775,136.53846153846155,434,1.285925925925926,1,0,0,1,FALSE,FALSE,FALSE
155,2021-11-13T01:36:31Z,1,1.7777777777777777,864,6,3,4,5,2,4,2,1,4,1,2,1,1,5,3,4,4,2,1,1,1,1,1,1,2,0,2,0,0,5,4,5,5,4,5,5,5,3,1,5,1,1,3,2,5,1,1,1,1,2,5,1,1,1,3,1,1,1,1,1,5,1,1,1,2,1,1,1,1,1,1.25,0,1,0,1.6666666666666667,0,1.4444444444444444,0,1.3333333333333333,0,1.1666666666666667,0,0.8571428571428571,0,1.3333333333333333,0,1.2972972972972974,0,0,0,0,-1.0595509648598957,-1.046673960694304,-0.7372407672780129,-0.8919573639861584,5,1,2,1,1,2,1,1.5714285714285714,0,1,-0.5612498234260587,3,3,4,4,2,2,3,3,0,3,0.9547190977297628,0,2,2,2,3,2,2,3,2,1,1,1,4,3,3,4,3,4,2,3,4,2.2,0,4.2,0,2.6,0,3.6,0,3.466666666666667,0,1,3,2,3,3,2,2,1,1,1,2,3,2,2,1,4,1,1,1,2,1.8,0,"White, Caucasian, Anglo, European American",0,29,1,2,NA,5,2,0,0,0,0,0,TRUE,TRUE,TRUE,TRUE,TRUE,0,2,0.8640382352979744,0.7555555555555555,0.3726247366387821,2,0.4034968750048429,0.5052133333325386,1,0.967741935483871,0.002340293861043407,0.004879074945883507,2,0.5722624999955297,0.6772413793082895,1,0.90625,0.005585745000405044,0.006373648226414728,1.5694,0.7035,0.4572,1.3047,0.5574,0.5095,0.0198,1.56560376,0.7600845886666666,0.45219736066666666,0.9942,4.7183,0.2981,4.4226,0.3989,-91.8604,0.7801,6.4013,0.3467,4.8473,0.4203,0.9794,1.136875965,4.424572783333334,4.98036714,0.38734214266666667,0.2907615393333333,0.6476,4.6307,0.5134,4.2799,0.6131,0.9892,0.071,0.441,0.583,0.008,1.308,163.5,374,1.108148148148148,1,0,0,1,FALSE,FALSE,FALSE
156,2021-11-13T00:59:59Z,1,1.7777777777777777,1080,4,3,4,4,3,3,2,2,2,3,2,3,3,2,2,2,3,2,2,1,1,1,1,1,1,0,2,0,0,5,2,4,3,2,4,3,3,3,4,5,4,1,3,2,3,2,3,2,2,3,4,1,1,1,1,1,1,1,4,1,4,2,1,1,1,1,2,1,1,1,1.25,0,1.25,0,2.8,0,2.7777777777777777,0,2.5,0,1,0,1.5714285714285714,0,1,0,2.081081081081081,0,0,0,0,-0.5720308120990136,-0.22279558792264442,-0.6588395645607719,-0.44081757624170814,4,2,2,1,2,2,1,2,0,1,-0.3048482679606258,4,4,4,3,2,2,2,3.2857142857142856,0,2.7142857142857144,0.9547190977297628,0,2,2,1,2,2,2,4,3,3,4,2,3,3,3,3,3,3,2,3,3,1.8,0,3.6,0,3.4,0,3,0,3.3333333333333335,0,2,1,1,2,1,2,2,2,2,3,2,2,2,2,2,2,1,2,2,1,2,0,"White, Caucasian, Anglo, European American",0,22,0,1,NA,5,2,0,1,0,0,1,TRUE,TRUE,TRUE,TRUE,TRUE,0,2,0.9226147058820899,0.6938775510204082,0.07131090776359057,2,0.590763333333532,0.6632300000006954,0.9375,0.967741935483871,0.0222326682259929,0.01006408051603291,2,0.6875125000011176,0.7304366666659713,1,0.967741935483871,0.00608248177428162,0.006476533913994683,1.2539,0.6695,0.5868,0.9462,0.8952,0.7002,0.3116,1.3215451933333333,0.7758421963333333,0.5738346306666666,1.8968,2.3853,0.2319,4.019,0.4274,-31.8618,1.1276,3.7969,0.4251,3.7339,0.5245,0.9762,1.7851428066666666,2.99835243,2.47862485,0.3698861903333333,0.243000629,0.9669,6.3697,0.6148,5.1197,0.6375,0.9977,0.067,0.548,0.486,0.016,1.289,80.5625,104,0.3081481481481481,1,0,5,6,FALSE,FALSE,FALSE
157,2021-11-13T01:36:25Z,0.8999999761581421,1.6,900,5,3,3,4,3,2,3,3,3,4,3,1,3,3,2,2,2,2,3,1,1,2,4,2,1,1,5,0,0,2,3,3,3,2,4,2,2,2,1,4,3,1,2,3,3,2,2,3,3,4,2,1,1,1,3,1,1,1,1,1,3,3,3,1,1,2,2,4,2,2,2,0,2.5,0,3,0,3.4444444444444446,0,2.5833333333333335,0,1.6666666666666667,0,1.7142857142857142,0,1.3333333333333333,0,2.4324324324324325,0,1,0,0,0.11301905772877759,0.3364583169028547,-0.06374107717804986,0.13635861986240244,5,1,3,1,1,3,1,1.5714285714285714,0,1.5,-0.3767559860388676,4,4,5,5,2,2,2,3.7142857142857144,0,2.2857142857142856,-0.7395711320441822,0,4,4,4,3,4,3,4,3,3,4,3,2,2,4,3,2,3,4,3,3,3.8,0,2.6,0,3.8,0,3.2,0,3.2,0,1,1,1,3,4,2,3,3,1,3,1,3,1,2,2,3,2,2,2,3,1.95,0,"White, Caucasian, Anglo, European American",0,22,1,2,NA,5,2,0,0,1,0,0,TRUE,TRUE,TRUE,TRUE,TRUE,0,1,0.9691190476190477,0.84,0.06001889795918397,1,0.4504666666666725,0.5035000000000155,0.9375,0.9375,0.005346458669354541,0.005973770161290237,1,0.598193548387093,0.7194137931034503,0.96875,0.90625,0.013990176411290592,0.025633060483869995,1.4748000000000001,1.1845,0.5688,1.2117,1.176,0.6799,0.1241,1.4905584233333333,1.0899207103333333,0.5591230693333333,1.0182,2.7832,0.2861,3.0974,0.3549,-56.0145,0.6811,4.6677,0.385,4.4487,0.43120000000000003,0.99,1.1178905843333333,3.3196923833333334,3.1892036966666666,0.34743839,0.28081395833333334,1.122,5.8025,0.4887,1.6295,0.5112,0.8502,0.082,0.368,0.335,0.01,1.408,140.79999999999998,422,1.2503703703703704,1,0,0,1,FALSE,FALSE,FALSE
158,2021-11-13T01:27:49Z,1,1.7777777777777777,864,5,3,4,4,3,5,2,1,4,1,2,1,1,5,3,4,4,1,2,1,1,1,1,1,2,0,2,0,0,5,3,3,4,2,5,4,3,5,1,5,1,1,3,2,5,2,1,1,3,2,5,1,1,1,1,1,1,1,1,1,5,1,1,1,1,1,1,1,1,1,1.25,0,1,0,1.7333333333333334,0,2.2222222222222223,0,1.5833333333333333,0,0.8333333333333334,0,0.8571428571428571,0,1,0,1.4864864864864864,0,0,0,0,-0.9418736866072692,-0.9367202680875601,-0.7372407672780129,-0.8369805176827865,5,2,4,1,1,2,2,1.5714285714285714,0,2,-0.19226214865167657,4,4,4,5,3,3,2,3.857142857142857,0,2.142857142857143,-0.1748077221195339,0,2,2,3,3,3,2,5,2,2,2,1,4,3,3,4,3,4,2,4,4,2.6,0,4.2,0,3.4,0,3.4,0,3.6666666666666665,0,2,1,3,1,3,3,3,1,2,2,1,2,1,1,1,2,3,3,2,3,2.4,0,"Hispanic of Latino (e.g., Mexican American, Central American, and others) & Middle Eastern",1,25,1,2,NA,5,2,0,0,0,0,0,TRUE,TRUE,TRUE,TRUE,TRUE,0,2,1.0167709677450119,0.6326530612244898,0.21851093171677444,2,0.7247517241280654,0.7974799999952317,1,1,0.06300930472953271,0.034148466495794824,2,1.1723968750089406,1.9461299999793371,1,1,0.2901456338435035,0.4989787104262279,1.6151,0.3469,0.3398,1.0974,0.6923,0.6303,0.5863,1.5946367766666667,0.4981271954666667,0.341069207,3.2563,3.1474,0.2074,3.274,0.3002,-12.8461,1.6679,1.9379,0.3586,3.1945,0.5409,0.9725,2.196216973333333,2.6598156533333333,2.7755442433333335,0.37345665933333333,0.31213296733333334,2.5749,1.5472,0.3706,0.8992,1.0158,0.9078,0.193,0.188,0.183,0.003,1.918,639.3333333333333,380,1.125925925925926,1,0,0,1,FALSE,FALSE,FALSE
159,2021-11-13T01:24:43Z,1,1.6,900,6,2,1,3,3,4,2,1,2,5,4,3,1,1,1,1,1,5,4,1,1,4,5,4,4,1,5,0,0,5,2,4,4,5,5,4,4,4,1,4,1,1,1,4,1,5,5,4,5,4,2,1,1,1,1,1,1,1,1,1,4,1,1,5,5,5,4,4,1,1,3.5,0,2.5,0,3.2666666666666666,0,1.8888888888888888,0,3.5,0,1.3333333333333333,0,1,0,5,0,2.4594594594594597,0,1,0,0,1.062842803624979,1.1072956478184441,-0.06374107717804986,0.5217772853201972,3,1,3,4,1,2,3,2.4285714285714284,0,1,-0.048446712495193056,3,2,4,3,1,1,5,2.142857142857143,0,3.857142857142857,2.0842459175790595,0,2,3,3,3,3,3,4,2,2,2,1,4,1,4,4,1,4,4,4,3,2.8,0,3.6,0,4,0,3.8,0,3.8,0,2,1,3,2,3,3,2,2,3,2,3,2,3,3,1,2,2,3,2,3,2.55,0,"Asian or Asian American (e.g., Chinese, Japanese, and others)",0,28,1,2,NA,5,2,0,0,1,0,0,TRUE,TRUE,TRUE,TRUE,TRUE,0,NA,NA,NA,NA,3,0.4886875,0.5901935483870968,1,1,0.010076092741935485,0.026387427956989253,3,0.76325,0.8537741935483871,1,0.96875,0.05639509677419355,0.02860787096774193,NA,NA,NA,NA,NA,NA,NA,NA,NA,NA,1.461,4.4508,0.3246,3.4194,0.3766,-63.1795,1.1902,4.5174,0.3542,3.3776,0.4035,0.9619,1.59594474,3.5568637633333333,4.592563996666667,0.3644686443333333,0.3149351326666667,1.4175,2.9182,0.4928,2.5306,0.5974,0.9304,0.096,0.442,0.288,0.018,1.886,104.77777777777779,356,1.0548148148148149,1,0,2,3,FALSE,FALSE,FALSE
160,2021-11-13T01:35:43Z,1,1.7777777777777777,1080,3,3,4,4,1,4,2,1,4,2,2,1,2,4,1,3,1,2,2,1,1,1,3,3,2,0,3,1,1,4,2,2,3,3,5,3,4,2,2,5,2,1,3,2,5,2,2,2,1,2,4,2,1,1,3,2,2,1,1,1,4,2,2,2,1,2,2,2,1,2,1.875,0,1.75,0,2,0,2.888888888888889,0,1.75,0,1.6666666666666667,0,1.4285714285714286,0,1.6666666666666667,0,2,0,0,1,1,-0.2337086371227119,-0.3328460707517538,-0.11895430463408513,-0.22590018769291947,4,2,3,1,1,2,2,1.8571428571428572,0,1,-0.39031545311577004,5,4,4,5,2,3,2,3.857142857142857,0,2.142857142857143,-0.1748077221195339,0,3,3,4,5,4,3,4,3,2,2,1,4,4,3,3,4,4,1,2,3,3.8,0,4.2,0,2.4,0,3.2,0,3.2666666666666666,0,3,1,4,1,3,3,4,2,3,2,2,2,1,4,1,2,3,3,3,4,2.85,0,"White, Caucasian, Anglo, European American",0,21,1,3,NA,5,2,0,0,1,0,0,TRUE,TRUE,TRUE,TRUE,TRUE,0,6,0.8393651162302771,0.8775510204081632,0.03348516066071212,6,0.45966875000298024,0.5148843750208616,1,1,0.0018223048073499816,0.0024970807158889116,6,0.6182125000357628,0.6504354838248222,1,0.96875,0.009610740490152607,0.00733811950286896,1.5131,1.6118,0.5014,1.1334,1.9356,0.6058,0.2719,1.50856947,1.2565049603333334,0.4518249303333333,3.8824,10.4623,0.2741,9.1314,0.3023,-109.2822,0.7396,6.6809,0.4054,6.3872,0.4621,0.9228,1.5395552623333333,5.438131876666667,6.25570778,0.3803240606666667,0.3429424896666667,0.7811,3.4166,0.5346,4.7847,0.5784,0.9652,0.069,0.413,0.341,0.022,1.631,74.13636363636364,424,1.2562962962962962,1,0,0,1,FALSE,FALSE,FALSE
161,2021-11-13T01:37:57Z,1,1.6,900,6,2,4,4,2,4,2,2,4,3,2,2,2,3,4,4,2,3,2,1,1,1,2,2,3,0,2,0,0,3,1,2,4,4,5,5,4,4,2,5,1,1,2,2,3,2,2,2,1,1,4,1,1,1,1,1,1,1,1,1,4,1,1,1,1,1,1,1,1,1,1.875,0,1,0,2.4,0,2.4444444444444446,0,1.8333333333333333,0,1,0,1,0,1,0,1.6756756756756757,0,0,0,0,-0.435441114127215,-0.3003245560370831,-0.7372407672780129,-0.5187826616575479,5,1,3,1,1,1,1,1.2857142857142858,0,1.5,-0.5476903563491562,4,4,4,4,3,3,2,3.7142857142857144,0,2.2857142857142856,-0.1748077221195339,0,2,2,2,3,2,2,4,2,2,5,1,4,2,4,5,1,5,1,5,1,2.2,0,4.6,0,4.6,0,4.4,0,4.533333333333333,0,3,2,3,1,4,2,3,2,2,2,3,2,2,4,2,2,3,2,3,3,2.8,0,"White, Caucasian, Anglo, European American",0,24,1,2,NA,5,2,0,0,1,0,0,TRUE,TRUE,TRUE,TRUE,TRUE,0,1,0.9807794871635926,0.78,0.12830292320049497,1,0.5061687500029802,0.6172033333539962,1,0.967741935483871,0.00783248156900856,0.014294363286018876,1,0.7782812499776482,0.8674843749776483,1,1,0.024782331898510895,0.024348805883428717,1.4992,0.8935,0.5536,1.2156,0.8095,0.6543,0.0624,1.5190857166666667,0.8995487313333334,0.5441723283333333,1.3526,4.9015,0.3682,2.8329,0.4046,-62.5544,1.2005,5.2628,0.386,4.1006,0.4634,0.9939,1.5494089866666667,3.0952705,5.014147923333334,0.38805417633333333,0.35304053333333335,1.3867,2.9121,0.5579,2.9214,0.6316,0.8884,0.102,0.49,0.335,0.024,1.938,80.75,352,1.0429629629629629,1,0,0,1,FALSE,FALSE,FALSE
162,2021-11-13T01:36:04Z,1,1.7777777777777777,864,5,3,2,3,3,3,5,4,2,4,3,4,3,2,3,1,2,3,2,1,2,2,3,4,4,0,3,0,0,3,2,4,3,2,4,1,2,2,4,2,4,2,4,3,4,5,4,4,3,3,4,1,1,1,3,1,3,1,1,1,2,5,4,2,2,3,1,2,1,1,2.625,0,1.25,0,3.7333333333333334,0,3.4444444444444446,0,3.3333333333333335,0,1.3333333333333333,0,2.5714285714285716,0,2.3333333333333335,0,2.864864864864865,0,0,0,0,0.7707509879622091,1.106037374927698,-0.6588395645607719,0.22359890518346304,4,2,3,2,2,3,3,2.4285714285714284,0,2.5,0.5050347996663801,4,3,4,5,3,3,2,3.7142857142857144,0,2.2857142857142856,-1.3043345419688306,0,3,4,4,3,3,4,5,3,3,4,2,3,2,4,4,5,4,3,4,3,3.4,0,3.2,0,3.6,0,3.4,0,3.4,0,2,1,2,3,3,2,3,3,2,1,3,3,2,2,2,3,1,2,1,3,2,0,"White, Caucasian, Anglo, European American & Middle Eastern",1,29,0,1,NA,5,2,0,0,1,0,0,TRUE,TRUE,TRUE,TRUE,TRUE,0,3,0.6686911111103164,0.9,0.02123268561714808,3,0.4355656249960885,0.5118937500016764,1,1,0.0020422765221942544,0.0027910902821637958,3,0.5691250000018626,0.6298419354836787,1,0.96875,0.009373683870736917,0.016087007085763348,1.4345,1.8638,0.3709,0.9724,2.0921,0.4957,0.1009,1.3863179433333332,1.4292305003333334,0.36744188633333336,2.8115,8.7004,0.274,8.0243,0.3367,-105.9921,0.7459,6.0951,0.3797,5.7635,0.4502,0.999,1.466028248,5.360910326666667,5.934517666666666,0.38231300366666665,0.317504229,1.405,7.9215,0.4858,3.5846,0.4443,0.8931,0.078,0.356,0.347,0.02,1.655,82.75,396,1.1733333333333333,1,0,1,2,FALSE,FALSE,FALSE
163,2021-11-13T01:41:51Z,1,1.6,900,6,2,5,5,3,4,2,2,4,3,2,1,1,5,3,5,5,1,1,1,1,1,1,2,1,0,2,0,0,5,5,5,4,5,5,5,5,5,1,5,1,1,4,2,5,3,1,1,1,3,5,1,1,1,4,2,1,1,1,1,5,1,2,1,3,1,3,1,1,1,1.125,0,1.5,0,1.7333333333333334,0,1.1111111111111112,0,1.5,0,1.5,0,1,0,1.6666666666666667,0,1.3783783783783783,0,0,0,0,-1.0868689044542559,-1.03689814823543,-0.5804383618435307,-0.8086682550394804,5,1,5,1,1,1,1,1,0,1,-0.9031185640466358,3,3,5,3,2,2,4,2.857142857142857,0,3.142857142857143,0.9547190977297628,0,2,2,2,3,2,2,4,2,1,3,1,4,2,4,4,1,5,2,4,1,2.2,0,4.4,0,4,0,4.4,0,4.266666666666667,0,2,1,2,4,3,1,3,3,1,1,4,3,2,2,1,3,2,2,1,3,1.9,0,"White, Caucasian, Anglo, European American",0,23,1,2,NA,5,2,0,0,0,0,0,TRUE,TRUE,TRUE,TRUE,TRUE,0,4,0.7727941176470589,0.68,0.06633596571428572,4,0.42525,0.4566,1,0.9375,0.00484967741935484,0.002780286290322581,4,0.54990625,0.6020689655172414,1,0.90625,0.0067779586693548395,0.005355394153225807,1.4267,0.5622,0.3538,1.0501,0.612,0.5225,0.2366,1.4515976666666666,0.6849551896666667,0.3491735933333333,0.9617,4.0539,0.3066,4.1942,0.3529,-86.2127,0.8669,5.4866,0.3445,5.554,0.38,0.9037,1.0585576603333333,4.266113163333333,4.319526443333333,0.3464087713333333,0.30126101133333333,0.8689,3.6356,0.4429,4.4629,0.5025,0.9028,0.053,0.424,0.486,0.024,2.009,83.70833333333333,434,1.285925925925926,1,0,0,1,FALSE,FALSE,FALSE
164,2021-11-13T01:34:22Z,1,1.6,900,6,3,2,4,3,4,2,4,2,4,4,4,4,3,2,2,3,2,5,1,1,2,4,4,3,0,2,0,0,4,4,2,3,4,4,5,4,3,1,5,2,1,3,3,5,4,2,2,5,5,1,1,1,1,1,1,1,1,1,1,4,2,2,1,3,2,1,1,1,1,2.75,0,1,0,3.2666666666666666,0,2.3333333333333335,0,2.5,0,1.5,0,1.2857142857142858,0,2,0,2.081081081081081,0,0,0,0,0.3609818940468122,0.6223766337693353,-0.7372407672780129,-0.05743206675433882,5,2,4,2,2,2,2,1.8571428571428572,0,1,-0.39031545311577004,4,4,5,4,1,1,3,3.142857142857143,0,2.857142857142857,0.6723373927674386,0,2,2,2,3,3,1,4,2,2,2,2,4,3,4,4,2,4,3,4,3,2.4,0,4,0,3.4,0,3.8,0,3.7333333333333334,0,3,3,4,2,3,4,4,2,3,4,3,2,3,3,1,2,4,4,2,2,3.1,0,"Hispanic of Latino (e.g., Mexican American, Central American, and others)",0,25,1,2,NA,5,2,0,0,1,0,0,TRUE,TRUE,TRUE,TRUE,TRUE,0,2,0.8312750000000008,0.8,0.04497634448979478,2,0.6047187499999909,0.6411666666666687,1,1,0.004809434475807099,0.003403522988505413,2,1.0838437500000109,1.5381249999999926,1,1,0.14963955544354865,0.19321024193549252,1.3192,1.1248,0.4904,1.1576,1.0417,0.552,0.1342,1.3583552366666667,1.052743692,0.4818654646666667,10,10.4479,0.1262,10.8226,0.1792,-83.2177,0.7272,3.6597,0.5294,5.2165,0.5878,0.9857,2.2867176033333334,4.90708856,5.500722603333333,0.4130043603333333,0.399571265,1.9443,2.6222,0.6858,1.2294,0.9836,0.9683,0.173,0.481,0.29,0,0.51,Inf,434,1.285925925925926,1,0,0,1,FALSE,FALSE,FALSE
166,2021-11-13T01:27:19Z,0.8999999761581421,1.6,900,3,4,2,5,2,5,2,2,4,3,1,2,1,4,2,3,4,3,4,4,2,2,3,3,2,1,3,0,0,4,4,4,5,3,5,5,5,5,2,5,3,1,3,2,5,5,3,4,4,4,2,1,1,1,2,1,3,2,2,1,3,3,3,1,1,1,1,1,1,1,2.875,0,1,0,2,0,1.5555555555555556,0,2.75,0,1.5,0,2.2857142857142856,0,1,0,2.081081081081081,0,1,0,0,0.43873295289229775,0.13174699660068598,-0.5341482934814965,-0.20120064844040525,5,1,5,1,1,1,1,1,0,1,-0.9031185640466358,5,5,5,5,2,3,1,4.285714285714286,0,1.7142857142857142,0.38995568780511447,0,2,4,3,4,4,2,3,4,2,1,1,4,4,2,4,5,4,1,4,4,3.4,0,4.4,0,2.2,0,2.8,0,3.1333333333333333,0,1,1,2,3,2,3,3,3,2,1,1,3,1,3,1,3,2,3,2,3,1.95,0,"White, Caucasian, Anglo, European American",0,21,0,1,NA,5,2,1,0,1,0,1,TRUE,TRUE,TRUE,TRUE,TRUE,0,6,1.077733333332198,0.84,0.18861045630988643,6,0.489006250000326,0.5694937499994412,1,1,0.007816603185429188,0.007361727056510311,6,0.6590096774207007,0.7149838709689437,1,0.96875,0.0070247269032245475,0.01185622708655509,1.7197,0.9557,0.5023,1.7339,0.9678,0.4962,0.2816,1.6745110966666668,0.926467356,0.500620485,1.462,4.911,0.3402,4.555,0.409,-80.5276,0.9198,4.9507,0.3881,4.5772,0.4678,0.9776,1.5982019066666666,4.51914049,4.952698043333333,0.396198247,0.329125733,1.0751,4.3594,0.541,3.4411,0.5777,0.8957,0.084,0.446,0.408,0.019,1.579,83.10526315789474,304,0.9007407407407407,1,1,5,6,FALSE,FALSE,FALSE
167,2021-11-13T01:41:11Z,1,1.7777777777777777,864,6,3,1,4,3,4,1,3,2,4,3,3,2,3,1,3,4,3,4,4,3,3,4,4,4,4,2,3,1,5,3,4,5,5,5,5,5,5,1,5,4,4,4,1,5,1,3,1,4,4,1,4,5,5,5,5,5,5,1,1,5,1,1,1,1,1,2,2,2,1,3.625,0,1.75,0,2.7333333333333334,0,1.3333333333333333,0,2.25,0,4.666666666666667,0,2,0,1,0,2.324324324324324,0,2,3,1,1.0565386637185885,0.8737408412514783,0.7004970581449952,0.7871189496982367,5,2,3,2,1,1,1,1.5714285714285714,0,1,-0.5612498234260587,5,5,5,5,1,1,3,3.5714285714285716,0,2.4285714285714284,0.6723373927674386,0,1,5,1,1,1,1,5,1,1,5,1,5,1,5,5,1,5,1,5,5,1.8,0,5,0,5,0,4.2,0,4.733333333333333,0,1,1,2,3,1,1,4,4,3,1,1,3,2,4,2,2,1,2,1,1,1.8,0,"White, Caucasian, Anglo, European American",0,23,1,2,NA,5,2,0,0,3,0,0,TRUE,TRUE,TRUE,TRUE,TRUE,0,6,0.6686468749999913,0.6530612244897959,0.016916583971082328,6,0.43127096774193246,0.5133964285714485,0.96875,0.875,0.003925098135088127,0.006526112741947177,6,0.5678937499999738,0.6375700000000031,1,0.9375,0.007156120604836141,0.007096260796371351,1.1394,0.5882,0.3412,0.8086,1.0522,0.4994,0.352,1.1966357663333334,0.7420384246376667,0.33495985166666664,1.0075,4.1602,0.3206,2.0971,0.3204,-59.2967,0.8272,4.2103,0.3401,3.1591,0.3964,0.9971,1.094158357,2.387051371,4.32859373,0.31508361133333335,0.31438868066666664,0.8255,3.3306,0.4801,3.8826,0.5392,0.9963,0.063,0.394,0.374,0.011,1.548,140.72727272727275,354,1.0488888888888888,1,0,0,1,FALSE,FALSE,FALSE
168,2021-11-13T01:33:06Z,1,1.7777777777777777,1080,6,2,4,4,2,4,2,1,3,3,2,2,1,3,2,3,4,3,1,2,1,1,1,2,3,1,3,0,3,4,4,4,3,3,4,3,4,4,2,4,1,2,3,2,5,5,5,3,2,3,3,2,5,1,4,1,1,2,1,1,5,2,1,1,2,2,2,2,2,1,1.75,0,1.75,0,2.1333333333333333,0,2.3333333333333335,0,2.5833333333333335,0,2.5,0,1.1428571428571428,0,1.6666666666666667,0,2.2162162162162162,0,1,0,3,-0.1769713779651954,-0.23634621905375758,0.23040425536776904,-0.002970981842994269,3,3,2,1,2,3,2,2.5714285714285716,0,2.5,0.5905019848215247,4,4,4,3,2,2,2,3.2857142857142856,0,2.7142857142857144,1.5194825076544112,0,2,3,2,2,2,2,4,1,2,3,2,3,2,4,3,3,5,2,3,2,2.2,0,4,0,3.4,0,4,0,3.8,0,2,2,3,3,3,3,3,2,1,1,3,3,2,1,1,3,2,2,1,3,2.1,0,"Hispanic of Latino (e.g., Mexican American, Central American, and others)",0,29,1,2,NA,5,2,0,0,1,0,0,TRUE,TRUE,TRUE,TRUE,TRUE,0,1,0.947806249999674,0.6530612244897959,0.05547745791660036,1,0.4559781249994412,0.5541656250003725,1,1,0.0029934985383356224,0.00650932684472627,1,0.6134187500005355,0.6303500000004424,1,1,0.0045160312500505655,0.006101745806471811,1.5982,0.4403,0.3896,1.2013,0.4604,0.6286,0.1154,1.5885213966666667,0.5763093403333334,0.3873853936666667,10,11.3733,0.0164,9.3195,0.0176,-83.0373,0.8195,6.0708,0.3967,4.8088,0.4738,0.9641,2.1028142733333333,4.831154973333334,5.0557432633333335,0.3402800713333333,0.2504743463333333,0.7366,4.8458,0.5443,4.9524,0.5575,0.9413,0.154,0.378,0.651,0.082,1.45,17.68292682926829,279,0.8266666666666667,1,0,0,1,FALSE,FALSE,FALSE
169,2021-11-13T01:41:28Z,0.8999999761581421,1.7777777777777777,864,6,4,5,5,4,4,2,1,4,1,1,1,1,5,1,4,5,1,1,1,1,1,1,1,1,1,2,0,0,5,5,3,5,5,5,5,5,4,1,5,1,1,3,2,5,1,1,1,1,1,4,1,1,1,2,1,1,2,2,1,5,2,1,1,1,1,1,1,2,2,1,0,1.5,0,1.4666666666666666,0,1.3333333333333333,0,1.25,0,1.1666666666666667,0,1.2857142857142858,0,1,0,1.2972972972972974,0,1,0,0,-1.2150530825508667,-1.2400608249797573,-0.3773458880470143,-0.8087033565133859,5,1,5,1,1,1,1,1,0,1,-0.9031185640466358,5,5,5,5,3,3,1,4.428571428571429,0,1.5714285714285714,-0.7395711320441822,0,2,3,2,1,2,2,3,2,2,2,1,3,2,3,3,3,4,2,3,2,2,0,4,0,3,0,3.6,0,3.533333333333333,0,2,2,3,1,2,2,2,2,1,1,2,2,1,2,1,2,1,3,3,2,2.15,0,"White, Caucasian, Anglo, European American",0,23,1,2,NA,5,2,0,1,1,0,1,TRUE,TRUE,TRUE,TRUE,TRUE,0,2,0.7542883720935084,0.86,0.030856720771175954,2,0.39719374999776486,0.46944999999925496,1,1,0.0014147696370695577,0.0032442716130782136,2,0.5367718749986962,0.6194724137926924,1,0.90625,0.004813216280131937,0.006529731683443942,1.3663,1.4514,0.4427,0.8807,1.586,0.6169,0.2849,1.3809948966666667,1.2421102813333333,0.435432253,10,15.1852,0.0679,10.9178,0.0115,-104.5686,0.7639,7.3454,0.348,5.6902,0.4174,0.9496,1.7716920266666667,4.54208138,6.740595326666667,0.277963031,0.27286075466666665,0.7906,5.6757,0.4734,3.1073,0.5139,0.9959,0.058,0.404,0.409,0.019,1.852,97.47368421052633,376,1.114074074074074,1,0,0,1,FALSE,FALSE,FALSE
170,2021-11-13T01:38:56Z,1,1.6,900,6,3,2,3,3,3,3,3,3,4,2,4,5,2,2,3,4,3,5,1,1,4,5,4,4,2,2,0,0,5,3,3,4,5,5,5,5,4,1,5,2,4,4,2,5,4,4,5,5,4,1,1,1,1,1,1,1,2,1,1,4,3,2,1,3,2,2,2,1,1,3.375,0,1.5,0,3.2,0,1.6666666666666667,0,2.9166666666666665,0,1.5,0,1.5714285714285714,0,2,0,2.108108108108108,0,1,0,0,0.7665482280246152,0.8739344216962085,-0.3773458880470143,0.2482942668245971,5,1,3,1,1,1,1,1.2857142857142858,0,1,-0.7321841937363471,4,4,5,4,2,2,3,3.4285714285714284,0,2.5714285714285716,-0.4571894270818581,0,3,3,3,4,3,3,5,2,2,4,2,4,2,5,5,2,3,3,5,2,3.2,0,3.4,0,4.4,0,4.4,0,4.066666666666666,0,3,1,2,2,3,2,4,3,1,4,1,2,3,4,2,2,2,3,4,2,2.6,0,"White, Caucasian, Anglo, European American",0,22,1,2,NA,5,2,0,0,0,0,0,TRUE,TRUE,TRUE,TRUE,TRUE,0,6,0.6348116279119669,0.86,0.021316455027779346,6,0.42823125000670553,0.4800531250089407,1,1,0.0013409964114432472,0.0021678909567167865,6,0.5410451613049353,0.6488096774239694,1,0.96875,0.004289578559008405,0.006798084153396679,1.1948,1.6504,0.4007,0.8456,1.7695,0.5045,0.2071,1.226509838,1.3154680673333334,0.3928119016666667,9.9916,15.7855,0.1118,12.9819,0.0952,-114.0286,0.733,8.5558,0.3853,9.25,0.4436,0.9979,1.541410931,5.3551212,6.608440816666667,0.34271578166666666,0.31908591633333333,0.7014,5.3291,0.4818,3.8403,0.5735,0.9977,0.082,0.39,0.535,0.014,1.745,124.64285714285715,474,1.4044444444444446,1,0,0,1,FALSE,FALSE,FALSE
171,2021-11-13T01:46:41Z,1,1.7777777777777777,864,6,3,3,3,2,3,2,2,3,2,2,2,2,3,2,3,3,3,2,2,1,3,2,2,3,1,2,0,0,4,2,4,4,4,4,4,4,4,1,4,1,1,4,1,4,2,2,3,2,2,4,1,5,1,2,2,1,2,1,1,3,3,2,1,1,1,2,2,2,1,2.25,0,1.75,0,2.466666666666667,0,2.2222222222222223,0,1.75,0,2,0,1.7142857142857142,0,1,0,1.8918918918918919,0,1,0,0,-0.0676996195877562,-0.01760031650865043,-0.2989446853297732,-0.1582725009192118,4,1,3,1,1,1,1,1.4285714285714286,0,1,-0.6467170085812028,3,3,3,3,1,1,3,2.4285714285714284,0,3.5714285714285716,0.10757398284279028,0,2,4,2,3,2,2,3,2,2,3,3,4,3,2,3,3,4,2,3,3,2.6,0,3.8,0,3,0,3.2,0,3.3333333333333335,0,1,1,1,3,1,1,1,3,1,2,2,3,1,2,1,3,1,2,1,2,1.45,0,"White, Caucasian, Anglo, European American",0,27,1,3,NA,5,2,0,0,0,0,0,TRUE,TRUE,TRUE,TRUE,TRUE,0,2,0.8794285714285714,0.7,0.05786229591836735,2,0.6719032258064516,0.686741935483871,1,1,0.056885490322580654,0.014822064516129031,2,0.698875,0.815516129032258,1,0.96875,0.009014887096774196,0.00668195060483871,1.3124,0.6772,0.5183,1.1625,0.4992,0.596,0.0676,1.3625083766666666,0.7761414744666667,0.5092992923333334,3.0904,3.4501,0.224,4.322,0.3292,-31.7234,1.1334,2.7693,0.4439,2.8685,0.5182,0.8742,2.2223275866666667,3.536113333333333,3.03899226,0.370093282,0.29448466766666664,0.5909,3.5415,0.6554,5.7205,0.769,0.8016,0.234,0.373,0.736,0.009,1.466,162.88888888888889,409,1.211851851851852,1,0,0,1,FALSE,FALSE,FALSE
172,2021-11-13T01:17:21Z,1,1.6,800,4,3,3,5,5,4,4,3,2,2,2,2,3,4,1,3,2,4,3,5,2,2,2,3,3,0,2,2,3,3,4,5,5,3,3,2,4,3,3,4,1,2,5,2,5,2,1,1,3,3,3,2,1,1,2,1,2,3,1,1,5,1,1,2,3,1,2,2,2,1,3,0,1.75,0,2.7333333333333334,0,2.4444444444444446,0,1.8333333333333333,0,1.5,0,1.2857142857142858,0,2,0,1.8918918918918919,0,0,2,3,0.3988067334851569,0.4193107472473732,0.4405781967573001,0.42994447200233665,4,2,5,1,1,2,1,1.4285714285714286,0,1,-0.6467170085812028,4,4,4,4,2,2,1,3.5714285714285716,0,2.4285714285714284,-0.7395711320441822,0,3,3,2,2,2,2,5,1,1,1,1,4,1,5,5,1,4,1,5,1,2.4,0,4.4,0,4.2,0,5,0,4.533333333333333,0,1,2,3,3,3,2,4,3,2,2,4,3,2,2,1,3,2,3,2,2,2.25,0,"Asian or Asian American (e.g., Chinese, Japanese, and others) & White, Caucasian, Anglo, European American",1,20,1,2,NA,5,2,1,1,1,0,2,TRUE,TRUE,TRUE,TRUE,TRUE,0,6,1.0423204545405778,0.88,0.10529103774974533,6,0.4624777777857251,0.5163896551872121,0.8709677419354839,0.90625,0.004929835978674469,0.007165697419988492,6,0.6500624999888241,0.7762000000035322,1,0.8709677419354839,0.008073775323560527,0.013753671979773695,1.6111,1.261,0.5715,1.4824,1.46,0.6358,0.4651,1.5901181533333333,1.128268753,0.5631223253333333,0.9652,2.1778,0.295,2.5264,0.3484,-43.0573,0.6673,2.9412,0.3825,5.4019,0.4457,0.9853,1.0443720043333333,2.800273193333333,2.57637575,0.342636388,0.290103185,0.9861,3.7201,0.5283,2.3917,0.6179,0.9063,0.072,0.471,0.401,0.009,1.677,186.33333333333334,387,1.1466666666666667,1,0,0,1,FALSE,FALSE,FALSE
173,2021-11-13T01:38:14Z,0.8999999761581421,1.6,900,6,3,4,4,1,4,1,1,4,1,1,1,1,5,1,4,3,1,2,1,1,1,1,1,1,0,2,0,0,4,2,3,4,2,5,3,3,3,1,5,1,1,4,1,5,1,1,1,1,1,4,1,1,1,2,1,1,1,1,1,5,2,1,1,1,1,1,1,1,1,1.125,0,1,0,1.4666666666666666,0,2.7777777777777777,0,1.0833333333333333,0,1.1666666666666667,0,1,0,1,0,1.5405405405405406,0,0,0,0,-0.9860026659520043,-1.0818088114128326,-0.7372407672780129,-0.9095247893454228,5,1,3,1,1,2,1,1.4285714285714286,0,1,-0.6467170085812028,4,4,5,4,1,1,1,3.4285714285714284,0,2.5714285714285716,0.38995568780511447,0,2,2,2,2,2,2,3,2,1,1,1,4,2,3,4,1,3,2,3,3,2,0,4,0,3.2,0,3.8,0,3.6666666666666665,0,1,1,1,3,1,1,1,4,1,1,1,4,1,1,1,4,1,1,1,1,1.05,0,"White, Caucasian, Anglo, European American",0,25,1,2,NA,5,2,0,0,0,0,0,TRUE,TRUE,TRUE,TRUE,TRUE,0,NA,NA,NA,NA,4,0.44187096774192797,0.5146999999999845,1,0.967741935483871,0.0029858494623658644,0.008129361290322419,4,0.6451874999999996,0.8263124999999972,1,1,0.023220092741935528,0.06683370564516204,NA,NA,NA,NA,NA,NA,NA,NA,NA,NA,1.8225,5.921,0.288,3.6045,0.2723,-67.112,0.6167,5.1457,0.3869,4.166,0.459,0.9401,1.65038578,3.4727316,5.3271436733333335,0.2837382666666667,0.29004580333333335,1.5099,4.8612,0.4662,2.2804,0.4977,0.8944,0.091,0.386,0.324,0.013,1.685,129.6153846153846,436,1.2918518518518518,1,0,0,1,FALSE,FALSE,FALSE
174,2021-11-13T01:50:39Z,1,1.6,900,4,4,5,5,2,5,1,1,5,1,1,1,1,5,2,5,3,1,1,1,1,1,1,1,1,1,2,0,0,5,5,2,5,5,5,5,5,5,1,5,1,1,3,1,5,1,1,1,3,4,5,1,1,1,1,1,1,1,5,1,5,1,1,1,1,1,1,1,1,2,1,0,1.25,0,1.2666666666666666,0,1.3333333333333333,0,1.5833333333333333,0,0.8333333333333334,0,1.4285714285714286,0,1,0,1.3783783783783783,0,1,0,0,-1.1646199632997414,-1.2911660623885257,-0.4557470907642554,-0.8734565765763905,5,1,3,1,1,1,1,1.2857142857142858,0,1,-0.7321841937363471,5,5,5,5,5,5,1,5,0,1,-0.7395711320441822,0,4,4,4,3,4,2,4,1,2,3,1,4,1,4,4,1,5,2,2,2,3.8,0,4.4,0,3.8,0,4.2,0,4.133333333333334,0,2,4,1,1,4,1,2,2,3,4,3,3,3,3,1,2,1,3,3,3,2.65,0,"White, Caucasian, Anglo, European American",0,21,1,2,NA,5,2,0,0,1,0,0,TRUE,TRUE,TRUE,TRUE,TRUE,0,2,0.6263866666654746,0.6122448979591837,0.01607146540847145,2,0.3946068965504909,0.5155233333339294,0.9666666666666667,0.9375,0.002748907172302382,0.013489510957846377,2,0.5868687500003725,0.7297500000006208,1,0.7741935483870968,0.009642124153257343,0.025413815612422348,0.9362,0.5032,0.4333,0.7884,0.2776,0.495,0.1875,1.0042572806666668,0.7240097306666666,0.425936712,1.2559,3.7745,0.235,2.6997,0.3021,-51.5712,1.0569,6.5989,0.3167,4.4686,0.3801,0.837,1.33033491,2.9122901933333334,4.025491746666667,0.298176347,0.232770105,1.0557,4.2022,0.4679,1.8899,0.5025,0.8511,0.068,0.407,0.408,0.009,1.779,197.66666666666669,376,1.114074074074074,1,0,0,1,FALSE,FALSE,FALSE
176,2021-11-13T01:49:13Z,1,1.6,900,4,4,3,4,2,4,2,2,4,2,2,2,2,4,2,3,3,1,2,1,1,1,1,3,1,0,2,0,0,4,3,4,4,4,4,4,4,5,1,4,2,1,4,2,5,3,2,1,1,1,3,1,1,1,1,1,1,1,1,1,4,2,2,1,1,1,1,1,1,1,1.375,0,1,0,2.2,0,2,0,1.5833333333333333,0,1.1666666666666667,0,1.2857142857142858,0,1,0,1.5675675675675675,0,0,0,0,-0.8136895085106579,-0.6476078738830316,-0.7372407672780129,-0.6924243205805223,5,1,4,1,1,1,1,1.1428571428571428,0,1.5,-0.6331575415043005,5,5,5,5,3,3,1,4.428571428571429,0,1.5714285714285714,-1.3043345419688306,0,2,2,2,3,2,2,4,2,2,3,1,3,3,4,4,2,4,2,4,2,2.2,0,4,0,3.6,0,4,0,3.8666666666666667,0,1,1,1,3,1,1,1,3,1,1,2,3,1,1,1,3,1,1,1,1,1.25,0,"White, Caucasian, Anglo, European American",0,21,1,2,NA,5,2,0,0,1,0,0,TRUE,TRUE,TRUE,TRUE,TRUE,0,2,0.6681424999937415,0.8,0.02056705748561951,2,0.5056687499973923,0.6218531249947846,1,1,0.004000275120042123,0.005678926440877102,2,0.5954312500059604,0.6905124999955297,1,1,0.005516413185036105,0.007539125645386365,1.1966,1.2836,0.4023,0.961,1.2502,0.4811,0.0636,1.243813134,1.1397782116666666,0.3948969253333333,2.1521,6.2992,0.3348,6.0336,0.4435,-88.2227,1.0298,4.4914,0.3988,4.2672,0.5058,0.966,1.8184904233333334,5.01628274,5.43500419,0.4462609986666667,0.341747087,0.8984,3.3408,0.4888,3.2563,0.5763,0.9536,0.171,0.33,0.662,0.011,1.377,125.18181818181819,438,1.2977777777777777,1,0,0,1,FALSE,FALSE,FALSE
180,2021-11-13T01:47:16Z,1,1.6,900,3,2,3,4,3,3,3,1,3,1,1,1,1,2,1,1,1,2,1,1,1,1,1,1,1,0,2,0,0,5,5,3,5,5,5,5,5,5,1,5,1,1,5,1,5,1,1,1,1,1,5,1,1,1,1,1,1,1,1,1,5,1,1,1,1,1,1,1,1,1,1.125,0,1,0,2.466666666666667,0,1.2222222222222223,0,1,0,0.8333333333333334,0,0.8571428571428571,0,1,0,1.054054054054054,0,0,0,0,-1.2886013814587587,-0.8611271044204237,-0.7372407672780129,-0.7991839358492183,3,2,2,2,1,4,1,2.4285714285714284,0,1,-0.048446712495193056,5,5,5,5,3,3,2,4.285714285714286,0,1.7142857142857142,1.5194825076544112,0,2,3,2,4,2,1,5,3,1,3,1,4,5,3,5,4,3,3,3,3,2.6,0,4,0,2.8,0,3.8,0,3.533333333333333,0,3,3,3,3,3,3,3,3,2,1,4,2,1,3,3,3,3,3,3,3,2.65,0,"Asian or Asian American (e.g., Chinese, Japanese, and others)",0,19,1,2,NA,5,2,0,0,0,0,0,TRUE,TRUE,TRUE,TRUE,TRUE,0,NA,NA,NA,NA,5,0.6456483870967734,0.8034966666666713,1,1,0.021932291247308597,0.028848581022992707,5,1.1086066666666652,1.3220677419355018,1,1,0.28486076064368604,0.44179980625804166,NA,NA,NA,NA,NA,NA,NA,NA,NA,NA,4.1343,4.3174,0.1668,4.4584,0.3398,-31.3506,1.0907,2.6765,0.4879,3.5835,0.6559,0.9811,2.3320535533333335,3.2692443066666668,3.3877594066666665,0.44275014566666665,0.292755875,2.2183,1.6219,0.4506,1.4085,0.5453,0.9164,0.223,0.141,0.24,0.014,1.938,138.42857142857142,348,1.031111111111111,1,0,0,1,FALSE,FALSE,FALSE
181,2021-11-13T01:40:06Z,1,1.6,900,7,2,3,4,3,3,5,1,4,1,2,1,2,3,3,3,3,3,4,4,1,2,3,3,2,3,2,1,1,4,3,4,3,3,5,4,4,4,3,4,3,1,3,2,5,5,4,5,5,5,1,1,5,1,3,2,1,2,2,1,3,3,3,1,1,2,1,2,2,1,2.75,0,1.5,0,2.466666666666667,0,2.2222222222222223,0,3.25,0,2.6666666666666665,0,2,0,1.3333333333333333,0,2.5675675675675675,0,2,1,1,0.6635806095535669,0.487644644237128,0.20882944024170652,0.34823704223941726,5,1,4,1,1,1,1,1.1428571428571428,0,3,-0.07967602934272733,5,5,5,5,2,1,1,4,0,2,0.6723373927674386,0,4,4,3,3,3,2,4,3,3,3,2,4,3,3,4,3,3,1,3,4,3.4,0,4,0,3.2,0,3,0,3.4,0,2,1,2,4,3,2,4,2,1,1,2,2,3,1,1,2,2,2,1,4,2.1,0,"White, Caucasian, Anglo, European American",0,28,1,2,NA,5,2,0,0,1,0,0,TRUE,TRUE,TRUE,TRUE,TRUE,0,5,1.114410869565185,0.92,0.08661973546539325,5,0.5240750000000698,0.5969933333331098,1,0.9375,0.004434135483824624,0.003499232862944885,5,0.6883249999994878,0.7616687500003027,1,1,0.0053695045161447534,0.004019404798359218,1.8229,1.4714,0.6043,1.3586,1.5713,0.7845,0.3555,1.7027776166666666,1.236027473,0.6015038646666667,1.1209,4.3752,0.396,3.7964,0.4624,-78.9796,0.7734,5.0484,0.4522,5.4502,0.524,0.9926,1.3281122076666667,3.94048724,4.73963975,0.443819094,0.38501695333333336,0.7764,3.5827,0.6024,4.9546,0.6847,0.9909,0.178,0.445,0.761,0.012,1.367,113.91666666666666,434,1.285925925925926,1,0,0,1,FALSE,FALSE,FALSE
182,2021-11-13T01:42:04Z,0.8999999761581421,1.6,900,5,2,3,4,3,4,4,3,2,4,3,3,3,3,2,3,3,3,4,5,3,1,3,3,2,6,1,1,5,5,2,3,4,4,5,3,5,4,4,4,2,3,3,3,5,3,3,3,2,4,1,5,4,1,3,2,5,5,1,1,4,3,3,1,1,2,2,3,3,1,3,0,2.25,0,3,0,2.111111111111111,0,2.75,0,3.1666666666666665,0,2.7142857142857144,0,1.3333333333333333,0,2.5945945945945947,0,3,1,5,0.8358937669949132,0.8358958643067274,1.3529241097866693,1.0944099870466983,5,1,5,1,1,2,1,1.1428571428571428,0,1.5,-0.6331575415043005,5,5,5,5,4,4,1,4.714285714285714,0,1.2857142857142858,-1.0219528370065065,0,1,1,1,3,2,2,5,2,1,2,2,3,2,4,5,1,5,2,4,3,1.6,0,4,0,4,0,4.2,0,4.066666666666666,0,1,2,1,2,3,2,3,3,1,1,3,3,2,2,2,3,1,2,2,2,1.95,0,"White, Caucasian, Anglo, European American",0,21,1,2,NA,5,2,0,0,0,0,0,TRUE,TRUE,TRUE,TRUE,TRUE,0,1,0.6913027777738041,0.72,0.027330334701464655,1,0.4665656250417233,0.5497096773962821,1,0.96875,0.0016238932966311133,0.004131696776416996,1,0.7097749999836087,0.8333166666507721,1,0.9375,0.006311644519133184,0.019114304149505094,1.222,0.8283,0.408,0.7515,0.8543,0.5959,0.3419,1.2731688266666668,0.8747496753333334,0.4011152083333333,1.586,6.6839,0.3479,4.289,0.3721,-87.6548,0.7435,6.011,0.4084,5.1269,0.4786,0.9617,1.5558793066666667,4.0995489166666665,5.994727753333334,0.36884598533333335,0.342323534,1.0181,4.5213,0.5998,2.6408,0.6644,0.9046,0.071,0.548,0.431,0.013,1.661,127.76923076923077,104,0.3081481481481481,1,0,0,1,FALSE,FALSE,FALSE
183,2021-11-13T01:39:50Z,1,1.6,800,5,2,2,4,1,4,2,1,5,1,2,1,1,5,4,4,3,1,3,5,1,2,2,2,1,3,2,0,1,5,3,1,5,5,5,5,5,5,2,5,1,1,3,4,4,3,2,3,3,2,2,1,1,1,3,2,2,1,2,1,4,2,1,1,1,1,2,3,1,2,2.125,0,2,0,1.8666666666666667,0,1.6666666666666667,0,2.25,0,1.8333333333333333,0,1.4285714285714286,0,1,0,1.837837837837838,0,2,0,1,-0.1790727579339924,-0.3523976956695021,0.15899863808316506,-0.09669952879316851,4,1,3,1,1,1,1,1.4285714285714286,0,1,-0.6467170085812028,5,5,5,5,3,3,2,4.285714285714286,0,1.7142857142857142,-0.4571894270818581,0,2,5,3,4,4,3,4,5,4,4,1,4,3,3,1,5,3,1,3,2,3.6,0,4,0,3,0,2.2,0,3.066666666666667,0,2,1,1,3,2,1,2,2,1,2,2,2,1,1,1,2,1,1,1,2,1.65,0,"White, Caucasian, Anglo, European American",0,21,1,2,NA,5,2,0,0,0,0,0,TRUE,TRUE,TRUE,TRUE,TRUE,0,2,1.0574736842230748,0.76,0.1159144036526479,2,0.5182290322549882,0.5944156250059605,0.96875,1,0.013054311766039344,0.005167915554828913,2,0.6199645161128813,0.7486290322465281,0.96875,0.96875,0.009423737417432262,0.013856429513022612,1.5758,0.7615,0.5164,1.4607,0.7711,0.5869,0.1412,1.5837508933333333,0.804719835,0.5077122246666667,1.3568,3.1443,0.3108,4.6774,0.4494,-65.71,1.1246,3.5813,0.3542,4.6647,0.4754,0.9616,1.5133000363333333,4.64301572,3.450221796666667,0.43535966766666667,0.299791086,1.0032,3.2657,0.488,3.2212,0.6171,0.9551,0.342,0.121,0.691,0.012,1.783,148.58333333333331,378,1.12,1,0,0,1,FALSE,FALSE,FALSE
184,2021-11-13T01:48:30Z,1,1.6,900,6,3,3,5,4,3,3,3,3,4,4,3,4,3,3,3,3,2,2,1,1,2,3,3,3,1,2,0,0,4,2,4,4,3,3,4,4,2,3,5,2,1,3,2,5,3,1,1,1,2,4,1,1,1,3,1,1,2,1,1,4,2,3,1,2,2,2,1,1,1,2.125,0,1.25,0,3.1333333333333333,0,2.6666666666666665,0,1.75,0,1.3333333333333333,0,1.5714285714285714,0,1.6666666666666667,0,1.9189189189189189,0,1,0,0,-0.12863963868286635,0.22679499496320607,-0.4557470907642554,-0.11447604790052467,4,2,2,2,1,3,1,2.142857142857143,0,1,-0.21938108280548152,5,5,5,5,3,3,1,4.428571428571429,0,1.5714285714285714,-1.3043345419688306,0,1,3,2,3,3,2,3,2,2,3,2,3,2,4,5,4,4,2,3,3,2.4,0,3.8,0,3,0,4,0,3.6,0,2,1,3,1,2,3,4,2,1,2,3,2,4,3,2,2,1,4,3,3,2.7,0,"White, Caucasian, Anglo, European American",0,22,1,2,NA,5,2,0,0,0,0,0,TRUE,TRUE,TRUE,TRUE,TRUE,0,6,0.8466153846161488,0.78,0.08406272392156584,6,0.45199687500158325,0.5267689655166248,1,0.9354838709677419,0.00718073644141256,0.004871731828062409,6,0.5854999999995344,0.6496066666682562,1,0.9375,0.008366613548502096,0.006762336764138204,1.6054,0.8659,0.3391,1.3142,1.1054,0.48,0.2925,1.5824846133333332,0.8723468686666667,0.3378238903333333,1.0896,3.9986,0.3157,3.4947,0.3845,-71.8907,0.9317,4.8496,0.3535,5.2312,0.4318,0.9927,1.223377397,3.67397374,4.322404523333334,0.37388882333333334,0.30833915866666667,0.8149,3.1772,0.4926,4.6945,0.5601,0.9931,0.073,0.384,0.41,0.015,1.92,128,440,1.3037037037037038,1,0,0,1,FALSE,FALSE,FALSE
185,2021-11-13T01:43:58Z,1,1.7777777777777777,1080,2,1,4,4,2,4,3,2,5,1,1,1,1,5,3,5,2,1,2,1,1,1,1,1,1,1,2,4,4,4,4,5,3,4,5,5,5,5,1,5,1,1,4,2,5,1,3,1,1,1,1,3,5,1,4,1,1,2,2,1,5,1,2,1,1,1,2,2,2,2,1.125,0,2,0,1.8,0,1.5555555555555556,0,1.3333333333333333,0,3,0,1.2857142857142858,0,1,0,1.6756756756756757,0,1,4,4,-0.9019474672001281,-0.8804851488934421,1.3117879353562858,0.21565139323142185,5,1,2,1,1,2,1,1.5714285714285714,0,1,-0.5612498234260587,5,5,4,5,2,3,1,4.142857142857143,0,1.8571428571428572,0.9547190977297628,0,1,2,2,2,2,2,4,1,1,3,3,4,2,3,5,5,4,1,3,2,1.8,0,4,0,3,0,4.4,0,3.8,0,2,2,4,1,3,4,4,2,4,3,3,2,3,3,1,2,2,4,2,3,3,0,"White, Caucasian, Anglo, European American",0,29,1,2,NA,5,2,0,0,0,0,0,TRUE,TRUE,TRUE,TRUE,TRUE,0,3,1.1721264705859562,0.68,0.26462373169253234,3,0.5074624999994412,0.6758218749985099,1,1,0.01060449661244984,0.02311444886139153,3,0.7252870967734245,0.752296875,1,1,0.022792641827507783,0.018461948054335268,1.7099,0.4468,0.4983,1.1409,0.5405,0.8035,0.8522,1.6852035066666666,0.5561006527,0.49389648633333333,2.3442,4.7685,0.2617,3.7797,0.3657,-51.835,1.1091,4.6003,0.3883,2.1788,0.475,0.9105,1.9759393266666667,3.44203247,4.35735427,0.38584139166666664,0.279696667,1.0559,3.4743,0.5885,2.7397,0.5888,0.8402,0.234,0.247,0.491,0.094,1.345,14.308510638297872,474,1.4044444444444446,1,0,0,1,FALSE,FALSE,FALSE
186,2021-11-13T01:54:39Z,0.8999999761581421,1.6,900,4,3,2,4,4,3,4,4,2,4,3,3,5,2,1,2,1,3,4,1,1,4,4,4,4,3,2,0,0,3,1,4,2,3,5,3,3,1,1,4,4,1,3,4,2,4,4,5,5,4,2,1,1,1,2,1,1,2,1,1,3,2,2,1,1,2,2,2,2,1,3.125,0,1.75,0,3.6,0,3.2222222222222223,0,3.4166666666666665,0,1.5,0,1.5714285714285714,0,1.3333333333333333,0,2.5945945945945947,0,2,0,0,0.9136448258403987,1.1474635900999572,-0.0958522115332568,0.5258056892833503,3,3,2,1,1,2,2,2.2857142857142856,0,1,-0.1339138976503373,2,2,1,1,2,2,3,1.8571428571428572,0,4.142857142857143,-0.7395711320441822,0,3,2,2,1,3,3,5,2,3,4,2,3,2,2,3,1,4,2,3,1,2.2,0,3.6,0,4.2,0,3.4,0,3.7333333333333334,0,3,2,4,1,4,4,4,2,3,3,3,1,2,4,2,1,4,4,4,4,3.45,0,"White, Caucasian, Anglo, European American",0,19,1,2,NA,5,2,0,0,1,0,0,TRUE,TRUE,TRUE,TRUE,TRUE,0,5,0.6606071428571428,0.84,0.039492183507739136,5,0.42516785713178773,0.4985629629779745,0.9032258064516129,0.84375,0.004419808365343355,0.009806623456074663,5,0.6109624999985099,0.6887760000085831,1,0.78125,0.012989825001648355,0.015055568225480587,1.312,1.3079,0.3188,1.2018,1.5388,0.3846,0.3075,1.3341933233333334,1.1543455836666667,0.31321414033333334,0.9159,2.9576,0.30620000000000003,1.8001,0.3076,-45.2267,0.7626,4.3048,0.3427,3.7324,0.3961,0.7401,0.9780720613333334,2.108079471,3.3127941566666665,0.3032393013333333,0.302200925,0.8853,3.4265,0.4854,2.1658,0.522,0.659,0.059,0.436,0.361,0.012,1.862,155.16666666666669,400,1.1851851851851851,1,1,0,1,FALSE,FALSE,FALSE
187,2021-11-13T01:20:27Z,1,1.7777777777777777,1080,6,2,4,5,4,5,2,3,3,2,1,1,2,3,1,3,5,1,2,1,1,1,2,2,3,1,2,0,0,5,4,5,5,5,5,5,5,5,1,5,1,1,5,1,5,1,1,2,1,5,4,1,1,1,1,1,1,1,1,1,5,1,1,1,1,1,1,1,1,1,1.625,0,1,0,2,0,1.1111111111111112,0,1.4166666666666667,0,1,0,0.8571428571428571,0,1,0,1.1891891891891893,0,1,0,0,-0.8935419473249401,-0.788728018091335,-0.5341482934814965,-0.6614381557864157,5,1,3,1,1,1,1,1.2857142857142858,0,1,-0.7321841937363471,5,5,5,5,2,2,2,4,0,2,-1.0219528370065065,0,3,3,3,1,2,4,5,4,3,2,1,3,1,3,2,1,5,3,3,2,2.4,0,3.6,0,4,0,2.8,0,3.466666666666667,0,1,3,2,2,2,3,2,3,1,1,2,2,3,3,2,1,1,3,4,3,2.4,0,"White, Caucasian, Anglo, European American",0,24,1,2,NA,5,2,1,0,0,0,1,TRUE,TRUE,TRUE,TRUE,TRUE,0,1,0.714758536585493,0.8367346938775511,0.037284732789256085,1,0.5003580645159368,0.5386566666662693,0.96875,0.967741935483871,0.0043832547983442,0.0027058998494650373,1,0.6100656249992317,0.7770806451612903,1,1,0.007064978457633246,0.012708054279620613,1.2863,1.3728,0.4016,0.9814,1.8294,0.5169,0.1793,1.31707512,1.1923630643333334,0.3948956223333333,1.1048,3.6276,0.3538,4.3629,0.4182,-75.6618,0.9082,5.2965,0.4159,5.5658,0.4584,0.9993,1.2608907783333334,4.42851888,3.9816722133333333,0.4064903366666667,0.3441485833333333,0.9664,4.2359,0.5105,3.222,0.6584,0.9849,0.366,0.139,0.78,0.01,1.78,178,301,0.8918518518518519,1,1,3,4,FALSE,FALSE,FALSE
188,2021-11-13T01:38:52Z,0.8999999761581421,1.6,900,6,4,2,5,5,4,1,2,2,4,2,3,4,1,4,1,3,3,4,1,1,3,5,3,4,1,3,0,0,3,4,1,3,3,4,5,5,2,2,4,5,1,3,2,3,2,5,5,5,3,3,1,1,1,1,1,1,1,2,1,4,1,2,1,1,4,1,4,1,2,3,0,2,0,3.2666666666666666,0,2.6666666666666665,0,3.1666666666666665,0,1.1666666666666667,0,1.2857142857142858,0,2,0,2.324324324324324,0,1,0,0,0.6677833694911609,0.8343472207488856,-0.22054348261253207,0.30690186906817674,5,1,4,1,2,2,1,1.4285714285714286,0,3.5,0.27575217835475235,5,5,5,5,5,4,1,4.857142857142857,0,1.1428571428571428,-0.4571894270818581,0,1,2,1,1,1,1,5,1,1,3,1,5,3,5,5,1,5,1,5,3,1.2,0,5,0,4.2,0,4.6,0,4.6,0,1,3,2,4,2,1,1,4,1,2,4,3,2,2,2,4,1,2,2,1,1.7,0,"White, Caucasian, Anglo, European American",0,25,1,2,NA,5,2,0,0,1,0,0,TRUE,TRUE,TRUE,TRUE,TRUE,0,3,0.9230294117647059,0.68,0.12626492897959185,3,0.4726774193548387,0.5599677419354838,0.96875,0.96875,0.004651902217741935,0.006248564516129031,3,0.61203125,0.67240625,1,1,0.006011773185483871,0.011285797379032257,1.5135,0.5174,0.4388,1.2694,0.4397,0.576,0.3255,1.52560674,0.6410749579333334,0.4332865043333333,1.2531,4.1162,0.3263,3.4206,0.3914,-66.7517,0.8188,6.7387,0.406,5.2319,0.4816,0.9426,1.383180444,3.6135938333333333,4.340574353333333,0.381696888,0.318239418,0.8498,6.5022,0.5464,3.7594,0.5716,0.9674,0.302,0.196,0.729,0.019,1.349,71,365,1.0814814814814815,1,0,0,1,FALSE,FALSE,FALSE
189,2021-11-13T01:42:01Z,1,1.7777777777777777,900,4,3,4,3,4,3,3,4,3,3,4,4,3,3,4,4,4,5,5,5,3,4,5,4,4,3,5,2,3,3,3,1,3,2,4,2,1,3,3,3,2,4,4,3,3,3,3,3,2,2,1,3,3,3,2,2,3,3,2,3,2,2,4,1,1,2,2,2,2,3,4.375,0,2.25,0,3.1333333333333333,0,3.5555555555555554,0,2.75,0,2.8333333333333335,0,2.857142857142857,0,1.3333333333333333,0,2.918918918918919,0,2,2,3,1.892887891299757,1.6234779036914775,1.003565549784815,1.3135217267381463,4,2,4,3,3,3,2,2.4285714285714284,0,2,0.32054096227918905,3,3,5,3,3,3,3,3.2857142857142856,0,2.7142857142857144,0.6723373927674386,0,3,2,2,3,2,3,3,2,2,3,3,3,2,3,4,4,3,3,4,4,2.4,0,3,0,3.2,0,3.4,0,3.2,0,3,2,3,3,3,1,1,2,2,1,3,2,4,4,4,2,4,4,4,3,2.85,0,"Asian or Asian American (e.g., Chinese, Japanese, and others) & Black or African American & White, Caucasian, Anglo, European American",1,22,1,2,NA,5,2,0,0,1,0,0,TRUE,TRUE,TRUE,TRUE,TRUE,0,1,1.1101878048036156,0.82,0.06763891896739545,1,0.8844962963528104,0.8967000000136239,0.9642857142857143,1,0.06250396961397443,0.03228045256139543,NA,NA,NA,NA,NA,NA,NA,1.5976,1.0363,0.6084,1.531,1.1224,0.661,0.3684,1.5923704566666668,0.9892273003333333,0.5985876476666667,2.2166,2.0594,0.3814,2.7467,0.4932,-3.2183,1.6205,1.6863,0.4827,3.0422,0.6394,0.945,2.3829252,2.7189592466666666,2.2083695666666667,0.4458821396666667,0.351223576,NA,NA,NA,NA,NA,NA,NA,NA,NA,NA,NA,NA,104,0.3081481481481481,1,0,1,2,FALSE,FALSE,FALSE
190,2021-11-13T01:48:03Z,1,1.7786458333333333,768,6,3,1,2,4,3,2,4,1,5,5,5,5,1,4,1,4,5,5,1,1,4,5,5,5,2,2,0,0,5,3,3,3,4,5,5,5,5,1,5,2,1,4,3,5,1,5,5,5,5,1,1,1,1,3,1,1,2,1,1,4,5,5,1,2,3,1,1,1,1,3.875,0,1,0,4.2,0,1.7777777777777777,0,2.6666666666666665,0,1.8333333333333333,0,2.2857142857142856,0,2,0,2.2432432432432434,0,1,0,0,1.161607662158434,1.5766314360667735,-0.5341482934814965,0.5212415712926385,5,1,3,1,1,1,1,1.2857142857142858,0,1,-0.7321841937363471,3,3,3,3,2,2,2,2.857142857142857,0,3.142857142857143,-0.4571894270818581,0,1,4,2,2,2,1,4,1,1,2,1,5,1,4,4,1,5,1,3,2,2.2,0,5,0,3.8,0,4.4,0,4.4,0,1,1,2,3,2,2,2,4,1,2,2,3,1,3,3,3,1,2,2,2,1.8,0,"White, Caucasian, Anglo, European American",0,30,1,2,NA,5,2,0,0,1,0,0,TRUE,TRUE,TRUE,TRUE,TRUE,0,1,0.7532567567438693,0.74,0.05621467478567786,1,0.49792187494039536,0.5918741935453107,1,1,0.005285276600858242,0.009081410643662587,1,0.7208656250238419,0.8589843750447035,1,1,0.012118911370970048,0.0243518923199385,1.3889,0.7858,0.3358,1.2173,0.8729,0.4256,0.4508,1.4154344366666667,0.839754043,0.33138931,3.2406,7.2845,0.2755,5.4818,0.2963,-74.2721,0.8752,5.2076,0.4156,4.2404,0.4908,0.9719,1.9267401366666668,4.028768393333333,5.559066203333333,0.35351397333333334,0.32820077366666667,1.1543,4.5438,0.6054,2.3406,0.6772,0.9424,0.243,0.274,0.541,0.013,1.758,135.23076923076923,384,1.1377777777777778,1,0,0,1,FALSE,FALSE,FALSE
191,2021-11-13T01:55:57Z,1,1.7777777777777777,720,4,4,2,3,4,3,5,3,3,4,4,3,5,2,2,2,1,4,4,1,1,4,4,4,4,0,2,0,0,2,2,4,3,2,3,3,5,2,4,5,3,3,2,4,3,5,5,5,5,5,1,2,1,1,2,2,2,1,1,1,4,3,3,1,1,4,2,5,1,2,3.25,0,2.5,0,3.7333333333333334,0,3.111111111111111,0,3.9166666666666665,0,2,0,1.7142857142857142,0,2,0,2.891891891891892,0,0,0,0,1.176317321940012,1.3862450686746384,-0.26683355097456624,0.559705758850036,5,1,4,1,1,3,1,1.4285714285714286,0,1.5,-0.4622231711940119,3,3,4,4,2,1,2,3,0,3,-0.7395711320441822,0,1,3,2,3,2,2,4,2,2,3,1,4,2,3,4,2,5,2,3,3,2.2,0,4.4,0,3.6,0,3.6,0,3.8666666666666667,0,2,3,3,1,4,4,3,1,2,2,4,1,2,2,2,1,1,3,3,4,3,0,"Asian or Asian American (e.g., Chinese, Japanese, and others) & White, Caucasian, Anglo, European American & Filipino",1,20,1,2,NA,5,2,0,0,1,0,0,TRUE,TRUE,TRUE,TRUE,TRUE,0,2,0.8908323529292556,0.68,0.039908661223789124,2,0.6231464285765376,0.6196357142754964,0.9333333333333333,0.9333333333333333,0.028196224412728246,0.018848447136457478,2,0.6973124999925494,0.8416862068957296,1,0.90625,0.025004186936662624,0.045677690958082884,1.3382,0.5948,0.496,0.8197,1.0221,0.7235,0.5396,1.3842930766666666,0.7170883539666667,0.487617928,0.9482,2.3839,0.4765,2.9243,0.4955,-46.6035,1.0643,3.0414,0.461,4.8639,0.4893,0.7434,1.145425322,3.143418736666667,2.78071126,0.47297665333333333,0.45321039366666666,1.3848,4.1857,0.5212,1.7264,0.5107,0.7123,0.102,0.326,0.266,0.012,2.07,172.49999999999997,412,1.2207407407407407,1,0,0,1,FALSE,FALSE,FALSE
192,2021-11-13T01:38:01Z,0.8999999761581421,1.7777777777777777,1152,3,2,4,3,2,3,3,1,3,3,3,1,1,3,3,3,4,2,1,1,1,1,1,1,2,2,2,0,0,5,1,3,4,3,5,3,3,2,2,4,4,2,3,3,4,5,3,3,3,3,4,1,1,1,1,1,1,2,2,1,3,4,3,1,3,1,2,3,2,3,1.25,0,2.5,0,2.4,0,2.7777777777777777,0,2.9166666666666665,0,1,0,2.142857142857143,0,1.6666666666666667,0,2.3783783783783785,0,1,0,0,-0.38710937484488595,-0.2669319293211263,-0.06374107717804986,-0.1653365032495881,5,1,2,3,1,2,2,2,0,1.5,-0.12035443057343476,4,3,4,3,1,1,3,2.7142857142857144,0,3.2857142857142856,0.10757398284279028,0,2,1,1,1,1,2,4,2,1,3,1,3,1,3,4,1,3,2,4,3,1.2,0,3.8,0,4.2,0,3.8,0,3.933333333333333,0,1,2,3,1,2,4,3,2,1,2,2,2,3,2,1,2,2,4,2,3,2.5,0,"White, Caucasian, Anglo, European American",0,29,1,2,NA,5,2,0,0,1,0,0,TRUE,TRUE,TRUE,TRUE,TRUE,0,2,0.8902181818160144,0.673469387755102,0.02717414410111965,2,0.4937343750037253,0.5550333333273729,1,0.9375,0.005567386199852311,0.004555585120226285,2,0.6619281250014901,0.713358064524589,1,0.96875,0.0036009743454934605,0.009121074344305166,1.0692,0.7105,0.624,0.9772,0.7579,0.6628,0.1281,1.143237352,0.8189751482333333,0.613662615,1.067,4.0306,0.3614,3.6385,0.4237,-75.7385,0.8754,4.7911,0.404,4.9237,0.4633,0.9923,1.233661338,3.816876913333333,4.40871885,0.4102968066666667,0.352205139,1.0248,5.6866,0.5775,3.2001,0.567,0.9969,0.06,0.531,0.459,0.024,1.388,57.83333333333333,340,1.0074074074074075,1,0,0,1,FALSE,FALSE,FALSE
193,2021-11-13T01:49:59Z,1,1.7777777777777777,1080,3,2,3,3,4,3,3,3,2,3,3,3,5,2,3,3,4,2,4,3,4,2,3,2,3,6,2,2,7,3,3,2,4,3,3,3,2,3,2,3,3,2,3,4,3,2,2,2,3,2,1,4,2,3,2,3,3,2,2,3,2,3,3,1,1,1,3,3,2,1,2.875,0,2.25,0,3.2666666666666666,0,3.111111111111111,0,2.5833333333333335,0,3,0,2.7142857142857144,0,1,0,2.72972972972973,0,3,2,6,0.8421979069013039,0.9548510475934248,1.7360069642788738,1.3454290059361493,3,3,2,5,3,3,3,3.4285714285714284,0,1.5,0.734317420978008,3,2,5,2,3,3,3,3,0,3,1.237100802692087,0,4,2,4,2,2,4,2,3,2,4,2,3,3,3,4,2,2,4,4,3,2.8,0,2.6,0,3.4,0,3.4,0,3.1333333333333333,0,2,2,3,2,3,2,3,3,2,2,3,3,2,2,1,3,2,1,3,3,2.25,0,"White, Caucasian, Anglo, European American",0,23,0,1,NA,5,2,0,0,1,0,0,TRUE,TRUE,TRUE,TRUE,TRUE,0,6,0.6630470588233541,0.6938775510204082,0.09336943443093303,6,0.45955862068821646,0.5132580645142063,0.9354838709677419,0.96875,0.005433158516224352,0.004907670160899071,6,0.5658624999979511,0.6227206896574333,1,0.90625,0.005934092742014197,0.006824598458047662,1.4343,0.6082,0.2148,1.1628,0.8574,0.3694,0.3241,1.44629647,0.7241041900333334,0.21435808366666667,0.9001,3.1813,0.33,4.0409,0.4061,-76.6387,0.8929,4.6561,0.3598,5.5535,0.4251,0.9378,1.0025699756666666,4.13208042,3.5751153766666666,0.3984507076666667,0.32342988166666664,0.891,3.7043,0.4653,4.2784,0.5218,0.9846,0.058,0.424,0.442,0.015,1.611,107.4,282,0.8355555555555556,1,0,0,1,FALSE,FALSE,FALSE
194,2021-11-13T01:44:33Z,1,1.7777777777777777,864,5,2,1,3,4,2,5,1,1,4,5,3,4,3,5,3,4,1,5,1,1,1,1,1,3,0,2,2,5,5,3,1,1,1,5,2,2,3,3,4,1,1,1,4,3,5,5,5,5,4,2,4,3,1,2,1,1,1,1,1,3,4,4,1,5,1,4,2,2,4,1.75,0,3,0,3.7333333333333334,0,3.4444444444444446,0,3.5833333333333335,0,2.3333333333333335,0,2,0,2.3333333333333335,0,3,0,0,2,5,0.3105487747956867,0.7880814944583723,1.1854835041418672,0.9867824993001197,5,1,3,1,1,1,1,1.2857142857142858,0,2,-0.3631965189619651,2,3,4,2,1,1,5,2,0,4,0.9547190977297628,0,1,1,1,1,1,1,5,1,1,3,1,5,1,4,5,1,5,1,4,3,1,0,5,0,4.4,0,4.4,0,4.6,0,3,2,1,3,3,2,3,3,1,1,4,2,1,2,3,2,1,1,2,1,2.05,0,"White, Caucasian, Anglo, European American",0,30,1,2,NA,5,2,0,0,2,0,0,TRUE,TRUE,TRUE,TRUE,TRUE,0,2,0.8790944444868299,0.72,0.09093996149259939,2,0.48342903232574463,0.5466166667620341,1,0.967741935483871,0.004195329462417479,0.0031597401429203807,2,0.6266500000059605,0.6826678571360452,1,0.9032258064516129,0.010472760635524256,0.006326637199381265,1.5079,0.6607,0.4128,1.2573,0.6022,0.5144,0.0043,1.51850288,0.7387608803333333,0.40792581866666666,1.6973,4.2348,0.283,4.7722,0.3794,-66.5149,0.8118,6.8007,0.4295,5.7297,0.4726,0.8382,1.6806416633333334,4.488467716666666,4.24475511,0.374547144,0.2832120716666667,0.7706,3.5131,0.5382,4.3728,0.6046,0.947,0.064,0.456,0.393,0.022,2.074,94.27272727272727,390,1.1555555555555557,1,0,1,2,FALSE,FALSE,FALSE
195,2021-11-13T01:52:57Z,0.800000011920929,1.6,800,6,3,4,5,2,5,1,1,4,2,2,1,1,4,1,5,5,1,1,1,1,1,1,1,1,3,2,0,0,5,5,5,5,5,5,4,5,5,1,5,1,1,5,1,5,1,1,1,1,1,5,1,1,1,1,1,1,2,1,1,5,1,1,1,1,1,2,1,2,1,1,0,1.5,0,1.4,0,1.1111111111111112,0,1,0,0.8333333333333334,0,1,0,1,0,1.054054054054054,0,2,0,0,-1.3663524403042442,-1.3732441709541232,-0.17425341425049792,-0.7737487926023106,5,1,4,1,1,1,1,1.1428571428571428,0,1,-0.8176513788914915,5,5,5,5,4,4,1,4.714285714285714,0,1.2857142857142858,-1.3043345419688306,0,2,2,3,3,3,2,5,1,1,4,1,4,1,5,5,1,5,2,5,3,2.6,0,4.4,0,4.8,0,4.6,0,4.6,0,1,1,1,4,2,1,1,3,1,1,1,4,1,3,1,3,1,2,1,1,1.3,0,"White, Caucasian, Anglo, European American",0,24,1,2,NA,5,2,0,0,1,0,0,TRUE,TRUE,TRUE,TRUE,TRUE,0,6,0.8334749999999942,0.8163265306122449,0.03580899659863852,6,0.4980624999999996,0.5579999999999985,1,0.9375,0.0240664475806454,0.015171628024194625,6,0.6905,0.8135625000000036,1,1,0.01021432258064464,0.017966254032255883,1.3199,1.2363,0.5029,0.9564,1.4671,0.6297,0.2404,1.3547979833333332,1.108122763,0.49410536866666666,1.1959,3.3837,0.3213,2.5335,0.3492,-48.1337,1.2024,4.0339,0.3335,3.0056,0.3632,0.9846,1.318673104,2.7882909633333335,3.67197477,0.3401481593333333,0.312337433,1.3439,3.4136,0.5063,3.4715,0.6176,0.9924,0.309,0.255,0.714,0.013,1.576,121.23076923076924,340,1.0074074074074075,1,0,0,1,FALSE,FALSE,FALSE
196,2021-11-13T01:54:13Z,1,1.6,900,7,3,2,4,2,3,2,2,3,2,2,2,4,3,2,3,3,2,4,1,1,3,4,4,4,1,2,0,0,3,2,3,3,3,4,3,3,3,2,4,2,1,4,2,3,2,3,4,4,4,3,2,1,1,3,3,1,1,1,1,3,3,2,2,3,3,2,2,3,2,2.875,0,2.25,0,2.6,0,3,0,2.5833333333333335,0,2,0,1.5714285714285714,0,2.6666666666666665,0,2.4594594594594597,0,1,0,0,0.6740875093975516,0.5522037225546441,-0.14214227989529096,0.2050307213296766,3,2,3,2,2,3,3,2.5714285714285716,0,2,0.4060081474343336,4,4,4,4,2,2,3,3.2857142857142856,0,2.7142857142857144,0.9547190977297628,0,2,3,2,3,2,2,4,3,2,3,2,4,3,4,3,2,4,3,3,2,2.4,0,3.8,0,3.4,0,3.6,0,3.6,0,2,2,3,2,3,3,3,2,1,2,3,2,2,3,1,2,2,3,2,3,2.5,0,"White, Caucasian, Anglo, European American",0,24,1,2,NA,5,2,0,0,2,0,0,TRUE,TRUE,TRUE,TRUE,TRUE,0,3,0.7261093023211457,0.86,0.04820107789388694,3,0.4760032258110662,0.5320548387150611,1,0.96875,0.0015459069887292765,0.004025808135005669,3,0.5367406249903143,0.6184406249970198,1,1,0.008112736037606313,0.008756640554518486,1.28,1.4925,0.4369,1.0139,1.5231,0.5207,0.1833,1.30669991,1.2619030183333333,0.42920188233333334,1.4575,6.799,0.3688,4.4119,0.3734,-91.377,0.8492,7.8139,0.4269,5.1937,0.4529,0.8307,1.4440560596666667,4.2197873066666665,6.046455563333334,0.369921352,0.362398322,1.0394,5.4806,0.4403,5.2815,0.533,0.7907,0.156,0.25,0.532,0.023,1.924,83.65217391304348,422,1.2503703703703704,1,0,0,1,FALSE,FALSE,FALSE
197,2021-11-13T01:44:25Z,1,1.7786458333333333,768,6,3,4,4,3,4,4,2,4,2,3,2,2,4,2,4,4,3,2,1,1,2,2,2,3,4,2,0,0,5,3,4,5,3,4,4,4,3,2,4,2,2,3,2,3,2,2,2,3,3,4,1,1,1,3,3,1,3,3,1,4,3,3,1,2,4,2,2,3,2,2,0,2.25,0,2.2666666666666666,0,2.111111111111111,0,2.3333333333333335,0,1.6666666666666667,0,2.142857142857143,0,2.3333333333333335,0,2.189189189189189,0,2,0,0,-0.038280300024599465,-0.08322408727218257,0.06095019390122543,-0.011136946685478571,4,2,4,1,1,2,4,2,0,2,0.06413940681375631,5,5,5,5,3,3,3,4.142857142857143,0,1.8571428571428572,-1.0219528370065065,0,3,3,3,4,3,3,5,2,2,3,2,4,3,4,4,2,4,2,4,3,3.2,0,3.8,0,3.8,0,3.8,0,3.8,0,2,3,3,2,3,3,3,2,3,3,3,2,2,3,1,2,2,3,3,3,2.75,0,"Asian or Asian American (e.g., Chinese, Japanese, and others)",0,23,1,2,NA,5,2,0,0,1,0,0,TRUE,TRUE,TRUE,TRUE,TRUE,0,1,0.8546966666668654,0.6122448979591837,0.13717008278029663,1,0.487328125,0.5693937499998137,1,1,0.003701799506120183,0.004076594798216989,1,0.6305531249986962,0.697612500000745,1,1,0.017164578699637566,0.01305663467768056,1.4399,0.3268,0.4175,1.2266,0.1827,0.5174,0.2277,1.4612274533333334,0.5119359851083334,0.411904269,6.0011,10.1333,0.1912,8.5676,0.2192,-89.9779,0.7688,6.3518,0.4224,5.9873,0.5103,0.995,1.91897502,4.55610079,6.08520252,0.3632685253333333,0.33492996433333333,1.1985,3.5867,0.4668,5.1562,0.5825,0.9911,0.262,0.152,0.559,0.01,1.206,120.6,342,1.0133333333333332,1,0,0,1,FALSE,FALSE,FALSE
198,2021-11-13T01:51:31Z,1,1.7777777777777777,864,4,3,2,3,4,3,4,3,2,4,3,3,5,3,2,3,4,3,5,2,3,3,4,4,3,0,2,0,0,4,4,4,5,4,5,5,5,5,2,4,4,1,3,3,4,2,3,5,5,4,4,1,1,1,2,1,1,1,1,1,5,5,1,1,3,1,2,1,1,1,3.375,0,1.25,0,3.3333333333333335,0,1.4444444444444444,0,3,0,1.1666666666666667,0,1.4285714285714286,0,1.6666666666666667,0,1.972972972972973,0,0,0,0,0.6824930292727389,0.8731600999172876,-0.6588395645607719,0.10716026767825787,3,2,3,2,2,4,3,2.7142857142857144,0,2.5,0.6759691699766689,4,4,4,2,2,4,4,3.142857142857143,0,2.857142857142857,-0.4571894270818581,0,4,3,5,5,5,4,5,3,4,3,2,3,4,3,4,5,3,2,5,4,4.4,0,3.2,0,3.2,0,2.8,0,3.066666666666667,0,2,1,4,1,3,4,3,1,4,2,4,2,3,4,2,3,4,4,4,4,3.25,0,"White, Caucasian, Anglo, European American",0,22,1,2,NA,5,2,0,0,0,0,0,TRUE,TRUE,TRUE,TRUE,TRUE,0,5,0.8383410256436238,0.7959183673469388,0.03368038427762738,5,0.4666906249988824,0.548818750004284,1,1,0.00795127765074647,0.005592649959870334,5,0.5593468750016763,0.6228548387116002,1,0.96875,0.007265872248324954,0.0056059215225040555,1.3783,1.1141,0.4851,0.961,1.2558,0.6442,0.1796,1.4057969,1.0462406033333334,0.47757061366666664,6.1453,7.0026,0.0279,8.6531,0.1937,-72.2327,0.908,4.3774,0.3792,4.6909,0.4535,0.9684,1.90824327,5.1563532033333335,4.014403796666667,0.36938992666666665,0.22533053866666666,0.9663,3.8451,0.4477,4.6325,0.5304,0.8273,0.089,0.364,0.489,0.016,1.837,114.8125,390,1.1555555555555557,1,0,0,1,FALSE,FALSE,FALSE
199,2021-11-13T01:15:38Z,1,1.5,940,6,3,3,4,3,3,2,3,2,3,4,2,4,3,4,2,3,4,4,5,3,2,4,3,4,7,2,4,3,4,5,2,2,3,3,1,2,3,2,3,5,2,3,4,5,3,5,5,3,4,1,5,4,4,5,2,2,5,5,5,4,3,2,3,5,3,2,2,3,3,3.625,0,2.5,0,3.1333333333333333,0,3.2222222222222223,0,3.3333333333333335,0,4,0,3.2857142857142856,0,3.6666666666666665,0,3.4864864864864864,0,4,4,3,1.7794133729847235,1.5450778235757536,1.9014181152811362,1.7232479694284448,2,5,2,4,4,5,4,4.285714285714286,0,3,1.8006020440704469,2,3,3,2,1,1,5,1.8571428571428572,0,4.142857142857143,0.38995568780511447,0,2,3,2,5,4,3,4,4,3,1,4,3,5,3,3,2,4,3,4,3,3.2,0,3,0,2.8,0,2.8,0,2.8666666666666667,0,3,3,3,1,4,4,4,2,3,3,4,2,4,4,3,2,4,4,3,3,3.45,0,"White, Caucasian, Anglo, European American",0,30,1,2,NA,5,2,0,0,1,0,0,TRUE,TRUE,TRUE,TRUE,TRUE,0,6,0.7098738095238805,0.84,0.02235121035122687,6,0.49169062499981375,0.5721677419365414,1,0.96875,0.0011145931350967733,0.003747724667126742,6,0.6194093749979511,0.7117299999992053,1,0.967741935483871,0.0047332724897517515,0.004141539612896973,1.1534,1.4805,0.4584,0.7463,2.1719,0.5976,0.3825,1.2021711343333332,1.246661077,0.44912099,1.2343,7.7583,0.4121,3.8181,0.4194,-99.4369,0.8544,6.7926,0.4315,4.7553,0.4901,0.9837,1.327474868,3.85696808,6.704958833333333,0.41070480233333334,0.3998405896666667,0.7899,5.379,0.5492,5.9164,0.6494,0.9943,0.075,0.48,0.612,0.013,1.74,133.84615384615384,390,1.1555555555555557,1,0,0,1,FALSE,FALSE,FALSE
200,2021-11-13T01:33:12Z,0.800000011920929,1.6,900,7,2,2,5,2,5,1,1,5,2,1,1,2,5,2,4,4,1,2,1,1,1,1,1,1,0,2,0,0,5,5,5,5,5,5,5,5,5,1,5,1,1,5,1,5,1,1,1,1,1,4,1,1,1,2,1,1,1,2,1,5,1,1,1,1,1,1,1,1,2,1.125,0,1.25,0,1.6,0,1,0,1,0,1.1666666666666667,0,1,0,1,0,1.0810810810810811,0,0,0,0,-1.2717903417083833,-1.2219610533974852,-0.6588395645607719,-0.9404003089791285,5,2,5,1,1,2,1,1.2857142857142858,0,1,-0.7321841937363471,5,5,5,5,2,3,1,4.285714285714286,0,1.7142857142857142,-1.0219528370065065,0,3,2,3,2,3,3,3,2,2,1,2,2,2,3,4,2,3,2,3,3,2.6,0,3.2,0,3,0,3.6,0,3.2666666666666666,0,1,1,1,4,2,1,1,4,1,1,1,4,1,1,1,4,1,1,1,2,1.1,0,"White, Caucasian, Anglo, European American",0,27,1,2,NA,5,2,0,0,0,0,0,TRUE,TRUE,TRUE,TRUE,TRUE,0,2,0.7673333333333369,0.66,0.02001923469387857,2,0.44132258064516505,0.5060645161290341,1,0.96875,0.005169892473118891,0.0020241118951606603,2,0.5419375000000036,0.6109629629629673,1,0.84375,0.0055786411290336705,0.007368258064515545,1.2663,0.5717,0.417,0.8786,0.6494,0.6018,0.3019,1.3168843,0.7173481736666667,0.41053484133333334,1.0801,4.9856,0.333,4.8202,0.4007,-94.3279,0.6797,5.3639,0.3772,5.9874,0.4506,0.9703,1.1954568306666666,4.740954296666667,5.069707323333334,0.3920533903333333,0.325067561,0.8021,4.2318,0.4551,2.6288,0.4941,0.9454,0.051,0.411,0.415,0.009,1.35,150.00000000000003,436,1.2918518518518518,1,0,0,1,FALSE,FALSE,FALSE
202,2021-11-13T01:45:21Z,1,1.6,900,4,4,5,5,1,5,2,1,5,1,1,1,1,5,1,5,5,1,1,1,1,1,1,1,1,1,2,0,0,5,4,5,5,5,5,5,5,5,2,5,1,1,5,1,5,1,1,1,1,1,5,1,1,1,2,1,1,2,2,1,5,1,1,1,1,1,2,1,2,2,1,0,1.75,0,1.0666666666666667,0,1.1111111111111112,0,1.0833333333333333,0,1,0,1.1428571428571428,0,1,0,1.135135135135135,0,1,0,0,-1.3159193210531184,-1.481649220003026,-0.2989446853297732,-0.8902969526663996,5,1,4,1,1,1,1,1.1428571428571428,0,1,-0.8176513788914915,5,5,5,5,4,5,1,4.857142857142857,0,1.1428571428571428,-1.3043345419688306,0,1,1,1,2,1,1,5,1,1,1,1,5,2,4,3,2,5,1,1,1,1.2,0,5,0,3,0,4.4,0,4.133333333333334,0,1,1,3,2,3,3,3,2,2,1,1,3,1,4,4,2,3,3,3,1,2.4,0,"White, Caucasian, Anglo, European American",0,19,1,2,NA,5,2,0,1,0,0,1,TRUE,TRUE,TRUE,TRUE,TRUE,0,2,0.8215536585366581,0.82,0.05896378981221199,2,0.4849258064514687,0.5841156249996274,0.96875,1,0.003167922973738778,0.0073552149092254845,2,0.6269250000001629,0.7036875,1,1,0.00735511806448954,0.007180642419374441,1.2963,1.234,0.524,1.0622,1.4136,0.5774,0.0676,1.3384176433333332,1.1214910326666667,0.514232299,1.9176,4.7395,0.2909,3.8386,0.3343,-59.0513,0.9529,5.6409,0.4041,4.593,0.4934,0.9678,1.80603419,3.67963583,4.5422891,0.33831943266666664,0.2934053916666667,1.0249,3.5566,0.5059,3.9111,0.5844,0.9852,0.225,0.288,0.66,0.015,1.472,98.13333333333334,424,1.2562962962962962,1,0,0,1,FALSE,FALSE,FALSE
204,2021-11-13T01:48:22Z,0.8999999761581421,1.7777777777777777,1080,3,2,2,4,5,2,3,4,3,4,3,4,4,2,1,2,2,5,5,1,1,5,5,4,5,3,2,1,0,3,2,4,2,2,4,4,3,2,2,5,4,2,1,2,3,4,4,4,4,4,2,2,1,1,5,4,1,3,2,3,2,3,3,2,3,5,3,3,2,2,3.875,0,2.5,0,3.533333333333333,0,3.111111111111111,0,3.25,0,2.6666666666666665,0,2.5714285714285716,0,3.3333333333333335,0,3.054054054054054,0,2,1,0,1.6659388546696912,1.638577178380432,0.34598460421149024,0.9922808912959611,3,2,3,2,2,3,3,2.5714285714285716,0,3,0.7749958222087157,2,2,3,2,1,1,5,1.7142857142857142,0,4.285714285714286,1.237100802692087,0,3,3,2,4,4,2,4,2,2,2,2,3,2,4,5,3,3,2,2,3,3.2,0,3.6,0,3,0,4,0,3.533333333333333,0,2,2,2,2,3,2,3,2,2,1,3,3,2,1,1,2,1,2,1,2,2.05,0,"White, Caucasian, Anglo, European American",0,28,1,2,NA,5,2,1,0,0,0,1,TRUE,TRUE,TRUE,TRUE,TRUE,0,6,0.6491368420939696,0.76,0.012755043024064331,6,0.4628677419308693,0.6161633333206177,0.96875,0.967741935483871,0.0036797715729948014,0.009912544945959403,6,0.6352218750230968,1.0003038461529292,1,0.8125,0.01590992305644746,0.09794153576380282,1.2111,1.1239,0.3855,0.7565,1.3142,0.5285,0.2025,1.2705232233333332,1.0172574323333334,0.351107419,1.3557,4.0006,0.3002,2.9717,0.4019,-55.1601,0.9979,4.7887,0.369,4.314,0.5024,0.7511,1.49343994,3.1794128566666666,4.262732846666666,0.39035026366666664,0.292439933,1.4201,3.9886,0.4694,1.1956,0.6125,0.8993,0.09,0.31,0.159,0.007,1.901,271.57142857142856,104,0.3081481481481481,1,0,1,2,FALSE,FALSE,FALSE
205,2021-11-13T01:57:13Z,1,1.6,900,4,2,1,2,4,2,3,4,1,5,4,4,4,1,2,2,2,4,5,1,2,4,4,4,4,1,3,0,0,2,2,2,2,1,2,3,3,2,2,4,4,1,1,1,2,5,4,4,5,5,1,2,1,1,1,1,1,2,2,3,1,5,5,1,2,1,2,2,2,2,3.5,0,2,0,4.066666666666666,0,3.888888888888889,0,3.5,0,1.6666666666666667,0,3.142857142857143,0,1.3333333333333333,0,3.108108108108108,0,1,0,0,1.4663077576339847,1.7298503580707134,-0.22054348261253207,0.7546534377290907,3,4,2,2,2,3,2,2.857142857142857,0,5.5,1.8683993794549596,2,2,3,2,1,1,2,2.142857142857143,0,3.857142857142857,0.38995568780511447,0,1,1,1,1,1,1,4,4,1,4,1,1,1,4,4,1,5,1,2,3,1,0,4.2,0,4,0,3.6,0,3.933333333333333,0,2,3,3,2,3,4,3,2,3,2,2,1,2,2,2,2,1,2,2,2,2.55,0,"White, Caucasian, Anglo, European American",0,28,1,2,NA,5,2,0,1,2,0,1,TRUE,TRUE,TRUE,TRUE,TRUE,0,6,0.7492473684227781,0.7755102040816326,0.020858056776660784,6,0.46105333333611487,0.5491625000005588,0.967741935483871,1,0.0036839458277244377,0.004224715967501446,6,0.62746451613307,0.7203275862058689,1,0.90625,0.008291010365832494,0.017766824748030964,1.1072,1.2089,0.5222,0.941,0.9426,0.5768,0.0716,1.1670276556666668,1.0929648653333333,0.5135893443333334,1.1766,4.4505,0.3454,4.54,0.4196,-83.3988,0.7623,6.3713,0.4059,4.704,0.4737,0.9672,1.3444511506666668,4.59952098,4.67938069,0.4069556676666667,0.33461905433333333,0.9019,3.0687,0.5122,2.7366,0.5813,0.9862,0.064,0.455,0.398,0.012,1.638,136.5,402,1.1911111111111112,1,0,0,1,FALSE,FALSE,FALSE
206,2021-11-13T01:59:32Z,1,1.6,900,4,2,5,3,3,4,2,1,4,1,3,1,1,3,1,4,4,3,2,2,1,1,1,2,2,0,3,1,0,5,2,2,4,4,4,4,4,3,2,3,1,1,1,2,2,1,1,4,4,4,5,2,1,1,1,2,1,1,1,1,4,3,2,2,3,1,2,1,1,1,1.75,0,1.25,0,1.8666666666666667,0,2.4444444444444446,0,2.6666666666666665,0,1.1666666666666667,0,1.4285714285714286,0,2,0,2.135135135135135,0,0,1,0,-0.2274044972163212,-0.38579032238545885,-0.45220635696774814,-0.4189983396766035,4,2,2,2,1,3,2,2.2857142857142856,0,1.5,0.050579939736853735,2,3,4,3,2,2,4,2.5714285714285716,0,3.4285714285714284,0.9547190977297628,0,3,3,4,5,4,4,5,2,2,3,1,5,3,5,5,1,5,1,5,3,3.8,0,4.4,0,4.2,0,4.2,0,4.266666666666667,0,4,2,4,2,2,4,4,3,3,3,4,3,2,3,1,3,3,4,3,2,2.85,0,"Asian or Asian American (e.g., Chinese, Japanese, and others)",0,21,1,2,NA,5,2,0,0,2,0,0,TRUE,TRUE,TRUE,TRUE,TRUE,0,2,0.7986076923081508,0.7959183673469388,0.024539321633579126,2,0.46297999999920525,0.5175200000007948,0.9375,0.9375,0.0033325380642504846,0.005452827742499574,2,0.5868580645178595,0.7070749999987228,0.96875,0.875,0.00976189338686258,0.012322026602794493,1.3188,1.1436,0.4632,0.919,1.2656,0.6293,0.1425,1.3532870366666667,1.0608699093333334,0.456234967,0.9658,3.103,0.3217,3.2395,0.3819,-65.0242,0.794,4.7381,0.3851,4.6073,0.4289,0.9859,1.0730371503333334,3.4462108833333334,3.5030727433333335,0.37380941333333334,0.3165648526666667,0.8401,4.1513,0.4866,2.5478,0.5852,0.9736,0.056,0.442,0.35,0.006,1.276,212.66666666666666,431,1.2770370370370372,1,0,0,1,FALSE,FALSE,FALSE
207,2021-11-13T01:23:48Z,1,1.7777777777777777,720,6,3,1,2,5,2,5,5,1,5,5,4,5,1,2,2,5,1,1,1,1,1,2,4,1,0,2,0,0,5,5,3,2,1,5,5,3,2,2,3,1,1,2,2,1,2,1,1,1,1,5,1,1,1,1,1,1,1,1,1,1,4,3,1,1,4,1,1,1,1,1.5,0,1,0,4.266666666666667,0,2.5555555555555554,0,2,0,0.8333333333333334,0,2.142857142857143,0,2,0,2.027027027027027,0,0,0,0,-0.4501507739087931,0.49170983357646164,-0.7372407672780129,-0.12276546685077563,2,5,1,2,4,5,4,4.142857142857143,0,1,0.9771595093665387,5,5,5,5,2,2,1,4.142857142857143,0,1.8571428571428572,1.8018642126167355,0,2,2,2,3,3,3,3,3,3,3,1,3,2,3,3,1,3,3,3,4,2.4,0,3.4,0,3.6,0,2.8,0,3.2666666666666666,0,1,1,1,1,1,1,1,1,1,1,1,3,1,2,1,1,1,1,1,2,1.6,0,"Hispanic of Latino (e.g., Mexican American, Central American, and others)",0,28,1,2,NA,5,2,1,0,1,0,1,TRUE,TRUE,TRUE,TRUE,TRUE,0,4,0.7807419354877164,0.6326530612244898,0.06117000033756975,4,0.5004818181612275,0.6413344827684863,0.7586206896551724,0.9354838709677419,0.021933621700019057,0.028066160128385975,4,0.6335812499858439,0.7244166666600439,1,0.6206896551724138,0.008228153828660665,0.024584911427870986,1.3045,0.4275,0.4279,1.1037,0.2782,0.5497,0.3561,1.3466308566666667,0.6042833644333333,0.420428511,1.2169,1.2447,0.2105,1.8095,0.3327,-4.2146,0.9063,1.8369,0.3051,2.7385,0.497,0.9626,1.261316692,2.0059587943333335,1.603952657,0.3289448186666667,0.21092898133333332,1.0135,5.2131,0.5364,1.1751,0.5,0.5291,0.052,0.466,0.355,0.013,2.133,164.0769230769231,104,0.3081481481481481,1,1,4,5,FALSE,FALSE,FALSE
208,2021-11-13T01:46:32Z,0.8999999761581421,1.7777777777777777,1080,4,2,1,1,3,2,1,2,1,2,4,2,4,1,1,1,3,5,2,4,2,4,5,3,2,7,2,5,2,4,2,2,1,1,1,1,1,1,3,4,5,1,2,2,1,2,4,4,5,5,2,3,5,2,3,1,2,4,3,3,5,1,2,5,1,5,2,3,2,2,3.375,0,2.25,0,3.4,0,4.444444444444445,0,3.5,0,2.8333333333333335,0,2.142857142857143,0,3.6666666666666665,0,3.4324324324324325,0,4,5,2,1.5902891757930024,1.5290106466631481,1.8532004732577383,1.6911055599604432,4,2,3,4,2,2,3,2.5714285714285716,0,8,2.619934196080626,2,2,2,2,1,1,1,2.142857142857143,0,3.857142857142857,0.6723373927674386,0,3,5,3,1,1,4,5,2,1,1,4,4,1,5,2,3,2,3,3,5,2.6,0,2.6,0,3.4,0,3.4,0,3.1333333333333333,0,1,1,2,4,2,2,3,3,2,2,4,2,1,1,1,2,2,2,1,2,1.9,0,"Asian or Asian American (e.g., Chinese, Japanese, and others) & Native Hawaiian or other Pacific Islander & Filipino",1,27,1,1,NA,5,2,0,0,1,0,0,TRUE,TRUE,TRUE,TRUE,TRUE,0,5,0.7401300000011921,0.625,0.30623541473412946,5,0.4460374999991618,0.5128937500007451,1,1,0.003191597257996141,0.004668522540361881,5,0.5522312499994878,0.6077548387096293,1,0.96875,0.014656624798403088,0.015568456088574326,1.3921,0.3708,0.3555,0.8518,0.2629,0.5111,0.3232,1.41326656,0.5515916963366667,0.3505405916666667,0.9836,5.9752,0.3637,4.4455,0.4023,-104.1318,0.7207,4.9873,0.3753,5.7318,0.445,0.9882,1.1713543623333333,4.59176904,5.82006907,0.389091997,0.3503684346666667,1.5743,5.9634,0.4171,4.4861,0.434,0.9672,0.09,0.284,0.334,0.018,1.655,91.94444444444446,318,0.9422222222222223,1,0,0,1,FALSE,FALSE,FALSE
209,2021-11-13T02:00:13Z,1,1.6,900,7,3,4,4,3,4,3,1,5,1,1,1,1,5,1,4,5,2,2,1,1,1,1,1,2,1,2,0,0,5,4,5,5,5,5,3,5,4,2,4,2,1,4,1,5,2,5,1,2,1,4,1,1,1,2,1,1,2,2,1,4,1,1,1,1,1,1,1,1,2,1.375,0,1.25,0,1.5333333333333334,0,1.4444444444444444,0,1.8333333333333333,0,1.1666666666666667,0,1.2857142857142858,0,1,0,1.5135135135135136,0,1,0,0,-0.8473115880114084,-0.9573365854513246,-0.4557470907642554,-0.70654183810779,5,1,3,1,1,1,1,1.2857142857142858,0,1,-0.7321841937363471,5,5,5,5,3,2,1,4.285714285714286,0,1.7142857142857142,0.10757398284279028,0,3,1,1,3,2,3,3,2,2,4,1,4,3,3,4,3,3,1,3,2,2,0,4,0,3.2,0,3.8,0,3.6666666666666665,0,1,1,2,3,3,2,3,3,1,1,2,2,1,3,1,1,1,1,2,2,1.9,0,"White, Caucasian, Anglo, European American",0,30,1,2,NA,5,2,0,0,1,0,0,TRUE,TRUE,TRUE,TRUE,TRUE,0,4,0.750567741935532,0.62,0.02575702571444535,4,0.43272187500051223,0.4901517241373658,1,0.90625,0.0020338707963702234,0.003136309516145996,4,0.5620281250004191,0.6439433333327373,1,0.9375,0.003889867892983897,0.005717012741811932,1.2501,0.4202,0.392,0.9676,0.5585,0.5437,0.2764,1.2981593433333334,0.6195228890366666,0.3863346323333333,1.0066,4.8349,0.3286,3.1367,0.3521,-81.1785,0.6735,6.7537,0.3862,4.4783,0.4254,0.8391,1.1112245913333334,3.33978072,5.00096397,0.344370594,0.32317895133333335,0.6982,4.3759,0.5004,3.8491,0.5628,0.9987,0.071,0.421,0.512,0.018,1.859,103.27777777777779,373,1.1051851851851853,1,0,0,1,FALSE,FALSE,FALSE
210,2021-11-13T01:58:12Z,1,1.6,900,4,5,2,5,3,5,1,2,1,1,1,1,3,2,1,3,4,1,5,1,1,1,5,3,3,1,2,0,0,5,5,5,5,5,5,5,5,3,1,5,4,1,5,1,5,5,5,5,5,5,1,1,1,2,2,1,1,3,1,1,4,1,1,1,1,3,2,2,1,2,2.5,0,1.75,0,2.2,0,1.2222222222222223,0,2.9166666666666665,0,1.8333333333333333,0,1.2857142857142858,0,1.6666666666666667,0,1.972972972972973,0,1,0,0,0.13823561735434034,0.010081687087766012,-0.2989446853297732,-0.1444314991210036,5,5,3,1,2,1,3,2.2857142857142856,0,2,0.2350737771240448,5,5,5,5,5,5,1,5,0,1,-1.3043345419688306,0,4,4,3,5,3,2,5,2,2,5,1,4,1,5,4,1,5,1,5,2,3.8,0,4.6,0,5,0,4.2,0,4.6,0,2,4,2,1,3,3,4,2,4,4,3,2,4,1,1,2,3,3,1,4,2.95,0,"White, Caucasian, Anglo, European American",0,21,1,2,NA,5,2,0,0,1,0,0,TRUE,TRUE,TRUE,TRUE,TRUE,0,3,0.9274861111077998,0.72,0.10793960869001742,3,0.723410714287843,0.813700000005109,0.9655172413793104,1,0.05613899756368245,0.05048125037050653,3,0.7340875000003725,0.9005774193540697,1,0.96875,0.010055469515116452,0.03468868112046995,1.7259,0.596,0.2386,1.4622,0.796,0.4255,0.3494,1.6737108766666666,0.6681232585333333,0.24226940633333333,1.8571,2.1336,0.307,2.3419,0.4173,-5.0398,1.5424,1.8498000000000001,0.3625,2.2815,0.4966,0.9235,1.95124242,2.446801916666667,2.352437016666667,0.400055995,0.300861979,1.2964,4.7589,0.6046,2.3958,0.6537,0.9793,0.114,0.477,0.426,0.011,1.82,165.45454545454547,104,0.3081481481481481,1,0,1,2,FALSE,FALSE,FALSE
211,2021-11-13T02:07:33Z,0.699999988079071,1.6,900,5,4,3,4,3,3,3,4,4,4,3,4,4,3,3,4,4,4,4,3,4,4,3,4,4,1,2,1,1,4,4,4,3,4,4,4,4,3,4,3,4,3,4,4,4,5,4,4,3,4,3,4,4,4,3,4,4,4,4,3,4,4,3,4,3,2,4,4,3,3,3.75,0,3.5,0,3,0,2.2222222222222223,0,3.5,0,3.5,0,3.2857142857142856,0,3,0,3.1621621621621623,0,1,1,1,1.6554319548257066,1.402118665142513,0.632946588183119,1.017532626662816,4,4,4,4,4,4,4,3.4285714285714284,0,3,1.2877989331395812,4,3,3,3,4,3,3,3.2857142857142856,0,2.7142857142857144,-1.3043345419688306,0,5,4,4,3,4,4,4,3,4,3,3,4,3,4,4,4,3,4,3,4,4,0,2.8,0,3,0,3,0,2.933333333333333,0,2,3,3,3,3,3,2,3,3,4,3,3,2,3,3,2,3,3,3,2,2.7,0,"White, Caucasian, Anglo, European American",0,19,0,1,NA,5,2,0,0,0,0,0,TRUE,TRUE,TRUE,TRUE,TRUE,0,4,0.7611315789473669,0.8085106382978723,0.060898340425539425,4,0.5238999999999923,0.6125625,0.967741935483871,1,0.018100464516128584,0.013626189516129298,4,0.6715937499999969,0.8112333333333305,1,0.9375,0.006382119959677607,0.014073547379032639,1.7318,0.9188,0.2148,1.1398,0.9743,0.5252,0.3798,1.6539017766666666,0.8943633846666666,0.22109959666666668,1.5805,2.909,0.2801,4.476,0.436,-53.5917,1.2938,6.1352,0.3934,4.8183,0.4669,0.7546,1.7036590366666666,4.370608266666666,3.20273511,0.4202716023333333,0.27489647866666667,1.0564,4.7151,0.5751,2.7463,0.6482,0.9132,0.098,0.461,0.466,0.013,2.042,157.07692307692307,104,0.3081481481481481,1,0,0,1,FALSE,FALSE,FALSE
212,2021-11-13T01:50:51Z,1,1.6,900,4,2,1,1,2,2,2,5,3,4,3,3,2,1,5,2,4,2,5,5,1,2,4,5,3,1,2,0,2,5,4,3,4,4,4,4,5,4,2,3,2,3,3,3,5,5,4,4,4,5,2,5,1,1,3,1,1,2,1,1,1,5,5,1,4,4,2,3,1,1,3.375,0,1.75,0,3.6,0,1.8888888888888888,0,3.25,0,2.3333333333333335,0,2.7142857142857144,0,3,0,2.7027027027027026,0,1,0,2,1.1363911025328706,1.3013600436604527,0.053954608468588336,0.6776573260645204,4,2,2,4,2,2,2,2.5714285714285716,0,1,0.03702047265995151,3,2,3,2,1,1,5,1.8571428571428572,0,4.142857142857143,0.38995568780511447,0,3,3,2,2,2,2,5,3,2,3,1,3,1,4,4,3,3,1,4,3,2.4,0,4,0,4,0,3.6,0,3.8666666666666667,0,3,1,2,3,3,2,3,3,1,3,3,3,2,1,2,3,2,3,4,3,2.3,0,"Asian or Asian American (e.g., Chinese, Japanese, and others) & White, Caucasian, Anglo, European American",1,29,1,2,NA,5,2,0,0,1,0,0,TRUE,TRUE,TRUE,TRUE,TRUE,0,5,0.8456842105263158,0.76,0.05144418938775511,5,0.46861290322580645,0.5859375,1,1,0.0063135784946236565,0.006714512096774193,5,0.5904193548387097,0.6703666666666667,1,0.967741935483871,0.007185584946236559,0.00869756559139785,1.384,0.8914,0.4664,0.8758,1.1742,0.6857,0.3791,1.4176400733333334,0.9043931573333334,0.45908280533333334,1.7601,6.3208,0.3294,4.6122,0.3951,-82.9238,0.8875,5.6183,0.3813,3.4523,0.4815,0.9934,1.6695019866666667,4.286201763333334,5.698321873333334,0.39397182566666666,0.32684348733333335,1.0657,4.5777,0.4873,4.3915,0.5604,0.8595,0.076,0.437,0.502,0.012,1.468,122.33333333333333,376,1.114074074074074,1,0,0,1,FALSE,FALSE,FALSE
213,2021-11-13T02:00:57Z,1,1.6,900,4,2,4,4,2,4,2,1,4,2,1,2,1,4,2,4,4,1,2,1,1,1,1,1,1,0,5,0,0,5,5,5,4,2,4,3,3,3,1,4,1,1,3,2,1,2,1,2,1,1,4,1,1,1,1,1,1,1,1,1,3,4,1,1,1,1,2,2,1,1,1.125,0,1.5,0,1.8,0,2.2222222222222223,0,1.8333333333333333,0,1,0,1.5714285714285714,0,1,0,1.7297297297297298,0,0,0,0,-0.8683253876993774,-0.85725549552582,-0.5804383618435307,-0.7188469286846754,5,1,3,1,1,1,1,1.2857142857142858,0,1,-0.7321841937363471,3,3,3,3,1,1,3,2.4285714285714284,0,3.5714285714285716,0.6723373927674386,0,2,2,2,3,2,2,5,1,2,2,1,3,2,4,4,3,5,2,2,2,2.2,0,4.2,0,3.2,0,4.2,0,3.8666666666666667,0,1,1,2,3,3,3,2,2,3,1,1,3,1,1,1,3,1,2,2,3,1.85,0,"Asian or Asian American (e.g., Chinese, Japanese, and others)",0,25,1,2,NA,5,2,0,0,1,0,0,TRUE,TRUE,TRUE,TRUE,TRUE,0,4,0.956910416662693,0.96,0.08883010384891502,4,0.4284968750029802,0.529480645133603,1,0.96875,0.0017700493453361335,0.005344258942561601,4,0.6390874999985099,0.6916062500029803,1,1,0.015551779201104217,0.017956425767749015,1.8582,1.8202,0.4792,1.659,1.7081,0.5482,0.3072,1.6582268966666667,1.41470583,0.484767176,1.5069,5.6308,0.2947,4.4463,0.3671,-83.8692,1.0087,8.6165,0.3709,3.6086,0.3978,0.953,1.489988806,4.2739133166666665,5.34460767,0.3644760086666667,0.292392016,0.9438,3.2482,0.5374,3.2234,0.5639,0.8133,0.196,0.212,0.45,0.021,1.283,61.09523809523809,384,1.1377777777777778,1,0,0,1,FALSE,FALSE,FALSE
214,2021-11-13T02:03:18Z,0.8999999761581421,1.6,900,4,4,5,4,2,4,3,2,5,2,3,1,2,5,2,5,2,2,3,1,2,1,1,1,1,2,2,0,0,4,4,2,4,5,5,2,2,5,2,5,1,1,2,3,5,5,3,2,1,2,4,1,1,1,3,1,2,2,1,1,4,2,1,1,1,1,1,1,1,1,1.5,0,1,0,1.9333333333333333,0,2.3333333333333335,0,2.1666666666666665,0,1.3333333333333333,0,1.4285714285714286,0,1,0,1.8918918918918919,0,1,0,0,-0.5342059726606693,-0.5691110035449424,-0.5341482934814965,-0.5516296485132195,5,1,4,1,1,1,1,1.1428571428571428,0,1,-0.8176513788914915,5,5,5,5,3,3,1,4.428571428571429,0,1.5714285714285714,-0.1748077221195339,0,2,2,3,3,2,2,2,2,2,2,1,3,3,4,5,3,3,2,2,4,2.4,0,3.8,0,2.4,0,3.8,0,3.3333333333333335,0,1,1,1,4,2,2,1,3,2,2,1,3,2,2,1,4,1,2,1,2,1.5,0,"White, Caucasian, Anglo, European American",0,24,1,2,NA,5,2,0,0,1,0,0,TRUE,TRUE,TRUE,TRUE,TRUE,0,2,1.0384547560867603,0.82,0.09889777733799109,2,0.512320322570421,0.5844943548342393,0.96875,0.96875,0.00275946152326012,0.0026096417564402436,2,0.6963090624994948,0.7189068749976286,1,1,0.028881774708752913,0.008431019323371678,1.7876,0.9281,0.431,1.1932,1.1918,0.7397,0.5591,1.71418152,0.9018683176666666,0.43201429733333335,0.9975,3.6226,0.3801,4.8582,0.487,-85.7133,0.6735,5.5566,0.4579,5.7659,0.5241,0.9621,1.198822197,4.790282213333334,4.097282683333333,0.470345428,0.36896459466666665,1.0307,2.539,0.5094,4.3019,0.6087,0.9566,0.112,0.433,0.462,0.014,1.223,87.35714285714286,425,1.2592592592592593,1,0,1,2,FALSE,FALSE,FALSE
215,2021-11-13T02:04:09Z,1,1.7777777777777777,1080,4,2,4,4,4,3,2,1,2,3,3,1,1,3,1,3,2,3,4,5,1,2,3,2,3,3,2,4,4,2,2,3,4,4,3,1,1,2,2,4,3,1,1,3,4,4,3,3,3,4,1,3,3,2,3,1,1,3,3,1,4,2,2,2,2,2,1,2,2,2,2.875,0,1.75,0,2.466666666666667,0,3.5555555555555554,0,2.9166666666666665,0,2.6666666666666665,0,1.8571428571428572,0,2,0,2.810810810810811,0,2,4,4,0.8926310261524294,0.6458966578040526,1.436479206435561,1.0411879321198068,4,2,2,3,2,2,3,2.5714285714285716,0,1,0.03702047265995151,3,4,4,4,1,2,3,3,0,3,-0.4571894270818581,0,3,3,3,2,3,2,3,4,2,2,2,4,2,3,4,4,4,1,4,4,2.8,0,4.2,0,3,0,3,0,3.4,0,1,2,1,4,2,1,1,4,1,1,1,4,2,1,1,4,2,2,1,1,1.25,0,"White, Caucasian, Anglo, European American",0,27,1,2,NA,5,2,0,0,1,0,0,TRUE,TRUE,TRUE,TRUE,TRUE,0,1,0.8933387096851103,0.6326530612244898,0.04899955326418937,1,0.5211032258079897,0.713,1,1,0.0021197903225793633,0.016225467741079486,1,0.6413062500031665,0.8017531250016764,1,1,0.004371318024059032,0.020296432892644493,1.0915,0.5011,0.6352,0.9521,0.378,0.6811,0.1576,1.164007221,0.6803326402333333,0.6232313173333334,3.5476,9.622,0.3368,4.8384,0.3464,-77.4806,0.9208,8.2904,0.4643,3.1835,0.5834,0.9921,2.0694507966666666,3.53356306,6.665002603333333,0.417920831,0.37264276,1.2216,6.5351,0.5565,2.534,0.5934,0.9738,0.142,0.391,0.542,0.011,1.647,149.72727272727275,320,0.9481481481481481,1,0,1,2,FALSE,FALSE,FALSE
216,2021-11-13T02:08:56Z,1,1.7786458333333333,768,6,3,3,4,3,3,4,4,3,4,4,3,2,3,2,3,3,2,2,1,1,2,2,3,1,4,2,0,0,3,3,5,4,4,4,3,4,4,2,4,2,1,4,4,4,4,2,4,4,4,5,1,1,1,3,1,1,2,3,1,3,4,4,1,1,1,1,1,1,1,1.75,0,1,0,3.066666666666667,0,2.2222222222222223,0,2.75,0,1.1666666666666667,0,2.4285714285714284,0,1,0,2.2162162162162162,0,2,0,0,-0.1769713779651954,0.16475246242718228,-0.33105581968498016,-0.08315167862889894,4,1,3,1,1,1,1,1.4285714285714286,0,1,-0.6467170085812028,4,4,4,4,3,2,2,3.5714285714285716,0,2.4285714285714284,-1.0219528370065065,0,2,2,2,3,2,2,4,3,2,3,2,4,2,4,4,2,4,3,3,3,2.2,0,3.8,0,3.6,0,3.6,0,3.6666666666666665,0,1,2,2,3,2,2,2,3,1,1,3,3,2,2,1,3,2,2,1,1,1.75,0,"White, Caucasian, Anglo, European American",0,28,1,2,NA,5,2,0,0,0,0,0,TRUE,TRUE,TRUE,TRUE,TRUE,0,2,0.7658131578972465,0.76,0.01823575603046319,2,0.44372500002384185,0.5121931034449874,1,0.90625,0.003770278061075518,0.0072011128583689245,2,0.5855250000059604,0.6658937499672174,1,1,0.003631689669288205,0.006772259311291057,1.0528,1.1469,0.5296,0.8955,1.2432,0.594,0.2048,1.1195546756666668,1.061782182,0.5204148076666667,1.0588,4.8309,0.3341,2.4489,0.3297,-68.6025,0.7996,4.4822,0.3579,3.6643,0.4144,0.9674,1.1600923106666667,2.73171476,4.923063703333334,0.322944342,0.32746875233333333,0.944,6.116,0.5046,4.0839,0.5547,0.9878,0.061,0.488,0.575,0.026,1.751,67.34615384615384,350,1.0370370370370372,1,0,0,1,FALSE,FALSE,FALSE
217,2021-11-13T01:54:59Z,1,1.7777777777777777,864,4,4,4,5,2,5,1,1,4,2,2,1,2,4,1,3,4,2,3,1,1,1,2,2,1,1,2,0,0,5,3,2,4,3,5,5,5,5,4,5,1,1,2,1,3,2,1,1,3,3,3,1,1,1,1,2,1,1,2,1,4,1,1,1,1,1,1,1,1,1,1.625,0,1,0,1.6666666666666667,0,1.8888888888888888,0,2.0833333333333335,0,1.3333333333333333,0,1.1428571428571428,0,1,0,1.7027027027027026,0,1,0,0,-0.5741321920678106,-0.7112958401992617,-0.5341482934814965,-0.6227220668403791,5,1,4,1,1,1,1,1.1428571428571428,0,1,-0.8176513788914915,5,5,5,5,3,3,1,4.428571428571429,0,1.5714285714285714,-0.7395711320441822,0,2,3,3,2,2,2,4,5,2,2,1,3,2,3,4,1,4,2,3,3,2.4,0,4,0,3.6,0,3,0,3.533333333333333,0,1,2,1,4,1,1,1,3,1,1,1,3,2,1,1,3,1,1,1,2,1.3,0,"Asian or Asian American (e.g., Chinese, Japanese, and others) & White, Caucasian, Anglo, European American",1,19,1,2,NA,5,2,1,1,1,0,2,TRUE,TRUE,TRUE,TRUE,TRUE,0,6,0.6231642857137181,0.84,0.012245912248873591,6,0.42161562500009314,0.48724137931034484,1,0.9354838709677419,0.001098457489917083,0.003995315182859345,6,0.49806875000009315,0.5634290322598912,1,0.96875,0.0039835589920488934,0.00674855700612605,1.1235,1.622,0.4161,0.6626,1.6676,0.5517,0.2396,1.1674571623333334,1.3012511716666666,0.4086403573333333,1.0814,6.5724,0.3393,3.4757,0.3455,-93.8048,0.6476,8.4418,0.3851,4.0935,0.4217,0.8374,1.127689797,3.559504663333333,6.04658907,0.341427199,0.33380850966666664,0.7599,4.6222,0.4345,4.1413,0.4882,0.8732,0.08,0.352,0.559,0.026,1.999,76.88461538461539,386,1.1437037037037037,1,0,0,1,FALSE,FALSE,FALSE
218,2021-11-13T02:11:24Z,1,1.7777777777777777,1080,2,3,3,4,4,3,5,2,5,3,3,1,2,4,2,3,3,2,5,1,1,1,3,2,2,0,2,0,0,4,5,4,5,5,5,3,3,5,5,4,1,1,4,1,5,3,1,1,1,2,2,1,1,1,1,1,1,1,2,1,4,2,2,1,1,1,2,2,1,2,2.125,0,1.75,0,2.6,0,1.6666666666666667,0,1.75,0,1.3333333333333333,0,1.4285714285714286,0,1,0,1.5945945945945945,0,0,0,0,-0.33037211568736946,-0.1417821718030628,-0.5020371591262895,-0.32190966546467614,5,1,4,1,1,1,1,1.1428571428571428,0,1,-0.8176513788914915,4,5,4,4,3,2,1,3.857142857142857,0,2.142857142857143,-1.5867162469311549,0,2,3,2,1,2,2,5,3,2,2,1,3,1,3,4,3,4,1,5,4,2,0,4.2,0,4,0,3.2,0,3.8,0,1,3,4,1,3,4,4,1,4,3,3,1,2,4,1,1,4,4,2,4,3.3,0,"Asian or Asian American (e.g., Chinese, Japanese, and others)",0,21,0,1,NA,5,2,0,0,1,0,0,TRUE,TRUE,TRUE,TRUE,TRUE,0,3,0.888990909089419,0.88,0.11337387590205109,3,0.34770937499497084,0.4274999999947125,1,0.96875,9.325150706326592e-4,0.003629660645287595,3,0.48901250000158325,0.5187032258063555,1,0.96875,0.005746380483884771,0.0036924795865836105,1.6306,1.3169,0.4045,1.4545,1.4856,0.4738,0.2322,1.58170543,1.164093788,0.402742372,1.3214,7.5782,0.2605,4.2295,0.2777,-100.1356,1.1311,8.7542,0.2856,6.9507,0.3458,0.9994,1.195860673,3.967963976666667,6.384688493333333,0.2837020726666667,0.2603219823333333,0.942,3.5872,0.3779,5.1624,0.4379,0.9647,0.066,0.342,0.444,0.03,1.723,57.43333333333334,278,0.8237037037037037,1,0,1,2,FALSE,FALSE,FALSE
219,2021-11-13T02:05:01Z,1,1.7777777777777777,864,4,3,5,5,1,5,1,1,3,1,1,1,1,4,1,4,3,2,1,1,1,1,1,1,1,5,2,0,0,4,4,5,5,5,5,5,5,5,1,5,1,1,4,1,4,1,1,1,1,1,4,1,1,1,1,1,1,2,2,2,5,1,1,1,1,1,1,2,2,2,1.125,0,1.75,0,1.4,0,1.2222222222222223,0,1.1666666666666667,0,1,0,1.2857142857142858,0,1,0,1.2162162162162162,0,3,0,0,-1.187735142956507,-1.2498366374386316,0.10724026226325957,-0.571298187587686,5,1,3,1,1,1,1,1.2857142857142858,0,1,-0.7321841937363471,5,4,5,3,3,2,2,3.7142857142857144,0,2.2857142857142856,0.9547190977297628,0,2,2,3,1,1,2,4,2,1,3,1,5,1,5,4,2,4,3,3,3,1.8,0,4.2,0,3.8,0,4.2,0,4.066666666666666,0,1,2,1,4,1,1,2,4,1,1,1,4,2,1,1,4,1,1,1,2,1.2,0,"White, Caucasian, Anglo, European American",0,29,1,2,NA,5,2,0,0,1,0,0,TRUE,TRUE,TRUE,TRUE,TRUE,0,2,0.8063176470586263,0.68,0.03434264150623493,2,0.5305468750001164,0.6055766666668156,1,0.9375,0.007024361280265259,0.007371990312394933,2,0.649421875,0.7160000000002483,1,0.967741935483871,0.011800008860864403,0.011787045698901204,1.1426,0.6587,0.5065,1.0926,0.5898,0.5609,0.2799,1.208676249,0.7744670569333333,0.495506364,1.1094,3.8871000000000002,0.3878,2.8516,0.4311,-62.174,0.8525,4.7556,0.4391,3.2779,0.5016,0.9768,1.335270433,3.1708799966666668,4.25065327,0.4116618123333333,0.37175666333333335,0.8288,3.1154,0.5449,3.0538,0.6294,0.9652,0.08,0.444,0.382,0.012,1.324,110.33333333333334,410,1.2148148148148148,1,0,0,1,FALSE,FALSE,FALSE
221,2021-11-13T02:03:57Z,1,1.6,800,6,2,4,4,2,4,2,2,4,2,2,2,2,4,2,3,3,2,2,1,1,1,1,2,2,1,2,0,0,4,3,5,4,4,5,5,5,4,1,4,2,1,4,2,4,2,2,1,1,2,4,1,1,1,2,1,1,2,1,1,4,2,1,1,1,1,1,1,2,1,1.5,0,1.25,0,2.1333333333333333,0,1.6666666666666667,0,1.6666666666666667,0,1.1666666666666667,0,1.2857142857142858,0,1,0,1.5135135135135136,0,1,0,0,-0.7695605291659228,-0.6457688596580947,-0.4557470907642554,-0.5507579752111751,4,2,3,1,1,2,2,1.8571428571428572,0,1,-0.39031545311577004,5,5,5,5,2,2,1,4.142857142857143,0,1.8571428571428572,0.10757398284279028,0,2,2,2,3,2,2,3,2,2,3,2,3,3,4,4,4,4,2,3,3,2.2,0,3.8,0,2.8,0,3.8,0,3.466666666666667,0,2,1,1,2,2,2,2,2,2,1,2,3,2,2,2,2,1,2,3,3,2.05,0,"White, Caucasian, Anglo, European American",0,28,1,2,NA,5,2,0,0,1,0,0,TRUE,TRUE,TRUE,TRUE,TRUE,0,4,0.8456787878796458,0.66,0.030386963367030128,4,0.6322093750000931,0.6758000000000466,1,1,0.008111216360700465,0.00818516580643805,4,0.7044937500003725,0.818724999998929,1,1,0.013675219959709602,0.014701244516203896,1.1442,0.5994,0.5703,0.8987,0.5036,0.6786,0.2775,1.2131862126666666,0.74294695608,0.559406617,4.346,6.6364,0.3048,6.1752,0.3239,-65.8877,0.999,4.1039,0.514,3.802,0.5623,0.9906,2.2469487833333335,4.29843893,4.776202696666667,0.417234697,0.3969366993333333,0.6862,4.6756,0.642,3.3847,0.764,0.9397,0.262,0.25,0.576,0.013,1.698,130.6153846153846,386,1.1437037037037037,1,0,0,1,FALSE,FALSE,FALSE
222,2021-11-13T01:54:50Z,1,1.7777777777777777,864,4,2,4,4,2,4,2,1,4,2,2,1,2,4,2,4,5,1,1,1,1,1,1,1,1,1,2,0,0,5,5,5,5,5,5,5,5,5,1,5,1,1,4,1,5,1,1,1,2,2,5,1,1,1,2,1,1,2,1,1,5,1,2,1,1,1,1,1,1,1,1,0,1,0,1.8,0,1,0,1.25,0,1,0,1.1428571428571428,0,1,0,1.162162162162162,0,1,0,0,-1.299108281302743,-1.1548854292984765,-0.5341482934814965,-0.8445168613899865,4,2,3,2,2,2,3,2.2857142857142856,0,1,-0.1339138976503373,5,5,5,4,3,3,1,4.285714285714286,0,1.7142857142857142,0.9547190977297628,0,3,2,2,2,2,2,5,2,1,3,1,2,1,5,5,1,4,1,4,3,2.2,0,4,0,4.4,0,4.4,0,4.266666666666667,0,1,2,1,4,2,1,2,3,1,1,2,4,2,2,1,4,1,2,1,2,1.45,0,"White, Caucasian, Anglo, European American",0,21,1,2,NA,5,2,0,0,0,0,0,TRUE,TRUE,TRUE,TRUE,TRUE,0,5,0.9347121951231142,0.82,0.08622242303413777,5,0.4781129032142701,0.5938903225852598,1,0.96875,0.006630503828754568,0.01206177124953195,5,0.680625,0.7447066666483879,1,0.9375,0.021415052255271485,0.013914624800696199,1.6296,0.9972,0.4336,1.309,0.9489,0.5909,0.2524,1.6035282933333332,0.958619939,0.42992884633333334,1.552,5.1446,0.3273,2.8358,0.3305,-58.0704,1.0844,4.9052,0.363,3.6605,0.4524,0.9762,1.6147311633333334,2.98544438,5.0613656,0.32710796366666667,0.3200832336666667,1.5145,3.4377,0.4596,4.1394,0.5544,0.9441,0.071,0.488,0.439,0.018,1.953,108.50000000000001,380,1.125925925925926,1,0,0,1,FALSE,FALSE,FALSE
223,2021-11-13T02:09:30Z,1,1.6,900,6,3,5,5,2,5,2,2,4,2,1,1,2,5,2,5,4,2,2,1,1,1,1,2,2,1,2,0,0,5,4,5,5,5,5,5,5,5,1,3,2,4,4,2,5,1,1,2,2,1,5,1,1,1,2,2,1,1,1,1,5,1,1,1,1,1,2,1,1,1,1.5,0,1.25,0,1.5333333333333334,0,1.1111111111111112,0,1.8333333333333333,0,1.1666666666666667,0,0.8571428571428571,0,1,0,1.3513513513513513,0,1,0,0,-0.8704267676681744,-0.9733069721415648,-0.4557470907642554,-0.7145270314529101,4,2,4,1,1,2,1,1.5714285714285714,0,1.5,-0.3767559860388676,5,5,5,5,3,3,2,4.285714285714286,0,1.7142857142857142,-0.4571894270818581,0,4,3,4,4,4,4,5,4,3,2,2,3,3,4,4,1,3,2,3,4,3.8,0,3.2,0,3.6,0,3,0,3.2666666666666666,0,1,1,2,4,3,1,3,4,1,1,1,4,1,2,1,4,2,2,1,2,1.45,0,"White, Caucasian, Anglo, European American",0,24,1,2,NA,5,2,0,0,1,0,0,TRUE,TRUE,TRUE,TRUE,TRUE,0,4,0.9206974999979138,0.8,0.06606923626015619,4,0.45753548387365955,0.5297374999970198,0.96875,1,0.0031529122488274325,0.004742376613315845,4,0.6019750000108034,0.6640709677434736,1,0.96875,0.005369578708845973,0.008753958780273569,1.4147,1.0427,0.5255,1.0817,1.1388,0.6627,0.2775,1.4404470566666667,1.004164286,0.5165020253333333,1.3483,5.4449,0.3407,3.4782,0.3359,-75.0332,0.9422,4.6928,0.361,6.756,0.4649,0.966,1.448971104,3.6395364166666666,5.25903138,0.33003464466666665,0.330606433,0.8689,5.4176,0.528,3.5077,0.5587,0.9997,0.063,0.464,0.421,0.031,1.787,57.64516129032258,374,1.108148148148148,1,0,0,1,FALSE,FALSE,FALSE
224,2021-11-13T02:11:55Z,1,1.7777777777777777,1080,6,2,3,4,4,4,2,1,4,1,1,1,2,3,3,3,4,3,3,1,1,1,3,2,4,1,2,0,0,5,3,5,5,5,5,2,4,3,1,4,1,1,3,1,5,4,4,4,4,4,4,1,1,1,3,1,1,2,1,1,4,3,2,2,1,2,1,1,2,2,2.25,0,1.5,0,2.1333333333333333,0,1.8888888888888888,0,2.5,0,1.3333333333333333,0,1.5714285714285714,0,1.6666666666666667,0,1.972972972972973,0,1,0,0,-0.017266500336630693,-0.12600536555755287,-0.3773458880470143,-0.2516756268022836,5,1,5,1,1,1,1,1,0,1.5,-0.7186247266594448,5,5,5,4,4,1,1,4.142857142857143,0,1.8571428571428572,-1.3043345419688306,0,3,4,4,3,3,2,4,2,2,2,3,3,3,3,4,3,2,2,3,3,3.4,0,3.2,0,3,0,3.6,0,3.2666666666666666,0,3,1,4,2,3,4,3,1,3,1,1,2,2,2,1,2,2,3,3,3,2.6,0,"White, Caucasian, Anglo, European American",0,24,1,3,NA,5,2,0,0,0,0,0,TRUE,TRUE,TRUE,TRUE,TRUE,0,2,0.7484000000238419,0.8,0.06706241578795664,2,0.5088000000215346,0.6006387096835721,0.96875,0.96875,0.005094416931383707,0.004418536761143591,2,0.6942125000357627,0.7608964285509927,1,0.875,0.008576504347407126,0.010430953544048282,1.2663,1.0912,0.3962,1.2665,1.2926,0.4145,0.1937,1.304696171,1.0336752,0.38881570033333335,1.2498,3.3407,0.3299,3.8992,0.4483,-63.3172,0.8383,4.2343,0.4184,4.5872,0.5184,0.9705,1.4397467823333334,4.03563163,3.7324227733333335,0.432013482,0.31902674766666667,0.6002,3.7862,0.6464,4.425,0.6904,0.8803,0.065,0.526,0.427,0.012,1.618,134.83333333333334,325,0.9629629629629629,1,0,0,1,FALSE,FALSE,FALSE
225,2021-11-13T02:10:48Z,0.8999999761581421,1.25,1024,4,1,2,4,5,2,5,4,1,5,5,5,3,1,1,1,3,3,4,1,1,2,5,5,5,0,2,0,0,4,2,1,3,3,4,2,4,2,1,4,5,2,2,2,3,5,5,5,5,5,2,3,1,1,1,1,1,1,1,1,2,5,5,1,1,3,1,3,1,1,3.25,0,1.5,0,4.066666666666666,0,3.2222222222222223,0,3.6666666666666665,0,1.6666666666666667,0,2.4285714285714284,0,1.6666666666666667,0,2.891891891891892,0,0,0,0,1.176317321940012,1.5294945977749739,-0.5804383618435307,0.4745281179657216,5,2,4,2,1,1,1,1.4285714285714286,0,1,-0.6467170085812028,5,5,5,5,3,3,1,4.428571428571429,0,1.5714285714285714,-0.7395711320441822,0,2,2,2,5,3,4,5,2,3,4,3,3,2,3,5,1,5,1,5,2,2.8,0,3.6,0,4.6,0,3.8,0,4,0,3,2,4,1,2,4,2,1,4,4,4,2,4,4,2,2,2,4,4,4,3.35,0,"White, Caucasian, Anglo, European American",0,25,1,2,NA,5,2,0,0,0,0,0,TRUE,TRUE,TRUE,TRUE,TRUE,0,NA,NA,NA,NA,2,0.5111187499999068,0.5828281250002328,1,1,0.004038863508066193,0.00561266402218366,2,0.6698354838707995,0.7686290322580646,0.96875,0.96875,0.009922706290333493,0.01603590974807067,NA,NA,NA,NA,NA,NA,NA,NA,NA,NA,3.9964,8.3325,0.2713,6.8713,0.292,-84.389,0.9663,5.4962,0.4244,5.581,0.5009,0.9851,1.8700985,4.56151238,5.67625827,0.3809798206666667,0.350664665,1.1742,4.1102,0.5345,4.3827,0.6332,0.9888,0.112,0.418,0.472,0.012,1.813,151.08333333333331,488,1.4459259259259258,1,0,0,1,FALSE,FALSE,FALSE
226,2021-11-13T01:59:48Z,1,1.7777777777777777,864,6,1,2,3,3,3,3,3,2,4,3,3,3,1,1,2,2,3,4,1,1,2,4,3,3,0,2,0,2,3,2,1,3,3,4,3,3,3,5,3,4,4,2,3,3,3,4,5,5,4,3,3,3,1,3,3,1,1,1,1,4,1,3,2,5,3,1,1,1,1,2.625,0,1,0,3.3333333333333335,0,3.2222222222222223,0,3.9166666666666665,0,2.5,0,1.2857142857142858,0,3.3333333333333335,0,3.027027027027027,0,0,0,2,0.8716172264644607,1.0038269001101612,-0.3843414734796514,0.3097427133152549,3,3,2,3,3,4,3,3.2857142857142856,0,2,0.8333440732100549,3,2,3,3,2,2,4,2.4285714285714284,0,3.5714285714285716,1.5194825076544112,0,2,3,2,4,3,2,5,2,2,5,1,5,2,4,4,1,5,2,3,2,2.8,0,4.6,0,4.4,0,4,0,4.333333333333333,0,1,1,3,2,2,3,2,2,1,1,4,2,1,4,3,2,2,4,3,2,2.45,0,"Hispanic of Latino (e.g., Mexican American, Central American, and others) & White, Caucasian, Anglo, European American",1,25,1,2,NA,5,2,0,0,1,0,0,TRUE,TRUE,TRUE,TRUE,TRUE,0,1,0.9855026315764377,0.76,0.0942921050172971,1,0.4936281250566244,0.6007483871675307,1,0.96875,0.004318765958518769,0.008364279350645001,1,0.7302437499910593,0.774546875,1,1,0.02344674964503584,0.022225762561946992,1.4515,0.8377,0.5106,1.2144,1.0742,0.6256,0.3625,1.4771320233333334,0.8675384196666667,0.5018013833333334,1.0351,4.5264,0.3793,3.5334,0.4601,-80.2781,0.905,5.0731,0.4067,5.2178,0.504,0.9404,1.3011347193333334,3.8016351266666666,4.931132026666667,0.43670308966666666,0.3629666716666667,1.0323,3.1887,0.5688,2.3227,0.6174,0.9369,0.164,0.382,0.449,0.041,0.951,23.19512195121951,346,1.0251851851851852,1,0,0,1,FALSE,FALSE,FALSE
227,2021-11-13T02:17:50Z,1,1.6,1120,6,3,4,5,2,4,2,1,5,2,1,2,2,4,3,4,5,2,3,1,1,2,3,2,3,0,2,0,0,5,5,5,5,5,5,5,5,5,1,5,3,1,5,2,5,2,3,3,3,2,4,1,1,1,1,1,1,1,1,1,1,1,1,1,1,1,1,1,1,1,2.125,0,1,0,1.7333333333333334,0,1,0,1.9166666666666667,0,1,0,1.4285714285714286,0,1,0,1.4324324324324325,0,0,0,0,-0.43123835418962103,-0.5839199075668012,-0.7372407672780129,-0.6605803374224071,4,1,4,1,1,1,1,1.2857142857142858,0,1,-0.7321841937363471,5,5,5,5,5,5,1,5,0,1,-1.869097951893479,0,3,3,3,4,3,4,4,4,3,2,3,3,4,NA,3,3,3,3,4,4,3.2,0,2.8,0,3,0,2.5,1,2.7857142857142856,1,3,3,2,4,2,2,3,3,1,1,2,3,2,1,1,3,1,1,1,2,1.75,0,"White, Caucasian, Anglo, European American",0,28,1,2,NA,5,2,0,0,1,0,0,TRUE,TRUE,TRUE,TRUE,TRUE,0,2,0.7125236842105851,0.76,0.011891760918397597,2,0.4962000000001242,0.5342827586204071,0.967741935483871,0.9354838709677419,0.0036084853978364875,0.004851351957001301,2,0.6160967741937887,0.7310586206898864,0.96875,0.90625,0.030248626522096256,0.02197715934463918,1.0271,1.2267,0.4819,0.7369,1.7498,0.5868,0.1275,1.086882979,1.09491188,0.47458154966666666,1.2925,4.1167,0.3543,2.7556,0.3213,-55.1187,0.747,9.3696,0.4514,6.6997,0.4742,0.9977,1.404682724,3.01259,4.285225323333333,0.3158881843333333,0.3461788396666667,1.3204,2.7751,0.3859,2.5241,0.5025,0.8269,0.067,0.362,0.22,0.011,1.63,148.1818181818182,440,1.3037037037037038,1,0,1,2,FALSE,FALSE,FALSE
228,2021-11-13T02:16:07Z,1,1.6,1050,4,3,4,5,3,5,2,2,5,2,2,1,1,5,2,5,4,2,2,1,1,1,1,3,2,0,3,0,0,5,4,3,3,4,5,5,5,5,1,5,1,1,4,3,2,1,1,1,1,2,5,1,1,1,1,1,1,1,2,2,5,1,1,1,1,1,1,1,1,1,1.625,0,1,0,1.6,0,1.6666666666666667,0,1.5833333333333333,0,0.8333333333333334,0,1.1428571428571428,0,1,0,1.4054054054054055,0,0,0,0,-0.7590536293219384,-0.8677088395412498,-0.7372407672780129,-0.8024748034096314,5,1,4,1,1,1,1,1.1428571428571428,0,1,-0.8176513788914915,5,5,5,5,4,3,1,4.571428571428571,0,1.4285714285714286,-1.0219528370065065,0,2,2,1,1,1,1,5,1,1,4,1,5,1,5,5,2,5,2,5,3,1.4,0,4.8,0,4.6,0,4.6,0,4.666666666666667,0,2,1,2,1,1,2,1,2,2,1,1,1,1,2,1,2,2,2,2,1,1.9,0,"Hispanic of Latino (e.g., Mexican American, Central American, and others)",0,19,1,2,NA,5,2,0,0,1,0,0,TRUE,TRUE,TRUE,TRUE,TRUE,0,5,1.1306166666717756,0.84,0.1954200055366425,5,0.5873312499858439,0.700725806443922,1,1,0.003334253186384315,0.00785358664536801,5,0.7354718750044703,0.8964937500059604,1,1,0.012449267893556578,0.03610095931633496,1.6532,1.0297,0.586,1.5125,1.1688,0.6314,0.0184,1.6376348233333333,0.98541168,0.5760593403333333,2.9206,7.3799,0.3895,5.6499,0.4423,-79.8733,1.014,6.6067,0.5073,3.789,0.5793,0.969,2.1384953033333334,4.48153945,5.791334523333333,0.464936987,0.40720490233333334,1.4313,4.1479,0.5585,2.3244,0.6188,0.9584,0.125,0.462,0.423,0.013,1.731,133.15384615384616,449,1.3303703703703704,1,0,0,1,FALSE,FALSE,FALSE
229,2021-11-13T02:04:49Z,1,1.6,900,6,3,4,4,2,5,2,1,4,2,2,1,2,5,2,5,5,1,1,1,1,1,1,2,2,5,2,0,0,5,5,5,5,5,5,4,5,4,1,4,1,1,5,1,5,1,1,1,2,2,5,1,3,1,3,1,2,4,4,2,5,1,1,1,1,1,2,2,3,3,1.25,0,2.5,0,1.6,0,1.2222222222222223,0,1.25,0,1.5,0,2,0,1,0,1.4594594594594594,0,3,0,0,-0.9586847263576442,-1.0056349064115053,0.3424438704149829,-0.3315955179982612,5,1,4,1,1,2,1,1.2857142857142858,0,1,-0.7321841937363471,5,5,5,5,3,3,1,4.428571428571429,0,1.5714285714285714,-1.3043345419688306,0,2,3,2,2,2,2,4,2,2,3,2,4,3,4,3,3,4,1,4,3,2.2,0,4.2,0,3.4,0,3.6,0,3.7333333333333334,0,1,1,2,2,2,2,2,2,1,2,1,3,1,2,1,2,2,2,1,1,1.75,0,"White, Caucasian, Anglo, European American",0,22,1,2,NA,5,2,0,1,0,0,1,TRUE,TRUE,TRUE,TRUE,TRUE,0,1,0.9893949999988079,0.8163265306122449,0.11095581349782109,1,0.4568062499947846,0.5722968749981373,1,1,0.002126288991715513,0.005511995151383017,1,0.6178937500081957,0.7629172413780771,1,0.9354838709677419,0.00440095157294407,0.012453426257434164,1.6282,0.9354,0.4757,1.5748,0.921,0.4826,0.1323,1.6061312233333334,0.9202422033333333,0.47121087066666667,3.7126,9.8389,0.2681,6.6721,0.2941,-93.3326,0.8017,6.6463,0.3982,4.4169,0.4939,0.9885,1.6370470383333333,4.3802986766666665,6.317514943333333,0.38860400466666667,0.333440444,1.0355,4.2982,0.5108,3.7812,0.6224,0.9678,0.069,0.486,0.493,0.012,1.797,149.75,104,0.3081481481481481,1,0,0,1,FALSE,FALSE,FALSE
230,2021-11-13T02:06:42Z,1,1.7786458333333333,768,3,2,3,3,3,4,2,1,2,3,3,2,3,3,2,3,1,3,3,2,4,2,2,2,3,8,2,2,0,5,1,2,3,2,5,5,5,2,3,2,3,3,3,1,3,3,4,4,5,5,2,3,5,1,3,4,1,3,1,1,4,1,2,2,3,1,1,2,1,1,2.625,0,1.25,0,2.8,0,2.6666666666666665,0,3.4166666666666665,0,3.1666666666666665,0,1.4285714285714286,0,2,0,2.7567567567567566,0,4,2,0,0.7035068289607077,0.6584793867115141,0.5667967458113412,0.6126380662614277,5,1,4,2,1,3,2,1.7142857142857142,0,1,-0.4757826382709144,1,3,3,3,1,1,3,2.142857142857143,0,3.857142857142857,1.8018642126167355,0,3,3,3,4,2,2,5,3,3,3,2,4,3,4,5,2,5,2,4,2,3,0,4.2,0,3.8,0,3.8,0,3.933333333333333,0,3,2,3,1,3,3,1,1,3,3,3,3,3,2,1,3,2,2,2,2,2.5,0,"White, Caucasian, Anglo, European American",0,18,1,2,NA,5,2,0,0,1,0,0,TRUE,TRUE,TRUE,TRUE,TRUE,0,2,1.0244161290324503,0.62,0.24425956908448498,2,0.5522290322607564,0.6352700000007947,0.96875,0.9375,0.00882873168318735,0.009135435323383524,2,0.7601124999988824,0.7580531249959022,1,1,0.019128275322221774,0.01372678127898969,1.6874,0.3002,0.3262,1.5462,0.3714,0.4015,0.1181,1.6496927766666667,0.45138305615,0.32860534333333336,1.5069,3.0874,0.3174,2.595,0.3723,-35.4375,0.8314,4.2889,0.4597,3.1779,0.5329,0.9973,1.6283448666666667,2.8056534033333334,3.3597587066666668,0.3628681006666667,0.3098109846666667,1.1196,2.477,0.5899,3.3038,0.6019,0.9976,0.195,0.356,0.489,0.175,1.708,9.76,334,0.9896296296296296,1,0,0,1,FALSE,FALSE,FALSE
231,2021-11-13T02:12:17Z,0.8999999761581421,1.7786458333333333,768,4,3,5,5,1,5,1,1,5,1,1,1,1,5,1,5,5,1,1,1,1,1,1,1,1,0,2,0,0,5,5,5,5,5,5,3,3,5,2,5,1,1,5,1,5,1,1,1,1,1,5,1,1,1,1,1,1,1,1,1,5,1,1,1,1,1,2,1,1,1,1,0,1.25,0,1,0,1.4444444444444444,0,1.0833333333333333,0,0.8333333333333334,0,0.8571428571428571,0,1,0,1.135135135135135,0,0,0,0,-1.3159193210531184,-1.5102991258230931,-0.6588395645607719,-1.0845693451919325,5,1,2,1,1,1,1,1.4285714285714286,0,1,-0.6467170085812028,5,5,5,5,2,2,3,3.857142857142857,0,2.142857142857143,0.9547190977297628,0,2,2,2,1,2,1,3,1,1,2,1,3,1,3,5,3,4,1,3,3,1.8,0,4.4,0,3.2,0,4.2,0,3.933333333333333,0,1,1,2,1,2,3,2,1,1,1,2,2,1,3,1,2,1,3,2,1,2.05,0,"White, Caucasian, Anglo, European American",0,20,1,2,NA,5,2,0,0,1,0,0,TRUE,TRUE,TRUE,TRUE,TRUE,0,4,0.8106744186046512,0.86,0.019095920000000002,4,0.57525,0.7154838709677419,1,1,0.01690406451612903,0.04083399139784946,4,1.17159375,1.3179666666666667,1,0.9375,0.31962850705645157,0.33897785383064516,1.2776,1.5894,0.5048,0.9017,2.485,0.6502,0.3698,1.3014540866666666,1.3029737843333333,0.4970222856666667,1.6517,3.9704,0.3673,2.8732,0.428,-45.941,1.1902,4.3221,0.4154,3.1742,0.5043,0.668,1.89030711,3.07159463,4.181618106666667,0.401954228,0.3472526083333333,2.3337,1.328,0.3691,1.271,0.4539,0.8511,0.125,0.378,0.142,0.182,1.835,10.082417582417582,104,0.3081481481481481,1,0,0,1,FALSE,FALSE,FALSE
232,2021-11-13T02:08:42Z,1,1.6,900,6,3,4,4,3,4,3,2,4,2,3,2,2,4,2,4,4,2,3,1,1,1,2,2,2,3,2,0,0,4,4,4,4,4,5,4,5,5,1,5,3,1,4,2,4,2,2,2,3,3,4,1,1,1,3,1,1,3,3,2,4,3,2,1,1,1,1,1,2,2,1.75,0,1.5,0,2.2,0,1.6666666666666667,0,2,0,1.3333333333333333,0,2.142857142857143,0,1,0,1.8108108108108107,0,2,0,0,-0.4291369742208243,-0.3819187134908551,-0.17425341425049792,-0.2780860638706765,5,2,4,2,1,2,2,1.7142857142857142,0,1,-0.4757826382709144,5,5,5,5,3,3,2,4.285714285714286,0,1.7142857142857142,-1.3043345419688306,0,2,2,2,3,2,2,3,3,2,3,2,4,2,4,4,3,4,2,3,3,2.2,0,4,0,3.2,0,3.6,0,3.6,0,2,2,1,4,2,2,3,3,2,3,3,2,2,4,1,2,1,4,2,3,2.3,0,"White, Caucasian, Anglo, European American",0,29,1,2,NA,5,2,0,0,2,0,0,TRUE,TRUE,TRUE,TRUE,TRUE,0,3,1.069666363632264,0.88,0.0986212675150723,3,0.554894687498745,0.61652281249917,1,1,0.0031322673699691874,0.004903464824323174,3,0.658517258065272,0.7557115624986182,1,1,0.010733075964217142,0.02526843082956429,1.7991,1.2104,0.5276,1.0431,1.5882,0.8484,0.4681,1.7049648533333333,1.080279548,0.5261411673333334,10,11.6948,0.1274,9.7776,0.1051,-86.5751,0.8263,5.6852,0.486,5.0729,0.548,0.8882,2.1654933333333335,4.603525846666667,5.849410726666667,0.38487168066666666,0.37451530466666666,1.0291,5.5533,0.5621,3.4483,0.6243,0.9659,0.132,0.377,0.453,0.018,1.546,85.8888888888889,422,1.2503703703703704,1,0,0,1,FALSE,FALSE,FALSE
233,2021-11-13T02:21:22Z,1,1.7777777777777777,1080,6,3,3,4,4,3,2,1,3,1,2,1,1,2,2,3,2,3,5,5,5,3,5,3,3,3,3,0,3,4,4,4,4,2,1,5,5,1,1,3,2,1,3,3,4,1,5,5,5,3,1,5,4,1,4,3,3,3,3,3,3,2,1,1,1,3,1,4,1,2,4,0,2,0,2.4,0,2.6666666666666665,0,2.8333333333333335,0,3.5,0,2.4285714285714284,0,1.6666666666666667,0,2.7837837837837838,0,2,0,3,1.5755795160114243,1.0890990860138068,0.5118979318815265,0.8004985089476666,5,1,5,1,1,2,1,1.1428571428571428,0,1,-0.8176513788914915,5,5,5,5,4,3,1,4.571428571428571,0,1.4285714285714286,-0.4571894270818581,0,1,1,1,2,1,1,5,1,1,1,1,5,3,5,3,5,5,1,5,3,1.2,0,5,0,3,0,4.2,0,4.066666666666666,0,4,4,4,4,4,4,4,1,4,4,4,2,3,4,2,2,4,4,1,4,3.45,0,"Hispanic of Latino (e.g., Mexican American, Central American, and others) & Filipino",1,28,1,3,NA,5,2,0,0,1,0,0,TRUE,TRUE,TRUE,TRUE,TRUE,0,5,0.6544822222206328,0.9,0.01555185211864936,5,0.42443870967145886,0.4910093749985099,1,1,0.0027545097848164966,0.003966044102519511,5,0.5590906249955296,0.6420166666636864,1,0.9375,0.007960774425874863,0.007670845231631474,1.3095,1.9719,0.3992,0.9309,2.3415,0.5045,0.1737,1.288800756,1.468952486,0.39362922433333336,2.7157,8.2757,0.2604,6.6703,0.2874,-94.7776,0.9713,5.0416,0.3322,6.275,0.4134,0.9968,1.5342234616666666,4.696297933333334,6.010467403333333,0.33257971933333336,0.3022109686666667,0.9414,3.7809,0.443,4.4246,0.5339,0.9706,0.071,0.417,0.581,0.019,2.02,106.31578947368422,358,1.0607407407407408,1,0,1,2,FALSE,FALSE,FALSE
234,2021-11-13T02:18:59Z,0.8999999761581421,1.6,900,3,4,4,5,2,5,2,1,4,2,2,2,1,4,2,5,4,2,2,1,1,1,1,1,1,0,2,0,0,5,1,4,4,4,4,4,4,3,2,4,2,1,3,2,5,1,1,1,1,1,4,1,1,1,1,1,1,1,1,1,5,1,1,1,1,1,1,1,1,1,1.25,0,1,0,1.6666666666666667,0,2.3333333333333335,0,1.5,0,1,0,0.8571428571428571,0,1,0,1.5135135135135136,0,0,0,0,-0.9250626468568939,-0.9537553472238163,-0.7372407672780129,-0.8454980572509145,5,2,4,1,1,2,1,1.4285714285714286,0,1,-0.6467170085812028,5,5,5,5,4,4,1,4.714285714285714,0,1.2857142857142858,-1.3043345419688306,0,1,1,2,3,2,2,5,2,2,3,1,4,1,4,4,4,4,1,4,4,1.8,0,4.4,0,3.8,0,3.6,0,3.933333333333333,0,2,4,2,2,1,2,2,2,2,3,3,3,2,3,1,3,1,3,2,1,2.2,0,"White, Caucasian, Anglo, European American",0,19,1,2,NA,5,2,0,0,1,0,0,TRUE,TRUE,TRUE,TRUE,TRUE,0,2,0.6201081081081097,0.7551020408163265,0.026753752551019833,2,0.44229032258064516,0.480064516129036,0.96875,0.96875,0.004234435483870781,0.00683478931451541,2,0.5645806451612885,0.6789230769230702,0.96875,0.8125,0.012001361895160555,0.01785941028225734,1.0159,1.1417,0.3886,0.9338,1.4126,0.409,0.0976,1.0782614873333334,1.0518120526666668,0.38122254733333333,1.0404,4.0444,0.3215,3.5391,0.3409,-75.5592,0.9032,4.2183,0.3378,3.076,0.357,0.7859,1.14560807,3.73144423,4.286629143333333,0.334301721,0.314971313,0.9725,4.9997,0.4589,1.898,0.5089,0.9256,0.054,0.403,0.34,0.006,1.304,217.33333333333334,431,1.2770370370370372,1,0,0,1,FALSE,FALSE,FALSE
235,2021-11-13T02:08:34Z,1,1.7777777777777777,1080,6,3,1,3,2,3,2,1,4,2,1,1,1,4,3,4,2,3,1,2,4,2,1,4,2,7,2,0,0,4,1,1,1,1,5,3,5,2,3,4,1,1,1,1,1,5,1,1,2,4,4,1,1,3,4,2,1,5,2,2,3,4,2,1,3,1,4,2,2,2,2.375,0,2.5,0,2.2666666666666666,0,3.4444444444444446,0,2.5833333333333335,0,2,0,2.5714285714285716,0,1.6666666666666667,0,2.675675675675676,0,4,0,0,0.4975715920186112,0.28699851327429293,0.5455363442114993,0.41626742874289613,5,1,3,1,1,2,1,1.4285714285714286,0,1,-0.6467170085812028,3,4,5,2,1,1,2,2.857142857142857,0,3.142857142857143,0.9547190977297628,0,3,5,2,2,3,3,1,4,2,1,3,3,2,1,4,5,3,1,1,4,3,0,3.4,0,1.6,0,2.6,0,2.533333333333333,0,1,1,2,3,4,2,2,2,1,1,1,2,3,3,1,2,1,2,4,3,2.15,0,"White, Caucasian, Anglo, European American",0,23,1,2,NA,5,2,0,0,0,0,0,TRUE,TRUE,TRUE,TRUE,TRUE,0,4,0.9634609756106284,0.82,0.12097707296318083,4,0.4173193548389019,0.49880333333363136,0.96875,0.9375,0.004922165070588962,0.005967858709707,4,0.5869312499999069,0.6588899999981125,1,0.9375,0.0093539344756045709,0.007853179102718384,1.4616,1.047,0.5355,1.4225,1.1637,0.5292,0.0376,1.4863614266666667,0.9988774966666667,0.52515695,1.2777,3.0971,0.2202,3.1156,0.3168,-50.2364,0.732,4.2208,0.3516,3.9531,0.4188,0.9792,1.3517372326666666,3.290379836666667,3.3851860566666665,0.3131414943333333,0.21824628866666668,0.84,3.0573,0.4774,3.2508,0.5619,0.8887,0.075,0.407,0.477,0.018,2.168,120.44444444444446,432,1.28,1,0,1,2,FALSE,FALSE,FALSE
236,2021-11-13T02:01:44Z,1,1.7777777777777777,900,6,2,2,4,5,2,5,4,3,5,5,2,4,2,2,3,3,4,4,5,3,1,4,5,3,7,1,2,0,4,2,3,4,4,4,1,3,2,1,4,5,1,3,3,5,5,5,5,5,1,1,4,3,1,5,1,1,3,2,2,3,5,3,1,3,1,2,3,2,1,3.625,0,2,0,3.6666666666666665,0,3,0,3.0833333333333335,0,3,0,2.5714285714285716,0,1.6666666666666667,0,2.891891891891892,0,4,2,0,1.4095704984764685,1.5187508830924488,0.8020003539630645,1.1603756185277567,5,1,3,1,1,2,2,1.5714285714285714,0,1,-0.5612498234260587,3,4,5,3,1,1,4,2.7142857142857144,0,3.2857142857142856,0.9547190977297628,0,2,2,2,2,2,2,4,2,2,3,1,4,1,4,3,4,4,1,3,2,2,0,4.4,0,3.4,0,3.8,0,3.8666666666666667,0,1,2,1,4,3,1,4,3,1,1,1,3,3,1,1,4,1,1,1,4,1.65,0,"White, Caucasian, Anglo, European American",0,30,1,2,NA,5,2,0,0,0,0,0,TRUE,TRUE,TRUE,TRUE,TRUE,0,6,0.7886268292636406,0.8367346938775511,0.055620091524215515,6,0.5730062500238419,0.625453125,1,1,0.0020025522190909232,0.0035778819231876255,6,0.6352937500029803,0.704393750011921,1,1,0.004009750284980689,0.00630877866434605,1.2041,1.3703,0.5362,0.9837,1.2441,0.606,0.1867,1.25977145,1.1925679033333334,0.524897815,9.9999,14.0289,0.2166,11.1484,0.177,-100.9895,0.8733,8.6921,0.5218,7.0941,0.564,0.979,2.175113006666667,4.925034853333333,6.738810333333333,0.41006016866666667,0.4183163733333333,0.7045,4.6568,0.58,3.8683,0.6277,0.7615,0.093,0.464,0.53,0.023,1.757,76.39130434782608,368,1.0903703703703704,1,0,0,1,FALSE,FALSE,FALSE
237,2021-11-13T01:46:18Z,1,1.6,900,7,3,4,4,2,4,3,1,4,1,1,1,1,4,1,4,2,2,2,1,1,1,3,1,2,2,2,0,5,4,2,2,2,3,4,2,4,2,1,4,2,1,3,2,2,1,1,1,1,1,3,3,1,1,2,1,1,1,1,1,4,1,1,1,1,1,2,3,3,1,1.625,0,2.25,0,1.8,0,3.2222222222222223,0,1.6666666666666667,0,1.6666666666666667,0,1,0,1,0,1.9189189189189189,0,1,0,5,-0.4396438740648087,-0.5610774150886396,0.7401059546006128,0.08951426975598659,4,2,2,1,2,3,2,2.2857142857142856,0,2,0.2350737771240448,4,5,5,4,2,3,2,3.857142857142857,0,2.142857142857143,-0.7395711320441822,0,3,2,3,4,3,2,4,1,1,2,1,2,1,4,4,2,3,1,4,4,3,0,3.8,0,3.8,0,4,0,3.8666666666666667,0,2,1,3,3,2,3,2,2,3,2,3,1,3,4,1,2,2,1,1,1,2.3,0,Black or African American,0,25,1,2,NA,5,2,0,0,2,0,0,TRUE,TRUE,TRUE,TRUE,TRUE,0,NA,NA,NA,NA,4,0.7549893548383543,0.8192779310323611,1,0.9666666666666667,0.07044758764620904,0.05610120158792292,NA,NA,NA,NA,NA,NA,NA,NA,NA,NA,NA,NA,NA,NA,NA,NA,NA,1.9795,2.342,0.3324,2.3088,0.4082,-6.4108,1.5138,1.9392,0.4093,2.7915,0.5291,0.9654,2.06297478,2.4069185366666668,2.51493083,0.3921042596666667,0.32277575000000003,NA,NA,NA,NA,NA,NA,NA,NA,NA,NA,NA,NA,104,0.3081481481481481,1,0,1,2,FALSE,FALSE,FALSE
238,2021-11-13T02:04:18Z,1,1.6,900,4,3,3,4,3,4,3,3,4,3,2,2,2,4,2,4,1,2,2,1,1,2,3,3,3,0,2,0,0,4,2,3,3,2,4,4,4,2,3,3,4,1,4,1,4,3,3,4,4,4,3,1,1,1,3,3,1,1,1,1,4,3,2,1,1,2,2,2,1,1,2.125,0,1.5,0,2.533333333333333,0,2.888888888888889,0,2.8333333333333335,0,1.8333333333333333,0,1.4285714285714286,0,1.3333333333333333,0,2.3513513513513513,0,0,0,0,0.14033699732313704,0.1547830695235775,-0.5804383618435307,-0.2128276461599766,4,1,3,1,1,1,1,1.4285714285714286,0,1,-0.6467170085812028,4,4,4,4,2,2,3,3.2857142857142856,0,2.7142857142857144,-1.0219528370065065,0,2,2,3,3,3,3,3,3,2,2,1,4,3,3,4,3,3,2,4,4,2.6,0,3.8,0,3,0,3.2,0,3.3333333333333335,0,2,3,1,3,1,1,2,3,1,2,2,4,2,2,1,4,1,1,1,2,1.55,0,"White, Caucasian, Anglo, European American",0,21,1,2,NA,5,2,0,1,1,0,1,TRUE,TRUE,TRUE,TRUE,TRUE,0,3,0.9257973684072495,0.76,0.12057794890823108,3,0.4225437499880791,0.5058406250178814,1,1,0.003116290925606605,0.002508605069581655,3,0.6113812500089407,0.6897124999985099,1,1,0.0077185377040995705,0.008285146286663584,1.7241,0.7397,0.3581,1.2224,0.7829,0.5616,0.1391,1.6780474633333333,0.775491424,0.35713746133333335,1.7482,6.8516,0.295,6.7118,0.3756,-104.7027,0.5179,5.405,0.3813,5.9629,0.4684,0.9938,1.3836433993333332,5.3891228133333335,5.68996647,0.3840619276666667,0.3055133976666667,0.9316,4.1042,0.5178,4.3428,0.586,0.8849,0.151,0.346,0.56,0.017,1.555,91.4705882352941,434,1.285925925925926,1,0,0,1,FALSE,FALSE,FALSE
239,2021-11-13T02:18:44Z,1,1.6,800,6,4,4,4,2,4,3,2,1,3,1,1,4,4,3,3,3,1,4,1,1,1,2,4,1,0,2,1,1,4,2,4,4,3,5,3,3,3,1,4,1,1,5,3,5,4,3,2,5,5,1,5,1,1,2,1,1,1,2,1,4,2,3,1,2,1,1,1,1,1,1.875,0,1,0,2.533333333333333,0,2.5555555555555554,0,2.4166666666666665,0,2.3333333333333335,0,1.5714285714285714,0,1.3333333333333333,0,2.2432432432432434,0,0,1,1,-0.08240927936933427,8.866159630821409e-4,-0.35415791278580844,-0.17663564841136314,4,2,2,1,1,2,1,1.8571428571428572,0,1,-0.39031545311577004,4,4,4,4,3,3,3,3.5714285714285716,0,2.4285714285714284,-1.3043345419688306,0,2,3,3,3,2,2,5,1,3,3,1,5,1,4,3,1,4,1,5,3,2.6,0,4.6,0,4.6,0,3.6,0,4.266666666666667,0,2,1,1,4,3,1,2,3,1,3,3,4,1,2,1,4,1,2,3,2,1.7,0,"Black or African American & White, Caucasian, Anglo, European American",1,28,1,2,NA,5,2,0,0,1,0,0,TRUE,TRUE,TRUE,TRUE,TRUE,0,3,1.0176128205141195,0.78,0.0657823271676161,3,0.4940656249993481,0.5690967741930677,1,1,0.0018558849093099673,0.004032065656008508,3,0.7163656250028871,0.7935838709694724,1,0.96875,0.014094322973514577,0.012728039022174661,1.4418,0.9315,0.6469,1.1072,0.8204,0.7809,0.2284,1.4792976233333333,0.925868051,0.6337359306666667,10,13.9973,0.1369,10.7711,0.1049,-97.9907,0.7984,6.7818,0.4356,5.4781,0.5004,0.961,1.89640192,4.817629453333334,6.498070893333334,0.37669935866666665,0.354502334,0.9724,2.6502,0.5859,3.7641,0.678,0.958,0.099,0.442,0.389,0.011,1.598,145.27272727272728,370,1.0962962962962963,1,0,0,1,FALSE,FALSE,FALSE
240,2021-11-13T02:23:21Z,1,1.7777777777777777,1080,4,3,1,2,5,2,5,5,1,5,4,5,5,2,1,1,1,5,5,4,3,5,5,5,5,3,2,0,0,1,1,3,2,2,2,3,4,3,4,3,4,2,3,4,1,5,5,5,5,5,1,1,1,1,3,1,4,2,3,3,2,5,4,2,2,4,4,5,2,2,4.625,0,3.25,0,4.466666666666667,0,3.6666666666666665,0,4.166666666666667,0,1.8333333333333333,0,3.4285714285714284,0,2.6666666666666665,0,3.4594594594594597,0,2,0,0,2.3846108039982328,2.5362097005942914,0.3745550047701899,1.4553823526822407,3,3,1,2,2,4,4,3.2857142857142856,0,2.5,1.017837910597246,4,4,3,1,3,1,3,2.7142857142857144,0,3.2857142857142856,0.38995568780511447,0,5,5,5,5,5,5,4,3,4,2,1,3,4,3,5,1,5,1,3,2,5,0,3.8,0,3.2,0,3.4,0,3.466666666666667,0,2,4,2,3,4,3,2,3,2,3,3,2,1,2,1,3,1,3,4,2,2.4,0,"White, Caucasian, Anglo, European American",0,21,1,1,NA,5,2,0,0,1,0,0,TRUE,TRUE,TRUE,TRUE,TRUE,0,2,0.8516031249989755,0.64,0.019855455203991745,2,0.5312645161300897,0.6135806451612903,0.96875,0.96875,0.005594821925409284,0.011031281129233402,2,0.6608806451602328,0.740516129030816,1,0.96875,0.015291983612698519,0.012652952903174218,1.0765,0.6551,0.6107,0.9439,0.4777,0.6609,0.1186,1.1631643153333333,0.7310491586666666,0.5773107566666666,1.1158,4.1225,0.4057,2.7518,0.4199,-61.8772,1.2342,4.73,0.3969,4.0891,0.4641,0.9628,1.3272415916666667,3.087918753333333,4.38099816,0.403480939,0.388887588,1.207,2.5246,0.4677,4.3068,0.5996,0.9621,0.084,0.435,0.406,0.013,1.689,129.92307692307693,342,1.0133333333333332,1,0,0,1,FALSE,FALSE,FALSE
241,2021-11-13T02:22:28Z,0.8999999761581421,1.7786458333333333,768,5,2,4,4,2,4,4,3,2,2,3,2,1,3,2,4,3,3,1,1,1,2,3,3,1,0,2,0,0,4,2,2,4,4,4,5,5,5,3,5,4,1,3,1,5,2,3,3,4,3,5,1,1,1,1,1,1,1,1,1,4,2,1,1,2,1,2,2,2,2,1.875,0,2,0,2.466666666666667,0,2.111111111111111,0,2.4166666666666665,0,0.8333333333333334,0,1.1428571428571428,0,1.3333333333333333,0,1.8108108108108107,0,0,0,0,-0.3513859153753388,-0.21360051679796055,-0.4236359564090485,-0.3186182366035045,5,1,3,1,1,1,1,1.2857142857142858,0,1,-0.7321841937363471,3,3,3,3,1,1,3,2.4285714285714284,0,3.5714285714285716,0.9547190977297628,0,2,3,3,2,3,3,4,3,4,3,1,4,2,3,4,4,4,3,4,4,2.6,0,3.8,0,3.4,0,2.8,0,3.3333333333333335,0,1,1,1,3,2,1,3,4,1,1,2,4,2,1,1,4,1,1,2,1,1.35,0,"Hispanic of Latino (e.g., Mexican American, Central American, and others)",0,21,0,1,NA,5,2,0,0,3,0,0,TRUE,TRUE,TRUE,TRUE,TRUE,0,2,0.9006148936170887,0.94,0.08731398942447088,2,0.5354906249999185,0.6131533333333209,1,0.9375,0.002633995715728666,0.004644123538317816,2,0.6784031249999826,0.7739093749999884,1,1,0.020390248699619265,0.006621515070567468,1.7971,1.7144,0.4363,1.5872,1.9912,0.5086,0.1937,1.6394808966666667,1.357258799,0.438958544,1.0989,4.5851,0.4157,3.4302,0.4687,-77.5887,0.732,6.7223,0.4853,5.3088,0.5401,0.9552,1.3384124676666667,3.6596195266666665,4.91544345,0.448123506,0.40073337633333334,1.0842,2.7955,0.5044,4.5008,0.6596,0.9893,0.18,0.341,0.564,0.009,1.495,166.11111111111114,104,0.3081481481481481,1,1,1,2,FALSE,FALSE,FALSE
242,2021-11-13T02:06:03Z,1,1.7777777777777777,864,4,3,3,5,2,4,2,2,1,3,2,1,2,4,5,3,4,2,4,1,1,2,3,3,2,0,3,2,0,5,2,1,5,5,4,1,1,3,2,5,5,1,2,3,4,5,2,2,2,1,3,5,1,1,2,1,1,1,5,5,5,1,1,1,1,2,1,2,3,2,2.25,0,2,0,2.466666666666667,0,3,0,2.5,0,2,0,2,0,1.3333333333333333,0,2.4054054054054053,0,0,2,0,0.2517101356693733,0.20308139048375845,-0.010369541223001058,0.0963559246303787,3,3,2,3,1,4,5,3.2857142857142856,0,4,1.5713194227588192,5,5,5,5,3,3,1,4.428571428571429,0,1.5714285714285714,1.237100802692087,0,2,2,2,1,2,2,4,3,2,5,4,2,1,3,3,2,3,1,2,3,1.8,0,3.2,0,4,0,3.2,0,3.466666666666667,0,2,4,1,3,1,1,2,1,1,1,1,3,2,1,1,3,1,1,1,2,1.65,0,"Hispanic of Latino (e.g., Mexican American, Central American, and others)",0,19,0,1,NA,5,2,0,0,1,0,0,TRUE,TRUE,TRUE,TRUE,TRUE,0,4,0.9238948717965529,0.7959183673469388,0.03817075514506781,4,0.40530645161290324,0.49132187500130386,1,1,0.0011468132904558566,0.0019122546674802778,4,0.5605906249992549,0.6586593749979511,1,1,0.009375988619329338,0.0121988779738501,1.4049,1.0646,0.5479,1.0737,1.1171,0.6909,0.1913,1.43689042,1.008580415,0.538275624,2.5843,10.8809,0.2866,8.749,0.3436,-121.2752,0.6761,6.9409,0.3554,8.1563,0.4499,0.9652,1.3132371123333333,5.458829416666667,6.900084883333333,0.3778134516666667,0.31811406966666667,1.0885,3.1971,0.4148,3.2969,0.5083,0.8932,0.151,0.274,0.546,0.017,1.81,106.47058823529412,350,1.0370370370370372,1,0,0,1,FALSE,FALSE,FALSE
243,2021-11-13T02:27:37Z,1,1.5,1024,4,3,4,4,3,3,4,2,2,3,3,4,2,2,3,4,4,2,3,1,1,1,2,3,1,3,2,0,0,4,3,3,3,3,4,3,4,4,3,4,2,1,4,3,4,4,4,2,4,4,3,1,1,1,3,1,1,3,4,4,4,3,2,1,2,1,3,1,3,2,1.75,0,2.25,0,2.8666666666666667,0,2.5555555555555554,0,2.75,0,1.5,0,2.5714285714285716,0,1.3333333333333333,0,2.4054054054054053,0,2,0,0,-0.05929409971256879,0.16010653175365794,0.06095019390122543,0.11052836282744169,4,2,4,1,1,1,3,1.7142857142857142,0,1,-0.4757826382709144,4,3,4,4,2,2,1,3.4285714285714284,0,2.5714285714285716,-0.7395711320441822,0,3,4,3,2,2,3,3,2,2,3,4,3,3,3,5,4,4,3,3,4,2.8,0,3,0,2.8,0,3.6,0,3.1333333333333333,0,2,3,2,2,3,3,3,3,2,2,3,4,2,3,3,2,3,2,3,4,2.6,0,"White, Caucasian, Anglo, European American",0,19,1,2,NA,5,2,0,0,1,0,0,TRUE,TRUE,TRUE,TRUE,TRUE,0,2,0.6879358974297841,0.78,0.03181262677965995,NA,NA,NA,NA,NA,NA,NA,2,0.46676451613826136,0.5624047619161152,0.96875,0.65625,0.0029551118941138817,0.012494103702223524,1.4463,0.9557,0.2873,0.906,1.0682,0.5269,0.2664,1.4511972166666667,0.9434545543333334,0.28480049366666665,NA,NA,NA,NA,NA,NA,NA,NA,NA,NA,NA,NA,NA,NA,NA,NA,NA,0.9077,7.4065,0.4046,1.2669,0.3666,0.8607,0.05,0.351,0.391,0.015,2.084,138.93333333333334,474,1.4044444444444446,1,0,0,1,FALSE,FALSE,FALSE
244,2021-11-13T02:22:29Z,1,1.6,900,5,4,5,5,1,4,1,1,5,1,1,1,1,4,1,3,4,1,1,1,1,1,2,1,1,6,2,0,0,5,5,5,5,4,5,5,5,5,1,1,1,1,3,3,4,1,1,3,5,5,5,1,1,1,5,1,1,5,5,5,5,1,1,1,1,1,2,1,4,4,1.125,0,2.75,0,1.3333333333333333,0,1.1111111111111112,0,2.5833333333333335,0,1.5,0,2.5714285714285716,0,1,0,1.972972972972973,0,3,0,0,-0.7170260299460003,-0.953271396111991,0.420845073132224,-0.2662131614898835,5,1,5,1,1,1,1,1,0,1,-0.9031185640466358,5,5,5,5,3,3,3,4.142857142857143,0,1.8571428571428572,0.10757398284279028,0,1,1,1,1,1,1,5,1,1,4,1,5,1,4,5,1,5,2,5,2,1,0,4.8,0,4.8,0,4.6,0,4.733333333333333,0,1,1,1,3,1,1,1,3,3,2,2,4,1,1,1,3,1,1,1,1,1.35,0,"White, Caucasian, Anglo, European American",0,25,1,2,NA,5,2,0,0,1,0,0,TRUE,TRUE,TRUE,TRUE,TRUE,0,2,1.4943781249970198,0.6666666666666666,0.37423102934302727,2,0.512428571407284,0.5970689655049094,0.9655172413793104,1,0.008421876624199092,0.01837147078718575,2,0.891551612896304,1.053565517232336,0.96875,0.90625,0.15346636544431413,0.22681640112450918,1.8627,0.3652,0.6199,2.0926,0.4112,0.4883,0.0037,1.81488926,0.46799694855,0.610761847,1.4532,3.2211,0.3054,3.5731,0.3937,-47.036,1.0414,3.8677,0.389,3.6727,0.4499,0.9077,1.5966671266666668,3.7277326766666667,3.530784683333333,0.38167407766666667,0.296436398,1.9995,1.7601,0.357,1.3783,0.3741,0.9876,0.098,0.371,0.148,0.018,1.65,91.66666666666667,498,1.4755555555555555,1,0,0,1,FALSE,FALSE,FALSE
245,2021-11-13T02:26:40Z,1,1.7777777777777777,1080,4,2,2,3,5,3,5,3,2,4,4,5,4,3,2,3,2,5,2,2,2,5,3,4,5,4,2,0,5,3,3,3,2,1,2,1,2,2,5,5,4,5,3,1,2,5,5,5,4,4,2,4,5,3,5,4,4,5,5,4,2,4,5,3,2,2,3,3,2,2,3.5,0,2.5,0,3.7333333333333334,0,3.888888888888889,0,3.8333333333333335,0,4,0,4.285714285714286,0,2.3333333333333335,0,3.891891891891892,0,2,0,5,1.9538279103948673,1.9234308028008964,1.0215996311143702,1.4725152169576332,2,4,2,3,3,3,4,3.5714285714285716,0,2,1.0042784435203436,2,2,3,1,2,2,3,2.142857142857143,0,3.857142857142857,2.0842459175790595,0,1,1,2,2,2,2,4,2,1,4,1,5,2,5,5,3,5,3,2,3,1.6,0,4.4,0,3.4,0,4.4,0,4.066666666666666,0,1,1,1,2,2,1,1,3,2,2,2,2,1,1,4,3,1,3,3,1,1.85,0,"Hispanic of Latino (e.g., Mexican American, Central American, and others)",0,29,0,1,NA,5,2,0,0,4,0,0,TRUE,TRUE,TRUE,TRUE,TRUE,0,3,0.9084318181818182,0.88,0.09294160040816325,3,0.41303225806451616,0.4891935483870968,0.96875,0.96875,0.002770958669354838,0.005258813508064516,3,0.6035,0.62609375,1,1,0.012131032258064518,0.011575055443548386,1.6443,1.2699,0.4373,1.4753,1.2628,0.5017,0.2209,1.5958744266666667,1.134255535,0.435473457,1.005,4.4938,0.3096,3.7986,0.3623,-84.4755,0.9464,6.0859,0.3303,5.0977,0.3903,0.8597,1.1057259713333334,3.92974985,4.682520443333333,0.355352764,0.30372509633333333,0.9583,3.622,0.4966,3.5741,0.5246,0.9512,0.287,0.092,0.555,0.109,1.669,15.311926605504588,442,1.3096296296296297,1,0,2,3,FALSE,FALSE,FALSE
246,2021-11-13T02:12:08Z,1,1.7777777777777777,864,5,2,1,2,2,2,4,4,2,4,4,2,5,1,4,1,1,1,5,5,5,5,5,5,5,4,4,4,1,1,1,1,1,1,1,1,1,1,5,2,5,5,4,5,4,5,5,5,5,5,1,5,5,5,5,5,5,5,5,5,3,2,2,5,5,5,5,5,5,5,4.5,0,5,0,4.066666666666666,0,5,0,4.416666666666667,0,4.833333333333333,0,3.7142857142857144,0,5,0,4.594594594594595,0,2,4,1,3.0129234146685078,2.7984144129813244,1.926345901062153,2.3623801570217386,4,2,3,4,1,1,1,2,0,4,0.8021147563625206,2,2,2,2,1,1,5,1.5714285714285714,0,4.428571428571429,0.9547190977297628,0,4,4,5,5,5,2,5,2,4,2,3,5,1,3,4,1,4,2,4,1,4.6,0,4,0,4.2,0,3.6,0,3.933333333333333,0,2,1,4,1,4,4,4,1,4,2,3,2,3,4,3,1,4,4,4,4,3.45,0,"White, Caucasian, Anglo, European American",0,29,1,3,NA,5,2,0,1,0,0,1,TRUE,TRUE,TRUE,TRUE,TRUE,0,2,1.0056000000000807,0.7872340425531915,0.0922100787981069,2,0.6007866666674614,0.6324103448288194,0.967741935483871,0.9354838709677419,0.01754437514005336,0.010124178903333954,2,0.7362516129036103,0.8537172413817767,1,0.90625,0.05222818324723023,0.07129712451569752,1.5988,0.8946,0.5178,1.0886,0.9526,0.7429,0.1554,1.5898308133333334,0.8876233386666667,0.5106167763333334,1.3017,2.6426,0.3639,2.8512,0.4272,-37.7801,0.9323,3.8754,0.4724,3.4631,0.5062,0.9985,1.4889847733333332,3.0654692133333334,3.01752464,0.40867839266666667,0.350382711,1.0747,3.0229,0.5395,2.7901,0.6349,0.9826,0.074,0.5,0.379,0.018,2.333,129.61111111111114,380,1.125925925925926,1,0,0,1,FALSE,FALSE,FALSE
247,2021-11-13T02:20:02Z,1,1.6,900,4,4,4,5,3,4,5,2,3,3,1,1,4,3,2,4,4,1,2,1,1,2,2,1,3,0,2,0,0,5,5,5,5,5,5,3,4,2,1,5,3,1,5,1,5,1,3,4,5,3,4,1,1,1,1,1,1,1,1,1,4,3,2,1,1,1,1,1,1,2,1.625,0,1.25,0,2.4,0,1.6666666666666667,0,2.0833333333333335,0,1,0,1.4285714285714286,0,1,0,1.6486486486486487,0,0,0,0,-0.6077542715685611,-0.4193765295461455,-0.6588395645607719,-0.5391080470534587,4,2,5,1,1,1,1,1.2857142857142858,0,1,-0.7321841937363471,5,5,5,5,5,3,1,4.714285714285714,0,1.2857142857142858,-0.1748077221195339,0,1,2,3,2,2,2,5,3,1,3,5,4,2,5,5,1,4,5,5,3,2,0,2.8,0,4.4,0,4.2,0,3.8,0,2,4,4,2,4,4,4,2,3,2,2,2,3,4,1,2,4,4,3,4,3.2,0,"White, Caucasian, Anglo, European American",0,18,1,2,NA,5,2,0,1,0,0,1,TRUE,TRUE,TRUE,TRUE,TRUE,0,NA,NA,NA,NA,3,0.5708413793115781,0.624700000005109,0.9666666666666667,0.9032258064516129,0.032201468379317914,0.040043406624840454,3,0.6208937499970197,0.7877433333257834,1,0.967741935483871,0.008932775443329311,0.02872999051670524,NA,NA,NA,NA,NA,NA,NA,NA,NA,NA,1.1819,2.8976,0.3939,1.9823,0.4384,-31.5028,1.1944,3.8355,0.4034,3.4687,0.4614,0.8927,1.3396406376666667,2.24554875,3.215899043333333,0.4210137663333333,0.37815044833333333,0.9077,4.7981,0.5384,4.1859,0.6653,0.9941,0.094,0.408,0.438,0.009,1.678,186.44444444444446,424,1.2562962962962962,1,1,5,6,FALSE,TRUE,FALSE
248,2021-11-13T02:21:00Z,1,1.7777777777777777,864,4,1,3,4,4,4,3,3,2,3,3,3,1,3,3,2,3,3,5,4,2,3,3,3,4,2,3,1,3,3,2,2,2,3,3,1,2,1,1,1,2,2,2,2,1,2,2,2,4,3,2,2,1,1,3,2,2,3,3,1,3,2,4,2,3,4,2,3,4,3,3.375,0,3,0,2.933333333333333,0,3.888888888888889,0,2.8333333333333335,0,2,0,2.4285714285714284,0,3,0,2.945945945945946,0,1,1,3,1.2876904602862478,1.1193944256140804,0.8290434765469984,0.9742189510805395,3,2,2,4,2,3,2,2.857142857142857,0,3,0.9459301925190042,3,3,4,4,1,1,4,2.5714285714285716,0,3.4285714285714284,0.38995568780511447,0,2,3,3,5,4,2,4,3,2,4,4,4,4,4,4,1,3,3,3,4,3.4,0,3.2,0,3.6,0,3.4,0,3.4,0,3,2,2,2,2,1,2,2,2,3,3,2,3,3,3,1,2,2,2,2,2.5,0,"White, Caucasian, Anglo, European American",0,21,1,2,NA,5,2,1,0,1,0,1,TRUE,TRUE,TRUE,TRUE,TRUE,0,NA,NA,NA,NA,2,0.7191035713808877,0.8139629629541326,0.9333333333333333,0.9642857142857143,0.04810177264327433,0.025866275087032167,2,0.9152718750238419,1.0499093750044703,1,1,0.050987878215313115,0.09416135379064212,NA,NA,NA,NA,NA,NA,NA,NA,NA,NA,1.912,1.5981,0.2059,2.7643,0.5122,0.7016,1.0249,4.565,0.584,3.6158,0.6816,0.7631,2.00527484,2.68916109,1.836745122,0.4740665826666667,0.21287472533333332,1.5081,2.4518,0.6322,2.0426,0.7066,0.9993,0.199,0.381,0.371,0.013,1.437,110.53846153846155,104,0.3081481481481481,1,1,0,1,FALSE,FALSE,FALSE
249,2021-11-13T02:25:45Z,1,1.6,900,7,4,2,4,5,4,4,1,4,3,2,2,2,4,2,3,4,1,3,1,1,2,2,1,1,1,2,0,0,5,4,5,4,5,4,4,5,5,2,4,3,1,4,3,5,2,2,3,4,4,3,1,1,1,1,1,1,2,1,1,5,2,2,1,1,1,1,2,1,1,1.5,0,1.25,0,2.533333333333333,0,1.4444444444444444,0,2.4166666666666665,0,1.1666666666666667,0,1.2857142857142858,0,1,0,1.7027027027027026,0,1,0,0,-0.6518832509132961,-0.3925656379510154,-0.4557470907642554,-0.4241563643576354,4,2,3,1,1,2,1,1.7142857142857142,0,4.5,0.8156742234394231,5,5,5,5,4,5,2,4.714285714285714,0,1.2857142857142858,-1.869097951893479,0,4,3,3,4,3,3,4,4,3,3,4,3,4,4,4,5,2,3,4,5,3.4,0,2.6,0,2.8,0,2.8,0,2.7333333333333334,0,1,1,1,4,2,2,1,3,1,1,1,3,2,2,2,3,1,2,1,2,1.5,0,"White, Caucasian, Anglo, European American",0,25,0,1,NA,5,2,0,0,1,0,0,TRUE,TRUE,TRUE,TRUE,TRUE,0,2,1.1569317073269587,0.82,0.10081585941036716,2,0.49994062500447034,0.57203125,1,1,0.0073135482954956735,0.007437897701499999,2,0.6620812499970198,0.768484375,1,1,0.005110199637265707,0.0070479510384331995,1.5701,1.0167,0.6765,1.1907,1.2795,0.848,0.4975,1.5834669866666666,0.9730509856666667,0.662429402,2.2861,6.0573,0.3112,5.117,0.3486,-76.8218,0.8734,4.4657,0.4004,4.2873,0.4767,0.9005,1.80793962,4.373046116666667,5.20071875,0.36759522233333336,0.32830054966666666,0.7951,5.9259,0.5977,5.0421,0.7034,0.9612,0.095,0.496,0.582,0.007,1.199,171.28571428571428,104,0.3081481481481481,1,1,0,1,FALSE,FALSE,FALSE
251,2021-11-13T02:25:53Z,1,1.6,1050,5,3,4,5,3,4,2,2,1,1,3,2,3,4,3,3,2,2,3,1,2,1,3,1,2,0,2,0,0,4,4,4,4,4,5,5,5,5,3,2,3,1,2,2,5,4,4,3,3,3,3,1,2,1,2,1,1,1,1,1,3,5,3,1,1,2,2,1,1,1,1.875,0,1.25,0,2.533333333333333,0,1.5555555555555556,0,2.9166666666666665,0,1.5,0,2,0,1.3333333333333333,0,2.108108108108108,0,0,0,0,-0.16646447812121104,-0.057187517455972794,-0.6588395645607719,-0.35801354100837235,5,1,5,1,3,2,1,1.4285714285714286,0,1,-0.6467170085812028,5,5,5,5,2,2,1,4.142857142857143,0,1.8571428571428572,-0.7395711320441822,0,2,2,2,2,2,2,4,3,1,3,2,4,2,5,5,3,4,2,4,3,2,0,4,0,3.6,0,4.2,0,3.933333333333333,0,2,3,1,4,2,1,2,3,1,2,2,3,1,2,3,3,2,2,2,2,1.85,0,"White, Caucasian, Anglo, European American",0,29,0,1,NA,5,2,0,0,1,0,0,TRUE,TRUE,TRUE,TRUE,TRUE,0,1,0.7664743589728307,0.8125,0.04074745339972362,1,0.4968034482773008,0.5770310344850195,0.9354838709677419,0.90625,0.008263177848882433,0.010771116088631788,1,0.7142968750009313,0.7881133333305518,1,0.9375,0.02381711192622023,0.02143123983987785,1.3746,1.137,0.3943,1.066,1.1519,0.5398,0.3628,1.3935520666666668,1.062698338,0.3879974193333333,1.1312,2.782,0.3136,2.3205,0.3715,-40.1479,0.704,4.467,0.416,3.2607,0.4795,0.9968,1.236995425,2.5752749466666667,3.13448005,0.3633946886666667,0.307550326,1.1782,2.9994,0.5237,2.1829,0.578,0.8883,0.083,0.431,0.313,0.008,1.397,174.625,500,1.4814814814814816,1,0,0,1,FALSE,FALSE,FALSE
252,2021-11-13T02:31:30Z,0.8999999761581421,1.7777777777777777,1152,6,3,5,5,2,5,2,1,5,1,2,1,1,5,5,5,5,2,2,1,2,2,2,2,2,1,2,0,0,5,5,5,5,5,5,5,5,5,5,5,1,1,5,4,5,1,1,4,1,1,5,1,1,1,2,1,4,2,1,1,5,1,1,1,1,1,2,1,1,1,1.875,0,1.25,0,1.4666666666666666,0,1,0,1.8333333333333333,0,1,0,1.4285714285714286,0,1,0,1.4054054054054055,0,1,0,0,-0.6035515116309674,-0.8175715043561326,-0.4557470907642554,-0.636659297560194,5,2,3,1,1,1,1,1.4285714285714286,0,1,-0.6467170085812028,4,5,5,5,4,4,2,4.428571428571429,0,1.5714285714285714,-1.0219528370065065,0,2,2,2,2,2,3,4,4,4,4,4,4,1,4,4,4,4,4,4,4,2,0,3,0,3.8,0,2.8,0,3.2,0,2,3,1,3,3,2,3,3,3,1,2,3,1,1,2,4,1,1,1,2,1.8,0,"White, Caucasian, Anglo, European American",0,22,0,1,NA,5,2,0,0,1,0,0,TRUE,TRUE,TRUE,TRUE,TRUE,0,5,0.7921000000003137,0.7755102040816326,0.08123575581627895,5,0.46357241379289793,0.5083645161294168,0.9666666666666667,0.96875,0.012836265057435847,0.009541445806512571,NA,NA,NA,NA,NA,NA,NA,1.6073,0.8335,0.2441,1.3716,0.9974,0.3847,0.3107,1.5746255966666667,0.8553337756666667,0.24750057866666667,1.2241,3.4297,0.2981,3.248,0.3273,-56.0074,1.1725,5.9899,0.3518,5.3868,0.3908,0.9397,1.3274173326666667,3.4452927066666668,3.73278347,0.32105689,0.29161655733333336,NA,NA,NA,NA,NA,NA,NA,NA,NA,NA,NA,NA,104,0.3081481481481481,1,0,5,6,FALSE,FALSE,TRUE
253,2021-11-13T02:30:28Z,1,1.7777777777777777,1080,4,2,5,5,2,5,1,1,4,1,1,1,1,5,1,5,5,1,1,1,1,1,1,1,1,2,2,0,0,5,5,5,5,5,5,5,5,4,1,5,1,1,3,1,5,1,1,1,3,1,5,1,1,1,2,1,1,2,2,1,5,1,1,1,1,1,2,1,1,1,1,0,1.25,0,1.1333333333333333,0,1.1111111111111112,0,1.3333333333333333,0,1,0,1.1428571428571428,0,1,0,1.2162162162162162,0,1,0,0,-1.2654862018019926,-1.4181548341315258,-0.4557470907642554,-0.9369509624478906,4,2,4,1,1,2,2,1.7142857142857142,0,1,-0.4757826382709144,4,4,5,4,1,2,1,3.5714285714285716,0,2.4285714285714284,0.38995568780511447,0,3,1,2,1,2,1,5,1,1,3,1,5,1,4,4,1,5,1,4,1,1.8,0,5,0,4.4,0,4.6,0,4.666666666666667,0,1,1,1,3,2,1,1,3,1,1,2,4,2,1,1,3,1,1,2,1,1.35,0,"Asian or Asian American (e.g., Chinese, Japanese, and others)",0,20,1,2,NA,5,2,0,0,1,0,0,TRUE,TRUE,TRUE,TRUE,TRUE,0,1,0.958035897436098,0.7959183673469388,0.21512891063766404,1,0.44802812500012806,0.521222580644933,1,1,0.0035013336995772214,0.0028329284731210204,1,0.5940937499998253,0.685234374999709,1,1,0.013226061895138936,0.009654464264122961,1.6853,0.823,0.4496,1.3921,0.7501,0.5749,0.2621,1.6508043833333332,0.838673853,0.44809008533333333,5.8967,9.8194,0.1478,9.9089,0.2237,-94.4383,0.7892,6.6033,0.3901,7.3072,0.4724,0.7287,1.676937378,5.11904164,5.66500429,0.36382042566666667,0.30422471766666664,1.231,5.8598,0.4791,6.3104,0.5872,0.7499,0.176,0.253,0.523,0.009,1.264,140.44444444444446,350,1.0370370370370372,1,0,1,2,FALSE,FALSE,FALSE
254,2021-11-13T02:32:45Z,1,1.7777777777777777,720,4,3,4,5,2,4,2,2,2,2,2,2,1,4,2,4,4,2,1,1,1,1,1,1,1,0,2,0,0,5,4,5,5,5,5,5,5,5,2,5,2,1,4,2,5,1,1,2,1,2,5,1,1,1,3,2,1,1,1,1,5,1,2,1,1,1,2,1,1,1,1.125,0,1.25,0,2,0,1.1111111111111112,0,1.5,0,1.3333333333333333,0,1,0,1,0,1.2972972972972974,0,0,0,0,-1.1373020237053812,-0.9571430050065944,-0.6588395645607719,-0.8079912847836832,5,1,4,1,1,1,1,1.1428571428571428,0,1.5,-0.6331575415043005,5,5,5,5,2,2,1,4.142857142857143,0,1.8571428571428572,-1.0219528370065065,0,2,3,2,2,2,2,5,3,3,3,2,2,2,3,3,1,4,2,4,3,2.2,0,3.6,0,4.2,0,3,0,3.6,0,2,1,2,3,3,2,2,3,2,1,3,2,3,2,2,3,1,2,2,3,2.1,0,"White, Caucasian, Anglo, European American",0,21,1,2,NA,5,2,0,0,0,0,0,TRUE,TRUE,TRUE,TRUE,TRUE,0,2,0.5868974999964237,0.8163265306122449,0.009010347611068167,2,0.5219733333269755,0.5870214285424777,0.9375,0.9333333333333333,0.045545470065977874,0.07149252408954034,2,0.5673645161274941,0.6973066666603088,1,0.9375,0.004671859035337047,0.007667512858268369,1.0801,1.5477,0.3721,0.629,2.4521,0.5079,0.2325,1.1281823993333333,1.2580054646666667,0.36604216366666664,1.23,2.235,0.2765,2.122,0.3261,-22.2063,1.343,3.4358,0.2845,4.7492,0.362,0.6548,1.2963635416666666,2.3435764933333334,2.521150622,0.321180718,0.27269284066666666,0.9701,4.1436,0.46,4.5424,0.5869,0.9363,0.084,0.409,0.553,0.011,1.793,163,378,1.12,1,0,0,1,FALSE,FALSE,FALSE
255,2021-11-13T02:33:12Z,1,1.7777777777777777,720,4,3,5,5,1,5,1,1,5,1,1,1,1,5,1,5,5,1,2,1,1,1,2,1,1,1,2,0,0,5,4,5,5,5,5,5,5,5,1,5,1,1,5,1,5,1,1,1,1,1,4,1,1,1,2,2,1,2,2,1,5,1,1,1,2,1,2,2,2,2,1.25,0,2,0,1,0,1.1111111111111112,0,1,0,1.3333333333333333,0,1.1428571428571428,0,1.3333333333333333,0,1.1891891891891893,0,1,0,0,-1.1267951238613967,-1.3796323256302194,-0.22054348261253207,-0.8000879041213758,5,1,5,1,1,1,1,1,0,1,-0.9031185640466358,5,5,5,5,3,3,1,4.428571428571429,0,1.5714285714285714,0.38995568780511447,0,2,2,1,1,1,1,3,2,1,4,1,3,1,5,4,2,4,1,3,2,1.4,0,4.4,0,3.8,0,4.4,0,4.2,0,1,2,1,3,3,1,1,3,2,1,1,4,2,2,1,4,1,1,2,2,1.5,0,"Hispanic of Latino (e.g., Mexican American, Central American, and others) & White, Caucasian, Anglo, European American",1,21,1,2,NA,5,2,0,0,1,0,0,TRUE,TRUE,TRUE,TRUE,TRUE,0,5,0.9034955555703905,0.9,0.04248640156945869,5,0.5688322580399052,0.6164620689852485,1,0.9666666666666667,0.05308451757510373,0.03801386581240596,5,0.5938937499374152,0.6476718750149012,1,1,0.010091746419376673,0.009133236288941542,1.4612,1.6316,0.5572,1.2436,1.6321,0.6246,0.0379,1.4496534333333333,1.3364550016666668,0.548647042,1.2442,3.0384,0.3641,2.6749,0.4003,-41.6281,0.947,3.2008,0.3861,3.7523,0.4645,0.9232,1.4236606366666666,2.9458967933333335,3.326406883333333,0.38416541066666665,0.34541871533333335,0.9884,4.3189,0.5028,3.9618,0.5438,0.6828,0.292,0.163,0.67,0.028,1.532,54.714285714285715,376,1.114074074074074,1,0,0,1,FALSE,FALSE,FALSE
256,2021-11-13T02:32:54Z,1,1.6,900,3,3,1,3,2,2,3,3,3,3,3,3,4,2,2,2,2,3,4,3,3,2,4,4,4,7,2,0,8,4,2,2,3,3,3,2,3,3,3,2,3,5,2,3,3,5,5,5,3,4,1,5,4,4,4,1,3,4,3,2,4,2,3,3,2,2,4,4,4,4,3.375,0,4,0,3.3333333333333335,0,3.2222222222222223,0,3.9166666666666665,0,3.6666666666666665,0,2.5714285714285716,0,2.3333333333333335,0,3.3783783783783785,0,4,0,6,1.5566670962922522,1.4771310874754593,2.0746414419100305,1.775886264692745,2,3,1,2,2,3,3,3.142857142857143,0,2.5,0.9323707254421016,2,4,3,4,1,1,2,2.7142857142857144,0,3.2857142857142856,-0.4571894270818581,0,2,2,2,3,2,2,4,2,2,2,4,3,3,3,4,4,3,3,4,3,2.2,0,3,0,3,0,3.6,0,3.2,0,2,4,2,2,3,3,2,1,1,1,3,2,3,2,1,2,3,3,2,3,2.55,0,"Black or African American & White, Caucasian, Anglo, European American",1,19,1,2,NA,5,2,0,0,1,0,0,TRUE,TRUE,TRUE,TRUE,TRUE,0,4,0.6922047619081679,0.8571428571428571,0.017605530800724422,4,0.4883968749959022,0.5578642857117312,1,0.9032258064516129,0.0040861751511048995,0.006762104452118421,4,0.6019548387104465,0.6991580645095917,1,1,0.005438590558545082,0.00792873518292825,1.1027,1.728,0.4602,0.8706,2.0097,0.5397,0.2025,1.1438505356666666,1.3382321503333334,0.45161488,1.2466,4.741,0.3569,2.5489,0.356,-62.3807,0.8282,5.4948,0.4119,3.9518,0.4541,0.9899,1.362548469,2.8120743866666666,4.843289583333333,0.34801797333333334,0.34886826666666665,1.0266,4.3812,0.4932,3.742,0.5714,0.9982,0.163,0.353,0.644,0.013,1.438,110.61538461538461,348,1.031111111111111,1,0,1,2,FALSE,FALSE,FALSE
257,2021-11-13T02:37:33Z,1,1.7777777777777777,864,6,3,2,2,4,3,5,2,3,2,2,1,2,3,3,4,1,2,2,1,2,2,2,2,2,0,2,0,0,4,1,2,3,3,3,2,3,2,5,3,1,1,2,2,3,5,2,2,5,2,4,1,1,1,3,1,1,1,1,1,2,5,3,2,2,1,1,2,1,1,1.875,0,1.25,0,3,0,3.4444444444444446,0,2.9166666666666665,0,1.3333333333333333,0,2.142857142857143,0,1.6666666666666667,0,2.5945945945945947,0,0,0,0,0.13613423738554362,0.35242870359309486,-0.6588395645607719,-0.1532054304838385,5,3,4,3,1,1,2,1.8571428571428572,0,1,-0.39031545311577004,4,4,4,3,1,1,2,3,0,3,-1.3043345419688306,0,3,3,4,4,4,2,5,2,2,4,2,3,2,4,5,2,4,1,5,3,3.6,0,4,0,4.4,0,4,0,4.133333333333334,0,2,3,1,2,4,2,3,4,1,1,4,4,2,4,2,3,1,3,3,2,2.25,0,"Asian or Asian American (e.g., Chinese, Japanese, and others) & White, Caucasian, Anglo, European American",1,24,1,2,NA,5,2,0,1,0,0,1,TRUE,TRUE,TRUE,TRUE,TRUE,0,4,0.5630047619058972,0.84,0.012932590840708543,4,0.3986466666698456,0.45132903226344817,0.967741935483871,0.96875,0.0023157978275992743,0.002234461774631728,4,0.5090281250029802,0.5481656250003726,1,1,0.008242831764741233,0.006761710070895329,1.1162,1.6013,0.3315,0.9078,1.9314,0.4021,0.2409,1.154415577,1.2858447586666666,0.32518903866666665,1.0558,3.7874,0.2646,5.2415,0.3559,-87.2785,0.7149,6.2298,0.3449,6.5631,0.3939,0.9623,1.1349467353333333,4.99743561,4.048237993333333,0.34906385666666667,0.26083241966666665,0.7256,3.4256,0.4446,4.7215,0.4884,0.718,0.178,0.195,0.56,0.041,2.013,49.09756097560975,466,1.3807407407407408,1,0,0,1,FALSE,FALSE,FALSE
258,2021-11-13T02:02:57Z,1,1.7777777777777777,1080,3,2,1,2,4,2,4,4,3,4,5,3,4,2,3,2,1,5,5,4,3,5,5,4,4,6,5,0,2,3,3,2,4,3,4,3,4,3,4,3,4,5,3,5,2,5,4,4,4,5,1,3,3,2,2,5,3,5,4,3,2,5,4,3,5,4,4,4,3,3,4.375,0,3.5,0,4,0,2.7777777777777777,0,4.166666666666667,0,3.1666666666666665,0,3.857142857142857,0,4,0,3.6486486486486487,0,3,0,2,2.3467859645598885,2.3095269998152466,1.008947975082309,1.6592374874487779,1,5,2,4,4,5,4,4.428571428571429,0,2.5,1.7015753918384005,1,2,3,1,1,1,5,1.4285714285714286,0,4.571428571428571,0.6723373927674386,0,3,3,2,3,3,2,4,1,1,2,1,4,3,3,4,3,5,2,3,3,2.8,0,4.4,0,3,0,4,0,3.8,0,3,4,3,1,4,2,4,2,3,1,4,2,3,4,2,2,3,2,4,3,3.1,0,"Black or African American & Hispanic of Latino (e.g., Mexican American, Central American, and others)",1,18,1,3,NA,5,2,0,0,0,0,0,TRUE,TRUE,TRUE,TRUE,TRUE,0,2,0.8802785714268685,0.84,0.04786305116477078,2,0.6178781249988824,0.8104781249966473,1,1,0.008787328215311752,0.009418243054691442,2,0.6875258064519975,0.7407870967791926,1,1,0.010091697311350543,0.006950423828092225,1.3824,1.2888,0.5037,0.9077,2.3639,0.692,0.5067,1.4118773033333334,1.1531153486666668,0.494654852,3.6773,6.5595,0.3376,5.5138,0.477,-66.108,1.0133,6.1594,0.5327,3.1003,0.678,0.8773,2.4990843833333334,4.06500249,5.218614616666667,0.5032268336666667,0.380064259,1.0146,3.3423,0.5544,4.7654,0.6397,0.9637,0.143,0.45,0.594,0.021,1.329,63.28571428571428,330,0.9777777777777777,1,0,3,4,FALSE,FALSE,FALSE
259,2021-11-13T02:06:20Z,0.8999999761581421,1.6,900,6,3,5,5,2,4,2,1,5,1,1,1,1,5,1,5,4,1,1,1,1,1,1,1,1,1,2,0,0,5,4,4,4,4,5,4,4,5,1,5,1,1,4,1,5,3,1,1,2,2,4,1,1,1,2,1,1,2,1,1,3,3,3,1,1,1,2,1,1,2,1,0,1.5,0,1.2666666666666666,0,1.6666666666666667,0,1.4166666666666667,0,1.1666666666666667,0,1.8571428571428572,0,1,0,1.5405405405405406,0,1,0,0,-1.0637537247974898,-1.2214771022856596,-0.3773458880470143,-0.7994114951663369,5,1,4,2,1,2,1,1.4285714285714286,0,2,-0.2777293338068208,5,5,5,5,3,3,1,4.428571428571429,0,1.5714285714285714,-0.4571894270818581,0,2,2,2,3,2,2,5,2,2,3,3,3,2,4,4,1,4,2,4,2,2.2,0,3.6,0,4.2,0,4,0,3.933333333333333,0,2,1,1,2,3,2,3,3,1,2,3,3,2,1,1,3,1,1,1,3,1.85,0,"White, Caucasian, Anglo, European American",0,25,1,2,NA,5,2,0,1,2,0,1,TRUE,TRUE,TRUE,TRUE,TRUE,0,6,0.96083870967741,0.7045454545454546,0.24368709672303598,6,0.4546896551724133,0.5010689655172409,0.9666666666666667,0.9354838709677419,0.00982857586206937,0.009692918279569704,6,0.6312666666666715,0.7590000000000011,0.9375,0.78125,0.018188673387097367,0.020529870967741063,1.8822,0.5017,0.2084,1.493,0.5632,0.4031,0.1126,1.7798300633333333,0.5888113305666667,0.21914979966666667,1.0839,3.3443,0.2998,2.8609,0.3274,-54.637,1.067,5.5799,0.3473,4.3887,0.3694,0.9996,1.181777155,3.110527046666667,3.6647597166666666,0.32106139366666664,0.293937567,0.9118,2.5599,0.4986,1.9772,0.5969,0.8212,0.062,0.42,0.3,0.005,1.513,302.59999999999997,424,1.2562962962962962,1,0,0,1,FALSE,FALSE,FALSE
260,2021-11-13T02:06:36Z,1,1.7786458333333333,768,2,2,3,4,2,4,2,3,4,3,3,2,2,3,3,2,2,3,3,1,2,2,3,3,3,4,2,0,1,3,2,2,2,1,3,3,3,3,1,5,2,1,3,3,4,5,3,3,2,2,2,2,3,1,3,1,1,3,3,1,4,3,2,2,2,2,2,2,2,2,2.5,0,2,0,2.6666666666666665,0,3.5555555555555554,0,2.3333333333333335,0,2.1666666666666665,0,2,0,2,0,2.5675675675675675,0,2,0,1,0.5080784918625958,0.4661572148720772,0.15899863808316506,0.3125779264776211,3,2,1,3,2,3,4,3.142857142857143,0,2,0.7478768880549106,4,4,4,4,2,2,3,3.2857142857142856,0,2.7142857142857144,1.8018642126167355,0,2,2,2,2,2,2,5,1,1,2,2,4,3,4,5,2,4,3,5,3,2,0,3.8,0,3.8,0,4.4,0,4,0,2,1,2,2,2,2,1,2,1,1,1,2,1,1,1,4,2,2,1,2,1.65,0,"White, Caucasian, Anglo, European American",0,28,1,2,NA,5,2,1,0,1,0,1,TRUE,TRUE,TRUE,TRUE,TRUE,0,6,1.0844583333334368,0.72,0.08053174120809359,6,0.6284225806452094,0.6677031249998836,1,1,0.01704603047322086,0.0065878570866955335,6,0.7525750000000698,0.7834266666661948,1,0.9375,0.012902936128966203,0.011574754264161402,1.4075,0.7006,0.6704,1.2204,0.663,0.7588,0.2405,1.4586373466666667,0.7807162506,0.65525256,8.0931,6.4394,0,8.0356,0.1642,-54.7995,1.0821,2.4999,0.4556,6.7941,0.5945,0.9267,2.3603094533333335,4.34265394,3.7510765233333334,0.3985027213333333,0.30712304333333335,1.0554,2.3489,0.6002,3.8382,0.6515,0.7877,0.062,0.568,0.333,0.014,1.313,93.78571428571428,344,1.0192592592592593,0,0,0,1,FALSE,FALSE,FALSE
261,2021-11-13T02:39:10Z,1,1.6,900,4,2,1,3,4,3,3,4,2,4,3,3,1,1,1,3,4,4,3,5,5,2,4,4,3,6,1,3,2,4,4,1,3,3,3,4,4,3,4,3,1,1,2,3,3,5,5,1,1,4,1,5,5,4,4,1,2,5,3,1,4,1,1,1,1,1,1,3,3,2,3.75,0,2.25,0,3.2,0,2.7777777777777777,0,2.9166666666666665,0,3.8333333333333335,0,2,0,1,0,2.7567567567567566,0,3,3,2,1.4032663585700773,1.3138459823455497,1.2368415842751745,1.2753437833103622,5,1,2,1,1,1,1,1.4285714285714286,0,2,-0.2777293338068208,4,3,4,3,2,2,4,2.857142857142857,0,3.142857142857143,-1.0219528370065065,0,2,2,2,2,2,2,5,2,2,2,2,4,1,4,4,4,5,1,5,1,2,0,4.4,0,3.8,0,4.2,0,4.133333333333334,0,3,2,4,1,3,4,4,2,4,4,1,1,2,4,2,1,4,4,4,4,3.4,0,"White, Caucasian, Anglo, European American",0,22,1,2,NA,5,2,0,0,1,0,0,TRUE,TRUE,TRUE,TRUE,TRUE,0,4,0.7039823529439814,0.6938775510204082,0.014574648123611752,4,0.41607999997933703,0.46495999998251597,0.9375,0.9375,0.0026883153936577706,0.003101973538835972,4,0.6317718750014901,0.7437266666650773,1,0.9375,0.00866799111806232,0.011547492493746692,1.0589,0.8252,0.4569,0.5509,1.3992,0.633,0.3292,1.1291114733333334,0.88814369,0.4487984953333333,0.9496,4.9304,0.3104,4.6032,0.3618,-82.3477,0.6721,5.0573,0.3556,5.0874,0.3964,0.9401,0.932497881,3.9842188833333334,3.59824422,0.360048406,0.29048751733333333,0.973,3.5324,0.5057,3.6966,0.6227,0.9453,0.085,0.444,0.483,0.011,1.681,152.81818181818184,478,1.4162962962962962,1,0,0,1,FALSE,FALSE,FALSE
262,2021-11-13T02:36:56Z,1,1.7777777777777777,1440,4,2,4,5,2,5,1,1,4,1,1,2,2,4,3,3,4,1,2,1,1,1,1,1,1,1,2,1,5,5,1,1,2,4,4,2,4,3,2,5,1,1,3,2,5,1,1,3,3,4,5,3,1,1,4,1,1,3,1,1,5,1,1,1,1,1,1,1,1,1,1.125,0,1,0,1.7333333333333334,0,3.111111111111111,0,1.9166666666666667,0,1.6666666666666667,0,1.1428571428571428,0,1,0,2,0,1,1,5,-0.7002149901956249,-0.7697571345077772,0.554733148607431,-0.10751199295017311,4,1,2,1,1,2,1,1.7142857142857142,0,1,-0.4757826382709144,3,4,5,5,2,2,2,3.5714285714285716,0,2.4285714285714284,1.237100802692087,0,2,4,2,4,2,2,5,1,1,3,1,4,2,4,4,1,4,1,4,1,2.8,0,4.4,0,4.2,0,4.6,0,4.4,0,3,2,2,1,3,2,3,2,1,2,2,3,1,1,1,3,1,3,2,2,2.1,0,"Hispanic of Latino (e.g., Mexican American, Central American, and others)",0,20,0,1,NA,5,2,0,0,0,0,0,TRUE,TRUE,TRUE,TRUE,TRUE,0,2,0.8411690476565133,0.84,0.04302850033047552,2,0.47046250002086165,0.5406000000317892,1,0.967741935483871,0.0017180753232479864,0.002248492904820596,2,0.5747625000402331,0.6590225806466995,1,0.96875,0.006204247579917024,0.0036063544793432383,1.4461,1.2925,0.4967,0.9834,1.2323,0.6565,0.2356,1.4524418366666667,1.147420573,0.489303382,1.2013,6.549,0.3787,4.4524,0.4121,-98.3959,1.0154,7.5636,0.405,6.8414,0.4682,0.8425,1.288571877,4.3883247,6.044565433333333,0.40379724466666667,0.3692437726666667,1.0064,6.6858,0.5027,8.2782,0.5957,0.9326,0.08,0.419,0.57,0.013,1.682,129.3846153846154,104,0.3081481481481481,1,1,0,1,FALSE,FALSE,FALSE
263,2021-11-13T02:40:18Z,1,1.6,900,6,3,4,4,2,4,2,2,3,2,2,2,2,4,3,4,4,1,4,1,1,1,1,1,1,0,2,0,0,5,5,5,5,5,5,5,5,5,1,5,1,1,5,2,5,2,1,1,1,1,3,1,1,1,2,1,1,1,1,1,5,1,1,1,1,1,1,1,1,1,1.375,0,1,0,2.1333333333333333,0,1,0,1.1666666666666667,0,1.3333333333333333,0,0.8571428571428571,0,1,0,1.135135135135135,0,0,0,0,-1.0826661445166619,-0.8620950066440746,-0.7372407672780129,-0.7996678869610437,5,1,5,1,1,1,1,1,0,1,-0.9031185640466358,4,5,5,5,4,4,1,4.571428571428571,0,1.4285714285714286,-0.7395711320441822,0,2,2,2,2,2,2,4,2,2,2,1,3,2,3,4,1,4,2,3,2,2,0,4,0,3.6,0,3.8,0,3.8,0,1,1,1,4,1,1,1,4,1,1,2,4,1,2,1,4,1,1,1,1,1.1,0,"White, Caucasian, Anglo, European American",0,27,1,2,NA,5,2,0,0,1,0,0,TRUE,TRUE,TRUE,TRUE,TRUE,0,2,0.9781857142857143,0.7,0.11960366973180378,2,0.7182354838732751,0.7905593750029802,1,1,0.06167489036250561,0.07480600183869254,2,0.8887999999951571,1.1334375000037253,1,1,0.084367592904661,0.13260328758387682,1.6655,0.5343,0.3255,1.3536,0.5965,0.556,0.3652,1.6377117066666667,0.6286004706,0.327027701,2.5083,2.5005,0.2167,2.5223,0.2933,-3.0193,1.6288,1.8821,0.3435,1.7348,0.4071,0.9405,2.0332995233333335,2.3506115166666666,2.3833863366666668,0.3439136953333333,0.2699583446666667,1.8037,1.4897,0.4313,2.2986,0.7727,0.7341,0.29,0.004,0.332,0.009,2.071,230.11111111111114,434,1.285925925925926,1,0,0,1,FALSE,FALSE,FALSE
264,2021-11-13T02:39:17Z,0.8999999761581421,1.6,1050,5,2,1,1,5,2,5,5,3,5,5,5,3,1,5,1,1,5,5,5,2,5,5,5,5,3,2,2,5,5,1,1,1,1,1,1,1,1,5,3,5,3,1,2,2,5,5,5,5,5,1,4,5,3,3,3,2,5,1,2,2,4,5,4,5,5,2,4,4,2,4.625,0,3,0,4.666666666666667,0,4.555555555555555,0,4.333333333333333,0,3.6666666666666665,0,3.142857142857143,0,4.666666666666667,0,4.135135135135135,0,2,2,5,2.804886797757614,2.912530085149767,1.5916684517349,2.2520992684423335,3,3,2,4,3,5,3,3.5714285714285716,0,1.5,0.8197846061331525,1,1,1,1,1,1,5,1,0,5,0.9547190977297628,0,1,1,2,3,2,2,5,1,1,1,1,5,1,4,5,2,5,1,5,4,1.8,0,4.8,0,4,0,4.2,0,4.333333333333333,0,1,4,1,2,2,1,3,4,3,2,1,3,4,4,1,3,2,4,2,2,2.25,0,"Hispanic of Latino (e.g., Mexican American, Central American, and others)",0,21,1,2,NA,5,2,0,0,1,0,0,TRUE,TRUE,TRUE,TRUE,TRUE,0,2,0.717126315788611,0.76,0.02955926564856725,2,0.5149343749983236,0.5752812499995343,1,1,0.0035199371673652474,0.006556382862851871,2,0.6140218750000931,0.750737500000745,1,1,0.007426734022309718,0.011101289516186231,1.254,0.9805,0.3861,0.9998,1.23,0.4984,0.2625,1.30251615,0.9703308816666667,0.3788407246666667,5.0491,9.0462,0.2359,7.1965,0.2245,-82.3004,0.9186,5.1854,0.4311,4.6949,0.4827,0.9829,1.91449449,4.46709003,5.602368753333334,0.364456574,0.34808544933333335,0.9927,3.1111,0.4923,3.3273,0.618,0.943,0.195,0.289,0.605,0.009,1.526,169.55555555555557,444,1.3155555555555554,1,0,0,1,FALSE,FALSE,FALSE
265,2021-11-13T02:45:24Z,0.8999999761581421,1.6,900,3,5,3,4,2,4,1,3,3,3,4,4,4,4,3,4,4,4,3,1,1,2,2,4,2,3,2,0,0,4,4,4,5,4,4,3,4,4,4,4,3,2,2,3,2,3,2,3,2,3,4,3,4,2,2,1,1,4,4,2,5,2,2,1,1,1,1,1,1,1,2.375,0,1,0,2.6666666666666665,0,2,0,2.9166666666666665,0,2.1666666666666665,0,2.142857142857143,0,1,0,2.324324324324324,0,2,0,0,0.2790280752637333,0.30790520130515253,-0.33105581968498016,-0.011575309189913813,5,1,4,1,1,1,1,1.1428571428571428,0,1.5,-0.6331575415043005,5,5,5,5,5,5,1,5,0,1,-1.3043345419688306,0,4,4,4,3,4,2,3,3,3,4,4,4,3,4,4,4,4,3,2,4,3.8,0,3.4,0,2.8,0,3.2,0,3.1333333333333333,0,3,1,3,3,3,4,3,3,3,3,3,3,2,1,3,2,2,3,3,3,2.6,0,"Asian or Asian American (e.g., Chinese, Japanese, and others)",0,21,1,2,NA,5,2,0,0,2,0,0,TRUE,TRUE,TRUE,TRUE,TRUE,0,1,0.6485806451612899,0.62,0.02869295877551095,1,0.41896774193548014,0.5408620689655093,1,0.90625,0.003831832258065602,0.0069723054435468475,1,0.5978750000000018,0.713814814814817,1,0.84375,0.004742370967741169,0.011758709677419314,1.2803,0.4172,0.3205,0.9047,0.2741,0.4779,0.2202,1.3200070333333334,0.6138478733,0.315292842,1.1343,4.55,0.2943,2.4854,0.3428,-62.3055,0.8492,5.4122,0.3424,3.4193,0.4338,0.9876,1.2352724416666667,2.742503816666667,4.712198383333333,0.335776144,0.288215568,0.8224,5.4794,0.5217,2.761,0.5965,0.9232,0.068,0.464,0.542,0.012,1.82,151.66666666666666,104,0.3081481481481481,1,0,0,1,FALSE,FALSE,FALSE
266,2021-11-13T02:38:12Z,1,1.6,900,6,3,3,2,2,2,2,1,4,1,4,1,1,1,5,3,5,4,3,1,1,4,4,5,3,0,2,3,0,5,3,4,5,3,5,3,5,5,2,5,5,2,3,3,5,5,5,5,5,5,2,3,1,1,4,3,1,1,1,1,1,5,5,5,5,2,1,1,1,1,3.125,0,1,0,2.6,0,1.7777777777777777,0,3.5,0,2.5,0,2.5714285714285716,0,4,0,2.8378378378378377,0,0,3,0,1.0649441835937759,0.8222484429532494,-0.11734114449894173,0.35245364922715383,5,1,4,1,1,1,1,1.1428571428571428,0,1,-0.8176513788914915,2,3,3,5,1,1,5,2.2857142857142856,0,3.7142857142857144,1.5194825076544112,0,1,1,4,2,2,1,5,1,1,5,1,5,1,5,5,1,5,1,5,3,2,0,5,0,5,0,4.6,0,4.866666666666666,0,3,4,2,4,2,1,4,3,1,2,4,3,2,1,1,3,1,2,1,1,1.95,0,"White, Caucasian, Anglo, European American",0,30,1,2,NA,5,2,0,0,1,0,0,TRUE,TRUE,TRUE,TRUE,TRUE,0,6,0.9113064516130234,0.6326530612244898,0.02467341534011486,6,0.5125718750000233,0.5595387096772751,1,0.96875,0.003981614344689405,0.004752959022195262,6,0.6125156249997672,0.7455968749998138,1,1,0.007770609102836902,0.01761252869958659,1.311,0.4533,0.5549,0.8704,0.3188,0.7588,0.2757,1.3658729333333333,0.62581244613,0.5451367476666666,1.8425,5.8083,0.354,3.7472,0.3232,-69.3282,0.9626,6.0284,0.433,4.8938,0.4691,0.8269,1.77166704,3.666672526666667,5.3608254,0.32524826566666665,0.350499457,1.0438,4.9205,0.5102,2.4806,0.5936,0.9922,0.176,0.297,0.555,0.01,1.441,144.1,428,1.268148148148148,1,0,0,1,FALSE,FALSE,FALSE
267,2021-11-13T02:29:20Z,1,1.6,800,3,2,2,3,4,3,4,1,2,3,3,2,4,3,2,3,3,3,4,1,1,3,2,4,3,4,1,0,1,4,2,2,3,2,3,2,3,2,3,5,3,3,3,3,3,4,3,4,5,4,3,2,3,1,2,5,1,4,4,1,3,3,3,3,3,1,4,3,2,2,2.625,0,2.75,0,3.066666666666667,0,3.4444444444444446,0,3.25,0,2.5,0,2.5714285714285716,0,2.3333333333333335,0,3.027027027027027,0,2,0,1,0.8716172264644607,0.8892272768298931,0.39420224623488836,0.6417147615323907,3,1,1,2,2,3,2,2.5714285714285716,0,2,0.4060081474343336,3,3,3,3,2,2,3,2.7142857142857144,0,3.2857142857142856,0.38995568780511447,0,4,4,4,3,3,3,5,4,4,1,2,4,3,4,4,1,4,2,4,2,3.6,0,3.8,0,3.6,0,3.2,0,3.533333333333333,0,3,3,3,1,3,3,2,2,3,3,3,3,3,3,3,3,2,3,4,3,2.9,0,"Hispanic of Latino (e.g., Mexican American, Central American, and others) & White, Caucasian, Anglo, European American",1,21,1,3,NA,5,2,0,1,2,0,1,TRUE,TRUE,TRUE,TRUE,TRUE,0,5,1.0882589743589888,0.78,0.10950808063670919,5,0.5866032258064877,0.6155193548387577,0.96875,0.96875,0.017050983377028775,0.016778212741965615,5,0.7279343749998661,0.8009032258065117,1,1,0.00658135329637958,0.014887130322548583,1.8921,0.7474,0.4122,1.1471,0.8834,0.823,0.5184,1.79726831,0.762224942,0.41445541233333333,1.697,2.9073,0.3164,2.6388,0.3059,-27.9738,1.3272,2.8536,0.3747,4.1563,0.4469,0.9633,1.7491650733333333,2.7930549466666665,3.0957077366666668,0.3045423346666667,0.3122997493333333,1.2154,3.7592,0.5816,2.8154,0.6123,0.9967,0.087,0.542,0.45,0.034,1.921,56.5,378,1.12,1,0,0,1,FALSE,FALSE,FALSE
268,2021-11-13T02:28:25Z,1,1.6,900,6,3,2,5,3,4,3,3,3,4,4,4,5,2,3,2,3,5,5,5,1,5,5,5,5,2,2,0,0,3,3,2,4,4,5,5,5,3,2,3,2,2,1,3,2,5,5,5,5,5,1,1,5,1,3,2,1,2,2,2,5,1,1,1,1,4,2,3,1,1,4.5,0,1.75,0,3.3333333333333335,0,2.2222222222222223,0,3.8333333333333335,0,2.6666666666666665,0,1.2857142857142858,0,2,0,2.675675675675676,0,1,0,0,1.819339592391865,1.6586127544100062,-0.2989446853297732,0.6798340345401165,5,1,5,1,1,1,1,1,0,1,-0.9031185640466358,5,5,5,5,5,5,1,5,0,1,-1.0219528370065065,0,2,1,2,3,3,2,5,1,1,4,1,5,4,5,5,1,5,1,4,3,2.2,0,4.8,0,4,0,4.6,0,4.466666666666667,0,1,1,4,4,3,4,4,2,1,2,4,2,1,4,2,2,3,4,2,3,2.65,0,"Hispanic of Latino (e.g., Mexican American, Central American, and others) & White, Caucasian, Anglo, European American",1,22,1,2,NA,5,2,0,0,1,0,0,TRUE,TRUE,TRUE,TRUE,TRUE,0,6,0.7576388888822662,0.72,0.019576449960841798,6,0.4756838709615892,0.5515562499836087,1,1,0.0043864460664747714,0.006174737385783099,6,0.9121312500238419,0.9580566666523616,1,0.967741935483871,0.15360576931000428,0.05946586837393866,1.0941,0.9004,0.471,0.9374,1.2699,0.5526,0.2534,1.1578193233333334,0.9219335063333334,0.4625471586666667,4.3674,8.8287,0.2283,6.5387,0.2176,-80.181,0.7955,4.8988,0.3966,4.2925,0.4797,0.9305,1.8528349633333334,4.1120258666666665,5.83632183,0.3282478306666667,0.32183917,1.9959,1.8994,0.3697,2.0738,0.5169,0.796,0.1,0.416,0.2,0.02,1.738,86.89999999999999,104,0.3081481481481481,1,0,2,3,FALSE,FALSE,FALSE
269,2021-11-13T02:44:26Z,1,1.6,800,6,2,2,5,4,4,1,1,5,5,1,1,4,2,1,3,3,5,5,1,1,5,5,5,5,1,2,0,0,3,1,4,2,2,4,1,1,1,4,4,5,1,2,1,5,1,5,5,5,5,4,1,1,1,2,1,1,2,1,1,5,1,1,1,1,3,1,1,1,1,4,0,1,0,2.4,0,3.888888888888889,0,3.25,0,1.1666666666666667,0,1,0,1.6666666666666667,0,2.5675675675675675,0,1,0,0,1.441091198008422,0.9961804725433192,-0.5341482934814965,0.23101608953091135,5,1,4,1,1,3,1,1.4285714285714286,0,1,-0.6467170085812028,5,5,5,5,4,4,1,4.714285714285714,0,1.2857142857142858,-1.0219528370065065,0,1,1,1,1,1,1,5,1,1,3,1,5,1,2,3,1,4,2,4,3,1,0,4.6,0,4.4,0,3.6,0,4.2,0,1,4,3,3,2,3,3,2,1,3,3,3,2,2,1,3,2,3,3,3,2.4,0,"White, Caucasian, Anglo, European American",0,24,1,2,NA,5,2,0,0,1,0,0,TRUE,TRUE,TRUE,TRUE,TRUE,0,4,0.8908052631571497,0.76,0.04793731435101328,4,0.5149322580647084,0.5807354838699103,1,0.96875,0.00627367492478991,0.016728959344628737,4,0.7609281249996275,0.8393741935486755,1,1,0.028304207248132526,0.023993796645355715,1.4882,0.8413,0.4275,0.815,1.5381,0.7373,0.5383,1.5003491566666667,0.8684574703333333,0.421885283,1.1531,4.0032,0.3709,3.1443,0.4055,-64.4622,1.1597,5.1288,0.4015,3.4818,0.4003,0.7829,1.3798929583333333,3.4227472066666667,4.390174016666666,0.3848502183333333,0.35627413733333335,1.2028,2.225,0.5304,2.5664,0.6362,0.9702,0.278,0.211,0.512,0.016,1.494,93.375,370,1.0962962962962963,1,0,0,1,FALSE,FALSE,FALSE
270,2021-11-13T02:35:08Z,1,1.7777777777777777,864,4,1,4,4,2,4,2,2,4,1,2,2,2,5,2,4,5,1,2,1,1,1,2,2,2,0,2,0,1,5,5,4,5,5,4,5,5,5,3,4,1,1,3,3,5,2,2,3,1,3,4,2,1,1,2,2,1,1,1,1,4,2,2,1,3,1,2,1,3,2,1.5,0,2,0,1.8,0,1.2222222222222223,0,2.0833333333333335,0,1.5,0,1.2857142857142858,0,1.6666666666666667,0,1.6486486486486487,0,0,0,1,-0.6855053304140466,-0.7309442553393755,-0.24718630950986772,-0.4890652824246216,2,4,2,3,2,4,3,3.4285714285714284,0,2.5,1.1033050957523902,3,3,3,3,2,2,2,2.857142857142857,0,3.142857142857143,1.5194825076544112,0,3,2,3,3,3,3,5,3,2,3,2,3,2,4,4,4,3,3,4,3,2.8,0,3.2,0,3.6,0,3.6,0,3.466666666666667,0,2,2,4,1,2,4,4,1,4,3,1,1,3,4,3,1,1,4,2,3,3.1,0,"Asian or Asian American (e.g., Chinese, Japanese, and others)",0,21,0,1,NA,5,2,0,0,1,0,0,TRUE,TRUE,TRUE,TRUE,TRUE,0,1,1.061034782609214,0.92,0.31183377546545776,1,0.39748620689737385,0.46272333333492277,0.9666666666666667,0.9375,0.0051121577472106996,0.00610752499990271,1,0.5385250000013039,0.6537483870983124,1,0.96875,0.006733638710104314,0.008940974182908139,1.8465,1.2015,0.4645,2.0895,1.5446,0.3537,0.0376,1.7287122233333334,1.0875998806666667,0.4751148706666667,1.0272,3.1902,0.245,3.3746,0.3256,-62.5397,0.9836,4.3323,0.2851,4.9383,0.3564,0.9982,1.1205519053333333,3.55615665,3.5844815666666667,0.31960611266666666,0.24148282233333335,1.1844,4.554,0.4143,4.5629,0.5243,0.9856,0.099,0.335,0.513,0.011,1.709,155.36363636363637,380,1.125925925925926,1,0,0,1,FALSE,FALSE,FALSE
271,2021-11-13T02:41:54Z,1,1.7777777777777777,864,3,2,5,5,4,4,5,5,3,3,2,4,3,2,3,2,1,1,2,3,1,1,1,1,1,1,2,0,0,4,2,4,2,1,4,3,3,3,2,5,1,1,3,1,5,3,1,2,1,1,3,1,1,1,1,1,1,2,2,2,3,4,2,1,1,1,2,2,1,1,1.375,0,1.5,0,3.2666666666666666,0,3.111111111111111,0,1.5,0,1.1666666666666667,0,2.142857142857143,0,1,0,1.972972972972973,0,1,0,0,-0.5615239122550293,-0.014986980504792623,-0.3773458880470143,-0.19616643427590347,4,1,3,1,1,1,1,1.4285714285714286,0,1,-0.6467170085812028,3,3,3,5,2,3,4,3,0,3,1.237100802692087,0,2,3,3,3,3,3,2,4,2,4,2,4,4,5,4,2,3,2,4,5,2.8,0,3.6,0,3.2,0,3.2,0,3.3333333333333335,0,2,1,1,4,1,1,1,4,1,1,1,4,2,1,1,4,1,1,1,1,1.1,0,"White, Caucasian, Anglo, European American",0,29,0,1,NA,5,2,0,0,0,0,0,TRUE,TRUE,TRUE,TRUE,TRUE,0,3,0.6725641025641026,0.78,0.017191257551020408,3,0.469,0.498,0.90625,1,0.0073151250000000004,0.004360193548387095,3,0.56921875,0.6542142857142857,1,0.875,0.005265595766129034,0.009644000000000002,1.055,1.295,0.4647,0.6947,1.3896,0.5736,0.0976,1.1148085896666666,1.126692741,0.457136724,1.1873,2.7045,0.2828,3.9534,0.3478,-59.014,0.8536,3.3412,0.3532,5.2592,0.4222,0.99,1.2860297623333334,4.088128696666667,3.0392455866666666,0.34171327133333335,0.27730770266666666,0.6769,7.2208,0.5279,2.8693,0.584,0.8899,0.065,0.407,0.399,0.014,1.831,130.78571428571428,395,1.1703703703703703,1,0,0,1,FALSE,FALSE,FALSE
272,2021-11-13T02:36:32Z,1,1.6,900,6,3,3,2,5,3,5,3,4,4,2,1,4,1,1,2,1,5,4,5,2,3,4,4,3,3,1,1,3,2,3,5,4,3,4,2,4,2,3,5,2,1,4,2,3,5,2,2,3,5,1,3,3,5,3,2,1,3,1,1,2,4,4,2,4,1,4,2,1,1,3.75,0,2,0,3.4,0,2.7777777777777777,0,2.5833333333333335,0,3.3333333333333335,0,2.4285714285714284,0,2.3333333333333335,0,2.7567567567567566,0,2,1,3,1.4032663585700773,1.3997956998057508,0.7185311394745503,1.0591634196401505,5,1,4,1,1,1,1,1.1428571428571428,0,1,-0.8176513788914915,2,3,4,4,3,3,4,3,0,3,-0.7395711320441822,0,1,2,2,3,3,1,5,2,2,4,1,5,3,5,5,3,5,1,3,2,2.2,0,5,0,3.6,0,4.4,0,4.333333333333333,0,2,3,3,4,4,2,4,3,1,2,2,3,3,2,2,2,2,2,1,3,2.3,0,"White, Caucasian, Anglo, European American",0,26,1,2,NA,5,2,0,1,1,0,1,TRUE,TRUE,TRUE,TRUE,TRUE,0,5,1.1270463414637417,0.8367346938775511,0.13821157710891285,5,0.4669562499998137,0.5492419354826693,1,0.96875,0.0012484289919824391,0.004857595967768703,5,0.6350562500006054,0.6878451612901784,1,0.96875,0.009669316733809294,0.014831435766100942,1.9942,0.9407,0.4376,1.2048,1.0741,0.8075,0.2376,1.84208076,0.8897244423333334,0.441568568,1.3767,6.4458,0.3602,4.2271,0.3937,-91.3561,0.8341,8.9588,0.4247,8.5846,0.4948,0.896,1.4115618956666667,4.131016366666667,5.94688495,0.38764400066666665,0.35337581166666665,1.2238,4.2626,0.4988,3.6903,0.5234,0.9919,0.074,0.457,0.398,0.012,1.026,85.5,440,1.3037037037037038,1,0,0,1,FALSE,FALSE,FALSE
273,2021-11-13T02:46:00Z,1,1.6,900,6,3,3,4,2,4,2,2,3,2,2,2,5,3,2,3,2,3,5,5,1,2,4,3,4,1,2,0,1,5,1,4,4,4,5,5,5,5,3,5,3,1,3,2,4,1,4,5,5,5,1,3,1,2,2,1,2,5,5,1,5,1,1,1,1,3,2,3,3,3,3.375,0,2.75,0,2.6,0,1.7777777777777777,0,2.9166666666666665,0,2.1666666666666665,0,2.142857142857143,0,1.6666666666666667,0,2.324324324324324,0,1,0,1,0.9010365460276174,0.7090038827860924,0.191109772438372,0.4500568276122322,5,1,4,1,1,1,1,1.1428571428571428,0,1,-0.8176513788914915,5,5,5,5,4,4,4,4.285714285714286,0,1.7142857142857142,-0.7395711320441822,0,1,3,3,3,3,1,5,1,1,4,1,5,2,5,5,1,5,5,5,3,2.6,0,4.2,0,4.6,0,4.6,0,4.466666666666667,0,2,2,3,3,3,3,2,3,3,3,2,1,2,3,1,2,2,3,1,4,2.5,0,"White, Caucasian, Anglo, European American",0,27,1,2,NA,5,2,0,0,1,0,0,TRUE,TRUE,TRUE,TRUE,TRUE,0,5,0.7378418604592945,0.86,0.01741979836725439,5,0.4327933333237966,0.5247781250067055,0.9375,1,0.0027255496679670075,0.005242350151118996,5,0.5665967741935484,0.6326862068895636,0.96875,0.90625,0.0077557844748360975,0.005186309989144534,1.2076,1.6315,0.4737,0.7668,2.3151,0.6273,0.2475,1.2420611803333332,1.3149428913333334,0.46487601566666664,1.232,3.5999,0.2759,4.1067,0.3748,-69.685,0.7734,4.9482,0.3609,4.7873,0.447,0.8686,1.3349842946666666,4.176435286666667,3.88490507,0.366993776,0.27068870333333334,0.7675,4.2824,0.4779,2.6329,0.5341,0.9278,0.049,0.453,0.411,0.018,1.725,95.83333333333334,372,1.1022222222222222,1,0,0,1,FALSE,FALSE,FALSE
275,2021-11-13T02:44:13Z,1,1.7777777777777777,1080,4,3,2,4,4,3,3,4,2,4,3,3,3,1,3,2,2,3,4,1,2,2,3,3,3,5,2,0,5,1,1,1,1,1,1,1,3,3,2,3,2,1,3,2,4,4,4,4,5,5,2,4,1,1,4,3,1,4,3,3,4,3,3,1,4,3,4,4,4,4,2.625,0,4,0,3.533333333333333,0,4.555555555555555,0,3.0833333333333335,0,2.6666666666666665,0,2.5714285714285716,0,2.6666666666666665,0,3.2972972972972974,0,3,0,5,1.0397276239682132,1.2059248844084727,1.6950993212143333,1.450512102811403,1,4,1,3,4,4,4,4.142857142857143,0,2.5,1.5306410215281119,3,3,4,2,1,1,3,2.4285714285714284,0,3.5714285714285716,0.38995568780511447,0,3,2,2,2,3,2,3,3,2,3,1,3,2,3,4,5,4,2,3,4,2.4,0,4,0,2.8,0,3.2,0,3.3333333333333335,0,1,1,1,4,3,2,2,3,1,1,1,4,1,2,1,4,1,2,1,2,1.4,0,"White, Caucasian, Anglo, European American",0,19,0,1,NA,5,2,0,0,1,0,0,TRUE,TRUE,TRUE,TRUE,TRUE,0,4,0.8944771428627627,0.7142857142857143,0.17088587677776026,4,0.5162466666738192,0.598018750003539,0.967741935483871,1,0.006613907612675412,0.006431478346734297,4,0.6844366666734218,0.7317666666726271,0.967741935483871,0.967741935483871,0.021376807461679435,0.025570173784610455,1.4239,0.6651,0.464,1.1274,0.886,0.5983,0.3895,1.45214865,0.7525184583333333,0.45628402766666665,1.1584,3.302,0.3481,4.6757,0.4741,-73.1498,1.1352,5.0248,0.4032,4.363,0.4665,0.6897,1.431663642,4.726847136666667,3.8105288366666668,0.4503455846666667,0.33099258433333334,1.653,4.6104,0.4975,6.1557,0.5692,0.9769,0.08,0.456,0.344,0.018,1.426,79.22222222222223,104,0.3081481481481481,1,0,0,1,FALSE,FALSE,FALSE
276,2021-11-13T02:43:34Z,0.800000011920929,1.7777777777777777,1080,3,3,5,3,3,3,3,3,5,2,1,1,1,4,2,4,3,2,1,3,1,1,1,2,1,2,1,1,1,5,2,5,5,5,5,3,3,5,3,5,1,1,5,3,5,5,4,3,3,5,1,1,3,1,3,3,1,2,2,1,3,4,2,2,4,1,2,1,1,1,1.5,0,1.25,0,2.066666666666667,0,1.7777777777777777,0,2.5833333333333335,0,2.5,0,2,0,2.3333333333333335,0,2.2972972972972974,0,1,1,1,-0.28204037640504065,-0.337588791647643,-0.07266423627205096,-0.205126513959847,4,2,1,1,1,2,1,2,0,1,-0.3048482679606258,3,3,4,2,1,1,4,2.2857142857142856,0,3.7142857142857144,1.5194825076544112,0,2,3,4,3,4,3,5,1,2,2,1,4,4,4,5,4,5,2,4,4,3.2,0,4.2,0,3,0,4,0,3.7333333333333334,0,2,1,4,1,4,4,4,1,4,3,1,1,3,3,2,1,1,4,1,2,2.95,0,"Hispanic of Latino (e.g., Mexican American, Central American, and others) & White, Caucasian, Anglo, European American",1,22,0,1,NA,5,2,0,0,1,0,0,TRUE,TRUE,TRUE,TRUE,TRUE,0,3,0.7314285714285714,0.84,0.0388761506122449,3,0.49023333333333335,0.5291612903225806,0.967741935483871,0.96875,0.004465873118279571,0.0033828225806451615,3,0.54996875,0.6052666666666666,1,0.9375,0.007613837701612904,0.005451290322580643,1.1813,1.4582,0.4663,0.968,1.5194,0.5344,0.1425,1.2269479446666667,1.2294072843333332,0.45736202,1.2946,3.3401,0.3049,4.2562,0.3833,-64.5223,0.7998,4.8128,0.4109,4.6167,0.4539,0.935,1.412423729,4.297779956666667,3.6627563166666666,0.374167326,0.298772813,0.8138,4.0988,0.471,3.686,0.5215,0.8488,0.089,0.34,0.448,0.016,1.701,106.3125,314,0.9303703703703704,1,0,0,1,FALSE,FALSE,FALSE
277,2021-11-13T02:46:06Z,1,1.6,800,7,3,2,4,3,3,2,1,4,2,2,1,1,4,3,4,3,2,3,1,1,1,1,1,1,0,2,0,0,4,4,3,4,5,4,4,4,4,2,4,2,2,3,3,4,1,1,1,1,1,4,1,1,1,1,1,1,1,1,1,5,2,2,1,1,1,2,2,1,2,1.375,0,1.75,0,2.2,0,2,0,1.75,0,1,0,1.1428571428571428,0,1,0,1.5675675675675675,0,0,0,0,-0.8136895085106579,-0.6476078738830316,-0.5020371591262895,-0.5748225165046605,5,1,3,1,1,1,1,1.2857142857142858,0,2,-0.3631965189619651,4,4,4,4,3,3,3,3.5714285714285716,0,2.4285714285714284,-0.4571894270818581,0,1,1,1,2,1,1,4,1,1,1,1,3,3,4,4,3,4,2,3,3,1.2,0,4.2,0,2.8,0,4.2,0,3.7333333333333334,0,2,2,2,1,3,3,3,2,2,2,2,2,2,2,1,2,3,3,1,2,2.4,0,"White, Caucasian, Anglo, European American",0,27,1,2,NA,5,2,0,0,1,0,0,TRUE,TRUE,TRUE,TRUE,TRUE,0,2,0.975070731707099,0.82,0.02978663339148163,2,0.5433903225794915,0.6387766666650772,1,0.967741935483871,0.00963447490319328,0.012553527312115861,2,0.6326451612908033,0.7581166666671634,0.96875,0.9375,0.012641774838886564,0.01800265032263755,1.325,1.2497,0.6312,0.9267,1.5744,0.7961,0.1275,1.3722576766666668,1.1285868916666666,0.6185975046666666,1.9119,4.6315,0.337,2.9274,0.3252,-45.95,1.0677,5.8014,0.4453,3.1238,0.4928,0.9665,1.86993969,2.95742694,4.497674476666667,0.32815481766666665,0.33475568866666666,1.6105,4.3228,0.4484,4.9731,0.5805,0.9882,0.064,0.461,0.355,0.01,1.526,152.6,404,1.1970370370370371,1,0,0,1,FALSE,FALSE,FALSE
278,2021-11-13T02:39:07Z,0.8999999761581421,1.7786458333333333,768,6,3,3,4,2,4,2,3,2,2,1,4,4,3,1,3,1,2,2,1,1,1,1,3,1,6,2,0,0,4,1,4,2,2,2,1,1,2,1,2,1,1,2,1,1,1,1,1,1,1,3,1,5,1,1,1,1,5,5,5,4,1,1,1,1,1,2,2,3,3,1.5,0,2.5,0,2.7333333333333334,0,3.888888888888889,0,1.8333333333333333,0,1.8333333333333333,0,2.7142857142857144,0,1,0,2.4864864864864864,0,3,0,0,-0.16436309815241404,0.03021405333970467,0.3424438704149829,0.1863289618773438,5,1,4,1,1,1,1,1.1428571428571428,0,3,-0.07967602934272733,4,4,4,5,2,2,2,3.5714285714285716,0,2.4285714285714284,0.6723373927674386,0,2,2,2,2,2,2,5,2,1,3,1,2,1,4,5,1,5,1,3,2,2,0,4.2,0,4.2,0,4.4,0,4.266666666666667,0,1,1,2,1,1,3,2,1,3,1,4,2,1,2,1,2,1,2,2,2,2.15,0,"Black or African American & White, Caucasian, Anglo, European American",1,24,1,2,NA,5,2,0,0,0,0,0,TRUE,TRUE,TRUE,TRUE,TRUE,0,3,1.0605499999962356,0.7755102040816326,0.13822577067996816,3,0.5886000000238418,0.6729548386758374,1,0.96875,0.0034208774232464445,0.01700752902701901,3,0.6361483871013888,0.7476531250178814,0.96875,1,0.008096902168713511,0.011847811596346708,1.6135,0.8323,0.5207,1.2591,1.0153,0.6823,0.249,1.6060908033333334,0.8502265723333333,0.5137173106666667,1.3992,5.7656,0.4673,2.6512,0.4191,-65.6988,1.2977,4.9114,0.4628,3.205,0.4866,0.8048,1.6850337733333334,2.983346516666667,5.601045966666667,0.39366347966666665,0.44188604766666667,0.9787,4.5136,0.5293,3.0652,0.6152,0.987,0.226,0.283,0.645,0.014,1.686,120.42857142857142,111,0.32888888888888884,1,0,0,1,FALSE,FALSE,FALSE
279,2021-11-13T02:49:16Z,1,1.7777777777777777,1152,3,3,4,4,2,5,2,1,4,2,2,1,1,5,3,4,3,1,2,4,3,2,1,2,2,0,1,4,1,5,4,2,3,3,4,4,4,4,2,4,2,1,4,2,5,2,3,1,1,2,2,3,5,4,4,3,2,1,1,1,4,2,2,1,2,1,2,2,1,1,2.125,0,1.5,0,1.8,0,2.3333333333333335,0,1.75,0,3.6666666666666665,0,1.4285714285714286,0,1.3333333333333333,0,2.1621621621621623,0,0,4,1,0.022659719070510696,-0.24166968128383745,0.42254411542774484,0.0904372170719537,5,1,4,1,1,2,2,1.4285714285714286,0,1,-0.6467170085812028,5,5,5,5,3,3,2,4.285714285714286,0,1.7142857142857142,-0.7395711320441822,0,2,2,2,2,2,2,3,3,2,3,2,4,1,3,3,3,3,2,3,3,2,0,3.8,0,3.4,0,3.2,0,3.466666666666667,0,1,2,1,1,1,1,1,3,1,1,1,4,1,2,1,3,1,1,1,1,1.35,0,"White, Caucasian, Anglo, European American",0,18,1,2,NA,5,2,0,0,0,0,0,TRUE,TRUE,TRUE,TRUE,TRUE,0,3,0.6414552631582084,0.76,0.023195661616318725,3,0.43176774193682976,0.48738620689639756,1,0.9354838709677419,0.003844414258025525,0.005630439591432899,3,0.677881249998929,0.6900937499993015,1,1,0.014439768024078512,0.01088006834680769,0.9974,1.1923,0.4303,0.8464,1.2197,0.4741,0.0525,1.0578290196666666,1.07665316,0.42252535933333335,1.235,4.8032,0.3032,3.0844,0.3123,-68.1719,0.6694,7.3118,0.3836,3.1956,0.4151,0.9514,1.3176888916666667,3.294919693333333,4.866130383333333,0.307561688,0.29730153,1.2005,3.6786,0.5166,4.249,0.5549,0.9659,0.129,0.407,0.479,0.181,1.553,8.58011049723757,366,1.0844444444444443,1,0,0,1,FALSE,FALSE,FALSE
280,2021-11-13T02:44:11Z,1,1.7786458333333333,768,6,4,5,5,5,5,5,1,1,1,1,1,1,5,2,5,5,4,4,5,1,1,4,4,2,3,1,0,0,5,5,5,5,5,5,5,5,5,1,5,3,1,5,1,5,2,1,1,1,5,1,1,5,5,5,5,1,5,5,1,5,2,1,1,5,1,4,4,4,4,3.125,0,4,0,1.8666666666666667,0,1,0,1.5833333333333333,0,4.166666666666667,0,2.142857142857143,0,2.3333333333333335,0,2.081081081081081,0,2,0,0,0.5942350705832687,0.18188433178580324,0.6097586129219131,0.3958214723538582,5,1,4,1,1,1,1,1.1428571428571428,0,2,-0.44866370411710943,4,4,4,4,2,2,2,3.4285714285714284,0,2.5714285714285716,-0.1748077221195339,0,4,4,4,2,4,2,5,3,3,4,1,2,1,5,1,1,3,1,3,5,3.6,0,3.8,0,4.4,0,2.6,0,3.6,0,4,1,4,1,4,4,4,1,4,4,3,1,4,4,4,2,2,4,4,4,3.65,0,"White, Caucasian, Anglo, European American",0,26,1,2,NA,5,1,0,0,0,1,0,TRUE,TRUE,TRUE,TRUE,TRUE,0,NA,NA,NA,NA,NA,NA,NA,NA,NA,NA,NA,5,0.8582482758554919,1.1416249999801318,0.9354838709677419,0.8275862068965517,0.3639301471614663,0.40154075891646623,NA,NA,NA,NA,NA,NA,NA,NA,NA,NA,NA,NA,NA,NA,NA,NA,NA,NA,NA,NA,NA,NA,NA,NA,NA,NA,NA,1.876,2.1061,0.2979,1.1857,0.3597,0.9795,0.077,0.373,0.15,0.008,2.102,262.75,104,0.3081481481481481,1,0,0,1,FALSE,FALSE,FALSE
281,2021-11-13T02:52:04Z,1,1.6,900,6,2,2,4,3,4,4,3,2,3,1,3,1,4,2,3,2,3,2,1,1,2,2,3,1,1,2,0,0,3,2,3,4,3,3,2,3,3,4,3,3,3,3,2,4,3,3,3,3,3,4,1,1,1,1,1,3,1,1,1,3,2,2,1,1,1,1,1,1,1,1.875,0,1,0,2.7333333333333334,0,3.111111111111111,0,2.9166666666666665,0,1,0,1.7142857142857142,0,1,0,2.324324324324324,0,1,0,0,-0.03197616011820878,0.12168081347471636,-0.5341482934814965,-0.20623374000339006,5,2,4,1,1,2,1,1.4285714285714286,0,2,-0.2777293338068208,5,5,5,5,5,5,1,5,0,1,-1.869097951893479,0,2,3,4,4,3,4,3,4,4,4,1,3,2,2,3,3,4,2,3,2,3.2,0,3.6,0,3.4,0,2.6,0,3.2,0,2,2,3,4,4,3,2,2,2,1,3,2,3,3,1,2,1,2,1,3,2.3,0,"White, Caucasian, Anglo, European American",0,28,1,2,NA,5,2,0,0,1,0,0,TRUE,TRUE,TRUE,TRUE,TRUE,0,4,0.7691555555562178,0.72,0.03290322289370864,4,0.4511903225789147,0.5393124999990687,1,1,0.004851032903262608,0.005739908225766081,4,0.6309687499990687,0.6910258064491134,1,1,0.007231995121104177,0.0148101079784366,1.149,0.8646,0.5096,0.8446,0.8213,0.6205,0.225,1.2115693786666666,0.901879944,0.500224653,2.1711,6.3918,0.2814,5.6653,0.3477,-84.3027,0.8604,5.4118,0.372,5.0505,0.4529,0.98740000000000006,1.64174681,4.653426486666667,5.3476708833333335,0.367418222,0.3009633663333333,1.462,7.0937,0.5375,3.6572,0.5077,0.4583,0.299,0.213,0.715,0.023,1.452,63.130434782608695,404,1.1970370370370371,1,0,0,1,FALSE,FALSE,FALSE
284,2021-11-13T02:51:27Z,1,1.7777777777777777,1440,3,2,4,4,2,4,2,2,4,2,2,2,2,4,2,4,4,2,2,1,1,2,2,2,2,0,2,0,0,4,4,3,4,3,5,5,5,4,1,4,2,2,4,2,4,2,2,2,2,2,4,2,1,1,2,1,3,1,1,1,4,2,2,1,1,1,1,1,1,2,1.75,0,1.25,0,2,0,1.8888888888888888,0,1.9166666666666667,0,1.3333333333333333,0,1.5714285714285714,0,1,0,1.7297297297297298,0,0,0,0,-0.4795700934719498,-0.5027129110024894,-0.6588395645607719,-0.5807762377816306,5,1,3,2,1,1,2,1.5714285714285714,0,2,-0.19226214865167657,4,4,4,4,2,2,2,3.4285714285714284,0,2.5714285714285716,0.38995568780511447,0,2,2,3,4,3,2,4,3,3,2,3,3,3,3,3,4,3,3,3,3,2.8,0,3.2,0,2.8,0,3,0,3,0,2,4,4,1,3,4,4,1,4,1,2,1,2,4,2,1,1,4,3,4,3.2,0,"White, Caucasian, Anglo, European American",0,19,0,1,NA,5,2,0,0,1,0,0,TRUE,TRUE,TRUE,TRUE,TRUE,0,5,0.6253486486383386,0.74,0.025095121677862344,5,0.36679677418739565,0.4346333333015442,0.96875,0.9375,0.0034148141870159092,0.006638638669195907,5,0.49744062502682207,0.5514777778519524,1,0.84375,0.005953167644715058,0.008653174674274768,1.0477,1.0425,0.392,0.9004,1.154,0.4465,0.0702,1.1072134246666667,1.0005876513333334,0.38425958233333335,1.1639,4.4039,0.2445,2.5754,0.2305,-61.0655,0.8482,4.9712,0.2837,4.0115,0.3383,0.9978,1.2201338626666667,2.80762608,4.549076583333333,0.22973260433333334,0.241795867,0.8324,4.8199,0.4166,2.4085,0.4242,0.978,0.05,0.365,0.379,0.009,1.403,155.88888888888891,420,1.2444444444444445,1,0,0,1,FALSE,FALSE,FALSE
285,2021-11-13T02:43:39Z,1,1.7777777777777777,864,3,3,3,5,3,4,1,2,4,2,1,1,3,4,2,3,3,1,1,1,1,1,1,2,2,0,2,0,0,5,5,5,5,5,5,5,5,5,1,4,3,1,5,1,5,1,1,3,2,3,5,1,1,1,1,1,1,1,1,1,4,2,1,1,2,2,1,1,1,1,1.25,0,1,0,2.066666666666667,0,1,0,1.6666666666666667,0,0.8333333333333334,0,1.1428571428571428,0,1.6666666666666667,0,1.3243243243243243,0,0,0,0,-1.0427399251095204,-0.8631596990900906,-0.7372407672780129,-0.8002002331840518,4,1,3,1,1,3,1,1.7142857142857142,0,1,-0.4757826382709144,4,4,5,5,2,2,3,3.5714285714285716,0,2.4285714285714284,-0.1748077221195339,0,1,3,1,2,1,1,4,2,1,2,1,5,1,5,5,3,5,1,3,4,1.6,0,5,0,3.4,0,4.2,0,4.2,0,3,4,2,3,3,2,4,1,2,3,3,2,3,2,1,3,1,2,1,2,2.45,0,"White, Caucasian, Anglo, European American",0,18,1,2,NA,5,2,0,0,0,0,0,TRUE,TRUE,TRUE,TRUE,TRUE,0,1,1.144307317074479,0.82,0.1518873960986294,1,0.42834838709908146,0.5366354838725059,1,0.96875,0.0016210285807507086,0.0036229772582377735,1,0.5858750000018627,0.6402399999996027,1,0.9375,0.008959312257505177,0.01524288887042431,1.7054,0.8947,0.5474,1.5758,0.8911,0.6182,0.372,1.67404789,0.886987751,0.541972658,1.9504,7.3158,0.2951,4.2645,0.317,-81.3814,0.744,6.862,0.3785,4.9553,0.4648,0.9899,1.6974031366666666,3.83807468,6.20180507,0.32447956533333333,0.29748405,0.8688,12.0833,0.5467,3.0312,0.5312,0.9918,0.066,0.399,0.361,0.016,1.507,94.18749999999999,378,1.12,1,0,0,1,FALSE,FALSE,FALSE
288,2021-11-13T02:48:49Z,0.4000000059604645,1.6,900,4,3,2,4,1,4,1,1,3,1,1,1,1,5,3,4,5,2,1,1,1,1,1,3,3,0,2,0,0,5,2,5,5,5,5,5,5,5,2,5,1,1,5,2,5,5,1,3,2,4,5,1,1,1,2,1,1,1,1,1,5,2,1,1,1,1,2,2,1,1,1.625,0,1.5,0,1.6666666666666667,0,1.3333333333333333,0,2,0,1,0,1,0,1,0,1.4594594594594594,0,0,0,0,-0.7254315498211877,-0.8158292803535607,-0.5804383618435307,-0.6981338210985457,5,1,4,1,1,1,1,1.1428571428571428,0,1,-0.8176513788914915,4,4,4,4,2,2,2,3.4285714285714284,0,2.5714285714285716,-0.1748077221195339,0,1,1,1,1,1,1,4,1,1,2,1,4,1,3,1,1,5,1,4,1,1,0,4.8,0,4,0,3.8,0,4.2,0,1,2,1,3,3,1,1,3,1,1,2,4,1,1,1,4,1,1,2,1,1.35,0,"White, Caucasian, Anglo, European American",0,20,1,2,NA,5,2,0,1,0,0,1,TRUE,TRUE,TRUE,TRUE,TRUE,0,6,0.5557948717948643,0.78,0.011951871020409737,6,0.4019999999999981,0.48132142857143223,0.967741935483871,0.875,0.0027809397849462565,0.006787028225806848,6,0.5905937500000036,0.6971379310344807,1,0.90625,0.00681786189516153,0.007895353830645015,0.9706,1.3816,0.3682,0.694,1.4395,0.4548,0.1854,1.0254205023333334,1.1630422733333334,0.361759276,0.9849,4.1919,0.2929,2.253,0.3031,-62.4088,0.7075,7.4789,0.351,3.7081,0.3908,0.9856,1.0578650906666667,2.5445293533333335,4.393741956666666,0.299075212,0.28879428166666665,0.9344,4.1306,0.4873,4.1427,0.587,0.834,0.062,0.451,0.477,0.009,1.555,172.77777777777777,104,0.3081481481481481,1,0,0,1,FALSE,FALSE,FALSE
289,2021-11-13T02:45:05Z,1,1.7777777777777777,720,4,3,3,2,3,4,3,4,3,3,2,4,1,3,2,2,3,2,3,1,3,1,2,3,2,5,2,0,0,4,1,5,3,4,4,5,5,4,1,4,2,1,3,4,3,5,2,2,3,2,1,1,5,1,3,3,1,4,3,1,4,2,3,2,3,1,2,2,2,2,2.125,0,2,0,2.933333333333333,0,2.111111111111111,0,2.5,0,2.8333333333333335,0,2.142857142857143,0,2,0,2.4054054054054053,0,3,0,0,0.17395907682388775,0.34991215781160245,0.1856414649805007,0.2677768113960516,4,2,3,2,1,2,2,2,0,2,0.06413940681375631,4,3,3,2,1,1,3,2.4285714285714284,0,3.5714285714285716,0.9547190977297628,0,3,3,4,3,4,4,3,4,3,2,3,2,3,2,3,3,2,4,3,2,3.4,0,2.2,0,2.8,0,2.8,0,2.6,0,2,2,1,3,3,1,2,2,1,1,2,3,2,1,2,3,1,2,1,2,1.75,0,"White, Caucasian, Anglo, European American",0,18,0,1,NA,5,2,0,0,0,0,0,TRUE,TRUE,TRUE,TRUE,TRUE,0,2,0.9155102563637953,0.7959183673469388,0.042710200204252265,2,0.4585124999731779,0.5178531250208617,1,1,0.004381728866003174,0.0034631625673449615,2,0.5859937500208616,0.6876124999821186,1,1,0.005136669638296211,0.004540171446186034,1.3327,1.0762,0.5711,1.0246,1.2504,0.6931,0.2144,1.3805375,1.0229542136666667,0.5596481556666667,3.2751,7.7609,0.2475,7.7392,0.3063,-93.6738,0.8525,5.7321,0.3818,5.8409,0.4478,0.9968,1.7256902133333334,5.09456178,5.643673673333334,0.3541629986666667,0.3097314273333333,0.82,5.9997,0.5168,5.8242,0.6283,0.855,0.184,0.318,0.7,0.014,1.714,122.42857142857143,346,1.0251851851851852,1,0,0,1,FALSE,FALSE,FALSE
290,2021-11-13T02:56:47Z,1,1.6,800,7,4,3,5,5,5,5,3,5,3,2,1,1,5,5,3,5,1,1,1,1,1,1,1,1,2,2,0,0,5,4,5,5,5,5,3,3,5,2,4,1,1,4,1,5,5,1,3,2,5,5,1,1,1,1,1,3,2,2,1,5,3,4,1,1,1,1,1,1,2,1,0,1.25,0,2.4,0,1.5555555555555556,0,2.1666666666666665,0,0.8333333333333334,0,2.142857142857143,0,1,0,1.7567567567567568,0,1,0,0,-0.9292654067944875,-0.6415100898740308,-0.4557470907642554,-0.5486285903191431,5,1,5,1,1,1,1,1,0,1,-0.9031185640466358,5,5,5,5,3,3,1,4.428571428571429,0,1.5714285714285714,-0.7395711320441822,0,3,2,2,3,2,2,4,2,1,4,1,5,1,5,5,2,5,2,4,5,2.4,0,4.6,0,4.2,0,4,0,4.266666666666667,0,2,2,2,4,2,1,2,4,1,1,3,4,2,1,3,2,1,2,1,3,1.75,0,"White, Caucasian, Anglo, European American",0,30,1,2,NA,5,2,0,0,1,0,0,TRUE,TRUE,TRUE,TRUE,TRUE,0,6,0.9089942857197353,0.7,0.06598407265565367,6,0.4643718750104308,0.5317413793021235,1,0.90625,0.002592929828371839,0.005306323857290735,6,0.7093624999970198,0.879309374973178,1,1,0.004829001124900464,0.011695162818752314,1.3219,0.6792,0.5679,1.0857,0.4307,0.6695,0.2025,1.37140951,0.7673394026,0.558331527,1.2183,5.2882,0.3492,2.5761,0.3331,-68.809,0.6476,5.5232,0.4116,3.3441,0.4687,0.9918,1.3091741143333333,2.81886117,5.24048015,0.3280018536666667,0.34227787266666665,1.0602,5.5999,0.6213,3.7293,0.7369,0.9208,0.155,0.449,0.597,0.008,1.561,195.125,104,0.3081481481481481,1,0,0,1,FALSE,FALSE,FALSE
292,2021-11-13T02:52:38Z,1,1.7777777777777777,900,7,2,1,3,1,4,3,2,3,2,1,1,1,4,1,4,5,1,1,1,3,1,1,1,1,0,4,0,0,4,4,4,4,3,5,5,5,5,2,5,3,1,4,2,5,2,3,1,1,3,4,1,1,1,1,1,1,1,2,1,4,1,2,1,1,1,3,3,2,2,1.25,0,2.5,0,2,0,1.6666666666666667,0,1.8333333333333333,0,1,0,1.2857142857142858,0,1,0,1.5405405405405406,0,0,0,0,-0.9082516071065188,-0.7988909914396698,-0.26683355097456624,-0.532862271207118,3,1,2,3,1,1,2,2.142857142857143,0,1.5,-0.03488724541829051,2,4,4,4,2,3,2,3.2857142857142856,0,2.7142857142857144,-0.1748077221195339,0,1,2,2,2,2,1,2,2,2,1,2,2,2,4,4,3,4,2,1,4,1.8,0,3.8,0,2.2,0,3.6,0,3.2,0,2,3,2,2,1,1,4,2,3,2,2,2,2,1,1,2,1,2,1,2,2.1,0,"White, Caucasian, Anglo, European American",0,30,1,2,NA,5,2,0,0,1,0,0,TRUE,TRUE,TRUE,TRUE,TRUE,0,6,0.7501138888878954,0.72,0.03686956428150865,6,0.49729000000059603,0.6590967741945097,0.967741935483871,0.96875,0.005024546924631495,0.015075232539532147,6,0.6688843749975786,0.7389193548396711,1,1,0.009384383941727683,0.007217027612927111,1.1254,0.8977,0.4941,0.8606,0.9556,0.5719,0.1495,1.1864030603333333,0.9223426256666667,0.485399669,1.6196,2.8524,0.2318,3.4036,0.4327,-39.2441,1.1223,5.7114,0.4026,3.8431,0.5079,0.9972,1.7455963233333334,3.4465452266666667,3.1677043966666667,0.415885417,0.229643123,0.9364,4.644,0.566,4.0465,0.6364,0.9899,0.169,0.402,0.646,0.01,1.139,113.9,356,1.0548148148148149,1,0,0,1,FALSE,FALSE,FALSE
293,2021-11-13T02:39:44Z,0.800000011920929,1.7777777777777777,1080,6,2,3,3,5,4,2,1,4,4,1,1,1,3,1,3,3,4,1,5,1,5,4,2,4,2,2,0,0,4,1,1,4,2,2,4,5,2,1,5,5,1,2,1,1,1,5,5,5,5,5,1,1,1,4,3,1,2,1,1,4,4,3,1,1,2,1,1,2,3,3.25,0,1.75,0,2.3333333333333335,0,3.2222222222222223,0,3.25,0,1.6666666666666667,0,1.8571428571428572,0,1.3333333333333333,0,2.6216216216216215,0,1,0,0,1.008206924436259,0.6684487796151188,-0.2989446853297732,0.18475204714267282,4,2,2,1,1,2,3,2.142857142857143,0,1.5,-0.03488724541829051,4,3,5,5,1,1,4,3,0,3,-0.7395711320441822,0,3,1,4,5,4,1,4,2,1,2,1,4,3,5,4,5,4,1,2,5,3.4,0,4.6,0,2.4,0,3.8,0,3.6,0,3,4,4,1,4,4,4,1,4,3,3,1,3,4,2,1,1,4,3,4,3.5,0,"Black or African American & Hispanic of Latino (e.g., Mexican American, Central American, and others) & White, Caucasian, Anglo, European American & Native American/Alaskan Native/indigenous",1,22,0,1,NA,5,2,0,1,1,0,1,TRUE,TRUE,TRUE,TRUE,TRUE,0,3,0.6909800000000538,0.9183673469387755,0.11626790564621277,3,0.5754093749999883,0.651900000000012,1,1,0.022906805393177226,0.022729525999990778,3,0.5961633333333303,0.6421937499999912,0.967741935483871,1,0.006840556645159035,0.013426657379045703,1.2636,1.846,0.4444,1.5899,2.6728,0.3809,0.0675,1.2753136913333334,1.43060912,0.435775988,1.6213,3.5613,0.3478,3.4736,0.4185,-50.0373,1.1307,2.9382,0.3939,3.7954,0.4864,0.9158,1.8245504766666667,3.6317843666666665,3.822796853333333,0.39914094033333336,0.331828337,0.9329,4.6038,0.5107,2.9524,0.5219,0.78,0.071,0.416,0.367,0.031,1.422,45.87096774193548,430,1.2740740740740741,1,0,3,4,FALSE,FALSE,FALSE
294,2021-11-13T02:47:17Z,1,1.7786458333333333,768,4,2,4,4,2,3,3,1,5,3,3,1,2,4,1,5,3,3,4,5,1,1,2,1,1,7,1,1,2,5,2,3,4,3,4,3,3,4,2,5,2,4,2,1,5,3,2,3,1,2,1,2,5,3,4,2,1,4,4,1,4,2,2,2,3,1,3,3,1,3,2.25,0,2.5,0,2,0,2.5555555555555554,0,2.1666666666666665,0,3.3333333333333335,0,2.142857142857143,0,2,0,2.4864864864864864,0,4,1,2,0.30214325492049876,0.03737652979472142,1.1050688456028845,0.571222687698803,3,3,2,2,2,3,3,2.857142857142857,0,1,0.20795484297024003,3,2,3,4,1,1,3,2.4285714285714284,0,3.5714285714285716,2.0842459175790595,0,3,3,2,2,3,3,4,3,3,2,2,3,2,3,4,1,4,1,3,3,2.6,0,3.8,0,3.6,0,3.2,0,3.533333333333333,0,2,2,1,3,1,1,2,2,2,1,3,3,1,1,1,3,1,1,1,2,1.6,0,"Hispanic of Latino (e.g., Mexican American, Central American, and others)",0,19,1,2,NA,5,2,0,0,1,0,0,TRUE,TRUE,TRUE,TRUE,TRUE,0,4,0.928246874999255,0.64,0.0663067796876988,4,0.5048374999985099,0.572199999999255,1,1,0.007703482419497774,0.008934820645970606,4,0.67069062500074506,0.8625300000011921,1,0.9375,0.01578034733097878,0.056654810953467284,1.2093,0.4786,0.57,1.198,0.6013,0.5826,0.1456,1.2725167366666668,0.6542263984666666,0.5583953636666666,4.5177,6.7109,0.1682,6.5265,0.2261,-67.6596,0.8492,4.9963,0.4264,4.5983,0.4828,0.9327,2.016800056666667,4.302193943333333,4.617657063333334,0.340534763,0.286988996,1.2028,3.0248,0.4944,2.0247,0.6053,0.9967,0.084,0.417,0.274,0.013,2.046,157.3846153846154,374,1.108148148148148,1,0,0,1,FALSE,FALSE,FALSE
295,2021-11-13T02:58:53Z,0.8999999761581421,1.7777777777777777,720,7,3,5,5,1,5,1,1,5,1,1,1,1,5,1,5,5,1,1,1,1,1,1,1,1,0,1,2,NA,5,1,3,1,3,5,5,5,5,5,5,1,1,5,1,5,1,1,1,1,1,1,1,5,1,2,1,1,1,1,1,4,3,1,1,1,1,1,1,1,1,1,0,1,0,1,0,2.3333333333333335,0,1.3333333333333333,0,2.3333333333333335,0,1.2857142857142858,0,1,0,1.7567567567567568,0,0,2,NA,-0.9292654067944875,-1.24315811209544,-0.2694891481859902,-0.7563236301407151,5,1,1,1,1,1,1,1.5714285714285714,0,1,-0.5612498234260587,5,5,5,5,3,5,1,4.714285714285714,0,1.2857142857142858,0.9547190977297628,0,1,1,1,1,1,1,4,1,1,1,1,4,1,5,1,2,5,2,1,2,1,0,4.6,0,3,0,4,0,3.8666666666666667,0,1,1,1,4,3,1,2,3,1,1,1,4,1,1,1,4,1,1,1,1,1.2,0,Black or African American,0,24,1,2,NA,5,2,0,0,1,0,0,TRUE,TRUE,TRUE,TRUE,TRUE,0,5,0.7008421052631579,0.7755102040816326,0.025603020408163268,5,0.49392592592592593,0.5384285714285715,1,0.9655172413793104,0.027539917378917377,0.00481088669950739,5,0.626,0.7085806451612904,1,1,0.008463161290322579,0.015536518279569892,1.0799,1.1933,0.4347,0.8338,1.7188,0.5293,0.2882,1.142390331,1.083478335,0.426513969,1.2867,4.1083,0.3373,3.6451,0.3693,-59.9106,1.0196,4.5383,0.3677,5.9385,0.4501,0.9972,1.430393293,3.8462569866666665,4.316462386666666,0.36028904733333333,0.325689617,1.0946,4.7374,0.5144,3.4831,0.5732,0.9749,0.256,0.205,0.614,0.015,1.465,97.66666666666667,396,1.1733333333333333,1,0,0,1,FALSE,FALSE,FALSE
296,2021-11-13T03:04:45Z,1,1.7777777777777777,720,6,3,5,5,2,5,2,1,4,1,1,1,1,5,1,5,4,1,1,1,1,1,1,1,1,0,2,0,0,5,4,5,5,5,5,5,5,5,1,5,1,1,4,1,5,1,1,1,1,1,5,1,1,1,5,1,1,1,1,1,5,1,1,1,3,1,2,1,1,1,1,0,1.25,0,1.2666666666666666,0,1.1111111111111112,0,1.0833333333333333,0,1.5,0,0.8571428571428571,0,1.6666666666666667,0,1.2162162162162162,0,0,0,0,-1.2654862018019926,-1.3608550224913916,-0.6588395645607719,-1.0098472935260818,5,1,3,1,1,1,1,1.2857142857142858,0,1,-0.7321841937363471,5,5,5,5,2,2,3,3.857142857142857,0,2.142857142857143,0.38995568780511447,0,5,2,3,3,2,1,5,1,1,3,1,5,3,5,5,1,5,1,5,4,3,0,5,0,4.2,0,4.4,0,4.533333333333333,0,1,1,2,4,1,1,2,4,1,1,2,4,2,1,2,4,2,3,2,3,1.55,0,"White, Caucasian, Anglo, European American",0,21,1,2,NA,5,2,0,0,1,0,0,TRUE,TRUE,TRUE,TRUE,TRUE,0,2,0.6598052631553851,0.76,0.015740339493077352,NA,NA,NA,NA,NA,NA,NA,2,0.5466374999582767,0.6614827586206896,1,0.90625,0.008193885630162915,0.01374763281567568,1.2482,1.0484,0.3685,0.8401,1.0572,0.5274,0.1678,1.2937632773333334,1.0100077953333333,0.362087196,NA,NA,NA,NA,NA,NA,NA,NA,NA,NA,NA,NA,NA,NA,NA,NA,NA,0.9445,4.4628,0.4426,2.6768,0.5258,0.9477,0.07,0.381,0.42,0.009,1.45,161.11111111111111,386,1.1437037037037037,1,0,0,1,FALSE,FALSE,FALSE
297,2021-11-13T02:48:57Z,1,1.7786458333333333,768,6,3,1,4,4,2,3,2,4,2,4,2,2,3,2,4,3,5,5,5,1,3,3,3,5,5,1,5,2,2,1,2,3,1,4,3,3,2,2,4,5,2,1,4,2,5,5,5,5,5,1,5,5,5,5,1,2,3,3,3,5,1,1,1,4,5,3,5,5,3,3.75,0,4,0,2.8,0,3.6666666666666665,0,4.083333333333333,0,4.166666666666667,0,1.8571428571428572,0,3.3333333333333335,0,3.5675675675675675,0,3,5,2,1.9075975510813352,1.4903913479394768,2.1989164184819097,1.8446538832106931,3,2,2,3,2,2,2,2.5714285714285716,0,5,1.51297117175748,1,1,1,1,1,1,5,1,0,5,0.6723373927674386,0,3,4,4,4,4,4,4,2,3,4,1,4,2,5,4,3,4,2,3,2,3.8,0,3.8,0,3.6,0,4,0,3.8,0,3,4,2,3,3,1,3,2,2,2,2,3,1,2,2,2,3,2,2,2,2.3,0,"White, Caucasian, Anglo, European American",0,28,1,2,NA,5,2,0,0,1,0,0,TRUE,TRUE,TRUE,TRUE,TRUE,0,3,0.7117289473602646,0.76,0.02025475071321701,NA,NA,NA,NA,NA,NA,NA,3,1.1357281249985098,1.3257062499932946,1,1,0.13525014659919832,0.2585314077015958,1.0055,1.1637,0.5154,0.839,1.1153,0.5637,0.2025,1.0758834586666666,1.0588015686666667,0.5055561726666666,NA,NA,NA,NA,NA,NA,NA,NA,NA,NA,NA,NA,NA,NA,NA,NA,NA,2.1989,1.8688,0.5668,1.2873000000000001,0.5934,0.9458,0.151,0.484,0.214,0.024,1.965,81.875,457,1.3540740740740742,1,0,0,1,FALSE,FALSE,FALSE
298,2021-11-13T02:47:11Z,1,1.7777777777777777,1080,6,3,5,5,3,4,2,1,5,1,1,1,1,5,1,5,3,1,2,1,1,1,2,1,1,0,2,0,0,4,5,5,4,5,5,5,5,5,1,3,1,3,5,1,5,1,3,3,3,1,4,1,2,1,2,1,1,1,2,2,4,1,1,1,1,1,1,2,1,2,1.25,0,1.5,0,1.4,0,1.2222222222222223,0,1.8333333333333333,0,1.3333333333333333,0,1.2857142857142858,0,1,0,1.4864864864864864,0,0,0,0,-0.9418736866072692,-1.0799697971878957,-0.5804383618435307,-0.8302040795157132,5,1,5,1,1,1,1,1,0,1,-0.9031185640466358,5,5,5,5,5,3,1,4.714285714285714,0,1.2857142857142858,-1.869097951893479,0,4,4,3,3,2,2,4,1,2,3,1,4,2,3,4,2,5,2,4,1,3.2,0,4.4,0,3.8,0,4.2,0,4.133333333333334,0,2,2,4,1,3,4,4,1,3,4,2,2,2,4,1,2,2,4,4,4,3.15,0,"White, Caucasian, Anglo, European American",0,22,1,2,NA,5,2,0,0,0,0,0,TRUE,TRUE,TRUE,TRUE,TRUE,0,4,0.8704999999973704,0.6938775510204082,0.058278716122005296,4,0.4481354838686605,0.5450387096779962,1,0.96875,0.002594474365792117,0.004855128669009368,4,0.5586500000013038,0.6395500000023416,1,0.9032258064516129,0.011322626451395272,0.01277269178424357,1.3646,0.6262,0.4892,1.2814,0.3906,0.5496,0.1575,1.4074997433333334,0.7300823533333334,0.480458254,1.5223,5.6548,0.3135,4.2927,0.377,-80.6324,0.8492,5.6432,0.3742,4.7604,0.4562,0.9963,1.5321249256666667,4.14984806,5.40075844,0.371890755,0.309551492,0.9119,2.986,0.4333,1.7523,0.5004,0.8773,0.07,0.364,0.356,0.016,1.704,106.5,478,1.4162962962962962,1,0,0,1,FALSE,FALSE,FALSE
299,2021-11-13T03:02:06Z,1,1.5,1080,6,3,2,3,2,3,2,1,3,2,2,2,2,3,3,3,2,2,1,1,2,1,1,1,2,1,2,0,0,1,1,5,2,2,5,1,1,1,1,5,1,1,3,1,2,3,1,1,1,3,5,1,1,1,1,1,3,1,1,1,4,1,5,1,1,1,2,1,1,1,1.375,0,1.25,0,2.6,0,3.888888888888889,0,1.75,0,0.8333333333333334,0,1.8571428571428572,0,1,0,2.135135135135135,0,1,0,0,-0.4606576737527777,-0.23179707860259807,-0.4557470907642554,-0.34377208468342674,5,1,4,2,1,1,1,1.2857142857142858,0,1,-0.7321841937363471,3,3,3,2,1,1,5,2,0,4,-0.7395711320441822,0,2,2,2,1,1,3,2,2,2,2,2,3,1,2,2,4,3,3,2,4,1.6,0,3.2,0,2.6,0,2.8,0,2.8666666666666667,0,2,3,2,1,2,3,3,1,3,2,3,2,2,3,1,1,2,2,2,2,2.6,0,"White, Caucasian, Anglo, European American",0,27,1,2,NA,5,2,0,0,1,0,0,TRUE,TRUE,TRUE,TRUE,TRUE,0,1,0.8730020833333402,0.96,0.07627700942448605,1,0.403058064516123,0.4669225806451042,0.96875,0.96875,5.730551209693789e-4,0.0024354308770136866,1,0.541284374999981,0.5736064516128897,1,0.96875,0.006943494264114925,0.009331594838705394,1.6718,1.8843,0.4793,1.6488,2.1028,0.5056,0.2788,1.5411881866666666,1.4516498286666666,0.4812173456666667,1.0863,6.7597,0.3259,3.9317,0.3339,-99.3292,0.7053,9.4805,0.3666,11.3092,0.4322,0.9546,1.106391592,3.9128428366666665,6.077325493333333,0.33175660533333334,0.32122014466666665,0.9047,4.941,0.4636,2.9637,0.459,0.7372,0.177,0.2,0.508,0.055,1.837,33.4,422,1.2503703703703704,1,0,0,1,FALSE,FALSE,FALSE
300,2021-11-13T03:00:44Z,0.8999999761581421,1.6,900,6,3,4,5,3,5,2,1,4,2,1,1,1,5,1,5,5,1,1,1,1,1,1,1,1,0,2,0,0,5,5,5,5,5,5,5,5,5,2,5,5,1,5,1,5,1,1,2,4,1,5,1,1,1,1,2,1,1,1,1,5,1,1,1,1,1,1,1,1,1,1,0,1,0,1.4,0,1,0,1.75,0,1,0,0.8571428571428571,0,1,0,1.2702702702702702,0,0,0,0,-1.231864122301242,-1.2803255574836354,-0.7372407672780129,-1.008783162380824,5,1,5,1,1,1,1,1,0,1,-0.9031185640466358,5,5,5,5,3,2,2,4.142857142857143,0,1.8571428571428572,0.10757398284279028,0,2,2,3,3,2,2,3,1,2,1,1,3,2,3,2,2,3,2,3,3,2.4,0,3.8,0,3,0,3.4,0,3.4,0,1,1,1,2,1,2,2,3,2,2,3,2,1,1,1,3,2,2,1,2,1.75,0,"White, Caucasian, Anglo, European American",0,28,1,2,NA,5,2,0,0,1,0,0,TRUE,TRUE,TRUE,TRUE,TRUE,0,1,0.8308421052631579,0.76,0.06387174244897867,1,0.4257000000000194,0.4846333333333372,0.967741935483871,0.9375,0.0037795161290319216,0.004838450604838662,1,0.5713125000000037,0.6741200000000069,1,0.78125,0.006182221774192479,0.008098802419356928,1.2725,0.8962,0.4631,1.3513,0.9544,0.451,0.4066,1.3225317533333334,0.9203938106666667,0.453433516,1.1806,4.2415,0.2937,2.7699,0.292,-60.909,0.8298,5.854,0.3539,4.7291,0.4009,0.9527,1.267431117,3.01671484,4.41274639,0.2879386293333333,0.28837047866666665,0.7968,3.4137,0.4806,2.1455,0.5402,0.9955,0.055,0.432,0.335,0.015,1.956,130.4,104,0.3081481481481481,1,0,0,1,FALSE,FALSE,FALSE
301,2021-11-13T03:05:04Z,1,1.7777777777777777,1080,4,3,5,5,1,4,1,1,4,1,1,1,1,5,2,5,5,1,2,1,1,1,1,1,1,0,2,0,0,5,5,5,5,5,5,5,5,5,1,5,1,1,5,1,5,1,1,2,1,2,5,1,1,1,2,1,1,1,1,1,5,1,1,1,1,1,1,1,1,1,1.125,0,1,0,1.2,0,1,0,1.1666666666666667,0,1,0,0.8571428571428571,0,1,0,1.0810810810810811,0,0,0,0,-1.2717903417083833,-1.3938604883178878,-0.7372407672780129,-1.0655506277979503,5,1,5,1,1,1,1,1,0,1,-0.9031185640466358,5,5,5,5,4,3,1,4.571428571428571,0,1.4285714285714286,0.6723373927674386,0,2,2,2,2,3,3,3,3,2,1,1,3,2,4,5,2,3,1,4,2,2.2,0,3.8,0,3.2,0,4,0,3.6666666666666665,0,1,1,1,4,1,1,1,4,1,1,1,4,1,1,1,4,1,1,2,1,1.05,0,"White, Caucasian, Anglo, European American",0,26,1,2,NA,5,2,0,0,1,0,0,TRUE,TRUE,TRUE,TRUE,TRUE,0,1,0.9834767441867396,0.86,0.10307436548612024,1,0.4343843749999069,0.49287419354819484,1,0.96875,0.0014107336188946974,0.003236709636989274,1,0.6186812499985099,0.6801516129038027,1,1,0.0041829377014133235,0.0085934059140616,1.5684,1.1868,0.5608,1.3027,1.0513,0.6761,0.2697,1.56078695,1.0864113343333333,0.5517659843333333,1.1519,6.6712,0.3481,4.4483,0.369,-102.3927,0.549,4.9572,0.392,7.2358,0.4491,0.6533,1.197991586,4.34321028,6.0646078333333335,0.36382342666666667,0.3413340716666667,0.8605,4.7376,0.5355,3.4423,0.5868,0.994,0.133,0.397,0.577,0.042,1.934,46.047619047619044,310,0.9185185185185185,1,0,2,3,FALSE,FALSE,FALSE
303,2021-11-13T02:53:26Z,0.8999999761581421,1.6,900,4,2,5,5,1,4,1,1,4,1,1,1,1,4,1,4,4,1,2,1,1,1,1,1,1,0,2,0,0,5,5,5,5,5,5,5,5,5,1,5,2,1,4,1,1,4,2,3,2,1,5,1,1,1,3,2,1,1,2,1,4,3,2,1,2,1,2,1,2,2,1.125,0,1.75,0,1.3333333333333333,0,1,0,2.0833333333333335,0,1.3333333333333333,0,1.5714285714285714,0,1.3333333333333333,0,1.5945945945945945,0,0,0,0,-0.9523805864512536,-1.1158789696853448,-0.5020371591262895,-0.8089580644058172,4,3,3,5,2,3,1,2.7142857142857144,0,2,0.49147533258947784,4,4,5,4,2,2,3,3.4285714285714284,0,2.5714285714285716,0.6723373927674386,0,2,2,3,3,2,1,4,1,3,1,1,4,2,4,3,1,4,2,3,3,2.4,0,4.4,0,3.4,0,3.6,0,3.8,0,1,1,2,2,3,3,3,2,3,3,1,2,1,1,1,2,3,3,2,3,2.3,0,"Hispanic of Latino (e.g., Mexican American, Central American, and others)",0,24,1,2,NA,5,2,0,1,1,0,1,TRUE,TRUE,TRUE,TRUE,TRUE,0,NA,NA,NA,NA,1,0.4724031250001863,0.5301774193554396,1,1,0.0034679299899186998,0.003814921139808876,1,0.6649687500002328,0.7574625000001397,1,1,0.0123026164113303,0.01232374370965587,NA,NA,NA,NA,NA,NA,NA,NA,NA,NA,2.3037,8.2306,0.3325,6.1165,0.3419,-97.0454,0.757,6.9416,0.4139,5.1701,0.463,0.9982,1.6283705406666666,4.721120936666667,6.32546459,0.36247818833333334,0.349613295,0.9958,4.1688,0.5562,2.657,0.6125,0.9722,0.266,0.238,0.625,0.017,1.63,95.88235294117646,441,1.3066666666666666,1,0,1,2,FALSE,TRUE,FALSE
304,2021-11-13T03:01:53Z,1,1.7777777777777777,720,4,3,4,4,3,4,2,1,4,2,2,1,2,4,1,4,4,2,1,1,1,1,2,1,2,1,2,0,0,5,3,4,5,5,5,5,5,5,2,5,3,1,5,1,5,1,1,1,2,4,4,1,1,1,4,1,1,3,3,1,4,2,1,1,2,1,1,1,1,2,1.375,0,1.25,0,1.8666666666666667,0,1.3333333333333333,0,1.5833333333333333,0,1.5,0,1.7142857142857142,0,1.3333333333333333,0,1.5675675675675675,0,1,0,0,-0.8136895085106579,-0.7908574029833673,-0.4557470907642554,-0.6233022468738113,5,1,3,1,1,1,1,1.2857142857142858,0,1,-0.7321841937363471,4,4,4,4,2,2,3,3.2857142857142856,0,2.7142857142857144,-1.0219528370065065,0,2,3,3,3,3,2,5,2,2,3,1,4,2,4,4,5,3,3,4,3,2.8,0,3.8,0,3.4,0,3.8,0,3.6666666666666665,0,2,2,2,2,3,1,3,3,2,2,3,3,1,3,2,3,1,2,3,2,2.15,0,"White, Caucasian, Anglo, European American",0,21,1,2,NA,5,2,0,0,1,0,0,TRUE,TRUE,TRUE,TRUE,TRUE,0,3,0.7322000000033267,0.86,0.017356822958987782,3,0.46068437499180437,0.513615625012666,1,1,0.0018920503933943901,0.005281030389430038,3,0.5759812500067055,0.6377218749970198,1,1,0.005345581572631512,0.00410140240993621,1.2919,1.6276,0.4686,0.8731,1.6233,0.5921,0.1708,1.3071119333333334,1.3176321933333333,0.4624909606666667,1.8188,7.4513,0.3386,6.3602,0.3706,-104.8657,0.7836,7.1564,0.4085,4.9024,0.4307,0.9358,1.4654041153333333,5.274236063333333,5.967809493333333,0.381180701,0.343024395,1.746,5.5756,0.4177,5.8957,0.4893,0.9837,0.099,0.415,0.644,0.021,1.6,76.19047619047619,325,0.9629629629629629,1,0,0,1,FALSE,FALSE,FALSE
306,2021-11-13T02:58:35Z,0.8999999761581421,1.7786458333333333,768,4,2,2,5,3,5,2,2,3,3,2,3,2,4,1,4,5,2,3,1,1,2,2,2,1,2,2,0,0,5,5,3,5,5,5,5,5,5,3,4,2,1,4,2,5,4,2,2,3,3,3,1,1,1,1,1,1,2,2,1,5,2,2,1,1,2,1,1,1,1,1.75,0,1,0,2.1333333333333333,0,1.2222222222222223,0,2.25,0,1.1666666666666667,0,1.4285714285714286,0,1.3333333333333333,0,1.6486486486486487,0,1,0,0,-0.5300032127230756,-0.4802575794137882,-0.5341482934814965,-0.5072029364476424,5,1,4,2,1,2,2,1.5714285714285714,0,2,-0.19226214865167657,5,5,5,5,2,2,2,4,0,2,-0.7395711320441822,0,3,3,3,2,3,3,5,3,2,3,4,2,3,3,4,1,3,2,5,4,2.8,0,2.8,0,4.2,0,3.2,0,3.4,0,1,3,2,2,3,4,4,1,3,4,4,2,3,3,3,2,1,3,3,3,3,0,Black or African American,0,19,1,2,NA,5,2,0,0,0,0,0,TRUE,TRUE,TRUE,TRUE,TRUE,0,5,0.8839972972974584,0.74,0.034065650628246326,5,0.515874999997206,0.559865625004284,1,1,0.003448039354999421,0.003922682973374857,5,0.6404483870960052,0.7130774193559923,1,0.96875,0.003288191913721358,0.0036644308771305997,1.4021,0.832,0.5085,0.9869,0.7696,0.692,0.1837,1.43833806,0.8674814436666667,0.5003520293333333,10,11.2937,0.0732,10.8835,0.1005,-89.7358,0.8364,5.3807,0.4444,5.6112,0.4892,0.9972,2.085618986666667,5.254200443333334,5.31912568,0.3674740913333333,0.322893413,0.7241,5.9238,0.5891,4.5207,0.6416,0.9854,0.067,0.542,0.673,0.016,1.377,86.0625,344,1.0192592592592593,1,0,0,1,FALSE,FALSE,FALSE
307,2021-11-13T02:59:21Z,1,1.6,900,5,2,3,3,3,2,2,3,3,3,3,2,2,1,1,2,3,3,5,1,1,3,3,3,3,0,2,0,0,4,4,4,4,4,5,5,5,5,3,3,5,1,3,2,3,3,2,4,3,3,2,2,1,1,1,1,1,1,1,1,4,1,3,1,2,3,1,1,1,1,2.75,0,1,0,2.933333333333333,0,1.5555555555555556,0,2.9166666666666665,0,1.5,0,1.2857142857142858,0,2,0,2.027027027027027,0,0,0,0,0.32735981454606206,0.4558974513013779,-0.7372407672780129,-0.14067165798831752,3,1,2,1,1,2,2,2,0,1,-0.3048482679606258,3,3,5,3,3,3,3,3.2857142857142856,0,2.7142857142857144,2.0842459175790595,0,2,2,2,2,2,2,3,3,1,3,2,2,1,2,4,3,3,3,2,4,2,0,3.2,0,3.2,0,3.2,0,3.2,0,1,1,3,1,2,3,4,2,1,2,2,2,1,4,2,1,1,3,3,4,2.55,0,"White, Caucasian, Anglo, European American",0,20,1,2,NA,5,2,0,0,1,0,0,TRUE,TRUE,TRUE,TRUE,TRUE,0,2,0.8391354838667378,0.6326530612244898,0.39316286510199433,2,0.5285562499910593,0.6206900000035763,1,0.9375,0.015931488991521362,0.03184178028202896,2,0.6364906250033527,0.8436903225798761,1,0.96875,0.03503908216858431,0.06413392579947795,1.6352,0.3329,0.4092,1.3949,0.1358,0.4917,0.2685,1.61934533,0.48034258312333333,0.407244066,1.5147,3.1844,0.2907,2.2201,0.3102,-30.2078,1.3177,3.8159,0.3484,2.0177,0.3473,0.9625,1.5796962433333332,2.41567035,3.4044132533333333,0.308579989,0.28749051233333334,1.3893,4.7517,0.4714,2.5338,0.5519,0.9905,0.092,0.388,0.367,0.011,1.895,172.27272727272728,342,1.0133333333333332,1,0,0,1,FALSE,FALSE,FALSE
308,2021-11-13T03:02:20Z,1,1.7777777777777777,864,3,4,2,4,2,4,3,2,1,1,1,1,1,5,1,4,4,2,1,3,1,1,1,1,1,0,3,3,0,5,5,5,5,5,5,4,5,5,2,4,1,1,5,1,5,2,2,1,1,3,4,1,1,2,2,3,1,1,1,1,5,1,1,1,1,1,2,2,1,2,1.375,0,1.75,0,2,0,1.1111111111111112,0,1.5,0,1.6666666666666667,0,0.8571428571428571,0,1,0,1.3243243243243243,0,0,3,0,-0.9649888662640349,-0.838091031497532,0.11786246365278161,-0.36011428392237516,5,1,5,1,1,1,2,1.1428571428571428,0,1.5,-0.6331575415043005,5,5,5,5,4,3,2,4.428571428571429,0,1.5714285714285714,-1.0219528370065065,0,1,1,2,2,2,2,5,3,2,5,2,5,2,4,5,1,5,3,4,3,1.6,0,4.2,0,4.6,0,3.8,0,4.2,0,3,2,3,2,2,2,2,3,1,1,3,2,1,2,1,3,1,2,1,2,1.95,0,"White, Caucasian, Anglo, European American",0,18,0,1,NA,5,2,0,0,0,0,0,TRUE,TRUE,TRUE,TRUE,TRUE,0,5,0.9109355555521117,0.9,0.04429785959233874,5,0.45922258064535354,0.5857593750013038,1,1,0.0026149324731457686,0.006187497973802546,5,0.5671968750013039,0.6735033333331346,1,1,0.0033857474093361146,0.006313238265023018,1.3433,1.6398,0.5879,1.1629,2.4,0.6676,0.4523,1.36779992,1.341738516,0.5760974413333333,3.5584,8.3279,0.2456,7.2293,0.3396,-89.3323,0.9903,5.7031,0.3777,5.3563,0.4898,0.9964,1.8306851433333333,5.0412529133333335,5.64172564,0.4092873263333333,0.3012166663333333,0.7763,4.7831,0.4921,4.9276,0.5913,0.8924,0.092,0.434,0.751,0.017,1.891,111.23529411764706,338,1.0014814814814814,1,0,0,1,FALSE,FALSE,FALSE
309,2021-11-13T03:08:35Z,0.8999999761581421,1.7777777777777777,864,4,3,2,3,4,3,3,5,2,5,5,4,5,2,1,2,3,3,3,1,1,2,4,4,3,1,2,0,1,3,3,2,4,4,5,5,5,2,1,5,4,1,3,3,5,2,2,5,5,5,2,2,5,1,1,1,1,2,2,3,3,2,2,1,1,2,1,2,1,2,2.625,0,1.5,0,3.8,0,2.3333333333333335,0,2.75,0,2.1666666666666665,0,2,0,1.3333333333333333,0,2.3513513513513513,0,1,0,1,0.4513412327050791,0.9140055737553562,-0.20089624114783355,0.3565546663037613,4,2,3,1,2,3,1,2,0,2.5,0.24863324420094737,5,4,5,5,3,2,1,4.142857142857143,0,1.8571428571428572,-1.0219528370065065,0,2,3,2,2,2,2,5,2,1,3,1,5,2,3,3,1,4,1,4,2,2.2,0,4.6,0,4.2,0,3.8,0,4.2,0,3,2,4,2,2,4,4,1,1,3,2,2,2,4,1,2,3,4,2,2,2.8,0,"White, Caucasian, Anglo, European American",0,18,1,2,NA,5,1,0,0,1,1,0,TRUE,TRUE,TRUE,TRUE,TRUE,0,5,0.8634617647072848,0.6938775510204082,0.206203610161646,5,0.4390249999985099,0.5169333333412807,1,0.9375,0.002462215485776856,0.00434671797484707,5,0.5718468750044704,0.6741107142652784,1,0.9032258064516129,0.00659404386180696,0.008098450727860309,1.398,0.5971,0.4435,1.1981,0.6903,0.4943,0.0526,1.43064193,0.703888866,0.435676104,1.269,5.1354,0.3155,3.495,0.3515,-77.3319,0.7512,4.8559,0.3707,4.9796,0.4414,0.9461,1.347212984,3.620327013333333,5.123804503333333,0.3459023583333333,0.3095903603333333,0.6943,3.6613,0.5096,6.5162,0.6112,0.9548,0.071,0.398,0.447,0.007,1.403,200.42857142857142,392,1.1614814814814816,1,0,0,1,FALSE,FALSE,FALSE
310,2021-11-13T02:54:02Z,1,1.7777777777777777,1080,4,1,1,2,4,2,4,5,2,5,3,4,4,1,2,1,2,5,4,1,3,5,5,5,5,7,2,3,0,3,3,2,4,2,4,2,3,2,3,3,4,4,3,4,4,4,4,4,4,4,1,3,1,1,5,3,4,5,3,3,4,2,2,3,5,3,1,2,4,4,4.125,0,2.75,0,4.133333333333334,0,3.2222222222222223,0,3.5833333333333335,0,2.8333333333333335,0,2.857142857142857,0,3.6666666666666665,0,3.2972972972972974,0,4,3,0,1.9727403301140392,2.108396917740587,1.2438371697078117,1.6761170437241995,2,4,1,4,3,4,4,4,0,5,2.367643023308923,3,3,3,3,1,1,5,2.142857142857143,0,3.857142857142857,0.6723373927674386,0,3,2,5,3,3,3,4,2,2,3,2,4,2,3,3,1,4,2,3,3,3.2,0,3.8,0,3.8,0,3.4,0,3.6666666666666665,0,1,2,1,3,2,1,2,3,1,1,3,4,2,2,2,4,1,1,1,2,1.55,0,"Black or African American & White, Caucasian, Anglo, European American",1,26,0,1,NA,5,2,0,0,0,0,0,TRUE,TRUE,TRUE,TRUE,TRUE,0,5,1.0415558139534538,0.86,0.15114166529012005,5,0.5252968749993016,0.5793093750004191,1,1,0.024177224829085665,0.011802774425356306,5,0.6247624999999534,0.676853124999674,1,1,0.017007497257968997,0.008331142570574858,1.5793,1.1427,0.6001,1.4204,0.949,0.6284,5e-4,1.5789631266666666,1.061601799,0.5887509016666667,2.5298,3.9387,0.2041,4.3084,0.2857,-45.9801,1.3654,2.6997,0.2908,4.936,0.4417,0.9998,1.8130400566666667,3.615938846666667,3.53248716,0.32707369333333336,0.2617058056666667,1.2005,3.8744,0.46,3.6645,0.5293,0.9107,0.124,0.375,0.52,0.025,1.77,70.8,376,1.114074074074074,1,0,2,3,FALSE,FALSE,FALSE
311,2021-11-13T03:07:07Z,0.8999999761581421,1.7777777777777777,1080,3,4,2,4,3,5,2,2,4,3,2,2,3,4,2,4,3,2,2,1,1,1,1,2,2,1,2,0,0,4,2,5,5,5,4,4,5,5,2,5,4,1,4,2,5,3,5,4,5,5,5,1,1,1,3,1,1,1,3,1,4,2,3,1,1,1,1,2,1,1,1.5,0,1.25,0,2.3333333333333335,0,1.6666666666666667,0,2.9166666666666665,0,1.1666666666666667,0,1.7142857142857142,0,1,0,2,0,1,0,0,-0.46696181365916845,-0.3507522618892957,-0.4557470907642554,-0.40324967632677555,5,1,4,1,1,1,1,1.1428571428571428,0,1,-0.8176513788914915,5,5,5,5,3,3,1,4.428571428571429,0,1.5714285714285714,-0.1748077221195339,0,3,3,3,4,4,4,3,4,3,3,2,4,5,3,4,1,4,3,5,4,3.4,0,3.4,0,3.4,0,2.8,0,3.2,0,1,4,1,3,4,1,2,3,1,1,3,4,3,2,2,4,1,1,2,3,1.9,0,"White, Caucasian, Anglo, European American",0,19,1,2,NA,5,2,0,0,3,0,0,TRUE,TRUE,TRUE,TRUE,TRUE,0,1,0.7717128205146545,0.78,0.10630283469337262,1,0.5292156250011176,0.6020625000046567,1,1,0.006528046521960115,0.004786463064511374,1,0.6494064516117496,0.8152709677392437,1,1,0.021320862624439496,0.02116500612797852,1.6183,0.8387,0.2515,1.4494,0.7995,0.3472,0.0826,1.59307113,0.8534076453333334,0.2520706126666667,10,9.449,0,10.0736,0.1059,-76.7252,0.85,4.3668,0.4408,4.7333,0.525,0.9626,2.00731159,4.8008338833333335,4.812719103333333,0.39739716033333333,0.32164097366666666,0.833,3.505,0.5408,2.9266,0.6898,0.9801,0.199,0.349,0.715,0.005,1.232,246.4,304,0.9007407407407407,1,0,0,1,FALSE,FALSE,FALSE
312,2021-11-13T03:07:03Z,1,1.6,1120,4,3,2,3,3,3,4,3,3,3,2,3,4,3,3,3,2,4,4,5,4,3,3,3,5,1,2,3,1,4,3,2,4,4,5,5,5,5,4,4,5,1,5,3,4,5,5,5,5,5,1,3,1,1,3,4,5,2,1,1,4,2,2,1,3,2,2,2,2,2,3.875,0,2,0,3.2,0,1.8888888888888888,0,3.5833333333333335,0,2.6666666666666665,0,2,0,2,0,2.6486486486486487,0,1,3,1,1.4137732584140625,1.3211052490229314,0.5758057870657198,0.9484555180443256,3,3,1,1,1,4,1,2.5714285714285716,0,1,0.03702047265995151,2,4,5,5,2,2,2,3.4285714285714284,0,2.5714285714285716,-0.1748077221195339,0,2,2,1,1,1,1,4,1,1,3,3,4,1,3,5,5,3,2,3,1,1.4,0,3.8,0,3.2,0,4.6,0,3.8666666666666667,0,2,3,3,1,4,2,4,1,4,2,3,2,1,4,1,1,2,3,4,4,3.05,0,"White, Caucasian, Anglo, European American",0,19,1,4,Genderfluid,5,2,0,0,0,0,0,TRUE,TRUE,TRUE,TRUE,TRUE,0,5,1.2856228571210588,0.7,0.18685730640114273,5,0.48943750001490116,0.5942937500923872,1,1,0.004284952741586085,0.005790583178998846,5,0.676056249961257,0.8540419354131145,1,1,0.006764476087249209,0.021655834511173522,1.834,0.4842,0.5308,1.7356,0.3191,0.6607,0.4565,1.7815247866666666,0.5731106057666666,0.5256328553333334,6.3659,9.2456,0.1452,8.151,0.2038,-81.3149,0.866,5.1712,0.4113,4.9249,0.5126,0.8561,1.9304068533333334,4.565545846666667,5.393832216666667,0.3868084583333333,0.3132074496666667,1.1533,4.5155,0.5496,2.315,0.6615,0.9765,0.118,0.461,0.539,0.006,1.261,210.16666666666666,447,1.3244444444444445,1,0,1,2,FALSE,FALSE,FALSE
313,2021-11-13T03:02:05Z,1,1.7786458333333333,768,6,4,2,4,1,2,1,1,5,1,1,1,1,4,4,4,4,1,3,1,1,1,1,1,1,3,2,0,1,3,3,5,4,4,4,4,4,4,1,4,1,1,5,5,5,1,1,2,2,2,5,1,1,1,1,1,1,4,1,1,5,1,2,1,1,1,1,1,1,1,1.25,0,1,0,1.8666666666666667,0,2.111111111111111,0,1.6666666666666667,0,0.8333333333333334,0,1.4285714285714286,0,1,0,1.5945945945945945,0,2,0,1,-0.8746295276057681,-0.832961149712182,-0.1546061727857994,-0.49378366124899076,5,1,4,1,1,1,1,1.1428571428571428,0,1,-0.8176513788914915,4,3,4,4,3,3,2,3.5714285714285716,0,2.4285714285714284,-0.1748077221195339,0,1,2,1,4,2,2,3,1,1,1,1,2,2,4,5,3,4,3,3,3,2,0,3.6,0,2.8,0,4.4,0,3.6,0,2,1,2,3,1,1,3,3,1,1,2,4,2,1,1,4,1,1,1,1,1.4,0,"Hispanic of Latino (e.g., Mexican American, Central American, and others)",0,NA,1,2,NA,5,2,0,0,0,0,0,TRUE,TRUE,TRUE,TRUE,TRUE,0,3,0.9181697674418778,0.86,0.08630887171019286,3,0.5733633333333147,0.6745062499999768,1,1,0.016716961712608214,0.022460703185473968,3,0.9517125000000087,1.0053031250000348,1,1,0.1813966566128481,0.08732176160280454,1.4922,1.2153,0.4659,1.1893,1.4997,0.6261,0.3914,1.4892645433333334,1.1091249966666668,0.46018703233333336,1.5414,3.4383,0.3492,3.7552,0.4693,-53.1599,1.1949,3.7376,0.4083,3.8792,0.5005,0.8114,1.8564699533333333,3.8679717366666666,3.8708579566666668,0.43500446833333334,0.32851747233333334,1.6534,1.6055,0.4821,1.5885,0.6087,0.889,0.138,0.341,0.246,0.014,1.713,122.35714285714286,358,1.0607407407407408,1,0,0,1,FALSE,FALSE,FALSE
314,2021-11-13T03:11:08Z,1,1.6,900,4,3,4,4,2,4,2,2,4,2,2,2,2,5,3,4,4,1,2,1,1,1,1,2,1,0,2,0,0,5,4,4,4,5,5,4,4,5,1,5,1,1,5,1,5,2,1,1,1,3,4,1,1,1,2,1,1,1,1,1,4,2,2,1,1,1,2,1,1,1,1.25,0,1.25,0,2,0,1.5555555555555556,0,1.25,0,1.1666666666666667,0,1.2857142857142858,0,1,0,1.3513513513513513,0,0,0,0,-1.0259288853591455,-0.8801947782263467,-0.6588395645607719,-0.7695171713935594,4,1,3,1,1,2,1,1.5714285714285714,0,1,-0.5612498234260587,5,4,5,5,3,3,2,4.142857142857143,0,1.8571428571428572,0.6723373927674386,0,4,3,4,5,4,4,4,3,4,3,3,3,3,3,3,3,3,2,4,3,4,0,3,0,3.4,0,2.8,0,3.066666666666667,0,2,3,4,2,4,4,3,2,3,3,4,2,2,4,1,2,3,4,4,4,3.2,0,"White, Caucasian, Anglo, European American",0,20,1,2,NA,5,2,0,0,1,0,0,TRUE,TRUE,TRUE,TRUE,TRUE,0,2,0.6872411764772499,0.68,0.024590879689440574,2,0.43176206897250535,0.4977551724150263,0.90625,0.9666666666666667,0.008537080483751585,0.008778100644359495,2,0.6355343749988824,0.7766999999942451,1,0.9354838709677419,0.010349117167627118,0.03064303045075285,1.1975,0.6807,0.3863,0.7423,0.8576,0.559,0.1575,1.2514091436666666,0.7978345956666667,0.38034555066666664,0.9499,2.4244,0.2676,3.773,0.3781,-59.6332,1.1032,4.4573,0.2962,4.3771,0.3602,0.8639,1.035561799,3.88054366,2.8326711566666667,0.3707439103333333,0.26289903866666664,1.2017,4.6169,0.5024,2.1668,0.549,0.9976,0.069,0.476,0.398,0.015,1.751,116.73333333333333,429,1.271111111111111,1,0,0,1,FALSE,FALSE,FALSE
315,2021-11-13T03:05:22Z,1,1.6,1120,6,4,2,5,3,5,3,1,4,2,2,1,2,5,3,4,5,2,4,1,1,2,4,2,2,9,2,0,0,5,5,5,5,5,5,5,5,5,1,4,2,1,5,2,5,2,2,2,3,3,4,1,1,1,3,1,1,5,5,1,5,1,2,1,1,1,1,2,4,4,2.25,0,2.75,0,1.9333333333333333,0,1,0,1.8333333333333333,0,1.3333333333333333,0,2.142857142857143,0,1,0,1.5945945945945945,0,5,0,0,-0.25262105684188396,-0.3745626565911081,0.8270300207252568,0.22623368206707434,5,2,4,1,1,1,1,1.2857142857142858,0,2,-0.3631965189619651,5,5,5,5,4,4,1,4.714285714285714,0,1.2857142857142858,-0.4571894270818581,0,2,2,2,3,2,2,3,1,1,2,1,4,3,5,4,2,5,2,3,3,2.2,0,4.4,0,3,0,4.4,0,3.933333333333333,0,1,1,1,4,1,1,1,4,1,1,1,4,1,1,1,4,1,1,1,1,1,0,"White, Caucasian, Anglo, European American",0,30,1,2,NA,5,2,0,0,1,0,0,TRUE,TRUE,TRUE,TRUE,TRUE,0,1,0.9717444444451895,0.72,0.06831872524067656,1,0.5700062499986962,0.6713806451616748,1,1,0.005166227056489258,0.014952056946201392,1,0.7176031249989756,0.8561709677418393,1,1,0.006336608054621669,0.018011179462681673,1.3144,0.7398,0.614,1.2677,0.5736,0.6454,0.1056,1.3714624466666667,0.8077166403333333,0.601197518,2.685,6.1406,0.3514,4.6329,0.3816,-65.9633,1.0446,5.2544,0.4736,3.2108,0.5238,0.9879,2.0659754566666666,3.931446836666667,5.104758806666666,0.409070492,0.37039022833333335,1.0631,4.4052,0.6012,2.1361,0.703,0.904,0.109,0.486,0.438,0.012,1.54,128.33333333333334,382,1.1318518518518519,1,0,0,1,FALSE,FALSE,FALSE
316,2021-11-13T03:00:33Z,1,1.7777777777777777,900,3,1,3,5,2,3,2,3,3,3,3,3,2,3,2,3,3,3,3,5,1,3,3,3,3,1,2,1,0,4,4,3,5,4,5,5,5,4,1,5,4,3,4,2,5,1,4,4,4,4,3,1,1,2,1,1,1,3,3,2,4,2,2,1,1,3,2,2,2,2,3,0,2,0,2.6,0,1.6666666666666667,0,2.5833333333333335,0,1.3333333333333333,0,2,0,1.6666666666666667,0,2.027027027027027,0,1,1,0,0.4828619322370331,0.4200850690262941,-0.01391027501950836,0.20308739700339287,4,1,3,1,1,2,2,1.7142857142857142,0,2,-0.10679496349653231,5,5,5,5,5,5,1,5,0,1,-0.1748077221195339,0,3,3,2,2,3,2,3,3,2,2,1,4,3,3,4,3,5,1,4,5,2.6,0,4.6,0,3,0,3,0,3.533333333333333,0,2,1,1,3,2,1,2,4,1,2,2,4,3,1,1,4,2,2,1,2,1.55,0,"White, Caucasian, Anglo, European American & Native American/Alaskan Native/indigenous",1,30,1,2,NA,5,2,1,1,0,0,2,TRUE,TRUE,TRUE,TRUE,TRUE,0,6,0.8168595238129298,0.84,0.030728582383561645,6,0.44186562499869614,0.4968656250014901,1,1,0.0013731474897763262,0.0020180603930500156,6,0.5972906249994412,0.6742931034513588,1,0.90625,0.006378107973399765,0.01261604286291184,1.6207,1.2372,0.3896,0.9107,1.4949,0.652,0.0187,1.5760114333333333,1.104099084,0.38667945,3.2942,10.4566,0.2844,9.4173,0.322,-116.3694,0.5919,5.5464,0.3963,7.3903,0.4568,0.8368,1.3972785046666667,5.745554823333333,6.249629056666667,0.38342458566666665,0.3361966373333333,0.8646,3.1791,0.488,2.5946,0.55,0.9672,0.063,0.442,0.399,0.013,1.493,114.84615384615385,444,1.3155555555555554,1,0,0,1,FALSE,FALSE,FALSE
317,2021-11-13T03:11:40Z,1,1.7777777777777777,1080,7,4,4,5,3,3,4,1,4,2,2,1,2,4,1,3,1,1,1,1,1,1,1,1,1,0,2,0,0,3,5,3,4,2,5,5,5,5,1,4,5,1,3,1,4,1,1,2,2,3,3,1,1,1,3,3,1,1,1,1,5,2,2,1,1,2,2,2,2,2,1,0,2,0,2.2666666666666666,0,1.8888888888888888,0,2,0,1.8333333333333333,0,1.1428571428571428,0,1.3333333333333333,0,1.7837837837837838,0,0,0,0,-0.9124543670441124,-0.687195074830354,-0.4236359564090485,-0.5554155156197013,4,2,4,2,2,2,2,2,0,2,0.06413940681375631,5,5,5,5,4,3,2,4.428571428571429,0,1.5714285714285714,-0.7395711320441822,0,2,2,2,2,2,2,4,2,1,4,1,3,2,4,4,3,3,1,3,2,2,0,4,0,3.6,0,4.2,0,3.933333333333333,0,1,4,4,2,4,4,4,2,1,3,4,2,1,4,1,3,3,4,3,4,3,0,"White, Caucasian, Anglo, European American",0,22,1,2,NA,5,2,0,0,2,0,0,TRUE,TRUE,TRUE,TRUE,TRUE,0,6,0.8570936170201352,0.94,0.04564437761573103,6,0.429421874997206,0.5188571428571429,1,0.875,0.0031981624091378825,0.007024682540192432,6,0.5298343749972991,0.6598964285712157,1,0.875,0.003401311360868272,0.007040710282434143,1.5339,1.9735,0.5102,1.3599,2.6174,0.5944,0.371,1.4594447866666667,1.492185576,0.504336609,1.015,4.5729,0.3184,2.324,0.3519,-67.5446,0.732,5.4103,0.3674,3.9403,0.4173,0.9533,1.116176435,2.6122865343333332,4.73651719,0.344891467,0.311806711,0.8283,5.1324,0.449,3.0576,0.5486,0.9296,0.065,0.428,0.652,0.013,1.85,142.30769230769232,308,0.9125925925925925,1,0,0,1,FALSE,FALSE,FALSE
318,2021-11-13T02:40:07Z,0.8999999761581421,1.7777777777777777,864,4,3,4,4,2,4,2,4,3,4,5,4,2,3,4,4,5,3,4,3,4,3,4,4,3,5,2,0,0,4,3,4,3,3,4,2,4,2,4,3,4,3,4,3,4,3,4,3,3,3,4,2,4,4,4,2,4,4,2,2,2,4,3,2,2,2,2,2,2,3,3.5,0,2.25,0,2.8,0,2.7777777777777777,0,3.0833333333333335,0,2.8333333333333335,0,3.142857142857143,0,2,0,2.945945945945946,0,3,0,0,1.3654415191317333,1.115813187386572,0.2640426676977418,0.6899279275421569,4,2,3,3,4,2,4,2.857142857142857,0,1,0.20795484297024003,2,3,4,2,4,3,3,3,0,3,0.6723373927674386,0,1,3,1,3,2,2,3,2,3,4,4,2,3,4,2,4,4,2,3,2,2,0,3.2,0,3,0,3.4,0,3.2,0,1,2,1,2,2,1,3,1,2,1,NA,3,2,1,1,4,1,2,1,2,1.736842105263158,1,"White, Caucasian, Anglo, European American",0,30,0,1,NA,5,2,0,0,1,0,0,TRUE,TRUE,TRUE,TRUE,TRUE,0,1,0.9782375000000466,0.6530612244897959,0.06616675444728623,1,0.5564178571430967,0.606766666666915,1,1,0.04899017707674215,0.028967469884962307,NA,NA,NA,NA,NA,NA,NA,1.3946,0.4725,0.5241,1.1207,0.7037,0.6831,0.3975,1.4342904333333333,0.6216121749666667,0.514870784,1.8424,2.6324,0.2065,3.5393,0.3465,-30.3888,1.4193,2.3034,0.2757,3.0433,0.3715,0.7841,1.7593732666666666,3.4769222566666667,2.76308217,0.35110681866666665,0.22071414166666667,NA,NA,NA,NA,NA,NA,NA,NA,NA,NA,NA,NA,216,0.64,1,0,1,2,FALSE,FALSE,FALSE
319,2021-11-13T02:57:23Z,1,1.7786458333333333,768,4,3,1,3,3,3,5,2,1,3,2,2,3,3,2,4,3,5,4,4,3,4,4,4,4,9,3,0,0,5,4,3,3,2,5,4,4,5,5,4,4,1,3,2,5,5,5,4,2,2,3,1,1,1,5,3,3,5,5,5,4,3,3,2,4,2,5,3,5,5,4,0,4.5,0,3.066666666666667,0,2.111111111111111,0,3,0,2.1666666666666665,0,3.5714285714285716,0,2.6666666666666665,0,2.7837837837837838,0,5,0,0,1.5755795160114243,1.375598144214478,1.3758384397459444,1.3757182919802111,4,3,2,2,3,3,2,2.7142857142857144,0,1.5,0.3069814952022868,3,3,3,4,1,1,5,2.2857142857142856,0,3.7142857142857144,-0.7395711320441822,0,1,2,1,2,1,1,3,1,1,3,1,5,3,5,2,2,5,2,2,3,1.4,0,4.8,0,3,0,4,0,3.933333333333333,0,2,1,2,3,1,2,2,3,1,1,1,3,1,1,1,3,3,2,2,2,1.65,0,"Hispanic of Latino (e.g., Mexican American, Central American, and others)",0,25,1,2,NA,5,2,0,0,1,0,0,TRUE,TRUE,TRUE,TRUE,TRUE,0,2,0.9187676470630309,0.6938775510204082,0.10811019541619234,2,0.41706874999031424,0.4642225806636195,1,0.96875,9.093957663045292e-4,0.002217717489493758,2,0.5358124999776482,0.6472586206814338,1,0.90625,0.0026997559685179107,0.008268486087062809,1.4629,0.5691,0.4661,1.2977,0.4232,0.5594,0.3242,1.4854282966666668,0.6818327554666667,0.459467099,1.1695,7.3114,0.3371,4.9951,0.3542,-110.7699,0.6344,7.6967,0.3766,6.0211,0.4136,0.978,1.1339827356666667,4.63012998,6.296818563333333,0.352633762,0.3335617713333333,0.7137,5.5713,0.4779,4.5374,0.5631,0.8616,0.079,0.39,0.582,0.012,1.741,145.08333333333334,384,1.1377777777777778,1,0,0,1,FALSE,FALSE,FALSE
320,2021-11-13T03:15:23Z,1,1.77875,800,4,2,2,3,2,3,2,2,2,3,2,2,2,3,2,3,3,3,2,3,3,2,3,2,4,2,4,1,1,2,2,3,2,3,2,3,2,3,3,2,2,3,2,3,2,3,2,3,2,2,2,2,2,3,2,3,2,2,3,2,3,2,2,2,2,3,3,2,2,3,2.75,0,2.5,0,2.6666666666666665,0,3.5555555555555554,0,2.9166666666666665,0,2.5,0,2.142857142857143,0,2.3333333333333335,0,2.864864864864865,0,1,1,1,0.8485020468076946,0.7013574552192497,0.3193417773141546,0.5103496162667022,2,3,2,3,2,2,3,3,0,1.5,0.47791586551257526,2,3,2,2,3,2,3,2.4285714285714284,0,3.5714285714285716,0.9547190977297628,0,2,3,2,3,3,2,2,3,2,3,2,2,3,2,2,3,3,2,3,3,2.6,0,3.4,0,2.8,0,2.8,0,3,0,2,2,1,2,2,2,2,2,2,1,2,2,2,3,2,2,1,2,2,2,2.1,0,"Hispanic of Latino (e.g., Mexican American, Central American, and others)",0,22,0,1,NA,5,2,0,0,2,0,0,TRUE,TRUE,TRUE,TRUE,TRUE,0,6,0.9770374999996274,0.6808510638297872,0.32631797780864197,6,0.6157625000004967,0.736199999999255,0.96,0.9333333333333333,0.025795929933947137,0.01797876510361442,6,0.8521062499987893,0.9731903225803568,1,0.96875,0.056210338669668965,0.0857983585472962,1.4929,0.4891,0.4946,1.5183,0.5635,0.442,0.0377,1.5160802766666666,0.6159659543,0.4859816003333333,1.4065,2.3201,0.3271,2.483,0.4825,-21.4339,1.279,4.0742,0.4427,3.9322,0.5617,0.982,1.6320922833333333,2.677606126666667,2.74725809,0.45099107266666666,0.3131304816666667,1.6453,3.4369,0.5773,1.8697,0.5829,0.9826,0.088,0.547,0.298,0.016,1.716,107.25,104,0.3081481481481481,1,1,4,5,FALSE,FALSE,FALSE
321,2021-11-13T03:14:49Z,1,1.7786458333333333,768,3,3,5,5,1,5,1,1,4,1,1,1,1,5,1,5,5,1,1,1,1,1,1,1,1,5,2,0,0,5,5,5,5,5,5,5,5,5,1,5,1,1,5,1,5,1,1,1,1,1,5,1,3,1,3,2,1,3,3,1,5,1,1,1,1,1,1,1,1,1,1,0,1,0,1.0666666666666667,0,1,0,1,0,1.6666666666666667,0,1.4285714285714286,0,1,0,1.2432432432432432,0,3,0,0,-1.2486751620516177,-1.435189913267782,-0.12796334588846375,-0.7815766295781228,5,1,5,1,1,1,1,1,0,1,-0.9031185640466358,5,5,5,5,4,3,1,4.571428571428571,0,1.4285714285714286,0.9547190977297628,0,1,1,1,2,2,1,4,1,1,3,1,4,1,5,5,1,4,1,3,1,1.4,0,4.6,0,4,0,5,0,4.533333333333333,0,2,1,2,4,1,2,1,4,1,1,1,4,1,1,1,4,1,2,1,1,1.2,0,"White, Caucasian, Anglo, European American",0,26,1,2,NA,5,2,0,0,1,0,0,TRUE,TRUE,TRUE,TRUE,TRUE,0,3,0.7858263157894345,0.76,0.057156888412385885,3,0.46442857142830535,0.5842464285708432,1,1,0.006330256190405133,0.018237403320266705,3,0.641268749999581,0.6844375000002328,1,1,0.012215178991864155,0.005156829515985426,1.3162,0.944,0.4422,1.0674,0.9541,0.5347,0.0929,1.3584167533333333,0.9511811213333333,0.4349514016666667,2.1463,6.4031,0.2968,4.0469,0.3191,-62.5531,1.0318,6.138,0.3734,5.0636,0.474,0.989,1.7738436933333332,3.606734266666667,5.517810613333333,0.33621692966666666,0.3077068396666667,0.8893,3.6527,0.5327,5.6035,0.6088,0.8464,0.191,0.354,0.698,0.016,1.31,81.875,428,1.268148148148148,1,0,0,1,FALSE,FALSE,FALSE
322,2021-11-13T03:12:33Z,0.8999999761581421,1.7777777777777777,720,6,3,5,5,3,5,1,1,2,1,1,1,1,4,1,4,4,1,1,1,1,1,1,1,2,0,2,0,0,5,4,5,5,4,5,5,5,3,1,5,1,1,4,2,5,1,1,1,1,4,4,1,1,1,1,1,1,1,1,1,5,1,2,1,1,1,1,1,1,1,1.125,0,1,0,1.5333333333333334,0,1.4444444444444444,0,1.4166666666666667,0,1,0,1,0,1,0,1.2972972972972974,0,0,0,0,-1.1373020237053812,-1.1576923457470643,-0.7372407672780129,-0.9474665565125386,5,1,3,1,1,1,1,1.2857142857142858,0,1,-0.7321841937363471,5,5,5,5,2,2,2,4,0,2,-1.3043345419688306,0,2,2,2,3,2,2,3,3,2,3,2,4,2,4,4,3,3,2,3,3,2.2,0,3.8,0,3.2,0,3.6,0,3.533333333333333,0,1,2,3,3,2,3,2,2,2,1,2,2,3,4,1,2,2,2,2,1,2.2,0,"White, Caucasian, Anglo, European American",0,22,1,2,NA,5,2,0,0,1,0,0,TRUE,TRUE,TRUE,TRUE,TRUE,0,2,0.7693184210626702,0.7916666666666666,0.0373532105306384,2,0.45960666666030886,0.6039709677388592,0.9375,0.96875,0.002760508998038962,0.008432056855650353,2,0.6000500000119209,0.6605516128847676,1,0.96875,0.01166651613450204,0.010742111896200142,1.1593,1.1696,0.4562,1.0402,1.4593,0.5247,0.3323,1.22212055,1.0795135606666666,0.446249397,1.1981,3.3023,0.2956,3.2587,0.4305,-57.883,1.266,5.9188,0.3496,3.4704,0.43120000000000003,0.9958,1.3425286323333334,3.4535321966666666,3.69041146,0.4169277496666667,0.288933117,1.1305,4.8459,0.4802,4.4307,0.5387,0.8899,0.074,0.397,0.36,0.028,2.011,71.82142857142857,356,1.0548148148148149,1,0,0,1,FALSE,FALSE,FALSE
323,2021-11-13T03:08:02Z,1,1.6,900,4,1,3,4,2,4,3,2,3,3,2,2,1,3,1,4,3,2,4,5,5,1,3,3,2,2,4,0,4,3,1,3,3,2,3,3,5,3,3,4,1,5,2,1,3,3,5,2,1,1,3,5,5,1,5,1,1,2,2,2,5,1,1,1,1,1,1,3,2,2,3.125,0,2,0,2.2666666666666666,0,3.111111111111111,0,2.5833333333333335,0,3.1666666666666665,0,1.2857142857142858,0,1,0,2.4864864864864864,0,1,0,4,0.8464006668388974,0.5280061669633707,0.4852551049841909,0.5066306359737808,4,2,3,2,2,2,1,2,0,1,-0.3048482679606258,5,5,5,5,2,2,2,4,0,2,1.5194825076544112,0,2,2,2,3,2,2,5,1,1,2,1,3,2,3,4,1,3,1,3,4,2.2,0,4,0,3.8,0,3.8,0,3.8666666666666667,0,1,1,1,3,1,1,1,3,2,1,2,3,3,2,2,2,2,2,2,1,1.7,0,Black or African American,0,24,1,2,NA,5,2,0,0,1,0,0,TRUE,TRUE,TRUE,TRUE,TRUE,0,2,0.9837138888883508,0.7346938775510204,0.19634297623363225,2,0.4752032258070765,0.5442068965519811,1,0.90625,0.008778378989115222,0.008976172258060515,2,0.6195483870965338,0.7535366666669647,1,0.9375,0.01223699458077558,0.014387552863178847,1.6023,0.6379,0.4295,1.4908,0.5483,0.428,0.1275,1.5942586866666666,0.7075582083333334,0.426128333,1.2555,3.0036,0.2662,2.8697,0.3551,-45.9855,0.9073,4.3906,0.3762,3.604,0.4171,0.9899,1.3741466356666667,3.078667626666667,3.356939673333333,0.3452020653333333,0.2613674346666667,1.0628,4.2211,0.5012,3.0633,0.6018,0.9522,0.084,0.394,0.382,0.005,1.153,230.6,431,1.2770370370370372,1,0,0,1,FALSE,FALSE,FALSE
324,2021-11-13T03:14:41Z,1,1.7777777777777777,720,7,3,4,4,2,3,2,2,3,2,2,2,2,4,2,3,4,2,2,1,1,1,1,2,2,2,2,0,0,4,3,4,4,4,5,5,5,5,2,4,3,1,3,2,4,2,2,2,3,3,4,1,5,1,1,1,2,3,3,3,4,2,2,1,1,1,2,2,2,2,1.5,0,2,0,2.2,0,1.6666666666666667,0,2.25,0,1.6666666666666667,0,2.2857142857142856,0,1,0,1.972972972972973,0,1,0,0,-0.4837728534095438,-0.4196669002132409,-0.22054348261253207,-0.32010519141288646,4,2,2,1,1,2,2,2,0,1.5,-0.12035443057343476,4,4,4,4,2,2,1,3.5714285714285716,0,2.4285714285714284,0.9547190977297628,0,3,3,3,3,3,3,4,2,3,3,2,3,3,2,3,2,3,2,3,2,3,0,3.4,0,3.4,0,3.2,0,3.3333333333333335,0,2,2,2,3,2,2,2,2,2,1,3,2,1,2,1,2,1,2,2,2,2,0,"White, Caucasian, Anglo, European American",0,28,1,2,NA,5,2,0,0,1,0,0,TRUE,TRUE,TRUE,TRUE,TRUE,0,6,0.5973475000016392,0.8163265306122449,0.015104259685198561,6,0.4814624999985099,0.5587374999942258,1,1,0.004224755967961664,0.006363026935781111,6,0.5948387096783807,0.6998838709698569,1,0.96875,0.024467817117750926,0.01169296963685748,1.0587,1.4779,0.3772,0.73,1.8981,0.4897,0.2306,1.1134558126666667,1.2252141693333334,0.36948170033333333,6.5806,9.3801,0.1307,7.9214,0.1434,-79.5274,0.9636,9.1977,0.4262,7.9171,0.4932,0.9201,1.8911017933333334,4.2499433233333335,5.558649826666667,0.33837783633333335,0.315120183,1.0827,2.8609,0.4259,4.4671,0.5722,0.9955,0.306,0.076,0.606,0.008,1.247,155.875,340,1.0074074074074075,1,0,0,1,FALSE,FALSE,FALSE
325,2021-11-13T03:19:57Z,1,1.7786458333333333,768,4,2,3,3,4,4,4,3,4,3,3,2,2,4,3,4,4,2,3,3,3,2,3,3,2,7,2,0,0,3,3,3,4,4,4,3,2,2,3,3,4,4,4,3,3,3,3,4,4,4,3,3,5,4,4,4,3,4,3,4,4,4,3,4,3,2,3,4,3,2,2.625,0,3,0,2.6666666666666665,0,2.888888888888889,0,3.3333333333333335,0,3.6666666666666665,0,3.142857142857143,0,3,0,3.27027027027027,0,4,0,0,1.0229165842178378,0.821861282063789,0.7023387496459815,0.7621000158548852,2,3,2,3,3,2,3,3.142857142857143,0,2,0.7478768880549106,3,3,3,4,4,3,3,3.2857142857142856,0,2.7142857142857144,0.6723373927674386,0,3,4,4,3,3,3,3,4,4,3,3,3,2,3,3,4,4,4,3,3,3.4,0,3,0,3,0,2.6,0,2.8666666666666667,0,2,3,3,2,2,2,3,3,4,3,3,2,2,2,2,2,3,3,3,4,2.75,0,"White, Caucasian, Anglo, European American",0,19,1,2,NA,5,2,0,0,2,0,0,TRUE,TRUE,TRUE,TRUE,TRUE,0,NA,NA,NA,NA,5,0.5154586206633469,0.6328366666634878,0.9354838709677419,0.9375,0.017321406441113667,0.00660034522631378,5,0.6883937499821186,0.8409096774593476,1,0.96875,0.00476761545040538,0.010525703879964122,NA,NA,NA,NA,NA,NA,NA,NA,NA,NA,1.2175,2.0294,0.2424,3.1034,0.4612,-33.9141,0.7386,3.4085,0.422,3.8597,0.5509,0.9854,1.3481714466666668,3.24495072,2.4048994926666665,0.4455111646666667,0.23629504833333334,1.1009,4.69,0.577,3.4792,0.7019,0.9115,0.1,0.511,0.562,0.009,1.573,174.7777777777778,104,0.3081481481481481,1,0,0,1,FALSE,FALSE,FALSE
326,2021-11-13T03:15:19Z,1,1.7777777777777777,864,5,3,5,4,3,4,2,2,4,1,2,1,2,4,2,5,4,1,1,1,1,1,1,1,2,0,2,0,0,5,3,4,5,5,4,3,3,2,1,5,1,1,3,2,5,2,2,1,1,3,3,1,1,1,3,3,1,1,1,1,4,1,2,1,2,1,2,1,1,1,1.125,0,1.25,0,1.8,0,2.2222222222222223,0,1.5833333333333333,0,1.8333333333333333,0,1.1428571428571428,0,1.3333333333333333,0,1.7297297297297298,0,0,0,0,-0.8683253876993774,-0.85725549552582,-0.6588395645607719,-0.758047530043296,5,1,4,2,1,2,2,1.5714285714285714,0,1,-0.5612498234260587,5,5,5,3,2,2,2,3.7142857142857144,0,2.2857142857142856,-0.1748077221195339,0,2,2,2,2,2,2,5,2,3,3,2,4,1,3,3,1,4,2,4,2,2,0,4,0,4.4,0,3.4,0,3.933333333333333,0,3,3,3,2,4,3,3,2,3,1,2,2,3,3,1,2,3,3,1,2,2.65,0,"White, Caucasian, Anglo, European American",0,20,1,2,NA,5,2,0,0,1,0,0,TRUE,TRUE,TRUE,TRUE,TRUE,0,6,0.8342400000050664,0.8163265306122449,0.05582210255027043,6,0.4455500000044703,0.5594375,1,1,0.0016609606451505991,0.006114055322535115,6,0.6183062499966472,0.7227468750048429,1,1,0.006028754799517091,0.018254891601778605,1.3334,1.2236,0.4967,1.1403,1.4354,0.5508,0.1425,1.3668776166666667,1.1084679933333332,0.4878612153333333,10,14.0582,0.0899,9.6361,0.0405,-94.3114,0.8048,7.2588,0.3963,4.5644,0.4777,0.9857,1.8882200666666666,4.723446133333334,6.099470376666667,0.36354049233333335,0.296302213,1.2296,5.096,0.4967,2.927,0.5277,0.9641,0.109,0.394,0.476,0.014,1.553,110.92857142857142,376,1.114074074074074,1,0,0,1,FALSE,FALSE,FALSE
327,2021-11-13T03:14:34Z,1,1.6,800,3,3,4,4,2,4,2,2,4,1,1,4,1,5,3,4,4,2,2,1,2,1,1,1,1,1,3,0,0,4,5,5,5,4,4,4,4,5,1,4,1,1,4,1,4,1,2,1,1,1,5,1,1,1,1,1,1,2,2,1,4,1,1,1,1,1,2,1,2,2,1.375,0,1.75,0,1.9333333333333333,0,1.5555555555555556,0,1.3333333333333333,0,0.8333333333333334,0,1.2857142857142858,0,1,0,1.3243243243243243,0,1,0,0,-0.9649888662640349,-0.8667409373175989,-0.2989446853297732,-0.5828428113236861,4,1,4,1,1,1,1,1.2857142857142858,0,1,-0.7321841937363471,4,4,4,4,3,3,1,3.857142857142857,0,2.142857142857143,2.0842459175790595,0,3,3,2,2,2,2,4,2,2,2,2,2,2,2,4,3,3,2,4,3,2.4,0,3.4,0,3.4,0,3.4,0,3.4,0,1,1,1,2,1,1,2,3,1,1,1,3,2,1,1,3,1,1,1,1,1.35,0,"Hispanic of Latino (e.g., Mexican American, Central American, and others)",0,23,1,2,NA,5,2,0,0,0,0,0,TRUE,TRUE,TRUE,TRUE,TRUE,0,2,1.1588125,0.64,0.07552177183673471,2,0.4820625,0.5918,1,0.967741935483871,0.0030998024193548378,0.006045382795698923,2,0.62521875,0.78503125,1,1,0.010355982862903223,0.021471128024193546,1.2903,0.4546,0.7782,1.0885,0.5156,0.8777,0.4179,1.3671049,0.6189083995666667,0.7587569323333333,1.2139,6.0313,0.3814,3.7693,0.4402,-87.9532,0.9617,6.1438,0.3985,5.279,0.4941,0.9508,1.3685401456666666,3.9170215533333335,5.83176659,0.42768116366666664,0.36898653033333334,1.0566,4.3202,0.5004,2.3977,0.6054,0.9577,0.176,0.336,0.599,0.007,1.282,183.14285714285714,428,1.268148148148148,1,0,0,1,FALSE,FALSE,FALSE
329,2021-11-13T03:09:33Z,1,1.6,900,7,3,2,4,5,3,3,5,4,3,3,2,2,4,2,4,5,2,5,1,1,2,4,3,4,1,2,0,0,5,3,1,1,1,4,4,5,4,4,5,2,1,3,3,5,4,3,1,4,5,3,1,1,1,3,3,1,1,1,1,4,3,2,1,1,1,2,2,1,1,2.75,0,1.5,0,2.7333333333333334,0,2.888888888888889,0,2.6666666666666665,0,1.8333333333333333,0,1.4285714285714286,0,1,0,2.27027027027027,0,1,0,0,0.4786591722994391,0.4744811739954753,-0.3773458880470143,0.048567642974230496,5,1,5,1,1,1,1,1,0,1,-0.9031185640466358,5,5,5,5,3,3,3,4.142857142857143,0,1.8571428571428572,-1.3043345419688306,0,5,3,3,2,2,2,4,3,1,3,1,4,2,4,4,1,5,1,3,4,3,0,4.6,0,3.8,0,3.6,0,4,0,1,1,1,4,1,1,1,4,1,3,2,4,1,1,1,4,1,1,2,1,1.2,0,"White, Caucasian, Anglo, European American",0,26,1,2,NA,5,2,0,0,1,0,0,TRUE,TRUE,TRUE,TRUE,TRUE,0,1,1.1227187500000035,0.6666666666666666,0.10802649468085168,1,0.518612903225814,0.6280624999999891,1,1,0.0033475784946227992,0.009076124999999925,1,0.6649375000000054,0.7638666666666706,1,0.967741935483871,0.010893479838711174,0.009105769892473848,1.5126,0.4785,0.645,1.289,0.3214,0.7785,0.2507,1.5435133633333333,0.6047046236333333,0.630600351,2.7294,7.4545,0.3355,5.2706,0.3691,-79.2745,0.9073,4.4116,0.4232,4.8011,0.5345,0.9662,1.90961249,4.181907443333333,5.83901683,0.40213658,0.3601433823333333,1.0541,3.5133,0.5237,5.2043,0.6524,0.9973,0.084,0.491,0.552,0.012,1.664,138.66666666666666,104,0.3081481481481481,1,0,0,1,FALSE,FALSE,FALSE
330,2021-11-13T02:59:35Z,1,1.6,900,6,2,3,5,1,4,1,1,4,4,5,2,5,3,1,3,4,2,3,1,1,3,5,3,2,3,2,0,0,5,5,5,5,5,5,1,2,3,1,5,5,5,4,4,1,5,5,5,5,5,3,1,1,1,4,5,1,3,4,1,5,1,1,1,1,1,1,1,1,1,2.5,0,1,0,2.4,0,2,0,4,0,2.3333333333333335,0,1.5714285714285714,0,1,0,2.5945945945945947,0,2,0,0,0.5248895316129712,0.36317241827561997,-0.33105581968498016,0.016058299295319906,3,2,2,1,1,4,1,2.2857142857142856,0,2,0.2350737771240448,1,2,5,5,1,1,4,2.4285714285714284,0,3.5714285714285716,2.0842459175790595,0,2,4,2,3,3,3,5,5,1,5,1,5,1,4,4,1,5,1,5,5,2.8,0,4.6,0,5,0,3,0,4.2,0,1,2,1,1,3,1,3,4,2,1,2,2,1,4,1,2,1,2,3,1,2,0,"Asian or Asian American (e.g., Chinese, Japanese, and others)",0,25,1,2,NA,5,2,0,1,1,0,1,TRUE,TRUE,TRUE,TRUE,TRUE,0,NA,NA,NA,NA,4,0.48447499999962745,0.5900259259268641,0.8571428571428571,0.9,0.017830023121893402,0.03312483862049658,4,0.6243156250012107,0.8008999999993082,1,0.875,0.00739436394148765,0.035849972863132656,NA,NA,NA,NA,NA,NA,NA,NA,NA,NA,1.2139,1.6918,0.2094,1.7819,0.2959,-8.3279,0.9077,2.2605,0.33,2.8937,0.4298,0.9963,1.2513695463333334,1.9971737833333334,2.0268864393333335,0.29494714833333335,0.21131767,1.3259,5.8051,0.5126,1.7483,0.5177,0.9474,0.075,0.43,0.365,0.005,1.285,257,425,1.2592592592592593,1,0,0,1,FALSE,FALSE,FALSE
331,2021-11-13T03:17:24Z,1,1.6,900,7,3,1,5,2,4,2,2,3,2,5,2,4,2,2,3,3,3,5,1,1,3,5,3,3,3,2,0,0,3,4,3,5,3,5,5,5,3,2,5,5,1,3,2,4,2,5,5,5,3,2,1,1,1,1,1,1,4,4,3,4,1,1,1,1,3,2,3,3,3,3,0,2.75,0,2.8,0,2,0,3,0,1.3333333333333333,0,2.142857142857143,0,1.6666666666666667,0,2.27027027027027,0,2,0,0,0.6341612899904101,0.6105682266407941,0.21775259933570762,0.4141604129882509,5,1,4,1,1,1,1,1.1428571428571428,0,1,-0.8176513788914915,4,4,4,4,2,2,2,3.4285714285714284,0,2.5714285714285716,-0.4571894270818581,0,2,2,2,3,2,3,4,3,2,3,2,3,4,4,4,3,4,3,4,4,2.2,0,3.4,0,3.2,0,3.4,0,3.3333333333333335,0,2,1,1,4,2,2,1,3,1,2,2,3,2,2,1,3,2,2,2,1,1.65,0,"White, Caucasian, Anglo, European American",0,25,1,2,NA,5,2,0,0,1,0,0,TRUE,TRUE,TRUE,TRUE,TRUE,0,5,0.812460975609538,0.82,0.0550032674939502,5,0.5302874999999767,0.57803548387089565,1,1,0.0065204475807040035,0.0054009563655613565,5,0.7104312500006054,0.7463406249996042,1,1,0.021493762862976665,0.004174794102851127,1.3584,1.2115,0.4714,1.0768,1.4948,0.5614,0.2025,1.3857592333333333,1.096425582,0.4637654606666667,5.4945,7.6545,0.1714,7.9501,0.2325,-75.0247,0.8822,3.9164,0.4297,4.4811,0.4891,0.9825,1.97471727,4.80766537,4.78146311,0.37749537633333335,0.32456268866666665,1.2072,2.7509,0.512,8.7834,0.6766,0.8345,0.234,0.29,0.582,0.02,1.665,83.25,388,1.1496296296296296,1,0,0,1,FALSE,FALSE,FALSE
332,2021-11-13T03:27:44Z,1,1.7777777777777777,1080,3,1,1,4,2,3,1,4,2,5,2,1,3,1,1,2,3,2,5,1,1,3,4,5,3,7,2,0,0,4,1,3,1,1,2,1,2,1,1,5,3,4,3,4,3,4,5,4,5,3,2,1,4,3,3,2,1,4,5,2,2,4,3,2,4,1,2,1,1,3,3,0,1.75,0,3,0,4.222222222222222,0,3.3333333333333335,0,2.6666666666666665,0,3.142857142857143,0,2.3333333333333335,0,3.3783783783783785,0,4,0,0,1.3234139197557957,1.172725838137246,0.31033273605977596,0.7415292870985111,2,3,1,4,1,4,3,3.4285714285714284,0,3.5,1.472292770526772,1,3,4,2,1,1,5,1.8571428571428572,0,4.142857142857143,2.0842459175790595,0,4,5,2,4,2,4,5,2,3,1,1,4,5,1,4,5,3,1,3,5,3.4,0,3.8,0,2.2,0,2.6,0,2.8666666666666667,0,2,3,4,1,2,3,2,4,3,3,2,1,3,4,1,1,1,4,3,2,2.75,0,"White, Caucasian, Anglo, European American",0,25,0,1,NA,5,2,0,0,1,0,0,TRUE,TRUE,TRUE,TRUE,TRUE,0,1,0.8436558823506621,0.68,0.09405734675890141,1,0.5032593749994412,0.6810607142868851,1,0.9032258064516129,0.006008249586639282,0.020310889462180463,1,0.6625187499984168,0.814761290321427,1,0.96875,0.011503428669180029,0.022477761935682294,1.6655,0.4889,0.2667,1.2615,0.5325,0.5032,0.5683,1.6365619566666667,0.6054480592,0.2680434,1.2913,4.7522,0.3674,2.0183,0.419,-51.3698,1.1213,5.7367,0.3993,2.7302,0.476,0.8997,1.440746096,2.2596645866666667,4.87031186,0.40231714766666665,0.3562562146666667,1.1876,6.9714,0.5766,3.66,0.6569,0.9913,0.111,0.389,0.408,0.007,1.407,201,270,0.8,1,0,0,1,FALSE,FALSE,FALSE
333,2021-11-13T03:24:01Z,1,1.6,900,6,2,3,4,1,4,3,1,4,4,2,1,3,3,1,3,1,3,4,1,1,3,4,3,4,2,2,0,0,4,1,3,5,5,5,5,5,5,3,4,4,1,4,2,5,3,5,5,5,5,3,1,1,1,3,2,1,3,3,3,4,3,1,2,4,3,4,1,2,2,2.875,0,2.25,0,2.4,0,1.7777777777777777,0,3.1666666666666665,0,1.6666666666666667,0,2.142857142857143,0,3,0,2.4324324324324325,0,1,0,0,0.6572764696471762,0.4546391784106317,-0.14214227989529096,0.15624844925767034,4,2,3,2,1,3,2,2.142857142857143,0,1,-0.21938108280548152,5,5,5,5,1,1,4,3.4285714285714284,0,2.5714285714285716,-0.7395711320441822,0,2,3,1,4,1,2,4,1,1,3,3,3,1,3,4,1,4,1,3,4,2.2,0,3.8,0,4,0,3.8,0,3.8666666666666667,0,1,4,1,3,3,2,3,3,2,2,1,4,4,4,3,3,1,2,3,3,2.3,0,"White, Caucasian, Anglo, European American",0,22,1,2,NA,5,2,0,0,1,0,0,TRUE,TRUE,TRUE,TRUE,TRUE,0,1,0.773880952380951,0.84,0.01758770163265368,1,0.45990625,0.53896875,1,1,0.002266668346774029,0.0022486764112901636,1,0.7221562499999945,0.7747812499999982,1,1,0.009100523185484656,0.013387466733869782,1.1574,1.5488,0.5198,0.915,1.5903,0.6119,0.1188,1.2058477746666667,1.2778896743333332,0.510703577,4.1973,10.1495,0.2531,9.6312,0.3211,-107.685,0.7285,5.9254,0.4023,6.7179,0.4865,0.991,1.6516761,5.71869362,6.03726093,0.402514104,0.32832160666666665,1.0612,4.8814,0.6264,4.1082,0.6423,0.896,0.301,0.282,0.676,0.029,1.331,45.89655172413793,422,1.2503703703703704,1,0,1,2,FALSE,FALSE,FALSE
335,2021-11-13T03:12:45Z,1,1.7786458333333333,768,4,4,2,2,2,2,3,3,2,3,2,2,1,2,2,2,3,3,4,1,1,1,3,3,2,2,2,1,1,3,3,3,3,3,3,2,2,2,2,2,2,1,2,2,3,3,2,2,4,3,2,1,1,1,2,3,1,2,2,1,3,3,2,4,3,3,1,1,1,1,2.25,0,1,0,3,0,3.3333333333333335,0,2.6666666666666665,0,1.8333333333333333,0,1.8571428571428572,0,3.3333333333333335,0,2.6486486486486487,0,1,1,1,0.4030094934227509,0.5368140771985941,-0.15106543898929206,0.19287431910465103,4,2,2,2,1,2,3,2.2857142857142856,0,1,-0.1339138976503373,2,2,2,2,1,1,4,1.7142857142857142,0,4.285714285714286,0.9547190977297628,0,2,1,1,1,1,1,1,1,1,1,1,1,1,1,1,1,1,1,1,1,1.2,0,3.4,0,2.6,0,3.4,0,3.1333333333333333,0,1,1,1,1,1,1,1,1,1,1,1,1,1,1,2,1,1,1,1,1,1.65,0,Black or African American,0,30,1,2,NA,5,2,1,0,1,0,1,TRUE,TRUE,TRUE,TRUE,TRUE,0,4,1.0322500000000001,0.72,0.11287184040816327,4,0.5451,0.6101875,0.967741935483871,1,0.013116991397849461,0.009098802419354837,4,0.5958125,0.6471612903225806,1,0.96875,0.005645512096774193,0.00266811995967742,1.5319,0.6338,0.4849,1.4338,0.5829,0.5644,0.2565,1.54501999,0.7146593366666667,0.47743663,1.3572,3.5755,0.363,3.7537,0.4294,-60.4864,1.1158,4.0084,0.3997,5.1797,0.4975,0.9248,1.57319782,3.9668729333333332,3.8719324166666667,0.412286691,0.34563281733333334,0.946,4.2273,0.4953,7.2326,0.5857,0.8265,0.062,0.472,0.52,0.023,1.844,80.17391304347827,311,0.9214814814814816,1,0,0,1,FALSE,FALSE,FALSE
336,2021-11-13T03:24:55Z,1,1.7777777777777777,1080,3,2,5,3,5,2,5,3,2,1,3,2,2,1,1,2,1,3,2,1,3,2,1,1,1,2,2,5,3,4,1,2,2,3,4,1,1,1,4,3,2,1,1,5,1,4,1,1,1,1,1,5,3,1,4,1,1,2,2,2,4,1,3,4,4,1,2,2,2,2,1.75,0,2,0,3.2,0,3.888888888888889,0,2.75,0,3,0,1.7142857142857142,0,3,0,2.945945945945946,0,1,5,3,0.276926695294936,0.5356525945302133,1.3419714960501288,0.938812045290171,1,3,1,2,2,4,3,3.4285714285714284,0,2,0.9188112583651991,2,2,2,3,1,1,3,2,0,4,0.38995568780511447,0,3,2,3,2,2,2,5,3,2,2,1,3,5,3,2,1,3,1,1,4,2.4,0,4,0,2.8,0,2.8,0,3.2,0,2,4,3,2,1,3,3,2,3,3,3,2,4,3,2,2,1,3,3,1,2.7,0,Black or African American,0,18,1,2,NA,5,2,0,0,1,0,0,TRUE,TRUE,TRUE,TRUE,TRUE,0,5,1.3166717948730176,0.8125,0.21100681464062102,5,0.6335687500014902,0.6826499999999068,1,1,0.023986228669028574,0.012181708386689263,5,0.9313225806466033,1.5191066666662694,1,0.967741935483871,0.042511847807218325,0.2215342844519091,1.7878,0.8528,0.687,1.4303,1.0642,0.8953,0.4458,1.7530115,0.8434192913333334,0.672041636,3.6652,4.6579,0.2401,5.1163,0.3245,-47.1861,1.4418,3.9167,0.4433,5.8705,0.5576,0.9267,2.26980275,3.927000816666667,3.721051,0.393274166,0.32288444866666666,1.9845,3.5997,0.6342,1.1986,0.8702,0.9954,0.181,0.309,0.229,0.005,1.943,388.6,340,1.0074074074074075,1,0,0,1,FALSE,FALSE,FALSE
337,2021-11-13T03:33:04Z,1,1.7777777777777777,1080,6,4,4,5,2,4,1,1,4,2,1,1,1,4,1,4,4,1,2,1,1,1,1,3,2,0,2,0,0,5,5,5,4,5,5,4,5,5,1,5,2,1,4,1,5,2,2,1,2,2,5,1,1,1,1,1,1,1,1,1,5,1,1,1,1,1,1,1,1,1,1.5,0,1,0,1.5333333333333334,0,1.2222222222222223,0,1.5,0,0.8333333333333334,0,0.8571428571428571,0,1,0,1.2162162162162162,0,0,0,0,-0.9544819664200506,-1.0313811055606197,-0.7372407672780129,-0.8843109364193162,5,1,4,1,1,1,1,1.1428571428571428,0,1,-0.8176513788914915,5,5,5,5,4,3,1,4.571428571428571,0,1.4285714285714286,-0.7395711320441822,0,3,3,2,4,3,2,4,2,3,4,3,3,1,4,4,2,3,2,4,2,3,0,3.4,0,4.2,0,3.8,0,3.8,0,1,1,2,3,2,3,1,3,2,2,3,3,1,2,1,2,1,3,3,2,1.95,0,"Hispanic of Latino (e.g., Mexican American, Central American, and others) & White, Caucasian, Anglo, European American",1,25,0,1,NA,5,2,0,0,1,0,0,TRUE,TRUE,TRUE,TRUE,TRUE,0,5,1.2583472222354677,0.72,0.3335454565581729,5,0.3876593750268221,0.45849687500298025,1,1,0.0014840270052027895,0.003989824183680032,5,0.5622906250059605,0.6238838709554364,1,0.96875,0.009648511842290626,0.0036831354434551157,1.6139,0.5766,0.6002,1.684,0.6264,0.534,0.0912,1.6242464333333333,0.66144005479,0.587325591,3.6723,11.4033,0.2266,7.5299,0.2146,-106.2548,0.6401,6.7382,0.3408,5.6017,0.4022,0.946,1.540062151,4.67465396,6.80036568,0.297840625,0.281914417,0.9755,4.2277,0.4462,5.2426,0.5359,0.966,0.064,0.425,0.516,0.016,1.604,100.25,272,0.8059259259259259,1,0,1,2,FALSE,FALSE,FALSE
338,2021-11-13T03:24:48Z,0.8999999761581421,1.7777777777777777,1080,5,3,4,2,4,3,5,2,4,2,3,3,2,4,3,3,3,2,1,1,1,1,2,2,4,0,2,1,0,5,3,2,3,4,4,3,3,5,3,4,3,3,3,3,5,4,2,3,3,3,4,1,2,1,3,2,1,1,1,1,3,4,4,1,1,1,1,3,2,5,1.75,0,2.75,0,2.8666666666666667,0,2.4444444444444446,0,2.75,0,1.6666666666666667,0,2,0,1,0,2.27027027027027,0,0,1,0,-0.143349298464445,0.102032398334603,0.018200859335698566,0.06011662883515078,4,2,3,1,1,4,2,2.142857142857143,0,1,-0.21938108280548152,5,5,5,5,2,2,1,4.142857142857143,0,1.8571428571428572,-0.7395711320441822,0,2,2,3,2,2,2,5,2,2,4,1,4,2,4,5,2,5,3,4,3,2.2,0,4.2,0,4.2,0,4,0,4.133333333333334,0,3,1,2,3,3,2,4,3,3,2,1,2,4,3,2,3,2,2,2,4,2.45,0,"White, Caucasian, Anglo, European American",0,19,1,2,NA,5,2,0,0,1,0,0,TRUE,TRUE,TRUE,TRUE,TRUE,0,5,1.045263414603908,0.82,0.08452266601967862,5,0.6279812500029802,0.7442937499731779,1,1,0.012309263502842189,0.010997498677165395,5,0.7400781250298023,0.7649580644945945,1,1,0.009216111456349397,0.013139237176991041,1.4879,1.0704,0.6198,1.251,1.045,0.6962,0.1125,1.5145796166666667,1.0234793806666667,0.607278601,1.7137,3.7681,0.4006,4.6433,0.5598,-63.1056,0.9824,2.6749,0.4867,4.884,0.6337,0.9297,2.2346473166666665,4.525236186666667,4.23812203,0.5006756956666667,0.36286696933333334,0.9866,3.9098,0.6201,2.9769,0.6173,0.9805,0.115,0.521,0.537,0.074,1.658,22.405405405405407,310,0.9185185185185185,1,0,0,1,FALSE,FALSE,FALSE
339,2021-11-13T03:25:53Z,1,1.7777777777777777,720,6,2,4,5,3,4,3,2,4,2,2,1,1,4,4,4,4,2,3,1,1,2,1,1,2,1,2,0,0,5,5,5,5,5,5,5,5,5,2,5,2,2,5,2,4,2,2,4,4,4,4,1,1,1,2,2,1,1,1,1,5,2,2,1,2,1,2,1,1,1,1.625,0,1.25,0,2.066666666666667,0,1,0,2.3333333333333335,0,1.3333333333333333,0,1.1428571428571428,0,1.3333333333333333,0,1.5945945945945945,0,1,0,0,-0.6413763510693116,-0.5858557120141032,-0.4557470907642554,-0.5208014013891793,5,2,3,2,1,1,2,1.7142857142857142,0,2,-0.10679496349653231,5,5,5,5,3,2,2,4.142857142857143,0,1.8571428571428572,-0.1748077221195339,0,2,2,2,2,2,2,5,2,2,4,1,5,1,5,5,1,4,4,4,2,2,0,4,0,4.6,0,4.4,0,4.333333333333333,0,1,1,1,3,1,1,2,3,2,2,1,4,2,1,1,4,1,1,2,3,1.45,0,"White, Caucasian, Anglo, European American",0,23,1,2,NA,5,2,0,1,1,0,1,TRUE,TRUE,TRUE,TRUE,TRUE,0,3,0.8582837837934494,0.74,0.1079353474476834,3,0.45649999999230906,0.5220499999920527,1,0.9375,0.008825129333774091,0.0030308883459422473,3,0.6755290322803682,0.7234250000081957,1,1,0.0671040028004955,0.016536787741759092,1.4422,0.7497,0.3871,1.193,0.8939,0.5068,0.4064,1.4622075466666666,0.8047793033333334,0.38199602033333335,1.3022,3.9203,0.2904,3.5576,0.3565,-63.8829,0.6843,4.3873,0.3864,5.4743,0.4645,0.9764,1.4070490506666666,3.701763306666667,4.16799396,0.348998674,0.28477242533333336,1.404,3.6304,0.4512,3.1496,0.514,0.8707,0.159,0.316,0.495,0.022,1.84,83.63636363636364,340,1.0074074074074075,1,0,0,1,FALSE,FALSE,FALSE
340,2021-11-13T03:39:02Z,1,1.7777777777777777,1440,6,2,4,4,2,4,2,1,4,1,2,1,1,4,5,5,5,1,1,1,1,1,1,1,1,0,2,0,0,5,3,1,5,4,5,5,5,5,1,5,2,1,3,2,4,3,1,1,2,1,5,1,1,1,1,1,1,1,1,1,4,2,2,1,3,1,1,2,1,2,1,0,1.5,0,1.8,0,1.7777777777777777,0,1.6666666666666667,0,0.8333333333333334,0,1.2857142857142858,0,1.6666666666666667,0,1.5405405405405406,0,0,0,0,-1.0637537247974898,-0.9922778557251226,-0.5804383618435307,-0.7863581087843267,4,2,2,1,2,2,3,2.2857142857142856,0,5,1.3420368014471913,4,4,4,4,2,2,2,3.4285714285714284,0,2.5714285714285716,1.5194825076544112,0,1,1,2,3,1,2,5,1,1,2,1,3,3,4,4,2,3,1,4,1,1.6,0,4,0,3.6,0,4.6,0,4.066666666666666,0,1,4,3,1,3,4,2,2,4,3,2,1,4,4,1,1,1,4,2,4,3.05,0,"Hispanic of Latino (e.g., Mexican American, Central American, and others) & White, Caucasian, Anglo, European American",1,25,0,4,"Currently identifying as male, but questioning. Thank you for having a text box option.",5,2,0,0,1,0,0,TRUE,TRUE,TRUE,TRUE,TRUE,0,4,0.6190238095238095,0.84,0.023554284081632654,4,0.4048275862068966,0.4661034482758621,0.90625,0.90625,0.0013645806451612905,0.002611866935483871,4,0.46596875,0.5522333333333334,1,0.9375,0.0013620312500000006,0.0034865443548387095,1.0548,1.604,0.4014,1.0209,1.6847,0.4153,0.0126,1.104456764,1.2800429606666666,0.3935195403333333,0.9138,3.0516,0.2801,3.0601,0.3391,-66.7114,0.4978,5.0152,0.3656,4.529,0.4216,0.9476,0.995718508,3.31758973,3.432950066666667,0.3343745613333333,0.2763837436666667,0.5833,6.8393,0.4251,4.319,0.4969,0.9855,0.066,0.363,0.688,0.025,2.114,84.55999999999999,386,1.1437037037037037,1,0,0,1,FALSE,FALSE,FALSE
341,2021-11-13T03:46:47Z,1,1.7777777777777777,864,6,2,3,3,3,3,3,3,3,3,3,3,3,3,3,3,3,3,3,3,3,3,3,3,3,0,3,0,0,3,3,3,3,3,3,3,3,3,3,3,3,3,3,3,3,3,3,3,3,3,3,3,3,3,3,3,3,3,3,3,3,3,3,3,3,3,3,3,3,3,3,0,3,0,3,0,3,0,3,0,2.8333333333333335,0,2.857142857142857,0,3,0,3,0,0,0,0,1.0880593632505418,1.0101182645638922,-0.11003114554008399,0.4500435595119041,3,3,3,3,3,3,3,3,0,1,0.2934220281253842,3,3,3,3,3,3,3,3,0,3,2.0842459175790595,0,3,3,3,3,3,3,3,3,3,3,3,3,3,3,3,3,3,3,3,3,3,0,3,0,3,0,3,0,3,0,2,2,2,2,2,2,2,2,2,2,2,2,2,2,2,2,2,2,2,2,2.2,0,"Asian or Asian American (e.g., Chinese, Japanese, and others)",0,23,0,1,NA,5,3,0,0,1,1,0,TRUE,TRUE,TRUE,TRUE,TRUE,0,5,0.9360166666441494,0.72,0.1184853120750223,5,0.45181935482640423,0.5830437499731779,1,1,0.003812857615219876,0.012630923824893236,5,0.5944687500074506,0.6939580645176672,1,1,0.009621778344877477,0.028724351187267606,1.5992,0.6496,0.363,1.3046,0.8134,0.505,0.0483,NA,NA,NA,1.6344,7.0551,0.336,3.7572,0.3655,-81.6167,0.9954,8.1563,0.3819,3.1261,0.4416,0.9807,NA,NA,NA,NA,NA,1.3263,5.6443,0.484,4.3141,0.5216,0.8821,0.252,0.159,0.579,0.017,1.582,93.05882352941177,336,0.9955555555555555,1,0,0,1,FALSE,FALSE,FALSE
342,2021-11-13T03:36:48Z,1,1.7777777777777777,1080,6,2,2,4,4,3,3,4,2,5,3,4,5,2,1,2,4,3,4,1,2,5,5,4,5,0,2,0,2,5,4,3,4,3,4,5,5,4,2,5,5,2,2,3,5,4,5,5,5,5,1,3,1,1,5,1,3,1,1,1,4,1,1,1,3,4,1,2,2,1,3.625,0,1.5,0,3.466666666666667,0,1.8888888888888888,0,3.5,0,2.5,0,1.2857142857142858,0,2.6666666666666665,0,2.5135135135135136,0,0,0,2,1.1742159419712153,1.2701935920588932,-0.22753906804516918,0.521327262006862,3,4,2,4,2,3,3,3.2857142857142856,0,2.5,1.017837910597246,4,3,5,5,1,1,2,3.2857142857142856,0,2.7142857142857144,0.10757398284279028,0,1,3,3,1,2,1,5,1,2,4,2,5,1,4,2,4,5,2,5,2,2,0,4.6,0,4.2,0,3.8,0,4.2,0,1,1,3,4,3,2,3,3,2,2,2,2,3,2,3,2,1,2,3,4,2.3,0,"White, Caucasian, Anglo, European American",0,30,0,1,NA,5,2,0,0,1,0,0,TRUE,TRUE,TRUE,TRUE,TRUE,0,4,0.9389,0.8333333333333334,0.21548596409574466,4,0.4424375,0.4929655172413793,1,0.9354838709677419,0.0014672217741935486,0.002757916129032258,4,0.5820625,0.646483870967742,1,1,0.01823025403225807,0.021981858064516125,1.6137,1.0268,0.4569,1.3855,1.4985,0.5302,0.3141,1.5969745666666666,0.982322551,0.45228307,1.0183,4.9492,0.3396,4.4173,0.3895,-93.3494,0.7324,6.8096,0.3906,4.9427,0.4202,0.9586,1.1216924296666666,4.35254205,5.075495956666667,0.38043804433333334,0.3339806846666667,1.0183,3.0484,0.4469,5.6335,0.539,0.9972,0.227,0.147,0.526,0.015,1.237,82.46666666666668,346,1.0251851851851852,1,0,1,2,FALSE,FALSE,FALSE
343,2021-11-13T03:27:35Z,1,1.6,800,3,4,1,4,4,4,3,2,2,2,1,2,1,4,1,4,4,3,2,1,1,1,1,1,1,1,2,0,0,4,1,4,3,1,1,5,5,4,4,3,4,1,4,5,1,5,5,5,5,5,5,1,1,1,1,1,1,1,1,1,4,5,5,1,1,1,1,1,1,1,1.375,0,1,0,2.3333333333333335,0,2.888888888888889,0,4.083333333333333,0,0.8333333333333334,0,2.142857142857143,0,1,0,2.7027027027027026,0,1,0,0,-0.10762583899489758,-0.10248534152283549,-0.5341482934814965,-0.318316817502166,5,1,3,1,1,1,3,1.5714285714285714,0,2.5,-0.007768311264485517,4,4,4,4,2,2,1,3.5714285714285716,0,2.4285714285714284,0.38995568780511447,0,1,1,1,3,2,1,5,3,3,5,2,4,3,3,3,3,5,3,2,4,1.6,0,4.2,0,3.6,0,2.8,0,3.533333333333333,0,3,1,4,3,4,2,2,3,1,1,1,2,4,1,2,2,1,1,3,1,2.1,0,Black or African American,0,25,0,1,NA,5,2,0,0,1,0,0,TRUE,TRUE,TRUE,TRUE,TRUE,0,3,0.924337105255721,0.76,0.03894705870500693,3,0.5539142187626567,0.6513481250076438,1,1,0.0051773305449158745,0.008283445332567098,3,0.6748404687677976,0.7356535483737506,1,0.96875,0.017078911337499118,0.010507762342368093,1.1704,1.012,0.6237,1.193,0.9752,0.621,0.1664,1.244737643,0.9868986686666666,0.6107245926666667,4.8986,8.1556,0.2536,6.6318,0.282,-74.6852,0.9358,4.9876,0.4613,4.9062,0.5565,0.9666,2.2278699,4.28607048,5.44988396,0.39409043,0.35244119333333335,0.9295,3.228,0.54990000000000006,3.5403,0.6143,0.8741,0.077,0.452,0.39,0.01,1.424,142.39999999999998,410,1.2148148148148148,1,0,0,1,FALSE,FALSE,FALSE
344,2021-11-13T03:44:04Z,1,1.7777777777777777,864,3,2,1,4,5,4,2,1,5,1,2,1,1,5,3,5,5,5,3,1,1,5,1,1,5,4,2,0,0,5,1,5,4,3,3,3,4,3,2,1,1,1,3,1,4,4,3,2,4,2,5,1,1,1,3,1,1,3,3,4,4,2,2,3,2,1,1,3,2,2,2.75,0,2,0,1.9333333333333333,0,2.5555555555555554,0,2.5,0,1.1666666666666667,0,2.2857142857142856,0,2,0,2.27027027027027,0,2,0,0,0.4786591722994391,0.13068230415467,-0.01745100881601569,0.056615647669327154,5,1,1,3,1,1,1,1.8571428571428572,0,1,-0.39031545311577004,3,3,3,3,1,1,3,2.4285714285714284,0,3.5714285714285716,2.0842459175790595,0,4,3,4,1,1,2,3,2,1,1,1,2,1,1,3,1,3,1,5,1,2.6,0,3.8,0,3.8,0,3.6,0,3.7333333333333334,0,1,1,1,4,1,1,2,3,1,1,2,4,2,1,1,3,1,1,1,2,1.3,0,"Asian or Asian American (e.g., Chinese, Japanese, and others)",0,20,0,1,NA,5,2,0,0,1,0,0,TRUE,TRUE,TRUE,TRUE,TRUE,0,3,0.7949186046518558,0.8775510204081632,0.04695125916670925,3,0.4071928571436022,0.47006206896541447,0.9655172413793104,0.90625,0.003236148817703363,0.005961934022035426,3,0.5390093750013039,0.6145468749995343,1,1,0.01170526087732522,0.00790800128019147,1.58,1.4514,0.4109,1.0651,1.4976,0.5849,0.1774,1.5305628333333334,1.2302210723333333,0.40756844633333333,1.0314,4.2546,0.2916,2.2632,0.2718,-56.4073,0.8105,5.2875,0.3317,4.0449,0.381,0.8522,1.1064926693333332,2.5473156666666665,4.42784228,0.268600311,0.28654901466666666,0.713,3.4643,0.4694,4.8954,0.5548,0.9841,0.308,0.078,0.668,0.013,1.361,104.6923076923077,104,0.3081481481481481,1,1,1,2,FALSE,FALSE,FALSE
345,2021-11-13T03:44:00Z,1,1.7777777777777777,864,3,3,5,5,1,5,1,1,5,1,1,1,1,5,1,5,5,1,1,1,1,1,1,1,1,1,2,0,0,5,5,5,5,5,5,5,5,5,1,5,1,1,5,1,5,1,1,1,1,1,5,1,1,1,1,1,1,1,1,1,5,1,1,1,1,1,1,1,1,1,1,0,1,0,1,0,1,0,1,0,0.8333333333333334,0,0.8571428571428571,0,1,0,1,0,1,0,0,-1.3999745198049947,-1.568373259242148,-0.5341482934814965,-1.0512607763618222,5,1,4,1,1,1,1,1.1428571428571428,0,1,-0.8176513788914915,5,5,5,5,3,3,2,4.285714285714286,0,1.7142857142857142,0.9547190977297628,0,1,1,1,3,3,3,3,3,3,1,1,4,1,3,4,2,4,1,3,4,1.8,0,4.2,0,3.2,0,3,0,3.466666666666667,0,2,2,2,2,2,3,2,3,1,2,2,2,2,3,1,3,1,2,2,1,2,0,"White, Caucasian, Anglo, European American",0,25,0,1,NA,5,2,0,0,1,0,0,TRUE,TRUE,TRUE,TRUE,TRUE,0,4,0.9698625000044704,0.64,0.12312368635075824,4,0.4586379310385934,0.5531812499985099,0.9354838709677419,1,0.010034411849764346,0.010191947380106774,4,0.7676806451601367,0.90884375,1,1,0.17732693295419416,0.08392329157176032,1.5026,0.3983,0.5195,1.2575,0.3125,0.6566,0.4503,1.5212022466666666,0.5499998830666667,0.510746961,1.2766,2.9304,0.2625,3.5397,0.3729,-52.9825,0.9663,3.5212,0.3231,4.1146,0.4346,0.9572,1.3822499463333333,3.6968071166666667,3.2499884166666666,0.364953703,0.2573932526666667,1.4092,3.0419,0.4764,2.5626,0.5923,0.8117,0.108,0.421,0.372,0.008,1.453,181.625,347,1.028148148148148,1,0,0,1,FALSE,FALSE,FALSE
346,2021-11-13T03:38:27Z,1,1.7777777777777777,1080,4,2,4,5,1,5,1,1,3,1,1,1,1,5,3,4,5,3,1,2,1,3,2,3,3,4,2,1,0,5,1,3,5,5,5,2,2,2,1,5,1,1,3,2,5,2,2,3,2,2,1,4,2,3,2,3,1,1,1,1,5,1,3,1,3,1,2,2,2,2,2.25,0,2,0,1.4,0,2.6666666666666665,0,1.75,0,3,0,1.1428571428571428,0,1.6666666666666667,0,2.108108108108108,0,2,1,0,0.06678869841524551,-0.3830801961592365,0.18918219877700804,-0.09694899869111423,5,1,3,1,1,1,1,1.2857142857142858,0,3,0.005791155812417015,5,5,5,5,4,4,2,4.571428571428571,0,1.4285714285714286,1.5194825076544112,0,5,5,5,5,5,5,3,4,5,1,1,5,5,3,2,5,5,3,3,5,5,0,3.8,0,1.8,0,1.8,0,2.466666666666667,0,3,2,4,4,2,3,1,3,1,3,2,2,3,4,4,4,3,2,2,4,2.5,0,"White, Caucasian, Anglo, European American",0,25,0,1,NA,5,2,0,0,1,0,0,TRUE,TRUE,TRUE,TRUE,TRUE,0,NA,NA,NA,NA,6,0.41782500000018624,0.47691562499990686,0.8571428571428571,1,0.007047352209008952,0.002107746522211119,6,0.6271062499994878,0.7490214285712157,1,0.9032258064516129,0.03685202899170853,0.034510305118299944,NA,NA,NA,NA,NA,NA,NA,NA,NA,NA,1.0183,2.163,0.2308,4.8713,0.3724,-65.9615,0.7825,2.9067,0.3091,6.1222,0.4176,0.9632,1.0838136076666667,4.745475926666667,2.58612374,0.367168791,0.22803564266666668,1.1297,3.8656,0.4625,2.5598,0.5529,0.8178,0.076,0.37,0.314,0.008,1.552,194,224,0.6637037037037037,1,0,1,2,FALSE,FALSE,FALSE
347,2021-11-13T03:47:45Z,1,1.6,900,6,3,4,4,2,4,2,1,4,2,2,1,2,3,2,3,3,2,4,1,1,1,2,2,1,3,2,0,0,5,3,4,4,5,3,4,3,3,2,4,2,1,2,2,5,3,2,1,2,2,4,1,1,1,3,1,1,3,3,3,4,2,2,1,1,1,1,2,1,1,1.75,0,1.25,0,2.066666666666667,0,2.2222222222222223,0,2,0,1.3333333333333333,0,2.142857142857143,0,1,0,1.945945945945946,0,2,0,0,-0.3450817754689478,-0.3811443917119342,-0.25265461696773905,-0.3168995043398366,5,2,4,1,1,2,1,1.4285714285714286,0,1,-0.6467170085812028,5,5,5,5,4,2,1,4.428571428571429,0,1.5714285714285714,-0.4571894270818581,0,2,2,2,5,2,2,4,2,2,4,4,5,3,4,5,1,4,4,4,2,2.6,0,3.4,0,4,0,4.2,0,3.8666666666666667,0,2,1,3,2,3,3,2,2,2,1,3,2,2,3,1,2,2,3,3,2,2.4,0,"White, Caucasian, Anglo, European American",0,28,0,1,NA,5,2,0,0,0,0,0,TRUE,TRUE,TRUE,TRUE,TRUE,0,6,1.0252093750238418,0.64,0.47169251902833687,6,0.5030187499821186,0.5245533332824707,1,0.967741935483871,0.0042605996364145126,0.0027443997840810586,6,0.7084500000178814,0.8568518518695125,1,0.9,0.10712231483766002,0.12190705753669315,1.7635,0.3268,0.4296,1.5106,0.2281,0.5113,0.1725,1.7165609533333333,0.45367155901666667,0.43248784566666665,1.197,5.1498,0.3868,4.1469,0.3886,-85.1858,0.691,6.1518,0.4455,6.8894,0.477,0.962,1.358352473,4.278362476666667,5.199658733333333,0.377117951,0.37477996566666666,1.2039,2.924,0.4498,1.7658,0.544,0.7826,0.07,0.442,0.284,0.013,1.779,136.84615384615384,388,1.1496296296296296,1,0,0,1,FALSE,FALSE,FALSE
348,2021-11-13T03:49:54Z,1,1.7777777777777777,1080,4,2,2,2,3,2,2,2,4,2,2,2,2,3,2,3,3,2,2,4,2,2,3,3,2,3,2,0,0,4,3,3,3,4,3,3,3,3,2,4,3,3,2,3,3,2,2,2,2,2,3,2,1,2,3,3,1,3,3,2,4,2,2,3,2,2,2,2,2,2,2.5,0,2,0,2.6666666666666665,0,2.7777777777777777,0,2.5,0,2.1666666666666665,0,2,0,2.3333333333333335,0,2.4594594594594597,0,2,0,0,0.440834332861095,0.41969790813683366,-0.01745100881601569,0.201123449660409,3,2,2,2,1,2,2,2.2857142857142856,0,1,-0.1339138976503373,3,3,3,3,1,1,4,2.2857142857142856,0,3.7142857142857144,0.10757398284279028,0,2,2,3,2,2,2,3,3,2,2,3,3,3,3,4,4,4,3,3,3,2.2,0,3.4,0,2.6,0,3.4,0,3.1333333333333333,0,2,1,3,1,2,3,3,1,3,2,3,1,2,3,1,1,1,2,2,3,2.6,0,"White, Caucasian, Anglo, European American",0,28,0,1,NA,5,2,0,0,1,0,0,TRUE,TRUE,TRUE,TRUE,TRUE,0,1,0.8877179487182353,0.78,0.04868439340407696,1,0.5527709677418874,0.6529968749999534,1,1,0.010181403462339606,0.00846959773183207,NA,NA,NA,NA,NA,NA,NA,1.2978,1.0247,0.5241,1.3025,1.0407,0.5281,0.0099,1.3411506433333333,0.9924125086666666,0.5144998643333333,1.9353,5.4904,0.3765,4.7627,0.4498,-74.7245,0.9684,4.8117,0.4479,4.4841,0.5444,0.955,1.9438809633333334,4.442025636666667,5.163620603333333,0.43714580166666667,0.36706189333333333,NA,NA,NA,NA,NA,NA,NA,NA,NA,NA,NA,NA,104,0.3081481481481481,1,0,1,2,FALSE,FALSE,FALSE
349,2021-11-13T03:20:41Z,1,1.6,800,3,3,4,4,2,5,2,2,4,2,1,2,1,4,1,4,4,2,2,1,1,1,1,1,1,4,2,0,0,5,4,5,5,5,4,4,4,4,2,4,1,1,3,1,4,1,1,1,1,1,4,2,1,1,4,3,1,3,3,3,5,1,1,1,1,1,2,1,2,2,1.25,0,1.75,0,1.7333333333333334,0,1.5555555555555556,0,1.4166666666666667,0,2,0,1.7142857142857142,0,1,0,1.6216216216216217,0,2,0,0,-0.8578184878553927,-0.8786461346685052,-0.0958522115332568,-0.487249173100881,5,1,4,1,2,1,1,1.2857142857142858,0,1,-0.7321841937363471,4,4,5,4,3,2,2,3.7142857142857144,0,2.2857142857142856,-1.3043345419688306,0,1,1,1,1,1,1,4,2,4,3,1,4,2,4,2,1,3,2,4,2,1,0,4.2,0,4,0,3.2,0,3.8,0,1,2,1,3,2,2,1,2,1,2,3,3,1,2,1,3,1,2,2,1,1.7,0,"Asian or Asian American (e.g., Chinese, Japanese, and others)",0,20,1,2,NA,5,1,0,0,0,1,0,TRUE,TRUE,TRUE,TRUE,TRUE,0,NA,NA,NA,NA,2,0.5720200000047684,0.6325933333317438,1,0.967741935483871,0.027335914761841447,0.03105886531071951,2,1.009140625,1.117251612913224,1,1,0.24626421409370222,0.10253172458027279,NA,NA,NA,NA,NA,NA,NA,NA,NA,NA,1.2438,2.9391,0.3605,2.986,0.4328,-44.4691,1.3956,3.1396,0.3453,3.9818,0.4321,0.9974,1.4671196006666667,3.213363036666667,3.32476995,0.40935435433333334,0.34215123366666667,2.0943,2.4887,0.4728,2.549,0.689,0.6867,0.161,0.385,0.298,0.01,1.844,184.4,104,0.3081481481481481,1,0,0,1,FALSE,FALSE,FALSE
350,2021-11-13T03:33:31Z,0.8999999761581421,1.7786458333333333,768,5,3,3,4,3,3,3,2,3,2,3,2,2,3,2,3,2,3,3,3,3,3,3,3,3,5,6,0,0,2,1,2,5,2,2,3,4,5,3,2,3,2,3,2,2,3,5,3,4,3,1,1,3,2,3,5,3,NA,3,5,3,4,3,5,5,5,1,1,1,1,3,0,1,0,2.6666666666666665,0,3.111111111111111,0,3.25,0,3,0,3.3333333333333335,1,5,0,3.388888888888889,1,3,0,0,1.329951546325386,1.0339931860806149,-0.12796334588846375,0.4530149200960756,2,3,2,3,2,3,3,3.142857142857143,0,6,2.223827587152439,3,2,3,2,3,2,3,2.5714285714285716,0,3.4285714285714284,-0.1748077221195339,0,5,5,5,5,5,5,4,5,4,5,5,5,4,5,3,4,2,4,2,3,5,0,2.2,0,3,0,2.8,0,2.6666666666666665,0,2,3,3,1,1,1,1,1,1,1,1,1,1,1,1,1,1,1,1,1,1.85,0,Black or African American,0,25,0,1,NA,5,2,0,0,1,0,0,TRUE,TRUE,TRUE,TRUE,TRUE,0,6,0.7897533333331347,0.6382978723404256,0.09958438346851138,6,0.5398900000008444,0.6935612903227729,0.967741935483871,1,0.009327624516048707,0.018435866451875695,6,0.7046468749991618,0.7762838709683668,1,1,0.01375740063510177,0.010325664731174024,1.4089,0.4087,0.2644,1.4698,0.4795,0.2816,0.2585,1.4245191666666666,0.5836721753666667,0.263019003,1.523,3.5275,0.3332,3.0569,0.4445,-45.2094,1.1942,5.9921,0.4324,2.8561,0.5037,0.9519,1.7360907333333333,3.26682225,3.8359335833333335,0.42371659466666667,0.31805532766666667,1.1663,3.0612,0.5431,4.2327,0.647,0.9575,0.211,0.389,0.665,0.017,1.523,89.58823529411764,316,0.9362962962962963,1,0,0,1,FALSE,FALSE,FALSE
351,2021-11-13T03:39:11Z,1,1.7786458333333333,768,3,2,5,5,3,3,4,3,3,3,2,1,2,4,2,4,3,2,1,1,2,1,1,1,1,2,2,0,0,4,3,2,3,3,4,3,3,3,2,4,1,1,4,2,1,5,2,1,1,1,5,1,1,1,3,1,2,2,1,1,3,3,3,1,1,1,2,1,1,1,1.25,0,1.25,0,2.3333333333333335,0,2.888888888888889,0,2.0833333333333335,0,1.1666666666666667,0,2,0,1,0,2.081081081081081,0,1,0,0,-0.5720308120990136,-0.42334492866311435,-0.4557470907642554,-0.43954600971368485,1,4,1,3,2,4,4,3.857142857142857,0,1.5,0.990718976443441,4,3,4,4,1,1,3,2.857142857142857,0,3.142857142857143,NA,1,2,3,1,2,1,2,3,2,2,1,2,5,2,4,5,2,5,1,2,5,1.8,0,4.6,0,2.8,0,3.6,0,3.6666666666666665,0,1,1,1,3,1,1,3,4,1,1,2,4,1,1,1,4,1,1,1,1,1.2,0,"Hispanic of Latino (e.g., Mexican American, Central American, and others)",0,29,0,1,NA,5,2,0,0,3,0,0,TRUE,TRUE,TRUE,TRUE,TRUE,0,NA,NA,NA,NA,1,0.5024935483797904,0.6167562500033528,1,1,0.0016105252904474146,0.00646866834619745,1,0.731562500005588,0.726346875000745,1,1,0.02121335919185274,0.012824657410808458,NA,NA,NA,NA,NA,NA,NA,NA,NA,NA,4.2264,10.6019,0.3032,7.1606,0.3216,-93.8965,0.7064,6.0051,0.4514,5.7259,0.5505,0.9384,1.8204518573333333,4.73166053,6.330155663333334,0.42858394866666666,0.36520268433333336,0.8855,2.9015,0.6283,5.6252,0.6534,0.985,0.286,0.188,0.531,0.143,1.112,7.776223776223778,400,1.1851851851851851,1,0,0,1,FALSE,FALSE,FALSE
352,2021-11-13T03:50:17Z,0.800000011920929,1.7777777777777777,1080,4,2,3,3,3,4,4,4,3,3,3,3,3,3,3,3,3,3,3,4,4,3,3,3,3,2,2,1,1,4,4,4,4,4,4,4,4,4,4,4,3,3,3,3,3,2,3,3,3,3,2,2,3,3,3,3,1,2,3,3,3,2,2,3,3,3,2,2,2,3,3.25,0,2.25,0,3.066666666666667,0,2,0,2.9166666666666665,0,2.8333333333333335,0,2.142857142857143,0,3,0,2.5945945945945947,0,1,1,1,0.9913958846858842,0.9719829169520463,0.2409405745969135,0.6064617457744799,3,2,3,3,2,4,4,3,0,2.5,0.8469035402869574,3,3,3,3,2,2,3,2.7142857142857144,0,3.2857142857142856,-1.3043345419688306,0,2,2,4,4,4,2,4,2,2,4,2,2,2,4,4,3,4,4,4,4,3.2,0,3.2,0,3.8,0,3.6,0,3.533333333333333,0,2,2,2,3,3,3,3,3,2,3,3,3,3,3,2,2,2,2,3,3,2.5,0,"Hispanic of Latino (e.g., Mexican American, Central American, and others) & White, Caucasian, Anglo, European American",1,22,0,1,NA,5,2,0,0,0,0,0,TRUE,TRUE,TRUE,TRUE,TRUE,0,3,0.6629166666666667,0.7346938775510204,0.11049280272108841,3,0.5334333333333333,0.6256,1,0.967741935483871,0.06820066781609196,0.030240073118279573,3,0.5719354838709677,0.6823793103448276,0.96875,0.9354838709677419,0.013252705645161289,0.02235796559139785,1.2971,0.8009,0.3195,0.998,0.9151,0.4313,0.2966,1.33485648,0.850849256,0.314184451,1.4327,2.8193,0.2793,2.7769,0.3788,-34.2807,1.3762,4.1414,0.3167,4.834,0.4578,0.9329,1.53772881,2.94965123,3.1083337933333333,0.368761952,0.273373909,1.4124,5.7131,0.4396,4.7797,0.518,0.9897,0.074,0.372,0.374,0.01,1.496,149.6,104,0.3081481481481481,1,1,0,1,FALSE,FALSE,FALSE
353,2021-11-13T03:56:55Z,1,1.7777777777777777,1080,4,4,5,5,1,5,1,1,5,1,1,1,1,5,1,5,5,1,3,3,1,1,1,1,1,0,2,1,0,5,5,5,5,5,5,2,4,5,1,5,1,1,5,1,5,1,1,1,1,1,3,1,1,1,2,1,1,1,1,1,5,1,1,1,1,1,1,1,1,1,1.5,0,1,0,1,0,1.4444444444444444,0,1,0,1.3333333333333333,0,0.8571428571428571,0,1,0,1.1891891891891893,0,0,1,0,-0.9712930061704257,-1.2721951788049675,-0.5306075596849892,-0.9014013692449783,5,1,2,1,1,1,1,1.4285714285714286,0,2.5,-0.09323549641962975,5,5,5,5,2,2,1,4.142857142857143,0,1.8571428571428572,-0.1748077221195339,0,1,1,1,1,1,1,4,1,1,3,2,4,1,5,5,2,5,2,4,3,1,0,4.4,0,4,0,4.6,0,4.333333333333333,0,1,1,1,4,1,1,1,4,1,1,1,4,1,1,1,4,1,1,1,1,1,0,"White, Caucasian, Anglo, European American",0,19,0,1,NA,5,2,0,0,1,0,0,TRUE,TRUE,TRUE,TRUE,TRUE,0,5,0.6974714285717124,0.84,0.05447185724588709,5,0.30983437499962746,0.38049032257449245,1,0.96875,0.0012626565221512203,0.0016637970865659203,5,0.4367312499973923,0.5085833333353201,1,0.9375,0.00237001447602435,0.004618981128331366,1.2636,1.341,0.3938,1.1568,1.3476,0.4244,0.0675,1.29838523,1.1730885453333333,0.386005747,1.2271,7.8287,0.2315,4.902,0.2605,-110.7997,0.6074,7.8242,0.2717,6.8099,0.3359,0.7527,1.1053067433333332,4.402333033333333,6.50108735,0.263123104,0.23160356433333334,0.6411,5.8446,0.3874,4.3847,0.4502,0.9843,0.054,0.346,0.618,0.016,1.558,97.375,312,0.9244444444444444,1,0,0,1,FALSE,FALSE,FALSE
354,2021-11-13T03:57:24Z,0.8999999761581421,1.7777777777777777,1080,7,3,4,4,4,3,3,3,2,3,2,3,2,3,2,4,3,2,3,1,1,3,4,3,3,1,2,0,0,4,3,3,4,4,5,3,3,4,3,5,2,1,4,2,5,4,3,2,2,2,3,1,1,1,3,1,2,2,3,1,3,2,3,1,4,2,2,2,1,2,2.5,0,1.75,0,2.7333333333333334,0,2.3333333333333335,0,2.0833333333333335,0,1.5,0,2.142857142857143,0,2.3333333333333335,0,2.135135135135135,0,1,0,0,0.23910185585659188,0.3089698937511685,-0.2989446853297732,0.005012604210697658,4,2,3,1,1,2,3,2,0,1,-0.3048482679606258,3,4,4,3,1,1,4,2.5714285714285716,0,3.4285714285714284,0.6723373927674386,0,2,3,3,3,2,3,4,4,2,4,4,3,2,4,4,2,3,2,4,3,2.6,0,3,0,4,0,3.4,0,3.466666666666667,0,2,4,3,2,4,4,4,3,2,1,3,2,2,3,1,3,1,2,2,3,2.55,0,"White, Caucasian, Anglo, European American",0,26,0,1,NA,5,2,0,0,2,0,0,TRUE,TRUE,TRUE,TRUE,TRUE,0,3,0.8578695652173913,0.92,0.12960723135716704,3,0.46417741935291595,0.5328718750011175,0.96875,1,0.002853454153378145,0.0028615098286394022,3,0.6221656249966472,0.6628937499895692,1,1,0.010037620394636964,0.008130914151539593,1.6461,1.5034,0.3827,1.7198,1.5757,0.3653,0.2036,1.56784767,1.2664812933333334,0.38403614566666666,1.2738,5.0637,0.3448,4.8226,0.4008,-89.2511,0.7323,6.0539,0.4045,5.779,0.4753,0.9562,1.3702970936666667,4.7350785433333336,5.010101783333333,0.392761114,0.336031308,0.9293,3.6971,0.5059,3.8562,0.564,0.8644,0.2,0.273,0.581,0.021,1.362,64.85714285714286,517,1.5318518518518518,1,0,0,1,FALSE,FALSE,FALSE
355,2021-11-13T03:39:39Z,1,1.7777777777777777,864,6,3,1,5,2,4,2,1,5,1,2,2,1,5,3,5,4,1,1,1,1,1,1,1,1,0,2,0,0,4,4,4,4,4,4,4,4,4,2,4,2,2,4,2,5,1,1,2,1,1,5,1,1,1,2,1,2,1,2,1,5,1,1,1,1,1,1,1,1,1,1,0,1,0,1.8,0,2,0,1.5833333333333333,0,1,0,1.1428571428571428,0,1,0,1.5135135135135136,0,0,0,0,-1.0805647645478649,-1.0038926824089338,-0.7372407672780129,-0.8705667248434734,5,1,3,1,1,1,2,1.4285714285714286,0,2,-0.2777293338068208,4,5,4,5,4,4,2,4.285714285714286,0,1.7142857142857142,-0.7395711320441822,0,1,1,1,1,1,1,3,2,1,3,1,4,1,4,5,1,5,2,3,4,1,0,4.6,0,3.8,0,4,0,4.133333333333334,0,1,1,1,4,1,1,1,4,1,1,2,4,1,1,1,4,1,1,1,1,1.05,0,Middle Eastern,0,29,0,1,NA,5,2,0,0,1,0,0,TRUE,TRUE,TRUE,TRUE,TRUE,0,6,1.74965625,0.64,0.3265709914285715,6,0.8350344827586207,0.9238064516129032,0.9354838709677419,0.96875,0.013129049462365589,0.01075456451612903,6,1.030125,1.15396875,1,1,0.006217790322580645,0.009228998991935487,1.9716,0.3036,0.8825,1.9274,0.2456,0.9371,0.2035,1.9367724066666667,0.4034632767,0.8369340333333334,1.4508,1.968,0.4969,3.5849,0.7302,-31.2359,0.977,3.2783,0.7117,3.8471,0.8039,0.9723,2.187895393333333,3.20178679,2.52098326,0.592061776,0.4180885306666667,0.9382,4.608,0.9442,3.2148,1.0388,0.8098,0.429,0.484,0.77,0.011,1.388,126.18181818181819,289,0.8562962962962963,1,0,0,1,FALSE,FALSE,FALSE
356,2021-11-13T04:06:53Z,1,1.5,960,4,3,4,4,3,4,2,3,2,3,2,3,2,3,2,3,4,1,1,1,1,1,2,2,2,5,2,0,0,4,4,5,5,3,5,4,4,5,2,5,1,1,4,1,5,2,1,1,2,1,4,1,3,1,3,1,1,3,3,1,4,1,1,1,1,1,1,1,2,2,1.375,0,1.5,0,2.533333333333333,0,1.6666666666666667,0,1.3333333333333333,0,1.6666666666666667,0,1.5714285714285714,0,1,0,1.5405405405405406,0,3,0,0,-0.8305005482610333,-0.5159731714665071,0.028839059546018453,-0.24356705596024433,5,1,3,1,1,2,2,1.5714285714285714,0,2.5,-0.007768311264485517,4,5,5,5,2,2,2,3.857142857142857,0,2.142857142857143,-0.4571894270818581,0,2,3,2,2,2,3,3,3,1,3,3,3,2,4,4,2,4,3,3,4,2.2,0,3.2,0,3.4,0,3.6,0,3.4,0,2,1,2,3,3,3,3,2,1,1,2,3,2,1,1,2,1,3,1,3,2,0,"White, Caucasian, Anglo, European American",0,26,0,1,NA,5,2,0,0,1,0,0,TRUE,TRUE,TRUE,TRUE,TRUE,0,1,0.8985999999962202,0.82,0.05759747035006367,1,0.5285749999973923,0.5999413793169219,1,0.9354838709677419,0.0027609258061179237,0.004658719785375593,1,0.6537343749981374,0.743215624999255,1,1,0.00405711974779473,0.01015490781280612,1.3712,1.1402,0.5408,1.224,1.073,0.606,0.3024,1.4076279766666666,1.065615514,0.5303980986666667,1.4131,5.4662,0.3993,3.1016,0.3996,-69.6432,0.7906,5.3806,0.4607,4.0542,0.5175,0.939,1.5437128133333333,3.280463983333333,5.361375306666667,0.3895177613333333,0.38736723366666664,1.1035,5.6108,0.561,3.3883,0.5924,0.973,0.078,0.522,0.54,0.032,2.089,65.28125,104,0.3081481481481481,1,1,0,1,FALSE,FALSE,FALSE
357,2021-11-13T04:10:22Z,1,1.6,1050,6,4,5,5,1,5,1,1,3,2,2,1,4,4,2,4,5,2,4,4,1,1,2,1,1,0,2,0,0,5,5,5,5,5,5,5,5,5,1,5,1,1,4,1,5,1,3,3,3,4,3,1,1,1,1,1,1,1,1,1,5,2,2,1,1,1,1,1,1,1,2,0,1,0,1.6666666666666667,0,1,0,1.8333333333333333,0,1.1666666666666667,0,1.1428571428571428,0,1,0,1.3783783783783783,0,0,0,0,-0.5426114925358573,-0.6895180401671162,-0.7372407672780129,-0.7133794037225645,5,1,5,1,1,2,1,1.1428571428571428,0,1,-0.8176513788914915,5,5,5,5,3,3,1,4.428571428571429,0,1.5714285714285714,-1.869097951893479,0,2,1,2,1,2,1,5,1,1,4,1,4,1,4,5,1,4,1,4,3,1.6,0,4.6,0,4.6,0,4.4,0,4.533333333333333,0,2,1,1,4,2,1,2,2,2,1,2,3,2,3,2,2,1,1,1,2,1.75,0,"White, Caucasian, Anglo, European American",0,24,0,1,NA,5,2,0,0,1,0,0,TRUE,TRUE,TRUE,TRUE,TRUE,0,6,0.7071487179474953,0.78,0.048822708319217985,6,0.46639375000447036,0.5546354838801969,1,0.96875,0.01036011479551198,0.015352493140375767,6,0.8183387096620375,0.7691870967495826,1,0.96875,0.24622727242910555,0.043232969630467806,1.297,1.0405,0.3411,1.0477,1.4843,0.45,0.2475,1.33268665,0.998606998,0.33463622233333334,1.4057,4.2384,0.3006,2.7201,0.3067,-53.438,1.1017,4.2023,0.3306,3.5074,0.4015,0.9867,1.4786097343333333,2.9119371566666667,4.35772511,0.303816285,0.29497259833333334,1.7309,1.9747,0.3291,2.901,0.4547,0.7612,0.089,0.374,0.22,0.032,1.738,54.3125,408,1.208888888888889,1,0,1,2,FALSE,FALSE,FALSE
358,2021-11-13T04:13:28Z,1,1.7777777777777777,1080,4,3,3,3,4,4,3,4,4,2,2,2,2,5,3,4,4,3,3,5,3,2,2,3,2,3,2,0,0,4,4,4,5,5,5,4,5,5,2,3,2,1,5,2,5,3,3,3,2,4,3,1,4,2,4,4,2,2,2,3,4,2,2,2,2,1,2,3,4,4,2.875,0,3.25,0,2.466666666666667,0,1.4444444444444444,0,2.25,0,2.8333333333333335,0,2,0,1.6666666666666667,0,2.108108108108108,0,2,0,0,0.4555439926426731,0.3439111640249665,0.3745550047701899,0.3592330843975782,2,3,4,3,3,3,4,3.142857142857143,0,3,1.1168645628292926,4,4,4,4,2,2,2,3.4285714285714284,0,2.5714285714285716,0.10757398284279028,0,4,3,4,3,3,3,4,3,2,3,2,4,2,3,3,3,4,3,3,3,3.4,0,3.6,0,3.4,0,3.2,0,3.4,0,1,1,1,4,2,2,1,3,1,1,2,3,2,2,1,3,1,2,2,2,1.55,0,"White, Caucasian, Anglo, European American",0,30,0,1,NA,5,2,0,0,1,0,0,TRUE,TRUE,TRUE,TRUE,TRUE,0,2,1.1917684210507493,0.76,0.18801290782149493,2,0.48814193548646667,0.4944781250008382,1,1,0.004829711849401184,0.0024876075706578064,2,0.6280687499986961,0.6819750000000931,1,1,0.009842872540121936,0.009728854838567707,1.8817,0.6575,0.4507,1.5328,0.7131,0.6507,0.1726,1.7947646366666667,0.698722654,0.45197820066666666,5.4857,8.7862,0.176,10.091,0.2227,-92.6478,0.9329,4.7351,0.3965,7.9685,0.4399,0.7201,1.8038616,5.5807940333333335,5.198553133333333,0.3404510723333333,0.317296661,1.0479,4.5347,0.5048,3.0021,0.5372,0.9516,0.127,0.391,0.563,0.027,1.8,66.66666666666667,314,0.9303703703703704,1,0,0,1,FALSE,FALSE,FALSE
359,2021-11-13T04:20:27Z,1,1.7777777777777777,1152,4,4,3,4,2,4,3,4,3,3,3,2,2,4,2,3,4,1,1,1,1,2,2,3,2,3,2,0,0,4,5,5,5,5,4,4,5,4,1,4,1,1,3,2,5,1,2,2,1,3,5,1,2,1,2,1,1,3,3,3,5,2,2,1,1,1,2,1,3,3,1.625,0,2.25,0,2.533333333333333,0,1.4444444444444444,0,1.6666666666666667,0,1.1666666666666667,0,2,0,1,0,1.5945945945945945,0,2,0,0,-0.6413763510693116,-0.38530637127363354,0.06095019390122543,-0.16217808868620406,5,2,4,2,1,2,1,1.5714285714285714,0,1.5,-0.3767559860388676,5,5,5,5,3,2,2,4.142857142857143,0,1.8571428571428572,-1.3043345419688306,0,2,2,3,2,3,2,4,3,2,2,1,4,3,4,4,2,4,3,4,4,2.4,0,4,0,3.4,0,3.4,0,3.6,0,2,1,1,4,4,3,3,3,1,1,2,4,1,1,1,4,1,2,1,2,1.6,0,"White, Caucasian, Anglo, European American",0,23,0,1,NA,5,2,0,0,1,0,0,TRUE,TRUE,TRUE,TRUE,TRUE,0,6,1.0252682926829269,0.82,0.18921450979591836,6,0.3944375,0.5064333333333333,1,0.9375,0.0017014798387096773,0.007458447580645163,6,0.55309375,0.6076451612903225,1,0.96875,0.00838744254032258,0.00955482157258065,1.8711,0.8823,0.3775,1.4283,1.1137,0.6165,0.5236,1.7698455,0.860094803,0.3818352306666667,1.2526,6.3296,0.2955,2.8291,0.3039,-78.2127,0.8449,6.8315,0.3317,6.2268,0.4217,0.8355,1.2733720373333333,2.96791492,5.867872603333334,0.3030519523333333,0.2908845093333333,1.0315,3.993,0.4285,4.2063,0.4872,0.995,0.069,0.383,0.448,0.015,1.469,97.93333333333334,289,0.8562962962962963,1,0,1,2,FALSE,FALSE,FALSE
360,2021-11-13T04:20:20Z,1,1.7777777777777777,1080,4,3,2,3,2,4,2,1,3,3,2,2,2,2,1,3,3,4,4,3,1,2,3,3,2,1,2,0,0,4,5,4,3,3,5,4,5,4,2,4,2,2,4,2,4,2,4,3,3,3,2,1,1,2,3,1,1,3,1,2,4,2,2,1,1,1,1,3,1,1,2.75,0,1.5,0,2.466666666666667,0,1.8888888888888888,0,2.4166666666666665,0,1.8333333333333333,0,1.7142857142857142,0,1,0,2,0,1,0,0,0.3105487747956867,0.2437332838770968,-0.3773458880470143,-0.06680630208495875,4,1,3,1,1,2,1,1.5714285714285714,0,1.5,-0.3767559860388676,5,5,5,5,2,2,2,4,0,2,0.6723373927674386,0,2,3,3,3,3,3,2,2,2,3,4,3,3,4,3,4,3,2,4,3,2.8,0,3,0,2.8,0,3.6,0,3.1333333333333333,0,1,1,1,4,1,2,2,4,2,2,1,3,1,1,1,3,1,2,1,2,1.4,0,"Hispanic of Latino (e.g., Mexican American, Central American, and others)",0,24,0,1,NA,5,2,0,0,1,0,0,TRUE,TRUE,TRUE,TRUE,TRUE,0,6,1.0123046511772067,0.86,0.048738260222410616,6,0.49497419356530714,0.583835483874044,0.96875,0.96875,0.007502052485815152,0.007601973701675562,6,1.2056275862167622,1.0674483870998506,0.9666666666666667,1,0.6415830403656204,0.3177509046128657,1.5166,1.2757,0.6069,1.1304,1.3339,0.7745,0.4089,1.5234916833333334,1.1444050233333334,0.5955981143333333,1.2149,4.0783,0.3568,2.9157,0.3834,-60.4599,0.7459,5.8822,0.4219,3.8927,0.5094,0.7077,1.3820200173333332,3.1975757866666665,4.308928496666667,0.3720799026666667,0.344294612,2.3575,1.2465,0.2315,2.027,0.4012,0.3907,0.113,0.332,0.146,0.166,1.613,9.716867469879517,104,0.3081481481481481,1,1,1,2,FALSE,FALSE,FALSE
361,2021-11-13T04:23:18Z,1,1.7777777777777777,1080,1,1,2,4,2,2,2,3,4,2,3,1,1,4,2,4,1,5,5,5,3,3,4,4,3,7,1,3,1,1,1,1,1,1,2,2,2,1,2,4,2,2,2,3,2,5,5,5,5,5,1,5,5,2,5,5,2,3,3,3,2,5,2,3,5,2,1,2,2,2,4,0,1.75,0,2.466666666666667,0,4.666666666666667,0,3.6666666666666665,0,4.333333333333333,0,3,0,3.3333333333333335,0,3.918918918918919,0,4,3,1,2.2816431855271846,1.6055717125539355,1.106682005738028,1.3561268591459816,4,2,3,2,1,3,2,2.142857142857143,0,8,2.363532640615193,4,4,4,4,1,1,5,2.7142857142857144,0,3.2857142857142856,1.5194825076544112,0,3,3,3,2,3,5,4,3,3,2,3,2,4,3,2,2,3,3,2,3,2.8,0,2.4,0,2.8,0,2.8,0,2.6666666666666665,0,1,4,4,1,4,4,4,1,4,3,2,1,1,4,2,2,1,2,2,4,3.05,0,"White, Caucasian, Anglo, European American",0,27,0,1,NA,5,2,0,0,1,0,0,TRUE,TRUE,TRUE,TRUE,TRUE,0,3,0.7049871794864153,0.78,0.012970844260550528,3,0.3837187500018626,0.4708266666650772,1,0.9375,9.917454436041127e-4,0.0035033845059560856,3,0.5180062499986962,0.5381333333323399,1,0.967741935483871,0.004598684475358781,0.002650380365664284,1.0791,1.2523,0.4639,0.8337,1.4553,0.5606,0.1663,1.1384396306666666,1.1148553806666666,0.45568347033333334,1.1586,8.0321,0.3135,3.7677,0.3328,-107.9537,0.4973,7.3078,0.3516,6.3239,0.4244,0.8789,1.1736621316666667,3.310843913333333,6.860613703333334,0.3064530753333333,0.305658643,0.6878,3.9786,0.4425,4.8187,0.4773,0.7834,0.063,0.378,0.429,0.044,1.502,34.13636363636364,316,0.9362962962962963,1,0,0,1,FALSE,FALSE,FALSE
362,2021-11-13T04:24:58Z,1,1.7777777777777777,1080,3,2,3,4,4,3,4,1,2,3,2,2,4,3,3,3,4,4,4,5,1,4,4,2,4,0,1,2,1,5,3,2,3,3,3,3,4,4,1,5,4,2,3,3,4,4,4,4,5,3,1,2,4,2,3,1,1,1,1,1,4,1,2,1,2,1,2,4,1,1,3.5,0,2,0,2.8666666666666667,0,2.6666666666666665,0,3,0,2.6666666666666665,0,1.1428571428571428,0,1.3333333333333333,0,2.4324324324324325,0,0,2,1,1.0460317638746037,0.9237813862142307,0.1660801056761797,0.5449307459452052,1,3,1,4,3,3,5,4,0,6,2.736630698083305,2,3,3,2,1,1,5,1.8571428571428572,0,4.142857142857143,0.9547190977297628,0,2,2,3,4,3,3,3,1,1,4,4,3,1,4,5,3,3,5,4,4,2.8,0,2.4,0,3.8,0,4.2,0,3.466666666666667,0,1,1,1,3,1,1,2,3,1,1,4,3,1,1,1,4,1,1,1,1,1.35,0,"White, Caucasian, Anglo, European American",0,28,0,1,NA,5,2,0,0,1,0,0,TRUE,TRUE,TRUE,TRUE,TRUE,0,3,0.8111766666680574,0.6122448979591837,0.05251185187056104,3,0.45229666666686535,0.5009656249997206,0.9375,1,0.006688620604519712,0.0059204597481103075,3,0.6085193548404402,0.6743218749994412,0.96875,1,0.0061099702823565845,0.011738003054080784,1.3428,0.3582,0.3894,1.0348,0.5357,0.5646,0.451,1.3798589233333334,0.5561907767263333,0.38300529333333333,1.3292,3.2039,0.2646,3.9005,0.3306,-59.6212,0.7628,6.0323,0.3794,7.2559,0.4481,0.9412,1.4084415103333334,3.9947980966666665,3.483421496666667,0.3253953153333333,0.26131346066666666,0.9682,4.0198,0.4976,2.9278,0.5525,0.9055,0.068,0.449,0.37,0.053,1.769,33.37735849056604,317,0.9392592592592592,1,0,0,1,FALSE,FALSE,FALSE
363,2021-11-13T04:23:05Z,0.8999999761581421,1.7777777777777777,864,6,3,3,3,2,2,2,3,3,4,4,3,5,2,2,2,2,4,5,5,1,4,5,4,4,3,2,0,0,4,2,3,3,3,3,2,2,1,3,4,5,2,3,2,3,2,5,5,5,5,1,5,5,2,4,2,3,2,1,1,4,1,1,1,3,3,2,3,2,3,4,0,2.5,0,3.3333333333333335,0,3.4444444444444446,0,3.5,0,3.6666666666666665,0,1.4285714285714286,0,2.3333333333333335,0,3.081081081081081,0,2,0,0,1.7605009532655516,1.6179608610166674,0.13935139661846652,0.8786561288175669,4,2,3,4,2,2,2,2.4285714285714284,0,2,0.32054096227918905,2,3,4,4,1,2,3,2.7142857142857144,0,3.2857142857142856,-0.7395711320441822,0,1,1,2,2,3,1,4,3,1,3,1,5,2,5,4,2,5,4,4,2,1.8,0,4.4,0,3.8,0,4.2,0,4.133333333333334,0,1,1,1,4,2,2,2,3,1,2,3,4,1,1,1,4,1,1,1,2,1.4,0,"Asian or Asian American (e.g., Chinese, Japanese, and others) & White, Caucasian, Anglo, European American",1,24,0,1,NA,5,2,0,0,1,0,0,TRUE,TRUE,TRUE,TRUE,TRUE,0,3,0.6740424999999813,0.8,0.024567845097879702,3,0.4741812500001397,0.4623548387097976,1,0.96875,0.005099315766122206,0.0044567516128844855,3,0.5798000000000466,0.6179843749998836,1,1,0.00981192774197075,0.0068713039415235575,1.0816,1.3126,0.4268,0.852,1.7495,0.5034,0.3428,1.1402500853333333,1.1542472073333334,0.4179332216666667,1.1949,4.0998,0.3285,4.6804,0.3417,-81.7938,0.7477,4.5806,0.3977,4.8292,0.3838,0.9925,1.306844095,4.62218,4.339911413333334,0.33268237266666667,0.321954092,0.9293,3.1324,0.4609,5.1182,0.5349,0.8669,0.186,0.242,0.556,0.029,1.525,52.586206896551715,390,1.1555555555555557,1,0,1,2,FALSE,FALSE,FALSE
365,2021-11-13T04:12:15Z,0.8999999761581421,1.7777777777777777,1080,3,2,4,4,3,4,5,2,4,2,2,2,2,4,2,4,4,3,3,1,1,2,3,3,2,2,2,0,0,5,3,4,5,5,4,4,4,5,3,4,2,4,5,4,5,5,3,4,4,3,4,1,1,1,3,3,2,2,2,1,4,2,2,1,3,2,2,2,2,2,2.25,0,2,0,2.2666666666666666,0,1.6666666666666667,0,3,0,1.6666666666666667,0,1.7142857142857142,0,2,0,2.189189189189189,0,1,0,0,0.11722181766637156,0.024213059553069287,-0.22054348261253207,-0.09816521152973139,4,2,2,2,1,3,4,2.5714285714285716,0,3.5,0.9594896595959068,4,5,4,4,2,2,3,3.4285714285714284,0,2.5714285714285716,1.5194825076544112,0,2,3,3,3,3,2,5,3,2,3,2,4,2,4,5,2,4,2,5,2,2.8,0,4,0,4.2,0,4,0,4.066666666666666,0,2,1,3,3,3,4,2,4,1,1,3,2,2,4,3,4,1,3,4,2,2.3,0,"White, Caucasian, Anglo, European American",0,18,0,1,NA,5,2,0,0,0,0,0,TRUE,TRUE,TRUE,TRUE,TRUE,0,4,0.959218749994412,0.6530612244897959,0.06936333341955578,4,0.5065533333301544,0.6318258064543048,0.967741935483871,1,0.01978481318121958,0.012233129977209168,4,0.7191937500108033,0.7185,1,1,0.024262177378159635,0.01051601096832014,1.7941,0.3932,0.2911,1.1657,0.3911,0.67490000000000006,0.3213,1.7266064766666667,0.5122647912666667,0.294773455,1.359,3.2508,0.3247,3.8549,0.4556,-56.8552,2.1084,5.4298,0.2984,7.9751,0.4869,0.9848,1.5517467333333332,4.005765506666667,3.5850328233333335,0.438760905,0.310573305,1.142,2.7712,0.5336,5.0076,0.6151,0.9782,0.16,0.348,0.434,0.064,1.054,16.46875,282,0.8355555555555556,1,0,4,5,FALSE,FALSE,FALSE
366,2021-11-13T03:19:09Z,1,1.6,900,6,2,3,3,3,2,4,2,3,2,2,3,3,3,2,3,3,2,3,1,1,2,2,1,2,0,2,0,1,4,3,3,3,2,5,5,5,5,2,3,2,3,3,3,3,4,3,3,3,4,3,2,4,1,1,1,1,1,2,1,1,4,2,2,3,2,2,2,1,1,1.75,0,1.5,0,2.8666666666666667,0,2.111111111111111,0,3,0,1.8333333333333333,0,2.142857142857143,0,2.3333333333333335,0,2.4324324324324325,0,0,0,1,-0.04248305996219344,0.1717213584374688,-0.40398871494434996,-0.11613367825344058,4,2,4,1,1,3,2,1.8571428571428572,0,2.5,0.1631660590458031,3,4,4,3,1,1,3,2.7142857142857144,0,3.2857142857142856,-1.0219528370065065,0,2,3,3,2,2,3,3,4,3,5,3,3,2,3,3,1,3,3,5,3,2.4,0,3,0,4.4,0,2.8,0,3.4,0,1,2,3,2,2,2,2,2,2,2,2,2,2,2,2,2,2,2,2,2,2.2,0,Other & multiple,1,25,0,1,NA,5,3,0,0,1,1,0,TRUE,TRUE,TRUE,TRUE,TRUE,0,NA,NA,NA,NA,NA,NA,NA,NA,NA,NA,NA,6,0.6549687500000219,0.7429333333333256,1,0.967741935483871,0.006665644153220522,0.013368122580643725,NA,NA,NA,NA,NA,NA,NA,NA,NA,NA,NA,NA,NA,NA,NA,NA,NA,NA,NA,NA,NA,NA,NA,NA,NA,NA,NA,0.8961,4.778,0.5706,4.4557,0.6355,0.9362,0.071,0.493,0.432,0.015,1.575,105,104,0.3081481481481481,1,0,2,4,FALSE,FALSE,FALSE
367,2021-11-13T04:34:29Z,0.8999999761581421,1.7777777777777777,1080,3,3,1,3,5,2,5,1,1,5,4,2,4,1,2,1,1,5,5,5,5,5,5,5,4,7,3,4,11,5,1,3,1,1,1,1,1,3,2,4,5,3,2,1,3,1,5,5,5,1,1,3,3,2,4,3,1,4,4,2,5,1,4,1,1,5,2,3,5,2,4.875,0,3,0,4,0,4.111111111111111,0,3.0833333333333335,0,3.1666666666666665,0,2.2857142857142856,0,2.3333333333333335,0,3.189189189189189,0,4,4,6,2.3720025241854517,2.3269492398409626,2.587569461413161,2.4572593506270617,4,1,2,1,1,1,2,1.7142857142857142,0,3,0.2621927112778498,5,5,5,5,3,1,1,4.142857142857143,0,1.8571428571428572,1.237100802692087,0,4,4,5,2,2,2,5,1,1,1,1,5,1,2,5,1,1,1,2,1,3.4,0,4,0,3.6,0,4.4,0,4,0,2,4,3,1,4,4,2,1,1,1,4,3,2,1,2,3,2,2,2,3,2.55,0,"Hispanic of Latino (e.g., Mexican American, Central American, and others) & Native American/Alaskan Native/indigenous",1,22,0,1,NA,5,2,0,0,1,0,0,TRUE,TRUE,TRUE,TRUE,TRUE,0,NA,NA,NA,NA,1,0.5343448275862069,0.60090625,0.9666666666666667,1,0.010733040229885056,0.012381442540322581,1,0.714375,0.76175,1,1,0.01438282258064516,0.018131548387096765,NA,NA,NA,NA,NA,NA,NA,NA,NA,NA,1.917,3.2324,0.2501,3.9817,0.3602,-43.8255,1.0595,3.9495,0.3987,3.552,0.4577,0.9976,1.8496608066666667,3.8457696566666666,3.3109105,0.36039003033333333,0.255606397,1.1922,3.2435,0.5467,2.7876,0.5741,0.9537,0.082,0.51,0.388,0.022,1.225,55.68181818181819,294,0.8711111111111112,1,0,0,1,FALSE,FALSE,FALSE
368,2021-11-13T04:41:40Z,1,1.7777777777777777,1080,3,2,5,5,1,5,1,1,4,1,1,1,1,4,1,5,4,1,1,1,1,1,1,1,1,1,2,0,0,5,5,5,5,5,5,5,5,5,1,5,1,1,5,1,4,1,1,1,1,1,5,1,1,1,1,1,1,3,2,1,5,1,1,1,1,1,2,1,1,2,1,0,1.5,0,1.2,0,1,0,1.0833333333333333,0,0.8333333333333334,0,1.2857142857142858,0,1,0,1.1081081081081081,0,1,0,0,-1.3327303608034937,-1.4359642350467026,-0.3773458880470143,-0.9066550615468585,5,1,3,1,1,1,1,1.2857142857142858,0,1,-0.7321841937363471,5,5,5,5,3,3,1,4.428571428571429,0,1.5714285714285714,0.38995568780511447,0,1,1,1,1,1,1,4,1,1,4,1,4,1,4,4,1,4,4,4,1,1,0,4,0,4.4,0,4.6,0,4.333333333333333,0,1,1,1,4,1,1,1,4,1,1,1,4,1,1,1,4,1,1,1,1,1,0,Black or African American,0,24,0,1,NA,5,2,0,0,1,0,0,TRUE,TRUE,TRUE,TRUE,TRUE,0,4,0.7471951219512195,0.8367346938775511,0.03731618962585035,4,0.4255,0.4940322580645161,1,0.96875,0.0031169032258064524,0.003274337701612903,4,0.5443125,0.6341379310344828,1,0.90625,0.005536028225806451,0.010570641129032258,1.2812,1.3292,0.4307,1.148,1.1918,0.4861,0.1504,1.31386979,1.1743830323333333,0.4230260083333333,1.1231,5.4785,0.323,4.2737,0.3735,-93.2934,0.5703,4.5185,0.3721,4.0105,0.4426,0.9926,1.2168530406666667,4.29148505,5.392886466666667,0.36573264866666666,0.31609343666666667,0.5677,4.325,0.5033,3.5583,0.5813,0.9505,0.066,0.389,0.448,0.014,1.8,128.57142857142858,558,1.6533333333333333,1,0,0,1,FALSE,FALSE,FALSE
370,2021-11-13T04:03:55Z,1,1.7777777777777777,864,7,4,2,3,3,3,3,3,3,3,2,2,3,3,3,3,3,2,3,1,2,2,3,3,3,6,2,0,0,4,4,4,4,3,3,3,3,3,3,4,3,1,4,2,3,3,3,4,4,4,3,1,1,1,3,3,1,2,3,1,3,3,4,1,1,2,1,2,1,2,2.375,0,1.5,0,2.933333333333333,0,2.5555555555555554,0,2.8333333333333335,0,1.8333333333333333,0,2.2857142857142856,0,1.3333333333333333,0,2.4324324324324325,0,3,0,0,0.3462722342652341,0.46896413132066517,0.028839059546018453,0.2489015954333418,5,1,5,2,1,2,2,1.4285714285714286,0,2,-0.2777293338068208,5,5,5,5,4,3,1,4.571428571428571,0,1.4285714285714286,-1.3043345419688306,0,3,3,3,3,3,3,4,4,3,3,2,3,3,2,3,3,3,3,2,4,3,0,3.2,0,3,0,2.4,0,2.8666666666666667,0,2,2,1,2,3,2,4,3,4,3,2,3,3,3,2,4,1,3,2,3,2.4,0,"Asian or Asian American (e.g., Chinese, Japanese, and others)",0,25,0,1,NA,5,2,1,1,1,0,2,TRUE,TRUE,TRUE,TRUE,TRUE,0,5,1.170075,0.8,0.11399012897959185,NA,NA,NA,NA,NA,NA,NA,5,0.9231,1.14359375,1,1,0.08787967931034484,0.20093211995967739,1.7069,0.8442,0.5791,1.1466,1.1057,0.8903,0.5484,1.6809917266666667,0.84423605,0.5708347436666666,NA,NA,NA,NA,NA,NA,NA,NA,NA,NA,NA,NA,NA,NA,NA,NA,NA,1.7327,1.7285,0.5066,1.3613,0.6695,0.6876,0.2,0.18,0.249,0.015,2.006,133.73333333333332,383,1.1348148148148147,1,1,14,15,FALSE,FALSE,FALSE
371,2021-11-13T04:41:31Z,1,1.6,900,6,3,4,5,3,4,2,1,5,2,1,1,1,5,1,5,3,2,1,1,1,1,1,1,1,2,2,0,0,5,4,5,5,5,5,5,5,5,1,5,1,1,5,1,5,1,1,2,1,2,5,1,1,1,1,1,1,3,3,1,5,1,1,1,1,1,2,1,1,2,1.125,0,1.5,0,1.5333333333333334,0,1.1111111111111112,0,1.1666666666666667,0,0.8333333333333334,0,1.4285714285714286,0,1,0,1.1891891891891893,0,1,0,0,-1.2045461827068822,-1.2041516524823082,-0.3773458880470143,-0.7907487702646612,4,2,3,2,1,1,3,2,0,1,-0.3048482679606258,4,5,5,5,3,3,2,4.142857142857143,0,1.8571428571428572,-0.1748077221195339,0,1,1,2,2,2,2,4,2,1,2,1,4,2,5,5,3,4,1,3,5,1.6,0,4.4,0,3.2,0,4,0,3.8666666666666667,0,2,1,2,2,4,1,3,2,2,2,1,3,3,4,1,2,1,3,1,3,2.25,0,"White, Caucasian, Anglo, European American",0,24,0,1,NA,5,2,0,0,1,0,0,TRUE,TRUE,TRUE,TRUE,TRUE,0,5,0.9260125000089406,0.8,0.14152547857594866,5,0.5819968750067055,0.6779781249761582,1,1,0.007302947410378193,0.0067639624074519065,5,0.7791250000074506,0.7813781250081956,1,1,0.0052008412890774975,0.0017532991841419895,1.3646,1.005,0.5728,1.1222,0.92,0.6123,0.0042,1.40955153,0.9806258293333333,0.5603055806666667,10,8.8938,0.0197,9.038,0.1247,-69.4394,0.8756,3.6661,0.4751,4.8484,0.5901,0.9533,2.39225881,4.637353743333334,4.5576176366666665,0.42375007566666667,0.31947130566666665,0.9257,4.8339,0.6885,7.4775,0.7247,0.9344,0.119,0.609,0.703,0.229,1.448,6.323144104803493,104,0.3081481481481481,1,0,0,1,FALSE,FALSE,FALSE
372,2021-11-13T04:38:23Z,0.8999999761581421,1.6,1200,6,3,5,4,2,4,2,1,4,1,2,1,1,5,1,5,4,1,1,1,1,1,1,1,1,0,2,0,0,5,2,5,3,4,5,4,4,5,2,5,1,2,2,2,3,2,1,1,1,1,5,1,1,1,2,1,1,1,1,1,3,3,2,1,1,1,1,1,1,1,1,0,1,0,1.4666666666666666,0,1.8888888888888888,0,1.75,0,1,0,1.5714285714285714,0,1,0,1.6216216216216217,0,0,0,0,-1.0133206055463637,-1.1006829047740254,-0.7372407672780129,-0.9189618360260192,4,2,3,1,1,2,3,2,0,2,0.06413940681375631,5,5,5,5,3,2,2,4.142857142857143,0,1.8571428571428572,-0.1748077221195339,0,2,2,1,3,2,2,4,2,2,1,1,3,2,2,4,3,5,1,3,1,2,0,4.4,0,3,0,3.8,0,3.7333333333333334,0,1,3,4,1,2,4,2,1,4,3,3,2,4,3,1,1,1,3,2,3,2.9,0,"White, Caucasian, Anglo, European American",0,28,0,1,NA,5,2,0,0,0,0,0,TRUE,TRUE,TRUE,TRUE,TRUE,0,2,1.0409473684210526,0.76,0.13588492081632653,2,0.51553125,0.6131666666666666,1,0.9375,0.0015842570564516135,0.006750176411290321,2,0.62690625,0.6952258064516129,1,0.96875,0.006948926411290324,0.0075667701612903236,1.4983,0.7779,0.6064,1.3279,0.6221,0.6551,0.0378,1.5299878566666667,0.8217501866666667,0.593020173,1.4503,5.2915,0.3785,3.4673,0.4248,-72.7432,0.7357,8.1527,0.4762,4.2748,0.5322,0.9013,1.56213903,3.516421116666667,5.2855218,0.4111627273333333,0.3705885686666667,0.9032,4.3719,0.5315,4.9852,0.5958,0.98,0.067,0.479,0.461,0.021,1.865,88.80952380952381,244,0.7229629629629629,1,0,0,1,FALSE,FALSE,FALSE
373,2021-11-13T04:49:40Z,1,1.6,900,6,3,1,2,1,2,2,2,1,2,1,1,1,1,2,1,2,2,1,1,1,1,1,1,2,1,2,0,0,2,1,2,2,2,1,2,1,1,1,2,2,1,1,2,2,1,2,1,1,2,1,1,1,1,1,1,2,1,2,1,2,1,1,1,2,2,1,1,2,1,1.25,0,1.25,0,2.933333333333333,0,4.444444444444445,0,2.1666666666666665,0,1.5,0,1.5714285714285714,0,1.6666666666666667,0,2.5135135135135136,0,1,0,0,-0.3030541760930097,0.020341450658465283,-0.4557470907642554,-0.21770282005289507,1,2,2,2,1,2,1,2.4285714285714284,0,1.5,0.13604712489199797,2,1,2,3,3,2,2,2.4285714285714284,0,3.5714285714285716,0.10757398284279028,0,1,2,1,1,2,1,2,2,1,1,1,1,2,1,2,1,1,1,1,1,1.4,0,3.4,0,2.6,0,3.4,0,3.1333333333333333,0,1,2,1,2,2,2,1,1,2,2,1,1,1,2,1,1,2,1,2,2,2,0,"White, Caucasian, Anglo, European American",0,23,0,1,NA,5,2,0,0,1,0,0,TRUE,TRUE,TRUE,TRUE,TRUE,0,NA,NA,NA,NA,1,0.5095903225781456,0.601262068964284,1,0.9354838709677419,0.01380876290303995,0.03341910000023842,NA,NA,NA,NA,NA,NA,NA,NA,NA,NA,NA,NA,NA,NA,NA,NA,NA,1.3274,3.546,0.3224,2.2663,0.3329,-39.8023,1.1226,4.1045,0.3685,3.6477,0.4219,0.9641,1.4350704833333334,2.51500931,3.7891942933333334,0.325578834,0.31424404466666667,NA,NA,NA,NA,NA,NA,NA,NA,NA,NA,NA,NA,104,0.3081481481481481,1,1,6,7,FALSE,TRUE,TRUE
374,2021-11-13T04:35:14Z,1,1.7786458333333333,768,4,1,2,4,5,4,2,3,2,4,3,3,3,2,2,2,4,4,4,4,2,3,4,4,4,1,2,1,1,4,3,3,4,4,2,2,4,1,3,3,5,2,3,2,4,1,5,5,5,5,2,2,1,5,4,3,2,4,4,1,4,1,1,2,2,4,3,5,2,2,3.625,0,3,0,3.1333333333333333,0,3,0,3.4166666666666665,0,3,0,2,0,2.6666666666666665,0,2.972972972972973,0,1,1,1,1.4600036177275941,1.3243961165833447,0.47614418274863685,0.9002701496659907,5,2,4,2,1,1,2,1.5714285714285714,0,2,-0.19226214865167657,4,4,5,4,4,4,1,4.285714285714286,0,1.7142857142857142,-0.1748077221195339,0,1,1,1,2,3,2,5,4,2,3,1,4,3,5,4,4,4,1,3,3,1.6,0,4.4,0,3.2,0,3.6,0,3.7333333333333334,0,3,3,2,2,3,4,3,2,4,3,3,2,2,4,2,1,1,4,2,2,2.9,0,"White, Caucasian, Anglo, European American",0,24,0,1,NA,5,2,1,0,1,0,1,TRUE,TRUE,TRUE,TRUE,TRUE,0,5,1.1542694444447341,0.72,0.16579419100342818,5,0.45021612903211383,0.5058793103450845,1,0.90625,0.00165244139787013,0.006045568387033584,5,0.5653687500003726,0.630922580644969,1,0.96875,0.00656348350797073,0.010892509828737532,1.6161,0.6039,0.585,1.3237,0.6202,0.7337,0.334,1.62327867,0.6814915196666667,0.572732531,1.0931,5.1188,0.3434,2.8067,0.338,-74.2191,1.0748,10.4854,0.4007,5.3348,0.3993,0.8922,1.17808571,3.02762538,5.166156926666667,0.331857387,0.33838529966666664,0.9709,3.2728,0.446,3.5581,0.5063,0.9215,0.081,0.397,0.516,0.009,1.143,127.00000000000001,373,1.1051851851851853,1,0,0,1,FALSE,FALSE,FALSE
375,2021-11-13T04:52:30Z,1,1.7777777777777777,1440,3,3,2,3,3,2,2,4,2,4,3,3,1,2,4,2,3,1,3,1,5,3,2,3,3,1,3,0,0,4,2,2,4,3,2,3,3,4,1,4,2,1,3,1,5,4,2,1,4,4,3,1,1,1,4,3,2,1,3,1,3,3,2,1,4,1,2,1,1,1,2.625,0,1.25,0,3.3333333333333335,0,3,0,2.1666666666666665,0,2,0,2,0,2,0,2.3513513513513513,0,1,0,0,0.4513412327050791,0.7134562330148865,-0.4557470907642554,0.12885457112531554,1,5,1,3,3,5,4,4.285714285714286,0,4,2.169589718844829,2,2,4,3,1,1,5,2,0,4,0.10757398284279028,0,3,3,2,3,2,2,4,2,1,2,3,2,3,2,3,4,1,4,2,5,2.6,0,2.4,0,2.6,0,3,0,2.6666666666666665,0,1,1,2,3,1,1,1,2,2,3,2,3,1,1,2,3,1,1,1,2,1.6,0,"White, Caucasian, Anglo, European American",0,29,0,1,NA,5,2,0,1,1,0,1,TRUE,TRUE,TRUE,TRUE,TRUE,0,1,1.1167324324330767,0.74,0.08645007412404411,1,0.45191874999925497,0.4960193548394788,1,0.96875,0.0033370486697503338,0.0045561864420647115,1,0.5881968750022352,0.6643709677438582,1,0.96875,0.008210334506563693,0.010903786934265263,1.546,0.698,0.5865,1.2778,0.912,0.7476,0.7419,1.5654046933333334,0.754303776,0.5749721186666666,1.3324,5.3545,0.3275,4.1274,0.3413,-83.6315,0.941,5.3299,0.3631,5.3979,0.4107,0.9944,1.3932840796666666,4.1172876333333335,5.22625885,0.3361354813333333,0.32142627966666665,1.0859,3.5942,0.4475,3.0472,0.5167,0.8769,0.073,0.414,0.389,0.02,1.681,84.05,392,1.1614814814814816,1,0,1,2,FALSE,FALSE,FALSE
376,2021-11-13T04:49:33Z,1,1.7777777777777777,864,5,4,4,5,2,5,2,1,4,2,1,1,1,3,2,4,2,1,2,1,1,2,1,1,1,0,2,0,0,4,4,3,4,4,5,4,5,4,3,4,2,1,4,2,4,3,1,1,3,3,4,1,1,1,1,1,1,1,1,1,5,1,1,1,1,1,1,1,1,1,1.25,0,1,0,1.8,0,1.8888888888888888,0,2.0833333333333335,0,1,0,0.8571428571428571,0,1,0,1.5945945945945945,0,0,0,0,-0.8746295276057681,-0.861611055532249,-0.7372407672780129,-0.799425911405131,5,1,3,1,1,1,1,1.2857142857142858,0,1,-0.7321841937363471,5,5,5,5,3,3,1,4.428571428571429,0,1.5714285714285714,-0.7395711320441822,0,2,3,2,3,2,2,5,2,2,3,3,4,2,4,5,3,4,3,5,3,2.4,0,3.6,0,4,0,4,0,3.8666666666666667,0,1,1,3,2,1,3,3,1,2,1,1,2,2,3,1,1,3,4,3,3,2.45,0,"White, Caucasian, Anglo, European American",0,21,0,1,NA,5,2,0,0,1,0,0,TRUE,TRUE,TRUE,TRUE,TRUE,0,3,0.8183562500006519,0.64,0.06689531105654165,3,0.4381218749997206,0.480113333333532,1,0.967741935483871,0.0035481443447771704,0.0058581012257902165,3,0.6066531250006519,0.7102312500025145,1,1,0.00889824902214695,0.01510519576586315,1.4735,0.4188,0.3947,1.3268,0.2081,0.4952,0.1954,1.48992198,0.574148809708,0.38974057766666664,1.8329,5.2465,0.2712,5.1304,0.3066,-77.4577,1.1729,6.212,0.3471,4.6384,0.3511,0.9994,1.60918087,4.559316143333334,4.04961469,0.3157771543333333,0.23565988933333334,1.184,3.5987,0.459,3.1674,0.5315,0.828,0.177,0.299,0.578,0.011,1.394,126.72727272727272,366,1.0844444444444443,1,0,1,2,FALSE,FALSE,FALSE
377,2021-11-13T04:48:05Z,0.8999999761581421,1.7777777777777777,900,8,4,5,5,1,5,1,1,5,1,1,1,1,4,1,4,4,1,1,1,1,1,1,1,1,2,2,0,0,5,5,5,5,3,5,5,5,4,2,4,1,1,5,1,4,1,1,1,1,1,5,1,1,1,1,1,1,2,2,1,5,1,2,1,1,1,1,1,1,1,1,0,1,0,1.2,0,1.3333333333333333,0,1.25,0,0.8333333333333334,0,1.2857142857142858,0,1,0,1.2432432432432432,0,1,0,0,-1.2486751620516177,-1.3778901016276477,-0.5341482934814965,-0.9560191975545721,5,1,4,1,1,1,1,1.1428571428571428,0,1,-0.8176513788914915,5,5,5,4,4,3,2,4.285714285714286,0,1.7142857142857142,-1.869097951893479,0,1,3,1,1,1,1,4,1,1,3,1,4,2,4,4,4,4,1,3,3,1.4,0,4.6,0,3.2,0,4.2,0,4,0,2,2,2,3,2,2,2,2,1,1,3,3,3,2,1,2,1,2,2,2,2,0,"Asian or Asian American (e.g., Chinese, Japanese, and others)",0,26,0,1,NA,5,2,0,0,1,0,0,TRUE,TRUE,TRUE,TRUE,TRUE,0,5,0.9158648648648648,0.74,0.06356129346938777,5,0.4293125,0.5213225806451613,1,0.96875,0.0018884798387096779,0.0036815483870967737,5,0.5753125,0.6681612903225806,1,0.96875,0.007360286290322582,0.018401773185483875,1.5166,0.7236,0.4486,1.1123,0.7698,0.6726,0.4006,1.52722674,0.78171913,0.442608034,1.39,6.9274,0.329,4.0212,0.358,-91.8294,0.732,6.5485,0.3729,4.83,0.4528,0.993,1.3783144956666666,3.9044019233333334,6.1714065,0.355684711,0.32366407933333335,0.8892,4.0525,0.4799,2.9082,0.5352,0.9537,0.08,0.388,0.437,0.01,1.366,136.6,330,0.9777777777777777,1,0,0,1,FALSE,FALSE,FALSE
378,2021-11-13T04:44:14Z,1,1.7777777777777777,864,4,2,3,4,3,3,2,2,4,2,3,2,2,2,2,3,3,3,4,4,1,2,4,2,3,1,2,0,0,4,3,2,3,3,4,3,3,3,1,5,3,1,3,3,1,2,3,4,4,5,2,1,1,2,2,1,1,2,1,1,4,2,2,2,3,2,2,2,2,1,2.875,0,1.75,0,2.533333333333333,0,2.888888888888889,0,2.9166666666666665,0,1.6666666666666667,0,1.4285714285714286,0,2.3333333333333335,0,2.4324324324324325,0,1,0,0,0.6572764696471762,0.5119389900507657,-0.2989446853297732,0.10649715236049626,4,2,3,1,1,3,2,2,0,1,-0.3048482679606258,4,4,4,4,2,2,3,3.2857142857142856,0,2.7142857142857144,0.38995568780511447,0,2,3,3,3,3,2,3,2,2,2,2,4,2,4,5,3,4,2,2,2,2.8,0,4,0,2.8,0,4.2,0,3.6666666666666665,0,1,1,1,3,1,1,2,2,1,1,2,3,1,1,1,3,1,2,2,2,1.5,0,"White, Caucasian, Anglo, European American",0,21,0,1,NA,5,2,0,0,0,0,0,TRUE,TRUE,TRUE,TRUE,TRUE,0,4,0.8916309523752758,0.84,0.06738224393230956,4,0.420125,0.5355624999925495,1,1,0.0035665148391166813,0.004769089516445323,4,0.5426312500014902,0.6663483870644723,1,0.96875,0.009378071241346694,0.013072897051102131,1.5199,1.1374,0.4634,1.3028,0.983,0.56,0.3012,1.5187764833333333,1.0543956866666666,0.456979048,1.3821,6.2013,0.3087,5.2462,0.4038,-99.1181,0.791,5.5457,0.3448,4.3778,0.4497,0.9928,1.3843817583333333,4.85532911,5.744576406666667,0.39811301266666665,0.3040344996666667,1.0999,3.2754,0.4023,3.7011,0.521,0.9389,0.085,0.363,0.455,0.016,2.001,125.06249999999999,388,1.1496296296296296,1,0,1,2,FALSE,FALSE,FALSE
379,2021-11-13T04:53:12Z,1,1.7777777777777777,864,6,3,4,5,2,4,2,1,3,2,2,2,2,4,3,3,3,2,4,1,1,1,3,1,1,1,2,0,0,5,3,2,3,3,4,3,3,4,2,5,4,1,3,3,4,4,4,4,4,3,2,1,1,1,1,1,1,2,1,1,3,3,2,1,1,1,2,1,1,1,1.75,0,1.25,0,2.1333333333333333,0,2.6666666666666665,0,2.9166666666666665,0,1.3333333333333333,0,1.7142857142857142,0,1,0,2.27027027027027,0,1,0,0,-0.143349298464445,-0.21311656568613527,-0.4557470907642554,-0.33443182822519535,4,2,4,1,1,2,1,1.5714285714285714,0,1,-0.5612498234260587,5,5,5,5,3,4,2,4.428571428571429,0,1.5714285714285714,0.10757398284279028,0,2,3,3,2,2,1,5,2,2,4,3,4,2,4,4,2,5,2,4,2,2.4,0,4.2,0,4.2,0,4,0,4.133333333333334,0,1,1,2,3,2,2,1,1,2,2,1,3,4,3,1,4,1,2,2,1,1.85,0,"White, Caucasian, Anglo, European American",0,30,0,1,NA,5,2,0,0,1,0,0,TRUE,TRUE,TRUE,TRUE,TRUE,0,1,0.9425088235069724,0.6938775510204082,0.04127507795380456,1,0.4783062500655651,0.5632906249910593,1,1,0.0023660960929056136,0.005120999577424275,1,0.6704624999761581,0.7851062500029802,1,1,0.0066649101651579355,0.019333574165954555,1.3366,0.6585,0.5808,1.0112,0.489,0.7427,0.2875,1.3875987966666667,0.7573664286666667,0.570057984,2.9373,9.5596,0.3247,6.166,0.3251,-96.6711,0.8594,6.8062,0.4138,4.6255,0.4793,0.9988,1.7034267299999999,4.382495826666666,6.678656073333333,0.372269656,0.35827282666666666,1.2772,4.7746,0.544,5.3608,0.6365,0.8655,0.436,0.183,0.9,0.011,1.313,119.36363636363636,376,1.114074074074074,1,0,0,1,FALSE,FALSE,FALSE
380,2021-11-13T04:58:44Z,1,1.7777777777777777,1080,7,2,3,3,3,3,2,1,2,2,2,2,2,3,2,3,3,3,2,1,1,1,1,2,1,3,2,1,2,4,4,3,3,2,3,3,3,2,1,4,3,3,3,2,4,3,2,2,3,3,4,2,1,1,2,1,2,3,3,3,4,1,2,2,2,2,2,2,2,1,1.5,0,1.75,0,2.533333333333333,0,3,0,2.4166666666666665,0,1.3333333333333333,0,2.142857142857143,0,2,0,2.3513513513513513,0,2,1,2,-0.24841829690429024,-0.11380979753955131,0.4636802898581284,0.17493524615928857,3,2,2,3,2,3,3,2.857142857142857,0,2.5,0.7614363551318132,3,3,3,3,1,1,3,2.4285714285714284,0,3.5714285714285716,0.9547190977297628,0,1,1,2,3,2,1,2,2,1,2,1,3,2,2,4,2,4,2,3,2,1.8,0,4.2,0,3,0,3.8,0,3.6666666666666665,0,2,2,3,3,2,2,3,2,2,1,3,2,3,1,2,2,1,2,2,2,2.2,0,"White, Caucasian, Anglo, European American",0,25,0,1,NA,5,2,0,0,1,0,0,TRUE,TRUE,TRUE,TRUE,TRUE,0,4,1.058110256415147,0.7959183673469388,0.15869713456317064,4,0.5246548386850665,0.6333838709092909,0.96875,1,0.004584185439791447,0.00888904606916557,4,1.0098968750834465,1.0587093750089407,1,1,0.17764869062985938,0.10444602088562302,1.4053,0.9558,0.646,1.2492,1.0824,0.67,0.253,1.45326094,0.940355461,0.630087382,1.217,3.4968,0.3572,4.7151,0.5043,-73.5881,0.9877,5.2386,0.436,5.0088,0.5204,0.8087,1.5125189393333334,4.69523896,4.022373936666667,0.476235358,0.34021465966666664,1.9419,1.7317,0.4894,1.7718,0.5785,0.8165,0.209,0.227,0.278,0.022,1.724,78.36363636363637,104,0.3081481481481481,1,0,1,2,FALSE,FALSE,FALSE
381,2021-11-13T05:08:57Z,1,1.7777777777777777,720,6,3,4,4,2,4,2,2,4,2,2,2,1,5,2,4,4,2,1,1,1,2,1,2,2,3,2,1,3,4,4,5,4,4,4,4,5,4,2,4,4,4,3,3,2,3,5,2,2,3,4,4,3,2,2,2,4,3,3,2,3,4,2,3,3,2,3,3,2,4,1.5,0,3,0,1.8666666666666667,0,1.7777777777777777,0,3.0833333333333335,0,2.3333333333333335,0,2.857142857142857,0,2.6666666666666665,0,2.6216216216216215,0,2,1,3,-0.08030789940053812,-0.2841605889021127,1.0321359503435148,0.37398768072070104,3,2,4,2,2,3,3,2.4285714285714284,0,1,-0.048446712495193056,3,4,3,3,4,3,3,3.2857142857142856,0,2.7142857142857144,0.38995568780511447,0,3,2,2,3,2,2,2,1,3,4,3,3,3,2,3,3,3,2,2,3,2.4,0,3.4,0,2.8,0,3.2,0,3.1333333333333333,0,2,3,3,2,2,1,1,3,2,2,2,3,1,1,1,3,2,2,2,1,1.85,0,"Asian or Asian American (e.g., Chinese, Japanese, and others)",0,27,0,1,NA,5,2,0,0,1,0,0,TRUE,TRUE,TRUE,TRUE,TRUE,0,6,0.6614451612907071,0.6326530612244898,0.03569860147862422,6,0.446868965517858,0.5515689655203244,0.90625,0.9354838709677419,0.0012688640222404957,0.011617231613029768,6,0.584534375000745,0.6309222222235468,1,0.84375,0.00786263845831985,0.009041415474200395,1.4064,0.4109,0.2124,0.9702,0.4842,0.45,0.3983,1.4257434833333333,0.5777524463,0.21077118,1.0241,3.6165,0.3291,2.4746,0.3631,-57.0743,0.8626,6.7711,0.3835,6.4165,0.4618,0.8621,1.120474564,2.7519110633333335,3.924502363333333,0.3564658926666667,0.3233065943333333,0.9293,3.9431,0.4785,2.5274,0.4788,0.9908,0.051,0.439,0.339,0.018,1.646,91.44444444444444,362,1.0725925925925925,1,0,0,1,FALSE,FALSE,FALSE
382,2021-11-13T04:51:25Z,1,1.7777777777777777,1080,5,4,3,4,2,4,3,2,4,2,2,2,2,4,2,3,2,2,2,3,2,1,2,2,2,5,2,2,2,3,4,5,4,3,3,4,4,3,3,3,3,1,3,2,4,2,2,3,3,4,3,1,3,1,2,1,2,4,3,1,3,2,2,1,1,1,2,2,3,2,2,0,2.25,0,2.3333333333333335,0,2.3333333333333335,0,2.5833333333333335,0,1.6666666666666667,0,2.2857142857142856,0,1,0,2.2432432432432434,0,3,2,2,-0.004658220523848765,-0.03134452808449325,1.0302083766821508,0.49943192429882877,4,1,3,1,1,2,1,1.5714285714285714,0,3,0.17672552612270553,5,5,5,5,3,2,2,4.142857142857143,0,1.8571428571428572,-0.4571894270818581,0,3,3,3,2,2,3,4,3,2,2,2,3,2,3,3,3,3,2,4,3,2.6,0,3.4,0,3.4,0,3.2,0,3.3333333333333335,0,2,2,2,2,2,3,2,3,1,3,1,3,2,1,1,3,1,2,1,3,1.9,0,"White, Caucasian, Anglo, European American",0,20,0,1,NA,5,2,0,0,0,0,0,TRUE,TRUE,TRUE,TRUE,TRUE,0,3,0.9112657894586262,0.76,0.060868902965406646,3,0.4458419354807946,0.49272187500447034,0.96875,1,0.005075200482594408,0.004040501761975548,3,0.5111193548402478,0.6237379310501033,0.96875,0.90625,0.012221135482674261,0.012102959021157341,1.2688,0.9072,0.5575,0.9582,1.0569,0.7023,0.3952,1.3257566493333333,0.9216435456666666,0.5455093896666666,1.3223,3.7999,0.2803,5.6246,0.3752,-82.5134,0.7906,4.8356,0.3741,5.8565,0.4215,0.8557,1.3789410556666666,5.248168096666666,3.9660771833333333,0.3673263506666667,0.276938578,0.8867,2.8112,0.3932,3.5459,0.4973,0.99,0.077,0.314,0.402,0.009,1.501,166.77777777777777,104,0.3081481481481481,1,1,3,4,FALSE,FALSE,FALSE
383,2021-11-13T04:57:17Z,0.800000011920929,1.7777777777777777,1440,4,3,2,5,2,4,2,1,3,2,1,2,2,4,1,4,4,2,1,1,1,1,1,1,1,3,2,3,2,5,5,4,5,5,5,5,5,5,2,5,2,1,5,2,5,3,3,2,2,2,5,1,3,1,3,2,1,4,4,1,5,1,2,1,1,1,2,1,1,2,1.125,0,1.5,0,1.9333333333333333,0,1.1111111111111112,0,1.8333333333333333,0,1.6666666666666667,0,1.8571428571428572,0,1,0,1.6216216216216217,0,2,3,2,-0.9355695467008782,-0.8464149906209297,0.7985455023269348,-0.023934744146997478,5,1,3,1,1,1,1,1.2857142857142858,0,2,-0.3631965189619651,4,4,4,4,3,2,2,3.5714285714285716,0,2.4285714285714284,-0.7395711320441822,0,1,1,1,1,1,1,5,1,1,5,1,5,1,5,5,1,5,1,5,5,1,0,5,0,5,0,4.2,0,4.733333333333333,0,1,1,1,2,2,2,2,2,2,1,2,3,2,3,1,3,1,3,2,1,1.85,0,"Hispanic of Latino (e.g., Mexican American, Central American, and others)",0,21,0,1,NA,5,2,0,0,1,0,0,TRUE,TRUE,TRUE,TRUE,TRUE,0,3,0.9097027026986754,0.7551020408163265,0.05944145246733419,3,0.3965599999984105,0.42300800000071526,0.9375,0.8064516129032258,0.005740791844718046,0.006204156129223249,3,0.4799562499979511,0.5804769230702749,1,0.8125,0.006886205120779053,0.01376526770087017,1.471,0.8056,0.4587,1.1981,0.8229,0.6139,0.3773,1.4902991833333332,0.8403278196666667,0.45197417966666664,0.9528,3.5055,0.2891,1.6044,0.2534,-48.9989,0.6154,3.9909,0.3317,3.3963,0.3542,0.9198,1.0118498023333333,1.9361723673333333,3.78747862,0.251064262,0.285510759,0.7849,4.521,0.4058,2.3942,0.4583,0.7082,0.06,0.314,0.343,0.013,2.013,154.84615384615384,380,1.125925925925926,0,0,1,2,FALSE,FALSE,FALSE
385,2021-11-13T05:15:13Z,1,1.7777777777777777,1080,7,3,1,4,2,4,2,4,1,4,3,4,4,1,2,2,3,4,4,1,1,2,5,4,2,2,3,3,6,1,2,3,3,1,2,3,2,3,2,3,2,2,3,2,3,2,4,4,5,5,1,1,2,1,2,1,1,2,3,2,4,2,2,1,1,3,1,1,2,2,2.875,0,1.5,0,3.4,0,3.7777777777777777,0,3.0833333333333335,0,1.8333333333333333,0,1.8571428571428572,0,1.6666666666666667,0,2.7567567567567566,0,1,3,6,0.8590089466516787,1.0237656859173703,1.3012516161271415,1.162508651022256,4,3,4,2,3,2,3,2.4285714285714284,0,2.5,0.5050347996663801,5,4,3,4,3,4,2,3.857142857142857,0,2.142857142857143,-0.7395711320441822,0,2,3,2,2,3,2,3,2,3,2,3,3,2,3,2,3,2,2,3,3,2.4,0,3.2,0,3,0,3,0,3.066666666666667,0,2,3,2,3,2,3,3,2,3,3,2,2,3,4,3,2,1,3,3,4,2.75,0,"White, Caucasian, Anglo, European American",0,26,0,1,NA,5,2,0,0,1,0,0,TRUE,TRUE,TRUE,TRUE,TRUE,0,NA,NA,NA,NA,1,0.5553562500004191,0.6876724137933604,1,0.90625,0.0037686831855083553,0.00822709515125445,1,0.6268749999995343,0.7294899999996026,1,0.967741935483871,0.003640157419403104,0.00866918346246709,NA,NA,NA,NA,NA,NA,NA,NA,NA,NA,1.4628,3.4859,0.3455,2.8196,0.4695,-46.0698,0.7787,5.7855,0.493,4.1173,0.5905,0.9989,1.6849385733333333,2.9518333633333333,3.914043653333333,0.44073010733333334,0.336218433,1.0793,6.791,0.5575,4.0002,0.5964,0.8984,0.087,0.453,0.498,0.017,1.937,113.94117647058823,104,0.3081481481481481,1,0,0,1,FALSE,FALSE,FALSE
386,2021-11-13T05:05:13Z,1,1.4995014955134596,1003,6,4,3,5,1,5,1,1,5,5,1,1,1,5,3,5,3,1,3,2,1,1,1,1,1,1,2,5,30,5,5,3,5,5,5,5,5,5,2,3,1,1,3,1,5,1,1,1,1,1,3,5,1,1,3,1,1,5,5,5,5,1,1,1,1,1,4,3,2,4,1.375,0,3.25,0,1.6666666666666667,0,1.2222222222222223,0,1.4166666666666667,0,2.1666666666666665,0,2.5714285714285716,0,1,0,1.7297297297297298,0,1,5,6,-0.7128232700084064,-0.8071181603407025,2.2633264503338766,0.728104144996587,5,1,1,1,1,1,1,1.5714285714285714,0,1,-0.5612498234260587,5,5,4,4,3,5,1,4.428571428571429,0,1.5714285714285714,-0.1748077221195339,0,3,3,2,3,2,2,5,1,2,3,1,3,1,5,3,4,3,1,3,1,2.6,0,4,0,3.6,0,4.4,0,4,0,1,1,1,4,2,2,2,4,2,1,1,4,1,2,1,4,1,1,1,1,1.25,0,"Asian or Asian American (e.g., Chinese, Japanese, and others) & White, Caucasian, Anglo, European American",1,28,0,1,NA,5,2,0,0,0,0,0,TRUE,TRUE,TRUE,TRUE,TRUE,0,6,1.080965789474939,0.7755102040816326,0.10228046585675724,6,0.6184806451605213,0.6741781250014901,0.96875,1,0.0058794535384446905,0.002290326925558419,6,0.8018687499985099,1.1818312499988823,1,1,0.01266291189703509,0.0428753318935862,1.4397,0.8907,0.6637,1.2093,0.7367,0.7316,0.0426,1.4874906366666667,0.9042655743333333,0.6477212806666667,1.4177,3.9458,0.4542,4.7529,0.5324,-84.9516,0.6276,7.2921,0.5693,7.3361,0.6385,0.8163,1.91057107,5.42122481,4.040772946666666,0.504130699,0.38807976066666666,1.3633,3.6758,0.6269,2.1918,0.9239,0.9966,0.355,0.297,0.712,0.003,1.26,420,104,0.3081481481481481,1,0,0,1,FALSE,FALSE,FALSE
387,2021-11-13T05:16:03Z,1,1.7777777777777777,1080,4,3,4,4,2,4,3,2,4,2,1,2,1,4,2,4,3,3,1,1,1,1,1,2,1,2,2,0,0,5,5,5,5,5,5,5,5,2,2,4,1,1,5,1,5,3,1,1,1,2,5,1,5,1,3,1,1,2,2,1,5,1,2,1,1,1,1,1,2,2,1.375,0,1.5,0,2,0,1.3333333333333333,0,1.4166666666666667,0,1.8333333333333333,0,1.2857142857142858,0,1,0,1.4594594594594594,0,1,0,0,-0.8809336675121587,-0.780016898078477,-0.3773458880470143,-0.5786813930627457,5,1,3,1,1,1,1,1.2857142857142858,0,1,-0.7321841937363471,5,5,5,5,2,2,1,4.142857142857143,0,1.8571428571428572,-0.4571894270818581,0,3,2,2,2,2,3,4,3,2,2,4,3,2,3,4,5,3,3,2,5,2.2,0,2.8,0,2.6,0,3,0,2.8,0,1,1,3,4,2,2,3,2,1,1,3,4,2,1,1,4,1,2,1,3,1.7,0,"Hispanic of Latino (e.g., Mexican American, Central American, and others)",0,24,0,1,NA,5,2,0,0,1,0,0,TRUE,TRUE,TRUE,TRUE,TRUE,0,4,0.7435621621614775,0.74,0.06789574377568618,4,0.3636781249991618,0.42932258064492096,1,0.96875,0.0013591269254363163,0.0017928651612525723,4,0.6275843750010245,0.7153875000008848,1,1,0.024186089102635457,0.03304918241931183,1.2244,0.8724,0.4201,1.1279,1.019,0.458,0.1063,1.2740585713333332,0.898761311,0.41243265166666665,1.2682,6.2031,0.2615,5.4657,0.3185,-103.7329,0.7547,6.9588,0.3109,6.2002,0.3723,0.9266,1.201795405,4.926486286666667,5.601119723333333,0.31851799633333333,0.2603636693333333,1.4016,3.2755,0.4138,2.1626,0.4387,0.8915,0.11,0.312,0.323,0.011,1.149,104.45454545454547,312,0.9244444444444444,1,0,0,1,FALSE,FALSE,FALSE
388,2021-11-13T05:04:05Z,1,1.7777777777777777,1080,5,3,1,4,1,4,1,1,4,1,2,1,1,5,1,5,4,1,1,1,1,1,1,1,1,0,3,0,0,5,2,2,2,5,4,3,3,2,3,4,1,1,1,1,2,2,1,1,1,1,5,1,1,1,1,1,1,1,1,1,4,2,2,1,1,1,1,1,1,1,1,0,1,0,1.6,0,2.888888888888889,0,1.9166666666666667,0,0.8333333333333334,0,1.2857142857142858,0,1,0,1.837837837837838,0,0,0,0,-0.8788322875433621,-0.9504644796634032,-0.7372407672780129,-0.843852623470708,5,1,4,1,1,1,1,1.1428571428571428,0,1,-0.8176513788914915,5,5,5,5,5,3,1,4.714285714285714,0,1.2857142857142858,0.9547190977297628,0,1,3,1,1,1,1,5,2,2,1,1,3,1,3,3,1,5,1,3,3,1.4,0,4.6,0,3.8,0,3.4,0,3.933333333333333,0,1,2,2,1,1,3,1,1,3,3,1,1,1,3,1,1,1,3,1,3,2.3,0,"White, Caucasian, Anglo, European American",0,21,0,1,NA,5,2,0,0,1,0,0,TRUE,TRUE,TRUE,TRUE,TRUE,0,2,1.0293102040814655,1,0.09859358010217167,2,0.4410468749996508,0.47717741935435803,1,0.96875,0.0032872432157684856,0.003061271925413355,2,0.575545161290635,0.6538258064517811,1,0.96875,0.00419519589254329,0.010218741683451455,2.439,2.4106,0.5234,2.0204,2.3806,0.6014,0.3129,1.7019110733333334,1.5642664736666667,0.5745388023333333,1.3126,4.9508,0.3085,4.5674,0.3392,-84.8041,0.7641,7.0424,0.3872,7.4807,0.4226,0.9925,1.3610238426666668,4.470829476666666,4.918411613333333,0.334017796,0.3042722786666667,1.0492,5.3338,0.4727,4.0348,0.5261,0.8388,0.061,0.453,0.497,0.016,1.604,100.25,326,0.965925925925926,1,0,1,2,FALSE,FALSE,FALSE
389,2021-11-13T05:05:46Z,1,1.7777777777777777,1080,6,3,3,4,2,4,2,1,4,1,1,1,1,4,3,4,4,1,2,1,1,1,2,1,2,2,2,0,0,4,4,5,5,5,5,5,5,5,1,4,1,5,4,2,4,1,1,1,1,1,5,1,1,1,2,1,1,2,1,1,5,3,1,1,1,1,2,1,2,2,1.375,0,1.75,0,1.8,0,1.2222222222222223,0,1.6666666666666667,0,1,0,1.2857142857142858,0,1,0,1.3783783783783783,0,1,0,0,-0.9313667867632848,-0.9008110955901112,-0.2989446853297732,-0.5998778904599422,5,1,3,1,1,1,2,1.4285714285714286,0,2.5,-0.09323549641962975,4,4,5,5,3,3,4,3.7142857142857144,0,2.2857142857142856,-0.7395711320441822,0,2,2,2,2,2,2,4,3,2,2,1,4,2,2,3,1,3,2,3,3,2,0,4,0,3.6,0,3,0,3.533333333333333,0,1,1,1,2,1,1,2,1,1,1,1,3,2,1,1,4,1,1,1,1,1.4,0,"White, Caucasian, Anglo, European American",0,22,0,1,NA,5,2,0,0,1,0,0,TRUE,TRUE,TRUE,TRUE,TRUE,0,6,0.9160200000013624,0.7,0.06732935500430963,6,0.38051935483947874,0.4588612903241188,0.96875,0.96875,0.0013765612802592352,0.0042134138309262974,6,0.5822875000070781,0.6587000000039116,1,1,0.004372986290570565,0.005044798064375809,1.2717,0.6713,0.5656,1.1611,0.583,0.6195,0.2417,1.3322240966666667,0.766878927,0.5532620806666667,1.2337,4.614,0.2519,3.9563,0.309,-78.2964,0.6149,7.2276,0.3402,5.24,0.403,0.9856,1.2786073286666666,3.9940152933333333,4.67933312,0.30574555166666667,0.249183407,0.7902,4.7565,0.5031,4.1576,0.5803,0.9667,0.094,0.415,0.57,0.021,1.891,90.04761904761904,348,1.031111111111111,1,1,2,3,FALSE,FALSE,FALSE
390,2021-11-13T05:17:40Z,1,1.7777777777777777,864,6,3,1,1,2,3,1,4,2,3,4,1,4,2,1,4,2,3,4,5,1,2,3,3,4,2,1,1,1,1,4,1,2,1,1,4,1,2,4,1,2,5,5,2,1,4,4,4,2,3,3,5,3,2,4,2,3,1,4,5,3,1,4,4,1,4,2,3,3,4,3.125,0,3,0,3.1333333333333333,0,4.111111111111111,0,3.4166666666666665,0,3,0,2.857142857142857,0,3,0,3.4324324324324325,0,1,1,1,1.4347870581020314,1.3069738765576282,0.47614418274863685,0.8915590296531325,1,4,2,3,3,2,3,3.4285714285714284,0,2,0.9188112583651991,2,3,1,4,1,1,4,2,0,4,-0.7395711320441822,0,2,4,4,1,3,3,5,3,1,5,1,1,2,4,3,5,2,4,1,5,2.8,0,2.6,0,3.2,0,3.2,0,3,0,4,1,3,4,2,4,2,1,4,2,3,1,2,3,2,4,1,3,3,4,2.65,0,"Asian or Asian American (e.g., Chinese, Japanese, and others)",0,28,0,1,NA,5,2,0,0,1,0,0,TRUE,TRUE,TRUE,TRUE,TRUE,0,NA,NA,NA,NA,6,0.6066812500001397,0.6667843750000466,1,1,0.006226837056508379,0.006555574909363486,6,0.8616967741943174,0.9403531250008382,1,1,0.07893153432282461,0.05423691740904169,NA,NA,NA,NA,NA,NA,NA,NA,NA,NA,6.1178,7.8635,0.2177,7.9104,0.2801,-73.6188,1.0142,4.0856,0.487,4.7608,0.5621,0.9336,2.30478809,4.809957633333333,4.83739048,0.43170442233333334,0.3692672616666667,1.372,2.3921,0.5655,2.3021,0.6637,0.96,0.127,0.48,0.367,0.024,2.04,85,446,1.3214814814814815,1,0,0,1,FALSE,FALSE,FALSE
391,2021-11-13T05:25:05Z,0.8999999761581421,1.7777777777777777,1080,4,4,5,3,2,5,1,1,5,2,1,1,1,5,1,5,5,1,2,1,1,1,2,2,2,1,2,0,0,5,5,5,5,5,5,5,5,5,1,5,1,1,4,1,3,3,2,2,2,1,4,1,1,1,2,1,1,2,2,2,4,3,3,1,1,1,1,1,1,1,1.5,0,1,0,1.2666666666666666,0,1,0,1.6666666666666667,0,1.1666666666666667,0,2,0,1,0,1.4864864864864864,0,1,0,0,-0.7863715689162981,-1.0298324620027786,-0.5341482934814965,-0.7819903777421375,5,1,4,1,1,2,1,1.2857142857142858,0,1,-0.7321841937363471,5,5,5,5,3,3,1,4.428571428571429,0,1.5714285714285714,-0.1748077221195339,0,3,3,3,3,3,3,4,4,2,3,1,3,4,3,4,5,4,2,3,5,3,0,3.8,0,2.6,0,2.8,0,3.066666666666667,0,1,1,1,3,2,1,1,2,1,1,1,4,2,2,1,3,1,2,2,1,1.45,0,"Asian or Asian American (e.g., Chinese, Japanese, and others)",0,18,0,1,NA,5,2,0,0,1,0,0,TRUE,TRUE,TRUE,TRUE,TRUE,0,2,0.7696666666697233,0.78,0.031961580066280915,2,0.44071250000130385,0.5523066666672627,1,0.967741935483871,0.0019051456452254753,0.006930224924384986,2,0.6653833333333333,0.7348172413778716,1,0.90625,0.04471235178155551,0.031725883226724635,1.3594,1.0109,0.3813,1.0983,1.1429,0.5196,0.0525,1.3874318633333333,0.9814047553333334,0.37572050533333334,1.3642,5.3243,0.3126,4.3454,0.4024,-83.5166,0.8388,7.2914,0.3865,4.4362,0.4559,0.9988,1.4407030486666668,4.236886403333333,5.295476876666667,0.39226199133333334,0.30763558133333335,0.9691,3.7858,0.5321,2.7491,0.5671,0.9712,0.072,0.401,0.3,0.013,1.83,140.76923076923077,274,0.8118518518518519,1,0,0,1,FALSE,FALSE,FALSE
392,2021-11-13T05:25:51Z,1,1.6,900,6,3,5,5,1,5,1,1,5,1,1,1,1,5,1,5,4,1,1,1,1,1,1,1,1,1,2,0,0,5,5,5,5,5,5,5,5,5,1,5,1,1,5,1,5,1,1,1,1,2,5,1,1,1,1,1,1,2,2,1,5,1,1,1,1,1,2,1,1,2,1,0,1.5,0,1.0666666666666667,0,1,0,1.0833333333333333,0,0.8333333333333334,0,1.1428571428571428,0,1,0,1.0810810810810811,0,1,0,0,-1.3495414005538688,-1.5048788733706477,-0.3773458880470143,-0.9411123807088311,5,2,4,2,1,1,1,1.4285714285714286,0,1,-0.6467170085812028,5,5,5,5,3,3,1,4.428571428571429,0,1.5714285714285714,-0.7395711320441822,0,2,2,2,2,2,2,4,3,2,5,1,4,3,4,4,2,4,2,3,3,2,0,4.2,0,3.8,0,3.6,0,3.8666666666666667,0,1,1,1,4,1,1,1,4,1,1,2,4,2,1,1,4,1,1,1,2,1.15,0,"Asian or Asian American (e.g., Chinese, Japanese, and others) & White, Caucasian, Anglo, European American",1,27,0,1,NA,5,2,0,0,1,0,0,TRUE,TRUE,TRUE,TRUE,TRUE,0,2,0.8535227272727273,0.88,0.050933766938775514,2,0.42275,0.5110967741935484,1,0.96875,0.0018581935483870968,0.004645725806451612,2,0.54721875,0.6763225806451613,1,0.96875,0.0036418538306451607,0.01374317641129032,1.4883,1.4713,0.4968,0.941,1.8402,0.6829,0.3638,1.4776238966666666,1.249934807,0.489723267,1.205,6.2489,0.3263,3.8165,0.3604,-91.1278,0.7566,7.2473,0.3715,5.0139,0.4381,0.9441,1.26379845,3.8456044533333333,5.858170696666667,0.35483178433333334,0.319930478,1.1701,5.5721,0.4421,3.9597,0.5428,0.949,0.07,0.428,0.581,0.012,1.642,136.83333333333331,400,1.1851851851851851,1,0,0,1,FALSE,FALSE,FALSE
395,2021-11-13T05:31:44Z,1,1.4995014955134596,1003,4,4,5,5,1,5,1,1,5,1,1,1,1,5,3,5,4,1,1,1,1,1,1,1,1,0,2,0,0,5,5,4,5,5,5,5,5,5,2,5,2,1,5,2,5,1,1,1,1,1,5,1,1,1,3,1,1,1,1,1,4,1,2,1,1,1,1,1,1,1,1,0,1,0,1.2,0,1.1111111111111112,0,1.25,0,1.1666666666666667,0,1.1428571428571428,0,1,0,1.2162162162162162,0,0,0,0,-1.2654862018019926,-1.3895049283114589,-0.7372407672780129,-1.063372847794736,4,3,3,3,2,3,2,2.5714285714285716,0,1,0.03702047265995151,5,5,5,5,4,4,2,4.571428571428571,0,1.4285714285714286,1.5194825076544112,0,1,1,1,1,1,1,3,2,2,1,1,1,3,5,4,2,2,1,1,5,1,0,3.6,0,2.4,0,3.6,0,3.2,0,1,1,1,4,1,1,3,3,1,1,1,3,2,1,1,3,1,1,1,1,1.3,0,Other & Indo-Caribbean,1,20,0,1,NA,5,2,0,0,1,0,0,TRUE,TRUE,TRUE,TRUE,TRUE,0,NA,NA,NA,NA,4,0.4689310344837863,0.586131250000326,0.9354838709677419,1,0.0034852344730692845,0.00726943318537662,4,0.6375593750008848,0.6912800000001986,1,0.967741935483871,0.011124307006188092,0.0058501418493306385,NA,NA,NA,NA,NA,NA,NA,NA,NA,NA,1.77,3.4214,0.2343,3.7869,0.3524,-47.7633,0.9009,5.5891,0.385,4.6276,0.496,0.9095,1.75644781,3.7220528766666665,3.5750512733333335,0.35009593433333336,0.23746791833333333,1.0765,4.0254,0.5037,5.1558,0.5943,0.9244,0.077,0.467,0.501,0.015,1.531,102.06666666666666,104,0.3081481481481481,1,1,6,7,FALSE,TRUE,FALSE
396,2021-11-13T05:13:28Z,1,1.7777777777777777,1440,1,1,2,3,3,3,2,1,2,3,2,1,3,3,2,3,3,3,3,1,1,1,2,3,1,7,3,0,0,4,2,2,3,3,4,4,5,3,1,4,3,1,3,2,3,5,3,3,4,4,2,2,5,1,3,1,1,5,5,3,2,4,2,3,3,2,2,1,3,3,1.875,0,2.25,0,2.6666666666666665,0,2.6666666666666665,0,2.8333333333333335,0,2.5,0,3.2857142857142856,0,2.6666666666666665,0,2.864864864864865,0,4,0,0,0.30424463488929604,0.3253274413308691,0.4671351414942582,0.39623129141256364,4,2,3,3,1,2,2,2.142857142857143,0,2,0.14960659196890055,2,2,3,4,1,1,5,2,0,4,1.5194825076544112,0,2,2,2,2,2,2,3,4,2,1,1,4,2,3,4,5,4,2,3,4,2,0,4.2,0,2.4,0,3,0,3.2,0,2,1,2,3,3,3,2,3,1,3,2,3,2,2,1,4,2,3,2,2,2,0,"Hispanic of Latino (e.g., Mexican American, Central American, and others) & White, Caucasian, Anglo, European American",1,23,0,1,NA,5,2,1,1,0,0,2,TRUE,TRUE,TRUE,TRUE,TRUE,0,4,0.9562176470581223,0.68,0.2793249725054637,4,0.43659000000009934,0.49006250000139695,0.967741935483871,1,0.0031457607958959833,0.007933436612976649,4,0.5595531249996275,0.6307451612891689,1,1,0.00618939740918229,0.01118383389283409,1.6643,0.4697,0.3797,1.3951,0.3572,0.4827,0.1687,1.6410021733333333,0.5788704626333333,0.37877604466666664,1.1881,4.675,0.3147,3.7678,0.3324,-76.7705,0.9912,5.2569,0.3405,3.783,0.36870000000000003,0.9988,1.2911649556666667,3.93622159,4.76782956,0.32607763733333334,0.30751365333333336,1.4067,4.8444,0.4259,7.4547,0.525,0.9381,0.174,0.301,0.671,0.012,1.21,100.83333333333333,356,1.0548148148148149,1,0,1,2,FALSE,FALSE,FALSE
397,2021-11-13T05:22:32Z,1,1.7777777777777777,1080,2,3,2,3,2,4,2,3,1,3,4,3,3,2,4,2,1,2,2,4,2,2,1,4,1,2,6,4,1,4,2,2,4,4,4,4,3,1,2,4,1,1,3,1,4,2,2,1,2,3,2,2,3,2,1,3,3,2,3,2,3,2,2,1,2,1,2,1,2,2,2.25,0,1.75,0,3.4,0,2.888888888888889,0,1.8333333333333333,0,2.3333333333333335,0,2.2857142857142856,0,1.3333333333333333,0,2.27027027027027,0,1,4,1,0.16765493691749705,0.5461059385456428,0.7040377919415024,0.6250718652435726,4,2,3,2,1,4,2,2.2857142857142856,0,2.5,0.41956761451123586,4,3,5,3,2,3,2,3.4285714285714284,0,2.5714285714285716,0.6723373927674386,0,3,4,3,2,3,2,3,4,4,2,2,4,5,3,4,5,3,2,2,4,3,0,3.8,0,1.8,0,2.6,0,2.7333333333333334,0,2,1,3,2,3,3,2,1,3,3,2,1,2,4,2,1,2,3,2,3,2.75,0,"White, Caucasian, Anglo, European American",0,27,0,1,NA,5,2,0,0,0,0,0,TRUE,TRUE,TRUE,TRUE,TRUE,0,4,0.659921052631579,0.76,0.05257280979591836,4,0.41396666666666665,0.492,0.9375,0.967741935483871,0.002873047379032259,0.004380836559139786,4,0.57096875,0.6762333333333334,1,0.9375,0.005478869959677419,0.012644490927419356,1.1043,1.0221,0.3779,1.1379,1.0811,0.3688,0.1227,1.161286635,0.9907038786666666,0.3690753606666667,0.9151,3.458,0.2929,3.7048,0.3738,-75.5589,0.8052,5.0633,0.3329,5.3172,0.415,0.9339,1.019086211,3.880123536666667,3.829893536666667,0.36629918466666667,0.2875574986666667,0.9077,4.3778,0.4797,3.3109,0.5443,0.9011,0.095,0.349,0.447,0.008,1.39,173.74999999999997,404,1.1970370370370371,1,0,9,10,FALSE,FALSE,FALSE
398,2021-11-13T05:29:21Z,0.800000011920929,1.7786458333333333,768,4,2,3,3,4,3,4,3,2,4,3,3,4,1,2,2,3,4,5,1,1,4,4,3,4,2,2,0,0,4,4,4,4,3,4,5,5,2,3,4,5,3,2,3,4,4,5,5,5,5,2,1,1,1,3,3,1,3,1,1,3,3,3,2,4,3,2,1,3,1,3.25,0,1.75,0,3.466666666666667,0,2.111111111111111,0,3.8333333333333335,0,2,0,2,0,3,0,2.7567567567567566,0,1,0,0,1.0922621231881353,1.2135713119753146,-0.2989446853297732,0.4573133133227707,5,1,2,2,1,2,2,1.8571428571428572,0,1,-0.39031545311577004,3,4,3,3,2,2,4,2.7142857142857144,0,3.2857142857142856,-0.7395711320441822,0,2,2,4,2,3,3,5,2,1,4,2,3,2,4,5,2,3,2,3,4,2.6,0,3.4,0,4,0,4,0,3.8,0,1,1,3,4,3,3,4,2,1,2,3,1,1,4,1,1,1,3,1,2,2.3,0,"White, Caucasian, Anglo, European American",0,24,0,1,NA,5,2,0,0,1,0,0,TRUE,TRUE,TRUE,TRUE,TRUE,0,5,0.8014235294136931,0.68,0.04385278122656727,5,0.47205937500111755,0.5308290322605641,1,0.96875,0.004809792167820138,0.002655889314569209,5,0.620862500000745,0.6988624999970198,1,1,0.007136965645262484,0.00993452693534001,1.2515,0.6311,0.4783,1.053,0.5323,0.5542,0.1974,1.30643091,0.748250542,0.46898981133333334,1.3223,4.414,0.3223,4.9259,0.4032,-82.7625,0.7883,5.1489,0.3943,5.4899,0.461,0.9894,1.4237497586666668,4.747829643333334,4.556944873333333,0.39324064033333334,0.31563512833333335,0.8908,3.7353,0.5189,3.4861,0.5884,0.9965,0.157,0.364,0.6,0.017,1.505,88.52941176470587,338,1.0014814814814814,1,0,0,1,FALSE,FALSE,FALSE
399,2021-11-13T05:36:48Z,0.800000011920929,1.6,900,4,4,5,5,2,4,1,1,5,2,1,1,1,5,1,5,4,2,2,1,1,1,1,1,1,0,2,0,0,5,3,4,5,5,5,5,5,4,2,5,2,1,3,2,5,1,1,1,2,2,4,1,1,1,1,1,1,1,1,1,5,1,2,1,1,1,1,1,1,1,1.25,0,1,0,1.2666666666666666,0,1.4444444444444444,0,1.5833333333333333,0,1,0,1,0,1,0,1.3513513513513513,0,0,0,0,-1.0259288853591455,-1.195343742247085,-0.7372407672780129,-0.966292254762549,5,1,3,1,1,1,1,1.2857142857142858,0,1,-0.7321841937363471,4,4,5,4,2,3,2,3.7142857142857144,0,2.2857142857142856,-0.7395711320441822,0,2,3,3,2,2,1,5,2,1,3,1,5,2,5,5,1,5,2,4,5,2.4,0,4.8,0,4.2,0,4,0,4.333333333333333,0,2,2,2,3,1,2,2,3,1,2,2,3,2,3,1,3,1,2,1,2,1.8,0,"White, Caucasian, Anglo, European American",0,19,0,1,NA,5,2,0,0,1,0,0,TRUE,TRUE,TRUE,TRUE,TRUE,0,4,1.0572750000000088,0.8,0.1248585453061265,4,0.4673124999999927,0.5667096774193454,1,1,0.0017731895161293113,0.007447879569892766,4,0.6508437500000018,0.7512812499999991,1,1,0.00877091028225865,0.014374337701611704,1.6265,0.9152,0.5529,1.1149,0.9783,0.7639,0.3042,1.6172525466666667,0.9065184456666666,0.5444769836666666,6.0371,11.7819,0.2111,7.7142,0.1754,-90.8656,0.6156,6.7761,0.4256,7.103,0.5194,0.8162,1.8561054566666666,4.58375396,6.16904314,0.367909268,0.32249308833333334,1.1083,5.7375,0.5541,3.5283,0.6151,0.9072,0.179,0.335,0.557,0.01,1.261,126.1,423,1.2533333333333332,1,0,0,1,FALSE,FALSE,FALSE
400,2021-11-13T05:43:40Z,1,1.7777777777777777,1080,6,1,4,4,3,4,3,2,3,3,3,2,3,3,2,4,3,2,4,3,1,1,2,2,2,5,2,0,0,4,3,3,3,2,4,2,3,3,3,4,3,3,3,3,4,4,4,3,4,4,2,1,3,1,4,5,1,3,3,3,3,2,2,1,1,1,1,2,2,2,2.125,0,1.75,0,2.533333333333333,0,3,0,3.1666666666666665,0,2.8333333333333335,0,2.2857142857142856,0,1,0,2.7837837837837838,0,3,0,0,0.40931363332914156,0.3406202964645538,0.10724026226325957,0.22393027936390666,3,2,2,2,2,2,2,2.4285714285714284,0,1,-0.048446712495193056,5,5,5,5,2,2,2,4,0,2,-1.869097951893479,0,3,2,3,1,2,2,4,3,2,3,2,4,2,2,3,3,5,3,3,3,2.2,0,4,0,3.4,0,3,0,3.466666666666667,0,2,1,1,3,1,3,2,2,3,2,1,1,1,1,3,2,1,3,3,2,2.1,0,"Asian or Asian American (e.g., Chinese, Japanese, and others)",0,27,0,1,NA,5,2,0,0,1,0,0,TRUE,TRUE,TRUE,TRUE,TRUE,0,4,0.657583333330495,0.84,0.033931699763547714,4,0.4494156249910593,0.5133548387173683,1,0.96875,0.001504668456669911,0.002098261775303195,4,0.530175000000745,0.5458258064485365,1,0.96875,0.00729695161271576,0.008443067006412225,1.3381,1.3508,0.3534,0.9577,1.3094,0.4758,0.1615,1.35396713,1.1800991926666666,0.34766065933333334,1.1987,6.5495,0.3579,4.8626,0.3949,-103.5884,0.7656,5.8217,0.388,7.1676,0.4607,0.9995,1.232048881,4.631319796666666,5.98831819,0.38945868433333336,0.3519021606666667,0.8073,10.6153,0.4953,5.3869,0.4708,0.9596,0.071,0.333,0.344,0.064,1.107,17.296875,482,1.4281481481481482,1,0,0,1,FALSE,FALSE,FALSE
401,2021-11-13T05:28:03Z,1,1.7786458333333333,768,4,3,3,4,2,3,2,2,3,3,1,1,1,2,1,3,2,2,3,1,2,1,3,1,2,2,2,0,0,4,4,3,4,2,5,3,5,2,2,4,1,2,3,4,5,4,4,3,5,3,3,1,1,1,3,1,1,3,1,1,3,2,1,1,1,1,3,2,2,1,1.875,0,2,0,2.3333333333333335,0,2.4444444444444446,0,2.8333333333333335,0,1.5,0,1.5714285714285714,0,1,0,2.189189189189189,0,1,0,0,-0.11603135887008498,-0.10829275486474121,-0.22054348261253207,-0.16441811873863665,4,2,3,1,1,1,2,1.7142857142857142,0,1.5,-0.2912888008837234,4,5,5,3,2,2,2,3.5714285714285716,0,2.4285714285714284,-0.4571894270818581,0,3,4,3,4,3,2,4,3,2,3,2,3,4,4,3,4,4,2,2,3,3.4,0,3.8,0,2.6,0,3.4,0,3.2666666666666666,0,2,3,4,2,3,4,3,1,2,3,3,3,1,4,1,2,1,4,4,3,2.85,0,"White, Caucasian, Anglo, European American",0,20,0,1,NA,5,2,0,0,0,0,0,TRUE,TRUE,TRUE,TRUE,TRUE,0,6,0.7142608695522599,0.9387755102040817,0.04606242682832435,6,0.4968593749925494,0.5627468749843538,1,1,0.006203027653393122,0.009285269022583628,6,0.5375687500014901,0.6206133333365123,1,0.967741935483871,0.004393468669031301,0.006189920367911053,1.6554,1.9471,0.3393,1.4347,2.221,0.4107,0.1607,1.5138132366666666,1.4619549936666667,0.339495785,3.2625,6.2661,0.2365,5.9128,0.2869,-71.5719,1.0865,4.7913,0.3823,4.5693,0.4416,0.9741,1.91938186,4.5910732,4.60433155,0.3575412,0.2886754893333333,1.0873,4.6061,0.4267,5.187,0.5175,0.921,0.072,0.404,0.543,0.016,1.706,106.625,346,1.0251851851851852,1,0,0,1,FALSE,FALSE,FALSE
402,2021-11-13T05:47:34Z,1,1.6,900,4,3,5,4,3,4,1,2,4,3,1,1,3,5,1,3,1,1,2,1,1,1,1,2,1,0,2,0,0,5,5,5,5,3,5,4,5,3,1,5,1,1,5,1,5,2,1,1,4,3,4,1,1,1,2,1,1,1,1,1,5,2,2,1,1,1,1,1,1,2,1.25,0,1.25,0,2.066666666666667,0,1.5555555555555556,0,1.5,0,1.1666666666666667,0,1.1428571428571428,0,1,0,1.4054054054054055,0,0,0,0,-0.9923068058583949,-0.8283152190386573,-0.6588395645607719,-0.7435773917997146,5,1,3,2,2,1,1,1.5714285714285714,0,1,-0.5612498234260587,5,5,5,4,4,4,2,4.428571428571429,0,1.5714285714285714,2.0842459175790595,0,4,2,4,4,3,3,4,2,1,3,1,3,1,2,5,3,5,1,3,5,3.4,0,4.2,0,3.6,0,3.4,0,3.7333333333333334,0,1,1,1,2,1,1,3,3,2,1,1,3,1,3,1,3,1,2,4,2,1.75,0,"Hispanic of Latino (e.g., Mexican American, Central American, and others)",0,20,0,1,NA,5,2,0,0,0,0,0,TRUE,TRUE,TRUE,TRUE,TRUE,0,2,0.9555676470521618,0.68,0.06973914989384754,2,0.443868965514775,0.5009233333309492,0.9354838709677419,0.967741935483871,0.004259775978709091,0.00417966184913946,2,0.6453000000026077,0.8535592592623499,1,0.84375,0.02115808128866165,0.10745541128122599,1.3682,0.5583,0.5597,1.2922,0.437,0.6117,0.2596,1.41226375,0.6835946667666667,0.548581199,1.1014,3.2815,0.3105,3.8371,0.371,-65.245,0.8261,3.9916,0.3513,6.1583,0.4297,0.9978,1.205471222,3.87652149,3.5243020233333335,0.351868794,0.281832392,1.2036,2.2669,0.4411,2.1413,0.5181,0.8822,0.072,0.384,0.222,0.011,2.043,185.72727272727275,434,1.285925925925926,1,0,0,1,FALSE,FALSE,FALSE
403,2021-11-13T05:50:30Z,0.8999999761581421,1.7777777777777777,1080,6,3,5,5,1,5,1,1,5,1,1,1,1,5,1,5,1,1,1,1,1,1,1,1,1,0,2,0,0,5,2,5,4,2,5,5,5,3,1,5,1,1,3,1,4,1,1,1,1,1,5,1,1,1,1,1,1,1,1,1,5,1,1,1,1,1,1,1,1,1,1,0,1,0,1.2666666666666666,0,2,0,1.25,0,0.8333333333333334,0,0.8571428571428571,0,1,0,1.3243243243243243,0,0,0,0,-1.1982420428004914,-1.3143957157561477,-0.7372407672780129,-1.0258182415170802,5,1,3,1,1,1,1,1.2857142857142858,0,1,-0.7321841937363471,5,5,5,5,3,3,1,4.428571428571429,0,1.5714285714285714,-0.1748077221195339,0,3,3,3,1,3,3,3,3,3,1,1,3,1,4,3,4,4,1,3,4,2.6,0,4,0,2.8,0,3,0,3.2666666666666666,0,1,1,1,4,1,1,1,3,1,1,1,4,1,1,1,4,1,1,1,1,1.05,0,"Asian or Asian American (e.g., Chinese, Japanese, and others)",0,24,0,1,NA,5,2,0,0,1,0,0,TRUE,TRUE,TRUE,TRUE,TRUE,0,2,0.7124142857141793,0.7,0.039309959873567404,2,0.595386206896526,0.8112888888887785,0.90625,0.84375,0.03678772603827246,0.035974257419409954,2,0.5896406250006985,0.6788965517245233,1,0.90625,0.00668808313502301,0.014164024475889703,1.1518,0.7562,0.417,1.0679,0.8343,0.4583,0.2775,1.2107825206666667,0.8429740906666666,0.40944804333333334,1.4694,1.5872,0.1961,1.2929,0.4071,14.372,1.1446,1.9552,0.3775,1.7044,0.5681,0.9823,1.51187113,1.4473555776666667,1.8260874793333333,0.39517415333333333,0.20146137766666666,0.7676,4.5745,0.5261,3.2925,0.5788,0.9165,0.063,0.418,0.381,0.01,1.515,151.5,416,1.2325925925925925,1,0,2,3,FALSE,FALSE,FALSE
404,2021-11-13T05:40:44Z,1,1.7777777777777777,1080,4,3,4,4,2,4,2,2,4,2,2,2,2,4,2,4,4,3,3,4,2,3,3,3,3,0,2,0,0,4,4,3,3,2,4,4,4,3,2,4,4,2,3,2,4,3,4,4,4,4,3,2,1,2,2,1,1,2,1,1,4,1,2,1,1,3,2,2,1,2,3,0,1.75,0,2,0,2.5555555555555554,0,3,0,1.6666666666666667,0,1.2857142857142858,0,1.6666666666666667,0,2.2972972972972974,0,0,0,0,0.6509723297407854,0.27838418348379973,-0.5020371591262895,-0.11182648782124491,5,2,4,1,1,2,2,1.5714285714285714,0,1,-0.5612498234260587,4,4,4,4,4,4,2,4,0,2,-0.7395711320441822,0,2,2,2,2,2,2,4,3,2,3,2,3,3,3,3,3,4,2,3,3,2,0,3.8,0,3.2,0,3.2,0,3.4,0,2,2,3,1,2,3,3,2,3,4,3,2,2,3,2,2,1,3,3,3,2.75,0,"Asian or Asian American (e.g., Chinese, Japanese, and others)",0,24,0,1,NA,5,2,0,0,0,0,0,TRUE,TRUE,TRUE,TRUE,TRUE,0,6,0.6824461538462112,0.78,0.0254157172897447,6,0.3969677419354839,0.4650322580645762,0.96875,0.96875,0.003397397903241063,0.0031957722479658583,6,0.751362500000163,0.852635483871124,1,0.96875,0.052318052742021635,0.04079592587698166,1.1844,1.1144,0.3892,0.6542,1.7165,0.5991,0.3232,1.2342069246666667,1.0438483286666667,0.381814343,1.346,3.9301,0.2324,3.9569,0.304,-67.6205,0.8704,5.7306,0.3292,5.7346,0.3938,0.6288,1.3907824953333334,3.9994650233333333,4.114989426666667,0.30064008933333336,0.23119227933333333,1.4357,2.2825,0.4582,1.9416,0.5464,0.9994,0.086,0.426,0.272,0.018,2.086,115.88888888888889,312,0.9244444444444444,1,0,0,1,FALSE,FALSE,FALSE
406,2021-11-13T05:43:51Z,0.8999999761581421,1.7777777777777777,1080,4,2,2,3,3,3,3,3,3,3,4,2,3,2,2,2,2,3,3,1,1,2,2,2,2,4,2,0,0,2,2,3,3,2,3,2,2,2,4,2,3,1,2,3,2,4,3,4,4,3,3,1,2,1,3,3,1,2,2,2,3,3,3,2,3,3,2,1,2,2,2,0,1.75,0,3.2,0,3.6666666666666665,0,3.4166666666666665,0,2,0,2.142857142857143,0,2.6666666666666665,0,3,0,2,0,0,0.46605089248665776,0.6663193947230869,-0.0958522115332568,0.285233591594915,3,3,2,2,1,3,3,2.7142857142857144,0,8,2.7054013812357707,2,3,4,3,2,2,3,2.7142857142857144,0,3.2857142857142856,0.6723373927674386,0,2,2,2,3,2,3,2,3,2,3,3,2,3,3,3,4,3,3,2,3,2.2,0,2.8,0,2.4,0,3.2,0,2.8,0,1,2,1,2,2,1,2,2,2,1,3,2,1,1,1,2,1,1,1,1,1.7,0,"Asian or Asian American (e.g., Chinese, Japanese, and others)",0,28,0,1,NA,5,2,0,0,1,0,0,TRUE,TRUE,TRUE,TRUE,TRUE,0,5,1.1143588235290611,0.85,0.1330453753595087,5,0.5862968749988359,0.723914814815477,1,1,0.01706993515127976,0.0318190651565032,NA,NA,NA,NA,NA,NA,NA,1.7527,1.0678,0.5267,1.7348,1.1165,0.5541,0.0017,1.6860262866666667,0.995127934,0.521310518,2.0539,4.2253,0.3432,3.2153,0.4045,-42.2278,1.049,4.0881,0.4541,2.8352,0.54990000000000006,0.9979,2.0354659766666665,3.15942754,4.176837126666666,0.39706226466666666,0.33990370933333336,NA,NA,NA,NA,NA,NA,NA,NA,NA,NA,NA,NA,104,0.3081481481481481,1,0,0,1,FALSE,FALSE,FALSE
407,2021-11-13T05:35:51Z,1,1.7777777777777777,1080,4,2,4,4,2,4,3,1,5,2,2,2,2,4,3,4,4,2,4,5,1,2,2,2,1,0,2,0,0,4,2,3,4,3,4,2,3,3,2,3,4,2,3,3,4,3,2,3,3,3,2,1,3,1,4,3,1,1,1,1,4,2,3,1,3,2,2,2,1,1,2.375,0,1.5,0,2,0,2.888888888888889,0,2.75,0,2.5,0,1.4285714285714286,0,2,0,2.4864864864864864,0,0,0,0,0.37989431376598426,0.09109510320734764,-0.5804383618435307,-0.24467162931809153,5,2,3,2,1,1,2,1.7142857142857142,0,3.5,0.4466865486650409,5,5,5,4,2,2,3,3.7142857142857144,0,2.2857142857142856,0.38995568780511447,0,3,2,2,3,2,3,4,3,3,2,4,4,4,3,4,3,4,2,2,3,2.4,0,3.4,0,2.6,0,3.2,0,3.066666666666667,0,1,2,3,1,2,4,3,1,4,3,2,2,1,3,2,1,2,3,2,3,2.75,0,"Black or African American & White, Caucasian, Anglo, European American & Native American/Alaskan Native/indigenous",1,22,0,1,NA,5,2,0,1,0,0,1,TRUE,TRUE,TRUE,TRUE,TRUE,0,3,0.9356486486486486,0.74,0.04548373918367347,3,0.4035,0.49648387096774194,1,0.96875,0.002335741935483871,0.005007354838709677,3,0.6236875,0.6479333333333334,1,1,0.007072737903225805,0.003601374712643678,1.3642,0.8199,0.5492,1.1329,0.7492,0.6688,0.2176,1.4087140433333334,0.861874495,0.5395859323333333,1.7127,6.7862,0.2773,3.7058,0.2746,-78.7984,0.5564,5.9955,0.3587,5.1758,0.455,0.9841,1.53538735,3.509660703333333,5.946934976666666,0.2841955546666667,0.279345934,0.8994,4.5839,0.5276,4.7876,0.5621,0.9862,0.116,0.426,0.627,0.047,2.014,42.85106382978723,366,1.0844444444444443,1,0,2,3,FALSE,FALSE,FALSE
408,2021-11-13T05:51:41Z,1,1.7786458333333333,768,6,1,2,2,3,3,2,2,1,3,2,4,2,1,1,2,4,3,4,1,1,2,3,3,3,1,2,1,3,5,5,3,5,1,5,5,5,4,2,5,5,2,3,2,4,4,4,5,5,3,1,5,1,1,2,1,3,1,2,1,4,2,2,2,3,3,2,1,2,2,2.5,0,1.75,0,3.066666666666667,0,1.7777777777777777,0,3.1666666666666665,0,2.3333333333333335,0,1.7142857142857142,0,2.6666666666666665,0,2.4324324324324325,0,1,1,3,0.4240232931107196,0.5799825163734255,0.43703746296079277,0.5085099896671091,1,5,1,4,5,5,5,4.857142857142857,0,8,3.9874091585629348,1,1,3,3,1,3,4,2,0,4,0.38995568780511447,0,3,2,3,3,3,2,4,3,3,3,2,3,3,3,4,1,4,2,3,4,2.8,0,3.8,0,3.6,0,3,0,3.466666666666667,0,2,1,3,2,2,3,2,1,4,2,1,2,1,4,2,2,1,3,4,2,2.5,0,"Asian or Asian American (e.g., Chinese, Japanese, and others) & Black or African American",1,26,0,1,NA,5,2,0,0,1,0,0,TRUE,TRUE,TRUE,TRUE,TRUE,0,4,1.0241777777777779,0.9,0.23731179959183674,4,0.44315625,0.5109032258064516,1,0.96875,0.0019271038306451615,0.0035013941532258067,4,0.58715625,0.6489354838709678,1,0.96875,0.007011039314516129,0.007971757056451612,1.7476,1.2262,0.5016,1.829,1.4182,0.4351,0.0376,1.6760064933333334,1.1026748946666667,0.5008924733333333,1.2894,6.0733,0.337,4.3106,0.3671,-92.1749,0.8959,7.4996,0.3852,5.1272,0.4217,0.9743,1.3479109983333333,4.270347983333333,5.743568583333333,0.3612634026666667,0.3302471283333333,0.8492,4.1692,0.4965,5.681,0.5655,0.9591,0.066,0.425,0.379,0.022,1.74,79.0909090909091,290,0.8592592592592593,1,0,2,3,FALSE,FALSE,FALSE
411,2021-11-13T06:00:24Z,1,1.7777777777777777,864,3,2,4,4,2,4,2,2,4,2,2,2,2,4,2,4,4,2,2,1,1,2,2,2,1,1,2,1,3,4,3,3,4,3,4,4,4,4,2,4,2,2,3,2,3,2,2,2,2,3,4,1,1,1,3,3,1,3,1,1,4,2,2,2,2,2,2,1,2,1,1.625,0,1.5,0,2,0,2.3333333333333335,0,2.25,0,1.6666666666666667,0,1.5714285714285714,0,2,0,2.081081081081081,0,1,1,3,-0.33877763556255713,-0.40543873752557247,0.35863626024355166,-0.023401238641010402,4,2,3,2,2,2,2,2.142857142857143,0,1,-0.21938108280548152,4,4,4,4,2,2,2,3.4285714285714284,0,2.5714285714285716,0.10757398284279028,0,2,1,1,2,2,2,4,2,1,3,1,4,2,4,5,2,4,2,4,2,1.6,0,4.2,0,3.8,0,4.4,0,4.133333333333334,0,2,1,2,2,1,2,3,2,2,1,1,3,1,2,1,3,1,2,1,2,1.75,0,"White, Caucasian, Anglo, European American",0,30,0,1,NA,5,2,0,0,1,0,0,TRUE,TRUE,TRUE,TRUE,TRUE,0,4,0.8880444444815317,0.72,0.06306818393777351,4,0.4009281250089407,0.46428709674650626,1,0.96875,0.0019218633763511143,0.0016144851220517968,4,0.5431656249985098,0.5956124999970198,1,1,0.0034304281329476925,0.0025971462919820508,1.4035,0.6937,0.4728,1.0128,0.7541,0.6683,0.4679,1.43523195,0.7749306803333333,0.465478206,1.2415,6.3702,0.3035,5.128,0.3502,-103.0728,0.589,5.8751,0.358,5.4756,0.417,0.9911,1.2228636023333332,4.742351723333333,5.805779403333333,0.3475046866666667,0.30051070966666665,0.7528,4.4168,0.468,6.327,0.5347,0.9817,0.265,0.251,0.935,0.019,1.422,74.84210526315789,370,1.0962962962962963,1,0,2,3,FALSE,FALSE,FALSE
412,2021-11-13T05:58:29Z,1,1.7777777777777777,1080,5,4,5,5,2,5,1,1,5,2,1,1,1,5,2,5,5,1,1,1,1,1,1,1,1,2,2,0,0,5,5,5,5,5,5,5,5,5,2,5,1,1,5,2,5,1,1,1,2,2,5,1,1,1,3,1,1,2,2,2,5,1,1,1,1,1,1,1,1,1,1,0,1,0,1.2,0,1,0,1.3333333333333333,0,1.1666666666666667,0,1.2857142857142858,0,1,0,1.2432432432432432,0,1,0,0,-1.2486751620516177,-1.3778901016276477,-0.5341482934814965,-0.9560191975545721,4,2,3,1,1,2,2,1.8571428571428572,0,1,-0.39031545311577004,4,5,5,5,3,5,3,4.285714285714286,0,1.7142857142857142,0.38995568780511447,0,1,1,1,3,2,1,4,1,1,3,2,3,3,5,4,3,4,1,4,1,1.6,0,4.2,0,3.4,0,4.8,0,4.133333333333334,0,1,1,2,4,3,2,3,4,1,1,3,4,2,2,1,3,1,2,1,3,1.7,0,"White, Caucasian, Anglo, European American",0,28,0,1,NA,5,2,0,0,1,0,0,TRUE,TRUE,TRUE,TRUE,TRUE,0,6,0.8950650000000373,0.8,0.14038220096331552,6,0.5028870967742536,0.5890031250000466,0.96875,1,0.009335489667358142,0.006400432570549223,6,0.6751250000000583,0.7719312500000524,1,1,0.009164055483863232,0.010069130604860923,1.4946,0.9407,0.5099,1.2197,0.8037,0.5853,0.1072,1.5115169733333333,0.9313245016666667,0.5015895896666667,1.9815,3.7683,0.2505,4.2352,0.3551,-52.668,0.9996,3.5642,0.3671,4.0902,0.4795,0.9655,1.85061075,3.97046224,3.7405113533333334,0.357026627,0.25906302566666667,0.8238,3.293,0.5813,4.3458,0.6806,0.9775,0.258,0.294,0.68,0.012,1.459,121.58333333333334,310,0.9185185185185185,1,0,0,1,FALSE,FALSE,FALSE
413,2021-11-13T06:00:49Z,1,1.7777777777777777,1080,3,2,3,3,4,2,2,1,4,4,4,2,2,2,1,2,2,2,5,5,1,1,2,3,2,1,2,0,1,4,1,2,3,2,4,5,3,2,2,2,4,3,1,1,1,4,4,5,5,2,1,2,2,1,4,4,2,1,1,1,3,4,3,2,4,3,1,1,1,1,2.625,0,1,0,2.933333333333333,0,3.111111111111111,0,3.6666666666666665,0,2.8333333333333335,0,2,0,3,0,3.081081081081081,0,1,0,1,0.9052393059652108,0.8551571185573803,-0.35769864658231576,0.24872923598753227,3,2,1,2,2,3,3,2.857142857142857,0,3,0.9459301925190042,3,3,3,2,1,1,5,2,0,4,2.0842459175790595,0,2,3,2,2,2,2,5,3,2,5,1,5,1,5,3,1,4,3,3,2,2.2,0,4.2,0,4.6,0,3.8,0,4.2,0,3,1,2,3,3,4,3,3,2,1,1,2,2,4,2,2,1,3,2,1,2.25,0,"Asian or Asian American (e.g., Chinese, Japanese, and others)",0,20,0,1,NA,5,2,0,0,1,0,0,TRUE,TRUE,TRUE,TRUE,TRUE,1,6,0.6738153846156902,0.78,0.009187965555135062,6,0.48978666666671633,0.550767741935628,1,0.96875,0.0015078005057652406,0.005203675554450656,6,0.6447218750002794,0.7088931034484814,1,0.90625,0.0035990901512115633,0.005903986411279873,0.9629,1.3626,0.4822,0.6352,1.6177,0.5985,0.2086,1.0299207313333334,1.1492817513333333,0.4736739936666667,1.3265,7.0914,0.3963,3.8006,0.3838,-88.7918,0.5611,6.8057,0.4492,4.7466,0.501,0.9021,1.3919109186666667,3.8274520733333333,6.313135296666666,0.37682740266666664,0.386012887,0.8699,4.3589,0.5609,4.0124,0.5995,0.9978,0.056,0.539,0.552,0.021,1.711,81.47619047619048,306,0.9066666666666667,1,0,0,1,FALSE,FALSE,FALSE
414,2021-11-13T05:55:54Z,1,1.7777777777777777,1080,3,3,1,3,4,4,2,2,1,4,3,3,3,1,1,2,1,4,5,2,3,4,5,4,4,3,5,2,2,5,1,3,3,1,1,2,2,1,3,4,5,4,3,2,2,3,3,4,5,5,2,1,1,1,4,2,3,3,1,1,4,2,1,1,3,2,3,4,2,3,3.875,0,3,0,3.4,0,3.888888888888889,0,3.5833333333333335,0,2,0,1.7142857142857142,0,2,0,2.972972972972973,0,2,2,2,1.6155057354185651,1.5464328866888646,1.0623195110373578,1.3043761988631113,3,5,2,4,3,4,4,3.857142857142857,0,4.5,2.0976820007665875,3,5,4,4,2,2,3,3.2857142857142856,0,2.7142857142857144,2.0842459175790595,0,1,1,3,3,3,1,5,1,1,4,3,5,3,5,3,2,4,2,5,3,2.2,0,4.2,0,4.2,0,4.2,0,4.2,0,3,1,1,2,1,4,1,2,4,1,3,1,4,4,2,2,1,1,1,1,2.3,0,"Asian or Asian American (e.g., Chinese, Japanese, and others) & White, Caucasian, Anglo, European American",1,25,0,1,NA,5,2,0,0,1,0,0,TRUE,TRUE,TRUE,TRUE,TRUE,0,5,1.099078787878833,0.66,0.1816251681795729,5,0.4906875,0.5499838709673814,1,0.96875,0.0036766604838679635,0.005559312217738711,5,0.6733093749993714,0.7148187499997439,1,1,0.005133095715753153,0.003255679637073336,1.8127,0.37,0.5117,1.5199,0.3622,0.5365,0.0056,1.65901343,0.5379497458333333,0.44574643733333336,1.3093,4.56,0.3471,4.0893,0.3973,-76.7959,0.9654,6.4544,0.4198,4.3837,0.4357,0.8721,1.462280151,4.152689353333334,4.7531902666666666,0.38418399066666664,0.33773695833333334,0.695,3.7767,0.6072,8.9835,0.6695,0.9076,0.15,0.467,0.745,0.014,1.058,75.57142857142857,318,0.9422222222222223,1,0,0,1,FALSE,FALSE,FALSE
415,2021-11-13T05:35:59Z,0.8999999761581421,1.7786458333333333,768,3,1,1,1,5,2,5,4,1,5,5,4,5,1,1,1,1,5,5,5,5,5,5,5,2,7,3,6,4,1,1,1,1,1,1,1,1,1,5,1,5,5,1,5,2,5,5,2,5,5,1,5,4,3,5,3,5,5,5,5,2,4,5,2,5,5,1,1,1,5,4.625,0,2,0,4.533333333333333,0,5,0,4.666666666666667,0,4,0,4.571428571428571,0,4,0,4.621621621621622,0,4,6,4,3.107485513264368,3.0642971538182313,2.334331771931882,2.6993144628750567,1,5,1,5,5,4,5,4.857142857142857,0,6,3.24943380901417,2,2,1,2,1,1,5,1.4285714285714286,0,4.571428571428571,0.10757398284279028,0,2,2,3,1,2,2,5,2,2,3,1,5,1,4,5,4,5,1,3,3,2,0,4.8,0,3.6,0,4,0,4.133333333333334,0,3,2,3,2,1,2,3,1,3,1,4,2,3,2,2,3,2,3,3,2,2.55,0,"Black or African American & White, Caucasian, Anglo, European American",1,21,0,1,NA,5,2,0,0,1,0,0,TRUE,TRUE,TRUE,TRUE,TRUE,0,6,1.0050303030284968,0.66,0.35278047198628726,6,0.581631034488308,0.6354387096791498,0.90625,0.96875,0.04088085032164549,0.01925458410334233,6,0.6779312500003725,0.7731965517257822,1,0.90625,0.010603903507950896,0.024875241936004457,1.8387,0.3747,0.2622,1.4993,0.3546,0.4482,0.3825,1.7611296033333332,0.48264412919,0.270125504,1.2592,1.8276,0.2817,2.9144,0.4287,-27.0881,1.3178,2.6684,0.3107,3.1616,0.418,0.9567,1.3691112683333333,3.0597930366666666,2.139984027,0.414839538,0.274751221,0.9342,3.7507,0.5683,2.6794,0.606,0.9831,0.076,0.471,0.393,0.015,1.895,126.33333333333334,250,0.7407407407407408,1,1,4,5,FALSE,FALSE,FALSE
416,2021-11-13T05:49:27Z,1,1.7777777777777777,864,6,3,2,4,3,3,2,3,2,4,2,2,1,3,1,3,3,2,5,1,5,3,4,4,3,3,4,0,0,5,2,5,4,2,4,1,2,2,5,4,3,2,2,2,4,3,5,5,5,5,3,1,1,1,3,1,4,5,5,5,4,2,2,1,1,2,2,3,4,4,3.375,0,3.25,0,2.6666666666666665,0,3,0,3.5833333333333335,0,1.5,0,3.4285714285714284,0,1.3333333333333333,0,2.945945945945946,0,2,0,0,1.2876904602862478,1.0047948023338122,0.3745550047701899,0.6896749035520011,5,1,4,1,1,1,2,1.2857142857142858,0,1.5,-0.5476903563491562,5,5,5,3,3,3,2,4,0,2,-0.1748077221195339,0,3,3,2,2,3,2,2,2,2,3,3,4,4,3,4,4,4,4,4,3,2.6,0,3.4,0,2.6,0,3.6,0,3.2,0,3,2,2,1,2,2,2,1,4,3,2,2,2,3,1,2,1,2,3,3,2.55,0,"Asian or Asian American (e.g., Chinese, Japanese, and others) & Black or African American & Filipino",1,22,0,1,NA,5,2,0,0,2,0,0,TRUE,TRUE,TRUE,TRUE,TRUE,0,1,0.9641349999999628,0.8163265306122449,0.2396209279680326,1,0.5557225806465553,0.6171225806462669,0.96875,0.96875,0.03558701982845939,0.041448591441573646,1,0.5955312499993015,0.7051241379318566,1,0.90625,0.020615922863058283,0.012352139959642681,1.897,0.8162,0.3032,1.5732,0.6684,0.4516,0.2006,1.78137467,0.8126463953333334,0.31490288666666666,1.2909,2.5532,0.3126,2.7065,0.3924,-35.3775,1.4057,3.3047,0.3205,3.8251,0.3943,0.7515,1.4168658333333333,2.9092630033333333,2.8632121433333335,0.37968169133333335,0.302623514,0.7286,4.7008,0.5058,3.2228,0.6217,0.9733,0.074,0.388,0.42,0.01,1.778,177.8,104,0.3081481481481481,1,0,4,5,FALSE,FALSE,FALSE
417,2021-11-13T05:06:13Z,1,1.7777777777777777,864,6,3,2,2,2,4,3,1,3,3,2,1,2,3,2,3,3,2,3,1,1,1,2,3,3,1,3,0,0,4,5,5,4,3,3,4,4,4,3,3,2,2,3,4,5,1,2,2,3,3,3,1,1,1,2,1,1,2,1,1,4,1,3,2,2,1,1,2,3,2,2,0,2,0,2.533333333333333,0,2,0,2.4166666666666665,0,1.3333333333333333,0,1.4285714285714286,0,1.6666666666666667,0,1.945945945945946,0,1,0,0,-0.1895796577779768,-0.07315790414621297,-0.22054348261253207,-0.1468506933793725,4,2,3,2,1,2,2,2,0,2,0.06413940681375631,5,5,4,5,3,3,2,4.142857142857143,0,1.8571428571428572,2.0842459175790595,0,2,2,2,1,2,2,4,4,2,3,3,4,3,4,5,5,4,3,3,4,1.8,0,3.6,0,2.8,0,3.4,0,3.2666666666666666,0,1,1,1,2,2,1,2,2,1,1,2,3,1,3,1,2,1,1,1,2,1.65,0,"Asian or Asian American (e.g., Chinese, Japanese, and others)",0,24,0,1,NA,5,2,0,0,1,0,0,TRUE,TRUE,TRUE,TRUE,TRUE,0,1,0.8029358974374258,0.78,0.10288383957514792,1,0.4724900000075499,0.6194903225879516,1,0.96875,0.003149394723406389,0.02702938641137846,1,0.5266593750044704,0.6167806451551375,1,0.96875,0.007120021845557834,0.007189200282562015,1.446,0.8995,0.38,1.2398,1.0396,0.4739,0.3544,1.45965036,0.9047189836333334,0.3749161066666667,1.7043,5.5711,0.3195,2.8659,0.3341,-57.2116,0.9161,4.8312,0.3838,2.6681,0.4638,0.8641,1.6843539533333334,2.92930158,5.27869307,0.336246008,0.3158130416666667,0.9913,4.2541,0.4192,4.4119,0.5064,0.9989,0.079,0.368,0.541,0.015,1.737,115.80000000000001,420,1.2444444444444445,1,0,0,1,FALSE,FALSE,FALSE
418,2021-11-13T05:31:03Z,1,1.7786458333333333,768,4,3,5,5,2,5,1,1,5,1,1,1,2,4,1,4,3,1,1,1,1,1,1,1,1,0,2,0,0,4,5,5,5,5,5,5,5,5,1,5,1,1,5,1,5,1,1,1,1,3,5,1,1,1,1,1,1,1,1,1,5,1,1,1,1,1,1,1,1,1,1,0,1,0,1.4,0,1.1111111111111112,0,1.1666666666666667,0,0.8333333333333334,0,0.8571428571428571,0,1,0,1.0810810810810811,0,0,0,0,-1.3495414005538688,-1.3616293442703125,-0.7372407672780129,-1.0494350557741627,5,2,3,1,1,1,1,1.4285714285714286,0,1,-0.6467170085812028,5,5,5,5,2,2,1,4.142857142857143,0,1.8571428571428572,-0.7395711320441822,0,2,2,2,1,2,2,3,5,1,1,2,2,2,5,3,2,4,2,3,4,1.8,0,3.6,0,3,0,3.2,0,3.2666666666666666,0,3,1,2,3,2,3,2,3,1,1,2,3,2,3,1,3,1,2,1,2,1.85,0,"White, Caucasian, Anglo, European American",0,26,0,1,NA,5,2,1,0,1,0,1,TRUE,TRUE,TRUE,TRUE,TRUE,0,NA,NA,NA,NA,3,0.5402419354836306,0.6126464285709496,0.96875,0.875,0.01156988958670178,0.019860680393371594,3,0.6473906250004656,0.6828774193542139,1,0.96875,0.018634296361092623,0.01228533136089609,NA,NA,NA,NA,NA,NA,NA,NA,NA,NA,0.9916,3.3084,0.4048,1.9919,0.4475,-48.0429,0.9698,3.7038,0.399,3.1248,0.4472,0.7912,1.118991725,2.281829724,3.60554021,0.4338546773333333,0.3924836763333333,1.172,3.4099,0.4849,3.5056,0.5228,0.9821,0.081,0.441,0.402,0.036,1.658,46.05555555555556,444,1.3155555555555554,1,0,0,1,FALSE,FALSE,FALSE
419,2021-11-13T06:10:15Z,1,1.7777777777777777,720,4,2,4,5,3,4,3,1,5,1,2,1,1,5,1,5,3,1,1,1,1,1,1,1,1,0,2,0,0,5,4,5,5,3,5,5,5,5,2,5,1,1,4,2,5,2,1,1,1,1,5,1,1,1,3,1,1,1,1,1,4,2,1,1,1,1,1,2,1,1,1,0,1.25,0,1.6,0,1.3333333333333333,0,1.3333333333333333,0,1.1666666666666667,0,1.1428571428571428,0,1,0,1.2972972972972974,0,0,0,0,-1.2150530825508667,-1.182761013339623,-0.6588395645607719,-0.9208002889501974,5,2,3,2,1,3,2,2,0,1,-0.3048482679606258,5,5,5,5,2,2,2,4,0,2,-0.7395711320441822,0,2,2,2,1,2,2,4,3,2,4,1,4,1,4,5,1,4,2,3,2,1.8,0,4.2,0,4.2,0,4,0,4.133333333333334,0,1,1,1,4,1,1,2,4,1,1,2,4,1,1,1,4,1,1,1,2,1.15,0,"White, Caucasian, Anglo, European American",0,18,0,1,NA,5,2,0,0,1,0,0,TRUE,TRUE,TRUE,TRUE,TRUE,0,3,0.6864157894747822,0.76,0.020677335118759067,3,0.47674375000037256,0.503734375,1,1,0.004740496088866463,0.0030912087798055524,3,0.5707999999960884,0.6603312499951571,1,1,0.007670987097170276,0.0053720435071775655,1.0871,1.137,0.4439,0.8739,1.2362,0.5193,0.0375,1.1462482843333333,1.0670981413333334,0.4363915176666667,3.4622,7.0294,0.2305,8.5111,0.3003,-91.4818,0.7343,4.0541,0.3984,4.217,0.4317,0.9205,1.7323503,5.64369238,4.914694273333334,0.3578531033333333,0.30191213466666666,1.3639,4.2975,0.4279,10.3982,0.5889,0.7502,0.213,0.234,0.63,0.014,1.507,107.64285714285714,373,1.1051851851851853,1,0,1,2,FALSE,FALSE,FALSE
420,2021-11-13T06:08:31Z,1,1.7786458333333333,768,4,2,5,5,5,5,5,3,3,2,2,2,1,2,1,2,2,1,1,1,1,1,1,1,1,3,3,0,0,5,5,5,5,5,5,5,5,5,1,5,1,1,3,3,5,1,1,1,1,1,5,1,1,1,1,1,1,2,2,1,5,1,1,1,1,1,1,1,3,3,1,0,2,0,2.6,0,1,0,1.3333333333333333,0,0.8333333333333334,0,1.1428571428571428,0,1,0,1.162162162162162,0,2,0,0,-1.299108281302743,-0.8110865594576713,-0.01745100881601569,-0.4142687841368435,3,3,3,2,1,4,4,2.857142857142857,0,3.5,1.1304240299061954,5,5,5,5,5,5,1,5,0,1,0.10757398284279028,0,4,2,4,1,4,3,2,2,4,2,2,3,2,4,4,4,4,4,2,2,3,0,3.2,0,2.4,0,3.6,0,3.066666666666667,0,1,1,1,1,1,1,1,3,2,1,2,3,4,3,1,3,1,2,1,2,1.75,0,"Hispanic of Latino (e.g., Mexican American, Central American, and others)",0,24,0,1,NA,5,2,0,0,0,0,0,TRUE,TRUE,TRUE,TRUE,TRUE,0,4,0.7355128205143489,0.78,0.018103193469785672,4,0.5343187500033527,0.5253437499981374,1,1,0.006318385443325065,0.005184663830345921,4,0.624512499999255,0.6447625000011176,1,1,0.014636934033323043,0.01141505403108044,1.1163,1.2149,0.4766,0.9123,1.4104,0.5582,0.2338,1.1741988233333334,1.101572652,0.4681886536666667,1.7509,5.2282,0.3669,5.4502,0.3647,-83.5464,1.0174,4.1937,0.4169,4.3996,0.4144,0.9993,1.6860241686666666,4.96439849,4.894307983333333,0.3615073223333333,0.3636343186666667,1.0057,5.2918,0.532,6.266,0.5714,0.8281,0.299,0.133,0.609,0.078,1.879,24.08974358974359,376,1.114074074074074,1,0,0,1,FALSE,FALSE,FALSE
421,2021-11-13T06:14:26Z,1,1.7777777777777777,864,3,1,3,3,3,3,5,3,2,2,4,2,3,2,3,3,1,3,4,1,1,3,3,3,3,1,2,0,0,1,1,1,1,1,1,1,1,2,4,3,3,2,1,3,1,3,4,3,3,4,2,1,1,1,5,4,1,2,1,1,3,2,3,2,3,3,2,1,1,1,2.625,0,1.25,0,3.3333333333333335,0,4.888888888888889,0,3.5,0,2.5,0,1.7142857142857142,0,2.6666666666666665,0,3.324324324324324,0,1,0,0,1.0565386637185885,1.131589993632082,-0.4557470907642554,0.3379214514339133,4,1,1,3,1,1,1,2,0,5,1.1711024311369027,1,1,1,1,1,1,5,1,0,5,1.5194825076544112,0,2,2,3,2,2,2,3,2,2,3,3,4,2,3,3,4,4,3,3,2,2.2,0,3.6,0,3,0,3.6,0,3.4,0,3,4,4,1,3,4,4,1,4,3,4,1,3,4,2,1,1,4,3,3,3.45,0,"White, Caucasian, Anglo, European American",0,28,0,1,NA,5,2,0,0,1,0,0,TRUE,TRUE,TRUE,TRUE,TRUE,0,6,0.8768894736843037,0.76,0.04784965851428018,6,0.4332187500001164,0.5639620689654338,1,0.90625,0.0036773989919290976,0.012763782540322843,6,0.6304531250001164,0.7131000000000771,1,0.9354838709677419,0.010998278054415623,0.017029244989220656,1.5639,0.7858,0.3847,1.0069,0.93,0.6839,0.4725,1.5543290466666666,0.823373056,0.38198277766666666,1.4955,4.3568,0.2616,2.4488,0.3011,-49.7371,0.8092,5.6466,0.3641,3.4018,0.4514,0.9836,1.5274991466666668,2.6152410433333335,4.445536066666667,0.3015525626666667,0.26021021266666666,1.1621,5.6126,0.525,3.1085,0.537,0.9671,0.073,0.454,0.421,0.02,1.962,98.1,330,0.9777777777777777,1,0,1,2,FALSE,FALSE,FALSE
422,2021-11-13T06:12:48Z,1,1.7777777777777777,1080,6,4,3,4,3,5,5,4,4,4,3,3,3,4,2,3,5,2,3,1,1,1,2,3,2,0,2,0,0,5,5,4,5,4,5,4,5,4,4,4,2,2,4,2,5,3,2,3,3,3,5,1,1,1,4,1,1,1,1,1,3,5,4,1,1,2,2,1,1,2,1.875,0,1.5,0,2.7333333333333334,0,1.4444444444444444,0,2.4166666666666665,0,1.3333333333333333,0,2.142857142857143,0,1.3333333333333333,0,1.9189189189189189,0,0,0,0,-0.28414175637383765,-0.05254158678244845,-0.5804383618435307,-0.3164899743129896,5,1,3,1,1,2,2,1.5714285714285714,0,2,-0.19226214865167657,5,5,5,5,3,3,2,4.285714285714286,0,1.7142857142857142,-1.0219528370065065,0,3,2,3,4,3,3,4,4,3,3,2,5,3,4,5,3,5,1,3,4,3,0,4.4,0,3.2,0,3.2,0,3.6,0,2,1,1,4,3,1,2,3,2,2,2,3,1,2,2,3,1,2,1,2,1.7,0,"White, Caucasian, Anglo, European American",0,30,0,1,NA,5,2,0,0,1,0,0,TRUE,TRUE,TRUE,TRUE,TRUE,0,5,1.024551282060452,0.78,0.12727284498194968,5,0.46216874999552965,0.5212968750074506,1,1,0.002162136411175593,0.0027128699890755547,5,0.6470156249962747,0.6697687500044703,1,1,0.009070872974773648,0.0024780306057277605,1.6172,0.8247,0.4692,1.3214,0.9742,0.6137,0.1575,1.6045100966666668,0.8371657786666666,0.46454960266666667,2.6865,8.1984,0.2983,8.0076,0.3535,-104.7677,0.4448,5.947,0.4342,6.2065,0.4877,0.7304,1.4686315773333334,5.528291533333333,5.705781093333333,0.39606097366666665,0.3382404153333333,0.8665,2.8785,0.537,7.179,0.6059,0.9537,0.222,0.356,0.781,0.034,1.492,43.882352941176464,350,1.0370370370370372,1,0,0,1,FALSE,FALSE,FALSE
423,2021-11-13T06:14:48Z,1,1.7777777777777777,864,3,3,4,5,2,5,2,1,4,1,2,2,1,5,1,5,4,1,2,1,1,1,1,2,1,1,2,0,0,5,2,4,5,3,4,4,5,3,2,4,2,1,4,2,3,4,2,4,5,3,4,1,1,1,1,1,1,2,3,1,4,2,2,1,1,1,2,5,1,2,1.25,0,2.5,0,1.4666666666666666,0,2.111111111111111,0,2.6666666666666665,0,1,0,1.7142857142857142,0,1,0,2,0,1,0,0,-0.6224639313501394,-0.8306381843754198,-0.06374107717804986,-0.44718963077673485,5,1,4,1,1,2,2,1.4285714285714286,0,1,-0.6467170085812028,4,5,5,5,4,4,2,4.428571428571429,0,1.5714285714285714,0.9547190977297628,0,2,2,1,1,1,2,4,2,1,2,2,4,1,3,3,4,3,2,3,5,1.4,0,3.8,0,3.2,0,3.2,0,3.4,0,1,1,2,1,1,1,1,4,1,1,2,4,2,2,1,3,1,1,1,2,1.45,0,"White, Caucasian, Anglo, European American",0,23,0,1,NA,5,2,0,0,1,0,0,TRUE,TRUE,TRUE,TRUE,TRUE,0,2,1.0948484848475817,0.66,0.09997247807750388,2,0.5434656249992549,0.5771333333363136,1,0.9375,0.0026197100701820337,0.003534897086750826,2,0.7010812499998137,0.7680677419343303,1,0.96875,0.01163892931499311,0.009189492006699131,1.3902,0.4795,0.6616,1.4527,0.3476,0.6477,0.0385,1.44278794,0.6226967383666666,0.645268949,1.2567,5.3942,0.427,3.4364,0.4179,-79.2162,0.8072,4.9136,0.4677,4.9488,0.4993,0.9627,1.4173545686666666,3.63468844,5.3700589433333334,0.405365314,0.41443524466666665,1.0346,3.7177,0.5794,3.8763,0.6396,0.9956,0.08,0.479,0.376,0.014,1.647,117.64285714285714,104,0.3081481481481481,1,0,0,1,FALSE,FALSE,FALSE
424,2021-11-13T06:20:30Z,0.8999999761581421,1.7777777777777777,1080,6,2,5,3,3,3,3,1,4,2,2,1,1,5,1,5,5,1,1,1,1,1,1,1,1,2,3,0,1,5,3,2,3,5,5,1,1,2,1,5,1,1,3,1,5,3,1,1,1,1,1,1,5,3,4,2,1,2,1,1,5,1,1,1,1,1,2,2,2,2,1,0,2,0,1.7333333333333334,0,3,0,1.3333333333333333,0,3.1666666666666665,0,1,0,1,0,2,0,1,0,1,-0.7779660490411104,-0.8234757079204031,-0.04409383571335133,-0.43378477181687725,2,5,1,5,5,5,5,4.857142857142857,0,5.5,3.0649399716269796,3,3,3,2,1,1,5,2,0,4,0.9547190977297628,0,1,1,1,1,1,1,4,1,1,5,1,5,1,5,5,1,5,1,5,3,1,0,5,0,4.8,0,4.6,0,4.8,0,1,1,1,4,4,2,1,4,1,1,2,4,1,1,1,4,1,2,1,2,1.35,0,"Hispanic of Latino (e.g., Mexican American, Central American, and others)",0,29,0,1,NA,5,2,0,0,1,0,0,TRUE,TRUE,TRUE,TRUE,TRUE,0,1,0.8424874999985099,0.8163265306122449,0.07305979612325515,1,0.4810999999960264,0.5228374999994412,1,1,0.0029253227586011213,0.0053127682261253995,1,0.836593749997206,1.0667064516082887,1,0.96875,0.14918716770493085,0.4744848692629974,1.4647,1.0709,0.4125,1.162,1.1139,0.5527,0.2954,1.4789410266666667,1.0241106413333334,0.406872568,3.8471,9.0793,0.2692,7.1566,0.2541,-88.4226,0.8164,6.493,0.4206,4.9052,0.4488,0.9083,1.7235089673333333,4.68896688,5.857901233333333,0.343327051,0.339089265,2.782,2.022,0.1419,1.6252,0.1828,0.7711,0.119,0.217,0.164,0.024,1.611,67.125,104,0.3081481481481481,1,0,0,1,FALSE,FALSE,FALSE
425,2021-11-13T06:22:56Z,0.8999999761581421,1.6,800,6,3,4,4,2,4,2,2,3,2,3,2,2,4,2,4,3,1,3,1,1,1,1,2,1,2,2,0,0,4,2,4,4,3,5,2,3,2,2,4,1,1,2,1,3,3,1,1,2,4,5,1,1,1,2,1,2,2,3,2,4,2,2,1,1,1,1,1,2,2,1.375,0,1.5,0,2.2,0,2.7777777777777777,0,2.0833333333333335,0,1,0,2,0,1,0,2.027027027027027,0,1,0,0,-0.5279018327542786,-0.45015582025824447,-0.3773458880470143,-0.41375085415262935,5,2,3,1,1,1,1,1.4285714285714286,0,1,-0.6467170085812028,4,5,5,5,1,1,1,3.7142857142857144,0,2.2857142857142856,-1.3043345419688306,0,4,4,4,2,4,4,4,4,3,3,2,3,1,2,2,5,3,1,2,4,3.6,0,3.4,0,3,0,2.2,0,2.8666666666666667,0,2,2,2,3,3,2,2,3,1,2,2,2,1,4,1,2,1,1,1,2,1.95,0,"Asian or Asian American (e.g., Chinese, Japanese, and others)",0,25,0,1,NA,5,2,0,0,1,0,0,TRUE,TRUE,TRUE,TRUE,TRUE,0,1,0.6924,0.8,0.01080436285714286,1,0.43253125,0.46820689655172415,1,0.9354838709677419,0.001855934475806452,0.004738879569892474,1,0.6363548387096775,0.7162413793103448,0.96875,0.90625,0.017113544354838705,0.01208618951612903,1.2726,1.2563,0.3865,0.7291,1.5557,0.5959,0.225,1.3109936266666666,1.1288568396666667,0.380039653,1.0045,5.2882,0.3376,3.4902,0.3374,-87.5999,0.802,6.6304,0.3734,4.758,0.3819,0.9999,1.0944780853333334,3.6338869066666666,5.279529833333333,0.33088331,0.331752241,1.1145,2.9872,0.4561,3.6146,0.5605,0.9267,0.066,0.442,0.382,0.013,1.738,133.6923076923077,404,1.1970370370370371,1,0,1,2,FALSE,FALSE,FALSE
426,2021-11-13T06:19:13Z,1,1.7777777777777777,1080,3,2,3,3,2,3,2,3,3,3,2,2,3,2,1,3,1,2,3,1,3,2,3,3,2,8,2,0,0,3,1,2,2,1,2,2,3,3,2,5,3,1,3,3,2,4,3,3,3,3,4,1,1,1,4,3,3,5,5,4,2,4,4,3,3,2,2,2,4,4,2.375,0,3,0,2.8,0,3.888888888888889,0,2.75,0,1.8333333333333333,0,4,0,2.6666666666666665,0,3.1621621621621623,0,4,0,0,0.8001703075253659,0.7252646401434276,0.7023387496459815,0.7138016948947046,3,3,2,3,2,3,3,3,0,2,0.6624097028997663,3,4,4,3,1,1,5,2.4285714285714284,0,3.5714285714285716,0.38995568780511447,0,3,3,3,2,3,3,4,3,4,3,1,3,2,3,3,5,3,2,3,4,2.8,0,3.6,0,3,0,2.6,0,3.066666666666667,0,2,1,2,3,2,2,2,3,2,2,3,3,2,1,2,3,1,2,2,2,1.9,0,"White, Caucasian, Anglo, European American",0,25,0,1,NA,5,2,0,0,1,0,0,TRUE,TRUE,TRUE,TRUE,TRUE,0,4,0.9570945945954,0.7551020408163265,0.07567686666690143,4,0.47608620689655173,0.5860249999994412,0.9666666666666667,1,0.0019588859881392996,0.006363889031505229,4,0.719515625002794,0.8421375000039115,1,1,0.011204809102974425,0.02324834242027868,1.4057,0.83,0.5876,0.6078,1.2597,0.9079,0.616,1.4518424666666667,0.86141635,0.575183055,1.4028,5.4499,0.3465,4.1977,0.4289,-81.0792,1.0476,7.4102,0.4122,4.862,0.4775,0.8486,1.6168611963333333,4.563406473333333,4.473356036666667,0.41227948833333333,0.30259836,1.1477,5.3095,0.6056,2.3278,0.6529,0.9568,0.095,0.484,0.371,0.023,1.88,81.73913043478261,298,0.882962962962963,1,0,0,1,FALSE,FALSE,FALSE
427,2021-11-13T05:44:47Z,1,1.6,900,4,2,4,4,2,4,2,1,3,2,1,1,3,4,1,4,4,2,3,1,2,1,2,1,3,3,2,0,0,5,5,4,4,4,4,4,4,4,2,4,1,1,3,1,4,2,1,2,2,4,3,1,1,1,3,1,1,2,2,1,4,1,1,1,1,2,2,2,2,2,1.875,0,2,0,1.8666666666666667,0,1.7777777777777777,0,1.9166666666666667,0,1.5,0,1.2857142857142858,0,1.3333333333333333,0,1.7027027027027026,0,2,0,0,-0.41863007437683963,-0.5179089759138089,-0.01745100881601569,-0.2676799923649123,5,1,4,1,1,1,1,1.1428571428571428,0,1,-0.8176513788914915,5,5,5,4,3,3,2,4.142857142857143,0,1.8571428571428572,-0.7395711320441822,0,4,3,4,3,4,3,3,5,2,2,4,3,2,3,3,4,2,2,3,4,3.6,0,2.8,0,2.8,0,2.6,0,2.7333333333333334,0,1,1,1,2,2,1,1,3,2,1,1,4,1,2,2,4,1,1,2,1,1.4,0,"White, Caucasian, Anglo, European American",0,23,0,1,NA,5,2,0,1,2,0,1,TRUE,TRUE,TRUE,TRUE,TRUE,0,1,1.0555421052645695,0.7755102040816326,0.1856584202292594,1,0.3911517241371089,0.46788928571449856,0.90625,0.875,0.001920281895034938,0.003900813216004493,1,0.5300000000009313,0.6621499999985099,1,0.875,0.005194170967888831,0.008971347378889374,1.6102,0.7942,0.5295,1.3512,0.8826,0.6462,0.3558,1.6081906,0.8217622986666666,0.5217470706666667,0.7309,3.9085,0.3101,2.459,0.3518,-78.4708,0.6904,5.0408,0.3222,3.7801,0.3849,0.9967,0.786202969,2.782119261666667,4.148927806666666,0.348138977,0.3062402613333333,0.7191,3.8156,0.4546,2.7036,0.5681,0.9317,0.059,0.398,0.424,0.009,1.613,179.22222222222223,404,1.1970370370370371,1,0,3,4,FALSE,FALSE,FALSE
428,2021-11-13T06:23:10Z,0.8999999761581421,1.7777777777777777,900,4,2,3,5,1,4,1,1,5,1,3,1,1,4,1,4,4,1,1,1,1,3,1,2,1,1,2,0,0,3,3,5,5,5,5,5,5,5,1,5,1,1,5,1,5,3,2,2,1,1,5,1,1,1,2,2,1,1,3,1,5,1,5,1,1,1,2,2,1,2,1.375,0,1.75,0,1.5333333333333334,0,1.4444444444444444,0,1.3333333333333333,0,1.1666666666666667,0,1.7142857142857142,0,1,0,1.4324324324324325,0,1,0,0,-0.8977447072625341,-0.9921810655027575,-0.2989446853297732,-0.6455628754162653,5,1,4,1,1,1,2,1.2857142857142858,0,1.5,-0.5476903563491562,5,5,5,5,2,1,1,4,0,2,-0.4571894270818581,0,2,2,1,1,2,2,5,1,1,3,1,5,1,5,5,1,4,1,5,3,1.6,0,4.6,0,4.6,0,4.6,0,4.6,0,2,1,2,3,1,3,4,4,1,2,2,3,3,2,1,4,2,2,2,1,1.85,0,"White, Caucasian, Anglo, European American",0,20,0,3,NA,5,2,0,0,1,0,0,TRUE,TRUE,TRUE,TRUE,TRUE,0,1,1.1096999999996275,0.8,0.2977239618325536,1,0.4853843749985099,0.5621266666685542,1,0.9375,0.0031829897480949963,0.00497261512113743,1,0.6064874999988824,0.7431333333328366,1,0.967741935483871,0.004072915967858616,0.013358504623869949,2.0479,0.7323,0.3174,1.5025,0.7898,0.6031,0.084,1.8893958566666667,0.7384249656666667,0.33021199966666664,1.241,5.601,0.3746,3.1414,0.3808,-77.7685,0.9256,5.8797,0.4054,4.178,0.4533,0.9636,1.35283617,3.33094911,5.4931607,0.3726959536666667,0.3656044093333333,1.3294,5.486,0.4868,3.8608,0.5704,0.9997,0.081,0.469,0.585,0.009,1.434,159.33333333333334,104,0.3081481481481481,1,1,1,2,FALSE,FALSE,FALSE
429,2021-11-13T06:24:34Z,0.8999999761581421,1.778125,960,4,4,5,5,2,5,1,2,4,2,1,1,1,4,3,4,3,1,1,1,1,1,1,1,1,1,2,0,0,4,1,4,4,3,5,3,3,4,2,4,1,1,3,1,5,1,1,1,1,1,5,1,1,1,1,1,1,1,1,1,5,1,1,1,1,1,1,2,2,2,1,0,1.75,0,1.6666666666666667,0,2.5555555555555554,0,1.3333333333333333,0,0.8333333333333334,0,0.8571428571428571,0,1,0,1.4864864864864864,0,1,0,0,-1.0973758042982402,-1.072807320732879,-0.2989446853297732,-0.6858760030313261,5,1,5,1,1,1,1,1,0,2,-0.5341308892722537,5,5,5,5,2,2,1,4.142857142857143,0,1.8571428571428572,-1.3043345419688306,0,3,3,3,3,3,2,4,3,2,3,1,3,1,3,3,2,5,2,3,3,3,0,4.2,0,3.8,0,3.2,0,3.7333333333333334,0,2,1,1,4,2,1,1,3,1,1,2,3,1,1,1,3,1,2,1,1,1.35,0,"White, Caucasian, Anglo, European American",0,22,0,1,NA,5,2,0,0,1,0,0,TRUE,TRUE,TRUE,TRUE,TRUE,0,5,1.0171249999983443,0.72,0.08262335526972343,5,0.4908093749997206,0.5794999999971159,1,0.96875,0.008361904748076495,0.013263363225820928,5,0.6292499999981374,0.7481124999988824,1,1,0.010443739999673561,0.02685186435467746,1.5127,0.6597,0.5538,1.106,0.5586,0.7562,0.202,1.53488215,0.7399888186666667,0.5441060896666666,1.275,4.454,0.3477,3.014,0.3771,-64.2888,1.0837,4.8058,0.3749,3.0848,0.4171,0.9994,1.4420763906666667,3.2492719966666668,4.665326813333333,0.3632484503333333,0.336090995,1.2757,3.7375,0.4756,3.3199,0.5476,0.9612,0.232,0.229,0.557,0.02,1.791,89.55,236,0.6992592592592592,1,0,0,1,FALSE,FALSE,FALSE
430,2021-11-13T06:25:00Z,1,1.7777777777777777,1080,6,3,5,5,1,5,1,1,5,1,1,1,1,5,2,5,5,2,2,1,1,1,1,1,1,0,2,0,0,5,5,5,5,5,5,4,4,5,1,5,1,1,5,1,5,1,1,1,2,1,5,1,1,1,2,1,1,1,1,1,5,1,1,1,1,1,1,1,1,1,1.25,0,1,0,1.0666666666666667,0,1.2222222222222223,0,1.0833333333333333,0,1,0,0.8571428571428571,0,1,0,1.1081081081081081,0,0,0,0,-1.1772282431125227,-1.3858268998615852,-0.7372407672780129,-1.061533833569799,5,1,5,1,1,1,1,1,0,1,-0.9031185640466358,5,5,5,5,2,2,1,4.142857142857143,0,1.8571428571428572,-0.4571894270818581,0,3,3,2,3,2,2,5,1,1,5,1,4,1,5,4,1,5,1,3,1,2.6,0,4.6,0,4.6,0,4.8,0,4.666666666666667,0,1,1,2,3,4,2,2,2,1,2,2,3,1,1,1,3,1,2,2,3,1.85,0,"White, Caucasian, Anglo, European American",0,27,0,1,NA,5,2,0,0,1,0,0,TRUE,TRUE,TRUE,TRUE,TRUE,0,6,0.8390552631569536,0.76,0.05533297380012391,6,0.4636718750002328,0.5057343750002329,1,1,0.0030311278931665748,0.003330558457585537,6,0.618962500001071,0.7208000000007451,1,1,0.007456317903330582,0.014605549032152382,1.3544,0.9033,0.4818,0.9878,0.8974,0.6315,0.1448,1.39487357,0.912097888,0.47391626266666664,2.4448,8.335,0.317,6.697,0.3232,-100.8521,0.5556,6.1415,0.4168,7.1277,0.4682,0.7135,1.6012883593333334,5.055547366666667,6.14481296,0.3532860896666667,0.33910553066666665,0.9733,4.4351,0.5193,3.4445,0.5815,0.8146,0.109,0.403,0.513,0.014,1.569,112.07142857142857,336,0.9955555555555555,1,0,1,2,FALSE,FALSE,FALSE
431,2021-11-13T06:27:53Z,0.8999999761581421,1.7777777777777777,1080,6,3,3,5,1,3,1,3,1,1,1,1,1,4,1,4,1,4,1,5,1,3,3,2,4,1,1,0,1,5,4,1,5,4,4,5,5,5,2,5,1,1,3,1,5,5,1,4,1,1,1,1,2,1,3,2,1,2,1,1,3,4,1,1,2,1,2,1,1,1,2.875,0,1.25,0,2.066666666666667,0,1.7777777777777777,0,1.8333333333333333,0,2.1666666666666665,0,1.7142857142857142,0,1.3333333333333333,0,1.864864864864865,0,1,0,1,0.30424463488929604,0.06747828895026543,-0.27929744386507466,-0.10590957745740462,5,1,4,1,1,1,4,1.5714285714285714,0,1.5,-0.3767559860388676,3,4,4,4,1,2,4,2.857142857142857,0,3.142857142857143,-1.0219528370065065,0,1,1,1,1,1,1,5,1,1,2,1,5,1,5,5,1,5,3,5,5,1,0,4.6,0,4.4,0,4.2,0,4.4,0,1,2,2,4,2,3,4,3,2,1,2,3,2,3,1,3,1,3,1,3,2,0,"White, Caucasian, Anglo, European American",0,26,0,1,NA,5,2,0,0,1,0,0,TRUE,TRUE,TRUE,TRUE,TRUE,0,3,0.6786931818188592,0.88,0.04101521715924314,3,0.4572937500001863,0.5198903225785302,1,1,0.006947921250636234,0.0077454189032154334,3,0.5626645161269173,0.6790464285697256,1,0.875,0.016099027698432834,0.017526299959010918,1.343,1.5576,0.3625,1.1321,1.5555,0.4345,0.2022,1.3475961166666666,1.2948777626666668,0.357440076,4.2668,6.7503,0.1413,6.7033,0.2016,-70.07,0.9823,4.5053,0.3495,5.2307,0.4232,0.9829,1.90653077,4.692045646666666,4.378326263333333,0.3212422386666667,0.23870258166666666,0.8492,3.1428,0.4636,3.3897,0.5624,0.771,0.089,0.293,0.383,0.008,1.852,231.5,104,0.3081481481481481,1,0,10,11,FALSE,FALSE,FALSE
432,2021-11-13T06:15:46Z,1,1.7786458333333333,768,3,2,2,3,3,2,3,5,2,4,4,5,5,2,2,1,2,4,5,5,3,4,4,5,4,6,2,3,50,3,2,3,2,2,2,1,1,2,5,2,5,5,2,5,2,5,5,5,5,5,2,5,5,5,5,5,4,5,5,5,2,4,4,5,5,5,4,4,5,5,4.25,0,4.5,0,3.933333333333333,0,4,0,4.75,0,4.666666666666667,0,4.285714285714286,0,5,0,4.54054054054054,0,3,3,6,2.823799217476786,2.6104478011483163,2.6482509963270675,2.629349398737692,3,4,1,4,1,3,4,3.4285714285714284,0,5,2.0257742826883454,1,4,3,4,2,1,5,2.2857142857142856,0,3.7142857142857144,0.38995568780511447,0,2,2,3,1,2,2,4,2,2,4,1,4,2,4,3,2,4,3,5,4,2,0,4,0,4.2,0,3.4,0,3.8666666666666667,0,2,1,1,4,2,2,2,3,2,2,2,3,2,1,2,3,2,2,2,2,1.8,0,"White, Caucasian, Anglo, European American",0,21,0,1,NA,5,2,0,1,3,0,1,TRUE,TRUE,TRUE,TRUE,TRUE,0,3,1.0842289473696758,0.7755102040816326,0.10866586583424077,3,0.6693781249988824,0.7552468750011175,1,1,0.038970809505978435,0.03610589741017762,3,1.1069249999988824,1.314828125,1,1,0.06449302645361911,0.1628523001507486,1.5168,0.858,0.5909,1.4168,0.7851,0.6467,0.1807,1.53446258,0.8733825396666667,0.5799031583333333,2.2184,2.6935,0.2576,3.5261,0.4407,-25.9735,1.4472,2.1477,0.3894,3.056,0.5128,0.9902,2.1038262766666667,3.31348329,2.7695114166666666,0.43404971466666664,0.2743078153333333,2.0018,2.1458,0.6761,1.6708,0.7663,0.941,0.205,0.388,0.275,0.006,1.263,210.49999999999997,346,1.0251851851851852,1,0,1,2,FALSE,FALSE,FALSE
433,2021-11-13T05:51:13Z,1,1.7773766546329723,831,3,4,2,4,4,3,3,3,3,3,3,3,3,3,3,3,3,4,4,2,3,3,3,3,4,0,2,0,0,3,3,4,4,3,3,4,4,4,2,3,3,3,4,1,4,1,3,3,3,3,3,1,1,1,3,1,1,2,1,1,3,3,3,1,1,1,1,2,3,3,3.25,0,2.25,0,3.066666666666667,0,2.4444444444444446,0,2.4166666666666665,0,1.5,0,1.8571428571428572,0,1,0,2.108108108108108,0,0,0,0,0.6887971691791296,0.7629160366434483,-0.34523475369180734,0.2088406414758205,4,1,4,2,1,5,5,2.5714285714285716,0,5,1.51297117175748,4,4,4,4,3,3,2,3.7142857142857144,0,2.2857142857142856,-1.3043345419688306,0,2,2,2,2,2,2,4,2,2,4,2,4,2,4,2,2,4,4,4,3,2,0,3.6,0,4,0,3.4,0,3.6666666666666665,0,2,2,1,3,2,1,2,3,2,2,1,3,2,2,1,3,1,1,2,1,1.65,0,"Asian or Asian American (e.g., Chinese, Japanese, and others)",0,21,0,1,NA,5,2,0,0,0,0,0,TRUE,TRUE,TRUE,TRUE,TRUE,0,4,0.9240968749979511,0.6530612244897959,0.1367302666585981,4,0.6759750000024214,0.7680482758622745,1,0.9666666666666667,0.05702553419443631,0.05142254723065537,4,0.8569741935470412,0.9006766666680575,1,0.9375,0.052953451978067854,0.06576849383224978,1.7297,0.4011,0.3363,1.1961,0.3737,0.6249,0.0302,1.686816,0.5262987761333333,0.3373519623333333,1.5863,2.8137,0.3941,2.2234,0.4325,-21.9964,1.4934,2.7977,0.3848,2.7935,0.48,0.8605,1.8304958633333333,2.4674995566666666,3.0534749166666666,0.40508094733333333,0.3641553336666667,1.6306,2.9307,0.5687,2.1039,0.5343,0.9851,0.073,0.562,0.226,0.137,1.076,7.854014598540146,255,0.7555555555555555,1,1,13,14,FALSE,FALSE,FALSE
434,2021-11-13T06:30:14Z,NA,1.7777777777777777,720,6,3,2,3,3,3,3,1,1,1,1,1,1,3,1,3,3,1,1,1,1,1,1,1,1,0,4,0,0,3,3,3,3,3,3,3,3,3,1,3,1,1,3,1,1,1,1,1,2,2,4,1,1,1,1,1,1,1,1,1,1,1,1,1,1,1,2,2,2,2,1,0,2,0,2.4,0,3,0,1.8333333333333333,0,1,0,1.4285714285714286,0,1,0,1.8918918918918919,0,0,0,0,-0.8452102080426114,-0.5834359564549759,-0.4236359564090485,-0.5035359564320122,3,3,3,3,3,3,3,3,0,1,0.2934220281253842,3,3,3,3,3,3,3,3,0,3,-0.7395711320441822,0,1,1,1,1,1,1,1,1,1,1,1,1,1,3,3,1,3,3,3,3,1,0,3.4,0,3,0,3.8,0,3.4,0,1,1,1,1,1,1,3,3,1,1,1,3,1,1,1,3,1,1,1,1,1.4,0,"White, Caucasian, Anglo, European American",0,24,0,1,NA,5,2,0,0,1,0,0,TRUE,TRUE,TRUE,TRUE,TRUE,0,NA,NA,NA,NA,NA,NA,NA,NA,NA,NA,NA,2,1.4526580645172826,1.7716838709680784,1,1,0.3511400411828002,0.40203714806576013,NA,NA,NA,NA,NA,NA,NA,NA,NA,NA,NA,NA,NA,NA,NA,NA,NA,NA,NA,NA,NA,NA,NA,NA,NA,NA,NA,2.5342,1.1398,0.5462,1.2363,0.9085,0.9908,0.179,0.321,0.15,0.003,1.275,424.99999999999994,104,0.3081481481481481,1,1,6,7,TRUE,FALSE,FALSE
435,2021-11-13T06:38:42Z,1,1.7777777777777777,1080,6,3,5,4,3,4,1,1,4,1,1,1,1,4,1,4,4,1,1,1,1,1,1,1,1,1,4,0,0,5,4,4,4,3,4,2,5,5,2,5,3,1,5,2,5,1,1,2,2,2,5,1,1,1,1,1,1,3,3,3,5,1,2,1,1,1,1,1,1,2,1,0,1.25,0,1.5333333333333334,0,2,0,1.5833333333333333,0,0.8333333333333334,0,1.8571428571428572,0,1,0,1.6216216216216217,0,1,0,0,-1.0133206055463637,-1.072032998953958,-0.4557470907642554,-0.7638900448591067,5,1,4,1,1,1,1,1.1428571428571428,0,1,-0.8176513788914915,5,5,5,5,4,4,1,4.714285714285714,0,1.2857142857142858,-1.5867162469311549,0,3,3,3,3,3,3,4,2,2,4,1,4,2,3,4,1,4,1,4,2,3,0,4.2,0,4.2,0,3.8,0,4.066666666666666,0,3,1,1,3,1,1,3,3,1,2,3,3,4,3,2,3,1,1,2,3,2,0,"Asian or Asian American (e.g., Chinese, Japanese, and others)",0,22,0,1,NA,5,2,0,0,1,0,0,TRUE,TRUE,TRUE,TRUE,TRUE,0,3,0.5801111111135946,0.72,0.01428670612236901,3,0.44328387096620375,0.5245899999986092,0.96875,0.9375,0.00684076418370719,0.004043709828460586,3,0.5391624999982305,0.5996000000007691,1,0.96875,0.004436134032236067,0.005719382248326065,0.8968,1.0627,0.4207,0.8329,0.755,0.4483,0.0675,0.9598287686666667,1.0005541246666667,0.41366853366666667,0.8554,4.2182,0.3572,3.2804,0.4089,-83.0583,0.9077,5.1253,0.3565,4.8532,0.4264,0.9129,0.96203886,3.526518116666667,4.462734773333334,0.40112627566666664,0.3496818273333333,0.8492,6.3165,0.478,3.012,0.4933,0.7102,0.087,0.36,0.488,0.025,1.904,76.16,240,0.7111111111111111,1,0,2,3,FALSE,FALSE,FALSE
436,2021-11-13T06:39:59Z,1,1.7777777777777777,1080,4,2,4,4,1,4,1,1,4,1,1,1,1,4,1,4,4,1,1,1,1,1,1,1,1,1,2,1,1,4,4,4,4,4,4,3,3,4,1,1,1,1,3,1,3,2,1,1,1,1,5,1,1,1,1,1,1,2,2,1,4,3,1,1,1,1,2,1,2,2,1,0,1.75,0,1.4666666666666666,0,2.2222222222222223,0,1.75,0,0.8333333333333334,0,1.5714285714285714,0,1,0,1.6756756756756757,0,1,1,1,-0.9796985260456136,-1.0774532514064032,0.08413816916243128,-0.496657541121986,4,1,2,2,1,1,1,1.7142857142857142,0,1,-0.4757826382709144,4,4,4,3,3,3,1,3.7142857142857144,0,2.2857142857142856,2.0842459175790595,0,2,2,2,2,2,2,3,3,2,3,1,2,3,2,3,3,4,1,2,3,2,0,4,0,2.8,0,3,0,3.2666666666666666,0,1,1,1,2,1,1,1,3,2,2,1,3,1,1,1,3,1,1,1,1,1.35,0,"Hispanic of Latino (e.g., Mexican American, Central American, and others)",0,22,0,1,NA,5,2,0,0,1,0,0,TRUE,TRUE,TRUE,TRUE,TRUE,0,6,0.8298885714279753,0.7142857142857143,0.04028388273040863,6,0.4446785714285714,0.56696666666617,0.9032258064516129,0.9375,0.004712153978600934,0.017158363941265995,6,0.5077833333303531,0.5414592592622395,0.9375,0.8709677419354839,0.00416973741925732,0.004942486516204387,1.3125,0.7415,0.4803,1.0788,0.5888,0.6016,0.1275,1.3609856666666666,0.8188474376666667,0.47148676766666664,1.116,2.913,0.2823,2.1377,0.3294,-37.8009,0.8583,3.9526,0.3394,2.8698,0.4408,0.9973,1.1973178303333334,2.3758195466666665,3.24011525,0.32342508466666664,0.2775524483333333,0.7288,3.443,0.4235,3.0774,0.4443,0.9965,0.044,0.387,0.341,0.037,1.981,53.54054054054055,356,1.0548148148148149,1,0,0,1,FALSE,FALSE,FALSE
438,2021-11-13T06:31:52Z,1,1.6,900,4,3,4,5,2,4,2,2,4,2,2,2,2,4,2,4,5,1,2,1,1,1,1,2,2,1,3,0,0,5,3,3,4,4,4,3,3,4,2,5,2,2,3,2,5,1,2,2,3,3,4,1,1,1,1,2,1,2,1,1,5,1,3,2,2,1,2,2,2,2,1.375,0,2,0,1.8666666666666667,0,2.3333333333333335,0,2,0,1.1666666666666667,0,1.2857142857142858,0,1.6666666666666667,0,1.837837837837838,0,1,0,0,-0.6455791110069055,-0.6747091361452571,-0.22054348261253207,-0.4476263093788946,4,3,3,3,2,3,3,2.7142857142857144,0,2,0.49147533258947784,3,3,4,4,1,1,2,2.857142857142857,0,3.142857142857143,-0.1748077221195339,0,2,2,2,3,2,2,3,2,2,2,1,4,2,3,4,2,3,1,4,3,2.2,0,4.2,0,3.4,0,3.6,0,3.7333333333333334,0,2,1,2,3,1,2,2,2,1,1,1,3,3,2,1,2,1,2,1,2,1.75,0,"Asian or Asian American (e.g., Chinese, Japanese, and others) & Filipino",1,19,0,1,NA,5,2,0,0,0,0,0,TRUE,TRUE,TRUE,TRUE,TRUE,0,2,1.113658536585366,0.8367346938775511,0.1231800399659864,2,0.47090625,0.5291612903225806,1,1,0.0011783457661290325,0.0018830731182795694,2,0.5783125,0.6796875,1,1,0.008861576612903226,0.008176157258064516,1.6104,1.0601,0.6478,1.3735,0.8708,0.7213,0.0375,1.6084091533333333,0.9989722506666666,0.6345028803333334,7.3323,14.6042,0.2199,12.6491,0.2393,-117.3231,0.7245,6.079,0.4156,5.9031,0.4697,0.9361,1.5155916786666668,5.790119403333334,6.577304766666667,0.406329501,0.3629485963333333,1.0776,4.5056,0.4614,3.8971,0.5462,0.9996,0.176,0.321,0.712,0.015,1.747,116.46666666666668,432,1.28,1,0,0,1,FALSE,FALSE,FALSE
439,2021-11-13T06:44:18Z,1,1.7777777777777777,864,4,4,5,5,2,5,2,2,5,2,1,1,1,4,1,4,1,1,5,1,1,1,3,3,1,0,2,0,0,5,3,4,4,1,5,4,5,5,1,5,4,1,4,1,4,1,1,1,2,4,2,1,1,1,2,1,1,1,1,1,5,1,1,1,1,1,1,1,1,1,2,0,1,0,1.6666666666666667,0,2,0,1.75,0,1.5,0,0.8571428571428571,0,1,0,1.5945945945945945,0,0,0,0,-0.40812317453285496,-0.5965994266966284,-0.7372407672780129,-0.6669200969873206,5,1,5,1,1,1,1,1,0,1,-0.9031185640466358,5,5,5,5,3,3,1,4.428571428571429,0,1.5714285714285714,-1.0219528370065065,0,4,5,4,2,3,4,2,5,3,1,4,3,2,2,3,4,3,4,5,4,3.6,0,2.4,0,2.8,0,2.2,0,2.466666666666667,0,1,3,1,2,2,2,3,2,1,1,2,2,3,3,1,2,1,2,2,3,2.15,0,"White, Caucasian, Anglo, European American",0,19,0,1,NA,5,2,0,0,0,0,0,TRUE,TRUE,TRUE,TRUE,TRUE,0,3,0.911884210526306,0.76,0.03490334963674074,3,0.516737500000003,0.6010166666666589,1,1,0.027091165645160065,0.014913149712647749,3,0.6255483870967742,0.7236187499999979,0.96875,1,0.008760230554435628,0.008295118346775373,1.3574,0.9418,0.5477,0.9663,0.9158,0.705,0.1885,1.39797953,0.9369076996666666,0.5386743343333333,1.3051,4.0685,0.3563,4.0197,0.4387,-69.627,0.7289,5.3739,0.4332,3.6342,0.499,0.9374,1.5507400396666666,4.156832596666667,4.382735453333333,0.41641870766666667,0.33855205233333335,0.9747,3.6561,0.5061,4.7616,0.6158,0.7722,0.189,0.357,0.706,0.013,1.444,111.07692307692308,339,1.0044444444444445,1,1,2,3,FALSE,FALSE,FALSE
440,2021-11-13T06:38:51Z,0.8999999761581421,1.6,800,6,2,4,5,2,4,2,1,3,2,2,1,1,5,3,5,4,1,1,1,1,1,1,1,1,1,2,0,2,5,3,4,4,3,5,5,5,5,1,4,2,2,3,2,5,1,1,1,1,1,4,2,1,1,3,1,1,3,1,1,5,1,2,1,1,1,1,1,2,2,1,0,1.5,0,1.7333333333333334,0,1.6666666666666667,0,1.5,0,1.5,0,1.2857142857142858,0,1,0,1.5135135135135136,0,1,0,2,-1.0805647645478649,-1.032542588229001,-0.024446594248652788,-0.5284945912388268,5,1,3,1,1,2,2,1.5714285714285714,0,1,-0.5612498234260587,5,5,5,3,3,3,3,3.857142857142857,0,2.142857142857143,2.0842459175790595,0,1,2,2,2,2,1,5,1,1,1,1,4,2,3,5,3,5,2,3,3,1.8,0,4.6,0,3.2,0,4.2,0,4,0,1,1,1,3,1,1,2,3,1,1,1,3,1,1,1,3,1,1,1,1,1.25,0,"Hispanic of Latino (e.g., Mexican American, Central American, and others)",0,27,0,1,NA,5,2,0,0,1,0,0,TRUE,TRUE,TRUE,TRUE,TRUE,0,5,1.3407282051280713,0.78,0.38590284016736986,5,0.48356562499981376,0.5582781250001863,1,1,0.0011865752318470238,0.003511965635078265,5,0.6606937499997438,0.8020468749998836,1,1,0.008620976088601443,0.011028099344754568,1.8294,0.6789,0.5934,1.8614,0.7832,0.5297,0.0676,1.7849049933333334,0.715811075,0.585611906,3.7566,11.5385,0.3208,8.2204,0.3298,-110.1107,0.7679,7.3927,0.4325,5.1228,0.4885,0.9977,1.551467037,5.09778637,6.76472367,0.412057749,0.37595576133333336,1.218,5.2563,0.5429,3.7857,0.6593,0.9881,0.167,0.363,0.567,0.011,1.697,154.27272727272728,105,0.3111111111111111,1,1,4,5,FALSE,FALSE,FALSE
441,2021-11-13T06:50:58Z,1,1.7777777777777777,1080,6,2,2,3,5,2,3,4,1,5,3,3,4,2,3,1,3,4,5,2,2,4,4,3,3,0,3,0,0,4,2,4,4,4,4,5,5,2,2,4,5,3,3,3,4,5,5,3,5,5,3,1,1,1,2,1,3,1,1,1,2,4,4,3,4,5,3,1,1,1,3.375,0,1.5,0,3.8666666666666667,0,2.2222222222222223,0,3.5833333333333335,0,1.3333333333333333,0,2.4285714285714284,0,4,0,2.7567567567567566,0,0,0,0,1.1700131820336208,1.439189320308343,-0.5804383618435307,0.42937547923240615,1,5,1,5,3,4,4,4.428571428571429,0,3,1.8860692292255914,2,2,3,3,1,1,4,2,0,4,0.9547190977297628,0,1,1,2,3,2,1,5,2,1,3,1,4,1,4,4,1,5,1,4,2,1.8,0,4.8,0,4.4,0,4.2,0,4.466666666666667,0,2,3,2,1,2,4,4,1,4,1,2,1,2,3,2,1,1,2,3,3,2.8,0,"Hispanic of Latino (e.g., Mexican American, Central American, and others) & Native Hawaiian or other Pacific Islander",1,25,0,1,NA,5,2,0,0,1,0,0,TRUE,TRUE,TRUE,TRUE,TRUE,0,5,1.0643902439053465,0.82,0.06250767347080782,5,0.5012258064554583,0.5407187499962747,0.96875,1,0.004036219314659713,0.0033027306045624433,5,0.6283999999910593,0.6855281250104308,1,1,0.010948115484307505,0.008070254342888716,1.8096,0.966,0.5097,1.2079,0.9283,0.7977,0.1928,1.72939189,0.924126889,0.5064756933333333,1.5882,4.5816,0.3357,4.6718,0.3707,-74.3101,0.8573,5.7527,0.4266,6.3446,0.475,0.9437,1.6172221033333334,4.51091175,4.530694476666667,0.365113019,0.330120522,1.2422,5.1943,0.5066,6.1575,0.5858,0.9989,0.207,0.273,0.608,0.018,1.568,87.11111111111111,104,0.3081481481481481,1,1,3,4,FALSE,FALSE,FALSE
443,2021-11-13T06:48:41Z,0.8999999761581421,1.7786458333333333,768,3,1,4,3,5,4,3,5,4,3,3,2,2,4,1,4,4,4,2,5,3,4,3,5,4,0,3,0,0,5,1,4,3,4,5,2,2,3,2,5,2,2,2,2,3,5,4,5,5,1,3,1,4,3,1,1,1,1,1,1,2,5,3,1,2,2,2,3,1,1,3.75,0,1.75,0,2.6,0,2.7777777777777777,0,3,0,2,0,2.142857142857143,0,1.6666666666666667,0,2.5675675675675675,0,0,0,0,1.285589080317451,0.9746930431782689,-0.5020371591262895,0.23632794202598967,5,1,3,1,1,3,1,1.5714285714285714,0,1,-0.5612498234260587,5,5,5,5,3,4,2,4.428571428571429,0,1.5714285714285714,0.10757398284279028,0,3,3,3,3,3,3,5,4,2,3,2,3,5,4,3,5,4,3,2,4,3,0,3.4,0,2.4,0,3,0,2.933333333333333,0,1,2,4,2,3,4,3,1,4,1,2,2,2,3,1,1,2,3,2,3,2.7,0,"White, Caucasian, Anglo, European American",0,23,0,1,NA,5,2,0,0,0,0,0,TRUE,TRUE,TRUE,TRUE,TRUE,0,6,1.089739999985695,0.8,0.13091249012922296,6,0.3888071428707668,0.411977777754819,0.9032258064516129,0.84375,0.0013698809454670466,0.0033196094240203495,6,0.5540062500014901,0.6590645161136505,1,0.96875,0.003658554150272166,0.010674039023802874,1.9983,0.789,0.3766,1.4545,0.7396,0.6511,0.1425,1.8593829166666667,0.782378327,0.382594009,0.7875,3.82,0.3034,2.2368,0.2847,-71.7794,0.5561,5.3247,0.3394,3.4111,0.3491,0.9989,0.8423707776666667,2.58601023,4.093956303333333,0.282339369,0.2997716423333333,1.0258,5.8435,0.4685,3.827,0.5249,0.9706,0.077,0.423,0.579,0.018,1.848,102.66666666666669,336,0.9955555555555555,1,0,0,1,FALSE,FALSE,FALSE
444,2021-11-13T07:00:40Z,1,1.7777777777777777,1080,3,4,4,5,1,5,1,1,4,1,1,1,1,4,1,4,3,1,3,1,1,1,1,1,1,1,2,0,0,5,5,5,5,5,5,4,4,4,1,5,1,1,2,1,4,1,1,1,1,1,4,1,1,1,1,1,1,2,2,1,5,1,1,1,1,1,1,1,2,2,1.25,0,1.5,0,1.4,0,1.3333333333333333,0,1.3333333333333333,0,1,0,1.1428571428571428,0,1,0,1.2702702702702702,0,1,0,0,-1.076362004610271,-1.172888410658384,-0.3773458880470143,-0.7751171493526992,5,1,5,1,1,1,1,1,0,1.5,-0.7186247266594448,5,5,5,5,3,2,1,4.285714285714286,0,1.7142857142857142,-1.0219528370065065,0,2,2,2,2,2,2,4,2,2,5,4,4,1,4,4,1,5,4,4,4,2,0,3.4,0,4.6,0,3.6,0,3.8666666666666667,0,1,1,1,3,2,2,2,2,2,1,1,2,1,3,1,2,1,3,1,1,1.75,0,"White, Caucasian, Anglo, European American",0,20,0,1,NA,5,2,0,0,1,0,0,TRUE,TRUE,TRUE,TRUE,TRUE,0,1,0.779262500000745,0.8333333333333334,0.02475863808539215,1,0.4357064516135762,0.5152366666659712,0.96875,0.9375,0.0010228929738501785,0.002855373135066533,1,0.6058812500000931,0.693467741936926,1,0.96875,0.011127475121083301,0.01669126387058847,1.2284,1.4715,0.5051,0.8715,1.8738,0.613,0.2175,1.2662857933333334,1.226712314,0.4963817933333333,0.7476,5.8613,0.3779,3.4033,0.4139,-103.853,0.6806,6.479,0.3845,5.4866,0.4497,0.9467,0.8183169373333333,3.59573591,5.5615401,0.40915273933333335,0.37269128333333335,1.1746,5.1758,0.4991,6.8309,0.597,0.9884,0.085,0.367,0.364,0.021,2.101,100.04761904761904,326,0.965925925925926,1,1,2,3,FALSE,FALSE,FALSE
445,2021-11-13T06:52:28Z,1,1.7777777777777777,1080,3,3,4,4,2,3,2,1,4,2,2,1,2,3,2,3,3,2,3,1,1,1,2,1,2,2,2,0,0,5,5,3,4,4,5,5,5,4,2,4,2,2,2,2,3,3,3,4,3,3,4,1,1,1,4,2,1,2,1,1,4,3,2,1,3,1,2,2,2,2,1.625,0,2,0,2.1333333333333333,0,1.5555555555555556,0,2.75,0,1.6666666666666667,0,1.5714285714285714,0,1.6666666666666667,0,2.027027027027027,0,1,0,0,-0.37239971506330755,-0.3713685792530602,-0.22054348261253207,-0.29595603093279615,4,1,3,1,1,1,1,1.4285714285714286,0,1,-0.6467170085812028,4,3,4,3,2,2,3,3,0,3,0.9547190977297628,0,3,3,3,2,3,3,4,2,2,3,2,3,3,3,4,3,3,3,3,3,2.8,0,3.2,0,3.2,0,3.6,0,3.3333333333333335,0,2,2,3,2,2,3,2,1,2,2,2,1,3,3,2,2,2,3,3,3,2.65,0,"White, Caucasian, Anglo, European American & Filipino",1,19,0,1,NA,5,2,0,0,1,0,0,TRUE,TRUE,TRUE,TRUE,TRUE,0,1,0.8736692307545588,0.78,0.05239145356835077,1,0.4346062500104308,0.5064548386681464,1,0.96875,0.0010685489928681045,0.005435951249091916,1,0.5790468750149012,0.6291812499985099,1,1,0.0037263535372033616,0.0034953944764558155,1.4646,0.9627,0.4818,1.0596,0.8262,0.6377,0.0126,1.48287845,0.9478078296666667,0.474646503,1.1752,6.8087,0.3483,3.9787,0.3662,-97.7775,1.1315,9.5731,0.3786,4.8317,0.3908,0.8031,1.226258535,3.958467683333333,6.179480653333333,0.3607824513333333,0.341429714,0.6753,5.8204,0.5193,5.2049,0.5732,0.8773,0.152,0.368,0.731,0.032,1.844,57.625,304,0.9007407407407407,1,0,0,1,FALSE,FALSE,FALSE
446,2021-11-13T06:48:03Z,0.8999999761581421,1.7777777777777777,1440,1,2,4,3,3,3,3,2,4,4,3,1,4,2,2,4,3,3,5,1,1,2,3,3,3,1,2,0,2,4,3,1,1,1,1,1,1,1,3,2,1,1,1,1,3,5,5,4,5,5,2,4,1,1,4,1,1,1,1,1,1,4,3,1,3,2,1,1,1,1,2.625,0,1,0,2.7333333333333334,0,4.444444444444445,0,3.5,0,2.3333333333333335,0,2.142857142857143,0,2,0,3.2162162162162162,0,1,0,2,0.989294504717087,0.8272815345162342,-0.18124899968313501,0.3230162674165496,4,2,1,1,1,2,1,2,0,2,0.06413940681375631,2,3,3,2,1,3,5,2.142857142857143,0,3.857142857142857,1.5194825076544112,0,4,3,3,3,4,4,5,3,3,4,3,3,2,4,4,5,5,2,1,3,3.4,0,3.4,0,3,0,3.4,0,3.2666666666666666,0,3,3,2,2,4,2,3,2,3,1,2,3,2,3,2,3,1,2,3,3,2.45,0,"White, Caucasian, Anglo, European American",0,25,0,1,NA,5,2,0,0,0,0,0,TRUE,TRUE,TRUE,TRUE,TRUE,0,2,0.7530205882366966,0.6938775510204082,0.014983831249830092,2,0.7472062499942258,0.9057419354848323,1,0.96875,0.011866689637120804,0.018463897257578413,2,0.9729781249985099,1.0526281249988825,1,1,0.02432186627985378,0.015929456279693787,1.1694,0.7584,0.4592,0.7407,0.9684,0.6414,0.2813,1.231050871,0.8366929813666667,0.4517824876666667,2.38,4.0987,0.4569,2.8643,0.5067,-31.9532,0.7906,3.6815,0.6605,3.3569,0.8122,0.9602,2.5436257666666666,2.794168363333333,3.9853779433333334,0.459382064,0.42322194166666666,1.4475,2.6238,0.7291,3.5025,0.8558,0.9295,0.314,0.393,0.534,0.021,1.763,83.95238095238095,104,0.3081481481481481,1,0,2,3,FALSE,FALSE,FALSE
447,2021-11-13T07:01:39Z,1,1.7777777777777777,1080,4,2,5,5,2,5,2,1,4,1,1,1,1,5,2,5,3,1,1,1,1,1,1,1,1,1,2,0,0,4,1,5,4,3,5,5,5,5,2,5,1,1,4,1,5,1,1,1,1,1,5,1,1,1,1,1,1,2,2,1,5,1,1,1,1,1,1,1,1,1,1,0,1,0,1.4,0,1.8888888888888888,0,1.1666666666666667,0,0.8333333333333334,0,1.1428571428571428,0,1,0,1.3243243243243243,0,1,0,0,-1.1982420428004914,-1.2570959041160135,-0.5341482934814965,-0.895622098798755,5,1,5,1,1,2,1,1.1428571428571428,0,2,-0.44866370411710943,5,5,5,5,2,2,1,4.142857142857143,0,1.8571428571428572,-1.0219528370065065,0,2,3,2,2,2,1,5,2,2,3,1,5,1,4,4,1,5,2,3,4,2.2,0,4.8,0,4.2,0,3.6,0,4.2,0,1,1,1,4,1,1,1,4,1,4,1,4,1,1,1,4,1,1,1,1,1.15,0,"White, Caucasian, Anglo, European American",0,19,0,1,NA,5,2,1,0,1,0,1,TRUE,TRUE,TRUE,TRUE,TRUE,0,1,0.9516702702722034,0.7551020408163265,0.10693821558000186,1,0.4519310344858416,0.516448387096005,0.9354838709677419,1,0.006529939848622366,0.014644945247618753,1,0.6087874999977648,0.6318518518507481,1,0.8709677419354839,0.020825563709762306,0.013520757569278565,1.5402,0.7583,0.4528,1.31,0.7047,0.5804,0.3147,1.5442113833333333,0.8066020413333334,0.447307402,1.2008,3.3514,0.288,3.3349,0.3364,-57.228,1.0036,4.561,0.3401,3.7504,0.3767,0.8793,1.300471378,3.5441561433333333,3.645204006666667,0.33048109,0.28212432066666665,1.0373000000000001,4.2033,0.4758,2.943,0.4759,0.9316,0.066,0.361,0.265,0.026,2.066,79.46153846153845,310,0.9185185185185185,1,0,0,1,FALSE,FALSE,FALSE
448,2021-11-13T07:02:25Z,1,1.7777777777777777,1080,2,3,2,5,1,3,1,2,4,2,1,1,3,5,5,5,3,1,1,1,1,1,1,1,2,1,2,0,0,4,2,3,3,2,4,2,4,3,1,5,1,1,4,2,4,2,1,1,3,3,5,1,1,1,2,1,1,3,3,1,5,1,2,1,1,1,2,1,1,1,1.125,0,1.25,0,2.066666666666667,0,3,0,1.6666666666666667,0,1,0,1.5714285714285714,0,1,0,1.864864864864865,0,1,0,0,-0.7842701889475012,-0.6845817388264964,-0.4557470907642554,-0.5701644147953759,4,1,3,1,1,2,2,1.7142857142857142,0,2,-0.10679496349653231,5,5,5,5,3,3,1,4.428571428571429,0,1.5714285714285714,1.5194825076544112,0,2,2,3,1,1,1,4,2,1,3,1,4,1,4,3,2,4,5,3,4,1.8,0,3.8,0,3.8,0,3.6,0,3.7333333333333334,0,2,1,1,2,1,3,2,3,2,1,2,2,3,3,1,2,2,3,2,2,2.1,0,"White, Caucasian, Anglo, European American",0,19,0,1,NA,5,2,0,0,1,0,0,TRUE,TRUE,TRUE,TRUE,TRUE,0,2,0.8581268292687289,0.82,0.06431406050593737,2,0.4843843749999069,0.5884225806440077,1,1,0.00845003942553164,0.007383664473053891,2,0.6489999999993015,0.7477806451604251,1,0.96875,0.006752745806463361,0.014415538377184563,1.6852,1.0873,0.4025,1.3003,0.936,0.5262,0.2316,1.6383748866666668,0.9748448193333333,0.347205121,2.1485,5.7246,0.2967,4.9019,0.3693,-73.7554,0.8854,4.9372,0.3886,4.5967,0.4883,0.7623,1.7926244566666667,4.246877326666667,5.1280709133333335,0.38030508,0.31159789666666665,1.0553,6.0242000000000004,0.5586,2.75,0.5881,0.9674,0.076,0.474,0.41,0.019,1.851,97.42105263157895,314,0.9303703703703704,1,0,1,2,FALSE,FALSE,FALSE
449,2021-11-13T07:01:36Z,0.8999999761581421,1.7786458333333333,768,6,1,4,4,2,4,2,1,4,2,2,2,1,3,1,4,4,3,3,1,2,2,3,3,3,1,3,0,0,5,3,3,3,1,4,3,3,5,2,4,3,2,2,2,4,3,2,3,2,2,4,1,5,1,1,1,2,3,3,1,4,3,2,2,1,3,2,3,3,3,2.5,0,2.75,0,1.8666666666666667,0,2.6666666666666665,0,2.4166666666666665,0,1.6666666666666667,0,2.142857142857143,0,2,0,2.324324324324324,0,1,0,0,0.3567791341092188,0.01782490487697288,0.01466012553919125,0.016242515208082065,3,2,3,1,1,3,2,2.142857142857143,0,1.5,-0.03488724541829051,1,2,3,3,1,2,2,2.2857142857142856,0,3.7142857142857144,0.6723373927674386,0,2,2,2,2,2,2,3,4,2,3,3,3,2,3,3,4,3,2,3,4,2,0,3.4,0,3,0,2.8,0,3.066666666666667,0,1,1,2,3,3,2,2,2,2,1,2,3,3,3,1,2,1,2,3,2,2.05,0,Black or African American,0,28,0,1,NA,5,2,0,0,0,0,0,TRUE,TRUE,TRUE,TRUE,TRUE,0,4,0.7654424242415663,0.673469387755102,0.020721780340105807,4,0.5244281250000932,0.62023333333383,1,0.9375,0.0044449317641940085,0.0036750026512124357,4,0.6190612903230133,0.6733678571432828,0.96875,0.9032258064516129,0.005647513619019642,0.005598943333316892,0.981,0.7785,0.5514,0.7653,0.821,0.6203,0.1972,1.0478103113333332,0.8640450486666666,0.5438169783333333,1.2695,4.2308,0.3744,3.6553,0.4653,-70.5072,0.7604,5.3843,0.4565,4.0216,0.5374,0.9931,1.4617310676666666,3.77147916,4.551769573333333,0.4470724226666667,0.362835076,0.6947,5.0097,0.55,2.6464,0.5855,0.6652,0.046,0.515,0.407,0.008,0.981,122.625,334,0.9896296296296296,1,0,0,1,FALSE,FALSE,FALSE
450,2021-11-13T07:03:49Z,1,1.7777777777777777,864,4,2,3,4,5,2,5,3,1,3,4,5,5,2,4,2,2,3,5,5,2,4,5,3,3,3,2,2,2,5,1,2,5,1,5,5,5,2,5,1,1,5,2,5,2,5,5,5,5,5,1,2,5,1,5,5,1,3,3,1,4,1,1,1,5,2,2,2,2,2,3.75,0,2,0,4,0,2.5555555555555554,0,4.5,0,3.6666666666666665,0,1.5714285714285714,0,2.6666666666666665,0,3.2432432432432434,0,2,2,2,1.7058650740768326,1.8667117324949531,0.7487147001683933,1.3077132163316731,4,2,2,2,1,1,1,1.8571428571428572,0,4.5,0.9011414085945675,1,4,4,3,2,2,4,2.5714285714285716,0,3.4285714285714284,1.8018642126167355,0,1,1,1,1,1,2,5,1,1,5,2,5,1,5,5,1,5,1,5,1,1,0,4.6,0,5,0,5,0,4.866666666666666,0,4,4,4,1,2,4,4,1,4,4,4,1,4,4,4,1,1,4,4,4,3.75,0,"Hispanic of Latino (e.g., Mexican American, Central American, and others)",0,27,0,1,NA,5,2,0,0,0,0,0,TRUE,TRUE,TRUE,TRUE,TRUE,0,6,0.911248936196591,0.94,0.04682031478414324,6,0.46906774191702566,0.54235,0.96875,0.9375,0.0034525787075830277,0.004683184153033572,6,0.6619718750119209,0.7239187500476837,1,1,0.013527470483496343,0.015585897056015386,1.5393,1.8483,0.5585,1.4026,1.9069,0.5972,0.2893,1.4827288266666667,1.4454096946666666,0.551779224,1.2119,3.5715,0.3103,3.2097,0.3748,-60.0171,0.7541,4.5379,0.3955,4.0008,0.4628,0.9878,1.3389503276666668,3.39202679,3.8938963233333332,0.36504979633333334,0.304080258,1.2493,4.0147,0.5163,5.6212,0.6072,0.9743,0.302,0.175,0.639,0.017,1.487,87.47058823529412,352,1.0429629629629629,1,0,0,1,FALSE,FALSE,FALSE
451,2021-11-13T07:01:09Z,0.8999999761581421,1.7777777777777777,1080,3,2,4,4,2,4,1,1,4,1,2,1,1,4,1,4,3,2,2,1,1,2,2,1,2,2,4,0,0,4,4,4,4,2,5,5,5,3,1,5,2,2,3,2,5,1,1,2,1,1,5,1,1,1,2,1,1,3,3,1,4,1,1,1,2,1,2,2,2,2,1.625,0,2,0,1.6666666666666667,0,2,0,1.5,0,1,0,1.5714285714285714,0,1.3333333333333333,0,1.5945945945945945,0,1,0,0,-0.6413763510693116,-0.7577551469345059,-0.22054348261253207,-0.489149314773519,2,4,2,4,4,4,4,4,0,1,0.8916923242113942,4,3,3,3,1,1,2,2.7142857142857144,0,3.2857142857142856,0.38995568780511447,0,3,3,3,3,3,3,3,3,3,2,3,3,2,3,2,4,3,3,3,3,3,0,3,0,2.8,0,2.8,0,2.8666666666666667,0,3,2,4,1,3,4,3,1,4,2,1,2,3,3,2,2,2,3,3,4,3,0,"Black or African American & White, Caucasian, Anglo, European American",1,25,0,1,NA,5,2,0,0,1,0,0,TRUE,TRUE,TRUE,TRUE,TRUE,0,NA,NA,NA,NA,2,0.5405692307696892,0.5463846153811767,0.8125,0.896551724137931,0.04537445305523142,0.022694802562596105,2,0.7035718750003725,0.777066666668212,1,0.9,0.021017112409436992,0.008475311540262969,NA,NA,NA,NA,NA,NA,NA,NA,NA,NA,1.1368,1.142,0.2486,2.4195,0.3939,-9.5915,0.8522,2.1378,0.387,1.8667,0.4161,0.9426,1.2005525703333333,2.622323536666667,1.437113047,0.3853459456666667,0.24447689733333333,0.8158,3.3713,0.5897,2.9639,0.6631,0.9994,0.069,0.521,0.404,0.01,1.43,143,104,0.3081481481481481,1,1,20,21,FALSE,FALSE,FALSE
452,2021-11-13T07:17:03Z,1,1.7777777777777777,1080,3,3,5,5,2,5,1,1,5,1,1,1,1,5,1,5,4,1,1,1,1,1,1,1,1,1,2,0,0,5,4,3,4,5,5,5,5,5,1,5,1,1,3,1,5,1,1,1,1,1,5,1,1,1,2,1,1,2,1,1,5,1,1,1,1,1,1,1,1,2,1,0,1.25,0,1.1333333333333333,0,1.4444444444444444,0,1.1666666666666667,0,1,0,1,0,1,0,1.2162162162162162,0,1,0,0,-1.2654862018019926,-1.4181548341315258,-0.4557470907642554,-0.9369509624478906,5,1,4,1,1,1,1,1.1428571428571428,0,1.5,-0.6331575415043005,5,5,5,5,2,2,2,4,0,2,-0.1748077221195339,0,2,2,2,3,2,2,4,4,2,2,3,3,2,4,4,1,4,3,3,4,2.2,0,3.4,0,3.6,0,3.2,0,3.4,0,1,2,1,4,3,2,1,2,1,2,1,3,1,2,1,2,1,2,1,2,1.65,0,"White, Caucasian, Anglo, European American",0,22,0,1,NA,5,2,0,0,1,0,0,TRUE,TRUE,TRUE,TRUE,TRUE,0,2,0.7345714285714285,0.7,0.0172580729015323,2,0.5327193548352488,0.5801281249988824,1,1,0.0041011582796154095,0.004539739505797383,2,0.6952562499968334,0.7684906250014901,1,1,0.01546806318542994,0.008276725393623221,1.2582,0.7533,0.3849,0.8806,1.1524,0.546,0.1692,1.3049047833333334,0.83502995,0.378819768,9.9997,10.6433,0.063,10.604,0.1086,-84.1227,0.8259,5.6035,0.4596,4.9512,0.5022,0.8873,2.11821395,5.132596743333333,5.240207846666666,0.3791435186666667,0.333121406,1.2666,3.7242,0.5297,4.1153,0.6249,0.9581,0.194,0.354,0.588,0.016,1.628,101.74999999999999,324,0.96,1,0,0,1,FALSE,FALSE,FALSE
453,2021-11-13T07:18:33Z,0.8999999761581421,1.7777777777777777,864,3,3,5,5,1,5,1,1,5,1,1,1,1,5,1,5,5,1,1,1,1,1,1,1,1,0,2,0,0,5,5,5,5,5,5,5,5,5,1,5,1,1,5,1,5,1,1,1,1,1,5,1,1,1,1,1,1,1,1,1,5,1,1,1,1,1,1,1,1,1,1,0,1,0,1,0,1,0,1,0,0.8333333333333334,0,0.8571428571428571,0,1,0,1,0,0,0,0,-1.3999745198049947,-1.568373259242148,-0.7372407672780129,-1.1528070132600805,5,1,5,1,1,1,1,1,0,1,-0.9031185640466358,5,5,5,5,5,5,5,4.428571428571429,0,1.5714285714285714,0.9547190977297628,0,1,1,3,1,1,1,4,1,1,3,1,3,2,4,4,1,3,2,2,5,1.4,0,4,0,3.6,0,3.8,0,3.8,0,1,1,1,4,1,1,1,4,1,1,1,4,1,1,1,4,1,1,1,1,1,0,"White, Caucasian, Anglo, European American",0,29,0,1,NA,5,2,0,0,1,0,0,TRUE,TRUE,TRUE,TRUE,TRUE,0,4,0.7005538461540755,0.78,0.020963124636685863,4,0.4623866666669647,0.5075749999981906,0.967741935483871,0.875,0.0026065125807642705,0.0034554470867074727,4,0.5669096774189702,0.6466916666645557,1,0.75,0.004512048903137541,0.00693556942560671,1.3101,1.0819,0.3515,0.8256,1.7317,0.5496,0.2167,1.34399686,1.0327461376666667,0.345604424,0.8279,4.2369,0.3685,2.6386,0.3857,-76.7959,0.7375,4.8083,0.3879,3.0655,0.4121,0.9592,0.9149353116666666,2.9304141033333333,4.455152843333333,0.379348596,0.3627845536666667,0.6402,3.8078,0.5074,2.4369,0.5525,0.8708,0.052,0.426,0.362,0.014,1.893,135.21428571428572,390,1.1555555555555557,1,0,0,1,FALSE,FALSE,FALSE
454,2021-11-13T07:19:27Z,0.8999999761581421,1.6,900,3,3,4,4,2,4,1,1,3,1,2,2,1,4,1,4,4,2,2,1,1,2,1,1,1,0,2,0,0,5,1,2,3,1,5,3,4,4,2,4,1,1,4,1,2,2,1,1,1,1,5,1,1,1,2,1,1,1,1,1,4,1,3,1,1,1,2,1,1,2,1.375,0,1.5,0,1.7333333333333334,0,2.888888888888889,0,1.5833333333333333,0,1,0,1.2857142857142858,0,1,0,1.7567567567567568,0,0,0,0,-0.696012230258031,-0.7668534278368243,-0.5804383618435307,-0.6736458948401776,3,2,3,2,2,2,1,2.142857142857143,0,1.5,-0.03488724541829051,4,4,4,4,3,2,2,3.5714285714285716,0,2.4285714285714284,0.9547190977297628,0,2,3,3,2,3,3,3,4,3,2,3,3,2,4,4,3,3,2,3,3,2.6,0,3.2,0,3,0,3.2,0,3.1333333333333333,0,1,1,1,1,1,1,1,4,1,1,1,4,1,1,1,4,1,1,1,1,1.15,0,"Hispanic of Latino (e.g., Mexican American, Central American, and others)",0,18,0,1,NA,5,2,0,0,1,0,0,TRUE,TRUE,TRUE,TRUE,TRUE,0,5,0.7742952380955574,0.84,0.03340963028968948,5,0.48193749999953434,0.561596666666617,1,0.967741935483871,0.001734710161285254,0.006972735118131363,5,0.6426781249998603,0.7221906249995809,1,1,0.010944617893025253,0.01223361636084099,1.1634,1.5045,0.5173,0.7273,1.9855,0.6418,0.1939,1.211384615,1.2487698403333334,0.507984904,1.5038,5.9652,0.3559,3.8895,0.3763,-79.8084,0.7832,7.696,0.4361,3.789,0.4703,0.9991,1.541186781,3.84162593,5.617661643333333,0.3703299663333333,0.349279132,1.1336,3.1961,0.488,4.537,0.6002,0.9071,0.252,0.245,0.644,0.021,1.835,87.38095238095238,444,1.3155555555555554,1,0,0,1,FALSE,FALSE,FALSE
456,2021-11-13T07:01:40Z,1,1.7777777777777777,864,4,3,2,5,4,5,3,1,5,1,1,1,1,5,1,5,3,2,1,1,1,1,1,1,1,1,2,0,0,5,5,5,5,4,5,5,5,5,1,4,1,1,5,1,4,3,1,2,3,2,5,1,1,1,1,1,1,2,1,1,5,2,2,1,1,1,2,1,1,1,1.125,0,1.25,0,1.6666666666666667,0,1.1111111111111112,0,1.6666666666666667,0,0.8333333333333334,0,1.2857142857142858,0,1,0,1.3243243243243243,0,1,0,0,-1.120490983955006,-1.088777707423119,-0.4557470907642554,-0.7722623990936872,5,1,3,1,1,1,1,1.2857142857142858,0,1,-0.7321841937363471,5,5,5,5,4,4,1,4.714285714285714,0,1.2857142857142858,-0.7395711320441822,0,2,2,3,3,2,2,5,3,2,4,3,4,3,5,4,1,3,4,4,3,2.4,0,3.2,0,4.2,0,3.8,0,3.7333333333333334,0,2,2,4,4,2,3,2,3,2,2,3,1,1,4,2,2,4,4,1,4,2.6,0,"White, Caucasian, Anglo, European American",0,19,0,1,NA,5,2,0,0,0,0,0,TRUE,TRUE,TRUE,TRUE,TRUE,0,2,0.95174358970691,0.7959183673469388,0.17423973944445859,2,0.4054593750089407,0.4911333333333333,1,0.9375,0.002740178610545263,0.005709751514081265,2,0.5521125000119209,0.5868156249970198,1,1,0.004110212739320877,0.006101084592810694,1.4501,0.9294,0.5723,1.2922,0.7895,0.6231,0.1987,1.4824848033333333,0.920517404,0.5602425026666666,1.364,4.5504,0.2556,3.5203,0.3154,-69.2193,0.7906,5.7486,0.3416,4.5313,0.4043,0.9924,1.4036757083333333,3.6032732,4.61901254,0.3127157113333333,0.25356923066666665,1.0249,5.957,0.4686,3.9287,0.4674,0.9912,0.106,0.383,0.598,0.056,1.341,23.94642857142857,390,1.1555555555555557,1,0,0,1,FALSE,FALSE,FALSE
457,2021-11-13T07:21:18Z,0.8999999761581421,1.7777777777777777,1080,4,4,4,5,2,4,2,1,4,1,1,1,1,5,2,5,4,1,2,1,1,1,1,1,2,0,5,0,0,5,4,5,3,3,3,4,4,5,2,5,1,1,5,1,4,1,1,1,2,2,5,1,1,1,1,1,1,1,1,1,5,1,1,1,1,1,1,1,2,2,1.25,0,1.5,0,1.4666666666666666,0,2,0,1.3333333333333333,0,0.8333333333333334,0,0.8571428571428571,0,1,0,1.3513513513513513,0,0,0,0,-1.0259288853591455,-1.1093940247868836,-0.5804383618435307,-0.8449161933152072,4,1,3,1,1,3,2,1.8571428571428572,0,2,-0.021327778341387937,5,5,5,5,3,3,1,4.428571428571429,0,1.5714285714285714,-0.7395711320441822,0,2,2,2,2,2,3,2,3,2,3,2,2,2,3,2,3,3,3,4,5,2,0,3,0,3.2,0,2.6,0,2.933333333333333,0,1,1,1,4,2,1,2,2,1,2,1,4,2,1,2,4,1,1,1,3,1.45,0,"White, Caucasian, Anglo, European American",0,18,0,1,NA,5,2,0,0,1,0,0,TRUE,TRUE,TRUE,TRUE,TRUE,0,1,0.8299761904761904,0.8571428571428571,0.016880308673469385,1,0.4150967741935484,0.4579375,1,1,0.0026282903225806455,0.002884447580645161,1,0.54775,0.6125483870967742,1,1,0.001379419354838709,0.0031146559139784945,1.1384,1.701,0.602,0.9968,1.4258,0.6477,0.0821,1.185877642,1.33637139,0.5916663296666667,2.3816,8.6297,0.2771,6.8699,0.2846,-102.7252,0.7671,7.8935,0.3636,6.323,0.4014,0.8533,1.412493479,4.902158273333334,6.20872287,0.3192360576666667,0.30749524466666667,0.7021,6.4968,0.5018,5.8126,0.5518,0.966,0.092,0.433,0.771,0.038,2.02,53.15789473684211,312,0.9244444444444444,1,0,0,1,FALSE,FALSE,FALSE
458,2021-11-13T07:17:03Z,1,1.7777777777777777,864,3,3,2,4,3,4,2,2,4,2,3,3,2,4,2,4,3,1,2,1,1,1,3,2,2,1,2,0,0,3,2,4,4,2,4,5,5,4,2,4,2,1,3,2,5,2,1,2,1,2,3,1,3,1,2,2,1,2,1,1,5,2,2,1,1,1,1,2,2,2,1.625,0,1.75,0,2.4,0,2.3333333333333335,0,1.75,0,1.8333333333333333,0,1.2857142857142858,0,1,0,1.8108108108108107,0,1,0,0,-0.5068880330663098,-0.3496875694432797,-0.2989446853297732,-0.3243161273865265,5,1,3,1,1,2,2,1.5714285714285714,0,1.5,-0.3767559860388676,4,5,5,4,2,2,1,3.857142857142857,0,2.142857142857143,0.38995568780511447,0,3,3,2,1,2,3,4,3,2,4,2,3,1,4,3,1,4,2,4,4,2.2,0,3.6,0,4.4,0,3.2,0,3.7333333333333334,0,2,1,1,2,3,2,3,3,2,2,1,2,2,3,2,2,1,3,2,2,2.15,0,"White, Caucasian, Anglo, European American",0,20,0,1,NA,5,2,0,0,0,0,0,TRUE,TRUE,TRUE,TRUE,TRUE,0,6,0.8154769230767702,0.7959183673469388,0.051330464447260034,6,0.5751968750001397,0.6470709677417913,1,1,0.02671520934500982,0.030657730129410535,6,0.7462843749998137,1.0073406250001862,1,1,0.033460995554123824,0.03600689345728552,1.4382,1.0269,0.4074,1.1394,1.3223,0.5392,0.3287,1.4564719866666667,0.986391248,0.4011295733333333,2.7616,3.9799,0.2282,4.3534,0.3299,-43.2283,1.3539,4.4917,0.4108,3.7534,0.4441,0.9388,2.1276452933333334,3.8688416533333334,3.452339406666667,0.3713877683333333,0.2589752356666667,1.3049,3.5956,0.5459,2.1048,0.7757,0.9331,0.156,0.376,0.429,0.008,1.951,243.875,104,0.3081481481481481,1,0,0,1,FALSE,FALSE,FALSE
459,2021-11-13T07:19:40Z,1,1.7777777777777777,1080,5,3,5,5,1,5,1,1,4,1,2,1,1,4,1,5,4,1,1,1,1,1,1,1,1,0,3,0,0,5,3,4,4,1,4,3,4,3,1,4,1,1,4,1,5,1,1,1,2,3,4,1,1,1,1,1,1,1,1,1,5,1,2,1,2,1,1,1,1,1,1,0,1,0,1.2666666666666666,0,2.5555555555555554,0,1.4166666666666667,0,1,0,1,0,1.3333333333333333,0,1.5945945945945945,0,0,0,0,-1.030131645296739,-1.198247448918038,-0.7372407672780129,-0.9677441080980254,5,1,4,1,1,2,1,1.2857142857142858,0,1,-0.7321841937363471,4,4,4,3,1,1,2,3,0,3,2.0842459175790595,0,2,1,1,1,2,2,3,2,2,2,1,4,1,3,4,4,5,2,2,4,1.4,0,4.4,0,2.8,0,3.4,0,3.533333333333333,0,2,1,1,4,3,2,2,3,1,1,1,3,2,2,2,3,1,1,2,2,1.65,0,"Asian or Asian American (e.g., Chinese, Japanese, and others)",0,27,0,1,NA,5,2,0,0,2,0,0,TRUE,TRUE,TRUE,TRUE,TRUE,0,3,0.7064217391506485,0.92,0.025886081670636257,NA,NA,NA,NA,NA,NA,NA,3,0.4608843750171363,0.5092250000089407,1,1,0.004682586521717133,0.004064649676385541,1.2211,2.0882,0.4689,1.0834,2.4987,0.508,0.198,1.22491571,1.5141310456666666,0.460541916,NA,NA,NA,NA,NA,NA,NA,NA,NA,NA,NA,NA,NA,NA,NA,NA,NA,0.9077,4.3402,0.3703,5.9744,0.4453,0.5051,0.08,0.297,0.462,0.028,1.64,58.57142857142857,382,1.1318518518518519,1,0,5,6,FALSE,FALSE,FALSE
460,2021-11-13T07:32:55Z,0.8999999761581421,1.7777777777777777,864,4,3,5,5,1,5,1,1,5,1,1,1,1,5,1,5,3,1,1,1,1,1,1,1,1,1,2,0,0,4,1,1,2,2,3,1,1,3,3,2,2,1,2,2,2,2,2,2,2,2,5,5,1,1,1,1,1,3,3,3,5,1,1,1,2,1,2,1,3,3,1,0,2.25,0,1.1333333333333333,0,4,0,2.5,0,1.5,0,1.7142857142857142,0,1.3333333333333333,0,2.5135135135135136,0,1,0,0,-0.4585562937839808,-0.8606431533085982,-0.14214227989529096,-0.5013927166019446,5,1,4,1,1,1,1,1.1428571428571428,0,1,-0.8176513788914915,3,3,5,3,1,1,2,2.857142857142857,0,3.142857142857143,2.0842459175790595,0,1,1,2,2,2,1,5,1,1,1,1,5,1,4,5,1,2,1,5,4,1.6,0,4.4,0,4.2,0,4.2,0,4.266666666666667,0,1,1,1,3,1,1,1,3,1,1,1,3,1,1,1,3,1,1,1,1,1.2,0,"Hispanic of Latino (e.g., Mexican American, Central American, and others)",0,24,0,1,NA,5,2,0,0,1,0,0,TRUE,TRUE,TRUE,TRUE,TRUE,0,1,0.7017076923174735,0.78,0.0489792292923733,1,0.528617857166699,0.6535199999809265,0.9655172413793104,0.9375,0.008177040663751217,0.007479323715584971,1,0.6442406250238418,0.7254033333778381,1,0.9375,0.0044462179746330936,0.009893419912938822,1.3306,0.9952,0.3081,1.1722,1.2408,0.4057,0.4443,1.3581968533333333,0.9749708953333334,0.30341187133333336,1.2246,3.1448,0.3444,3.0626,0.4803,-49.9325,0.8671,4.5786,0.4366,4.2329,0.5509,0.8705,1.4225910593333333,3.2699706133333333,3.592124023333333,0.460168097,0.333663075,0.9617,5.778,0.5621,2.5509,0.5824,0.9969,0.065,0.519,0.498,0.021,1.791,85.28571428571428,104,0.3081481481481481,1,0,0,1,FALSE,FALSE,FALSE
463,2021-11-13T07:39:30Z,0.8999999761581421,1.7777777777777777,1080,6,3,4,3,2,3,2,2,4,2,2,2,2,3,2,3,3,2,3,3,2,2,2,2,2,0,7,0,0,4,4,3,3,3,5,4,4,3,2,4,2,2,3,2,2,4,2,2,2,2,3,1,1,1,1,1,1,1,1,1,4,2,2,1,1,2,2,2,1,1,2.25,0,1.5,0,2.3333333333333335,0,2.3333333333333335,0,2.4166666666666665,0,1.1666666666666667,0,1.2857142857142858,0,1.3333333333333333,0,1.945945945945946,0,0,0,0,-0.034077540087006045,-0.051670474781162705,-0.5804383618435307,-0.3160544183123467,4,2,3,2,2,2,2,2.142857142857143,0,1.5,-0.03488724541829051,3,3,4,4,1,1,2,2.857142857142857,0,3.142857142857143,-0.1748077221195339,0,2,2,2,2,2,2,5,2,2,2,1,5,1,3,3,3,5,2,2,3,2,0,4.6,0,3.4,0,3.4,0,3.8,0,1,1,3,1,3,3,2,1,4,1,3,1,1,3,1,2,1,4,2,2,2.5,0,"Asian or Asian American (e.g., Chinese, Japanese, and others)",0,22,0,1,NA,5,2,0,0,1,0,0,TRUE,TRUE,TRUE,TRUE,TRUE,0,6,0.8697849999986589,0.8,0.02924828597600922,6,0.5930866666674613,0.6939031249983236,0.967741935483871,1,0.04677260189118381,0.0678407390210682,6,0.6547366666684548,0.6985531250005588,0.967741935483871,1,0.006027819183183104,0.003264284506065785,1.3662,1.1343,0.5108,0.7321,1.7228,0.7519,0.353,1.3997466966666667,1.0617281916666668,0.5026621636666667,1.7539,2.7088,0.2844,2.1614,0.2882,-14.2848,1.3671,2.8644,0.3204,1.9841,0.38,0.5257,1.7501869233333334,2.26550892,2.8836260333333334,0.2918140653333333,0.288848345,0.9377,4.5467,0.5607,5.7472,0.6284,0.8929,0.22,0.377,0.786,0.025,1.303,52.12,104,0.3081481481481481,1,1,0,1,FALSE,FALSE,FALSE
464,2021-11-13T07:41:52Z,0.8999999761581421,1.7777777777777777,864,4,2,4,3,4,3,3,2,4,1,2,1,1,4,1,4,4,1,1,2,1,1,1,2,1,3,2,0,0,5,4,4,5,4,5,5,5,5,2,4,1,4,2,2,4,2,2,1,1,1,3,1,1,2,3,2,1,3,3,3,4,2,2,2,2,2,2,3,2,3,1.25,0,2.5,0,2.066666666666667,0,1.3333333333333333,0,2,0,1.8333333333333333,0,2.142857142857143,0,2,0,1.8918918918918919,0,2,0,0,-0.6897080903516403,-0.6192483387300597,0.13935139661846652,-0.23994847105579659,3,2,2,2,1,3,2,2.4285714285714284,0,3,0.6895286370535711,4,5,5,4,2,2,3,3.5714285714285716,0,2.4285714285714284,0.9547190977297628,0,4,4,4,2,3,5,4,2,2,2,1,2,2,3,3,4,3,2,3,4,3.4,0,3,0,3,0,3.2,0,3.066666666666667,0,1,1,2,3,3,1,1,2,1,1,1,4,1,1,1,3,1,1,1,2,1.4,0,"Hispanic of Latino (e.g., Mexican American, Central American, and others)",0,25,0,1,NA,5,2,0,0,0,0,0,TRUE,TRUE,TRUE,TRUE,TRUE,0,2,1.1273783783783784,0.74,0.09577692285714284,2,0.50259375,0.5384375,1,1,0.00288270060483871,0.0020694153225806443,2,0.66709375,0.74340625,1,1,0.00524137802419355,0.008292248991935485,1.4653,0.7124,0.7065,1.2033,0.5041,0.8556,0.2085,1.51955308,0.774414117,0.6857213573333333,2.1772,7.2515,0.3525,7.9672,0.4018,-106.6334,0.6843,5.4507,0.4434,6.4724,0.4838,0.9705,1.5420157216666666,5.885093596666667,5.646016676666667,0.41596918866666666,0.37057509833333335,0.673,4.688,0.5999,3.8343,0.6769,0.7919,0.122,0.463,0.593,0.018,1.562,86.77777777777779,359,1.0637037037037036,1,0,0,1,FALSE,FALSE,FALSE
465,2021-11-13T07:44:48Z,1,1.7777777777777777,1080,3,2,2,3,5,2,5,5,3,5,4,5,5,1,1,1,3,1,5,5,3,5,5,5,5,4,5,3,1,5,4,2,4,4,5,2,2,3,2,4,1,3,2,4,5,5,5,5,5,5,2,5,5,5,4,4,5,5,5,5,3,4,4,1,3,3,2,4,4,4,4.25,0,3.5,0,4.133333333333334,0,2.5555555555555554,0,3.5,0,4.333333333333333,0,4.285714285714286,0,2.3333333333333335,0,3.5135135135135136,0,2,3,1,2.184979706962527,2.2550341046237006,1.2493054771656829,1.7521697908946918,2,5,1,3,3,3,3,3.7142857142857144,0,3.5,1.6432271408370611,3,3,5,3,1,1,3,2.7142857142857144,0,3.2857142857142856,0.38995568780511447,0,2,2,2,3,2,2,5,2,4,5,1,5,1,5,5,1,3,1,5,1,2.2,0,4.4,0,5,0,4.2,0,4.533333333333333,0,2,3,4,1,3,4,4,1,4,4,4,1,3,2,4,1,3,4,4,4,3.6,0,"White, Caucasian, Anglo, European American",0,NA,0,1,NA,5,2,0,0,0,0,0,TRUE,TRUE,TRUE,TRUE,TRUE,0,NA,NA,NA,NA,2,0.527483870967742,0.6202333333333333,0.96875,0.967741935483871,0.003430931451612902,0.003062995698924731,2,0.6961935483870968,0.73425,1,1,0.0037615612903225807,0.008380709677419355,NA,NA,NA,NA,NA,NA,NA,NA,NA,NA,0.9172,4.4533,0.4301,3.8026,0.5042,-86.765,0.7964,4.5409,0.4416,5.9169,0.5519,0.9289,1.110124418,4.065831116666667,4.708709866666666,0.490179959,0.41611939466666664,0.8094,7.2289,0.6495,3.8018,0.639,0.9283,0.175,0.434,0.63,0.073,1.379,18.89041095890411,104,0.3081481481481481,1,1,0,1,FALSE,FALSE,FALSE
466,2021-11-13T07:44:04Z,1,1.7777777777777777,1440,4,3,4,4,2,4,2,1,3,2,2,1,1,4,2,3,3,2,3,1,1,1,2,2,2,0,2,0,0,4,4,4,4,5,5,4,4,3,2,4,2,2,3,1,3,2,2,2,3,3,3,1,1,1,2,1,1,1,1,1,5,1,2,1,1,1,1,1,1,1,1.75,0,1,0,2,0,1.8888888888888888,0,2.25,0,1.3333333333333333,0,1,0,1,0,1.7297297297297298,0,0,0,0,-0.4795700934719498,-0.5027129110024894,-0.7372407672780129,-0.6199768391402511,4,2,3,1,1,2,2,1.8571428571428572,0,1,-0.39031545311577004,4,4,5,4,3,3,2,3.857142857142857,0,2.142857142857143,0.9547190977297628,0,3,2,2,2,2,2,3,3,2,2,3,3,1,2,3,3,2,3,1,3,2.2,0,3,0,2.8,0,3,0,2.933333333333333,0,1,2,2,1,2,3,3,1,2,1,2,1,2,4,1,2,2,3,2,3,2.5,0,"White, Caucasian, Anglo, European American",0,22,0,1,NA,5,2,0,0,1,0,0,TRUE,TRUE,TRUE,TRUE,TRUE,0,6,0.8148642857138599,0.84,0.05217319193872678,6,0.4900843749996275,0.5542625000029803,1,1,0.009801927812360996,0.009536665645043485,6,0.6433656250019558,0.6876187500013039,1,1,0.009833351361037823,0.008964842863045839,1.4058,1.2458,0.4311,1.3108,1.4468,0.4902,0.3059,1.4225751166666667,1.1263108413333334,0.42406168433333336,1.5122,4.4326,0.3195,3.8116,0.3559,-66.6335,0.9459,4.2606,0.375,4.2414,0.4503,0.9262,1.6128436246666666,3.8921269233333335,4.522119473333333,0.348028047,0.311265033,0.9943,2.8031,0.5122,3.8758,0.5608,0.9868,0.182,0.336,0.608,0.035,1.828,52.22857142857143,368,1.0903703703703704,1,0,0,1,FALSE,FALSE,FALSE
467,2021-11-13T07:44:41Z,1,1.7777777777777777,1080,4,2,2,3,5,2,4,3,2,5,5,4,3,1,1,1,1,5,5,5,1,5,5,5,5,1,2,1,1,1,1,2,2,2,3,2,2,1,3,2,5,2,2,3,5,5,5,5,5,5,1,1,3,3,1,1,1,3,1,1,3,3,2,3,3,5,5,5,5,5,4.5,0,5,0,4,0,4.222222222222222,0,3.9166666666666665,0,2.1666666666666665,0,1.8571428571428572,0,3.6666666666666665,0,3.3513513513513513,0,1,1,1,2.239615586151246,2.2354824797059516,1.1033538044865656,1.6694181420962586,3,2,3,2,2,3,3,2.5714285714285716,0,2,0.4060081474343336,3,3,3,3,1,1,3,2.4285714285714284,0,3.5714285714285716,-1.0219528370065065,0,5,3,5,5,5,4,4,4,4,2,4,2,5,2,5,5,3,1,3,3,4.6,0,2.8,0,2.2,0,2.8,0,2.6,0,1,4,4,1,4,4,4,1,4,4,4,1,1,4,4,1,1,4,1,4,3.4,0,"White, Caucasian, Anglo, European American",0,21,0,1,NA,5,2,0,0,0,0,0,TRUE,TRUE,TRUE,TRUE,TRUE,0,2,1.0018810810811214,0.7708333333333334,0.3523096134574627,2,0.40105937500006983,0.5058806451613744,1,0.96875,0.0023206179737739066,0.003509660645165922,2,0.5927906249998487,0.6448483870969184,1,0.96875,0.009733634425388495,0.011465611249995407,1.7131,0.716,0.4246,1.3401,0.776,0.5219,0.0188,1.6770325333333334,0.7636196526666666,0.4235465176666667,2.4261,6.4999,0.2144,4.3429,0.2379,-70.0134,0.8572,6.245,0.3364,6.2951,0.4405,0.9714,1.9331780233333333,3.7995903733333334,5.449990953333334,0.26045814766666664,0.22747027433333333,0.9866,5.3255,0.5044,3.5712,0.5279,0.8228,0.081,0.398,0.408,0.017,1.303,76.6470588235294,527,1.5614814814814815,1,0,1,2,FALSE,FALSE,FALSE
468,2021-11-13T07:37:26Z,1,1.7786458333333333,768,5,2,2,4,3,3,3,4,4,3,2,2,3,4,2,4,2,4,3,3,3,3,4,3,3,5,2,5,1,4,1,2,1,1,3,1,1,1,1,3,3,1,2,3,4,3,3,4,4,4,2,4,5,2,3,1,3,3,3,2,3,1,2,2,3,3,2,2,2,2,3.25,0,2,0,2.7333333333333334,0,4.333333333333333,0,2.9166666666666665,0,3,0,2.2857142857142856,0,2.6666666666666665,0,3.189189189189189,0,3,5,1,1.3612387591941397,1.0842595748955521,1.3952571498447999,1.239758362370176,2,5,3,4,3,3,4,3.7142857142857144,0,5,2.1967086529986344,4,4,4,4,3,4,3,3.7142857142857144,0,2.2857142857142856,0.6723373927674386,0,2,2,2,2,2,2,4,2,2,3,2,4,3,4,4,1,5,2,3,2,2,0,4.2,0,3.6,0,4,0,3.933333333333333,0,1,1,3,2,2,4,2,2,4,1,4,2,2,4,1,2,2,3,3,3,2.6,0,Black or African American,0,29,0,1,NA,5,2,0,0,1,0,0,TRUE,TRUE,TRUE,TRUE,TRUE,0,4,0.7165305555562178,0.72,0.03659390816304017,4,0.4737874999940395,0.5092483871040806,1,1,0.0029171469352139963,0.0011465919143787838,4,0.5585749999955296,0.5830928571373224,1,0.875,0.008223620001198553,0.007398769032466526,1.1724,0.8013,0.4005,1.0872,0.8698,0.4624,0.3702,1.2298687536666666,0.8583838426666667,0.39181055066666665,3.7106,8.9147,0.2657,11.5757,0.349,-112.5027,0.4275,6.4855,0.4382,6.0278,0.4834,0.7476,1.5252263826666668,6.45102991,5.52154766,0.400896922,0.3397115866666667,0.8846,4.5603,0.4684,2.799,0.4548,0.9239,0.053,0.404,0.317,0.031,1.606,51.80645161290323,348,1.031111111111111,1,0,0,1,FALSE,FALSE,FALSE
469,2021-11-13T07:46:55Z,0.8999999761581421,1.7777777777777777,1080,4,2,3,3,4,2,3,1,3,2,2,3,1,2,2,2,2,2,3,1,1,2,1,2,2,5,2,0,0,3,3,2,3,2,2,3,3,3,4,3,2,4,3,3,4,3,4,5,5,5,3,1,2,1,4,4,2,3,3,3,4,2,2,2,3,1,3,2,2,3,1.75,0,2.5,0,2.8666666666666667,0,3.3333333333333335,0,3.5833333333333335,0,2.3333333333333335,0,2.2857142857142856,0,2,0,3,0,3,0,0,0.3105487747956867,0.4156327187974994,0.3424438704149829,0.37903829460624117,3,1,2,1,1,2,1,1.8571428571428572,0,1.5,-0.20582161572857902,3,3,3,3,1,1,4,2.2857142857142856,0,3.7142857142857144,-0.1748077221195339,0,2,2,1,1,2,1,2,3,2,3,2,3,2,2,2,5,3,2,2,4,1.6,0,3.8,0,2.4,0,2.6,0,2.933333333333333,0,2,2,3,1,3,4,3,1,2,2,3,1,2,1,2,1,1,3,2,3,2.7,0,Black or African American,0,21,0,1,NA,5,2,0,0,0,0,0,TRUE,TRUE,TRUE,TRUE,TRUE,0,3,0.7454949999999255,0.8,0.01859850040821814,3,0.42710000000020554,0.4818937500006286,0.90625,1,0.003317412096770125,0.0031608515725899257,3,0.5579343749999535,0.588153571428598,1,0.875,0.014306284909291174,0.005619544354855868,1.1556,1.2767,0.4993,0.8797,1.1547,0.5906,0.2476,1.2112760753333334,1.129031997,0.4900221143333333,0.9911,3.5841,0.311,3.5911,0.3439,-73.4353,0.4678,4.6193,0.3844,5.2675,0.4516,0.9686,1.1044210543333333,3.86297938,3.8685561633333334,0.3381843176666667,0.30289228133333335,0.8468,2.8575,0.4425,3.5224,0.4857,0.7406,0.057,0.395,0.378,0.019,1.817,95.63157894736842,279,0.8266666666666667,1,0,0,1,FALSE,FALSE,FALSE
470,2021-11-13T07:50:24Z,1,1.6,800,5,2,1,5,1,4,1,1,3,1,1,1,1,3,2,4,4,2,2,1,1,1,1,1,1,1,4,0,0,5,4,5,4,3,3,1,4,3,3,5,1,1,2,1,2,1,1,1,1,1,4,1,1,1,5,2,1,2,1,1,3,3,2,1,3,1,2,2,1,2,1.25,0,1.75,0,1.8,0,2.4444444444444446,0,1.6666666666666667,0,1.8333333333333333,0,1.7142857142857142,0,1.6666666666666667,0,1.945945945945946,0,1,0,0,-0.6560860108508899,-0.7106183086427063,-0.2989446853297732,-0.5047814969862398,5,1,3,1,1,3,2,1.7142857142857142,0,3.5,0.4466865486650409,4,4,5,4,4,3,2,4,0,2,1.5194825076544112,0,4,4,4,1,4,4,2,5,3,2,5,1,1,3,3,5,1,5,2,5,3.4,0,1.2,0,2.4,0,2.2,0,1.9333333333333333,0,1,1,1,3,2,1,1,2,1,1,3,3,1,1,1,3,1,2,1,1,1.45,0,"Asian or Asian American (e.g., Chinese, Japanese, and others)",0,26,0,1,NA,5,2,0,0,1,0,0,TRUE,TRUE,TRUE,TRUE,TRUE,0,5,0.9214500000476837,0.64,0.04318328366595294,5,0.505246666653951,0.5691406249701977,0.967741935483871,1,0.002428493035036804,0.0036319128021363683,5,0.6750343750715255,0.7391354838032876,1,0.96875,0.00950159328717493,0.015543563691625288,1.2063,0.5048,0.5883,0.8836,0.6065,0.7156,0.2789,1.27007024,0.6739667889,0.577543354,1.474,4.9712,0.3648,4.8133,0.416,-80.8735,0.7494,6.3298,0.4495,6.2401,0.5097,0.8048,1.5572738733333333,4.68889555,4.88237264,0.4072989776666667,0.35534341133333336,1.2432,3.4535,0.5083,3.2135,0.5463,0.9921,0.064,0.509,0.35,0.041,1.923,46.90243902439024,428,1.268148148148148,1,0,0,1,FALSE,FALSE,FALSE
471,2021-11-13T07:37:42Z,0.8999999761581421,1.6,1120,5,3,3,4,4,4,2,2,4,2,2,1,2,4,2,4,3,3,2,1,1,2,1,1,3,3,2,0,0,4,3,3,5,3,3,4,3,3,2,4,3,1,4,2,3,2,3,3,1,2,4,1,2,1,3,1,2,3,2,2,3,2,3,1,1,1,2,2,2,2,1.75,0,2,0,2.2,0,2.5555555555555554,0,2.1666666666666665,0,1.5,0,2.2857142857142856,0,1,0,2.135135135135135,0,2,0,0,-0.2274044972163212,-0.2425407932851232,-0.01745100881601569,-0.12999590105056946,4,2,3,2,2,2,3,2.2857142857142856,0,2,0.2350737771240448,3,4,4,4,3,3,3,3.4285714285714284,0,2.5714285714285716,-0.7395711320441822,0,3,3,2,2,2,3,4,2,2,3,2,4,1,3,3,3,3,2,3,3,2.4,0,3.6,0,3.6,0,3.4,0,3.533333333333333,0,1,1,2,2,2,1,2,2,1,1,3,2,3,2,1,3,2,2,2,1,1.9,0,"Asian or Asian American (e.g., Chinese, Japanese, and others)",0,21,0,1,NA,5,2,0,0,0,0,0,TRUE,TRUE,TRUE,TRUE,TRUE,0,2,1.1446437499895692,0.6956521739130435,0.23241963420518566,2,0.5099031250029802,0.5611299999872843,1,0.967741935483871,0.004264328052748999,0.005018665161472265,2,0.654362500011921,0.7702928571403026,1,0.9032258064516129,0.011257220485668492,0.02137272606968794,1.4695,0.5519,0.6363,1.3263,0.5168,0.6702,0.1194,1.5130975733333334,0.664865033,0.6189080526666667,1.3679,5.0271,0.3738,4.1162,0.4036,-78.5268,0.801,6.5302,0.441,4.8203,0.4801,0.8356,1.5053469333333334,4.163173216666666,5.061166356666667,0.39165599333333334,0.362937347,1.031,3.4511,0.5192,2.5938,0.6141,0.9936,0.087,0.449,0.448,0.011,1.88,170.9090909090909,447,1.3244444444444445,1,0,4,5,FALSE,FALSE,FALSE
472,2021-11-13T07:24:43Z,1,1.7777777777777777,720,4,3,5,5,2,4,3,1,3,2,2,2,2,5,2,3,4,2,2,1,1,1,1,1,1,0,2,0,0,4,4,3,4,4,5,5,5,5,2,4,2,1,3,2,4,2,2,2,2,2,5,1,1,1,1,1,1,1,1,1,3,3,3,1,1,1,1,1,1,1,1.25,0,1,0,1.9333333333333333,0,1.6666666666666667,0,2,0,0.8333333333333334,0,1.7142857142857142,0,1,0,1.6486486486486487,0,0,0,0,-0.8410074481050176,-0.781081590524493,-0.7372407672780129,-0.7591611789012529,5,1,4,1,1,2,1,1.2857142857142858,0,1,-0.7321841937363471,5,5,5,5,5,3,1,4.714285714285714,0,1.2857142857142858,-1.3043345419688306,0,2,2,3,3,3,3,3,3,3,3,3,2,3,2,3,3,3,2,3,4,2.6,0,3,0,3,0,2.6,0,2.8666666666666667,0,2,1,1,4,2,1,2,3,1,1,2,3,1,1,1,3,1,1,1,1,1.35,0,Black or African American,0,22,0,1,NA,5,2,0,0,1,0,0,TRUE,TRUE,TRUE,TRUE,TRUE,0,2,1.0607588235280092,0.68,0.0673436527570011,2,0.4559481481479274,0.5149874999995033,0.84375,0.7741935483870968,0.004130404354946127,0.004700297333268484,2,0.5289677419316384,0.6183565217399078,1,0.71875,0.00436588625804471,0.005725897006246658,1.4663,0.5519,0.5527,1.3098,0.6851,0.669,0.2435,1.49811161,0.6661536801333333,0.542715102,0.7715,2.3486,0.3468,1.6808,0.3881,-51.3753,0.4607,4.7128,0.4089,2.7379,0.4727,0.9632,0.826360036,2.058550638,2.793124897333333,0.38327515733333334,0.34269530633333334,0.7236,5.0947,0.4649,2.2765,0.5106,0.6672,0.053,0.395,0.41,0.008,1.423,177.875,374,1.108148148148148,1,0,0,1,FALSE,FALSE,FALSE
473,2021-11-13T07:55:54Z,1,1.7777777777777777,864,4,3,5,5,1,5,1,1,5,1,1,1,1,5,1,5,5,1,1,1,1,1,1,1,1,0,2,0,0,5,5,5,5,5,5,5,5,5,1,5,1,1,5,1,5,1,1,1,1,1,5,1,1,1,2,1,1,1,1,1,5,1,1,1,1,1,1,1,1,1,1,0,1,0,1,0,1,0,1,0,1,0,0.8571428571428571,0,1,0,1.027027027027027,0,0,0,0,-1.3831634800546193,-1.556758432558337,-0.7372407672780129,-1.146999599918175,5,1,5,1,1,1,1,1,0,1.5,-0.7186247266594448,5,5,5,5,2,2,1,4.142857142857143,0,1.8571428571428572,-1.5867162469311549,0,1,1,1,1,1,1,4,1,1,4,1,4,1,5,4,1,5,1,4,1,1,0,4.8,0,4.4,0,4.8,0,4.666666666666667,0,1,1,1,1,1,1,1,4,1,1,1,4,1,1,1,4,1,1,1,1,1.15,0,"Asian or Asian American (e.g., Chinese, Japanese, and others)",0,19,0,1,NA,5,2,0,0,1,0,0,TRUE,TRUE,TRUE,TRUE,TRUE,0,3,0.9298878048454843,0.82,0.06760752613893951,3,0.5226249999403954,0.7073093750029802,1,1,0.01249996258653087,0.01630834087848904,3,0.8402064516159796,1.0742781250178814,1,1,0.029759411969301142,0.20338684174743982,1.5078,1.0589,0.5112,1.2659,0.9899,0.6298,0.3474,1.5183196933333334,1.009482139,0.5031001193333333,2.1092,4.7299,0.2997,3.54,0.4094,-52.5484,0.9687,3.5205,0.3851,3.2575,0.5873,0.9725,1.9463437633333334,3.32640811,4.558300746666666,0.41147065066666666,0.30826416966666664,1.4138,2.7957,0.6146,1.5554,0.6702,0.8644,0.133,0.399,0.239,0.013,1.693,130.23076923076925,382,1.1318518518518519,1,0,0,1,FALSE,FALSE,FALSE
474,2021-11-13T08:05:04Z,1,1.5,1000,6,4,5,5,1,5,2,1,4,1,1,1,2,4,1,4,4,1,1,1,1,1,1,1,1,3,2,0,0,5,5,5,3,3,4,5,5,4,2,5,1,1,5,1,5,2,2,1,1,1,5,1,1,1,3,1,1,3,3,3,5,1,1,1,1,1,2,1,2,2,1,0,1.75,0,1.4,0,1.6666666666666667,0,1.25,0,1.1666666666666667,0,1.7142857142857142,0,1,0,1.4594594594594594,0,2,0,0,-1.1141868440486153,-1.1990217706969584,-0.0958522115332568,-0.6474369911151076,5,3,4,1,1,2,2,1.7142857142857142,0,2,-0.10679496349653231,5,5,5,5,4,3,1,4.571428571428571,0,1.4285714285714286,-0.4571894270818581,0,3,3,4,3,3,3,4,3,3,3,2,3,1,4,2,1,4,2,5,3,3.2,0,3.6,0,4.4,0,3,0,3.6666666666666665,0,1,1,1,4,1,2,1,3,1,1,1,4,1,3,1,4,1,2,1,2,1.3,0,"Hispanic of Latino (e.g., Mexican American, Central American, and others)",0,23,0,1,NA,5,2,0,0,1,0,0,TRUE,TRUE,TRUE,TRUE,TRUE,0,2,1.0312861111097866,0.72,0.07608234093471006,2,0.563828125,0.709512903224076,1,0.96875,0.004967971118917582,0.009424340554189484,2,0.8481774193548387,1.0127593750022352,0.96875,1,0.015458947580859812,0.021252387650312416,1.6027,0.6451,0.4994,1.1528,0.6583,0.7353,0.3448,1.6022861733333333,0.7213099279,0.4927339376666667,2.0452,5.0249,0.3603,3.679,0.4477,-58.1328,1.0456,5.1428,0.468,4.8116,0.5968,0.979,2.050116596666667,3.53661308,4.867548093333333,0.433567744,0.3534322503333333,1.2162,3.1707,0.6834,2.804,0.8203,0.9777,0.327,0.27,0.567,0.011,1.92,174.54545454545456,104,0.3081481481481481,1,1,1,2,FALSE,FALSE,FALSE
476,2021-11-13T08:01:27Z,0.8999999761581421,1.7786458333333333,768,4,4,4,5,3,4,2,2,4,2,2,1,1,4,3,4,5,2,1,1,1,1,1,1,2,1,2,0,0,5,4,5,5,5,5,5,5,5,2,5,3,2,5,2,5,2,2,2,2,2,5,1,1,1,3,1,2,2,2,1,5,1,5,1,1,1,2,1,2,2,1.25,0,1.75,0,1.8666666666666667,0,1.1111111111111112,0,1.8333333333333333,0,1.1666666666666667,0,1.8571428571428572,0,1,0,1.5405405405405406,0,1,0,0,-0.9082516071065188,-0.8561908030798041,-0.2989446853297732,-0.5775677442047886,5,1,5,1,1,1,2,1.1428571428571428,0,1,-0.8176513788914915,5,5,5,5,3,3,2,4.285714285714286,0,1.7142857142857142,-0.7395711320441822,0,2,3,2,1,2,2,4,2,1,3,2,5,2,4,4,2,4,1,4,2,2,0,4.4,0,3.8,0,4.2,0,4.133333333333334,0,1,1,1,4,1,1,1,4,1,1,1,4,1,1,1,4,1,1,1,1,1,0,"White, Caucasian, Anglo, European American",0,26,0,1,NA,5,2,0,0,1,0,0,TRUE,TRUE,TRUE,TRUE,TRUE,0,6,1.0132222222222158,0.72,0.08850988850612927,6,0.6414468749999869,0.7028199999999953,1,0.967741935483871,0.01930765676411203,0.021358012580644056,6,0.6617906249999869,0.7424161290322701,1,0.96875,0.01871506216734104,0.0057102288608847345,1.4334,0.6626,0.5867,1.342,0.5413,0.6531,0.3189,1.47445367,0.747360205,0.57377808,1.5871,2.9881,0.3759,2.9116,0.4515,-35.5647,1.1847,3.7044,0.4819,2.1865,0.4867,0.9598,1.8789857700000001,3.09255908,3.3766156533333334,0.41590446366666667,0.3541078816666667,0.9534,2.7862,0.5303,5.5893,0.6503,0.9895,0.311,0.183,0.645,0.017,1.628,95.76470588235293,400,1.1851851851851851,1,0,0,1,FALSE,FALSE,FALSE
477,2021-11-13T07:10:49Z,1,1.7777777777777777,1080,3,2,3,2,3,3,3,1,2,3,2,2,2,2,3,2,2,3,2,5,1,3,3,3,2,6,1,1,1,2,2,1,2,2,3,2,2,2,2,3,2,2,1,2,1,4,3,2,2,2,1,1,1,1,5,5,1,5,5,5,4,2,2,2,2,2,1,2,5,5,2.75,0,3.25,0,3,0,4,0,2.8333333333333335,0,2.8333333333333335,0,3,0,2,0,3.135135135135135,0,3,1,1,1.016612444311447,0.9607552511576953,0.9607303330589108,0.960742792108303,4,2,1,2,2,2,2,2.4285714285714284,0,2.5,0.5050347996663801,3,3,5,5,1,1,3,3,0,3,0.9547190977297628,0,2,1,1,1,1,2,3,2,2,1,1,4,4,4,4,4,3,2,2,3,1.2,0,4,0,2,0,3.8,0,3.2666666666666666,0,2,1,1,1,1,3,3,2,2,1,3,2,4,2,1,1,1,1,1,3,2.2,0,"White, Caucasian, Anglo, European American",0,29,0,1,NA,5,2,0,0,1,0,0,TRUE,TRUE,TRUE,TRUE,TRUE,0,3,0.9551677419408675,0.62,0.10696001225375167,3,0.5013633333563805,0.5572161290453327,0.9375,1,0.008151378712460996,0.003919305398803814,3,0.7401750000081957,0.7875870967641954,1,0.96875,0.01956386709574157,0.0222306825399176,1.5175,0.3301,0.3829,1.1216,0.5318,0.6302,0.4702,1.52423427,0.49754430502333336,0.3795735673333333,1.2579,3.0434,0.3201,5.0928,0.4337,-70.3533,0.8217,4.3807,0.4,5.6458,0.4838,0.9795,1.3833402463333333,4.926416053333333,3.3567596833333333,0.42178411,0.31167012,1.3193,2.6459,0.5252,3.3015,0.5847,0.9978,0.074,0.496,0.318,0.017,1.591,93.58823529411764,290,0.8592592592592593,1,0,0,1,FALSE,FALSE,FALSE
478,2021-11-13T07:56:48Z,1,1.7777777777777777,864,3,3,4,4,2,4,2,2,2,2,2,2,2,4,2,4,4,3,3,2,2,2,2,2,2,3,2,0,0,4,3,4,4,4,4,4,4,4,2,2,3,2,4,2,4,3,3,3,3,2,4,2,1,3,3,1,2,3,3,3,4,2,2,2,2,2,2,2,2,2,2.25,0,2,0,2.1333333333333333,0,2.111111111111111,0,2.5833333333333335,0,1.8333333333333333,0,2.2857142857142856,0,2,0,2.2972972972972974,0,2,0,0,0.18446597666787243,0.013372554648178757,-0.01745100881601569,-0.002039227083918466,3,2,3,2,3,2,2,2.4285714285714284,0,1,-0.048446712495193056,4,4,4,4,3,3,3,3.5714285714285716,0,2.4285714285714284,0.9547190977297628,0,3,3,3,3,3,2,4,2,3,2,3,4,3,3,3,3,3,2,3,3,3,0,3.6,0,3,0,3.2,0,3.2666666666666666,0,2,2,2,2,2,2,2,3,1,2,2,2,2,2,2,2,1,2,2,1,2,0,Prefer not to say,0,19,3,5,NA,5,2,0,0,0,0,0,TRUE,TRUE,TRUE,TRUE,TRUE,0,NA,NA,NA,NA,6,0.5430387096774216,0.6130935483871013,0.96875,0.96875,0.017042679354839493,0.015272903870969204,6,0.861765625,0.8642437500000196,1,1,0.07051352684476203,0.04466776770161948,NA,NA,NA,NA,NA,NA,NA,NA,NA,NA,1.7533,2.7143,0.2327,2.7799,0.3102,-25.597,1.1186,4.1123,0.399,5.3198,0.5059,0.92490000000000006,1.7335322366666666,2.866540236666667,2.869478583333333,0.313960459,0.238546996,1.4108,1.8549,0.5408,1.9297,0.5836,0.995,0.141,0.398,0.318,0.052,1.621,31.173076923076923,432,1.28,1,0,0,1,FALSE,FALSE,FALSE
479,2021-11-13T07:55:14Z,1,1.7786458333333333,768,6,4,3,4,4,3,4,3,3,4,4,3,3,2,1,2,1,2,3,4,2,1,4,3,4,2,2,0,0,4,4,3,4,4,5,4,4,5,2,4,1,1,2,2,4,5,3,3,5,5,2,1,3,1,5,5,1,4,1,1,3,5,4,1,2,1,1,1,1,1,2.875,0,1,0,3.3333333333333335,0,1.8888888888888888,0,2.9166666666666665,0,3,0,2.5714285714285716,0,1.3333333333333333,0,2.5405405405405403,0,1,0,0,0.7245206286486771,0.902197166626815,-0.5341482934814965,0.18402443657265927,5,2,3,1,1,2,1,1.5714285714285714,0,1,-0.5612498234260587,4,4,5,4,2,2,3,3.4285714285714284,0,2.5714285714285716,-0.7395711320441822,0,3,2,5,3,4,2,3,3,4,2,1,3,4,4,5,4,4,2,3,5,3.4,0,4,0,2.4,0,3,0,3.1333333333333333,0,3,1,3,1,3,3,4,4,4,4,2,1,1,4,2,2,1,3,3,3,2.8,0,"White, Caucasian, Anglo, European American",0,27,0,1,NA,5,2,0,0,1,0,0,TRUE,TRUE,TRUE,TRUE,TRUE,0,2,0.9178083333348235,0.72,0.07004887218011878,2,0.4487937499987893,0.5271290322590259,1,0.96875,0.002205985120979724,0.003658209828599464,2,0.5683062499999069,0.6839290322589298,1,0.96875,0.006799052217942457,0.006414565231945262,1.2117,0.7913,0.6229,1.0734,0.5842,0.6546,0.0387,1.2766401433333334,0.8513834626666666,0.6106500903333333,1.1718,5.8484,0.3486,3.8473,0.381,-89.5817,0.9493,7.4576,0.3856,6.6655,0.456,0.9897,1.2899226443333334,3.9729507533333335,5.677939643333334,0.37263839833333334,0.3391998526666667,0.9929,4.1574,0.4627,5.7997,0.6019,0.5662,0.103,0.382,0.592,0.008,1.357,169.625,336,0.9955555555555555,1,0,1,2,FALSE,FALSE,FALSE
480,2021-11-13T08:09:44Z,1,1.6,900,4,4,2,4,2,4,2,3,3,4,2,2,3,3,5,3,3,3,4,5,2,3,4,3,3,7,1,3,3,5,3,3,3,4,4,3,3,3,2,4,4,2,3,2,4,2,3,3,4,4,2,2,1,2,5,1,2,4,1,1,4,1,2,1,1,2,2,2,1,1,3.375,0,1.5,0,2.8666666666666667,0,2.5555555555555554,0,2.75,0,2.3333333333333335,0,1.7142857142857142,0,1.3333333333333333,0,2.3783783783783785,0,4,3,3,0.9346586255283681,0.8468331594339827,1.3811800968191483,1.1140066281265655,5,2,4,1,1,3,2,1.7142857142857142,0,1,-0.4757826382709144,5,5,5,5,3,3,2,4.285714285714286,0,1.7142857142857142,-1.3043345419688306,0,2,2,2,3,2,2,4,3,2,4,3,4,3,3,3,3,4,2,3,3,2.2,0,3.8,0,3.4,0,3.2,0,3.466666666666667,0,2,2,1,1,2,2,3,2,2,2,2,2,1,3,2,3,2,2,2,1,2.15,0,"Asian or Asian American (e.g., Chinese, Japanese, and others) & White, Caucasian, Anglo, European American",1,18,0,1,NA,5,2,0,0,1,0,0,TRUE,TRUE,TRUE,TRUE,TRUE,0,4,0.7891951219454044,0.8367346938775511,0.1039671439612157,4,0.4702290322588336,0.5315300000230472,1,0.9375,0.0028297561280799673,0.005198726288899415,4,0.6200593750029803,0.657696774182781,1,1,0.007601781198724721,0.005897156988337912,1.4013,1.2411,0.3962,1.1855,1.6015,0.4642,0.1801,1.41855821,1.1202902286666667,0.38944599333333335,1.0185,4.8997,0.3663,3.2757,0.3894,-80.4244,0.761,4.9442,0.3975,3.8793,0.4374,0.7272,1.168527514,3.5146366166666665,5.08753265,0.3779730626666667,0.3569046516666667,0.9352,3.2757,0.5083,4.296,0.5608,0.9862,0.179,0.329,0.615,0.024,1.33,55.41666666666667,104,0.3081481481481481,1,0,0,1,FALSE,FALSE,FALSE
481,2021-11-13T08:21:03Z,1,1.7777777777777777,720,8,3,3,3,3,3,4,2,2,4,2,2,2,2,1,3,3,2,4,4,3,2,3,3,3,4,2,3,0,3,3,3,4,4,4,3,3,3,3,3,4,3,3,3,4,3,4,4,4,4,2,4,4,4,4,4,3,3,3,1,3,2,3,2,2,2,2,2,2,2,3,0,2,0,2.8666666666666667,0,2.6666666666666665,0,3.3333333333333335,0,3.8333333333333335,0,2.4285714285714284,0,2,0,3.027027027027027,0,2,3,0,1.1048704030009173,0.9644332796075691,0.6024486139630555,0.7834409467853123,2,4,2,2,3,3,3,3.2857142857142856,0,2,0.8333440732100549,4,4,4,4,1,1,2,3.142857142857143,0,2.857142857142857,-0.1748077221195339,0,3,3,3,2,3,3,3,2,2,4,2,4,1,4,3,2,4,4,3,3,2.8,0,3.4,0,3.8,0,3.6,0,3.6,0,1,1,1,1,1,1,1,3,1,1,2,3,2,1,2,3,1,1,1,2,1.5,0,"White, Caucasian, Anglo, European American",0,29,0,1,NA,5,2,0,0,1,0,0,TRUE,TRUE,TRUE,TRUE,TRUE,0,6,0.6983108107914796,0.74,0.02128745792160262,6,0.46360400005340574,0.5946392857091768,0.8333333333333334,0.875,0.010269709242556735,0.027897738545736347,6,0.579551724137931,0.6349958333472411,0.90625,0.75,0.014023092104654005,0.029719468992015777,1.0479,1.0283,0.4495,0.9493,1.1252,0.4975,0.1545,1.112853863,1.0018614103333334,0.441210824,1.1068,1.5887,0.2232,1.8103,0.3435,-14.4006,0.7391,3.9203,0.3704,3.1591,0.4755,0.7838,1.1585323556666667,2.030167031,1.9442787793333334,0.33838092266666664,0.221911725,0.7646,2.9544,0.4762,1.9567,0.486,0.8575,0.05,0.385,0.257,0.011,1.531,139.1818181818182,320,0.9481481481481481,1,0,0,1,FALSE,FALSE,FALSE
482,2021-11-13T07:58:26Z,0.8999999761581421,1.7777777777777777,864,1,3,3,4,3,4,1,2,2,4,3,1,4,2,4,2,4,2,5,1,1,2,5,2,3,0,2,0,0,5,2,4,4,5,3,5,5,2,1,5,1,2,2,1,4,3,3,1,5,5,2,1,1,1,2,2,1,1,3,1,5,2,2,1,2,1,2,1,2,2,2.625,0,1.75,0,2.8666666666666667,0,2.111111111111111,0,2.4166666666666665,0,1.6666666666666667,0,1.4285714285714286,0,1.3333333333333333,0,2,0,0,0,0,0.2327977159502012,0.36191414538487376,-0.5020371591262895,-0.07006150687070789,5,1,3,1,1,1,1,1.2857142857142858,0,1,-0.7321841937363471,5,5,5,5,3,3,3,4.142857142857143,0,1.8571428571428572,1.5194825076544112,0,2,2,1,1,1,2,3,2,2,2,5,4,2,3,4,4,4,3,3,2,1.4,0,3.2,0,2.8,0,3.8,0,3.2666666666666666,0,1,1,4,1,4,4,4,1,4,4,2,1,1,4,2,1,2,4,4,4,3.25,0,"White, Caucasian, Anglo, European American",0,27,0,1,NA,5,2,0,0,1,0,0,TRUE,TRUE,TRUE,TRUE,TRUE,0,1,0.8391025641025641,0.78,0.12811102040816327,1,0.5773333333333334,0.7052068965517242,0.967741935483871,0.9666666666666667,0.03423413978494624,0.04880075402298851,1,0.5970625,0.6565806451612903,1,0.96875,0.020989673387096768,0.012883016129032258,1.3594,0.9313,0.4828,1.1419,0.767,0.5304,0.0073,1.3973746166666667,0.933827808,0.47339890933333334,1.5087,2.0232,0.2183,2.9255,0.4621,-20.543,1.3266,2.9319,0.3432,3.4206,0.46,0.3993,1.67603956,2.9821481933333334,2.3826900133333333,0.431938453,0.21510210133333332,1.4348,4.493,0.4291,5.5706,0.5296,0.973,0.092,0.329,0.357,0.013,1.542,118.61538461538463,407,1.2059259259259258,1,1,1,2,FALSE,FALSE,FALSE
483,2021-11-13T08:11:10Z,0.8999999761581421,1.7708333333333333,768,2,1,4,4,2,4,2,2,5,2,2,1,1,5,2,5,2,2,2,1,1,1,1,1,1,1,2,0,0,4,4,2,5,4,4,3,4,4,3,5,1,1,2,1,4,4,1,3,1,1,5,1,1,1,2,4,1,2,1,1,4,1,2,1,3,1,1,1,2,1,1.25,0,1.25,0,1.8,0,2.2222222222222223,0,1.9166666666666667,0,1.5,0,1.2857142857142858,0,1.6666666666666667,0,1.837837837837838,0,1,0,0,-0.723330169852391,-0.75707761537795,-0.4557470907642554,-0.6064123530711027,4,2,3,1,1,2,1,1.7142857142857142,0,1,-0.4757826382709144,3,4,4,3,1,1,3,2.7142857142857144,0,3.2857142857142856,0.10757398284279028,0,2,3,1,4,1,3,2,4,3,1,2,2,4,3,3,4,3,4,2,4,2.2,0,2.8,0,1.8,0,2.6,0,2.4,0,1,1,2,3,1,2,2,2,1,2,2,4,2,1,1,4,2,2,1,3,1.65,0,"White, Caucasian, Anglo, European American",0,23,0,1,NA,5,2,0,0,0,0,0,TRUE,TRUE,TRUE,TRUE,TRUE,0,2,0.8312674999999814,0.8163265306122449,0.034582752346970884,2,0.45093125000060535,0.517971874999348,1,1,0.00226263124999412,0.002407768538357174,2,0.5949250000003958,0.6485937500001164,1,1,0.003888285161265287,0.005962122540314511,1.3406,1.22,0.4828,1.0327,1.516,0.6133,0.2785,1.37224063,1.1086379533333333,0.4747937836666667,6.6874,11.6091,0.1629,11.2237,0.2201,-105.5562,0.7797,5.8819,0.3889,5.8799,0.4543,0.6624,1.7536954893333334,5.5133599166666665,6.089239513333333,0.36637833433333333,0.31269445733333334,0.8395,5.0523,0.5213,4.5517,0.5578,0.7341,0.166,0.353,0.692,0.016,1.224,76.5,300,0.8888888888888888,1,0,1,2,FALSE,FALSE,FALSE
484,2021-11-13T08:06:03Z,1,1.7777777777777777,1080,3,2,2,2,4,2,4,3,1,3,4,4,4,2,1,2,2,3,3,5,1,3,3,3,3,15,3,0,1,1,4,1,4,1,4,5,5,5,2,5,5,1,2,1,5,5,5,5,5,5,1,1,5,5,5,5,2,5,5,5,3,3,4,2,2,3,3,5,5,5,3,0,4.5,0,3.7333333333333334,0,2.6666666666666665,0,3.3333333333333335,0,4.166666666666667,0,3.7142857142857144,0,2.3333333333333335,0,3.3513513513513513,0,6,0,1,1.3066028800054197,1.4762599754741736,1.7553805604416417,1.6158202679579077,4,1,3,1,1,2,2,1.7142857142857142,0,3,0.2621927112778498,4,4,5,5,4,4,1,4.428571428571429,0,1.5714285714285714,0.6723373927674386,0,2,2,2,2,2,2,5,2,2,4,1,4,2,5,4,1,5,2,4,1,2,0,4.4,0,4.4,0,4.4,0,4.4,0,1,2,2,4,4,2,1,4,2,1,3,4,1,2,4,4,2,2,2,2,1.85,0,Black or African American,0,23,0,1,NA,5,2,0,0,0,0,0,TRUE,TRUE,TRUE,TRUE,TRUE,0,1,0.7818878048785576,0.82,0.021590756326738788,1,0.46468709677481845,0.5803225806451613,0.96875,0.96875,0.0021684678931149035,0.0033118044758133442,1,0.5911064516137684,0.62268387096855915,1,0.96875,0.0062450539570534,0.005954771250039111,1.1528,1.442,0.5304,1.0762,1.5508,0.5516,0.1717,1.2427877033333334,1.2011537566666666,0.49293333466666667,1.1697,4.6166,0.3473,4.083,0.4441,-82.0103,0.8065,6.6611,0.4034,4.5502,0.5011,0.9017,1.304756818,4.162265,4.80346863,0.433236729,0.3391436196666667,0.6786,3.4085,0.5265,3.5316,0.559,0.9488,0.254,0.217,0.674,0.051,1.771,34.72549019607843,322,0.9540740740740741,1,0,0,1,FALSE,FALSE,FALSE
485,2021-11-13T08:10:11Z,1,1.7777777777777777,1080,4,3,2,4,1,3,2,3,3,4,4,3,2,1,1,3,3,3,4,4,1,4,4,4,4,0,2,1,0,4,4,1,4,4,4,4,4,4,1,4,1,1,1,1,1,5,5,5,5,5,1,1,1,1,1,5,1,1,1,1,5,1,1,1,1,2,1,4,1,1,3.5,0,1.75,0,2.8666666666666667,0,2.3333333333333335,0,3.4166666666666665,0,2.1666666666666665,0,0.8571428571428571,0,1.3333333333333333,0,2.3513513513513513,0,0,1,0,0.9955986446234777,0.8889369061627975,-0.2954039515332659,0.2967664773147658,4,1,3,1,1,1,1,1.4285714285714286,0,2,-0.2777293338068208,5,5,5,5,1,1,1,3.857142857142857,0,2.142857142857143,0.38995568780511447,0,2,3,3,1,1,1,4,2,3,2,2,2,1,1,3,2,2,2,1,1,2,0,3.4,0,3.2,0,3.2,0,3.2666666666666666,0,1,1,1,2,1,1,1,1,2,1,1,3,1,1,1,3,1,1,1,1,1.4,0,"White, Caucasian, Anglo, European American",0,21,0,1,NA,5,2,0,0,0,0,0,TRUE,TRUE,TRUE,TRUE,TRUE,0,2,1.01570285714282,0.7,0.08332807217957132,2,0.48427499999993595,0.5732285714283851,1,0.9032258064516129,0.006650286451593352,0.009368586903211714,2,0.547903125000099,0.6171548387096714,1,0.96875,0.00762136224797981,0.00945671248989676,1.4615,0.6036,0.5475,1.3587,0.5649,0.6209,0.4307,1.49215132,0.6998994173666667,0.536888605,1.1288,3.3243,0.3145,2.7409,0.3993,-53.4016,0.8788,4.5341,0.3919,3.2589,0.4443,0.9967,1.281895649,2.9779245766666667,3.71981801,0.384700479,0.3062473333333333,0.7333,3.5877,0.4676,3.4066,0.5467,0.9883,0.082,0.351,0.428,0.01,1.275,127.49999999999999,315,0.9333333333333332,1,0,0,1,FALSE,FALSE,FALSE
486,2021-11-13T07:58:27Z,1,1.7786458333333333,768,3,3,4,4,3,3,3,2,4,3,2,1,2,4,3,4,3,2,2,1,1,2,2,2,2,0,2,0,0,4,3,3,3,4,4,3,4,4,4,3,3,3,3,3,4,4,4,3,4,4,3,1,1,1,2,4,1,1,1,1,4,3,3,1,3,1,2,3,3,3,1.75,0,2.75,0,2.3333333333333335,0,2.4444444444444446,0,3.3333333333333335,0,1.8333333333333333,0,1.5714285714285714,0,1.6666666666666667,0,2.4594594594594597,0,0,0,0,-0.02567202021181809,-0.04586306143925698,-0.18843234825732513,-0.11714770484829105,4,2,3,2,2,3,3,2.4285714285714284,0,3.5,0.8740224744407622,4,5,4,3,3,3,3,3.5714285714285716,0,2.4285714285714284,0.38995568780511447,0,2,3,2,1,2,2,4,2,2,3,1,3,4,4,3,3,4,3,3,3,2,0,3.8,0,3,0,3.6,0,3.466666666666667,0,3,3,3,4,3,2,2,3,2,1,4,2,2,2,2,2,1,3,2,2,2.3,0,"White, Caucasian, Anglo, European American",0,30,0,1,NA,5,2,1,0,1,0,1,TRUE,TRUE,TRUE,TRUE,TRUE,0,2,1.0388318181810055,0.88,0.09854823086253944,2,0.5750249999947846,0.6581290322657555,1,0.96875,0.0173060909690695,0.01315217208534989,2,0.7987999999970198,0.8605,1,1,0.018803703226133704,0.03328002709582036,1.6506,1.2463,0.5423,1.475,1.4788,0.6314,0.5562,1.6157475833333332,1.1173839726666666,0.535459443,1.551,3.446,0.35,3.1796,0.4261,-47.0681,1.2991,4.8297,0.4276,3.0936,0.469,0.9049,1.7471057033333333,3.329528113333333,3.7402399933333332,0.4063321046666667,0.33558843033333335,1.6603,4.9485,0.6307,3.424,0.6095,0.9534,0.193,0.342,0.419,0.02,1.279,63.949999999999996,69,0.20444444444444443,1,0,8,9,FALSE,FALSE,FALSE
487,2021-11-13T08:06:00Z,1,1.7777777777777777,720,4,4,4,4,3,4,3,2,5,2,2,2,3,5,3,4,4,2,2,1,1,1,1,2,2,0,2,0,0,5,4,3,3,3,3,2,3,3,2,4,2,1,4,2,3,3,3,2,3,3,5,1,2,1,3,4,2,1,2,1,4,1,2,1,1,1,1,2,1,1,1.5,0,1.25,0,2.1333333333333333,0,2.7777777777777777,0,2.3333333333333335,0,1.8333333333333333,0,1.4285714285714286,0,1,0,2.135135135135135,0,0,0,0,-0.3829066149072922,-0.3786278459304421,-0.6588395645607719,-0.5187337052456069,4,2,4,1,1,2,2,1.7142857142857142,0,1.5,-0.2912888008837234,5,5,5,5,4,4,1,4.714285714285714,0,1.2857142857142858,-1.0219528370065065,0,2,2,3,3,3,2,4,3,2,4,1,4,3,4,5,3,3,2,3,4,2.6,0,4,0,3.4,0,3.6,0,3.6666666666666665,0,2,2,1,4,2,2,2,3,1,2,2,4,2,2,2,4,1,2,2,2,1.7,0,"Asian or Asian American (e.g., Chinese, Japanese, and others)",0,20,0,1,NA,5,2,0,0,3,0,0,TRUE,TRUE,TRUE,TRUE,TRUE,0,1,1.1532923076932247,0.78,0.37062570295891517,1,0.5858937499988824,0.6159687499990687,1,1,0.07049773157249113,0.0434886893139751,1,0.5951193548373638,0.7180419354852169,1,0.96875,0.012609034279998403,0.03705332500010964,1.7284,0.7179,0.5426,1.5771,0.6212,0.5565,8e-4,1.6998573966666666,0.7590560086666667,0.5376509593333333,1.5487,2.5266,0.2794,2.957,0.3541,-30.6434,1.3933,2.4541,0.2902,3.2432,0.3732,0.7821,1.60660368,3.0820630533333335,2.7526426466666667,0.3493388253333333,0.278163634,1.1677,4.0964,0.4484,4.1895,0.5496,0.9577,0.072,0.419,0.444,0.013,1.659,127.61538461538463,360,1.0666666666666667,1,1,6,7,FALSE,FALSE,FALSE
488,2021-11-13T08:32:35Z,0.8999999761581421,1.6,900,4,2,4,4,3,4,5,2,4,3,3,1,1,4,1,5,5,4,3,1,1,2,1,2,1,5,4,0,0,3,4,5,5,5,5,5,5,5,3,5,2,3,4,5,3,4,3,2,2,2,4,1,1,1,3,3,1,4,4,3,3,1,3,1,1,1,3,2,4,4,1.875,0,3.25,0,2.066666666666667,0,1.3333333333333333,0,2.6666666666666665,0,1.6666666666666667,0,2.5714285714285716,0,1,0,2.081081081081081,0,3,0,0,-0.1832755178715861,-0.2693516848802533,0.5776474785667063,0.1541478968432265,5,1,4,1,2,2,3,1.7142857142857142,0,3,0.2621927112778498,3,3,4,2,1,3,3,2.7142857142857144,0,3.2857142857142856,-0.7395711320441822,0,3,3,2,2,2,2,3,4,3,2,1,3,4,3,4,5,5,4,3,5,2.4,0,3.8,0,2.2,0,2.6,0,2.8666666666666667,0,2,1,1,2,4,3,3,1,3,3,2,3,2,3,1,3,1,2,1,4,2.35,0,"Asian or Asian American (e.g., Chinese, Japanese, and others)",0,24,0,1,NA,5,2,0,0,1,0,0,TRUE,TRUE,TRUE,TRUE,TRUE,0,2,0.7766352941148421,0.6938775510204082,0.0221807263539146,2,0.4527599999944369,0.4889366666555405,0.9375,0.9375,0.003218162811099007,0.0031523891010175396,2,0.5919625000059605,0.6352406250052154,1,1,0.010405581127617747,0.006600063778295539,1.143,0.7568,0.4882,0.6161,1.3037,0.6778,0.4496,1.2059612193333333,0.8379689679,0.479616021,0.8622,3.8359,0.3506,3.3159,0.3711,-79.7999,0.741,4.216,0.3714,5.232,0.4205,0.9939,0.9545423843333334,3.5634140233333333,4.092610956666666,0.3654174336666667,0.34430348466666666,0.8651,2.9015,0.4858,4.3293,0.5465,0.9453,0.229,0.222,0.632,0.018,1.234,68.55555555555556,468,1.3866666666666665,1,0,0,1,FALSE,FALSE,FALSE
489,2021-11-13T08:34:54Z,1,1.6,900,6,4,5,5,2,5,2,1,4,2,2,1,2,5,2,4,3,2,2,1,1,2,2,2,1,0,2,0,0,4,3,5,4,3,5,4,5,3,2,5,2,1,4,2,5,1,2,2,2,2,4,1,1,1,1,1,1,1,2,1,5,1,1,1,1,1,1,1,1,1,1.625,0,1,0,1.6666666666666667,0,2,0,1.6666666666666667,0,1,0,1,0,1,0,1.5135135135135136,0,0,0,0,-0.6918094703204373,-0.7925996269859388,-0.7372407672780129,-0.7649201971319759,5,2,4,1,1,1,1,1.2857142857142858,0,2.5,-0.17870268157477404,5,5,5,5,3,3,1,4.428571428571429,0,1.5714285714285714,-1.3043345419688306,0,2,2,3,1,2,2,4,2,1,5,2,3,2,5,4,3,4,2,3,3,2,0,3.8,0,3.8,0,4.2,0,3.933333333333333,0,2,1,2,3,3,1,2,3,1,1,3,3,2,3,1,3,1,2,2,2,1.85,0,"Asian or Asian American (e.g., Chinese, Japanese, and others)",0,23,0,1,NA,5,2,0,0,1,0,0,TRUE,TRUE,TRUE,TRUE,TRUE,0,5,0.7467069767242254,0.86,0.01824047118357775,5,0.43857741934253325,0.46017500000447037,1,1,9.391158059999505e-4,0.0018320141939454696,5,0.5693843750208616,0.6601906249970197,1,1,0.0032403774900163188,0.00618266345421201,1.2511,1.6644,0.481,0.9023,1.6561,0.5768,0.1125,1.27351334,1.3295942433333334,0.4735812286666667,10,17.6356,0.1551,13.9551,0.1019,-120.6088,0.7036,7.9032,0.3959,6.6334,0.4118,0.9671,1.464232475,5.469003066666667,6.951700773333333,0.33388332066666665,0.34111705033333334,0.986,5.3696,0.4845,5.5802,0.5662,0.8844,0.103,0.422,0.709,0.021,1.937,92.23809523809524,438,1.2977777777777777,1,0,0,1,FALSE,FALSE,FALSE
491,2021-11-13T08:33:59Z,0.8999999761581421,1.7777777777777777,1080,2,2,3,4,3,3,2,2,4,2,2,3,2,3,2,2,3,1,3,1,1,1,1,2,1,0,3,0,0,5,4,2,2,2,4,4,2,2,1,5,1,1,3,1,5,3,2,2,1,1,3,1,1,1,1,1,1,1,1,1,4,1,2,1,1,1,1,1,1,1,1.375,0,1,0,2.533333333333333,0,3,0,1.5,0,1.1666666666666667,0,1.1428571428571428,0,1,0,1.7567567567567568,0,0,0,0,-0.696012230258031,-0.42305455799601904,-0.7372407672780129,-0.580147662637016,4,2,3,1,2,3,2,2.142857142857143,0,1,-0.21938108280548152,4,4,5,4,2,2,1,3.7142857142857144,0,2.2857142857142856,0.6723373927674386,0,2,2,2,2,2,2,2,3,2,2,2,4,2,3,4,4,4,2,3,3,2,0,4,0,2.6,0,3.4,0,3.3333333333333335,0,1,1,2,3,1,2,1,2,3,2,2,1,1,3,1,1,1,2,2,2,2,0,"Asian or Asian American (e.g., Chinese, Japanese, and others)",0,27,0,1,NA,5,2,0,0,1,0,0,TRUE,TRUE,TRUE,TRUE,TRUE,0,3,1.1051944444444444,0.7659574468085106,0.28986854024051806,3,0.4211875,0.49734375000000003,1,1,0.005002028225806453,0.007076361895161291,3,0.59875,0.6710625,1,1,0.004209225806451614,0.004707221774193548,1.7126,0.6944,0.5584,1.4144,0.4905,0.6333,0.056,1.6896494433333333,0.7387267166666667,0.5503557106666667,5.27,8.276,0.1028,7.4277,0.1426,-78.1669,0.7945,7.3222,0.3651,7.2321,0.4377,0.9407,1.8626171466666666,4.51621365,5.016224786666666,0.294659691,0.23723029833333334,0.7315,4.2176,0.5297,5.5079,0.6074,0.9858,0.168,0.378,0.774,0.023,1.846,80.26086956521739,316,0.9362962962962963,1,0,0,1,FALSE,FALSE,FALSE
492,2021-11-13T08:48:38Z,0.8999999761581421,1.6,1050,4,3,4,4,2,4,1,1,4,1,1,1,1,4,1,4,4,1,1,1,1,1,1,1,1,0,2,0,0,5,4,4,4,4,4,4,4,4,1,5,1,1,4,4,4,1,1,1,1,1,5,1,1,1,1,1,1,1,1,1,5,1,1,1,1,1,1,1,1,1,1,0,1,0,1.5333333333333334,0,1.8888888888888888,0,1.4166666666666667,0,0.8333333333333334,0,0.8571428571428571,0,1,0,1.3513513513513513,0,0,0,0,-1.1814310030501165,-1.1881812657920683,-0.7372407672780129,-0.9627110165350405,4,1,3,1,1,2,2,1.7142857142857142,0,1,-0.4757826382709144,4,4,4,4,4,4,1,4.142857142857143,0,1.8571428571428572,0.10757398284279028,0,3,1,1,5,4,4,4,2,2,4,4,2,4,4,4,3,4,4,4,4,2.8,0,2.4,0,3.4,0,3.6,0,3.1333333333333333,0,1,1,1,3,1,1,1,4,1,1,1,4,1,1,1,3,1,1,1,1,1.1,0,"Asian or Asian American (e.g., Chinese, Japanese, and others)",0,21,0,1,NA,5,2,0,0,1,0,0,TRUE,TRUE,TRUE,TRUE,TRUE,0,5,0.7019705882352941,0.68,0.03434441469387755,5,0.596625,0.6276875,1,1,0.04241217741935484,0.04468293145161291,5,0.922,0.97684375,1,1,0.1123251612903226,0.07753394254032259,1.1945,0.6666,0.3739,1.0497,0.8076,0.4531,0.2503,1.2487722123333334,0.774126467,0.36736999466666664,1.3736,2.6694,0.3393,2.9081,0.3915,-36.9429,1.3328,2.2496,0.3291,3.0189,0.3874,0.5269,1.5593462466666668,3.132113873333333,2.9796067366666668,0.37322912933333335,0.32153144933333333,1.655,1.8512,0.5239,2.503,0.6484,0.9937,0.202,0.228,0.298,0.018,1.492,82.8888888888889,350,1.0370370370370372,1,0,2,3,FALSE,FALSE,FALSE
493,2021-11-13T08:24:33Z,1,1.7777777777777777,1080,6,3,1,4,4,4,2,1,1,4,3,4,2,1,1,2,3,2,4,1,1,1,4,2,1,0,2,0,0,3,4,4,4,4,5,4,4,4,2,4,4,4,4,3,4,4,4,2,4,4,2,1,1,1,1,1,1,1,1,1,5,1,1,1,1,1,1,1,1,1,2,0,1,0,3.1333333333333333,0,2,0,3.0833333333333335,0,1.3333333333333333,0,0.8571428571428571,0,1,0,2,0,0,0,0,-0.15595757827722637,0.20792090160201304,-0.7372407672780129,-0.26465993283799993,4,2,3,2,4,1,3,2.4285714285714284,0,1,-0.048446712495193056,5,5,5,5,3,3,1,4.428571428571429,0,1.5714285714285714,2.0842459175790595,0,2,2,2,3,2,2,4,2,4,4,2,4,2,4,4,2,3,3,4,4,2.2,0,3.6,0,4,0,3.2,0,3.6,0,2,2,2,1,1,2,2,3,2,2,3,2,2,1,1,2,2,2,1,2,2.05,0,"Asian or Asian American (e.g., Chinese, Japanese, and others)",0,27,0,1,NA,5,2,0,0,1,0,0,TRUE,TRUE,TRUE,TRUE,TRUE,0,NA,NA,NA,NA,6,0.3467032258029907,0.3973899999966224,0.96875,0.967741935483871,7.604088709679103e-4,0.0028300820645775545,6,0.5285562500017695,0.619679310345958,1,0.9666666666666667,0.009501079314818426,0.005954027540131798,NA,NA,NA,NA,NA,NA,NA,NA,NA,NA,0.7859,5.9396,0.2873,4.0862,0.3055,-108.005,0.5951,7.9866,0.3133,6.4838,0.354,0.9204,0.831770979,4.1029293000000004,5.615195286666666,0.3021535203333333,0.28359487066666667,0.9582,4.6324,0.4215,4.4735,0.519,0.9756,0.071,0.382,0.491,0.011,1.456,132.36363636363637,316,0.9362962962962963,1,0,6,7,FALSE,TRUE,FALSE
494,2021-11-13T08:37:44Z,0.8999999761581421,1.7777777777777777,720,7,3,4,4,2,4,2,2,4,2,2,2,2,4,2,4,4,2,2,2,2,2,2,2,2,1,2,0,0,4,4,4,4,4,4,4,4,4,4,4,2,2,4,3,4,2,2,2,2,2,4,1,1,1,3,1,1,1,1,1,4,1,1,1,1,1,2,1,2,1,2,0,1.5,0,2,0,2,0,2.25,0,1.3333333333333333,0,1,0,1,0,1.7567567567567568,0,1,0,0,-0.30725693603060344,-0.3836609374934269,-0.3773458880470143,-0.3805034127702206,4,2,4,2,2,2,2,2,0,1.5,-0.12035443057343476,4,4,4,4,3,3,2,3.7142857142857144,0,2.2857142857142856,-0.7395711320441822,0,2,2,2,2,2,2,2,2,2,4,2,4,2,4,4,2,4,2,3,3,2,0,4,0,3.4,0,3.8,0,3.7333333333333334,0,1,1,1,3,1,1,1,3,1,1,1,3,1,1,1,3,1,1,1,1,1.2,0,"Asian or Asian American (e.g., Chinese, Japanese, and others)",0,28,0,1,NA,5,2,0,0,1,0,0,TRUE,TRUE,TRUE,TRUE,TRUE,0,4,0.9220428571360452,0.84,0.11376379003568367,4,0.46143437500298023,0.5810343749895692,1,1,0.004027958460270453,0.013085743614080003,4,1.361237500011921,1.4467968749925495,1,1,0.13795315339438285,0.1697741699799048,1.5465,1.079,0.5186,1.3118,0.9028,0.628,0.237,1.5489050933333333,1.021019923,0.5106573093333333,2.447,6.818,0.282,4.75,0.3235,-76.2773,0.9309,5.1421,0.376,4.1694,0.4689,0.9964,1.8036214333333334,3.9561332,5.59172346,0.35456217,0.30417841866666667,2.0231,2.6684,0.9786,2.6299,1.0819,0.9931,0.314,0.274,0.278,0.317,1.317,4.1545741324921135,104,0.3081481481481481,1,0,1,2,FALSE,FALSE,FALSE
495,2021-11-13T09:00:24Z,1,1.7777777777777777,1080,3,4,5,5,3,4,2,1,5,2,3,1,2,5,2,4,4,2,2,1,1,1,2,2,2,0,2,0,0,3,4,4,5,4,5,4,5,5,2,4,2,1,3,2,4,2,2,2,1,1,5,1,1,1,3,1,1,1,1,1,5,1,3,1,1,1,1,1,1,1,1.625,0,1,0,1.7333333333333334,0,1.6666666666666667,0,1.8333333333333333,0,1.1666666666666667,0,1.1428571428571428,0,1,0,1.5405405405405406,0,0,0,0,-0.6749984305700623,-0.7523348944820606,-0.7372407672780129,-0.7447878308800367,5,2,4,1,2,2,1,1.5714285714285714,0,1,-0.5612498234260587,4,4,4,4,4,4,2,4,0,2,-0.7395711320441822,0,3,3,3,2,2,3,2,4,2,3,3,3,2,4,3,5,3,4,4,3,2.6,0,2.8,0,2.8,0,3.2,0,2.933333333333333,0,1,1,1,2,3,4,2,2,2,1,2,3,2,2,1,2,1,3,3,3,2.15,0,"White, Caucasian, Anglo, European American",0,19,0,1,NA,5,2,0,0,1,0,0,TRUE,TRUE,TRUE,TRUE,TRUE,0,NA,NA,NA,NA,4,0.4977741935483871,0.595741935483871,0.96875,0.96875,0.012194951612903225,0.01376677016129032,4,0.7783125,0.8448064516129032,1,0.96875,0.06129777016129031,0.02317962802419355,NA,NA,NA,NA,NA,NA,NA,NA,NA,NA,2.1663,3.8478,0.2348,3.7322,0.298,-45.2309,0.91,2.9037,0.3651,4.4722,0.495,0.8353,1.68226235,2.4736431933333334,3.7067874366666667,0.2532100016666667,0.27335396966666664,1.4299,2.5285,0.4931,2.6681,0.5905,0.8848,0.106,0.369,0.267,0.015,2.05,136.66666666666666,246,0.7288888888888888,1,1,5,6,FALSE,FALSE,FALSE
496,2021-11-13T08:49:09Z,0.8999999761581421,1.7777777777777777,1080,4,2,2,3,4,2,2,4,3,4,3,4,5,1,1,3,4,2,2,1,1,1,2,4,1,4,2,0,0,5,5,4,5,5,2,3,4,3,2,4,5,1,4,2,5,2,3,2,5,5,4,1,1,1,1,1,1,3,4,3,4,4,4,1,3,3,4,2,4,5,1.75,0,3.75,0,3.4,0,2,0,2.6666666666666665,0,1,0,2.857142857142857,0,2.3333333333333335,0,2.2972972972972974,0,2,0,0,-0.12653825871406965,0.34284647157895054,0.5313574102046721,0.4371019408918113,3,2,3,1,1,2,3,2.142857142857143,0,2.5,0.33410042935609163,2,4,3,5,2,2,3,3,0,3,1.5194825076544112,0,3,3,3,1,2,3,5,3,3,5,4,4,2,4,3,4,3,2,2,4,2.4,0,3.2,0,3.6,0,3,0,3.2666666666666666,0,1,2,4,3,3,2,3,2,1,3,2,2,2,4,1,2,1,3,2,2,2.35,0,"White, Caucasian, Anglo, European American",0,21,0,1,NA,5,2,0,0,1,0,0,TRUE,TRUE,TRUE,TRUE,TRUE,0,5,0.8899200000000005,0.9,0.15973604202449368,5,0.42434666666666937,0.5486666666666744,1,0.9375,0.00285545498850638,0.008272996038306805,5,0.5844612903225822,0.6503259259259018,0.96875,0.84375,0.008520280635082929,0.013275787056451379,1.6354,1.3712,0.4921,1.3095,1.2772,0.5628,0.038,1.5852550166666666,1.1955525846666666,0.487962932,1.4909,5.4599,0.2862,4.3601,0.3817,-75.6743,1.0293,5.8964,0.3369,4.6578,0.4287,0.9949,1.4589085863333333,3.243367613333333,5.116437723333333,0.339766934,0.28361841,0.8623,3.8768,0.4848,2.7824,0.5306,0.8245,0.059,0.41,0.375,0.011,1.712,155.63636363636365,104,0.3081481481481481,1,0,1,2,FALSE,FALSE,FALSE
497,2021-11-13T09:03:39Z,1,1.7777777777777777,1080,6,2,3,5,4,5,2,1,3,3,2,1,3,4,2,3,4,2,3,4,1,1,2,1,1,0,2,0,5,5,5,4,5,5,5,5,5,5,2,5,1,3,3,5,3,5,5,4,5,5,2,5,3,1,1,1,1,1,1,1,5,1,1,1,1,2,1,2,1,1,1.875,0,1.25,0,2.2,0,1.1111111111111112,0,3.5,0,2.3333333333333335,0,0.8571428571428571,0,1.3333333333333333,0,2.108108108108108,0,0,0,5,-0.16646447812121104,-0.20043704655630842,0.22340866993513192,0.011485811689411748,5,1,5,1,1,2,2,1.2857142857142858,0,3,0.005791155812417015,5,5,5,5,5,5,1,5,0,1,-0.7395711320441822,0,2,3,3,1,2,3,5,2,3,5,4,5,1,5,4,1,4,3,5,1,2.2,0,3.4,0,5,0,4.2,0,4.2,0,1,1,1,4,3,1,2,2,3,2,4,4,1,1,1,4,1,1,1,2,1.6,0,"Asian or Asian American (e.g., Chinese, Japanese, and others)",0,27,0,1,NA,5,2,0,0,1,0,0,TRUE,TRUE,TRUE,TRUE,TRUE,0,2,0.6590571428571429,0.7,0.01818894734693877,2,0.41435714285714287,0.48244,0.9333333333333333,0.78125,0.002053627586206897,0.008660564516129031,2,0.53934375,0.60692,1,0.78125,0.008230039314516128,0.01382082258064516,1.1344,0.7909,0.4139,0.7815,0.629,0.551,0.2338,1.195012827,0.8626768973333333,0.40650909766666665,0.7943,4.3687,0.3338,1.4748000000000001,0.3099,-61.521,0.6829,4.5301,0.3467,2.5591,0.3741,0.9898,0.842803471,1.82961356,4.479235293333334,0.30621331366666665,0.330083104,0.7531,3.874,0.4644,2.2971,0.4912,0.8606,0.055,0.368,0.33,0.016,2.005,125.31249999999999,472,1.3985185185185185,1,0,0,1,FALSE,FALSE,FALSE
498,2021-11-13T08:57:35Z,1,1.7786458333333333,768,4,3,4,5,2,5,1,1,1,1,1,1,2,4,3,4,2,3,2,2,1,1,1,1,1,3,2,0,3,5,3,4,4,4,4,3,4,4,1,4,1,1,4,1,5,1,1,1,1,1,4,1,1,1,4,1,1,4,4,1,1,1,1,1,1,1,1,2,4,3,1.5,0,2.5,0,1.9333333333333333,0,2.111111111111111,0,1.1666666666666667,0,1.5,0,2.2857142857142856,0,1,0,1.7027027027027026,0,2,0,3,-0.6518832509132961,-0.6504147903316194,0.6687003373160088,0.009142773492194667,3,2,3,2,1,1,1,1.8571428571428572,0,1.5,-0.20582161572857902,4,4,5,4,5,4,1,4.428571428571429,0,1.5714285714285714,0.10757398284279028,0,3,4,4,3,4,2,4,2,1,4,1,4,1,5,4,3,4,1,4,1,3.6,0,4.4,0,4,0,4.6,0,4.333333333333333,0,2,2,1,3,2,1,1,3,2,1,2,3,2,1,1,3,1,1,1,1,1.5,0,"White, Caucasian, Anglo, European American",0,28,0,1,NA,5,2,0,0,1,0,0,TRUE,TRUE,TRUE,TRUE,TRUE,0,1,0.8519292682926852,0.82,0.039393255710202,1,0.5485387096774554,0.6427548387096744,0.96875,0.96875,0.004984866764102903,0.005819197006050893,1,0.7403062499999651,0.7684781250000232,1,1,0.026266522540329528,0.02347719208670476,1.5418,1.1117,0.4029,0.8791,1.7849,0.6819,0.5022,1.53024762,1.0373882403333334,0.39864536333333334,1.1492,4.0662,0.4135,3.2098,0.476,-67.0789,1.024,4.7524,0.4404,5.5095,0.5498,0.9948,1.3957840676666666,3.52341045,4.392679216666667,0.4561662023333333,0.39467935666666665,1.3897,2.5408,0.504,2.7024,0.5301,0.9579,0.143,0.36,0.368,0.086,1.812,21.069767441860467,328,0.9718518518518519,1,0,0,1,FALSE,FALSE,FALSE
499,2021-11-13T08:38:22Z,1,1.25,1024,4,3,5,5,2,5,1,1,4,1,1,1,1,5,1,5,5,1,1,1,1,1,1,1,1,0,2,0,0,5,5,5,5,5,5,5,5,5,1,5,1,1,5,2,5,1,1,1,1,1,5,1,1,1,1,1,1,1,1,1,5,1,1,1,1,1,1,1,1,1,1,0,1,0,1.1333333333333333,0,1,0,1.0833333333333333,0,0.8333333333333334,0,0.8571428571428571,0,1,0,1.027027027027027,0,0,0,0,-1.3831634800546193,-1.4994586209182028,-0.7372407672780129,-1.118349694098108,3,1,3,1,1,1,1,1.5714285714285714,0,1,-0.5612498234260587,4,4,4,3,3,3,3,3.4285714285714284,0,2.5714285714285716,-0.7395711320441822,0,1,2,3,2,2,3,4,2,2,3,1,3,2,3,4,4,4,1,3,4,2,0,4,0,3.2,0,3.4,0,3.533333333333333,0,2,1,1,3,2,1,3,3,2,1,1,3,3,2,1,3,1,1,2,3,1.75,0,Prefer not to say,0,21,3,5,NA,5,2,0,0,1,0,0,TRUE,TRUE,TRUE,TRUE,TRUE,0,2,0.9625249999978326,0.88,0.08410022216009373,2,0.4527129032275369,0.5458482758618635,0.96875,0.90625,0.0018128077017237438,0.012101860635823468,2,0.543587096773809,0.6092566666642825,0.96875,0.9375,0.005858051361274707,0.00899798931435611,1.5534,1.4038,0.5638,1.2655,1.6965,0.6489,0.1859,1.53446396,1.2204595636666666,0.555501521,1.1255,4.7922,0.3432,2.2084,0.3222,-61.1016,0.929,6.1835,0.3778,2.7759,0.402,0.983,1.204947812,2.4619763,4.836627193333333,0.31758014966666664,0.33763035566666666,0.9571,4.2486,0.4399,3.8141,0.4777,0.8466,0.056,0.398,0.343,0.016,1.406,87.875,295,0.874074074074074,1,0,0,1,FALSE,FALSE,FALSE
500,2021-11-13T09:02:02Z,1,1.6,900,4,3,2,3,3,4,3,3,4,4,4,3,4,2,2,3,2,4,4,4,1,3,4,4,3,2,2,3,0,3,2,2,2,2,2,2,2,2,5,3,4,3,2,3,2,4,4,4,5,5,2,3,3,1,3,1,1,1,1,1,2,4,4,3,3,3,3,4,2,2,3.375,0,2.75,0,3.2,0,3.888888888888889,0,4,0,2.3333333333333335,0,2.142857142857143,0,3,0,3.324324324324324,0,1,3,0,1.5230450167915015,1.396601622467703,0.6345597483182625,1.0155806853929827,4,2,2,2,2,1,1,2,0,1.5,-0.12035443057343476,4,3,4,4,2,2,2,3.2857142857142856,0,2.7142857142857144,1.5194825076544112,0,2,2,3,3,3,3,3,2,2,3,1,3,2,4,5,1,4,2,4,3,2.6,0,3.8,0,3.8,0,4,0,3.8666666666666667,0,1,2,1,3,1,1,2,3,1,1,1,4,1,2,1,3,1,2,1,1,1.35,0,"Hispanic of Latino (e.g., Mexican American, Central American, and others) & White, Caucasian, Anglo, European American",1,22,0,1,NA,5,2,0,0,1,0,0,TRUE,TRUE,TRUE,TRUE,TRUE,0,5,0.8972794871697058,0.78,0.048861601104445415,5,0.4096451612903226,0.5300333333333334,0.96875,0.9375,0.0029323316022900796,0.00785692253371212,5,0.5511032258002989,0.6091275861920982,0.96875,0.90625,0.005784395117240318,0.009743193778444702,1.2638,1.3165,0.559,1.1693,1.2234,0.5961,0.485,1.38042501,0.9726658446666666,0.5083989623333334,1.2878,3.8132,0.2515,2.9459,0.3308,-56.645,0.7166,4.6401,0.3396,3.4126,0.4496,0.9851,1.3692042773333333,3.13926245,4.0607033066666665,0.32555570833333336,0.24820022966666666,0.8162,7.4482,0.5002,4.5644,0.5099,0.9649,0.059,0.38,0.328,0.023,2.058,89.4782608695652,434,1.285925925925926,1,0,0,1,FALSE,FALSE,FALSE
501,2021-11-13T09:00:15Z,0.8999999761581421,1.7777777777777777,1080,3,3,5,5,1,4,1,1,4,3,1,1,3,2,3,3,3,2,3,1,1,1,2,2,2,0,2,0,0,5,2,2,5,3,4,4,5,4,2,4,2,1,3,4,5,4,4,3,4,5,3,1,1,1,3,5,1,1,1,1,5,2,3,1,1,1,3,2,3,3,1.75,0,2.75,0,2,0,2.2222222222222223,0,2.9166666666666665,0,2.1666666666666665,0,1.2857142857142858,0,1,0,2.2162162162162162,0,0,0,0,-0.1769713779651954,-0.2936460306938916,-0.18843234825732513,-0.24103918947560837,5,2,2,2,2,2,3,2.2857142857142856,0,2.5,0.41956761451123586,5,5,4,5,3,3,1,4.285714285714286,0,1.7142857142857142,0.9547190977297628,0,2,2,4,4,4,3,4,2,3,4,1,4,5,4,4,1,4,3,4,4,3.2,0,3.8,0,3.6,0,3.4,0,3.6,0,2,1,2,3,3,2,2,2,3,2,3,3,3,2,2,3,1,2,2,3,2.2,0,"Hispanic of Latino (e.g., Mexican American, Central American, and others) & White, Caucasian, Anglo, European American",1,23,0,1,NA,5,2,0,0,1,0,0,TRUE,TRUE,TRUE,TRUE,TRUE,0,6,0.9005675675675613,0.7551020408163265,0.14784585147109253,6,0.5587700000000012,0.638296875,1,1,0.003940589068965195,0.0032384816028226343,6,0.7163374999999979,0.777158064516126,1,1,0.006911576612905116,0.0067310491827958195,1.3999,0.8149,0.523,1.2091,0.8374,0.5919,0.2426,1.43555565,0.8525238013333334,0.513116017,10,11.1799,0.1115,11.2595,0.1942,-88.035,0.769,5.8343,0.4908,5.2644,0.5724,0.786,2.2156307,5.041285523333333,5.730554706666667,0.42356291966666665,0.3701266713333333,0.8818,4.3841,0.6243,4.5225,0.6776,0.6092,0.085,0.56,0.551,0.016,1.288,80.5,105,0.3111111111111111,1,0,1,2,FALSE,FALSE,FALSE
502,2021-11-13T08:48:47Z,1,1.7777777777777777,1080,3,4,4,4,2,3,3,1,4,1,1,1,1,5,1,5,3,1,1,5,1,1,1,1,1,4,1,0,1,4,3,3,1,1,5,3,4,4,5,5,1,1,3,1,5,2,1,1,1,1,3,1,1,1,3,1,1,3,1,1,3,2,3,1,1,1,1,1,1,1,1.5,0,1,0,1.6666666666666667,0,2.888888888888889,0,1.5833333333333333,0,1.5,0,1.8571428571428572,0,1,0,1.945945945945946,0,2,0,1,-0.5005838931599188,-0.6604809734575887,-0.1546061727857994,-0.4075435731216941,3,2,2,1,1,2,1,2,0,1,-0.3048482679606258,5,5,5,5,3,3,2,4.285714285714286,0,1.7142857142857142,0.10757398284279028,0,2,1,2,2,2,1,2,1,1,1,1,5,3,4,3,5,4,1,4,4,1.8,0,4.8,0,2.2,0,3.8,0,3.6,0,1,1,1,4,1,1,1,3,1,1,2,3,1,1,1,3,1,1,1,2,1.25,0,"White, Caucasian, Anglo, European American",0,22,0,1,NA,5,2,0,0,1,0,0,TRUE,TRUE,TRUE,TRUE,TRUE,0,6,0.6649156250003725,0.64,0.01940194653075701,6,0.46866250000102444,0.5643516129026971,1,0.96875,0.0024258224193531874,0.004734491522176696,6,0.6798593749990687,0.7594419354837267,1,0.96875,0.011769056683695546,0.022941033699509537,1.1499,0.5408,0.403,0.6839,0.3957,0.5884,0.2747,1.2125096513333333,0.7087679146,0.395488354,1.2501,5.5839,0.3567,4.3743,0.428,-90.7336,0.9414,7.5328,0.4029,4.4638,0.4588,0.943,1.3719041983333333,4.316060263333333,5.5269514866666665,0.4153206053333333,0.34804968133333336,1.0249,3.0415,0.5333,2.3818,0.6075,0.9387,0.074,0.488,0.382,0.01,1.259,125.89999999999999,310,0.9185185185185185,1,0,0,1,FALSE,FALSE,FALSE
503,2021-11-13T09:09:52Z,1,1.6,900,3,4,5,5,2,5,1,1,4,2,1,1,1,5,2,5,3,1,2,1,1,1,1,1,1,3,2,0,0,5,5,5,5,5,5,5,5,5,1,5,1,1,5,2,5,5,1,1,2,1,5,1,1,1,3,1,1,2,2,2,3,4,1,1,1,1,2,1,2,2,1.125,0,1.75,0,1.4,0,1,0,1.5,0,1.1666666666666667,0,2,0,1,0,1.4324324324324325,0,2,0,0,-1.0532468249535052,-1.1569180239681438,-0.0958522115332568,-0.6263851177507003,5,2,2,1,1,2,1,1.7142857142857142,0,1,-0.4757826382709144,5,5,5,5,4,4,2,4.571428571428571,0,1.4285714285714286,-0.7395711320441822,0,2,1,1,2,1,1,1,1,1,5,5,5,2,4,5,1,5,2,2,4,1.4,0,4,0,3.4,0,4.2,0,3.8666666666666667,0,1,1,1,4,1,2,1,3,2,2,1,4,1,1,1,4,1,2,1,1,1.25,0,"White, Caucasian, Anglo, European American",0,18,0,1,NA,5,2,0,0,1,0,0,TRUE,TRUE,TRUE,TRUE,TRUE,0,2,0.9962428571428571,0.7142857142857143,0.057728816514386626,2,0.43207812500279397,0.49019642857355733,1,0.9333333333333333,0.0010961585383521082,0.003864193516779168,2,0.6113999999975785,0.6787366666644812,1,0.967741935483871,0.00726894516120803,0.006669373333502807,1.2674,0.7644,0.6437,1.1099,0.8355,0.7187,0.2027,1.33109106,0.8349685466666666,0.630974265,1.4582,6.1544,0.3136,3.5253,0.3079,-78.0375,0.5044,7.2167,0.4023,4.637,0.451,0.9688,1.43454423,3.5221048633333334,5.7021815,0.30828051666666667,0.31052498933333333,1.094,3.8476,0.4811,4.7867,0.5607,0.9651,0.065,0.466,0.489,0.019,1.819,95.73684210526316,430,1.2740740740740741,1,0,0,1,FALSE,FALSE,FALSE
504,2021-11-13T09:08:31Z,1,1.7777777777777777,864,3,3,5,5,5,4,5,5,3,3,5,3,1,4,2,4,4,5,5,1,1,1,5,5,3,7,2,0,0,5,2,5,5,5,5,5,5,5,4,4,4,3,5,4,4,3,5,4,3,5,4,1,1,1,5,1,1,5,5,5,5,1,3,3,1,1,3,4,4,4,3.25,0,3.75,0,2.8,0,1.3333333333333333,0,3.3333333333333335,0,1.6666666666666667,0,2.857142857142857,0,1.6666666666666667,0,2.4054054054054053,0,4,0,0,0.8737186064332574,0.7760795068851004,0.9375423577977049,0.8568109323414026,3,3,2,2,2,2,2,2.5714285714285716,0,1,0.03702047265995151,4,5,5,5,1,1,1,3.7142857142857144,0,2.2857142857142856,0.9547190977297628,0,5,5,5,5,5,4,2,3,4,3,3,4,4,4,3,3,3,3,2,2,5,0,3,0,2.4,0,3.2,0,2.8666666666666667,0,3,1,3,2,2,2,2,2,2,2,2,3,1,3,1,4,1,1,3,1,1.95,0,Black or African American,0,21,0,1,NA,5,2,0,1,0,0,1,TRUE,TRUE,TRUE,TRUE,TRUE,0,1,0.9535277777777778,0.72,0.058849375102040816,1,0.5139375,0.6827741935483871,1,1,0.0028992862903225816,0.016562380645161287,1,0.812875,0.92921875,1,1,0.026249725806451612,0.03549572479838709,1.3676,0.7151,0.5421,1.1688,0.7083,0.6481,0.29,1.4144075533333333,0.787693226,0.531298324,4.2224,8.617,0.2689,5.4281,0.2938,-72.4027,0.9403,7.0659,0.4524,2.6101,0.5422,0.9351,2.0756543633333333,3.8024390633333334,5.77944106,0.40932965233333335,0.339232648,1.3424,2.624,0.5911,2.7548,0.708,0.9905,0.267,0.224,0.456,0.018,2.041,113.3888888888889,103,0.30518518518518517,1,0,2,3,FALSE,FALSE,FALSE
505,2021-11-13T09:16:35Z,1,1.7777777777777777,720,7,2,5,5,1,5,1,1,5,1,1,1,1,5,1,5,5,1,1,1,1,1,1,1,1,3,2,0,0,5,4,5,5,5,5,5,5,5,4,5,1,1,5,1,5,1,1,1,1,1,5,1,1,1,4,1,1,2,2,1,5,2,1,1,1,1,1,1,1,1,1,0,1,0,1,0,1.1111111111111112,0,1.25,0,1.3333333333333333,0,1.2857142857142858,0,1,0,1.2702702702702702,0,2,0,0,-1.231864122301242,-1.452224992404038,-0.33105581968498016,-0.8916404060445091,5,1,4,1,1,1,1,1.1428571428571428,0,1,-0.8176513788914915,5,5,5,5,2,2,2,4,0,2,-0.7395711320441822,0,2,1,1,1,1,2,4,2,2,4,1,5,1,3,4,1,5,1,4,3,1.2,0,4.8,0,4.4,0,3.6,0,4.266666666666667,0,1,1,1,4,1,1,1,4,2,1,1,3,1,1,1,4,1,1,1,1,1.1,0,"White, Caucasian, Anglo, European American",0,29,0,1,NA,5,2,0,0,1,0,0,TRUE,TRUE,TRUE,TRUE,TRUE,0,6,0.8501955555412505,0.9,0.015538138061335579,6,0.43018387095389826,0.5031593750044704,0.96875,1,0.0035260044756003544,0.005546128298352062,6,0.6110312499925494,0.6465428571445602,1,0.875,0.010727535122936638,0.01309921603644578,1.2808,1.9308,0.5884,0.7492,2.3207,0.7497,0.2517,1.287510343,1.4507306803333333,0.5793601093333334,1.7545,4.751,0.2529,4.4336,0.3053,-69.521,0.822,5.26,0.3511,5.3694,0.4275,0.9027,1.6656599733333333,4.211425206666667,4.573182803333333,0.30736249033333335,0.25503681933333333,0.9047,3.4128,0.5057,2.9532,0.5108,0.9918,0.054,0.441,0.327,0.018,1.578,87.66666666666667,416,1.2325925925925925,1,0,0,1,FALSE,FALSE,FALSE
506,2021-11-13T09:25:32Z,1,1.7777777777777777,1440,4,4,4,4,2,4,2,4,4,2,2,2,2,4,2,4,3,2,1,1,1,2,1,1,1,0,2,1,1,4,3,5,4,3,4,4,4,4,2,4,5,2,4,4,4,3,3,5,5,4,4,3,1,1,3,2,2,1,1,1,4,2,2,1,1,1,2,2,2,2,1.25,0,2,0,2.2,0,2.111111111111111,0,3.25,0,1.8333333333333333,0,1.4285714285714286,0,1,0,2.27027027027027,0,0,1,1,-0.45435353384638705,-0.39934095351657173,-0.04055310191684401,-0.21994702771670788,4,2,4,2,2,2,2,2,0,2.5,0.24863324420094737,5,5,5,5,3,3,2,4.285714285714286,0,1.7142857142857142,-0.4571894270818581,0,3,3,2,3,2,3,2,3,2,2,4,2,3,2,3,2,2,3,2,3,2.6,0,2.4,0,2.6,0,3,0,2.6666666666666665,0,1,2,1,2,2,2,2,2,2,2,2,2,2,2,2,2,2,2,2,2,2.1,0,"Asian or Asian American (e.g., Chinese, Japanese, and others)",0,19,0,1,NA,5,2,0,0,0,0,0,TRUE,TRUE,TRUE,TRUE,TRUE,0,4,0.6791538461507896,0.78,0.04414924262910702,4,0.39057499999925493,0.43448709677496267,1,0.96875,0.0029764645163384176,0.002913049959994747,4,0.5683906249906868,0.6186699999948343,1,0.9375,0.0039951363609970515,0.003920888871169032,1.1509,1.1519,0.4574,0.9677,0.9654,0.5053,0.0376,1.2080969276666667,1.065452967,0.4488322513333333,1.0629,5.9913,0.3019,4.0393,0.3079,-97.1417,0.8395,6.6527,0.3172,5.1777,0.3562,0.7969,1.125650673,4.086093803333333,5.692128913333334,0.3038817796666667,0.2958873416666667,0.9077,5.479,0.4834,4.4028,0.5172,0.962,0.056,0.452,0.518,0.026,1.868,71.84615384615385,374,1.108148148148148,1,0,2,3,FALSE,FALSE,FALSE
507,2021-11-13T09:21:12Z,1,1.7786458333333333,768,4,3,4,4,3,4,2,2,3,2,2,2,2,5,2,4,3,2,2,1,1,2,1,1,2,1,2,0,0,4,4,4,5,4,4,5,5,4,2,4,2,2,5,2,5,3,1,2,2,3,5,1,1,1,2,1,1,2,1,1,4,2,2,1,2,3,2,1,2,2,1.5,0,1.75,0,2.1333333333333333,0,1.6666666666666667,0,1.9166666666666667,0,1,0,1.4285714285714286,0,2,0,1.6756756756756757,0,1,0,0,-0.6686942906636716,-0.5760798995552289,-0.2989446853297732,-0.437512292442501,4,3,5,2,3,5,5,3,0,1,0.2934220281253842,4,3,5,4,2,1,3,3.142857142857143,0,2.857142857142857,-0.7395711320441822,0,1,1,2,3,2,1,5,2,2,5,1,5,2,5,5,1,5,1,4,3,1.8,0,5,0,4.6,0,4.2,0,4.6,0,1,2,1,3,2,1,2,4,1,2,1,3,2,1,1,3,1,2,1,1,1.45,0,"White, Caucasian, Anglo, European American",0,20,0,1,NA,5,2,0,0,1,0,0,TRUE,TRUE,TRUE,TRUE,TRUE,0,1,0.9511243243217469,0.74,0.09389765108598215,1,0.46648064516292465,0.5487437499985098,0.96875,1,0.0022780154435526733,0.0021434283467823274,1,0.6051468750000931,0.6730517241384448,1,0.90625,0.008534532247787763,0.01798947990925265,1.5364,0.7144,0.4772,1.3544,0.5566,0.5886,0.231,1.54633609,0.7691811996666666,0.470414674,1.3475,5.3108,0.3456,4.9453,0.4125,-89.7435,0.7711,6.0511,0.4055,6.5835,0.4935,0.9932,1.4210915,4.792742156666667,5.140673113333333,0.405123553,0.337165134,0.9174,5.7759,0.5248,2.2449,0.5294,0.9478,0.068,0.405,0.327,0.026,2.059,79.19230769230771,342,1.0133333333333332,1,0,0,1,FALSE,FALSE,FALSE
508,2021-11-13T09:39:12Z,1,1.7777777777777777,1080,6,4,5,4,4,3,2,2,2,1,1,1,1,4,1,4,4,2,2,1,1,1,1,1,1,3,2,0,0,5,5,5,5,4,5,5,5,5,2,4,1,1,1,1,5,1,1,1,1,1,5,1,1,1,1,1,1,3,3,3,5,1,1,2,1,1,3,3,3,3,1.25,0,3,0,1.9333333333333333,0,1.1111111111111112,0,1.5,0,0.8333333333333334,0,1.7142857142857142,0,1.3333333333333333,0,1.3783783783783783,0,2,0,0,-1.0091178456087704,-0.8972298573626029,0.2961538020529488,-0.30053802765482707,4,2,3,1,1,3,2,2,0,1,-0.3048482679606258,3,2,4,3,1,1,3,2.4285714285714284,0,3.5714285714285716,-1.3043345419688306,0,1,1,1,2,1,1,4,4,1,2,1,5,1,3,4,4,5,1,4,4,1.2,0,5,0,3.4,0,3.2,0,3.8666666666666667,0,1,1,1,4,1,1,1,4,1,1,1,4,1,1,1,4,1,1,1,1,1,0,"White, Caucasian, Anglo, European American",0,23,0,1,NA,5,2,0,0,1,0,0,TRUE,TRUE,TRUE,TRUE,TRUE,0,4,0.6713294117617257,0.68,0.01743479928559115,4,0.5165874999975786,0.6235612903237343,1,1,0.00667326177387362,0.005815961117579267,4,0.7445281249983237,0.8002406249949708,1,1,0.03011340982812141,0.026871134103419354,1.0659,0.7419,0.4085,0.6933,1.2912,0.5531,0.2962,1.127509953,0.8367657856666667,0.40129336066666665,3.1423,6.5996,0.2785,6.2886,0.3737,-76.9243,0.9077,6.0448,0.4405,4.3196,0.5308,0.8776,1.9495701166666666,4.632400273333333,5.16908529,0.41686660566666667,0.330205098,1.6159,4.4979,0.5626,3.9584,0.5829,0.9605,0.217,0.279,0.46,0.043,1.718,39.95348837209303,292,0.8651851851851852,1,0,0,1,FALSE,FALSE,FALSE
510,2021-11-13T09:33:16Z,1,1.7777777777777777,1080,3,2,1,5,3,4,3,4,2,4,3,3,4,1,3,1,1,5,5,1,1,5,5,5,5,0,2,0,0,1,1,1,1,1,1,1,1,1,1,5,5,1,3,3,1,5,5,5,5,5,1,1,1,1,2,2,1,1,5,5,3,3,3,1,1,3,1,1,1,1,4,0,1,0,3.6,0,5,0,3.6666666666666665,0,1.8333333333333333,0,2.857142857142857,0,1.6666666666666667,0,3.4324324324324325,0,0,0,0,1.97904447002043,1.883553231186479,-0.7372407672780129,0.5731562319542332,5,1,5,2,1,1,1,1.1428571428571428,0,1,-0.8176513788914915,5,5,5,5,3,3,1,4.428571428571429,0,1.5714285714285714,-0.1748077221195339,0,5,5,5,5,5,5,3,5,5,1,5,3,5,3,1,5,3,3,1,3,5,0,2.2,0,1.4,0,1.8,0,1.8,0,4,4,4,1,4,4,4,1,4,3,4,1,4,4,3,1,4,4,4,4,3.9,0,"Hispanic of Latino (e.g., Mexican American, Central American, and others)",0,20,0,1,NA,5,2,0,0,1,0,0,TRUE,TRUE,TRUE,TRUE,TRUE,0,2,1.053394444445769,0.72,0.09313455255738762,2,0.4827499999925494,0.5335187499970198,1,1,0.004285652257516461,0.003479588668757522,2,0.6175874999910593,0.6929312500059605,1,1,0.005068270163142681,0.007151191894876032,1.4219,0.6729,0.6635,1.2385,0.4684,0.7808,0.3348,1.47537398,0.757148496,0.6471571863333333,1.2323,5.2416,0.3652,5.5074,0.4216,-98.4661,0.8559,4.6867,0.3918,6.011,0.4592,0.9973,1.4146951433333332,5.299448616666667,5.284500076666666,0.406725349,0.35172932166666665,1.0159,5.847,0.5349,6.8215,0.6098,0.9875,0.19,0.368,0.774,0.008,1.054,131.75,312,0.9244444444444444,1,0,1,2,FALSE,FALSE,FALSE
511,2021-11-13T09:39:25Z,1,1.7777777777777777,1080,2,1,3,3,3,3,3,3,3,3,3,3,3,3,3,3,3,1,1,1,1,1,1,1,1,1,2,0,0,3,3,3,3,3,3,3,3,3,3,3,3,3,3,3,3,3,3,3,3,3,5,1,3,3,3,3,3,3,3,3,3,3,3,3,3,1,1,1,1,1,1,0,1,0,3,0,3,0,3,0,2.1666666666666665,0,2.857142857142857,0,2.3333333333333335,0,2.8378378378378377,0,1,0,0,-0.2568238167794779,0.08093212985901263,-0.5341482934814965,-0.22660808181124192,5,1,3,1,1,1,1,1.2857142857142858,0,1,-0.7321841937363471,3,4,4,4,3,3,1,3.7142857142857144,0,2.2857142857142856,-0.4571894270818581,0,1,1,1,1,1,3,3,3,3,3,3,3,3,3,3,3,3,3,3,3,1,0,3,0,3,0,3,0,3,0,2,2,2,2,2,2,2,2,2,2,2,2,2,2,2,2,2,2,2,2,2.2,0,"White, Caucasian, Anglo, European American",0,30,0,1,NA,5,3,0,0,4,1,0,TRUE,TRUE,TRUE,TRUE,TRUE,0,4,0.9698906249981374,0.64,0.18653362220925057,4,0.5386451612864771,0.6165709677357828,0.96875,1,0.028782574426800222,0.02638607279613161,4,0.9417375000063329,1.3863966666678587,1,1,0.12547893016522596,0.3693246762020302,1.8903,0.3302,0.1919,1.4874,0.3045,0.471,0.3918,NA,NA,NA,1.7806,2.6104,0.2225,3.555,0.3661,-33.6565,1.3192,3.4484,0.3406,3.2905,0.4092,0.9983,NA,NA,NA,NA,NA,2.3989,3.4035,0.5296,1.2682,0.5477,0.9661,0.131,0.411,0.197,0.01,1.922,192.2,104,0.3081481481481481,1,0,1,2,FALSE,FALSE,FALSE
512,2021-11-13T09:34:18Z,1,1.7777777777777777,1080,4,2,4,5,1,4,1,1,3,2,2,1,2,4,1,4,2,2,3,4,1,1,1,2,2,1,2,0,0,2,2,3,3,3,3,4,3,2,5,2,3,3,2,4,4,4,4,3,3,4,2,1,1,2,1,1,1,1,4,2,4,2,1,3,2,1,1,3,2,2,2,0,2,0,1.8,0,3.2222222222222223,0,3.5833333333333335,0,1.5,0,1.7142857142857142,0,2,0,2.72972972972973,0,1,0,0,0.29794049498290537,-0.051476894336432474,-0.22054348261253207,-0.13601018847448226,2,3,3,3,2,4,3,3.142857142857143,0,2.5,0.9323707254421016,3,4,4,4,2,2,2,3.2857142857142856,0,2.7142857142857144,0.10757398284279028,0,1,1,1,1,1,1,5,3,1,5,2,5,1,5,4,1,5,2,1,2,1,0,4.6,0,4.2,0,4.2,0,4.333333333333333,0,1,1,1,1,1,1,1,3,1,1,1,1,1,1,2,1,1,1,2,1,1.6,0,Black or African American,0,23,0,1,NA,5,2,0,0,1,0,0,TRUE,TRUE,TRUE,TRUE,TRUE,0,4,0.7378648648648649,0.74,0.05050151020408165,4,0.4848125,0.5414666666666667,1,0.967741935483871,0.0041824153225806454,0.0052121311827957,4,0.57665625,0.6194375,1,1,0.002933007056451613,0.002982705645161292,1.2818,0.8627,0.3904,1.0446,0.8546,0.4878,0.1965,1.32685026,0.8965881293333333,0.383060634,1.2367,4.7729,0.3553,4.1442,0.3997,-80.8469,0.8475,5.8487,0.407,4.691,0.4484,0.8987,1.394259509,4.19084628,4.95093056,0.38596452,0.345656041,0.8149,5.892,0.5073,5.3725,0.5476,0.9948,0.082,0.464,0.739,0.037,1.769,47.810810810810814,317,0.9392592592592592,1,1,1,2,FALSE,FALSE,FALSE
513,2021-11-13T09:15:49Z,1,1.7777777777777777,864,4,4,3,4,3,4,4,4,4,2,3,1,3,2,1,4,4,1,3,1,1,1,2,2,1,0,2,NA,NA,5,5,4,5,5,5,5,5,4,3,5,3,5,4,2,5,3,3,4,5,5,5,1,1,1,4,2,1,1,2,1,4,5,3,3,1,1,2,1,1,1,1.5,0,1.25,0,2.533333333333333,0,1.2222222222222223,0,3.0833333333333335,0,1.5,0,2,0,1.6666666666666667,0,2.108108108108108,0,0,NA,NA,-0.39971765465766756,-0.2183432376938503,-0.8521929756973453,-0.5352681066955978,5,2,3,1,1,2,3,1.8571428571428572,0,4.5,0.9011414085945675,5,5,5,5,3,2,2,4.142857142857143,0,1.8571428571428572,-1.5867162469311549,0,1,2,2,1,2,1,4,2,2,2,3,4,2,4,4,2,5,2,3,4,1.6,0,4.2,0,3.4,0,3.6,0,3.7333333333333334,0,2,1,2,1,2,1,2,2,3,1,2,2,3,1,1,2,1,3,3,2,2.15,0,"White, Caucasian, Anglo, European American",0,25,0,1,NA,5,2,1,1,1,0,2,TRUE,TRUE,TRUE,TRUE,TRUE,0,2,0.9102837209320346,0.8775510204081632,0.17149172290908515,2,0.5224781250022351,0.5494000000001923,1,1,0.0039007604737379717,0.007124435333486081,2,0.605534375003539,0.6440451612905148,1,0.96875,0.014376632650777006,0.009245655150776634,1.7437,1.2609,0.4503,0.8057,2.1592,0.7672,0.3043,1.6621209133333332,1.116360371,0.44894627233333334,1.9002,6.0606,0.3657,5.2575,0.36870000000000003,-84.0095,0.9233,5.3937,0.4353,4.5892,0.4441,0.9353,1.72070611,4.730685963333333,5.369648893333333,0.3723620496666667,0.36560002233333333,0.9618,2.516,0.462,3.576,0.5344,0.9007,0.072,0.413,0.4,0.018,1.629,90.5,406,1.202962962962963,1,0,0,1,FALSE,FALSE,FALSE
514,2021-11-13T09:41:31Z,1,1.7777777777777777,1440,6,4,5,4,1,3,2,1,5,2,2,1,1,5,2,5,3,1,1,1,1,2,2,2,2,2,2,0,0,3,5,5,4,4,5,3,5,5,2,5,1,1,4,1,5,2,1,1,1,1,5,1,1,1,3,1,1,2,2,2,4,2,3,1,1,1,1,1,1,2,1.5,0,1.25,0,1.6,0,1.6666666666666667,0,1.25,0,1.1666666666666667,0,1.8571428571428572,0,1,0,1.4864864864864864,0,1,0,0,-0.7863715689162981,-0.8865829329024428,-0.4557470907642554,-0.6711650118333491,4,2,4,1,1,2,2,1.7142857142857142,0,1,-0.4757826382709144,5,5,5,5,3,2,1,4.285714285714286,0,1.7142857142857142,-1.3043345419688306,0,2,2,3,2,2,3,5,2,2,3,2,3,3,4,5,2,4,3,4,2,2.2,0,3.4,0,3.8,0,4.2,0,3.8,0,1,2,3,2,2,3,3,1,4,1,2,2,2,3,1,2,1,2,2,3,2.4,0,"White, Caucasian, Anglo, European American",0,24,0,1,NA,5,2,0,0,1,0,0,TRUE,TRUE,TRUE,TRUE,TRUE,0,6,0.7247837837837838,0.74,0.028265520000000002,6,0.45934375,0.5147419354838709,1,0.96875,0.0018985554435483865,0.0033792862903225802,6,0.6305625,0.7022903225806452,1,0.96875,0.00434528629032258,0.004298447580645161,1.1569,0.9825,0.4709,0.8602,0.9278,0.5704,0.137,1.2163478876666667,0.971526255,0.46297684666666666,1.7364,5.49,0.3012,4.9736,0.3498,-81.3405,0.7906,7.5548,0.4147,5.4202,0.4449,0.7525,1.62997896,4.60947604,5.081293686666666,0.35082368,0.30096560466666666,0.9763,5.6853,0.5425,4.9218,0.6073,0.7251,0.08,0.495,0.642,0.02,1.929,96.45,366,1.0844444444444443,1,0,0,1,FALSE,FALSE,FALSE
515,2021-11-13T09:41:35Z,0.8999999761581421,1.7777777777777777,864,6,2,5,4,4,4,3,2,3,3,5,2,5,1,3,1,2,4,4,1,1,1,3,5,3,5,2,0,0,2,4,1,1,2,1,4,3,3,2,3,5,5,2,5,5,5,5,3,5,5,1,1,5,3,5,5,1,3,4,4,5,1,1,1,3,1,4,5,2,3,2.75,0,3.5,0,3.2666666666666666,0,3.6666666666666665,0,4,0,3.8333333333333335,0,2,0,1.6666666666666667,0,3.3783783783783785,0,3,0,0,1.1679118020648247,1.179888314592263,0.6560486812839473,0.9179684979381051,2,4,1,4,4,5,5,4.428571428571429,0,6.5,3.1775260909359293,1,5,5,3,2,2,4,2.857142857142857,0,3.142857142857143,-0.7395711320441822,0,3,5,5,2,4,5,5,4,4,3,5,4,3,2,4,1,3,1,5,3,3.8,0,2.8,0,4.2,0,2.6,0,3.2,0,1,1,1,4,2,1,2,3,1,1,2,3,1,2,1,3,1,2,2,2,1.5,0,"White, Caucasian, Anglo, European American",0,24,0,1,NA,5,2,0,0,1,0,0,TRUE,TRUE,TRUE,TRUE,TRUE,0,4,0.9961156250033527,0.6530612244897959,0.22244689748886984,4,0.7946160000038147,0.916806896557068,0.9615384615384616,0.9666666666666667,0.07690392654079377,0.08526836253978134,4,1.5569206896568166,1.53411666666468,0.9666666666666667,0.9375,0.5947514680524554,0.47838362257197353,1.8716,0.3595,0.1881,1.2043,0.7125,0.6007,0.5736,1.7766094366666667,0.4765664502333333,0.19995432533333332,2.1632,2.1223,0.3178,1.5056,0.2335,18.5156,1.8205,1.837,0.346,2.2907,0.5303,0.9592,2.03838431,1.571489963,2.2016535833333335,0.2615074826666667,0.329133573,2.6462,0.8009,0.4133,1.206,0.4715,0.8408,0.139,0.356,0.111,0.243,1.835,7.551440329218107,104,0.3081481481481481,1,0,1,2,FALSE,FALSE,FALSE
516,2021-11-13T09:38:27Z,0.8999999761581421,1.7777777777777777,1080,6,2,2,3,2,3,1,1,1,1,1,3,1,2,1,2,1,3,2,1,1,1,1,3,1,0,2,0,0,4,1,1,3,1,4,4,4,4,1,4,2,1,2,1,5,4,3,4,4,1,1,1,5,1,4,3,1,1,1,2,4,1,1,1,1,1,4,1,1,1,1.625,0,1.75,0,2.6,0,3.111111111111111,0,2.3333333333333335,0,3,0,1.1428571428571428,0,1,0,2.3513513513513513,0,0,0,0,-0.17066723805880474,-0.031441318306858645,-0.5020371591262895,-0.2667392387165741,4,1,2,1,1,1,2,1.7142857142857142,0,1,-0.4757826382709144,2,4,4,4,1,1,2,2.857142857142857,0,3.142857142857143,2.0842459175790595,0,2,3,3,1,1,1,3,2,1,1,3,4,2,4,3,1,2,3,2,2,2,0,3.4,0,3,0,4,0,3.466666666666667,0,1,2,1,2,1,1,1,2,1,1,1,2,1,2,1,2,1,1,1,2,1.55,0,"White, Caucasian, Anglo, European American",0,24,0,1,NA,5,2,0,0,1,0,0,TRUE,TRUE,TRUE,TRUE,TRUE,0,3,0.64759375,0.64,0.01985289795918367,3,0.40874193548387094,0.4615806451612903,0.96875,0.96875,0.0046694989919354845,0.005060129032258065,3,0.5365625,0.6249677419354839,1,0.96875,0.0034146411290322583,0.0039770393145161275,1.0459,0.5754,0.38,0.8621,0.8322,0.4582,0.3286,1.109060716,0.7385475861666667,0.3731022033333333,1.093,3.9598,0.2763,3.3029,0.3026,-69.1893,0.7906,5.7009,0.3376,4.7605,0.3868,0.9989,1.181879313,3.49801564,4.214563833333333,0.29765741133333334,0.271546766,0.8805,5.5767,0.4575,4.7643,0.5418,0.9821,0.229,0.275,0.884,0.014,1.559,111.35714285714285,104,0.3081481481481481,1,0,0,1,FALSE,FALSE,FALSE
517,2021-11-13T09:51:05Z,1,1.7777777777777777,864,6,3,3,4,2,4,2,3,2,3,2,2,2,2,1,2,3,2,3,2,1,2,2,3,2,0,2,0,1,5,4,4,4,4,3,4,5,4,1,3,3,2,4,2,5,4,3,3,4,4,3,2,1,1,1,1,1,1,1,1,3,3,3,1,1,2,2,2,1,1,2.125,0,1.5,0,2.6,0,1.8888888888888888,0,2.6666666666666665,0,1.3333333333333333,0,1.7142857142857142,0,1.3333333333333333,0,2.027027027027027,0,0,0,1,-0.06139547968136551,0.044055055137912885,-0.40398871494434996,-0.17996682990321855,4,2,4,1,1,2,3,1.8571428571428572,0,1,-0.39031545311577004,4,4,4,4,1,1,1,3.2857142857142856,0,2.7142857142857144,-0.7395711320441822,0,3,3,2,4,3,1,4,2,2,3,1,5,3,3,3,3,4,2,4,3,3,0,4.6,0,3.4,0,3.4,0,3.8,0,3,1,2,3,2,2,3,2,1,3,2,3,2,2,2,3,1,2,2,2,2.05,0,"Asian or Asian American (e.g., Chinese, Japanese, and others) & White, Caucasian, Anglo, European American",1,23,0,1,NA,5,2,0,0,1,0,0,TRUE,TRUE,TRUE,TRUE,TRUE,0,2,0.6033571428571428,0.84,0.05372363265306123,2,0.3905806451612903,0.46540625,0.96875,1,0.00404991935483871,0.005079152217741934,2,0.5145,0.58465625,1,1,0.006341483870967742,0.002996813508064515,1.1751,1.3971,0.3335,1.0414,1.3276,0.3682,0.1262,1.2164354446666668,1.2037587926666666,0.32626267633333333,1.0486,4.8008,0.286,3.9171,0.3315,-86.1508,0.8265,4.7403,0.3019,5.6063,0.3942,0.9192,1.1418076806666666,4.051609493333333,4.88434136,0.3261989436666667,0.2798163043333333,1.0817,3.9623,0.3904,7.273,0.5085,0.9796,0.126,0.333,0.726,0.007,0.981,140.14285714285714,359,1.0637037037037036,1,0,0,1,FALSE,FALSE,FALSE
518,2021-11-13T09:56:35Z,0.8999999761581421,1.7777777777777777,1080,6,4,4,5,2,3,2,2,4,2,2,2,4,3,2,3,4,2,2,1,1,1,1,1,1,0,2,0,0,4,4,3,4,2,4,4,4,5,2,4,2,2,4,2,4,4,2,2,4,4,4,1,1,1,2,1,2,1,1,1,4,2,2,1,1,1,1,1,1,1,1.25,0,1,0,2.2666666666666666,0,2.2222222222222223,0,2.5,0,1.1666666666666667,0,1.4285714285714286,0,1,0,1.945945945945946,0,0,0,0,-0.6560860108508899,-0.5100689679022363,-0.7372407672780129,-0.6236548675901246,4,2,4,2,1,2,2,1.8571428571428572,0,3,0.34765989643299416,4,5,5,4,2,2,2,3.7142857142857144,0,2.2857142857142856,-0.1748077221195339,0,2,2,2,2,3,2,4,2,2,2,2,4,2,4,4,2,4,4,2,2,2.2,0,3.6,0,3.2,0,4,0,3.6,0,1,2,1,4,1,1,2,4,2,2,2,3,1,2,1,3,1,2,2,1,1.5,0,"White, Caucasian, Anglo, European American",0,26,0,1,NA,5,2,0,0,1,0,0,TRUE,TRUE,TRUE,TRUE,TRUE,0,5,0.9936757575756673,0.66,0.07772356448996058,5,0.5411321428572493,0.6656593749979511,0.9032258064516129,1,0.016641276515967213,0.011813155392907495,5,0.9777749999994412,1.2447677419353878,1,0.96875,0.06372144129003728,0.08330485934503105,1.5164,0.454,0.4288,1.2062,0.6662,0.6474,0.5759,1.5251299566666667,0.5855085376333333,0.423736178,1.476,2.1084,0.2402,3.1066,0.4281,-28.8655,0.8423,2.7696,0.427,3.5321,0.5635,0.9285,1.55557881,3.198276416666667,2.4227221666666665,0.41807469433333333,0.24042885533333333,1.7876,3.0794,0.6708,2.0864,0.8479,0.9945,0.133,0.535,0.322,0.006,1.937,322.8333333333333,104,0.3081481481481481,1,1,2,3,FALSE,FALSE,FALSE
519,2021-11-13T09:33:17Z,1,1.7777777777777777,1080,6,3,1,2,4,2,3,4,2,4,3,3,4,2,3,2,2,3,4,1,1,3,3,3,3,0,2,0,0,2,3,2,4,3,4,5,5,4,2,3,2,1,3,3,4,5,3,3,2,5,4,1,3,1,3,1,1,1,2,1,2,5,4,2,5,3,2,2,2,2,2.625,0,2,0,3.8,0,2.4444444444444446,0,2.8333333333333335,0,1.6666666666666667,0,2.4285714285714284,0,3.3333333333333335,0,2.5675675675675675,0,0,0,0,0.5858295507080814,1.0069241872258443,-0.4236359564090485,0.2916441154083979,4,2,3,2,1,1,2,1.8571428571428572,0,2.5,0.1631660590458031,3,4,3,5,2,3,4,3.142857142857143,0,2.857142857142857,-1.0219528370065065,0,2,3,2,2,3,2,5,3,2,3,3,4,1,4,4,5,3,2,4,2,2.4,0,3.6,0,3.6,0,3.8,0,3.6666666666666665,0,2,1,2,2,3,2,3,1,3,2,2,3,2,3,1,2,3,3,3,3,2.5,0,"White, Caucasian, Anglo, European American",0,29,0,1,NA,5,2,0,1,1,0,1,TRUE,TRUE,TRUE,TRUE,TRUE,0,1,0.852774418520373,0.86,0.028929447851734937,1,0.48432500003278256,0.5642218751013279,1,1,0.0028439593509300286,0.0028792966017320465,1,0.5791875001192093,0.6660968751460313,1,1,0.0036981888693354203,0.0020211861220067735,1.2564,1.5382,0.5607,1.1341,1.6435,0.6125,0.1058,1.2951891733333334,1.27631694,0.549792119,3.9237,9.1466,0.2698,8.582,0.3356,-99.7251,0.6735,6.4957,0.4327,5.0829,0.5071,0.9991,1.6972244466666666,5.283416553333334,5.919035086666667,0.410137865,0.34656565066666667,0.8492,4.3134,0.498,6.9786,0.6081,0.6457,0.195,0.338,0.824,0.012,1.377,114.75,194,0.5748148148148148,1,0,2,3,FALSE,FALSE,FALSE
520,2021-11-13T09:48:29Z,1,1.7777777777777777,1080,1,2,2,3,2,3,3,3,2,3,3,4,3,2,2,2,4,3,4,4,3,3,4,4,3,4,2,1,2,4,3,3,3,3,4,4,4,3,2,4,3,2,3,2,5,3,2,3,3,3,2,3,1,3,1,1,3,3,1,1,3,3,3,3,3,4,2,4,2,1,3.5,0,2.25,0,3.1333333333333333,0,2.5555555555555554,0,2.4166666666666665,0,2,0,2.2857142857142856,0,3.3333333333333335,0,2.4864864864864864,0,2,1,2,1.079653843375354,1.0616106628621211,0.6204826952926107,0.8410466790773659,4,2,4,2,2,2,2,2,0,3.5,0.6176209189753294,4,4,4,4,4,3,2,3.857142857142857,0,2.142857142857143,0.6723373927674386,0,2,2,3,3,3,2,4,2,2,3,2,3,3,4,4,2,4,2,3,3,2.6,0,3.8,0,3.4,0,3.8,0,3.6666666666666665,0,2,3,3,3,4,2,3,3,2,2,4,2,2,3,2,3,1,2,2,3,2.45,0,"White, Caucasian, Anglo, European American",0,30,0,1,NA,5,2,0,0,1,0,0,TRUE,TRUE,TRUE,TRUE,TRUE,0,1,1.2956857142857143,0.7,0.18200332285714288,1,0.60578125,0.7273870967741936,1,0.96875,0.006312886088709678,0.012819963709677421,1,0.771258064516129,0.8193666666666667,1,0.9375,0.008690264516129033,0.010090931451612902,1.6502,0.5146,0.7365,1.6873,0.3207,0.7499,0.0527,1.67402355,0.6113669974,0.712567869,2.0643,5.1239,0.4043,3.2347,0.424,-53.1192,0.9176,6.6518,0.533,3.1712,0.6034,0.9926,2.086872893333333,3.190372443333333,4.87802661,0.41234715,0.3928349326666667,0.9534,3.3086,0.6541,4.0614,0.7061,0.9209,0.076,0.58,0.409,0.023,1.885,81.95652173913044,317,0.9392592592592592,1,0,0,2,FALSE,FALSE,FALSE
522,2021-11-13T10:09:20Z,1,1.6,900,6,2,2,4,3,3,3,4,3,3,3,3,3,3,2,3,2,3,3,1,1,3,3,3,3,4,2,0,0,4,2,4,3,2,2,1,2,2,3,2,2,1,4,2,5,3,3,2,3,3,3,1,1,1,1,1,2,4,4,4,3,2,3,1,2,1,1,2,3,3,2.5,0,2.25,0,3.066666666666667,0,3.5555555555555554,0,2.4166666666666665,0,1.1666666666666667,0,3,0,1.3333333333333333,0,2.5675675675675675,0,2,0,0,0.5080784918625958,0.6380566497924803,0.06095019390122543,0.3495034218468529,4,2,3,3,3,3,2,2.5714285714285716,0,1.5,0.22151431004714253,5,5,5,5,2,2,2,4,0,2,-0.4571894270818581,0,3,2,3,3,3,3,4,4,2,3,2,2,3,3,4,3,3,3,2,3,2.8,0,3,0,3,0,3.2,0,3.066666666666667,0,2,1,3,2,4,3,4,2,3,3,1,1,3,3,2,2,2,3,3,4,2.85,0,"Asian or Asian American (e.g., Chinese, Japanese, and others) & White, Caucasian, Anglo, European American",1,27,0,1,NA,5,2,0,0,0,0,0,TRUE,TRUE,TRUE,TRUE,TRUE,0,4,0.7871738095255125,0.84,0.03124920068928651,4,0.46805624999478457,0.5254733333190282,1,0.967741935483871,0.0023829889906034065,0.005199822946529708,4,0.5856249999888241,0.6504433333317439,1,0.967741935483871,0.005672809033485805,0.006456455911608616,1.4848,1.2755,0.4185,0.9078,1.3423,0.6326,0.2994,1.4777441966666667,1.1348425146666667,0.413809994,1.1161,5.7846,0.3716,3.7489,0.3829,-89.2667,0.8947,6.5208,0.3991,4.2569,0.4265,0.9968,1.2597735453333334,3.89630043,5.659565113333334,0.37158498933333334,0.361176306,0.6717,3.672,0.5265,5.4672,0.582,0.6617,0.071,0.427,0.416,0.024,1.921,80.04166666666667,408,1.208888888888889,1,0,0,1,FALSE,FALSE,FALSE
523,2021-11-13T10:13:52Z,1,1.7777777777777777,1080,4,4,3,4,2,4,2,2,4,2,2,2,2,3,2,3,3,3,2,1,1,2,2,2,2,0,2,0,0,4,3,3,3,3,2,3,3,2,2,2,3,1,3,2,2,3,3,2,3,3,4,1,1,1,2,1,1,1,1,1,4,2,2,1,1,1,2,2,2,2,1.875,0,2,0,2.2666666666666666,0,3.111111111111111,0,2.75,0,1.1666666666666667,0,1.2857142857142858,0,1,0,2.2162162162162162,0,0,0,0,-0.09922031911971019,-0.12532783400099734,-0.4236359564090485,-0.2744818952050229,4,2,4,1,1,2,3,1.8571428571428572,0,4,0.7166475712073764,4,4,4,4,3,2,1,3.7142857142857144,0,2.2857142857142856,0.6723373927674386,0,3,4,4,4,4,4,4,4,4,3,4,2,3,2,2,1,4,3,4,4,3.8,0,2.6,0,3.8,0,2,0,2.8,0,2,2,3,2,2,3,2,2,3,2,3,2,2,3,2,2,2,3,2,3,2.55,0,"Asian or Asian American (e.g., Chinese, Japanese, and others)",0,18,0,1,NA,5,2,0,0,0,0,0,TRUE,TRUE,TRUE,TRUE,TRUE,0,3,0.7001736842107616,0.76,0.033431134874323226,3,0.4083935483847895,0.46065624999953436,1,1,8.453412903458553e-4,0.0026630128629211427,3,0.5731625000014902,0.6127517241388559,1,0.9354838709677419,0.004823666935482814,0.007522697849450759,1.0541,1.1026,0.4397,0.9578,1.3422,0.4807,0.1306,1.116649452,1.0400189533333333,0.4311188286666667,10,18.0785,0.1318,12.0875,0.047,-115.297,0.7644,8.0068,0.3644,5.6039,0.4013,0.9353,1.66206581,5.154282806666667,6.969655566666667,0.3051829676666667,0.2971078933333333,0.8227,3.3468,0.4791,3.6899,0.5069,0.9651,0.058,0.439,0.45,0.027,1.637,60.62962962962963,312,0.9244444444444444,1,0,2,3,FALSE,FALSE,FALSE
524,2021-11-13T10:01:13Z,1,1.7777777777777777,864,7,3,5,5,1,4,1,1,5,1,1,1,1,5,1,5,4,2,1,1,1,1,1,1,1,0,3,0,0,4,5,4,5,4,3,5,5,4,1,5,1,1,4,1,5,1,1,1,3,1,5,1,1,1,3,1,1,1,1,1,5,1,1,1,1,1,2,1,1,1,1.125,0,1.25,0,1.1333333333333333,0,1.6666666666666667,0,1.25,0,1.1666666666666667,0,0.8571428571428571,0,1,0,1.2972972972972974,0,0,0,0,-1.1373020237053812,-1.329591780667467,-0.6588395645607719,-0.9942156726141195,4,2,3,2,1,1,1,1.7142857142857142,0,1.5,-0.2912888008837234,4,5,5,5,4,4,1,4.571428571428571,0,1.4285714285714286,-1.3043345419688306,0,2,2,2,1,2,2,5,2,1,5,1,5,2,4,4,1,4,1,3,3,1.8,0,4.6,0,4.4,0,4,0,4.333333333333333,0,1,1,1,4,1,1,1,4,1,1,1,4,1,1,1,4,1,1,2,1,1.05,0,"White, Caucasian, Anglo, European American",0,22,0,1,NA,5,2,0,0,1,0,0,TRUE,TRUE,TRUE,TRUE,TRUE,0,5,0.7052973684197978,0.7755102040816326,0.04536001708100948,5,0.4352580645142063,0.5011965517360588,1,0.90625,0.0033058078501532156,0.007009270604561328,5,0.5443499999996275,0.591528571422611,1,0.875,0.006146867096091894,0.007288208023997868,1.2488,1.0126,0.3926,0.992,1.0644,0.4992,0.3389,1.29589658,0.9848501056666666,0.38469018266666666,1.0649,3.7139,0.2919,3.139,0.3569,-65.967,0.7728,5.533,0.3725,2.9984,0.396,0.9968,1.188298062,3.34515913,4.0852646,0.34692137466666667,0.287004891,0.8484,3.1097,0.4451,3.6375,0.4774,0.8816,0.05,0.413,0.408,0.017,1.592,93.6470588235294,378,1.12,1,0,0,1,FALSE,FALSE,FALSE
525,2021-11-13T10:13:58Z,1,1.7777777777777777,720,4,1,3,4,3,4,3,2,4,2,2,2,2,3,2,4,3,3,3,4,3,3,2,2,3,3,3,0,4,4,3,2,3,1,4,4,4,4,3,3,1,3,2,2,4,4,3,2,3,3,2,3,4,1,3,4,3,3,2,1,4,2,2,2,2,1,2,3,2,2,2.875,0,2.25,0,2.3333333333333335,0,2.7777777777777777,0,2.75,0,3,0,2,0,1.6666666666666667,0,2.6216216216216215,0,2,0,4,0.7749537478998025,0.5072930593772413,0.7667487814979485,0.637020920437595,3,3,2,3,3,3,3,3.142857142857143,0,3,1.1168645628292926,1,4,3,3,2,3,2,2.857142857142857,0,3.142857142857143,1.237100802692087,0,2,2,2,1,2,2,2,3,2,3,4,5,3,3,3,4,4,3,3,5,1.8,0,3.6,0,2.6,0,2.8,0,3,0,2,1,2,3,3,2,2,3,2,2,2,2,3,1,1,2,1,3,2,2,2.05,0,"Hispanic of Latino (e.g., Mexican American, Central American, and others) & White, Caucasian, Anglo, European American",1,28,0,1,NA,5,2,0,0,1,0,0,TRUE,TRUE,TRUE,TRUE,TRUE,0,6,1.1098536585365855,0.82,0.17086066326530613,6,0.4898709677419355,0.6120625,1,1,0.005897649462365592,0.008815028225806449,6,0.65390625,0.8079999999999999,1,0.96875,0.013315119959677421,0.025285232862903222,2.1792,0.8038,0.2427,1.4315,1.0075,0.667,0.228,1.9467251533333334,0.7755891223333333,0.26007926566666667,3.1022,6.6174,0.2555,5.4793,0.329,-71.1108,0.8549,4.8079,0.4009,3.8285,0.5132,0.9936,1.89023177,4.17781843,5.082913546666667,0.3881878813333333,0.30656884933333334,1.4249,4.0385,0.4824,2.4769,0.5475,0.9974,0.097,0.44,0.472,0.014,1.96,140,104,0.3081481481481481,1,1,1,2,FALSE,FALSE,FALSE
526,2021-11-13T10:21:14Z,0.8999999761581421,1.7777777777777777,1080,4,3,5,5,2,5,1,1,5,1,1,2,1,5,2,4,4,2,1,1,1,1,1,2,1,1,2,0,0,5,4,5,3,3,5,4,5,4,1,4,1,1,5,2,5,1,1,1,1,1,5,1,1,1,1,1,1,2,2,1,5,1,2,1,1,1,2,2,2,2,1.25,0,2,0,1.3333333333333333,0,1.7777777777777777,0,1.1666666666666667,0,0.8333333333333334,0,1.2857142857142858,0,1,0,1.3243243243243243,0,1,0,0,-1.0427399251095204,-1.1783086631108288,-0.22054348261253207,-0.6994260728616805,4,1,3,1,1,1,1,1.4285714285714286,0,1,-0.6467170085812028,5,5,5,5,3,2,2,4.142857142857143,0,1.8571428571428572,0.38995568780511447,0,2,2,1,1,2,1,4,3,1,3,2,5,2,3,4,2,5,2,3,2,1.6,0,4.6,0,3.6,0,3.8,0,4,0,1,1,1,4,2,1,2,3,1,1,1,4,2,1,1,4,1,1,1,2,1.25,0,"White, Caucasian, Anglo, European American",0,19,0,1,NA,5,2,0,0,1,0,0,TRUE,TRUE,TRUE,TRUE,TRUE,0,1,0.8735868421047926,0.76,0.11288076749515487,1,0.35712580645372793,0.4305333333313465,0.96875,0.967741935483871,0.0017526438607130344,0.0032256453120345302,1,0.5274354838728905,0.587063333333532,0.96875,0.9375,0.00612425410280567,0.010660965161078267,1.3681,0.8615,0.4852,1.2294,0.7934,0.5294,0.0286,1.40505896,0.881285098,0.4768051153333333,1.0142,4.858,0.2579,3.8449,0.3049,-86.5379,0.7533,6.0648,0.296,5.3838,0.3633,0.9291,1.0817363463333334,3.94668122,4.906738473333333,0.30082972533333335,0.2540487573333333,0.9859,4.2183,0.4194,3.1655,0.4575,0.932,0.06,0.358,0.322,0.02,1.728,86.39999999999999,292,0.8651851851851852,1,0,0,1,FALSE,FALSE,FALSE
528,2021-11-13T10:34:58Z,1,1.7708333333333333,768,7,3,4,4,1,4,1,1,4,1,1,1,1,4,1,4,4,1,1,1,1,1,1,1,1,2,2,1,1,4,4,4,4,4,4,4,4,4,1,4,1,1,4,1,4,1,1,1,1,1,4,1,1,1,1,1,1,1,1,1,4,1,1,1,1,1,1,1,1,1,1,0,1,0,1.4666666666666666,0,2,0,1.25,0,1,0,1,0,1,0,1.3783783783783783,0,1,1,1,-1.1646199632997414,-1.2052163449283244,-0.15106543898929206,-0.6781408919588082,4,3,3,2,2,2,4,2.5714285714285716,0,2.5,0.5905019848215247,4,4,4,4,3,3,2,3.7142857142857144,0,2.2857142857142856,0.9547190977297628,0,1,1,1,1,1,1,4,1,1,4,1,4,1,1,4,1,4,1,4,4,1,0,4.6,0,4.4,0,3.4,0,4.133333333333334,0,1,1,1,3,1,1,1,3,1,1,1,3,3,1,1,3,1,1,1,1,1.3,0,Black or African American,0,26,0,1,NA,5,2,0,0,1,0,0,TRUE,TRUE,TRUE,TRUE,TRUE,0,3,0.7329135135162521,0.7551020408163265,0.0347596118110335,NA,NA,NA,NA,NA,NA,NA,3,0.7301281250016763,0.8164645161292245,1,1,0.008608104021571892,0.02854434836493401,1.2008,0.9723,0.4431,0.6994,1.4589,0.6276,0.1939,1.2557173986666668,0.9629654276666667,0.435003313,NA,NA,NA,NA,NA,NA,NA,NA,NA,NA,NA,NA,NA,NA,NA,NA,NA,1.2868,4.7762,0.5945,2.2381,0.5793,0.9725,0.081,0.55,0.407,0.053,1.982,37.39622641509434,406,1.202962962962963,1,1,4,5,TRUE,FALSE,FALSE
529,2021-11-13T09:43:19Z,1,1.6,1050,6,2,4,1,4,2,4,4,3,2,2,1,3,2,1,4,3,3,1,1,3,1,4,3,3,2,2,0,1,4,2,1,1,1,1,1,1,2,4,3,4,1,3,5,3,5,5,5,5,5,3,1,5,1,3,3,1,2,1,1,2,2,4,1,3,1,2,2,1,1,2.375,0,1.5,0,2.933333333333333,0,4.444444444444445,0,4,0,2.5,0,2,0,1.6666666666666667,0,3.3513513513513513,0,1,0,1,0.9178475857779922,0.8638682385702389,-0.20089624114783355,0.33148599871120266,4,1,4,1,1,2,3,1.7142857142857142,0,2,-0.10679496349653231,3,4,4,4,2,3,3,3.2857142857142856,0,2.7142857142857144,-1.0219528370065065,0,3,1,3,3,4,3,4,3,2,1,1,3,3,5,3,4,5,2,3,4,2.8,0,4,0,2.6,0,3.4,0,3.3333333333333335,0,1,1,1,3,4,1,1,3,1,1,3,3,1,1,2,3,1,1,1,2,1.55,0,Black or African American,0,26,0,1,NA,5,2,1,0,1,0,1,TRUE,TRUE,TRUE,TRUE,TRUE,0,6,1.3626944444444444,0.72,0.1626742942857143,6,0.5521875,0.5818125,1,1,0.003928866935483873,0.006110608870967743,6,0.6866129032258065,0.8198125,1,1,0.013050445161290317,0.009290415322580644,1.6645,0.5812,0.7937,1.5134,0.521,0.895,0.2823,1.68826948,0.6517788016666667,0.767391112,2.8603,7.3,0.3563,5.9359,0.3409,-83.4575,1.1711,5.1647,0.4396,6.6961,0.4919,0.9806,1.8705002166666667,4.564939066666667,5.6058039866666665,0.3808106153333333,0.3895355816666667,0.9798,3.3589,0.5492,2.8156,0.6831,0.9486,0.148,0.401,0.54,0.009,1.55,172.22222222222223,136,0.40296296296296297,1,0,0,1,FALSE,FALSE,FALSE
530,2021-11-13T10:41:39Z,1,1.77735368956743,786,5,3,2,3,3,3,3,5,2,4,4,5,3,1,3,2,2,2,4,1,3,2,2,3,2,0,5,0,0,4,2,1,3,2,3,2,3,2,3,4,2,2,2,3,3,5,4,3,3,3,3,1,1,1,3,4,1,1,3,3,1,4,4,4,5,3,3,3,3,3,2.375,0,3,0,3.8,0,3.5555555555555554,0,3.0833333333333335,0,2,0,2.857142857142857,0,4,0,3.108108108108108,0,0,0,0,0.7665482280246152,1.131783574076812,-0.11003114554008399,0.510876214268364,2,4,2,4,3,4,4,3.857142857142857,0,3,1.5442004886050142,1,1,3,3,1,1,4,1.7142857142857142,0,4.285714285714286,0.6723373927674386,0,3,3,3,3,3,2,5,3,2,4,2,5,3,4,4,1,4,3,5,2,3,0,4,0,4.4,0,3.8,0,4.066666666666666,0,2,3,2,1,4,3,3,1,3,2,3,1,4,3,2,1,1,3,1,3,2.9,0,"White, Caucasian, Anglo, European American",0,22,0,1,NA,5,2,0,0,1,0,0,TRUE,TRUE,TRUE,TRUE,TRUE,0,2,0.8123411765098572,0.68,0.038760504349230535,2,0.48360645162674687,0.540640625,1,1,0.004012407959207309,0.003591003779355941,2,0.700531249947846,0.9045937499627471,1,1,0.011947471254966162,0.09595734835036045,1.3019,0.6277,0.4644,1.1143,0.4935,0.5529,0.0385,1.34804268,0.7421112203333333,0.45645674133333336,3.3903,7.338,0.2526,8.0211,0.3293,-90.0894,0.732,4.332,0.4106,4.3145,0.4652,0.9895,1.7645068126666668,5.46707128,5.1437042,0.3862591006666667,0.31437611633333334,1.6105,3.9253,0.5077,1.8389,0.4928,0.818,0.105,0.433,0.343,0.016,1.671,104.4375,104,0.3081481481481481,1,0,0,1,FALSE,FALSE,FALSE
532,2021-11-13T10:40:30Z,0.8999999761581421,1.7786458333333333,768,4,2,5,5,1,5,1,1,5,1,1,1,1,5,1,5,5,1,1,1,1,1,1,1,1,0,2,0,0,5,5,5,5,5,5,5,5,5,1,5,1,1,5,1,5,1,1,1,1,1,5,1,1,1,1,1,1,1,1,1,5,1,1,1,1,1,1,1,1,1,1,0,1,0,1,0,1,0,1,0,0.8333333333333334,0,0.8571428571428571,0,1,0,1,0,0,0,0,-1.3999745198049947,-1.568373259242148,-0.7372407672780129,-1.1528070132600805,4,2,4,1,1,1,2,1.5714285714285714,0,1,-0.5612498234260587,5,5,5,5,4,5,1,4.857142857142857,0,1.1428571428571428,-1.3043345419688306,0,1,1,1,1,1,1,3,1,1,1,1,5,1,5,5,1,5,1,1,3,1,0,5,0,3,0,4.6,0,4.2,0,1,1,1,1,1,1,1,4,1,1,1,4,1,1,1,4,1,1,1,1,1.15,0,"Hispanic of Latino (e.g., Mexican American, Central American, and others)",0,30,0,1,NA,5,2,0,0,1,0,0,TRUE,TRUE,TRUE,TRUE,TRUE,0,NA,NA,NA,NA,3,0.618103448275862,0.7489592592583763,1,0.8709677419354839,0.03868702963058236,0.045407427462327274,3,0.8875000000018627,1.0595343749998138,1,1,0.0987689638741757,0.10534146490713554,NA,NA,NA,NA,NA,NA,NA,NA,NA,NA,1.7427,3.3313,0.3565,1.2564,0.2282,-3.6403,1.222,2.8623,0.402,2.3287,0.5109,0.9469,1.76072988,1.407712312,3.41516671,0.23805703866666666,0.35096329,1.7515,2.0903,0.4845,1.5675,0.6487,0.9839,0.159,0.292,0.24,0.017,1.851,108.88235294117646,365,1.0814814814814815,1,0,0,1,FALSE,FALSE,FALSE
533,2021-11-13T10:13:53Z,1,1.7777777777777777,864,8,2,3,3,1,3,2,1,4,1,1,1,1,1,1,1,1,1,1,1,1,1,1,1,1,4,7,0,0,5,4,2,4,4,4,4,4,4,2,4,4,1,1,3,4,1,4,1,1,1,4,1,1,1,1,1,1,4,4,4,2,3,1,2,2,1,2,2,2,2,1,0,2,0,2.3333333333333335,0,2.111111111111111,0,2.25,0,1,0,2.857142857142857,0,1.6666666666666667,0,2.135135135135135,0,2,0,0,-0.6939108502892343,-0.5075524221207439,-0.01745100881601569,-0.2625017154683798,4,1,1,3,2,2,3,2.5714285714285716,0,5,1.51297117175748,2,2,3,4,1,1,4,2.142857142857143,0,3.857142857142857,-0.7395711320441822,0,1,1,1,1,1,1,4,1,1,1,1,4,1,4,4,1,4,4,5,1,1,0,4,0,4,0,4.6,0,4.2,0,1,1,1,1,1,3,4,4,2,3,3,3,1,3,2,2,1,3,3,1,2.15,0,Black or African American,0,26,0,1,NA,5,3,0,0,1,1,0,TRUE,TRUE,TRUE,TRUE,TRUE,0,1,0.9624674999989569,0.8,0.049179669943517426,1,0.615409677420893,0.6292125000022352,0.96875,1,0.010029258065462112,0.011856746289832533,1,0.6586387096778039,0.7351032258051057,0.96875,1,0.006691510232155584,0.013888733655659595,1.1714,1.1696,0.661,1.2613,1.2091,0.6354,0.1895,1.2473557176666668,1.0817960313333332,0.645639663,1.466,2.9941,0.3798,4.0591,0.4486,-53.9487,1.1596,5.1708,0.4961,3.4529,0.4679,0.9553,1.7305357333333333,4.159574826666667,3.3797968033333334,0.4231678563333333,0.36041665533333334,1.1233,5.7023,0.55,2.4051,0.5594,0.7148,0.079,0.477,0.379,0.042,1.695,40.357142857142854,382,1.1318518518518519,1,0,0,1,FALSE,FALSE,FALSE
534,2021-11-13T10:49:59Z,0.8999999761581421,1.7777777777777777,1080,4,2,2,3,4,3,3,4,3,4,3,2,3,3,2,3,2,4,4,4,2,4,5,5,5,1,3,0,0,5,4,4,2,3,3,2,4,2,2,5,5,1,2,2,4,4,4,5,5,5,1,1,5,1,1,1,1,2,1,1,4,1,2,1,1,4,2,1,1,1,4.125,0,1.25,0,3.2,0,2.7777777777777777,0,3.3333333333333335,0,2.1666666666666665,0,1.2857142857142858,0,2,0,2.5675675675675675,0,1,0,0,1.5188422568539075,1.3936979157967502,-0.4557470907642554,0.4689754125162474,5,1,3,1,1,2,1,1.4285714285714286,0,2.5,-0.09323549641962975,3,5,4,5,1,1,3,3.142857142857143,0,2.857142857142857,2.0842459175790595,0,3,3,3,1,2,2,4,2,2,4,3,4,1,4,3,2,4,1,2,5,2.4,0,4,0,3.8,0,3.2,0,3.6666666666666665,0,2,1,1,3,1,1,1,4,1,1,1,3,3,2,1,4,1,2,2,2,1.45,0,"White, Caucasian, Anglo, European American",0,24,0,1,NA,5,2,0,0,1,0,0,TRUE,TRUE,TRUE,TRUE,TRUE,0,6,0.8059785714285653,0.8571428571428571,0.03684016407312645,6,0.4467266666666682,0.5477600000000055,0.967741935483871,0.9375,0.0011563132903225205,0.0031754596370969783,6,0.6181624999999876,0.6541290322580721,1,1,0.004791517903227793,0.0041360921290341445,1.2563,1.5007,0.5226,0.7969,1.9899,0.662,0.3445,1.2972159143333333,1.2584241203333333,0.512546212,1.2967,5.2974,0.3314,3.0018,0.3578,-69.3081,0.7309,7.178,0.3997,4.6677,0.4804,0.9482,1.368331889,3.1585218833333335,5.22023853,0.35256285833333334,0.3254239156666667,0.569,4.3766,0.5725,4.4907,0.6082,0.9527,0.203,0.357,0.777,0.029,1.33,45.86206896551724,308,0.9125925925925925,1,0,0,1,FALSE,FALSE,FALSE
535,2021-11-13T10:48:22Z,1,2.3703703703703702,1080,4,3,4,3,3,3,4,3,4,4,4,3,3,3,3,3,3,2,3,3,4,3,3,4,3,2,3,2,1,4,3,3,4,3,3,3,4,3,4,4,4,3,3,3,4,4,3,3,3,3,4,4,4,3,4,4,2,2,3,3,4,4,3,3,3,3,4,3,4,2,3.125,0,3.25,0,3.066666666666667,0,2.6666666666666665,0,3.0833333333333335,0,3.3333333333333335,0,2.5714285714285716,0,3,0,2.972972972972973,0,1,2,1,1.1489993823456521,1.080871917112774,0.7611785930589017,0.9210252550858379,4,3,3,2,3,3,2,2.5714285714285716,0,4,1.143983496983098,2,2,2,2,3,3,4,2.2857142857142856,0,3.7142857142857144,-0.1748077221195339,0,1,2,2,4,2,2,2,3,4,3,2,3,4,3,2,1,3,3,3,2,2.2,0,3.4,0,3,0,2.8,0,3.066666666666667,0,2,2,2,2,2,2,2,2,3,2,3,2,2,2,3,3,3,2,2,2,2.35,0,"White, Caucasian, Anglo, European American",0,19,0,1,NA,5,2,0,0,1,0,0,TRUE,TRUE,TRUE,TRUE,TRUE,0,6,0.8169333333333333,0.9,0.03595283813877463,6,0.5107903225806452,0.5546645161290278,1,0.96875,0.015686420903225414,0.024750686280241657,6,0.7687533333333286,0.837877419354826,0.9375,1,0.05533375254032383,0.07148489647311453,1.3189,1.6789,0.5163,1.3504,2.1765,0.5308,0.3887,1.3381880966666666,1.350896215,0.5060745983333333,1.5611,3.347,0.2776,2.8182,0.2887,-39.7305,1.3402,2.7027,0.296,3.7009,0.36,0.8456,1.5852376266666666,2.9665112566666667,3.4975210333333333,0.29127769366666667,0.2771483556666667,1.4474,1.8056,0.4376,2.4163,0.5365,0.9341,0.077,0.455,0.217,0.015,1.033,68.86666666666666,390,1.1555555555555557,1,0,1,2,FALSE,FALSE,FALSE
536,2021-11-13T10:35:00Z,1,1.7708333333333333,768,7,3,4,4,1,4,1,1,4,1,1,1,1,4,1,4,4,1,1,1,1,1,1,1,1,2,2,0,0,4,4,4,4,4,4,4,4,4,1,4,4,1,4,4,4,1,1,4,1,1,4,1,1,1,1,1,1,1,1,1,4,1,1,1,1,1,1,1,1,1,1,0,1,0,1.4666666666666666,0,2,0,2,0,1,0,1,0,1,0,1.6216216216216217,0,1,0,0,-1.0133206055463637,-1.1006829047740254,-0.5341482934814965,-0.817415599127761,4,3,3,3,3,3,3,2.857142857142857,0,3,0.9459301925190042,4,4,4,4,3,3,1,3.857142857142857,0,2.142857142857143,0.9547190977297628,0,1,1,1,1,1,1,4,1,1,1,1,4,1,4,4,1,4,1,4,1,1,0,4.6,0,3.8,0,4.6,0,4.333333333333333,0,1,1,1,3,1,1,1,3,1,1,1,3,3,1,1,3,1,1,1,1,1.3,0,Black or African American,0,20,0,1,NA,5,2,0,0,1,0,0,TRUE,TRUE,TRUE,TRUE,TRUE,0,5,0.6962414634147795,0.8367346938775511,0.021101112959049505,5,0.5854093749970197,0.6400387096760735,1,1,0.014892542167086967,0.010623521784911778,5,0.7050468749990687,0.8353875000029802,1,1,0.005777120635170682,0.009876189516448591,1.025,1.5866,0.4752,0.9663,1.7021,0.5042,0.2092,1.087401367,1.2690390473333333,0.46509620166666665,2.9722,4.8183,0.277,5.6709,0.378,-60.2023,0.979,3.215,0.4502,5.4419,0.5392,0.9357,2.1440048133333334,4.510525973333333,4.09116143,0.406066271,0.3200965943333333,0.9077,3.9644,0.5954,2.8225,0.7171,0.9038,0.12,0.502,0.605,0.007,1.222,174.57142857142856,376,1.114074074074074,1,0,1,2,FALSE,FALSE,FALSE
537,2021-11-13T11:03:58Z,1,1.7786458333333333,768,6,4,1,3,3,4,4,2,2,4,4,3,2,4,3,4,3,4,3,4,2,3,2,3,4,1,2,0,0,3,4,3,3,4,2,4,3,4,2,4,3,4,3,4,4,3,2,3,4,3,4,2,4,3,4,4,3,2,4,3,2,3,4,2,3,2,1,1,1,1,3.125,0,1,0,3.066666666666667,0,2.6666666666666665,0,2.9166666666666665,0,3,0,3.142857142857143,0,2.3333333333333335,0,2.918918918918919,0,1,0,0,1.1153773028449019,1.0576422637451524,-0.5341482934814965,0.2617469851318279,3,2,4,4,3,4,3,3,0,2.5,0.8469035402869574,5,5,5,5,3,3,1,4.428571428571429,0,1.5714285714285714,-0.7395711320441822,0,3,4,3,2,3,2,4,3,4,3,2,3,4,2,4,3,3,5,3,2,3,0,3,0,3,0,3,0,3,0,2,2,3,2,3,1,2,4,3,2,3,2,2,1,2,3,2,3,2,3,2.25,0,"White, Caucasian, Anglo, European American",0,23,0,1,NA,5,2,0,0,1,0,0,TRUE,TRUE,TRUE,TRUE,TRUE,0,3,0.6947552631277787,0.76,0.018808014132922643,3,0.41355000003178916,0.47814285714285715,0.967741935483871,0.875,0.001469401399802136,0.004983106412033918,3,0.5827870967926517,0.6116433332602182,0.96875,0.967741935483871,0.007350578300222254,0.005824233160141011,1.2252,1.0468,0.4033,0.8029,1.4065,0.561,0.2925,1.2766995333333333,1.013611297,0.39663354866666667,0.9689,5.3256,0.3271,2.2012,0.309,-71.9954,0.6149,6.0238,0.3643,3.6894,0.4128,0.987,1.024522679,2.479366853666667,5.22724581,0.305474953,0.3230348336666667,1.2005,3.7751,0.4351,6.8014,0.5219,0.9854,0.062,0.432,0.447,0.015,1.298,86.53333333333335,346,1.0251851851851852,1,0,0,1,FALSE,FALSE,FALSE
538,2021-11-13T11:02:35Z,1,1.7777777777777777,864,4,3,4,4,3,4,2,1,3,2,2,1,2,4,1,4,5,2,2,1,1,1,1,1,2,0,2,0,0,5,5,2,5,5,5,4,5,4,1,5,2,1,3,2,5,2,2,3,3,3,4,1,1,1,2,1,1,1,2,1,4,2,2,1,1,1,1,1,2,2,1.375,0,1.5,0,1.8666666666666667,0,1.5555555555555556,0,2,0,1.1666666666666667,0,1.4285714285714286,0,1,0,1.6216216216216217,0,0,0,0,-0.7800674290099072,-0.7676277496157452,-0.5804383618435307,-0.6740330557296379,3,2,2,2,2,2,2,2.4285714285714284,0,2,0.32054096227918905,5,5,5,5,1,1,2,3.7142857142857144,0,2.2857142857142856,-0.4571894270818581,0,2,2,2,1,2,1,4,2,1,3,1,5,3,3,3,3,4,2,3,5,1.8,0,4.6,0,3.2,0,3.2,0,3.6666666666666665,0,1,2,1,4,1,1,1,4,1,1,1,4,1,2,1,2,1,1,1,1,1.2,0,Black or African American,0,22,0,1,NA,5,2,1,0,1,0,1,TRUE,TRUE,TRUE,TRUE,TRUE,0,1,1.0398863636363636,0.88,0.19203139142857142,1,0.382125,0.4494,1,0.9375,0.004019983870967742,0.004958064516129033,1,0.5505,0.6360645161290323,1,1,0.005283032258064516,0.0026567956989247306,1.759,1.1761,0.5041,1.3291,1.2847,0.6526,0.1062,1.68905769,1.06899573,0.5023975776666667,1.0787,4.2062,0.2539,3.7356,0.3192,-78.4302,0.8049,5.0446,0.3034,4.9534,0.3632,0.9616,1.1643557263333333,3.8539334833333334,4.455854256666667,0.31315309166666666,0.25018712033333335,0.8492,4.3399,0.4604,4.7003,0.5571,0.969,0.258,0.278,0.956,0.01,1.255,125.49999999999999,385,1.1407407407407408,1,0,0,1,FALSE,FALSE,FALSE
539,2021-11-13T11:04:56Z,1,1.7777777777777777,864,6,2,2,4,1,4,1,1,1,3,2,1,2,3,2,3,4,1,3,1,4,1,2,1,1,6,3,4,5,5,1,1,2,1,3,2,2,1,2,5,3,1,1,1,2,1,1,1,3,3,1,3,2,1,4,3,1,3,3,3,5,1,1,1,1,1,2,2,2,2,1.75,0,2,0,2.2666666666666666,0,4,0,2.1666666666666665,0,2.8333333333333335,0,1.7142857142857142,0,1,0,2.5945945945945947,0,3,4,5,0.05838317854005811,-0.016438833840269056,1.8944225298484991,0.9389918480041151,1,5,2,5,5,5,5,4.857142857142857,0,4,2.5114584594654064,3,5,3,5,2,3,3,3.4285714285714284,0,2.5714285714285716,-0.1748077221195339,0,2,2,2,1,1,2,4,2,3,1,1,3,1,3,3,1,3,1,3,2,1.6,0,4,0,3.6,0,3.4,0,3.6666666666666665,0,1,1,1,4,1,1,1,4,1,1,1,4,1,1,1,4,1,1,1,1,1,0,Black or African American,0,30,0,1,NA,5,2,0,0,1,0,0,TRUE,TRUE,TRUE,TRUE,TRUE,0,5,0.8794022727273405,0.88,0.06056987561141217,5,0.4630366666699449,0.5250843750010245,0.9375,1,0.005294561250218902,0.0089502478127288735,5,0.5763281250004657,0.6392531250012107,1,1,0.014669730473774567,0.010128626441645854,1.5467,1.4243,0.4784,1.1353,1.4338,0.6166,0.1786,1.51960281,1.2244702673333334,0.47294202166666666,1.3961,3.6228,0.2871,3.1002,0.2999,-51.9343,1.0601,5.439,0.3605,5.3742,0.4275,0.9826,1.4777845396666667,3.2864735666666665,3.8364841966666665,0.29643595,0.282263638,1.0766,2.4514,0.4042,4.1178,0.5085,0.8452,0.149,0.271,0.492,0.016,1.409,88.0625,388,1.1496296296296296,1,0,0,1,FALSE,FALSE,FALSE
540,2021-11-13T11:37:47Z,1,1.7777777777777777,1080,6,3,3,4,1,4,1,1,4,1,1,2,1,4,1,3,4,1,2,1,1,1,1,1,1,0,2,0,0,4,3,5,5,4,5,4,4,5,1,4,1,1,4,1,4,1,1,1,2,2,5,1,1,1,3,3,1,1,1,1,4,1,1,1,1,1,2,1,1,1,1.125,0,1.25,0,1.6666666666666667,0,1.6666666666666667,0,1.4166666666666667,0,1.5,0,1,0,1,0,1.4324324324324325,0,0,0,0,-1.0532468249535052,-1.0423184006878752,-0.6588395645607719,-0.8505789826243235,4,1,4,1,1,1,3,1.5714285714285714,0,1,-0.5612498234260587,4,4,5,5,3,3,4,3.7142857142857144,0,2.2857142857142856,-0.4571894270818581,0,2,3,2,1,2,1,4,2,1,4,1,4,1,4,2,1,4,2,3,1,2,0,4.4,0,4.2,0,4,0,4.2,0,2,1,2,3,1,3,1,2,1,1,1,2,3,2,1,3,1,2,1,1,1.7,0,"White, Caucasian, Anglo, European American",0,29,0,1,NA,5,2,0,0,1,0,0,TRUE,TRUE,TRUE,TRUE,TRUE,0,5,0.8440447368621826,0.76,0.03579383764840281,5,0.43527499997615815,0.530375,1,1,0.0025598561352040694,0.005917362573828543,5,0.6560062499940396,0.7028419355115583,1,0.96875,0.012318906404774649,0.0055682243519408455,1.3799,0.9334,0.4533,0.9955,1.1703,0.615,0.1166,1.4104129333333333,0.9283008973333333,0.44620025566666666,2.1915,8.088,0.2998,5.3767,0.3266,-93.5925,0.8454,5.9888,0.3653,5.0995,0.4468,0.7537,1.561413365,4.334463126666667,6.2542758266666665,0.3530013576666667,0.31644827366666667,0.9725,2.3748,0.5215,8.0097,0.6342,0.926,0.082,0.436,0.39,0.015,1.636,109.06666666666666,297,0.88,1,0,0,1,FALSE,FALSE,FALSE
541,2021-11-13T11:35:07Z,1,1.6,800,6,3,1,3,2,4,1,1,4,2,1,3,3,3,1,3,2,1,3,1,1,2,3,2,2,0,3,0,3,3,1,3,3,2,3,1,1,2,1,4,1,1,4,3,5,2,3,4,4,4,1,4,2,1,1,1,1,1,1,1,5,1,1,1,2,1,2,4,1,1,1.875,0,2,0,2.4,0,3.888888888888889,0,2.3333333333333335,0,2.1666666666666665,0,0.8571428571428571,0,1.3333333333333333,0,2.3783783783783785,0,0,0,3,0.0016459193825419229,0.0016609377420030566,0.10571298428849377,0.05368696101524841,4,2,2,1,1,2,2,2,0,2,0.06413940681375631,3,3,3,3,3,3,2,3.142857142857143,0,2.857142857142857,2.0842459175790595,0,3,3,3,5,4,3,5,2,1,5,1,5,5,3,3,3,3,2,3,3,3.6,0,4,0,3.4,0,3.6,0,3.6666666666666665,0,1,4,2,1,1,2,1,2,1,1,1,2,2,3,1,3,2,2,3,2,2.05,0,"Hispanic of Latino (e.g., Mexican American, Central American, and others)",0,23,0,1,NA,5,2,0,0,1,0,0,TRUE,TRUE,TRUE,TRUE,TRUE,0,3,0.8901621621613567,0.74,0.14720522950538478,3,0.43219999999646097,0.509875,1,1,0.002145769677564675,0.0054525929032289595,3,0.6063967741929716,0.6382718750024214,0.96875,1,0.012489445766731362,0.009962725957679275,1.4986,0.697,0.4638,1.4621,0.5086,0.4901,0.0459,1.5130785866666667,0.7604907093333333,0.457563214,2.5923,8.5983,0.2815,5.9024,0.2903,-94.2993,0.8787,6.3772,0.3619,4.7444,0.4284,0.9701,1.492022649,4.37411291,6.1208491799999996,0.34179406733333334,0.31601989,1.0048,3.2531,0.4639,3.0747,0.5056,0.9964,0.068,0.419,0.342,0.07,1.619,23.128571428571426,395,1.1703703703703703,1,0,0,1,FALSE,FALSE,FALSE
542,2021-11-13T11:43:29Z,0.8999999761581421,1.6,900,6,3,4,4,2,4,2,1,4,2,1,1,1,5,2,4,4,1,1,1,1,1,1,1,1,4,2,0,0,4,4,4,4,4,4,4,4,4,1,5,1,1,4,2,4,2,3,1,2,2,5,1,1,1,3,2,1,2,2,1,5,1,2,1,1,1,2,1,2,2,1,0,1.75,0,1.6666666666666667,0,2,0,1.6666666666666667,0,1.3333333333333333,0,1.2857142857142858,0,1,0,1.6216216216216217,0,2,0,0,-1.0133206055463637,-1.0147331873138241,-0.0958522115332568,-0.5552926994235404,4,2,3,1,1,2,1,1.7142857142857142,0,2,-0.10679496349653231,5,5,5,5,3,3,2,4.285714285714286,0,1.7142857142857142,-0.7395711320441822,0,3,3,3,3,3,3,3,3,2,4,2,3,3,3,3,2,3,3,3,3,3,0,3.2,0,3.4,0,3.2,0,3.2666666666666666,0,1,1,1,2,1,1,1,3,1,1,2,3,2,1,1,3,1,2,1,2,1.45,0,"Asian or Asian American (e.g., Chinese, Japanese, and others)",0,28,0,1,NA,5,2,0,0,0,0,0,TRUE,TRUE,TRUE,TRUE,TRUE,0,4,1.0602454545457254,0.88,0.2848381536159569,4,0.4614483870960051,0.5481312499996275,1,1,0.004376727246985211,0.005405173830341796,4,0.6409709677441466,0.7346533333331347,1,0.9375,0.027072118129495344,0.0165335573284663,1.8,1.1091,0.4076,1.6694,1.3649,0.4789,0.2554,1.70698697,1.0253808993333333,0.413546961,1.9987,7.3163,0.3249,4.9968,0.3481,-87.6542,0.7777,6.1924,0.3917,5.2045,0.4769,0.8913,1.62033771,4.287512983333333,6.04435078,0.3612270516666667,0.333429206,0.8623,3.2675,0.5217,3.1183,0.6284,0.9949,0.085,0.42,0.44,0.006,1.288,214.66666666666666,412,1.2207407407407407,1,0,1,2,FALSE,FALSE,FALSE
543,2021-11-13T11:51:58Z,1,1.7786458333333333,768,6,5,4,5,2,5,2,1,5,1,1,1,1,5,2,5,5,1,1,1,1,1,1,1,1,1,2,0,0,5,5,5,5,5,5,5,5,5,2,5,1,1,5,1,5,1,1,1,1,1,5,1,1,1,1,1,1,2,2,2,5,1,1,1,2,1,1,1,2,2,1,0,1.5,0,1.2666666666666666,0,1,0,1.0833333333333333,0,0.8333333333333334,0,1.2857142857142858,0,1.3333333333333333,0,1.135135135135135,0,1,0,0,-1.3159193210531184,-1.3956995025428247,-0.3773458880470143,-0.8865226952949194,5,1,5,1,1,1,1,1,0,1,-0.9031185640466358,5,5,5,5,5,4,1,4.857142857142857,0,1.1428571428571428,-1.0219528370065065,0,2,3,2,1,2,2,4,1,1,2,3,4,1,4,4,1,4,1,5,2,2,0,4,0,4.2,0,4.4,0,4.2,0,1,1,1,4,2,1,1,4,1,1,2,4,1,1,1,4,1,1,1,1,1.1,0,"White, Caucasian, Anglo, European American",0,28,0,1,NA,5,2,0,0,1,0,0,TRUE,TRUE,TRUE,TRUE,TRUE,0,2,1.4079619047611598,0.875,0.337430857123051,2,0.5520000000004657,0.6295299999992052,1,0.967741935483871,0.003359498709608788,0.005821607569914303,2,0.675268750000745,0.6953870967739532,1,1,0.005533164153221068,0.004019208494626728,2.1515,0.9246,0.6033,1.7972,0.9228,0.7676,0.5958,1.9561772533333333,0.8626468743333333,0.6079759626666666,1.981,5.8782,0.3835,3.713,0.3736,-65.8333,1.0229,5.5643,0.4652,5.4534,0.5379,0.9945,1.9068157033333333,3.5660915933333333,5.368868146666666,0.371491072,0.37760983833333334,0.715,3.5106,0.6042,6.4828,0.6399,0.9835,0.224,0.41,0.835,0.048,0.988,20.583333333333332,364,1.0785185185185184,1,0,0,1,FALSE,FALSE,FALSE
544,2021-11-13T11:51:07Z,1,1.7777777777777777,1080,4,2,2,3,4,2,3,3,2,4,2,2,3,2,1,2,2,3,4,1,1,3,4,3,3,1,2,0,0,3,3,4,3,3,4,3,2,2,2,2,3,3,2,2,3,3,3,2,2,3,3,1,1,1,3,2,1,1,1,1,3,1,2,1,3,2,1,2,1,1,2.75,0,1.25,0,3.2666666666666666,0,3,0,2.8333333333333335,0,1.6666666666666667,0,1.2857142857142858,0,2,0,2.3783783783783785,0,1,0,0,0.5459033313009405,0.750139727291256,-0.4557470907642554,0.1471963182635003,3,2,2,3,2,4,3,3,0,2,0.6624097028997663,5,5,5,5,3,3,4,4,0,2,1.5194825076544112,0,4,4,3,4,4,3,4,3,2,3,1,4,4,3,3,2,4,4,3,4,3.8,0,3.6,0,3.2,0,3,0,3.2666666666666666,0,2,2,3,2,2,3,3,3,4,3,2,2,2,1,2,2,3,2,2,3,2.5,0,"Asian or Asian American (e.g., Chinese, Japanese, and others)",0,28,0,1,NA,5,2,0,0,1,0,0,TRUE,TRUE,TRUE,TRUE,TRUE,0,2,1.0237947368420857,0.76,0.102978205881785,2,0.6684468750006054,0.6790645161285516,1,1,0.015218304506107078,0.008935555032250832,2,0.7168312499995809,0.7941875000001164,1,1,0.021000371250078725,0.014908065000044194,1.419,0.822,0.5847,1.2497,0.924,0.6666,0.2102,1.4610297133333334,0.860200043,0.5718775796666666,2.785,4.5038,0.3593,5.9736,0.446,-61.8271,1.142,3.2417,0.5018,5.2783,0.5647,0.9716,2.2914173266666666,4.911790146666666,3.95203073,0.45047625366666666,0.37453060633333335,1.1068,2.9454,0.5408,4.0815,0.6544,0.9973,0.236,0.328,0.634,0.011,1.316,119.63636363636365,512,1.517037037037037,1,0,5,6,FALSE,FALSE,FALSE
545,2021-11-13T11:52:32Z,1,1.7777777777777777,1080,3,3,4,4,2,4,3,1,5,2,2,1,2,4,2,3,3,1,2,1,1,1,2,2,1,0,2,0,0,5,5,2,4,3,4,3,4,3,1,4,2,1,3,2,3,3,3,2,3,3,4,1,1,1,2,1,1,1,1,1,4,1,2,1,1,1,1,1,1,1,1.375,0,1,0,2,0,2.3333333333333335,0,2.3333333333333335,0,1.1666666666666667,0,1.1428571428571428,0,1,0,1.864864864864865,0,0,0,0,-0.6287680712565301,-0.6057944978213119,-0.7372407672780129,-0.6715176325496623,5,1,3,1,1,2,1,1.4285714285714286,0,2,-0.2777293338068208,5,5,5,5,3,3,1,4.428571428571429,0,1.5714285714285714,-1.0219528370065065,0,2,2,2,2,3,2,4,2,2,2,3,4,2,4,4,2,3,2,3,3,2.2,0,3.6,0,3.4,0,3.8,0,3.6,0,1,1,2,3,2,2,1,2,1,1,2,2,2,2,1,2,1,2,2,2,1.8,0,"White, Caucasian, Anglo, European American",0,19,0,1,NA,5,2,0,0,1,0,0,TRUE,TRUE,TRUE,TRUE,TRUE,0,4,0.8587318181829019,0.88,0.02931388336732563,4,0.48665483870813925,0.5813199999978145,1,0.9375,0.003279467892545811,0.0044111038305952735,4,0.5402312500015832,0.6458357142859271,1,0.9032258064516129,0.004094620927437499,0.007000309999802904,1.2401,1.6698,0.5892,0.9389,2.1277,0.6796,0.2478,1.2797195653333333,1.3427852603333332,0.5776834656666666,0.9556,5.2719,0.396,3.0759,0.4394,-83.3664,0.7145,5.4873,0.416,5.3329,0.5152,0.7054,1.1358914816666668,3.393354213333333,5.320608843333333,0.42610208466666666,0.38306183266666666,1.5338,6.5363,0.4286,10.7802,0.5582,0.715,0.078,0.38,0.524,0.014,2.005,143.2142857142857,314,0.9303703703703704,1,0,1,2,FALSE,FALSE,FALSE
546,2021-11-13T12:12:12Z,1,1.7777777777777777,864,4,3,4,4,3,4,2,3,3,2,3,4,2,3,2,2,2,2,2,1,1,1,1,2,2,2,2,0,0,2,3,3,3,2,4,5,5,3,2,4,3,1,3,2,4,2,2,2,4,3,4,2,1,1,1,1,1,2,1,1,2,3,3,1,1,2,1,2,2,2,1.5,0,1.75,0,2.7333333333333334,0,2.6666666666666665,0,2.3333333333333335,0,1.1666666666666667,0,2,0,1.3333333333333333,0,2.135135135135135,0,1,0,0,-0.3829066149072922,-0.12077869354983783,-0.2989446853297732,-0.20986168943980552,4,2,3,1,1,3,2,2,0,1,-0.3048482679606258,4,4,4,4,2,2,2,3.4285714285714284,0,2.5714285714285716,-1.0219528370065065,0,2,2,2,3,3,2,4,2,1,2,2,3,3,2,3,4,5,4,3,3,2.4,0,3.6,0,2.8,0,3.4,0,3.2666666666666666,0,2,4,4,3,4,3,4,2,2,1,3,2,3,3,2,2,1,3,3,3,2.8,0,"Asian or Asian American (e.g., Chinese, Japanese, and others) & Filipino",1,19,0,2,NA,5,2,0,0,1,0,0,TRUE,TRUE,TRUE,TRUE,TRUE,0,5,0.7958432432435252,0.7551020408163265,0.05624046252540531,5,0.4797874999997439,0.49769375000032595,1,1,0.007745146290288202,0.003276753508044278,5,0.5913548387096774,0.6956812499999069,1,1,0.012920134559127829,0.024543887378926047,1.237,0.9438,0.4874,1.1467,0.6455,0.5234,0.0574,1.2927337933333334,0.94745127166666665,0.477801818,3.1351,5.6677,0.2032,8.4554,0.3123,-84.8148,0.7906,5.3939,0.4078,5.1627,0.4222,0.8674,1.7548191766666668,5.88896124,4.18351513,0.356942408,0.267751042,1.1096,4.124,0.4625,3.5898,0.5339,0.9963,0.266,0.188,0.669,0.013,1.402,107.84615384615384,384,1.1377777777777778,1,0,0,1,FALSE,FALSE,FALSE
547,2021-11-13T12:18:35Z,0.8999999761581421,1.6,900,8,3,5,5,1,5,1,1,5,1,1,1,1,5,2,5,5,1,1,1,1,1,1,1,1,0,2,0,0,5,5,5,5,5,5,5,5,5,1,5,1,1,5,1,5,1,1,1,1,1,5,1,1,1,3,1,1,1,2,1,5,1,1,1,1,1,1,1,1,1,1,0,1,0,1.0666666666666667,0,1,0,1,0,1.1666666666666667,0,1,0,1,0,1.0810810810810811,0,0,0,0,-1.3495414005538688,-1.5048788733706477,-0.7372407672780129,-1.1210598203243303,5,1,4,1,1,1,1,1.1428571428571428,0,1.5,-0.6331575415043005,5,5,5,5,3,3,1,4.428571428571429,0,1.5714285714285714,-0.1748077221195339,0,1,1,1,1,1,1,4,1,1,4,1,5,1,5,4,1,5,3,5,3,1,0,4.6,0,4.6,0,4.4,0,4.533333333333333,0,1,1,1,1,1,1,1,4,1,1,1,3,1,1,1,4,1,2,2,1,1.3,0,"White, Caucasian, Anglo, European American",0,26,0,1,NA,5,2,0,0,1,0,0,TRUE,TRUE,TRUE,TRUE,TRUE,0,3,0.853222222222219,0.72,0.05047873632653007,3,0.6358064516128938,0.6919677419354802,1,0.96875,0.06888222795698552,0.04634904737903334,3,0.6349999999999977,0.7778750000000013,1,1,0.008516451612903424,0.025245016129032394,1.2901,0.7454,0.4761,1.0067,0.8239,0.6158,0.4495,1.3424995133333333,0.8121088196666667,0.466343128,1.5966,2.1473,0.264,2.1634,0.3378,-8.2339,1.5547,1.4689,0.2431,2.8662,0.418,0.2332,1.6139772,2.2984661033333333,2.35774278,0.3383256963333333,0.26893178733333334,1.2319,4.7672,0.5104,2.3644,0.5634,0.9935,0.124,0.355,0.436,0.009,1.394,154.88888888888889,370,1.0962962962962963,1,0,0,1,FALSE,FALSE,FALSE
548,2021-11-13T12:25:19Z,1,1.7777777777777777,864,4,4,2,5,4,4,3,1,2,4,4,3,4,2,2,2,4,2,4,1,1,3,4,4,3,3,2,0,2,4,4,2,3,2,3,3,4,2,2,4,3,1,3,3,2,5,5,3,4,4,2,4,1,1,2,1,1,4,4,1,4,1,1,1,1,4,2,2,1,1,2.75,0,1.5,0,3.066666666666667,0,3,0,3.25,0,2,0,1.8571428571428572,0,2,0,2.675675675675676,0,2,0,2,0.7308247685550677,0.7919531033529758,0.1786458795478636,0.4852994914504197,5,1,5,2,1,1,1,1.1428571428571428,0,6.5,1.2117808323676102,5,5,5,5,2,2,1,4.142857142857143,0,1.8571428571428572,-1.3043345419688306,0,3,3,3,3,3,3,5,4,3,3,1,3,2,2,2,1,4,1,5,1,3,0,4,0,4.4,0,2.8,0,3.7333333333333334,0,1,1,3,2,2,3,3,2,3,3,3,1,1,4,1,1,1,4,3,1,2.55,0,"Asian or Asian American (e.g., Chinese, Japanese, and others)",0,22,0,1,NA,5,2,0,0,0,0,0,TRUE,TRUE,TRUE,TRUE,TRUE,0,1,0.5347031250009313,0.64,0.017482915203942465,1,0.3884238095219646,0.45026666666788084,0.8076923076923077,0.84375,0.005704336246295274,0.005045020715512337,1,0.5294774193576267,0.5708318181823601,0.96875,0.6875,0.008620769677208033,0.007715100876867076,1.0957,0.5504,0.257,0.6854,0.7073,0.4378,0.3543,1.1495940513333334,0.7288121676,0.2517195913333333,0.84,1.9559,0.2429,1.9887,0.2979,-39.5658,0.6653,2.6166,0.2989,3.2045,0.3572,0.9391,0.8886029686666667,2.3044022303333334,2.4973542213333335,0.2945523293333333,0.24029113533333332,0.7278,3.7565,0.4484,1.2378,0.4534,0.968,0.052,0.356,0.27,0.003,1.106,368.6666666666667,378,1.12,1,0,0,1,FALSE,FALSE,FALSE
549,2021-11-13T12:30:30Z,1,2.3703703703703702,1080,7,4,4,3,2,3,4,2,4,2,2,1,1,5,1,4,4,1,2,3,1,1,1,1,1,1,2,0,1,5,5,5,5,4,4,5,4,4,3,4,2,2,4,4,2,2,3,4,2,3,2,4,1,1,2,1,1,2,1,1,4,3,1,1,1,1,1,1,1,1,1.375,0,1,0,2,0,1.4444444444444444,0,2.75,0,2,0,1.4285714285714286,0,1,0,1.972972972972973,0,1,0,1,-0.5615239122550293,-0.5593351910860681,-0.35769864658231576,-0.45851691883419193,5,1,3,1,1,2,1,1.4285714285714286,0,1,-0.6467170085812028,5,5,5,5,2,2,1,4.142857142857143,0,1.8571428571428572,-1.3043345419688306,0,2,2,2,1,3,2,3,3,4,2,3,3,4,2,4,3,3,2,4,4,2,0,3.4,0,2.8,0,2.6,0,2.933333333333333,0,2,2,3,2,2,1,3,3,1,2,2,3,2,1,2,3,1,1,1,1,1.8,0,"White, Caucasian, Anglo, European American",0,27,0,1,NA,5,2,0,0,1,0,0,TRUE,TRUE,TRUE,TRUE,TRUE,0,NA,NA,NA,NA,1,0.426227586203608,0.4650607142874173,0.90625,0.9032258064516129,0.007057502732157948,0.008650555161548263,1,0.5261580645192054,0.6384379310320164,1,0.90625,0.0064960525166728135,0.014459484827592706,NA,NA,NA,NA,NA,NA,NA,NA,NA,NA,0.9759,2.5599,0.2686,2.597,0.3043,-48.8197,0.8286,4.4207,0.3277,3.4179,0.3418,0.8921,1.0476712393333334,2.847530933333333,2.937939963333333,0.29948478666666667,0.264437297,0.9524,3.7083,0.4138,3.8255,0.5059,0.9085,0.059,0.372,0.423,0.007,1.374,196.2857142857143,104,0.3081481481481481,1,0,4,5,FALSE,TRUE,FALSE
550,2021-11-13T12:42:45Z,1,1.7777777777777777,1080,4,1,5,5,1,5,1,1,5,1,1,2,1,5,1,5,1,1,1,1,1,1,1,1,1,4,1,1,1,1,3,2,3,1,5,1,5,3,1,5,2,1,3,1,5,1,1,2,2,2,3,1,1,1,3,1,1,3,3,3,5,1,1,1,1,1,1,1,2,2,1,0,1.5,0,1.3333333333333333,0,3.3333333333333335,0,1.5,0,1.5,0,1.7142857142857142,0,1,0,2,0,2,1,1,-0.7779660490411104,-0.9953751428408057,0.20882944024170652,-0.3932728512995496,5,1,3,1,1,3,1,1.5714285714285714,0,1,-0.5612498234260587,5,5,5,5,4,4,1,4.714285714285714,0,1.2857142857142858,-0.1748077221195339,0,3,2,3,2,3,3,3,3,3,2,5,1,3,3,3,5,3,5,2,3,2.6,0,1.8,0,2.2,0,3,0,2.3333333333333335,0,1,1,3,1,4,4,4,1,2,1,2,1,1,2,1,2,1,4,1,4,2.55,0,Black or African American,0,23,0,1,NA,5,2,0,0,1,0,0,TRUE,TRUE,TRUE,TRUE,TRUE,0,NA,NA,NA,NA,6,0.45246875,0.4718206896553266,1,0.9354838709677419,0.0026143989920432526,0.002882104322530447,6,0.596581250000745,0.6666187499999069,1,1,0.003449082217791571,0.0033481725403485124,NA,NA,NA,NA,NA,NA,NA,NA,NA,NA,0.9986,4.9667,0.3519,3.883,0.3554,-89.2917,0.7185,5.0422,0.3873,5.4852,0.4069,0.9633,1.0988176283333333,4.001132206666667,5.07974916,0.348204593,0.345998824,0.8002,5.276,0.5253,5.3912,0.5962,0.8022,0.138,0.4,0.717,0.024,1.867,77.79166666666667,356,1.0548148148148149,1,1,4,5,FALSE,FALSE,FALSE
551,2021-11-13T12:42:32Z,1,1.6,800,6,3,4,4,3,4,4,1,4,1,2,1,2,4,3,5,3,2,3,1,1,2,1,2,2,0,2,0,0,5,5,5,5,3,5,4,5,4,2,5,3,1,4,2,5,2,3,4,3,5,5,1,1,1,3,2,1,1,1,1,5,2,2,1,2,1,2,2,1,1,1.75,0,1.5,0,2.066666666666667,0,1.4444444444444444,0,2.4166666666666665,0,1.3333333333333333,0,1.1428571428571428,0,1.3333333333333333,0,1.7297297297297298,0,0,0,0,-0.4795700934719498,-0.47406300518242234,-0.5804383618435307,-0.5272506835129765,4,1,3,1,1,2,1,1.5714285714285714,0,1,-0.5612498234260587,4,4,4,3,1,2,5,2.7142857142857144,0,3.2857142857142856,-0.1748077221195339,0,2,2,2,2,2,2,5,3,2,2,2,4,3,4,5,4,4,2,3,3,2,0,4,0,3,0,3.8,0,3.6,0,3,3,4,2,4,4,4,2,1,4,1,2,2,3,2,2,1,3,2,4,2.85,0,"White, Caucasian, Anglo, European American",0,29,0,1,NA,5,2,0,0,0,0,0,TRUE,TRUE,TRUE,TRUE,TRUE,0,1,0.9535911764701938,0.6938775510204082,0.06839352474464175,NA,NA,NA,NA,NA,NA,NA,1,0.7346096774188261,0.794953125,1,1,0.004798773569899081,0.006278752247980209,1.3125,0.676,0.5572,0.9775,0.7699,0.69,0.1875,1.3618117133333334,0.7757592066666666,0.5482730233333334,NA,NA,NA,NA,NA,NA,NA,NA,NA,NA,NA,NA,NA,NA,NA,NA,NA,0.8138,4.6352,0.6553,3.8194,0.7,0.9943,0.182,0.508,0.831,0.025,1.674,66.96,382,1.1318518518518519,1,1,1,2,FALSE,FALSE,FALSE
552,2021-11-13T12:53:12Z,1,1.6,1050,7,5,4,5,3,4,2,2,4,2,2,2,2,4,2,4,4,2,3,1,1,1,2,3,2,1,2,0,0,4,4,4,4,4,4,3,4,4,2,4,2,1,4,1,5,3,2,2,2,3,4,1,1,1,1,1,1,2,2,1,4,1,2,1,1,1,1,1,2,2,1.875,0,1.5,0,2,0,2.111111111111111,0,1.9166666666666667,0,1,0,1.4285714285714286,0,1,0,1.7027027027027026,0,1,0,0,-0.41863007437683963,-0.46060916427367454,-0.3773458880470143,-0.41897752616034445,4,2,3,2,2,2,2,2.142857142857143,0,1,-0.21938108280548152,5,5,5,5,3,3,1,4.428571428571429,0,1.5714285714285714,-1.0219528370065065,0,2,3,3,2,2,3,5,2,2,3,2,4,2,4,4,2,4,2,4,2,2.4,0,3.8,0,4,0,4,0,3.933333333333333,0,1,1,1,4,1,1,1,4,1,1,2,4,1,1,1,4,1,1,1,1,1.05,0,"White, Caucasian, Anglo, European American",0,30,0,1,NA,5,2,0,0,1,0,0,TRUE,TRUE,TRUE,TRUE,TRUE,0,3,0.620389999999851,0.8163265306122449,0.023464337840232028,3,0.4382741935479064,0.4765740740740741,0.96875,0.8709677419354839,0.0019534101613117123,0.003204230473135126,3,0.5744937499995576,0.6431032258066679,1,0.96875,0.005924385120974626,0.00264020028232135,1.1505,1.3992,0.3788,0.9055,1.3786,0.4529,0.1133,1.1965994576666668,1.19198395,0.3713537573333333,0.8001,4.0202,0.3432,2.7452,0.3568,-78.2859,0.6735,5.9576,0.3837,4.5656,0.4041,0.9448,0.88197994,3.0392583866666665,4.313343213333333,0.350707951,0.338475068,1.0416,4.3594,0.4683,7.6905,0.5744,0.9508,0.098,0.403,0.612,0.017,1.839,108.17647058823529,396,1.1733333333333333,1,0,0,1,FALSE,FALSE,FALSE
553,2021-11-13T12:32:44Z,1,1.7777777777777777,1080,3,3,2,4,2,3,2,1,5,2,2,3,1,4,3,4,3,2,2,1,1,1,1,1,2,1,2,0,0,4,3,3,5,3,5,3,5,5,1,5,1,1,3,2,3,1,2,1,3,3,4,1,1,1,1,1,1,1,1,1,4,1,2,1,1,1,2,1,1,1,1.375,0,1.25,0,2.2,0,2,0,1.8333333333333333,0,1,0,1.1428571428571428,0,1,0,1.5945945945945945,0,1,0,0,-0.7968784687602826,-0.6359930471992205,-0.4557470907642554,-0.545870068981738,5,2,3,1,1,1,1,1.4285714285714286,0,1,-0.6467170085812028,4,3,3,4,3,3,2,3.4285714285714284,0,2.5714285714285716,-1.3043345419688306,0,1,3,1,2,3,2,2,2,1,1,2,3,1,4,4,2,3,4,3,2,2,0,3.2,0,3,0,4.2,0,3.466666666666667,0,2,2,1,1,1,1,1,3,1,1,3,3,2,1,2,3,1,2,1,1,1.65,0,"White, Caucasian, Anglo, European American",0,21,0,1,NA,5,2,0,0,2,0,0,TRUE,TRUE,TRUE,TRUE,TRUE,0,2,0.8295718750000014,0.6666666666666666,0.05659983913120998,2,0.4134218750000182,0.4512066666666884,1,0.967741935483871,0.0032892998286300577,0.002219417784945034,2,0.6321749999999774,0.7075624999999891,1,1,0.008266066451609428,0.009483995967740827,1.373,0.5252,0.3806,1.2603,0.4953,0.4631,0.3022,1.40510064,0.6676799937333333,0.3750223266666667,0.9928,4.9363,0.3129,4.9432,0.3572,-98.5253,0.8186,5.8817,0.3401,5.902,0.3805,0.9978,1.082285205,4.78123731,5.02986569,0.34991534,0.30738401666666665,0.8991,4.5277,0.5374,3.5205,0.5878,0.9617,0.248,0.28,0.698,0.014,1.289,92.07142857142857,104,0.3081481481481481,1,1,4,5,FALSE,FALSE,FALSE
554,2021-11-13T12:53:12Z,1,1.7777777777777777,1080,6,3,3,3,4,3,4,3,2,3,3,3,3,2,2,2,2,2,3,1,1,2,2,2,2,2,2,0,0,3,2,2,2,3,4,3,3,3,2,3,4,1,3,4,4,4,4,4,4,4,2,1,1,1,3,1,1,3,3,3,2,4,3,1,1,2,1,1,2,2,1.875,0,1.5,0,3.3333333333333335,0,3.2222222222222223,0,3.25,0,1.6666666666666667,0,2.857142857142857,0,1.3333333333333333,0,2.810810810810811,0,1,0,0,0.27062255538854535,0.5885968461639186,-0.3773458880470143,0.10562547905845215,5,1,5,2,1,1,1,1.1428571428571428,0,2.5,-0.2641698667299184,5,5,5,5,4,4,1,4.714285714285714,0,1.2857142857142858,-0.7395711320441822,0,2,2,2,2,2,2,4,2,2,4,3,3,1,4,4,1,3,3,4,2,2,0,3.2,0,4.4,0,4,0,3.8666666666666667,0,2,2,1,4,3,1,2,3,1,1,2,3,1,1,1,3,1,1,1,2,1.5,0,"Hispanic of Latino (e.g., Mexican American, Central American, and others)",0,28,0,1,NA,5,2,0,0,1,0,0,TRUE,TRUE,TRUE,TRUE,TRUE,0,1,0.7694214285725639,0.84,0.056477901730050725,1,0.4450093750003725,0.53235172413752,1,0.90625,0.0014056299092707056,0.005308950604895392,1,0.6472066666662692,0.6919281250019558,1,1,0.0020768234023330976,0.007300171119098916,1.3788,1.2466,0.4117,1.3255,1.4034,0.4347,0.0826,1.39743714,1.127103264,0.405444004,1.2393,6.6423,0.3517,2.4425,0.3165,-75.6299,0.732,7.0636,0.3951,4.2475,0.4544,0.9609,1.2888634983333334,2.64445381,6.099793436666666,0.31370299766666665,0.3444258396666667,1.0477,6.4912,0.5673,3.7872,0.5646,0.9916,0.083,0.51,0.579,0.032,1.215,37.96875,284,0.8414814814814815,1,0,0,1,FALSE,FALSE,FALSE
555,2021-11-13T12:49:21Z,1,1.6,800,6,2,1,2,2,3,2,2,3,4,3,3,3,4,3,1,2,2,3,1,3,4,2,3,2,0,6,3,2,4,2,1,2,3,2,2,1,3,2,2,2,1,1,2,2,3,4,3,2,1,2,1,1,1,1,1,1,1,1,1,3,2,2,3,3,2,2,1,1,1,2.5,0,1.25,0,3.2,0,3.7777777777777777,0,2.75,0,1.3333333333333333,0,1.4285714285714286,0,2.6666666666666665,0,2.5675675675675675,0,0,3,2,0.5080784918625958,0.6953564614326144,0.3139593520166609,0.5046579067246377,3,2,3,2,3,3,2,2.5714285714285716,0,3,0.7749958222087157,4,3,3,2,1,1,1,2.7142857142857144,0,3.2857142857142856,1.5194825076544112,0,4,3,3,2,2,1,2,1,3,2,1,4,2,3,3,1,3,2,3,4,2.8,0,4.2,0,3.2,0,3.2,0,3.533333333333333,0,2,1,2,1,2,3,2,2,1,2,2,1,2,1,1,2,1,1,1,3,2.05,0,"Asian or Asian American (e.g., Chinese, Japanese, and others)",0,25,0,1,NA,5,2,0,0,1,0,0,TRUE,TRUE,TRUE,TRUE,TRUE,0,1,0.6256727272730433,0.6875,0.033821862907753734,NA,NA,NA,NA,NA,NA,NA,1,0.8166481481481481,1.0871312499996275,0.84375,0.5161290322580645,0.22685538684484682,0.3263969162365287,1.2501,0.6647,0.2664,0.9462,1.0295,0.4097,0.2988,1.2954625633333334,0.7743862306666667,0.261082038,NA,NA,NA,NA,NA,NA,NA,NA,NA,NA,NA,NA,NA,NA,NA,NA,NA,1.3461,1.174,0.4228,0.2612,0.4247,0.9707,0.076,0.303,0.048,0.328,1.71,5.213414634146341,386,1.1437037037037037,1,0,1,2,FALSE,FALSE,FALSE
556,2021-11-13T13:03:48Z,1,1.7786458333333333,768,2,2,4,3,3,3,3,1,3,4,3,3,3,3,3,3,4,3,3,3,3,3,3,4,3,5,2,4,5,4,3,5,3,4,3,3,4,4,3,4,3,3,4,4,3,3,3,3,3,3,3,4,3,1,4,3,4,4,4,4,4,3,3,3,3,3,2,3,3,3,3.125,0,2.75,0,2.8,0,2.3333333333333335,0,2.9166666666666665,0,2.8333333333333335,0,3.2857142857142856,0,3,0,2.891891891891892,0,3,4,5,1.0985662630945265,0.9314278137810728,2.1296261380002224,1.5305269758906475,4,1,4,1,1,3,3,1.8571428571428572,0,1,-0.39031545311577004,3,3,3,3,3,2,3,2.857142857142857,0,3.142857142857143,0.38995568780511447,0,3,3,2,2,2,3,3,3,3,3,3,3,2,3,3,3,3,3,3,3,2.4,0,3,0,3.2,0,3,0,3.066666666666667,0,2,2,2,2,2,2,2,2,2,2,2,2,2,2,2,2,2,2,2,2,2.2,0,"White, Caucasian, Anglo, European American",0,27,0,1,NA,5,2,0,0,1,0,0,TRUE,TRUE,TRUE,TRUE,TRUE,0,3,0.8822758620689655,0.6304347826086957,0.13927399855072467,3,0.5918064516129032,0.6290967741935484,1,0.96875,0.023001294623655914,0.011381419354838707,3,0.64925,0.7821333333333333,1,0.967741935483871,0.011209999999999998,0.010897346236559139,1.3434,0.3994,0.4874,1.2666,0.2015,0.5079,0.0375,1.3880991366666666,0.5818943689333334,0.47692131,1.2406,3.4011,0.4095,3.1779,0.4415,-55.0118,1.0797,3.1421,0.4198,3.8811,0.4866,0.9848,1.525195268,3.516541386666667,3.7603797033333333,0.41836723366666667,0.383092936,1.1045,4.6439,0.5202,4.8283,0.6604,0.9173,0.095,0.452,0.548,0.011,1.792,162.90909090909093,350,1.0370370370370372,1,1,2,3,FALSE,FALSE,FALSE
557,2021-11-13T13:10:55Z,1,1.7786458333333333,768,5,2,1,2,2,2,3,1,5,1,1,1,2,3,3,3,3,1,1,1,2,1,1,1,1,1,1,4,0,2,3,2,5,1,5,5,5,5,1,4,5,1,2,1,1,3,1,1,1,1,1,4,5,1,3,3,2,1,1,1,5,1,1,2,3,1,3,2,4,2,1.125,0,2.75,0,2.466666666666667,0,2.3333333333333335,0,2.1666666666666665,0,3.3333333333333335,0,1,0,2,0,2.2162162162162162,0,1,4,0,-0.565726672192623,-0.36168955701655103,0.8411929559112861,0.23975169944736752,2,4,1,5,2,3,5,4,0,6,2.736630698083305,1,3,3,2,1,1,5,1.7142857142857142,0,4.285714285714286,1.8018642126167355,0,2,2,3,2,2,1,4,3,1,1,1,3,1,4,3,5,4,1,4,5,2.2,0,4.4,0,3,0,3.2,0,3.533333333333333,0,1,1,1,4,1,1,1,4,1,1,1,3,1,2,1,3,1,1,1,1,1.15,0,Black or African American,0,22,0,1,NA,5,2,0,0,2,0,0,TRUE,TRUE,TRUE,TRUE,TRUE,0,5,1.3422696969716839,0.66,0.2534461520660866,5,0.6191656249994412,0.7142548387108311,1,1,0.009546255876275455,0.011792842559204183,5,0.8351656249966473,1.064777419356569,1,1,0.04604045458633045,0.12031538580424916,1.8591,0.3597,0.6025,1.9051,0.2245,0.5925,0.2623,1.8113818266666666,0.4673421609633333,0.5931698386666666,1.9723,4.7765,0.4127,4.1436,0.4763,-61.7638,1.0093,4.065,0.4926,4.082,0.5921,0.914,2.18638946,4.0739708666666665,4.728502203333333,0.447266435,0.38812969366666666,1.9684,3.5927,0.5287,1.4685,0.5311,0.9127,0.127,0.433,0.294,0.009,1.495,166.11111111111114,332,0.9837037037037036,1,0,0,1,FALSE,FALSE,FALSE
558,2021-11-13T13:16:23Z,1,1.7777777777777777,1080,3,1,5,5,2,4,3,1,1,4,1,1,1,5,1,5,3,1,1,1,1,1,1,1,1,4,2,0,0,5,5,5,3,1,5,5,5,5,1,5,3,1,2,2,5,1,1,1,1,1,1,1,1,1,1,1,1,1,1,5,5,1,1,1,1,1,1,1,2,2,1,0,1.5,0,1.8666666666666667,0,1.6666666666666667,0,1.5,0,1.5,0,1.4285714285714286,0,1,0,1.5405405405405406,0,2,0,0,-1.0637537247974898,-0.9636279499050556,-0.17425341425049792,-0.5689406820777768,3,3,1,3,1,1,5,3,0,6,2.1383604019972946,4,4,4,4,1,1,1,3.2857142857142856,0,2.7142857142857144,0.9547190977297628,0,3,3,3,3,3,1,5,1,1,5,5,5,1,5,5,3,3,1,1,4,3,0,3.8,0,3.8,0,4.4,0,4,0,2,1,1,4,4,1,2,1,4,1,1,1,1,2,4,1,1,1,1,4,2.2,0,Black or African American,0,29,0,1,NA,5,2,0,0,1,0,0,TRUE,TRUE,TRUE,TRUE,TRUE,0,6,0.8211657142864807,0.7142857142857143,0.07651404833346265,6,0.42269375000032594,0.48782580645166096,1,0.96875,0.004048174798430775,0.003991598991879243,6,0.7119624999994412,0.7818375000008382,1,1,0.016932219193666682,0.015945316612640682,1.4334,0.6881,0.3519,1.1095,0.9939,0.4909,0.0958,1.45620442,0.7746866639333333,0.346978677,1.2379,4.9322,0.2972,4.1499,0.3448,-83.2462,0.9339,5.1993,0.3335,6.2669,0.4128,0.9984,1.3091196556666667,4.177900486666666,4.97107807,0.3391267666666667,0.29243681633333335,1.1112,3.5218,0.5519,3.391,0.6187,0.9197,0.085,0.513,0.472,0.016,1.485,92.8125,452,1.3392592592592591,1,0,1,2,FALSE,FALSE,FALSE
559,2021-11-13T13:19:06Z,1,1.7777777777777777,864,4,3,2,4,3,4,2,1,4,2,2,2,2,4,2,4,3,2,2,1,1,1,1,1,1,0,2,0,0,4,4,5,4,3,5,4,5,5,2,4,2,1,4,2,5,2,2,2,2,3,5,1,1,1,3,2,1,1,1,1,4,1,1,1,2,1,2,2,2,2,1.25,0,2,0,2.2,0,1.6666666666666667,0,1.9166666666666667,0,1.3333333333333333,0,1,0,1.3333333333333333,0,1.5945945945945945,0,0,0,0,-0.8746295276057681,-0.6897116206118464,-0.4236359564090485,-0.5566737885104475,5,1,4,1,1,1,3,1.4285714285714286,0,1,-0.6467170085812028,4,4,4,4,3,3,3,3.5714285714285716,0,2.4285714285714284,-0.1748077221195339,0,2,4,3,2,3,2,5,2,2,4,3,4,2,3,4,1,3,2,3,2,2.8,0,3.6,0,4.2,0,3.8,0,3.8666666666666667,0,2,1,2,3,2,1,2,3,1,3,2,3,2,2,1,4,1,2,2,2,1.75,0,"White, Caucasian, Anglo, European American",0,21,0,1,NA,5,2,0,0,1,0,0,TRUE,TRUE,TRUE,TRUE,TRUE,0,2,0.8799583333200879,0.72,0.14146444222085017,2,0.5211718750037253,0.6205375000089407,1,1,0.005005209184304422,0.011835861776351085,2,0.5718249999955297,0.6960064516221324,1,0.96875,0.00436858838653403,0.01135866774196663,1.669,0.5961,0.3369,1.481,0.4647,0.4645,0.185,1.6405900833333333,0.6788163517333333,0.33785014133333335,1.3852,5.9702,0.4052,3.4257,0.4184,-78.5426,0.8435,5.0233,0.4307,3.8018,0.5098,0.8456,1.66628637,3.7380246566666666,5.763836443333333,0.397445082,0.3812566763333333,0.9127,6.0249,0.4957,2.8206,0.5706,0.988,0.164,0.326,0.655,0.014,1.687,120.5,104,0.3081481481481481,1,0,1,2,FALSE,FALSE,FALSE
560,2021-11-13T13:24:53Z,0.699999988079071,1.6,900,6,4,1,4,2,3,2,2,1,3,1,1,2,1,1,1,1,3,3,1,1,3,5,3,4,2,2,0,0,4,4,1,5,4,5,5,5,2,2,4,5,1,3,2,3,3,5,5,5,5,4,1,1,1,3,1,1,2,2,1,4,2,3,1,1,4,1,1,1,1,2.875,0,1,0,2.933333333333333,0,2.111111111111111,0,3.4166666666666665,0,1.3333333333333333,0,1.7142857142857142,0,2,0,2.3783783783783785,0,1,0,0,0.623654390146426,0.6606087716035466,-0.5341482934814965,0.06323023906102504,5,1,1,1,1,1,1,1.5714285714285714,0,1.5,-0.3767559860388676,5,5,5,5,1,4,1,4.285714285714286,0,1.7142857142857142,-0.7395711320441822,0,1,1,1,2,1,2,4,1,1,2,1,4,3,4,5,1,5,2,3,4,1.2,0,4.4,0,3.4,0,4.2,0,4,0,1,1,2,4,2,2,2,4,1,1,1,4,2,2,1,4,1,2,1,2,1.4,0,"White, Caucasian, Anglo, European American",0,23,0,1,NA,5,2,0,0,1,0,0,TRUE,TRUE,TRUE,TRUE,TRUE,0,5,0.87185,0.8163265306122449,0.048046950680275424,5,0.479709677419352,0.52309375,0.96875,1,0.005103338709677058,0.002525571572580675,5,0.6705937500000037,0.7121935483870968,1,1,0.005940119959677378,0.0032768946236564653,1.4329,1.1276,0.4707,1.3125,1.3818,0.5304,0.33,1.4516425533333333,1.05018277,0.46318875233333334,1.1155,4.1712,0.353,5.1023,0.4138,-89.4811,0.7931,3.6186,0.3808,6.9399,0.4663,0.9843,1.2745465956666666,5.02900991,4.417201286666667,0.4022133883333333,0.341641794,1.0177,3.9386,0.5522,6.4401,0.6328,0.9913,0.219,0.376,0.75,0.022,1.386,63,370,1.0962962962962963,1,0,0,1,FALSE,FALSE,FALSE
561,2021-11-13T13:34:29Z,1,1.7786458333333333,768,6,4,4,3,2,4,3,2,4,1,1,1,1,5,2,5,3,2,1,1,1,1,1,1,1,4,2,0,0,5,4,4,2,1,5,3,4,5,2,4,1,1,5,1,5,1,1,1,2,2,5,1,1,1,4,3,2,5,5,1,4,2,1,1,1,1,2,1,3,3,1.125,0,2.25,0,1.8,0,2.3333333333333335,0,1.3333333333333333,0,1.6666666666666667,0,2.4285714285714284,0,1,0,1.864864864864865,0,2,0,0,-0.7842701889475012,-0.799181362106765,0.06095019390122543,-0.3691155841027698,5,1,2,1,1,1,3,1.7142857142857142,0,1,-0.4757826382709144,3,5,5,5,1,2,4,3.2857142857142856,0,2.7142857142857144,-1.3043345419688306,0,1,1,2,2,2,2,4,1,1,1,1,5,1,4,5,1,5,1,4,1,1.6,0,4.8,0,3.8,0,4.8,0,4.466666666666667,0,1,1,1,4,1,1,1,3,1,1,1,4,1,1,1,4,1,1,1,1,1.05,0,"Hispanic of Latino (e.g., Mexican American, Central American, and others)",0,21,0,1,NA,5,2,0,0,1,0,0,TRUE,TRUE,TRUE,TRUE,TRUE,0,5,0.8798441176453934,0.68,0.0709745258118037,5,0.40597142856993845,0.48372083333320914,0.9032258064516129,0.75,0.0058583976126168474,0.008445787812231657,5,0.5562499999980132,0.6595888888896615,0.9375,0.84375,0.02134461350833954,0.025871508780151337,1.5553,0.5211,0.3764,0.8644,0.8384,0.741,0.3444,1.5521647933333333,0.6377164763,0.3736386326666667,0.9356,2.7004,0.263,1.3137,0.2786,-38.059,0.7064,3.9661,0.323,2.3517,0.3551,0.9151,0.9879239006666667,1.651979264,3.0549919033333333,0.2758021726666667,0.25996291433333335,0.8198,3.4346,0.4372,2.8973,0.5245,0.9907,0.062,0.33,0.287,0.01,1.812,181.2,370,1.0962962962962963,1,0,0,1,FALSE,FALSE,FALSE
562,2021-11-13T13:47:23Z,0.8999999761581421,1.7777777777777777,1080,1,3,4,4,2,4,1,2,5,2,1,1,1,4,3,4,1,2,1,1,1,2,1,3,1,1,2,0,1,4,3,3,3,2,5,5,4,4,1,5,1,1,2,1,1,1,1,1,1,1,5,1,1,1,3,2,1,2,1,1,5,1,1,1,1,1,2,1,2,2,1.5,0,1.75,0,1.9333333333333333,0,2.3333333333333335,0,1.5833333333333333,0,1.3333333333333333,0,1,0,1,0,1.6216216216216217,0,1,0,1,-0.7023163701644217,-0.6852592703830522,-0.12249503843059244,-0.4038771544068223,2,2,1,2,1,2,1,2.4285714285714284,0,3,0.6895286370535711,3,3,4,4,1,1,3,2.7142857142857144,0,3.2857142857142856,2.0842459175790595,0,1,2,2,1,1,3,4,1,1,2,1,4,1,4,2,3,3,2,3,4,1.4,0,3.8,0,3.4,0,3.6,0,3.6,0,1,1,1,3,1,1,2,3,1,1,2,4,1,1,1,3,1,1,1,1,1.25,0,"White, Caucasian, Anglo, European American",0,21,0,1,NA,5,2,0,0,1,0,0,TRUE,TRUE,TRUE,TRUE,TRUE,0,2,0.8421472222222688,0.72,0.11268741092242825,2,0.48650322580634947,0.5712612903226587,0.96875,1,0.005167779425388478,0.0091632744516272,2,0.5863437500001164,0.6916999999998661,1,1,0.010310910282267634,0.01784381032257291,1.4503,0.6852,0.4109,1.127,0.5956,0.543,0.2645,1.4725062233333333,0.758197676,0.40475211133333333,1.6139,3.8358,0.287,3.9939,0.3692,-58.435,0.9364,4.8581,0.3981,3.8261,0.4581,0.6766,1.6592766633333333,3.974118,3.96447807,0.36312112933333335,0.2846218443333333,1.1246,3.6493,0.4503,4.0065,0.5369,0.9624,0.431,0.025,0.773,0.012,1.449,120.75,278,0.8237037037037037,1,0,3,4,FALSE,FALSE,FALSE
563,2021-11-13T13:51:07Z,1,1.7786458333333333,768,6,1,2,4,1,4,3,4,3,3,2,2,2,4,1,4,3,1,3,1,1,1,1,1,1,0,2,0,1,4,3,5,3,3,5,3,3,5,4,5,2,1,4,2,5,3,1,1,2,3,5,1,1,1,1,1,1,1,1,1,4,1,3,1,2,1,3,1,1,1,1.25,0,1.5,0,2.4,0,2.2222222222222223,0,1.9166666666666667,0,0.8333333333333334,0,1.2857142857142858,0,1.3333333333333333,0,1.7027027027027026,0,0,0,1,-0.8073853686042672,-0.5573025964164013,-0.40398871494434996,-0.48064565568037565,4,2,2,2,1,2,2,2.142857142857143,0,5.5,1.4410634536792382,4,4,4,4,2,2,3,3.2857142857142856,0,2.7142857142857144,0.38995568780511447,0,2,3,3,1,2,3,3,2,2,3,3,3,2,4,3,2,4,2,3,4,2.2,0,3.4,0,3.4,0,3.4,0,3.4,0,2,1,1,3,2,2,2,4,2,1,2,4,2,2,1,3,1,1,1,2,1.55,0,"White, Caucasian, Anglo, European American",0,24,0,1,NA,5,2,0,0,0,0,0,TRUE,TRUE,TRUE,TRUE,TRUE,0,NA,NA,NA,NA,1,0.4738718750178814,0.4987218749821186,1,1,0.0023315995095441813,0.0027306217627982555,1,0.6317312500327825,0.7131482758522034,1,0.90625,0.010625648013318317,0.013268004652575063,NA,NA,NA,NA,NA,NA,NA,NA,NA,NA,10,12.4333,0.0717,12.083,0.0849,-99.7877,0.5259,5.2912,0.4379,7.0734,0.4685,0.9505,1.91499985,5.70123639,5.396553553333334,0.3381511913333333,0.29984627166666666,0.9078,4.1243,0.5379,2.3296,0.5704,0.8981,0.07,0.438,0.365,0.016,1.769,110.56249999999999,336,0.9955555555555555,1,0,0,1,FALSE,FALSE,FALSE
564,2021-11-13T13:40:36Z,0.8999999761581421,1.7777777777777777,1080,6,3,5,5,2,5,1,1,5,1,1,1,1,5,2,5,3,1,1,1,1,1,1,1,1,1,2,0,0,5,4,4,5,4,5,5,5,5,1,5,1,1,5,1,5,1,1,1,1,2,5,1,1,1,2,2,1,2,2,1,5,1,1,1,1,1,2,1,1,2,1,0,1.5,0,1.2666666666666666,0,1.3333333333333333,0,1.0833333333333333,0,1.1666666666666667,0,1.1428571428571428,0,1,0,1.2162162162162162,0,1,0,0,-1.2654862018019926,-1.3608550224913916,-0.3773458880470143,-0.869100455269203,5,1,4,1,1,1,1,1.1428571428571428,0,1,-0.8176513788914915,4,3,5,5,2,3,2,3.7142857142857144,0,2.2857142857142856,-0.4571894270818581,0,1,2,2,2,2,2,4,3,1,4,1,5,2,5,5,1,5,1,4,2,1.8,0,4.8,0,4.2,0,4.4,0,4.466666666666667,0,1,1,1,4,1,1,1,4,1,1,1,4,1,1,1,4,1,1,1,1,1,0,"White, Caucasian, Anglo, European American",0,30,0,1,NA,5,2,0,0,1,0,0,TRUE,TRUE,TRUE,TRUE,TRUE,0,1,0.895434883720653,0.86,0.022624625698157708,1,0.4915937500055879,0.5697741935483871,1,0.96875,0.0021118980241960432,0.00241716160265523,1,0.6402906250040978,0.6464468750003726,1,1,0.006727498941655854,0.005067250313043982,1.2188,1.5692,0.6312,0.7093,2.1376,0.7969,0.3375,1.2692433843333333,1.290082319,0.6190592873333334,1.0185,7.0587,0.4195,3.9915,0.4473,-105.3445,0.6458,6.0456,0.4359,6.1639,0.5211,0.952,1.165729753,4.151551253333333,6.392375113333333,0.437341682,0.40632564633333335,0.8945,4.2133,0.5414,4.876,0.5562,0.8836,0.291,0.275,0.795,0.246,1.088,4.4227642276422765,354,1.0488888888888888,1,0,0,1,FALSE,FALSE,FALSE
