id,meta_start,meta_end,meta_duration,meta_finished,meta_recorded,meta_captcha,meta_browser,meta_version,meta_operating system,meta_resolution_width,meta_resolution_height,meta_feedback,meta_resolution_ratio,meta_task_duration,meta_state_duration,meta_ace_duration,meta_temp_orient_duration,meta_psychopath_duration,meta_dems_duration,meta_task_duration_z,meta_state_duration_z,meta_ace_duration_z,meta_temp_orient_duration_z,meta_psychopath_duration_z,meta_dems_duration_z,stai_s01,stai_s02,stai_s03,stai_s04,stai_s05,stai_s06,stai_s07,stai_s08,stai_s09,stai_s10,stai_s11,stai_s12,stai_s13,stai_s14,stai_s15,stai_s16,stai_s17,stai_s18,stai_s19,stai_s20,sd_stai,sick,meal,hungry,sleep,rested,stai_s_mean,stai_s_missing,chaos01,chaos02,chaos03,chaos04,chaos05,chaos06,chaos07,chaos08,chaos09,chaos10,chaos11,chaos12,chaos13,chaos14,chaos15,unp01,unp02,unp03,unp04,unp05,unp06,unp07,unp08,unp_moving,unp_other_adults,unp_female_fig_num,unp_female_fig_rom,unp_male_fig_num,unp_male_fig_rom,quic01,quic02,quic03,quic04,quic05,quic06,quic07,quic08,quic09,quic10,quic11,quic12,quic13,quic14,quic15,quic16,quic17,quic18,quic19,quic20,quic21,quic22,quic23,quic24,quic25,quic26,quic27,quic28,quic29,quic30,quic31,quic32,quic33,quic34,quic35,quic36,quic37,change_env01,change_env02,change_env03,change_env04,sd_quic,sd_chaos,pcunp_mean,pcunp_missing,change_env_mean,change_env_missing,chaos_mean,chaos_missing,quic_monitoring_mean,quic_monitoring_missing,quic_par_predict_mean,quic_par_predict_missing,quic_par_env_mean,quic_par_env_missing,quic_phys_env_mean,quic_phys_env_missing,quic_safety_mean,quic_safety_missing,quic_total_mean,quic_total_missing,unp_moving_binned,unp_male_fig_rom_binned,unp_female_fig_rom_binned,unp_subj_comp,unp_obj_comp,unp_comp,violence01,violence02,violence03,violence04,violence05,violence06,violence07,aces_fighting1,aces_fighting2,sd_violence,nvs_mean,nvs_missing,fighting_mean,vio_comp,ses01,ses02,ses03,ses04,ses05,ses06,ses07,dems_edu_first,dems_edu_second,dems_income_past,dems_class_past,sd_ses,edu_caregivers,ses_subj_comp,ses_subj_missing,ses_obj_comp,ses_obj_missing,ses_comp,impuls01,impuls02,impuls03,impuls04,impuls05,fos01,fos02,fos03,fos04,fos05,fos06,fos07,fos08,fos09,fos10,fos11,fos12,fos13,fos14,fos15,sd_fos,impuls_mean,impuls_missing.x,fos_pa_mean,fos_pa_missing,fos_tp_mean,fos_tp_missing,fos_fc_mean,fos_fc_missing,fos_fo_mean,fos_fo_missing,depression01.x,depression02.x,depression03.x,depression04.x,depression05.x,depression06.x,depression07.x,depression08.x,depression09.x,depression10.x,depression11.x,depression12.x,depression13.x,depression14.x,depression15.x,depression16.x,depression17.x,depression18.x,depression19.x,depression20.x,sd_depression.x,depression_mean.x,impuls_missing.y,depression01.y,depression02.y,depression03.y,depression04.y,depression05.y,depression06.y,depression07.y,depression08.y,depression09.y,depression10.y,depression11.y,depression12.y,depression13.y,depression14.y,depression15.y,depression16.y,depression17.y,depression18.y,depression19.y,depression20.y,sd_depression.y,depression_mean.y,impuls_missing,family_composition.x,fam_composition_multiple.x,dems_ethnicity,dems_ethnicity_mixed,dems_age,dems_sex,dems_gender,dems_gender_4_text,dems_born_us,dems_class_current,dems_edu,dems_occupation,dems_income,weight,height,activity,att_check01,att_check02,att_getup,att_interrupted,att_noise,attention_check_sum,attention_interrupt_sum,family_composition.y,fam_composition_multiple.y,ex_narb_NA_selfreport_pass,ex_narb_attention_checks_pass,ex_narb_suspect_responses_pass,ex_narb_resolution_ratio,ex_narb_resolution_height,counterbalance,rt_flanker_congruent_degraded,rt_flanker_congruent_enhanced,rt_flanker_congruent_standard,rt_flanker_incongruent_degraded,rt_flanker_incongruent_enhanced,rt_flanker_incongruent_standard,acc_flanker_congruent_degraded,acc_flanker_congruent_enhanced,acc_flanker_congruent_standard,acc_flanker_incongruent_degraded,acc_flanker_incongruent_enhanced,acc_flanker_incongruent_standard,start_a_flanker_std,start_t0_flanker_std,start_p_flanker_std,start_rd_flanker_std,start_sda_flanker_std,start_g2_flanker_std,start_bbic_flanker_std,a_flanker_std,t0_flanker_std,p_flanker_std,rd_flanker_std,sda_flanker_std,g2_flanker_std,bbic_flanker_std,final_width_px,scale_factor,no_resize,fullscreenenter,fullscreenexit,blur_event,focus_event,event_during_flanker
2,2022-03-18T14:13:15Z,2022-03-18T14:35:34Z,1339,1,2022-03-18T14:35:36Z,0.8999999761581421,Chrome,99.0.4844.51,Macintosh,1280,800,n/a,1.6,565,90,350,88,64,76,-0.23221707766877098,-0.15448135074188163,-0.22369843296398037,-0.12572661993958972,0.062217997952245516,-0.2521103918255647,1,2,1,1,1,1,1,3,1,2,2,1,1,1,1,2,1,1,2,2,1.2096106376585989,0,1,1,4,4,1.4,0,2,2,1,1,2,1,1,2,2,2,1,1,1,1,2,1,2,1,1,1,2,1,1,1,2,0,0,0,0,1,1,1,1,1,1,1,1,1,1,1,1,1,2,2,1,2,1,2,3,2,1,1,1,1,1,1,1,3,3,1,1,1,2,1,1,1,1,1,2,2,1.7971448827876204,1.6676187756655838,1.25,0,1.5,0,1.4666666666666666,0,1,0,1.5833333333333333,0,1,0,1.7142857142857142,0,1,0,1.3243243243243243,0,1,0,0,-1.1394251066627157,-0.22899200544817064,-0.6842085560554432,1,2,4,1,2,2,1,1,1,1.3451854182690985,1.8571428571428572,0,1,-0.4626854203256071,3,4,5,2,2,2,4,4,3,2,2,1.2149857925879117,3.5,3.142857142857143,0,-0.7874704359888487,0,-0.6419731697625203,2,2,3,2,2,4,4,4,4,4,4,4,4,3,4,4,4,4,4,2,1,2.2,0,4,0,4,0,3.4,0,3.8,0,2,1,1,2,1,1,1,2,1,1,1,1,2,2,1,2,1,2,1,1,0.9333020044867296,1.35,0,2,1,1,2,1,1,1,2,1,1,1,1,2,2,1,2,1,2,1,1,0.9333020044867296,1.35,0,I lived with my mother and father an equal amount of time (joint custody),0,"Asian or Asian American (e.g., Chinese, Japanese, and others)",0,25,1,2,NA,1,2,6,student,7,130,66,2,5,2,0,0,0,0,0,I lived with my mother and father an equal amount of time (joint custody),0,TRUE,TRUE,TRUE,TRUE,TRUE,6,0.5931500000040978,0.5087437500059605,0.5271062499973923,0.6241387096778039,0.5755374999996274,0.594265625,1,1,1,0.96875,1,1,0.112,0.398,0.908,0.013,1.305,46.8254725755632,1840.6884171002605,0.114,0.397,0.908,0.013,1.342,64.87877379183134,1849.2253660241956,386,1.1437037037037037,0,3,0,0,3,FALSE
3,2022-03-18T14:47:17Z,2022-03-18T15:05:21Z,1083,1,2022-03-18T15:05:23Z,0.699999988079071,Chrome,99.0.4844.51,Windows NT 10.0,1280,720,NA,1.7777777777777777,485,47,217,192,21,61,-0.3964147472957862,-0.39150469969310997,-0.7062185499392825,1.1547741100052586,-0.8183457176704515,-0.4206000101248282,2,2,3,2,2,1,2,3,1,3,3,1,1,1,3,3,2,1,2,3,0.7591546545162482,0,0,2,4,4,2.05,0,5,2,3,2,3,3,3,3,3,3,4,4,3,4,3,3,5,1,1,2,4,3,3,1,1,0,0,2,0,3,3,3,3,2,2,2,2,2,2,2,3,2,4,2,3,3,3,4,3,4,3,1,1,1,2,1,1,2,2,2,2,3,2,2,4,2,2,1,2,2,1.0237421785039669,0.7988086367179802,2.75,0,1.75,0,3.2,0,2.4444444444444446,0,2.9166666666666665,0,1.5,0,2,0,2.6666666666666665,0,2.3783783783783785,0,1,0,0,0.7341806043695177,-0.14280879051279902,0.29568590692835933,3,3,3,2,2,3,3,2,1,0.4879500364742666,2.7142857142857144,0,1.5,0.22777744339554973,4,3,4,4,2,2,3,6,8,4,3,0.8997354108424374,7,3.142857142857143,0,0.6173603799487777,0,0.21434474120802502,2,2,2,2,2,4,3,4,5,3,5,5,3,5,5,4,5,4,4,4,1.4638501094227998,2,0,4.6,0,3.4,0,4.6,0,4.2,0,2,2,2,2,2,2,2,2,1,1,2,2,1,1,1,2,2,2,1,2,0.7181848464596079,1.7,0,2,2,2,2,2,2,2,2,1,1,2,2,1,1,1,2,2,2,1,2,0.7181848464596079,1.7,0,I lived with my mother and father an equal amount of time (joint custody),0,"White, Caucasian, Anglo, European American",0,22,3,3,NA,1,2,6,freelancer,1,160,68,3,5,2,0,0,1,0,0,I lived with my mother and father an equal amount of time (joint custody),0,TRUE,TRUE,TRUE,TRUE,TRUE,2,0.6485125000000408,0.6517281249999068,0.6326750000000465,0.6969093750001047,0.7547968749999417,0.7537258064517031,1,1,1,1,1,0.96875,0.105,0.392,0.421,0.007,1.312,91.591595969057,1942.8046104862487,0.107,0.392,0.475,0.007,1.341,99.216300561566,1925.4551202257956,304,0.9007407407407407,1,3,0,0,3,FALSE
4,2022-03-18T14:49:21Z,2022-03-18T15:07:49Z,1107,1,2022-03-18T15:07:50Z,0.8999999761581421,Chrome,99.0.4844.51,Windows NT 10.0,1440,900,"Thank you! I had a second screen connected, but I covered it as instructed.",1.6,511,76,290,60,31,70,-0.34305050466700626,-0.2316517434236769,-0.44137668122351514,-0.4704768164632027,-0.6135634582233127,-0.3195062391452701,1,2,1,1,2,1,1,2,1,2,2,1,2,1,2,1,1,1,3,2,1.1192102478745307,0,1,1,4,3,1.5,0,3,2,1,2,1,2,2,3,1,2,2,3,2,3,4,2,5,5,1,3,4,3,4,4,2,0,0,0,0,2,4,2,4,4,2,2,2,4,1,1,4,1,3,1,1,2,2,4,4,4,5,1,3,2,3,2,1,4,2,1,2,1,2,1,1,3,2,2,2,2,1.322024110123468,1.0600988273786194,3.375,0,2,0,2.2,0,2.888888888888889,0,2.3333333333333335,0,2.6666666666666665,0,1.8571428571428572,0,1.6666666666666667,0,2.3783783783783785,0,2,0,0,0.5703040804743366,0.16253517528056266,0.36641962787744964,1,1,2,2,1,1,2,3,1,1.6035674514745464,1.4285714285714286,0,2,-0.324785349076635,5,5,5,4,2,2,5,6,6,4,3,1.7182493859684491,6,4,0,0.4366725657692403,0,0.5687662519876588,2,2,2,2,2,4,4,3,4,4,5,4,5,4,3,4,5,4,3,2,1.2227992865708155,2,0,4.4,0,4,0,3.2,0,3.8666666666666667,0,1,1,1,1,3,1,1,2,1,1,2,2,1,1,1,2,1,1,1,2,0.9880869341680844,1.35,0,1,1,1,1,3,1,1,2,1,1,2,2,1,1,1,2,1,1,1,2,0.9880869341680844,1.35,0,I lived with my mother and father an equal amount of time (joint custody),0,"White, Caucasian, Anglo, European American",0,24,1,2,NA,1,3,6,Marketing Specialist,4,165,65,2,5,2,0,0,0,0,0,I lived with my mother and father an equal amount of time (joint custody),0,TRUE,TRUE,TRUE,TRUE,TRUE,3,0.481296875,0.42500312500447035,0.47699999999813736,0.5611500000022351,0.49853125000558796,0.5407687499988824,1,1,1,1,1,1,0.13,0.315,0.781,0.025,1.528,14.779769599366114,1809.5728751921865,0.124,0.32,0.784,0.025,1.635,22.80645140136867,1809.3047992815261,304,0.9007407407407407,1,3,0,0,3,FALSE
5,2022-03-18T15:09:17Z,2022-03-18T15:31:02Z,1304,1,2022-03-18T15:31:04Z,1,Safari,15.1,Macintosh,1440,900,N/A,1.6,526,150,330,79,52,86,-0.31226344161194086,0.17624890360866954,-0.29625784905049196,-0.2365391831078939,-0.1835207133843211,-0.13978397962605565,2,2,2,2,2,1,1,2,1,2,2,2,2,1,2,2,2,1,2,2,0.8506963092234007,0,1,3,3,2,1.75,0,4,2,3,1,2,2,3,2,1,1,4,3,3,3,3,3,3,1,1,3,3,2,1,2,1,0,0,1,0,2,4,3,2,3,3,2,2,2,3,2,2,2,2,3,1,4,2,2,3,3,2,1,1,1,4,2,1,2,2,1,2,3,1,1,2,1,2,2,2,2,1.2030991012578505,1.0997835284835873,2.125,0,2,0,2.466666666666667,0,2.5555555555555554,0,2.4166666666666665,0,1.8333333333333333,0,1.7142857142857142,0,1.3333333333333333,0,2.135135135135135,0,1,0,0,0.034285132046014494,-0.05662557557742737,-0.011170221765706437,2,1,4,1,1,2,3,3,3,1.1547005383792515,2,0,3,0.3931933617292298,3,3,4,4,1,1,1,7,5,3,2,1.5275252316519468,6,2.4285714285714284,0,-0.12167321001615315,0,-0.6232684050429772,2,3,2,4,3,4,5,4,4,3,5,4,2,5,3,4,4,4,3,5,1.3020130933435712,2.8,0,4.2,0,3.4,0,4.2,0,3.933333333333333,0,2,1,2,1,3,2,4,1,1,1,3,2,2,1,1,2,1,2,1,2,1.0894228312566052,1.75,0,2,1,2,1,3,2,4,1,1,1,3,2,2,1,1,2,1,2,1,2,1.0894228312566052,1.75,0,I lived with my mother and father an equal amount of time (joint custody),0,"White, Caucasian, Anglo, European American",0,28,1,2,NA,1,4,7,Board Certified Behavior Analyst,4,171,62,2,5,2,0,0,2,0,0,I lived with my mother and father an equal amount of time (joint custody),0,TRUE,TRUE,TRUE,TRUE,TRUE,2,0.6360624999999945,0.4947499999999982,0.5082499999999973,0.661709677419352,0.5878387096774175,0.5847333333333338,1,1,1,1,0.96875,0.9375,0.055,0.376,0.406,0.007,1.085,96.1152618103163,1971.3597729647486,0.056,0.37,0.427,0.007,1.114,111.55544848076272,1979.0028101547368,436,1.2918518518518518,0,3,0,0,3,FALSE
6,2022-03-18T15:15:28Z,2022-03-18T15:36:53Z,1285,1,2022-03-18T15:36:54Z,0.8999999761581421,Chrome,99.0.4844.74,Windows NT 10.0,1920,1080,No,1.7777777777777777,518,76,331,126,41,79,-0.3286832085746424,-0.2316517434236769,-0.2926298782461664,0.3421486467710279,-0.40878119877617386,-0.218412468165712,1,1,2,1,1,1,2,2,1,1,3,2,2,2,1,2,2,1,2,3,1.0990426455975697,1,1,2,3,4,1.65,0,4,3,5,3,5,5,4,4,5,3,5,5,2,4,4,3,5,2,3,4,3,4,3,4,1,4,0,4,0,3,5,4,4,4,4,4,3,4,4,4,4,1,4,3,2,4,5,5,4,4,4,3,1,1,4,3,4,4,1,1,4,3,3,4,5,5,3,2,3,4,1.2863338037440573,1.4375905768565218,3.375,0,3,0,4.066666666666666,0,3.888888888888889,0,3.6666666666666665,0,2.6666666666666665,0,2.857142857142857,0,4.666666666666667,0,3.4864864864864864,0,2,0,0,1.8702927457040979,0.5072680350220491,1.1887803903630734,3,3,3,2,1,3,2,3,3,0.7867957924694432,2.4285714285714284,0,3,0.641798492967898,3,3,3,2,1,1,1,4,7,3,2,1.3972762620115438,5.5,2,0,-0.21201711710592183,0,-0.9106178403511915,2,3,2,3,2,4,5,4,5,3,5,4,3,4,5,5,5,4,4,5,1.5522640914238175,2.4,0,4.4,0,4,0,4.6,0,4.333333333333333,0,1,3,1,2,2,1,3,1,1,1,3,2,1,1,1,2,2,2,1,2,0.998683343734455,1.65,0,1,3,1,2,2,1,3,1,1,1,3,2,1,1,1,2,2,2,1,2,0.998683343734455,1.65,0,I lived with my mother and father an equal amount of time (joint custody),0,"White, Caucasian, Anglo, European American",0,29,1,2,NA,1,4,6,Human Resources Client Services,6,221,66,3,5,2,0,0,0,0,0,I lived with my mother and father an equal amount of time (joint custody),0,TRUE,TRUE,TRUE,TRUE,TRUE,2,0.5484749999940395,0.4858451612880153,0.4961451612864771,0.6250900000135103,0.5335444444373801,0.5646548387081393,1,1,0.96875,0.967741935483871,0.8709677419354839,0.96875,0.067,0.378,0.556,0.021,1.83,233.8987856396531,2174.4542435158046,0.073,0.367,0.653,0.02,1.861,265.4918051425363,2134.6472010938955,376,1.114074074074074,0,3,0,0,3,FALSE
7,2022-03-18T15:18:14Z,2022-03-18T15:37:26Z,1151,1,2022-03-18T15:37:28Z,0.8999999761581421,Safari,15.2,Macintosh,1440,900,NA,1.6,492,90,333,74,54,66,-0.3820474512034223,-0.15448135074188163,-0.2853739366375152,-0.29810171820139625,-0.14256426149489335,-0.3644368040250737,3,2,1,1,1,1,2,2,1,1,2,1,2,2,2,2,1,2,2,1,1.0809352675491624,0,0,2,4,4,1.6,0,3,1,2,2,1,2,3,4,2,2,1,3,1,3,4,4,2,5,3,2,2,4,3,7,1,0,0,3,3,2,3,3,2,3,3,4,4,3,3,3,1,1,2,2,4,1,2,3,2,3,5,5,4,1,2,1,1,5,5,1,2,2,2,1,1,1,2,4,4,3,1.28224184307959,1.1872336794093274,3.125,0,3.25,0,2.2666666666666666,0,3,0,2.25,0,3,0,2.5714285714285716,0,1,0,2.5135135135135136,0,4,3,0,0.549241271997719,3.1262522489848763,1.8377467604912976,2,2,4,1,1,1,1,2,1,1.1126972805283737,1.7142857142857142,0,1.5,-0.3523011961613431,3,3,5,5,1,2,4,6,9,2,3,1.5275252316519468,7.5,3.2857142857142856,0,0.27954890599084203,0,0.08585766527307817,3,4,4,5,4,3,5,3,3,2,2,4,3,4,3,5,4,3,4,3,0.9611501047232549,4,0,3.2,0,3.8,0,3.2,0,3.4,0,3,3,2,2,2,2,1,2,1,2,2,2,2,2,1,2,1,2,1,2,0.7591546545162482,1.85,0,3,3,2,2,2,2,1,2,1,2,2,2,2,2,1,2,1,2,1,2,0.7591546545162482,1.85,0,"I lived with my mother, but not father, most of the time.",0,"White, Caucasian, Anglo, European American",0,23,1,2,NA,1,4,6,nanny and student,1,132,68,3,5,2,0,0,1,0,0,"I lived with my mother, but not father, most of the time.",0,TRUE,TRUE,TRUE,TRUE,TRUE,3,0.5747187500000036,0.5874062500000014,0.5431562499999909,0.6297741935483908,0.6645937499999987,0.6674374999999946,1,1,1,1,1,1,0.145,0.326,0.67,0.012,1.739,46.1437247961917,1846.8184626677241,0.155,0.324,0.735,0.012,1.783,60.047389637808536,1846.9884724894312,364,1.0785185185185184,0,3,0,0,3,FALSE
8,2022-03-18T15:18:18Z,2022-03-18T15:38:55Z,1236,1,2022-03-18T15:38:56Z,0.8999999761581421,Chrome,99.0.4844.51,Macintosh,1680,1050,NA,1.6,502,67,282,59,193,66,-0.36152274250004546,-0.28126128157625957,-0.4704004476581198,-0.4827893234819032,2.7039091448203365,-0.3644368040250737,2,3,3,3,3,1,1,2,1,2,2,1,1,1,3,3,1,1,4,3,0.8750939799154206,0,1,1,3,2,2.05,0,2,2,3,2,2,2,2,3,2,1,1,2,4,2,1,2,1,1,1,1,1,3,1,1,1,2,0,1,0,1,2,3,2,3,1,2,1,3,2,3,2,1,2,2,2,2,1,1,1,1,2,1,1,1,3,2,1,2,2,1,2,3,2,1,1,1,2,1,1,2,1.365050681609794,1.245945806357946,1.375,0,1.5,0,2.066666666666667,0,2,0,1.6666666666666667,0,1.6666666666666667,0,1.8571428571428572,0,1,0,1.7297297297297298,0,1,0,0,-0.6454333508489534,-0.22899200544817064,-0.437212678148562,3,3,3,3,2,4,3,2,1,0.5773502691896257,3,0,1.5,0.39351419755466194,4,4,4,4,2,2,3,6,6,NA,3,0.9511897312113419,6,3.2857142857142856,0,0.41251961278270693,1,0.16691027073168607,3,3,4,3,4,3,4,3,4,2,4,3,3,4,3,2,4,3,4,3,0.7432233529572065,3.4,0,3.4,0,3,0,3.4,0,3.2666666666666666,0,2,1,1,2,3,1,3,2,1,1,4,2,1,2,2,2,1,1,1,3,1.025978352085154,1.8,0,2,1,1,2,3,1,3,2,1,1,4,2,1,2,2,2,1,1,1,3,1.025978352085154,1.8,0,I lived with my mother and father an equal amount of time (joint custody),0,"White, Caucasian, Anglo, European American",0,27,1,2,NA,1,2,7,Executive Coordinator,3,190,70,2,5,2,0,0,0,0,0,I lived with my mother and father an equal amount of time (joint custody),0,TRUE,TRUE,TRUE,TRUE,TRUE,3,0.44164666666785873,0.42568437499925493,0.4837437500003725,0.5775045454475013,0.5394766666710377,0.5831062499955296,0.967741935483871,1,1,0.6875,0.9375,1,0.113,0.308,0.584,0.017,1.564,301.1758915229817,2136.1530793008324,0.114,0.303,0.637,0.014,1.675,328.57616834377734,2118.332909825689,317,0.9392592592592592,0,3,0,3,6,FALSE
10,2022-03-18T15:41:04Z,2022-03-18T15:58:45Z,1061,1,2022-03-18T15:58:46Z,0.8999999761581421,Chrome,99.0.4844.74,Windows NT 10.0,1536,864,no,1.7777777777777777,491,61,258,73,32,61,-0.38409992207376004,-0.3143343070113147,-0.5574717469619337,-0.3104142252200967,-0.5930852322785988,-0.4206000101248282,1,2,1,1,1,1,1,2,1,1,2,1,1,1,1,1,1,1,2,1,1.3803127029389886,0,1,1,3,3,1.2,0,1,1,1,1,2,1,2,1,1,2,1,1,1,1,1,1,1,1,1,1,1,1,1,0,2,0,0,0,0,1,3,1,1,1,1,1,1,1,1,1,1,1,1,1,1,2,1,2,1,2,1,1,1,1,1,1,1,1,1,1,1,1,2,1,1,1,1,1,1,1,1.8639942259766993,1.9073791542572855,1,0,1,0,1.2,0,1.2222222222222223,0,1.25,0,1,0,1.1428571428571428,0,1,0,1.162162162162162,0,0,0,0,-1.4360760634315304,-0.6205191861769039,-1.028297624804217,1,1,3,1,1,1,1,1,1,1.5735915849388864,1.2857142857142858,0,1,-0.7941589286438315,5,5,5,5,3,1,4,4,3,3,3,1.7043362064926932,3.5,4,0,-0.22912466020345523,0,0.16292799501975622,3,3,4,2,3,3,4,4,3,3,3,3,4,4,3,4,3,3,4,4,0.7037315505489968,3,0,3,0,3.8,0,3.6,0,3.466666666666667,0,1,1,1,1,1,1,1,1,1,1,1,1,1,1,1,1,1,1,1,2,1.2258187382102494,1.05,0,1,1,1,1,1,1,1,1,1,1,1,1,1,1,1,1,1,1,1,2,1.2258187382102494,1.05,0,I lived with my mother and father an equal amount of time (joint custody),0,"White, Caucasian, Anglo, European American",0,30,1,2,NA,1,3,5,lab tech,4,160,66,3,5,2,0,0,1,0,0,I lived with my mother and father an equal amount of time (joint custody),0,TRUE,TRUE,TRUE,TRUE,TRUE,1,0.5668406250011175,0.45964516128263166,0.4683437499906868,0.6254571428554399,0.5182931034482758,0.5186933333317438,1,0.96875,1,0.9032258064516129,0.90625,0.9375,0.042,0.397,0.539,0.05,1.881,133.50624039602903,2028.9041100001837,0.042,0.397,0.537,0.042,2.032,166.29725251574453,2021.0255605192262,298,0.882962962962963,0,3,0,3,6,FALSE
12,2022-03-18T15:31:48Z,2022-03-18T16:00:40Z,1731,1,2022-03-18T16:00:42Z,1,Chrome,97.0.4692.71,Macintosh,1440,900,NA,1.6,575,112,622,98,97,154,-0.2116923689653941,-0.03321359081334619,0.7631096258125772,-0.002601549752585081,0.7379994541278038,0.6240356233306057,3,1,2,1,2,1,1,3,1,2,2,1,1,2,3,3,1,1,2,3,0.9119095061289915,0,1,1,4,4,1.8,0,3,2,2,3,2,3,4,3,3,3,4,4,2,4,3,3,4,1,3,3,3,3,3,7,1,1,0,1,1,1,2,3,3,4,1,1,1,1,3,1,2,1,3,2,1,4,3,2,4,4,3,1,1,1,2,5,2,5,1,1,3,4,2,3,5,2,4,3,4,1,1.456063226690421,0.7037315505489968,2.875,0,3,0,3,0,1.8888888888888888,0,2.5,0,2.1666666666666665,0,2.5714285714285716,0,3.3333333333333335,0,2.3783783783783785,0,4,1,0,0.7014052995904816,1.6437493691751877,1.1725773343828347,2,2,4,2,2,3,2,4,1,0.7867957924694432,2.4285714285714284,0,2.5,0.44854589172407777,2,2,3,3,1,1,1,4,3,1,1,1.3972762620115438,3.5,1.8571428571428572,0,-1.345816211774242,0,-1.6791544298938124,2,2,3,3,3,4,5,4,4,2,3,4,3,4,4,3,2,4,3,4,0.990430401872025,2.6,0,3.4,0,3.2,0,4,0,3.533333333333333,0,2,3,1,2,3,1,3,1,2,3,1,1,1,1,1,1,2,2,1,1,1.1367080817685316,1.65,0,2,3,1,2,3,1,3,1,2,3,1,1,1,1,1,1,2,2,1,1,1.1367080817685316,1.65,0,"I lived with my mother, but not father, most of the time.",0,Black or African American & Middle Eastern,1,23,1,2,NA,1,4,6,unemployed currently,4,103,64,3,5,2,0,0,0,0,0,"I lived with my mother, but not father, most of the time.",0,TRUE,TRUE,TRUE,TRUE,TRUE,3,0.5117937500011176,0.48012812500074503,0.49297741935522327,0.5902406250145287,0.541568750007078,0.5502874999959022,1,1,0.96875,1,1,1,0.058,0.382,0.542,0.018,1.414,77.47257521122464,1927.1380076153625,0.059,0.382,0.524,0.02,1.475,112.65284146034622,1941.073989023762,436,1.2918518518518518,0,3,0,3,6,FALSE
13,2022-03-18T15:36:57Z,2022-03-18T16:05:06Z,1688,1,2022-03-18T16:05:08Z,0.8999999761581421,Chrome,99.0.4844.51,Windows NT 6.1,1280,800,NA,1.6,905,118,380,78,72,79,0.4656230182460435,-1.4056537829107522e-4,-0.11485930883421297,-0.24885169012659436,0.2260438055099566,-0.218412468165712,3,3,3,3,3,1,3,3,1,3,4,3,3,1,3,3,2,1,3,2,0.7591546545162482,0,1,1,1,1,2.55,0,4,3,3,4,3,4,4,5,4,3,5,4,3,4,4,5,5,3,2,4,5,5,5,0,1,1,0,0,0,3,4,2,3,3,2,2,3,3,3,3,4,3,3,3,2,4,5,5,5,5,5,3,4,1,3,1,2,1,2,1,4,4,4,1,1,5,1,4,2,2,1.301419876017611,1.0690449676496976,4.25,0,2.25,0,3.8,0,2.7777777777777777,0,3.75,0,2.8333333333333335,0,2.5714285714285716,0,2.3333333333333335,0,3.027027027027027,0,0,0,0,1.935351233568792,-0.18960311150004575,0.872874061034373,1,1,1,1,1,2,2,8,1,1.8126539343499315,1.2857142857142858,0,4.5,0.5586092800629101,5,5,5,5,3,2,5,8,7,6,4,1.7043362064926932,7.5,4.285714285714286,0,1.480127753347792,0,1.3596602000207527,2,2,3,3,3,4,4,4,4,3,5,4,4,3,5,3,4,4,3,2,1.0997835284835873,2.6,0,4.2,0,3.4,0,3.6,0,3.7333333333333334,0,4,2,2,2,4,2,4,3,3,1,3,3,3,3,1,3,3,3,4,4,0.9665456669582609,2.85,0,4,2,2,2,4,2,4,3,3,1,3,3,3,3,1,3,3,3,4,4,0.9665456669582609,2.85,0,I lived with my mother and father an equal amount of time (joint custody),0,"White, Caucasian, Anglo, European American",0,27,1,2,NA,1,2,4,Transcription,1,133,66,1,5,2,1,0,1,0,1,I lived with my mother and father an equal amount of time (joint custody),0,TRUE,TRUE,TRUE,TRUE,TRUE,1,0.5449999999850988,0.50209375,0.5567281250208617,0.6401781249940396,0.5971218749582767,0.6460516129309132,1,1,1,1,1,1,0.087,0.421,0.624,0.016,1.496,21.635354830651863,1810.8354492568988,0.089,0.419,0.627,0.016,1.564,27.010810554140903,1810.1648696442273,390,1.1555555555555557,0,3,0,0,3,FALSE
15,2022-03-18T15:37:41Z,2022-03-18T16:07:03Z,1762,1,2022-03-18T16:07:04Z,0.8999999761581421,Chrome,98.0.4758.91,CrOS x86_64 14388.52.0,1920,1080,no,1.7777777777777777,790,63,337,114,56,76,0.22958886815720922,-0.30330996519962966,-0.2708620534202129,0.19439856254662236,-0.10160780960546556,-0.2521103918255647,1,1,1,1,1,1,1,1,1,1,1,3,2,1,1,2,1,1,1,2,1.394538218230416,0,0,3,3,3,1.25,0,5,4,4,5,4,4,4,4,3,4,4,4,3,4,4,4,4,5,2,3,3,3,3,6,2,0,0,0,0,1,5,3,4,5,4,4,4,4,4,4,2,1,3,3,3,5,4,2,3,3,3,1,4,1,5,5,1,5,4,1,3,3,3,4,5,3,3,3,3,2,1.3367074424820065,1.1464230084422218,3.375,0,2.75,0,4,0,3.7777777777777777,0,3.0833333333333335,0,3.1666666666666665,0,2.857142857142857,0,4,0,3.2972972972972974,0,3,0,0,1.758482696968407,0.6402455709446675,1.1993641339565373,5,3,5,3,3,5,3,5,1,1.3801311186847085,3.857142857142857,0,3,1.4704822637634591,2,2,2,1,1,1,1,7,6,2,2,1.4142135623730951,6.5,1.4285714285714286,0,-0.24540699345023656,0,-1.2406775114033903,4,4,4,5,4,2,5,3,3,2,3,3,2,2,5,1,3,4,3,2,1.0555973258234952,4.2,0,3,0,2.6,0,3,0,2.8666666666666667,0,3,3,3,4,3,3,3,4,2,3,4,3,4,3,1,3,1,3,3,2,0.9459053029269173,2.9,0,3,3,3,4,3,3,3,4,2,3,4,3,4,3,1,3,1,3,3,2,0.9459053029269173,2.9,0,"I lived with my mother, but not father, most of the time.",0,"White, Caucasian, Anglo, European American",0,20,1,2,NA,1,2,4,retail associate,2,140,62,1,5,2,0,0,1,0,0,"I lived with my mother, but not father, most of the time.",0,TRUE,TRUE,TRUE,TRUE,TRUE,4,0.6402000000000961,0.5146906249998138,0.5316612903225807,0.6926968749999068,0.577396774193933,0.6151580645177633,1,1,0.96875,1,0.96875,1,0.07,0.403,0.519,0.025,1.758,90.82353932311344,1962.4544555183968,0.07,0.405,0.554,0.026,1.901,122.29309207975257,1949.0700997312167,466,1.3807407407407408,0,3,0,0,3,FALSE
16,2022-03-18T15:47:44Z,2022-03-18T16:07:34Z,1189,1,2022-03-18T16:07:35Z,1,Edge,99.0.1150.39,Windows NT 10.0,1280,720,n/a,1.7777777777777777,525,98,308,76,42,79,-0.3143159124822786,-0.11038398349514147,-0.3760732067456547,-0.2734767041639953,-0.38830297283146,-0.218412468165712,2,2,3,2,2,2,1,3,1,3,3,2,2,1,3,2,2,1,4,3,0.7254762501100116,0,1,3,2,2,2.2,0,1,1,2,2,2,2,1,2,2,2,2,4,2,3,2,1,1,1,1,1,1,1,1,1,2,0,0,0,0,2,2,3,2,2,1,1,1,1,2,1,1,1,1,1,1,2,1,1,1,1,1,1,1,1,1,1,1,2,2,1,2,2,1,1,1,1,2,1,2,2,1.6930346618915888,1.2798809468443688,1,0,1.75,0,2,0,1.6666666666666667,0,1.1666666666666667,0,1,0,1.5714285714285714,0,1,0,1.3243243243243243,0,1,0,0,-1.015607288608579,-0.14280879051279902,-0.579208039560689,1,1,2,1,1,1,1,1,1,1.7320508075688772,1.1428571428571428,0,1,-0.8770273057233877,5,5,5,4,2,3,4,6,6,5,3,1.3801311186847085,6,4,0,0.6507502562930925,0,0.6992578091595676,2,1,2,3,2,4,4,4,5,3,5,3,3,4,3,5,3,3,3,3,0.9856107606091623,2,0,3.6,0,3.6,0,3.8,0,3.6666666666666665,0,1,1,1,2,1,1,1,2,1,1,1,2,1,2,1,1,1,1,2,1,0.9445132413883326,1.25,0,1,1,1,2,1,1,1,2,1,1,1,2,1,2,1,1,1,1,2,1,0.9445132413883326,1.25,0,I lived with my mother and father an equal amount of time (joint custody),0,"White, Caucasian, Anglo, European American",0,29,1,2,NA,1,3,7,Recruitment Coordinator,5,230,68,2,5,2,0,1,1,0,1,I lived with my mother and father an equal amount of time (joint custody),0,TRUE,TRUE,TRUE,TRUE,TRUE,4,0.5512468750020489,0.5671406249981373,0.5194000000011536,0.6749290322613332,0.6196580645192054,0.8277566666712364,1,1,0.96875,1,1,0.9375,0.073,0.377,0.333,0.006,1.704,256.2908037550112,2181.174368392169,0.073,0.377,0.371,0.006,1.726,250.12267096590637,2161.1092265263783,258,0.7644444444444445,0,3,3,6,9,FALSE
17,2022-03-18T15:40:54Z,2022-03-18T16:08:32Z,1658,1,2022-03-18T16:08:34Z,0.800000011920929,Firefox,98.0,Windows NT 10.0,1920,1080,I experienced a lot from the study.,1.7777777777777777,564,127,413,86,48,94,-0.23426954853910867,0.0494689727742916,0.004863727708531158,-0.15035163397699064,-0.26543361716317665,-0.04992284986644844,2,1,1,2,4,1,1,1,1,2,2,1,2,1,2,1,2,1,3,1,1.1964860832322377,0,1,3,5,4,1.6,0,2,1,2,2,2,1,4,1,2,2,1,2,1,2,3,2,1,1,2,1,1,1,1,0,1,1,1,1,1,2,3,2,2,3,2,2,3,2,2,3,1,3,2,3,2,1,1,2,2,4,2,1,1,2,4,1,2,1,2,1,2,1,1,2,1,1,1,2,2,3,1.2609877438302444,1.3557637102737474,1.25,0,2,0,1.8666666666666667,0,2.3333333333333335,0,2.1666666666666665,0,1.8333333333333333,0,1.4285714285714286,0,1.3333333333333333,0,1.945945945945946,0,0,1,1,-0.6929723064293571,1.3269026199255418,0.31696515674809234,2,2,2,1,1,1,1,3,2,1.4142135623730951,1.4285714285714286,0,2.5,-0.13153274783281477,4,5,4,4,5,4,4,7,7,5,5,1,7,4.285714285714286,0,1.5199742409957124,0,1.3839487198019815,1,1,2,1,1,5,3,5,4,1,5,4,4,4,4,5,4,3,4,2,1.3522468075656264,1.2,0,4.2,0,3.4,0,3.8,0,3.8,0,1,2,1,3,2,1,1,2,1,1,1,2,1,1,1,2,1,1,1,1,0.7591546545162482,1.35,0,1,2,1,3,2,1,1,2,1,1,1,2,1,1,1,2,1,1,1,1,0.7591546545162482,1.35,0,I lived with my mother and father an equal amount of time (joint custody),0,"White, Caucasian, Anglo, European American",0,29,1,2,NA,1,5,6,IT Expert,6,165,66,4,5,2,0,0,1,0,0,I lived with my mother and father an equal amount of time (joint custody),0,TRUE,TRUE,TRUE,TRUE,TRUE,2,0.58625,0.4976875,0.49634375,0.6283448275862069,0.550304347826087,0.5737931034482758,1,1,1,0.90625,0.7419354838709677,0.90625,0.055,0.374,0.422,0.012,1.314,25.165753793960306,1889.6073971513074,0.055,0.373,0.449,0.011,1.321,31.456545984097882,1885.187166084475,316,0.9362962962962963,0,3,3,6,9,FALSE
18,2022-03-18T15:49:21Z,2022-03-18T16:10:53Z,1291,1,2022-03-18T16:10:53Z,1,Chrome,96.0.4664.110,Macintosh,1920,1080,NA,1.7777777777777777,570,83,341,75,50,96,-0.22195472331708255,-0.19306654708277926,-0.25635017020291057,-0.28578921118269573,-0.22447716527374886,-0.027457567426546634,2,2,2,1,3,1,2,2,1,3,3,2,1,2,2,3,2,1,3,3,0.6863327411532597,0,0,4,2,1,2.05,0,1,1,2,2,1,1,3,1,1,1,1,2,3,3,2,1,2,3,1,1,1,1,1,2,2,0,0,0,0,2,5,4,3,3,3,4,3,3,1,2,2,1,3,1,3,1,1,1,1,3,4,4,5,1,3,1,1,3,1,1,2,1,1,1,1,1,2,2,1,1,1.2105641104317713,1.5491933384829668,1.375,0,1.5,0,1.6666666666666667,0,3.3333333333333335,0,1.6666666666666667,0,3,0,1.4285714285714286,0,1,0,2.189189189189189,0,1,0,0,-0.61944932543854625,-0.22899200544817064,-0.42422066544335846,1,1,3,1,1,1,1,1,1,1.5735915849388864,1.2857142857142858,0,1,-0.7941589286438315,5,4,5,4,1,1,4,6,10,2,3,1.7728105208558367,8,3.4285714285714284,0,0.3698928130806107,0,0.21835370368194879,2,1,2,2,1,5,5,5,5,3,5,5,5,4,4,4,5,4,4,5,1.6761634196950514,1.6,0,4.8,0,4.2,0,4.6,0,4.533333333333333,0,1,1,1,1,2,1,2,2,1,1,3,2,1,1,1,3,1,1,1,1,0.9403246919632545,1.4,0,1,1,1,1,2,1,2,2,1,1,3,2,1,1,1,3,1,1,1,1,0.9403246919632545,1.4,0,"I lived with my mother, but not father, most of the time.",0,"White, Caucasian, Anglo, European American",0,25,1,2,NA,1,3,6,Senior Admissions Representative for a university,3,130,65,2,5,2,0,0,1,0,0,"I lived with my mother, but not father, most of the time.",0,TRUE,TRUE,TRUE,TRUE,TRUE,2,0.7483593749701977,0.5732718749940395,0.6382375000044703,0.7970483870890833,0.6007064516236705,0.7054225806574668,1,1,1,0.96875,0.96875,0.96875,0.065,0.481,0.404,0.023,1.723,66.4944870241798,1919.7975789480404,0.065,0.481,0.402,0.024,1.767,86.08242778946061,1911.6986090252494,348,1.031111111111111,0,3,0,0,3,FALSE
19,2022-03-18T15:55:21Z,2022-03-18T16:13:39Z,1098,1,2022-03-18T16:13:41Z,1,Chrome,97.0.4692.91,CrOS x86_64 14324.72.0,1366,768,NA,1.7786458333333333,462,77,281,90,55,81,-0.443621577313553,-0.22613957251783437,-0.47402841846244537,-0.10110160590218879,-0.12208603555017945,-0.19594718572581019,2,1,2,1,2,1,1,3,1,2,3,2,2,1,2,2,2,1,2,2,0.9333020044867296,0,0,2,4,4,1.75,0,3,1,2,1,1,1,2,1,1,1,2,2,1,2,2,1,2,1,1,1,2,1,1,3,2,0,0,0,0,1,5,1,2,2,1,1,1,1,1,1,1,1,1,1,1,1,1,1,1,1,2,1,1,1,2,1,1,2,2,1,1,1,2,1,1,1,1,1,1,1,1.7879308422578029,1.5946338585572373,1.25,0,1,0,1.5333333333333334,0,1.6666666666666667,0,1,0,1.3333333333333333,0,1.4285714285714286,0,1,0,1.2972972972972974,0,2,0,0,-1.1221024230557777,-0.18219768446092388,-0.6521500537583508,1,1,3,1,1,1,2,1,1,1.5275252316519468,1.4285714285714286,0,1,-0.7112905515642753,5,5,5,5,4,4,5,6,3,5,4,1.4638501094227998,4.5,4.714285714285714,0,0.7239866202853277,0,1.131032698442667,2,2,2,2,2,5,4,5,5,4,5,4,5,5,3,5,5,4,4,4,1.5946338585572373,2,0,4.6,0,4.4,0,4.4,0,4.466666666666667,0,2,2,1,1,2,1,2,3,1,3,3,2,3,3,1,3,2,2,2,2,0.812727700887249,2.05,0,2,2,1,1,2,1,2,3,1,3,3,2,3,3,1,3,2,2,2,2,0.812727700887249,2.05,0,I lived with my mother and father an equal amount of time (joint custody),0,"White, Caucasian, Anglo, European American",0,27,1,2,NA,1,3,4,transcriber,6,123,67,2,5,2,0,0,1,0,0,I lived with my mother and father an equal amount of time (joint custody),0,TRUE,TRUE,TRUE,TRUE,TRUE,2,0.4061343750000087,0.38767812499999127,0.45252812500002254,0.484175,0.4627599999999977,0.5232777777777649,1,1,1,0.625,0.625,0.84375,0.057,0.331,0.499,0.019,1.967,64.86237360111602,1936.568234565794,0.057,0.331,0.518,0.019,2.003,76.76246192557933,1939.437208310804,360,1.0666666666666667,0,3,0,0,3,FALSE
20,2022-03-18T15:57:30Z,2022-03-18T16:15:51Z,1100,1,2022-03-18T16:15:53Z,1,Chrome,99.0.4844.74,Windows NT 10.0,1920,1080,NA,1.7777777777777777,512,59,310,65,50,66,-0.34099803379666854,-0.32535864882299975,-0.3688172651370035,-0.4089142813697004,-0.22447716527374886,-0.3644368040250737,2,3,1,1,3,1,1,4,1,3,4,1,1,1,2,3,1,1,3,3,0.6882472016116853,0,1,1,3,3,2,0,1,1,1,1,1,1,1,1,1,1,1,2,2,2,3,1,2,2,1,1,1,1,1,2,2,0,0,0,0,1,2,2,2,5,1,4,4,2,1,1,1,1,2,2,1,1,3,1,1,3,2,1,1,1,4,1,2,2,2,1,1,1,1,1,1,1,1,2,2,2,1.551904767828364,1.7994708216848747,1.25,0,1.75,0,1.3333333333333333,0,2.5555555555555554,0,1.5,0,1.6666666666666667,0,1.4285714285714286,0,1,0,1.7297297297297298,0,1,0,0,-1.0205285055423683,-0.14280879051279902,-0.5816686480275837,1,1,2,1,1,1,1,3,1,1.7320508075688772,1.1428571428571428,0,2,-0.49052210323574724,5,5,5,5,1,1,5,4,3,4,4,2.138089935299395,3.5,3.857142857142857,0,0.3292211155819382,0,0.42584227065432945,2,2,2,3,3,4,2,4,4,2,1,4,2,4,2,2,3,3,2,4,1.0600988273786194,2.4,0,3,0,2,0,3.6,0,2.8666666666666667,0,1,2,2,3,2,2,1,3,3,3,3,3,2,3,2,3,1,3,1,2,0.6863327411532597,2.25,0,1,2,2,3,2,2,1,3,3,3,3,3,2,3,2,3,1,3,1,2,0.6863327411532597,2.25,0,"I lived with my mother, but not father, most of the time. & I lived with my mother and father an equal amount of time (joint custody)",1,"White, Caucasian, Anglo, European American",0,23,1,2,NA,1,2,6,Customer Support Representative,2,92,61,1,5,2,0,0,1,0,0,"I lived with my mother, but not father, most of the time. & I lived with my mother and father an equal amount of time (joint custody)",1,TRUE,TRUE,TRUE,TRUE,TRUE,2,0.4811187500008382,0.4319437499996275,0.4510781249997672,0.5845259259265881,0.47264399999946355,0.5356777777779433,1,1,1,0.84375,0.78125,0.84375,0.057,0.348,0.559,0.017,1.883,38.30612656087759,1959.5977012114247,0.056,0.351,0.526,0.022,2.067,56.98339581604526,1959.413656268431,222,0.6577777777777777,0,3,0,0,3,FALSE
21,2022-03-18T15:56:19Z,2022-03-18T16:15:55Z,1176,1,2022-03-18T16:15:57Z,0.8999999761581421,Chrome,99.0.4844.51,Windows NT 10.0,1920,1080,NA,1.7777777777777777,493,81,302,58,52,80,-0.37999498033308465,-0.2040908888944643,-0.39784103157160816,-0.49510183050060363,-0.1835207133843211,-0.2071798269457611,3,3,3,2,4,1,2,3,1,3,3,3,3,2,3,2,2,1,3,3,0.6488856845230502,0,0,2,3,4,2.5,0,2,3,2,3,2,1,2,2,3,1,3,3,1,3,3,2,4,1,1,2,3,2,3,2,2,0,0,0,0,1,2,2,2,2,1,3,2,1,3,1,3,1,3,3,5,4,5,3,5,5,3,1,1,1,2,1,1,2,2,1,3,3,2,1,1,2,2,1,2,1,1.475017178095115,0.990430401872025,2.25,0,1.5,0,2.2666666666666666,0,1.7777777777777777,0,3.4166666666666665,0,1.5,0,2,0,1.3333333333333333,0,2.27027027027027,0,1,0,0,0.060564430472448465,-0.22899200544817064,-0.08421378748786108,2,2,3,1,1,2,1,1,1,1.1547005383792515,1.7142857142857142,0,1,-0.5455537974051633,3,3,3,2,1,1,4,3,9,4,2,0.8997354108424374,6,2.4285714285714284,0,0.09240448050769899,0,-0.49277684787106846,2,3,2,3,2,4,3,4,4,2,3,3,5,3,3,3,3,4,2,3,0.6399404734221844,2.4,0,3.4,0,3,0,3.4,0,3.2666666666666666,0,2,1,1,4,2,2,2,4,4,2,2,2,2,3,1,2,1,3,2,2,0.8583950752789521,2.2,0,2,1,1,4,2,2,2,4,4,2,2,2,2,3,1,2,1,3,2,2,0.8583950752789521,2.2,0,I lived with my mother and father an equal amount of time (joint custody),0,"White, Caucasian, Anglo, European American",0,20,1,2,NA,1,2,3,NA,4,120,63,2,5,2,0,0,1,0,0,I lived with my mother and father an equal amount of time (joint custody),0,TRUE,TRUE,TRUE,TRUE,TRUE,2,0.45019032258756697,0.4394531250074506,0.4419437499716878,0.5448285714387894,0.5173838709746638,0.5293689655065537,0.96875,1,1,0.875,0.96875,0.90625,0.064,0.351,0.704,0.016,1.769,21.00018712784987,1885.552173766187,0.065,0.352,0.736,0.019,1.851,20.68208436789645,1875.6401259970003,294,0.8711111111111112,0,3,0,0,3,FALSE
22,2022-03-18T15:49:28Z,2022-03-18T16:16:52Z,1643,1,2022-03-18T16:16:53Z,0.8999999761581421,Safari,14.1.2,Macintosh,1440,900,no,1.6,836,139,309,96,53,74,0.32400252819274294,0.11561502364440183,-0.3724452359413291,-0.02722656378998601,-0.16304248743960723,-0.2745756742654665,2,2,2,1,2,1,1,2,1,2,3,2,1,1,2,2,2,1,2,2,0.9119095061289915,0,0,2,3,3,1.7,0,3,1,2,1,2,2,2,4,2,3,3,3,2,3,2,1,4,1,1,1,2,2,1,1,2,0,0,0,0,2,1,1,1,1,1,1,1,1,1,1,3,1,2,1,1,1,2,3,2,1,2,1,1,1,2,2,1,2,1,1,1,1,1,1,2,1,2,1,2,1,1.745865987997947,1.0600988273786194,1.625,0,1.5,0,2.3333333333333335,0,1.1111111111111112,0,1.5833333333333333,0,1.5,0,1.1428571428571428,0,1.3333333333333333,0,1.3513513513513513,0,1,0,0,-0.5850008069020217,-0.22899200544817064,-0.4069964061750962,1,2,1,1,1,1,1,1,1,1.889822365046136,1.1428571428571428,0,1,-0.8770273057233877,5,5,5,5,3,2,4,7,7,6,4,1.4638501094227998,7,4.142857142857143,0,1.3897838462580232,0,1.2271641616118822,2,2,2,2,2,4,4,3,4,3,4,4,3,3,4,3,4,5,4,3,0.9258200997725514,2,0,4.2,0,3.4,0,3.4,0,3.6666666666666665,0,2,1,2,4,1,3,1,3,2,1,2,3,2,3,1,3,1,3,2,1,0.7163503994113789,2.05,0,2,1,2,4,1,3,1,3,2,1,2,3,2,3,1,3,1,3,2,1,0.7163503994113789,2.05,0,I lived with my mother and father an equal amount of time (joint custody),0,"White, Caucasian, Anglo, European American",0,23,1,2,NA,1,3,6,patient care tech,5,145,65,3,5,2,0,0,1,0,0,I lived with my mother and father an equal amount of time (joint custody),0,TRUE,TRUE,TRUE,TRUE,TRUE,6,0.5058125000000054,0.4622258064515904,0.47840625,0.5772258064516091,0.5019354838709827,0.5390312499999964,1,0.96875,1,0.96875,0.96875,1,0.102,0.306,0.617,0.011,1.208,58.137855024026656,1866.144485206684,0.104,0.308,0.636,0.013,1.266,71.59549885457737,1858.0619843880295,392,1.1614814814814816,0,3,0,3,6,FALSE
23,2022-03-18T15:58:42Z,2022-03-18T16:22:10Z,1408,1,2022-03-18T16:22:11Z,0.8999999761581421,Chrome,99.0.4844.74,Windows NT 10.0,1920,1080,NA,1.7777777777777777,427,47,563,181,77,65,-0.5154580577753721,-0.39150469969310997,0.5490593483573681,1.0193365327995534,0.328434935233526,-0.3756694452450246,2,3,1,1,2,1,1,3,1,2,3,1,1,1,2,1,1,1,2,3,0.9880869341680844,0,0,5,5,5,1.65,0,3,1,2,3,1,1,1,2,2,1,1,1,3,2,2,2,4,5,1,2,3,3,2,12,1,0,0,2,2,1,2,5,1,2,1,2,2,2,1,1,3,1,5,1,3,3,4,5,4,4,5,2,2,4,1,1,1,4,4,4,3,3,2,1,1,1,2,2,4,4,1.5122125468289127,1.52127765851133,2.75,0,3,0,1.7333333333333334,0,2,0,2.9166666666666665,0,2.5,0,3,0,1,0,2.4864864864864864,0,6,2,0,0.14048499347718574,2.7802307033283262,1.460357848402756,1,1,1,1,1,1,1,3,1,1.9518001458970664,1,0,2,-0.5733904803153034,5,5,5,5,2,2,5,3,3,3,2,1.8126539343499315,3,4.142857142857143,0,-0.6637366525547652,0,-0.024564063402106817,4,3,4,5,3,1,2,2,3,2,3,2,3,2,3,2,3,4,3,1,1.0327955589886444,3.8,0,2.6,0,2.4,0,2.2,0,2.4,0,3,2,3,3,3,2,3,3,4,2,2,3,2,2,1,3,2,3,3,3,0.6805570473787206,2.6,0,3,2,3,3,3,2,3,3,4,2,2,3,2,2,1,3,2,3,3,3,0.6805570473787206,2.6,0,I lived with my mother and father an equal amount of time (joint custody),0,"White, Caucasian, Anglo, European American",0,27,1,2,NA,1,2,3,Entertainment Producer,3,115,65,1,5,2,0,0,1,0,0,I lived with my mother and father an equal amount of time (joint custody),0,TRUE,TRUE,TRUE,TRUE,TRUE,1,0.46869999999552964,0.4836937499977648,0.47240624999999997,0.5709821428571429,0.5520419354823328,0.5468800000111262,1,1,1,0.875,0.96875,0.9375,0.061,0.332,0.461,0.018,1.751,64.94124389732256,1918.9710264521545,0.061,0.334,0.467,0.021,1.86,80.68816855839738,1927.4872478422876,358,1.0607407407407408,0,3,0,6,9,FALSE
24,2022-03-18T16:05:05Z,2022-03-18T16:23:38Z,1113,1,2022-03-18T16:23:39Z,0.8999999761581421,Chrome,99.0.4844.74,Macintosh,1440,900,no,1.6,492,67,286,73,47,83,-0.3820474512034223,-0.28126128157625957,-0.45588856444081743,-0.3104142252200967,-0.28591184310789053,-0.17348190328590837,3,3,3,3,3,3,4,3,2,3,3,3,3,2,3,3,3,2,3,3,0.5982430416161189,0,0,2,4,4,2.9,0,3,3,3,3,2,2,2,2,2,2,2,2,2,2,2,3,2,3,1,1,1,1,1,1,1,0,0,1,1,2,3,1,1,1,1,1,1,1,2,1,1,2,2,2,2,2,2,2,1,3,3,2,3,1,3,2,1,2,1,1,3,2,1,2,4,2,3,4,4,2,1.4436357172375875,0.8618916073713346,1.625,0,3.25,0,2.2666666666666666,0,1.3333333333333333,0,1.8333333333333333,0,2.3333333333333335,0,1.5714285714285714,0,2.6666666666666665,0,1.8108108108108107,0,1,1,0,-0.4133487602514538,1.0724503315365894,0.3295507856425678,2,2,5,2,2,2,2,1,1,0.8997354108424374,2.4285714285714284,0,1,-0.13121191200738283,2,3,3,2,1,1,2,3,9,1,1,1.1126972805283737,6,2,0,-0.8940966763253987,0,-1.3263810316481466,3,3,3,4,4,2,4,4,3,3,5,3,3,4,3,4,4,4,4,4,0.9611501047232549,3.4,0,3.6,0,3.6,0,3.6,0,3.6,0,2,3,2,3,3,3,1,4,2,2,2,4,2,2,1,4,2,2,1,2,0.6708203932499369,2.35,0,2,3,2,3,3,3,1,4,2,2,2,4,2,2,1,4,2,2,1,2,0.6708203932499369,2.35,0,"I lived with my mother, but not father, most of the time.",0,"Hispanic of Latino (e.g., Mexican American, Central American, and others)",0,20,1,2,NA,1,2,4,student,1,135,61,4,5,2,0,0,0,0,0,"I lived with my mother, but not father, most of the time.",0,TRUE,TRUE,TRUE,TRUE,TRUE,3,0.5048354838707394,0.4213812500000349,0.45843225806458826,0.5926033333334451,0.5228766666665052,0.5464548387096053,0.96875,1,0.96875,0.967741935483871,0.9375,0.96875,0.065,0.309,0.43,0.014,1.476,120.86776747872918,2006.653220454456,0.064,0.31,0.443,0.014,1.607,166.3985362255837,2042.8361259625506,432,1.28,0,3,0,0,3,FALSE
25,2022-03-18T15:58:17Z,2022-03-18T16:24:25Z,1567,1,2022-03-18T16:24:26Z,0.8999999761581421,Chrome,99.0.4844.74,Windows NT 10.0,1280,720,NA,1.7777777777777777,718,98,394,99,74,113,0.08181096549289554,-0.11038398349514147,-0.06406771757365486,0.009710957266115384,0.2670002573993844,0.1634973333126187,3,3,3,2,4,1,2,3,1,3,4,2,2,2,3,3,2,1,4,4,0.5712405705774795,0,0,2,3,2,2.6,0,5,3,4,3,4,3,4,3,3,2,4,4,3,4,4,4,4,4,1,2,4,4,4,6,2,0,0,0,0,4,2,4,3,4,2,3,3,3,4,3,3,1,4,3,4,4,4,4,4,4,5,1,1,1,2,1,1,3,3,1,3,3,3,2,3,2,2,2,2,2,1.068242079840118,0.8837151016885368,3.375,0,2,0,3.533333333333333,0,3.111111111111111,0,3.5,0,1.8333333333333333,0,2.4285714285714284,0,2.3333333333333335,0,2.8378378378378377,0,3,0,0,1.3537618163335812,0.38169592613855263,0.8677288712360669,4,5,5,5,5,4,4,4,2,1.6035674514745464,4.571428571428571,0,3,1.8848241491612394,3,3,3,4,1,1,2,1,5,2,2,1.2535663410560174,3,2.4285714285714284,0,-0.8778143430786174,0,-1.0841760019700786,2,3,3,3,3,4,4,4,4,2,5,4,4,3,4,5,4,5,4,3,1.1832159566199232,2.8,0,4.4,0,3.8,0,3.6,0,3.933333333333333,0,1,2,2,2,3,1,3,2,1,2,3,2,2,2,2,2,1,2,2,3,0.7677718959499145,2,0,1,2,2,2,3,1,3,2,1,2,3,2,2,2,2,2,1,2,2,3,0.7677718959499145,2,0,I lived with my mother and father an equal amount of time (joint custody),0,"Hispanic of Latino (e.g., Mexican American, Central American, and others)",0,26,1,2,NA,1,2,7,social worker,3,165,68,2,5,2,0,0,1,0,0,I lived with my mother and father an equal amount of time (joint custody),0,TRUE,TRUE,TRUE,TRUE,TRUE,4,0.5096516129032318,0.5226516129032468,0.48408437499999124,0.5390375000000349,0.5389312500000087,0.5409999999999845,0.96875,0.96875,1,1,1,0.9375,0.076,0.307,0.451,0.014,1.532,62.59180660336958,1930.6560329150157,0.076,0.307,0.451,0.014,1.606,80.91447919334884,1923.3886198142425,382,1.1318518518518519,0,3,0,0,3,FALSE
26,2022-03-18T15:52:31Z,2022-03-18T16:25:17Z,1966,1,2022-03-18T16:25:18Z,0.800000011920929,Firefox,98.0,Windows NT 10.0,1600,900,Nothing to say. Thanks.,1.7777777777777777,725,174,447,89,93,229,0.09617826158525937,0.30854100534889,0.12821473505560085,-0.11341411292088927,0.6560865503489481,1.4664837148269234,2,1,3,2,3,1,1,1,2,1,2,1,2,1,2,2,1,1,4,1,1.1742858972247996,0,1,4,4,3,1.7,0,1,2,2,2,4,3,4,3,4,3,4,2,5,2,2,4,2,3,4,3,4,4,4,1,1,1,0,1,1,2,2,3,1,3,2,2,2,3,3,3,4,3,3,2,5,2,3,1,2,2,2,2,3,3,3,3,3,4,1,2,4,2,1,1,2,1,4,4,5,2,1.0766425401028696,0.8997354108424374,3.5,0,3.75,0,2.8666666666666667,0,2.2222222222222223,0,2.75,0,2.6666666666666665,0,2.4285714285714284,0,1.3333333333333333,0,2.4324324324324325,0,1,1,0,0.9398874722019076,1.2448167614073327,1.0923521168046202,1,2,3,5,4,4,4,2,2,1.0690449676496976,3.2857142857142856,0,2,0.7525035529575942,4,4,4,4,4,4,2,6,6,1,3,0,6,3.7142857142857144,0,-0.2055605058023161,0,0.02243818357258892,1,1,1,1,1,2,4,2,2,4,2,5,3,4,5,5,4,3,5,2,0.990430401872025,1,0,3.2,0,4.2,0,3,0,3.466666666666667,0,3,1,2,2,3,3,2,1,1,1,1,2,2,2,1,2,1,2,1,2,0.9445132413883326,1.75,0,3,1,2,2,3,3,2,1,1,1,1,2,2,2,1,2,1,2,1,2,0.9445132413883326,1.75,0,I lived with my mother and father an equal amount of time (joint custody),0,"White, Caucasian, Anglo, European American",0,27,1,2,NA,1,3,6,Student,2,105,64,4,5,2,0,0,1,0,0,I lived with my mother and father an equal amount of time (joint custody),0,TRUE,TRUE,TRUE,TRUE,TRUE,6,0.71653125,0.62021875,0.63859375,0.788258064516129,0.69903125,0.74978125,1,1,1,1,1,1,0.23,0.294,0.659,0.009,1.256,17.66386321157431,1803.8346346823669,0.223,0.298,0.661,0.009,1.295,21.78408340501528,1803.0741376371261,340,1.0074074074074075,0,3,0,0,3,FALSE
27,2022-03-18T16:00:10Z,2022-03-18T16:26:38Z,1588,1,2022-03-18T16:26:39Z,0.8999999761581421,Chrome,99.0.4844.74,Windows NT 10.0,1366,768,No,1.7786458333333333,581,108,561,88,83,93,-0.19937754374336794,-0.055262274436716274,0.541803406748717,-0.12572661993958972,0.45130429090180935,-0.061155491086399345,2,2,2,1,2,1,2,2,1,3,3,2,2,2,3,3,2,1,3,3,0.6488856845230502,0,1,1,3,3,2.1,0,2,2,2,2,2,3,3,3,2,3,3,3,2,3,2,2,3,1,2,2,2,2,2,1,1,2,1,3,1,2,3,2,2,2,1,1,1,2,1,1,1,2,3,2,2,3,3,3,4,3,3,1,1,1,3,1,3,3,1,1,2,3,1,1,1,1,2,2,2,2,1.4072954488949647,0.7559289460184544,2,0,2,0,2.466666666666667,0,1.7777777777777777,0,2.3333333333333335,0,1.6666666666666667,0,2,0,1,0,1.9189189189189189,0,1,1,1,-0.11482774104779901,1.5460633707835318,0.7156178148678665,3,2,4,2,1,3,3,3,1,0.7559289460184544,2.5714285714285716,0,2,0.3381616675598139,4,4,4,4,3,3,4,2,1,3,3,0.7867957924694432,1.5,3.7142857142857144,0,-0.59050028856253,0,-0.2122027617163827,2,2,2,3,3,4,4,4,4,3,4,4,2,4,4,3,3,3,3,3,0.7988086367179802,2.4,0,3.6,0,3,0,3.8,0,3.466666666666667,0,2,2,3,2,2,2,2,3,2,2,2,2,2,1,1,3,1,2,2,2,0.5619514869490163,2,0,2,2,3,2,2,2,2,3,2,2,2,2,2,1,1,3,1,2,2,2,0.5619514869490163,2,0,I lived with my mother and father an equal amount of time (joint custody),0,"White, Caucasian, Anglo, European American",0,25,1,2,NA,1,3,4,Self employed,3,103,61,4,5,2,0,0,0,0,0,I lived with my mother and father an equal amount of time (joint custody),0,TRUE,TRUE,TRUE,TRUE,TRUE,5,0.5637124999999069,0.518234374998603,0.56959375,0.6449935483874814,0.55235624999972055,0.5931656249989755,1,1,1,0.96875,1,1,0.07,0.42,0.43,0.065,1.187,37.3604517156997,1826.7134358983228,0.072,0.417,0.451,0.095,1.224,54.73763295862984,1835.6408915692655,368,1.0903703703703704,0,3,0,0,3,FALSE
28,2022-03-18T15:53:32Z,2022-03-18T16:29:18Z,2145,1,2022-03-18T16:29:19Z,0.8999999761581421,Chrome,99.0.4844.51,Macintosh,1440,900,NA,1.6,666,248,818,134,104,118,-0.02491751976466432,0.7164416523812365,1.474191903460391,0.44064870292063163,0.8813470357408009,0.21966053941237323,4,3,4,3,4,2,2,4,1,3,4,4,2,2,4,4,3,2,4,4,0.9880869341680844,0,0,5,3,3,3.15,0,4,2,3,3,5,3,4,3,2,2,3,3,3,3,3,4,4,5,1,2,3,4,4,5,1,2,0,2,0,1,2,3,3,4,1,3,1,4,3,3,3,3,3,3,1,3,4,4,5,5,5,3,4,3,5,5,2,4,3,2,1,2,2,3,3,3,5,3,3,2,1.1170262968022497,0.7988086367179802,3.375,0,3.25,0,3.066666666666667,0,2.4444444444444446,0,3.3333333333333335,0,4.166666666666667,0,2.2857142857142856,0,3,0,3.027027027027027,0,3,0,0,1.2325030310850151,0.8126120008154107,1.022557515950213,4,4,3,2,3,3,3,1,2,0.6900655593423543,3.142857142857143,0,1.5,0.4763825746342179,3,3,3,3,2,2,2,4,3,NA,2,0.6900655593423543,3.5,2.5714285714285716,0,-0.7814618182828701,1,-0.9480173965791685,2,2,2,2,2,4,4,5,4,3,5,4,4,4,4,3,5,5,3,3,1.2649110640673518,2,0,4.6,0,3.4,0,4,0,4,0,2,2,1,2,3,1,3,3,2,2,3,2,2,1,2,2,1,1,2,3,0.7880689256524124,2,0,2,2,1,2,3,1,3,3,2,2,3,2,2,1,2,2,1,1,2,3,0.7880689256524124,2,0,"I lived with my mother, but not father, most of the time. & I lived with my extended family on mother's side (grandparents, aunts ,uncles, cousins)",1,Black or African American & Filipino,1,24,1,2,NA,1,2,7,Graduate Student,2,120,64,3,5,2,0,1,3,0,1,"I lived with my mother, but not father, most of the time. & I lived with my extended family on mother's side (grandparents, aunts ,uncles, cousins)",1,TRUE,TRUE,TRUE,TRUE,TRUE,3,0.5208468750002794,0.48423750000074506,0.5291812500013039,0.6165258064524781,0.5484366666689515,0.6082548387108311,1,1,1,1,0.9375,0.96875,0.081,0.386,0.615,0.019,1.722,108.58862336337785,1943.4025511078491,0.082,0.387,0.646,0.016,1.8,109.13449568231933,1932.6572494053132,374,1.108148148148148,0,3,0,3,6,FALSE
30,2022-03-18T15:48:45Z,2022-03-18T16:31:42Z,2577,1,2022-03-18T16:31:43Z,0.8999999761581421,Chrome,99.0.4844.51,Windows NT 10.0,1920,1080,NA,1.7777777777777777,469,79,452,67,41,71,-0.4292542812211892,-0.21511523070614935,0.14635458907722876,-0.38428926733229946,-0.40878119877617386,-0.3082735979253192,3,3,2,2,3,1,2,4,1,3,3,2,3,1,3,3,3,1,3,4,0.6155870112510925,0,0,3,2,2,2.5,0,3,3,2,3,3,3,3,3,3,2,2,3,1,3,2,3,3,1,1,2,2,3,2,4,1,2,0,1,0,2,3,4,3,3,2,3,2,3,2,2,1,1,4,1,1,4,2,2,2,2,2,1,3,2,1,1,1,3,3,1,4,4,3,1,3,3,2,2,2,2,1.1455620071878747,0.7037315505489968,2.125,0,2,0,2.6,0,2.7777777777777777,0,2,0,1.6666666666666667,0,2.7142857142857144,0,2.3333333333333335,0,2.2972972972972974,0,2,0,0,0.1634178643886434,0.16253517528056266,0.16297651983460304,2,2,3,1,1,2,3,8,5,1.1126972805283737,2,0,6.5,1.7459615704359712,2,3,3,2,1,1,2,4,9,NA,6,1.1126972805283737,6.5,2,0,2.097241857094296,1,0.49699637072895086,2,1,2,1,2,5,5,5,5,4,4,5,5,4,5,5,5,4,4,3,1.709915063331955,1.6,0,4.6,0,4.6,0,4.4,0,4.533333333333333,0,2,1,2,2,1,3,1,4,2,2,2,4,2,2,1,4,1,3,1,2,0.7326950970650465,2.1,0,2,1,2,2,1,3,1,4,2,2,2,4,2,2,1,4,1,3,1,2,0.7326950970650465,2.1,0,"I lived with my mother, but not father, most of the time.",0,"White, Caucasian, Anglo, European American",0,29,0,1,NA,1,6,6,Self-employed,7,135,69,3,5,2,0,0,0,0,0,"I lived with my mother, but not father, most of the time.",0,TRUE,TRUE,TRUE,TRUE,TRUE,1,0.5180156249962747,0.4501903225760306,0.4826781249977648,0.5479714285816465,0.48802903226498634,0.5110344827462887,1,1,1,0.9032258064516129,0.96875,0.9354838709677419,0.042,0.418,0.71,0.05,1.923,35.81957781732156,1906.7801292616787,0.042,0.42,0.71,0.056,2.006,51.13123685011743,1895.150939244188,168,0.49777777777777776,0,3,0,3,6,FALSE
31,2022-03-18T16:13:19Z,2022-03-18T16:31:53Z,1114,1,2022-03-18T16:31:54Z,0.8999999761581421,Chrome,99.0.4844.74,Windows NT 10.0,1920,1080,NA,1.7777777777777777,498,73,275,65,31,67,-0.3697326259813962,-0.24818825614120446,-0.49579624328839883,-0.4089142813697004,-0.6135634582233127,-0.35320416280512285,2,2,1,1,2,1,1,2,1,2,2,1,1,1,2,2,1,1,2,2,1.025978352085154,0,1,2,4,4,1.5,0,3,1,2,2,1,2,3,3,3,2,3,3,3,3,3,2,3,1,1,2,2,1,2,1,2,0,0,0,0,2,3,2,3,3,2,2,2,2,2,2,3,1,2,2,3,3,4,3,3,3,3,1,1,1,3,1,1,2,2,1,2,1,2,1,1,3,1,2,2,2,1.1657010160666665,0.9154754164341269,1.75,0,1.75,0,2.466666666666667,0,2.3333333333333335,0,2.5833333333333335,0,1.6666666666666667,0,1.5714285714285714,0,1.6666666666666667,0,2.108108108108108,0,1,0,0,-0.14140231249026128,-0.14280879051279902,-0.14210555150153015,1,2,2,2,1,2,2,2,3,1.3972762620115438,1.7142857142857142,0,2.5,0.03420400632629733,5,5,5,5,5,5,5,1,3,6,4,1.5118578920369088,2,5,0,0.4863447753603363,0,1.1410309527179257,2,3,3,2,2,4,4,3,4,3,5,4,3,4,4,4,4,4,3,3,0.9611501047232549,2.4,0,4.2,0,3.4,0,3.6,0,3.7333333333333334,0,2,1,1,4,1,1,1,1,1,1,1,1,1,1,1,1,1,1,1,1,1.1002392084403616,1.2,0,2,1,1,4,1,1,1,1,1,1,1,1,1,1,1,1,1,1,1,1,1.1002392084403616,1.2,0,I lived with my mother and father an equal amount of time (joint custody),0,"White, Caucasian, Anglo, European American",0,25,0,1,NA,1,3,6,Analyst,5,160,69,3,5,2,0,0,1,0,0,I lived with my mother and father an equal amount of time (joint custody),0,TRUE,TRUE,TRUE,TRUE,TRUE,2,0.7082838709700492,0.5922517241362868,0.5357633333484332,0.7748451612880153,0.6267733333468437,0.638209999994437,1,1,1,0.96875,0.9375,0.9375,0.062,0.375,0.316,0.02,1.196,114.23607286102323,1994.0600955236046,0.062,0.375,0.314,0.016,1.253,132.93068633260717,2001.869000013048,362,1.0725925925925925,0,3,0,3,6,FALSE
32,2022-03-18T16:09:59Z,2022-03-18T16:32:17Z,1338,1,2022-03-18T16:32:19Z,0.8999999761581421,Chrome,99.0.4844.51,Macintosh,1440,900,NA,1.6,528,86,398,103,80,86,-0.30815849987126553,-0.1765300343652517,-0.04955583435635254,0.05896098534091724,0.38986961306766765,-0.13978397962605565,2,3,1,1,3,1,1,3,1,3,3,1,1,1,3,3,1,1,2,2,0.7451598203705946,0,0,1,3,3,1.85,0,4,3,1,3,1,1,3,1,1,1,3,4,2,3,3,1,5,1,1,2,3,2,3,3,2,0,0,0,0,2,2,2,2,3,1,1,2,3,2,3,5,1,5,1,4,2,3,5,4,2,4,1,1,2,2,2,1,3,2,3,3,1,1,1,2,3,2,3,1,1,1.319750636196756,0.9258200997725514,2.25,0,1.75,0,2.2666666666666666,0,2,0,3.0833333333333335,0,2,0,2,0,2,0,2.3513513513513513,0,2,0,0,0.09599719239573111,0.07635196034519101,0.08617457637046105,3,2,4,1,1,1,1,2,1,0.7867957924694432,1.8571428571428572,0,1.5,-0.2694328190817869,3,3,4,4,1,1,2,9,9,NA,1,1.3451854182690985,9,2.5714285714285716,0,0.19281052080600125,1,-0.3541474126208932,3,3,2,3,2,5,3,2,4,2,4,2,2,3,3,2,3,4,3,2,0.9411239481143202,2.6,0,3.6,0,2.4,0,2.8,0,2.933333333333333,0,2,1,1,3,1,1,2,3,1,1,1,2,1,1,1,2,1,2,1,2,0.6882472016116853,1.5,0,2,1,1,3,1,1,2,3,1,1,1,2,1,1,1,2,1,2,1,2,0.6882472016116853,1.5,0,I lived with my mother and father an equal amount of time (joint custody),0,"Asian or Asian American (e.g., Chinese, Japanese, and others)",0,25,1,2,NA,1,2,6,Educator,2,160,62,2,5,2,0,0,1,0,0,I lived with my mother and father an equal amount of time (joint custody),0,TRUE,TRUE,TRUE,TRUE,TRUE,2,0.5832250000000495,0.5178999999999796,0.4494812500000262,0.6122031249999854,0.5608133333333457,0.5411937500000058,1,1,1,1,0.967741935483871,1,0.098,0.326,0.705,0.026,1.937,62.635199429745285,1865.5973719790952,0.092,0.328,0.735,0.024,2.043,65.67567006907292,1849.920267810942,438,1.2977777777777777,0,3,0,3,6,FALSE
33,2022-03-18T16:04:36Z,2022-03-18T16:34:36Z,1799,1,2022-03-18T16:34:38Z,0.8999999761581421,Chrome,99.0.4844.74,Windows NT 10.0,1536,864,none,1.7777777777777777,546,250,393,91,34,363,-0.2712140242051871,0.7274659941929215,-0.06769568837798043,-0.08878909888348833,-0.552128780389171,2.971657638300344,3,3,2,2,3,2,3,3,2,4,4,3,1,2,3,3,3,1,4,4,0.6708203932499369,0,1,1,3,1,2.75,0,5,3,5,4,4,5,5,5,5,5,5,5,1,5,5,5,5,5,4,5,5,5,5,6,1,4,0,NA,NA,5,5,5,5,5,5,5,5,5,4,4,5,4,5,4,3,5,5,5,5,5,5,1,1,1,1,1,4,1,1,1,3,1,2,2,1,5,1,4,1,2,1.6608004871923232,1.889822365046136,4.875,0,2,0,4.466666666666667,0,5,0,4.5,0,1.6666666666666667,0,1.8571428571428572,0,2.6666666666666665,0,3.5135135135135136,0,3,NA,0,2.71241138741411,0.5870674448078739,1.649739416110992,1,1,1,3,1,1,1,8,6,1.9023794624226837,1.2857142857142858,0,7,1.524872286282011,5,5,5,5,4,3,4,3,1,5,4,1.2149857925879117,2,4.428571428571429,0,0.27226708483648426,0,0.7008326017473295,4,4,4,2,3,3,2,2,3,2,5,3,5,2,2,2,4,5,2,3,1.0600988273786194,3.4,0,4,0,2.6,0,2.4,0,3,0,2,2,2,3,2,3,2,4,1,2,1,3,2,1,1,4,2,3,4,3,0.8255779474818965,2.35,0,2,2,2,3,2,3,2,4,1,2,1,3,2,1,1,4,2,3,4,3,0.8255779474818965,2.35,0,"I lived with my father, but not mother, most of the time.",0,"White, Caucasian, Anglo, European American",0,24,0,2,NA,1,1,4,none,1,130,68,1,5,2,0,0,0,0,0,"I lived with my father, but not mother, most of the time.",0,TRUE,TRUE,TRUE,TRUE,TRUE,3,0.6284366666475931,0.8065031250417233,0.8537343750298023,0.7555037037001716,1.0356031250059605,1.3286551723809077,0.9375,1,1,0.84375,1,0.90625,0.091,0.521,0.144,0.042,1.881,368.2250963552514,2301.1642144734265,0.104,0.467,0.216,0.007,2.152,269.72964066996303,2180.4627354767003,304,0.9007407407407407,1,3,0,0,3,FALSE
34,2022-03-18T16:19:49Z,2022-03-18T16:35:16Z,927,1,2022-03-18T16:35:17Z,0.8999999761581421,Chrome,99.0.4844.74,Windows NT 10.0,1920,1080,"No, everything was fine.",1.7777777777777777,475,52,198,57,38,58,-0.41693945599916304,-0.3639438451638974,-0.7751499952214684,-0.5074143375193041,-0.4702158766103155,-0.454297933784681,1,2,2,2,1,1,1,2,1,1,2,2,3,1,1,2,1,3,1,2,1.142481141154959,0,1,2,4,4,1.6,0,1,1,2,1,1,1,1,1,1,1,1,1,2,1,2,1,2,1,1,1,1,1,1,1,2,0,0,0,0,1,3,1,2,1,2,1,1,2,2,2,1,2,1,2,1,1,1,2,3,2,1,1,1,1,3,2,1,1,1,1,1,1,1,1,1,1,1,1,1,1,1.6725122711948326,1.9073791542572855,1.125,0,1,0,1.2,0,1.5555555555555556,0,1.6666666666666667,0,1.5,0,1,0,1,0,1.4324324324324325,0,1,0,0,-1.2633413490555285,-0.4013584353189139,-0.8323498921872212,1,1,2,1,1,1,1,3,1,1.7320508075688772,1.1428571428571428,0,2,-0.49052210323574724,5,5,5,5,4,4,4,7,6,5,4,1.1126972805283737,6.5,4.571428571428571,0,1.0853622486444023,0,1.27388335982979,4,3,3,2,2,4,4,2,4,4,1,4,5,4,4,4,5,4,4,3,1.2344267996967353,2.8,0,3.6,0,4.2,0,3.4,0,3.7333333333333334,0,1,1,1,1,2,1,1,1,1,1,1,2,2,2,1,1,1,1,1,2,1.118033988749895,1.25,0,1,1,1,1,2,1,1,1,1,1,1,2,2,2,1,1,1,1,1,2,1.118033988749895,1.25,0,I lived with my mother and father an equal amount of time (joint custody),0,"White, Caucasian, Anglo, European American",0,21,0,1,NA,1,4,4,Software Engineer,5,150,70,1,5,2,0,0,1,0,0,I lived with my mother and father an equal amount of time (joint custody),0,TRUE,TRUE,TRUE,TRUE,TRUE,3,0.4041093749997672,0.39789687500009313,0.3858774193544542,0.5227466666661202,0.4398741935479545,0.4879233333339294,1,1,1,0.9375,1,0.9375,0.071,0.261,0.592,0.011,1.611,59.498372971729935,1922.4684898444755,0.072,0.261,0.608,0.012,1.684,70.37362142620259,1914.577952216318,434,1.285925925925926,0,3,0,0,3,FALSE
35,2022-03-18T16:18:48Z,2022-03-18T16:37:21Z,1113,1,2022-03-18T16:37:22Z,0.8999999761581421,Chrome,99.0.4844.74,Windows NT 10.0,3440,1440,NA,2.388888888888889,511,54,319,67,50,57,-0.34305050466700626,-0.35291950335221234,-0.3361655278980733,-0.38428926733229946,-0.22447716527374886,-0.46553057500463185,2,2,1,1,3,1,1,3,1,3,3,1,1,1,2,2,1,1,2,3,0.8506963092234007,0,0,1,2,1,1.75,0,5,5,4,5,5,5,5,5,5,5,3,5,2,5,5,3,5,5,2,3,5,5,5,1,1,2,1,0,0,5,5,5,5,5,5,5,5,5,5,5,5,3,5,1,4,5,5,5,5,5,5,4,5,3,5,4,3,1,1,1,5,5,5,1,4,5,1,1,1,3,1.8355842038352175,1.869555587629877,4.125,0,1.5,0,4.6,0,5,0,4.416666666666667,0,4.333333333333333,0,3,0,3.3333333333333335,0,4.1891891891891895,0,1,0,1,2.738198564147166,0.6755371084756299,1.7068678363113978,2,1,1,1,1,1,1,4,3,1.7320508075688772,1.1428571428571428,0,3.5,0.08923570049571344,1,2,4,2,1,1,1,6,2,1,1,1.6035674514745464,4,1.7142857142857142,0,-1.2554723046844734,0,-1.7015117883842854,5,5,5,5,5,2,1,3,3,5,1,1,4,1,1,1,4,4,1,5,1.6388149028228556,5,0,2.4,0,2.4,0,2.6,0,2.466666666666667,0,4,4,1,4,4,4,4,4,4,4,4,4,3,3,4,4,4,4,4,4,1.3088765773505315,3.75,0,4,4,1,4,4,4,4,4,4,4,4,4,3,3,4,4,4,4,4,4,1.3088765773505315,3.75,0,"I lived with my mother, but not father, most of the time.",0,"White, Caucasian, Anglo, European American",0,28,0,1,NA,1,1,4,unemployed,2,380,70,1,5,2,0,0,1,0,0,"I lived with my mother, but not father, most of the time.",0,TRUE,TRUE,TRUE,TRUE,TRUE,5,0.5655034482807949,0.5675250000022352,0.5994781250059604,0.5825655172405572,0.5952482758637132,0.6641724137807714,0.90625,1,1,0.9354838709677419,0.9354838709677419,0.90625,0.058,0.449,0.356,0.02,1.655,48.46480720853692,1960.0219342081634,0.057,0.448,0.383,0.017,1.635,64.82912295918958,1954.008007425507,382,1.1318518518518519,0,3,0,3,6,FALSE
36,2022-03-18T16:15:05Z,2022-03-18T16:38:51Z,1425,1,2022-03-18T16:38:52Z,0.8999999761581421,Chrome,99.0.4844.51,Windows NT 10.0,1600,900,NA,1.7777777777777777,597,88,314,186,66,78,-0.1665380098179649,-0.16550569255356667,-0.35430538191970123,1.0808990678930557,0.10317444984167329,-0.22964510938566288,1,1,1,1,1,1,1,1,1,1,1,1,2,1,1,1,1,1,1,1,1.5035046776746235,0,1,1,4,3,1.05,0,4,2,1,3,2,1,3,3,1,1,1,3,1,4,1,4,4,5,1,3,4,5,3,0,1,2,2,2,2,1,2,1,3,4,1,1,1,2,1,1,1,1,1,2,3,1,1,3,4,4,5,5,1,1,1,1,2,1,1,1,1,1,3,1,1,1,1,2,1,1,1.7071656083738376,1.2649110640673518,3.625,0,1.25,0,2.066666666666667,0,1.7777777777777777,0,1.9166666666666667,0,2.3333333333333335,0,1.4285714285714286,0,1,0,1.7837837837837838,0,0,2,2,0.361447633804322,2.671041921480386,1.516244777642354,1,1,1,1,1,1,2,1,3,1.889822365046136,1.1428571428571428,0,2,-0.49052210323574724,5,5,5,5,5,5,5,6,6,6,4,1.5118578920369088,6,5,0,1.2090960320784858,0,1.5815856723915158,2,4,3,2,4,4,3,3,4,4,3,2,2,5,4,3,4,4,5,1,1.121223821162776,3,0,3.4,0,3.4,0,3.4,0,3.4,0,2,1,2,1,2,2,3,1,2,1,3,1,1,1,1,1,1,1,1,2,1.1652874052533586,1.5,0,2,1,2,1,2,2,3,1,2,1,3,1,1,1,1,1,1,1,1,2,1.1652874052533586,1.5,0,I lived with my mother and father an equal amount of time (joint custody),0,"Asian or Asian American (e.g., Chinese, Japanese, and others)",0,23,0,1,NA,1,4,6,Researcher,6,190,69,5,5,2,0,0,2,0,0,I lived with my mother and father an equal amount of time (joint custody),0,TRUE,TRUE,TRUE,TRUE,TRUE,5,0.5453531250022352,0.5642937500048428,0.6520312500000001,0.5845064516144414,0.5262032258010679,0.7032483871021579,1,1,1,0.96875,1,1,0.061,0.482,0.378,0.049,1.709,110.92628503489361,1913.552867161037,0.062,0.484,0.401,0.037,1.808,120.41067535555301,1903.6063627008386,432,1.28,0,3,0,0,3,FALSE
37,2022-03-18T16:17:21Z,2022-03-18T16:39:03Z,1301,1,2022-03-18T16:39:04Z,0.8999999761581421,Chrome,99.0.4844.74,Macintosh,1440,900,NA,1.6,787,50,238,86,39,57,0.22343145554619614,-0.37496818697558243,-0.6300311630484453,-0.15035163397699064,-0.4497376506656016,-0.46553057500463185,2,1,1,1,2,1,1,2,1,2,2,1,1,1,2,2,1,1,2,2,1.0990426455975697,0,1,1,3,3,1.45,0,2,2,2,1,2,2,2,2,2,1,1,1,3,1,2,1,1,1,1,1,1,1,1,1,2,0,0,0,0,1,1,1,1,1,1,1,1,1,1,1,1,1,2,1,1,1,1,1,1,1,1,1,1,1,1,1,1,2,1,1,1,1,1,1,1,1,1,1,1,1,1.923850618213691,1.4375905768565218,1,0,1,0,1.7333333333333334,0,1,0,1.0833333333333333,0,1,0,1.1428571428571428,0,1,0,1.054054054054054,0,1,0,0,-1.2502509120116492,-0.4013584353189139,-0.8258046736652815,1,1,2,1,1,1,2,1,1,1.6761634196950514,1.2857142857142858,0,1,-0.7941589286438315,5,5,5,5,4,4,5,6,6,5,4,1.4638501094227998,6,4.714285714285714,0,0.9950183415546338,0,1.2962407183202633,2,2,2,2,2,4,4,4,5,4,5,5,4,5,4,5,5,4,3,4,1.505545305418162,2,0,4.6,0,4,0,4.4,0,4.333333333333333,0,1,1,2,1,1,2,2,2,1,1,2,2,1,1,1,1,2,2,1,2,0.9880869341680844,1.45,0,1,1,2,1,1,2,2,2,1,1,2,2,1,1,1,1,2,2,1,2,0.9880869341680844,1.45,0,I lived with my mother and father an equal amount of time (joint custody),0,"White, Caucasian, Anglo, European American",0,29,1,2,NA,1,4,7,Faculty Coordinator,5,145,65,3,5,2,0,0,1,0,0,I lived with my mother and father an equal amount of time (joint custody),0,TRUE,TRUE,TRUE,TRUE,TRUE,2,0.5189218750074506,0.4748406250178814,0.5004750000014901,0.6186781249865889,0.5832586206649912,0.5807374999895691,1,1,1,1,0.9354838709677419,1,0.111,0.344,0.756,0.014,1.554,43.43583773960337,1832.7827193676221,0.137,0.34,0.895,0.019,1.783,36.555700101145355,1823.479620768119,416,1.2325925925925925,0,3,0,0,3,FALSE
38,2022-03-18T15:48:50Z,2022-03-18T16:39:18Z,3027,1,2022-03-18T16:39:18Z,1,Chrome,99.0.4844.51,Windows NT 10.0,1536,864,No,1.7777777777777777,950,379,820,157,77,174,0.5579842074112396,1.4385360410466066,1.481447845069042,0.7238363643507423,0.328434935233526,0.8486884477296238,1,1,1,1,1,1,1,1,1,2,1,1,1,1,2,2,1,1,1,2,1.3803127029389886,0,0,2,4,4,1.2,0,5,1,2,2,2,1,2,2,1,1,1,1,3,1,1,1,1,1,1,1,1,1,1,0,2,0,0,0,0,1,1,1,1,1,1,1,1,1,1,2,1,1,2,1,1,1,1,1,1,1,1,1,1,1,2,1,2,1,1,1,1,1,1,1,1,1,1,1,1,1,1.8800357801208292,1.6987390281365427,1,0,1,0,1.7333333333333334,0,1,0,1.1666666666666667,0,1.1666666666666667,0,1.1428571428571428,0,1,0,1.1081081081081081,0,0,0,0,-1.2266290707294607,-0.6205191861769039,-0.9235741284531823,1,1,2,1,1,1,1,4,1,1.7320508075688772,1.1428571428571428,0,2.5,-0.29726950199192703,5,5,5,5,4,4,5,6,6,4,3,1.4638501094227998,6,4.714285714285714,0,0.4366725657692403,0,0.9558997442360183,1,1,1,1,1,4,2,4,4,3,5,4,4,4,4,4,5,4,2,2,1.162919151265879,1,0,4.4,0,3,0,3.6,0,3.6666666666666665,0,1,1,1,1,1,1,1,1,1,1,2,1,1,1,1,1,1,1,1,1,1.2258187382102494,1.05,0,1,1,1,1,1,1,1,1,1,1,2,1,1,1,1,1,1,1,1,1,1.2258187382102494,1.05,0,I lived with my mother and father an equal amount of time (joint custody),0,"Asian or Asian American (e.g., Chinese, Japanese, and others)",0,27,1,2,NA,1,3,7,Engineering,5,176,68,4,5,2,0,0,1,0,0,I lived with my mother and father an equal amount of time (joint custody),0,TRUE,TRUE,TRUE,TRUE,TRUE,3,1.00078125,0.8720483870986969,0.8988870967703481,1.045300000000745,0.9342096774155094,0.9707343750037253,1,1,1,1,0.96875,1,0.12,0.704,0.62,0.024,1.715,34.88458654075024,1838.4430118439402,0.121,0.706,0.619,0.026,1.773,44.20911203273117,1826.577243508185,304,0.9007407407407407,1,3,0,3,6,FALSE
39,2022-03-18T16:22:29Z,2022-03-18T16:40:37Z,1087,1,2022-03-18T16:40:38Z,0.8999999761581421,Chrome,99.0.4844.74,Windows NT 10.0,1920,1080,N/A,1.7777777777777777,485,74,269,81,47,59,-0.3964147472957862,-0.24267608523536194,-0.5175640681143523,-0.21191416907049299,-0.28591184310789053,-0.44306529256473004,1,1,1,1,1,1,2,1,1,1,2,1,1,1,1,2,1,1,2,1,1.3917047478769187,0,1,3,3,4,1.2,0,2,1,2,2,2,2,2,2,2,2,2,2,3,2,2,2,2,1,1,2,2,2,2,2,2,0,0,0,0,1,2,2,2,2,1,1,2,2,2,4,3,1,2,3,1,2,3,3,3,3,2,1,3,1,3,3,1,3,1,1,2,2,2,1,1,1,2,1,2,1,1.3439889531935545,1.0997835284835873,1.75,0,1.5,0,2,0,1.6666666666666667,0,2.5,0,2.1666666666666665,0,1.7142857142857142,0,1,0,1.972972972972973,0,1,0,0,-0.4043921454319573,-0.22899200544817064,-0.31669207544006395,1,1,3,1,1,1,1,1,1,1.5735915849388864,1.2857142857142858,0,1,-0.7941589286438315,5,5,5,4,3,3,4,1,1,3,2,1.2149857925879117,1,4.142857142857143,0,-1.02511228091384,0,-0.244841423238902,2,2,3,2,2,4,3,3,4,2,4,4,4,3,4,4,4,3,4,3,0.8338093878327919,2.2,0,3.8,0,3.4,0,3.4,0,3.533333333333333,0,1,1,1,1,2,1,1,1,1,1,1,2,1,2,1,2,1,2,1,1,1.0399898784932577,1.25,0,1,1,1,1,2,1,1,1,1,1,1,2,1,2,1,2,1,2,1,1,1.0399898784932577,1.25,0,I lived with my mother and father an equal amount of time (joint custody),0,"Hispanic of Latino (e.g., Mexican American, Central American, and others)",0,20,0,1,NA,1,3,3,Student,4,135,67,3,5,2,0,0,1,0,0,I lived with my mother and father an equal amount of time (joint custody),0,TRUE,TRUE,TRUE,TRUE,TRUE,6,0.5693612903225641,0.5043437499999928,0.5339935483870757,0.5920999999999806,0.51095806451612,0.5686838709677329,0.96875,1,1,0.967741935483871,0.96875,0.96875,0.077,0.34,0.403,0.065,1.686,87.59365495771155,1973.5515510895782,0.07,0.348,0.39,0.028,1.824,94.42188940266787,1920.1532971280183,304,0.9007407407407407,1,3,0,0,3,FALSE
40,2022-03-18T16:19:29Z,2022-03-18T16:40:50Z,1281,1,2022-03-18T16:40:51Z,0.8999999761581421,Chrome,99.0.4844.51,Macintosh,1792,1120,Thank you!,1.6,646,62,347,57,37,78,-0.06596693717141812,-0.30882213610547216,-0.2345823453769571,-0.5074143375193041,-0.4906941025550294,-0.22964510938566288,2,2,1,1,2,1,1,2,1,2,2,1,2,1,2,2,1,1,2,2,0.998683343734455,1,1,2,3,3,1.55,0,3,3,3,4,3,3,3,3,3,2,2,3,2,3,4,3,3,3,1,2,3,3,3,3,2,0,0,0,0,3,3,3,3,3,3,3,3,3,2,3,2,1,3,2,3,3,3,3,3,3,4,1,1,2,3,3,1,3,2,1,3,2,3,3,4,3,2,2,2,2,0.7652356405615107,0.4879500364742666,2.625,0,2,0,2.933333333333333,0,3,0,2.5833333333333335,0,2.3333333333333335,0,2.142857142857143,0,3.3333333333333335,0,2.6216216216216215,0,2,0,0,0.6693189651821758,0.16253517528056266,0.4159270702313692,3,3,4,2,2,3,3,1,1,0.5345224838248488,2.857142857142857,0,1,0.1173932192312856,2,2,2,2,1,1,2,7,1,2,2,1,4,1.7142857142857142,0,-0.69712652889908,0,-1.3611708143000405,3,3,3,3,3,3,4,2,3,3,5,2,3,3,4,4,4,4,4,3,0.9258200997725514,3,0,3.6,0,3.6,0,3,0,3.4,0,2,2,4,3,4,4,4,3,4,3,4,3,3,4,3,3,4,4,4,4,0.910465468000326,3.45,0,2,2,4,3,4,4,4,3,4,3,4,3,3,4,3,3,4,4,4,4,0.910465468000326,3.45,0,I lived with my mother and father an equal amount of time (joint custody),0,Black or African American,0,24,1,2,NA,1,2,4,Data Analyst,2,150,65,1,5,2,0,0,1,0,0,I lived with my mother and father an equal amount of time (joint custody),0,TRUE,TRUE,TRUE,TRUE,TRUE,1,0.7777709677426085,0.6299156250003726,0.7652437499989755,0.7912468749997206,0.6580125000011176,0.8894781250013039,1,1,1,1,1,1,0.123,0.342,0.307,0.01,1.535,46.30630534003377,1834.697358145834,0.123,0.353,0.313,0.012,1.567,51.821657083575474,1832.967297857831,460,1.3629629629629632,0,3,0,0,3,FALSE
42,2022-03-18T16:17:13Z,2022-03-18T16:44:11Z,1618,1,2022-03-18T16:44:12Z,0.8999999761581421,Chrome,99.0.4844.51,Macintosh,1440,900,NA,1.6,745,68,247,124,48,96,0.13722767899201316,-0.2757491106704171,-0.5973794258095151,0.317523632733627,-0.26543361716317665,-0.027457567426546634,2,3,2,1,2,1,1,2,1,2,3,1,1,1,3,3,1,1,2,3,0.8335087534664907,0,0,4,2,1,1.8,0,4,3,3,3,4,3,4,3,2,4,4,4,2,3,4,2,4,1,1,3,3,3,2,1,2,0,0,0,0,2,4,1,2,3,1,1,1,3,1,1,3,1,2,3,1,2,4,3,4,4,3,1,1,1,1,1,1,1,1,1,2,3,2,1,4,2,1,1,1,1,1.5117160068231352,0.7745966692414834,2.375,0,1,0,3.3333333333333335,0,2,0,2.4166666666666665,0,1.3333333333333333,0,1.5714285714285714,0,2.3333333333333335,0,1.972972972972973,0,1,0,0,0.4514074793539887,-0.4013584353189139,0.02502452201753741,1,1,3,2,1,1,3,3,3,1.4960264830861913,1.7142857142857142,0,3,0.22745660757011754,2,2,2,3,1,1,1,3,3,NA,3,1.3801311186847085,3,1.7142857142857142,0,-0.4005755510252112,1,-1.1804074718474937,4,4,3,3,4,3,3,2,2,1,5,4,3,3,4,4,5,5,3,4,1.245945806357946,3.6,0,4.4,0,2.8,0,3,0,3.4,0,2,1,2,4,1,3,3,4,4,1,3,4,2,3,3,4,3,3,1,2,0.998683343734455,2.65,0,2,1,2,4,1,3,3,4,4,1,3,4,2,3,3,4,3,3,1,2,0.998683343734455,2.65,0,I lived with my mother and father an equal amount of time (joint custody),0,"White, Caucasian, Anglo, European American",0,30,0,1,NA,0,3,5,Student/Security Officer,2,250,73,2,5,2,0,0,1,0,0,I lived with my mother and father an equal amount of time (joint custody),0,TRUE,TRUE,TRUE,TRUE,TRUE,5,0.5473812499921769,0.4657218749988824,0.5327968750037253,0.5997700000027816,0.5739129032300364,0.6080843749940396,1,1,1,0.9375,0.96875,1,0.275,0.206,0.821,0.018,1.463,47.98413208946047,1845.4611765988075,0.245,0.229,0.813,0.018,1.625,53.68516965487087,1839.4974057279717,438,1.2977777777777777,0,3,0,3,6,FALSE
43,2022-03-18T16:27:40Z,2022-03-18T16:44:30Z,1010,1,2022-03-18T16:44:31Z,0.8999999761581421,Chrome,99.0.4844.74,Windows NT 10.0,1280,720,NA,1.7777777777777777,449,53,202,53,32,66,-0.470303698627943,-0.35843167425805483,-0.7606381120041661,-0.5566643655941059,-0.5930852322785988,-0.3644368040250737,1,2,1,1,2,1,1,2,1,1,2,1,1,1,1,1,1,1,1,2,1.332784974957958,0,1,1,4,3,1.25,0,1,1,2,1,2,1,2,2,1,1,1,1,1,1,2,1,1,1,1,1,1,1,1,1,2,0,0,0,0,1,1,1,1,1,1,1,1,1,2,1,1,1,1,2,1,3,1,1,1,1,1,1,2,1,1,1,1,2,2,1,1,1,1,1,1,1,1,1,1,1,1.8688211504829702,1.791514389985135,1,0,1,0,1.3333333333333333,0,1,0,1.3333333333333333,0,1.1666666666666667,0,1.2857142857142858,0,1,0,1.1891891891891893,0,1,0,0,-1.3659979342943716,-0.4013584353189139,-0.8836781848066427,3,2,3,2,1,3,3,1,1,0.7867957924694432,2.4285714285714284,0,1,-0.13121191200738283,5,5,5,5,5,5,5,6,7,NA,3,1.5118578920369088,6.5,5,0,0.54803547341736,1,1.178634662066547,2,2,2,2,2,4,4,4,5,3,3,5,4,3,5,4,4,4,3,4,1.1872336794093274,2,0,4,0,3.6,0,4.2,0,3.933333333333333,0,2,1,2,3,2,2,2,3,4,2,1,3,2,3,1,3,1,3,2,3,0.7591546545162482,2.25,0,2,1,2,3,2,2,2,3,4,2,1,3,2,3,1,3,1,3,2,3,0.7591546545162482,2.25,0,I lived with my mother and father an equal amount of time (joint custody),0,"Asian or Asian American (e.g., Chinese, Japanese, and others) & Filipino",1,28,1,2,NA,0,1,6,unemployed,5,100,60,2,5,2,0,0,1,0,0,I lived with my mother and father an equal amount of time (joint custody),0,TRUE,TRUE,TRUE,TRUE,TRUE,4,0.46940645161223027,0.38555161290543694,0.4652687500002794,0.5346612903221,0.4292586206886275,0.524010000000894,0.96875,1,1,0.96875,0.90625,0.9375,0.055,0.362,0.579,0.019,1.6,14.780238111012737,1863.7638317372423,0.055,0.362,0.585,0.021,1.669,21.24721153744618,1864.674843237072,364,1.0785185185185184,0,3,0,0,3,FALSE
45,2022-03-18T16:28:32Z,2022-03-18T16:45:27Z,1014,1,2022-03-18T16:45:27Z,0.8999999761581421,Chrome,99.0.4844.51,Macintosh,1440,900,n/a,1.6,526,85,212,43,45,62,-0.31226344161194086,-0.18204220527109422,-0.7243584039609103,-0.6797894357811106,-0.3268682949973183,-0.40936736890487735,3,3,3,3,3,2,2,3,1,3,3,3,3,2,3,3,1,1,3,3,0.6048053188292994,0,0,3,4,4,2.55,0,2,2,4,2,4,3,2,3,2,2,3,2,3,2,3,2,3,1,1,1,2,2,2,1,2,0,0,0,0,2,2,2,2,3,1,2,3,2,2,2,3,2,2,3,1,3,3,3,4,4,2,1,1,1,3,1,2,1,1,1,2,4,3,1,1,1,2,1,1,1,1.3231593822177095,0.7367883976130072,1.75,0,1.25,0,2.6,0,2.111111111111111,0,2.6666666666666665,0,1.5,0,2,0,1,0,2.081081081081081,0,1,0,0,-0.0949460246352905,-0.3151752203835423,-0.2050606225094164,1,2,1,1,1,2,2,3,1,1.7182493859684491,1.4285714285714286,0,2,-0.324785349076635,5,4,4,4,2,2,3,8,7,5,3,1.1338934190276817,7.5,3.4285714285714284,0,0.9217819775623984,0,0.5547590352384761,3,3,3,3,3,3,4,3,3,2,5,3,3,2,3,3,3,4,3,3,0.7037315505489968,3,0,3.6,0,3,0,2.8,0,3.1333333333333333,0,3,3,4,2,3,4,4,2,1,3,2,2,3,3,1,2,2,2,2,3,0.8506963092234007,2.55,0,3,3,4,2,3,4,4,2,1,3,2,2,3,3,1,2,2,2,2,3,0.8506963092234007,2.55,0,I lived with my mother and father an equal amount of time (joint custody),0,"White, Caucasian, Anglo, European American",0,23,1,2,NA,1,3,6,Legal assistant,1,125,67,2,5,2,0,0,1,0,0,I lived with my mother and father an equal amount of time (joint custody),0,TRUE,TRUE,TRUE,TRUE,TRUE,3,0.5353999999997905,0.5069968749997206,0.5043312500005123,0.629989655172645,0.627171875,0.692066666666915,1,1,1,0.9354838709677419,1,0.9375,0.077,0.368,0.464,0.011,1.865,96.30085127119551,1965.556612047317,0.077,0.368,0.56,0.012,1.975,88.12831083151293,1934.8586960108996,416,1.2325925925925925,0,3,0,0,3,FALSE
46,2022-03-18T16:26:00Z,2022-03-18T16:45:34Z,1173,1,2022-03-18T16:45:34Z,0.8999999761581421,Chrome,99.0.4844.74,Windows NT 6.2,1366,768,Nothing,1.7786458333333333,573,67,259,76,27,98,-0.21579731070606947,-0.28126128157625957,-0.553843776157608,-0.2734767041639953,-0.6954763620021682,-0.004992284986644828,3,1,2,1,3,1,1,1,1,1,1,1,1,1,2,2,1,1,1,1,1.332784974957958,0,0,3,5,5,1.35,0,1,2,1,1,1,1,1,1,1,1,1,1,1,1,2,1,1,1,1,1,1,1,1,2,2,0,0,0,0,1,1,1,1,1,2,2,2,2,1,1,1,1,1,1,1,1,1,1,1,1,1,1,1,1,2,1,1,2,2,1,1,1,1,1,1,1,2,1,2,2,1.8046486518867757,1.9444671200491874,1,0,1.75,0,1.1333333333333333,0,1.4444444444444444,0,1,0,1.1666666666666667,0,1.2857142857142858,0,1,0,1.1891891891891893,0,1,0,0,-1.4533987470384682,-0.14280879051279902,-0.7981037687756336,2,1,2,1,1,1,1,1,1,1.4638501094227998,1.2857142857142858,0,1,-0.7941589286438315,5,5,5,5,3,3,5,8,6,3,3,1.5735915849388864,7,4.428571428571429,0,0.4032826894249255,0,0.7806934700831635,1,1,1,2,1,4,4,3,4,3,5,4,5,4,4,3,4,1,3,5,1.2798809468443688,1.2,0,3.6,0,3.6,0,4,0,3.7333333333333334,0,1,1,1,1,1,1,1,1,1,1,1,1,1,1,1,1,1,1,1,1,1.231174022502185,1,0,1,1,1,1,1,1,1,1,1,1,1,1,1,1,1,1,1,1,1,1,1.231174022502185,1,0,I lived with my mother and father an equal amount of time (joint custody),0,Black or African American,0,22,1,2,NA,1,3,6,Customer Service Representative,5,145,62,2,5,2,0,0,1,0,0,I lived with my mother and father an equal amount of time (joint custody),0,TRUE,TRUE,TRUE,TRUE,TRUE,3,0.6880937499701977,0.47356562495976684,0.4993290322519118,0.7439968750327826,0.5911903225760307,0.5985310344860472,1,1,0.96875,1,0.96875,0.9354838709677419,0.055,0.415,0.586,0.017,1.792,87.9162303721306,1978.4251885231579,0.055,0.416,0.595,0.017,1.789,101.6985238398854,1990.4769242156422,340,1.0074074074074075,0,3,0,0,3,FALSE
47,2022-03-18T16:17:27Z,2022-03-18T16:47:30Z,1803,1,2022-03-18T16:47:33Z,0.4000000059604645,Chrome,99.0.4844.74,Windows NT 10.0,1366,768,57d0badf28d5250001bdd9d2,1.7786458333333333,738,100,508,202,60,94,0.12286038289964935,-0.09935964168345643,0.3495209541194612,1.2778991801922632,-0.019694905826610026,-0.04992284986644844,1,2,1,2,1,1,2,3,2,3,3,2,1,1,2,3,2,1,3,3,0.8870412083230169,0,1,1,5,5,1.95,0,3,1,4,1,1,2,3,3,1,1,1,3,1,3,1,3,2,1,1,3,4,3,5,5,2,0,0,0,0,1,5,1,1,1,1,1,1,1,1,1,5,1,1,1,1,3,5,5,5,2,2,1,1,1,1,1,1,3,1,1,2,1,1,1,1,1,1,1,2,1,1.9058153457594291,1.533747356112131,2.75,0,1.25,0,1.9333333333333333,0,1.4444444444444444,0,2.5833333333333335,0,1.1666666666666667,0,1.4285714285714286,0,1,0,1.7297297297297298,0,3,0,0,-0.10281997172935338,0.12314628133243774,0.01016315480154218,1,1,1,1,1,1,1,1,1,1.9518001458970664,1,0,1,-0.9598956828029438,5,5,5,5,5,4,5,5,5,4,4,1.4960264830861913,5,4.857142857142857,0,0.6002528368512442,0,1.1330371796796288,1,2,1,1,1,5,3,5,5,3,5,4,5,3,5,5,5,5,3,5,1.533747356112131,1.2,0,4.8,0,3.8,0,4.6,0,4.4,0,1,1,1,1,1,1,1,1,1,1,1,1,1,1,1,1,1,1,1,1,1.231174022502185,1,0,1,1,1,1,1,1,1,1,1,1,1,1,1,1,1,1,1,1,1,1,1.231174022502185,1,0,I lived with my mother and father an equal amount of time (joint custody),0,"Hispanic of Latino (e.g., Mexican American, Central American, and others) & White, Caucasian, Anglo, European American",1,29,1,2,NA,1,2,3,server,2,132,63,1,5,2,0,0,1,0,0,I lived with my mother and father an equal amount of time (joint custody),0,TRUE,TRUE,TRUE,TRUE,TRUE,3,0.5251129032258666,0.46609062500006987,0.507680645161038,0.610375,0.5389034482759006,0.5958129032257824,0.96875,1,1,1,0.90625,0.96875,0.06,0.404,0.537,0.019,1.736,95.40330238571283,1958.836027673447,0.061,0.403,0.591,0.019,1.813,106.30050871222501,1937.240493124913,344,1.0192592592592593,0,3,0,0,3,FALSE
48,2022-03-18T16:26:01Z,2022-03-18T16:47:50Z,1308,1,2022-03-18T16:47:53Z,0.800000011920929,Firefox,98.0,Windows NT 10.0,1600,900,No comments. Thanks.,1.7777777777777777,488,103,274,49,46,203,-0.3902573346847731,-0.08282312896592887,-0.4994242140927244,-0.6059143936689079,-0.3063900690526044,1.1744350431082,3,3,2,2,2,1,2,2,1,2,3,1,2,3,2,1,1,1,4,2,0.9119095061289915,0,0,3,5,3,2,0,3,4,3,2,3,4,3,3,4,2,4,2,3,5,3,2,3,3,3,2,3,1,2,2,2,0,0,0,0,3,2,2,5,3,3,2,2,3,3,2,3,4,4,5,3,4,3,3,4,3,4,3,3,1,2,3,4,3,4,3,3,3,2,3,3,2,2,3,3,4,0.8621155625803557,0.8837151016885368,2.375,0,3,0,3.2,0,2.7777777777777777,0,3.4166666666666665,0,2.6666666666666665,0,3.142857142857143,0,2.6666666666666665,0,3.027027027027027,0,1,0,0,0.8537661758605959,0.2881072841640591,0.5709367300123275,3,3,3,3,4,4,2,1,1,0.6900655593423543,3.142857142857143,0,1,0.2831299733903977,3,3,3,3,3,2,3,6,6,2,4,0.3779644730092272,6,2.857142857142857,0,0.3527852699830773,0,-0.1017810330411974,1,1,1,1,1,3,4,2,3,1,3,3,2,3,4,3,3,1,4,2,0.9102589898327995,1,0,2.6,0,2.8,0,2.8,0,2.7333333333333334,0,2,3,4,2,2,2,3,3,2,2,3,1,1,1,1,2,1,1,1,1,1.0208355710680808,1.9,0,2,3,4,2,2,2,3,3,2,2,3,1,1,1,1,2,1,1,1,1,1.0208355710680808,1.9,0,"I lived with my mother, but not father, most of the time.",0,"White, Caucasian, Anglo, European American",0,30,1,2,NA,1,3,6,Student,3,109,65,3,5,2,0,0,1,0,0,"I lived with my mother, but not father, most of the time.",0,TRUE,TRUE,TRUE,TRUE,TRUE,5,0.6233225806451613,0.55603125,0.62909375,0.7048387096774194,0.6199032258064516,0.6895666666666667,1,1,1,1,1,1,0.194,0.342,0.673,0.032,1.564,30.72906297350508,1813.0656268963533,0.194,0.342,0.672,0.037,1.601,44.06708405324172,1826.2814582706587,328,0.9718518518518519,0,3,0,0,3,FALSE
50,2022-03-18T16:24:10Z,2022-03-18T16:48:14Z,1444,1,2022-03-18T16:48:15Z,1,Safari,15.3,Macintosh,1440,900,NA,1.6,767,147,279,71,34,76,0.18238203813944234,0.159712390891142,-0.4812843600710965,-0.3350392392574976,-0.552128780389171,-0.2521103918255647,3,3,1,1,3,1,2,3,1,3,3,1,1,2,3,3,2,1,4,3,0.5026246899500346,0,1,3,3,2,2.2,0,3,2,5,3,4,2,2,2,3,1,2,3,3,3,3,2,1,1,1,2,2,2,1,3,2,0,0,0,0,2,3,2,3,4,1,3,3,1,2,2,2,1,2,2,3,2,2,2,1,3,2,1,3,1,4,3,1,2,1,1,2,3,2,2,3,1,2,1,1,1,1.1892915598853018,1,1.5,0,1.25,0,2.7333333333333334,0,2.4444444444444446,0,2,0,2.3333333333333335,0,1.7142857142857142,0,2,0,2.108108108108108,0,2,0,0,-0.13411891142825327,-0.09601446952555226,-0.11506669047690277,2,1,4,2,1,1,2,2,1,1.0690449676496976,1.8571428571428572,0,1.5,-0.2694328190817869,3,3,3,3,2,2,3,6,7,2,2,0.4879500364742666,6.5,2.7142857142857144,0,-0.24540699345023656,0,-0.5438372253563432,2,2,2,2,1,4,5,4,3,3,4,4,3,4,3,4,4,4,4,4,1,1.8,0,4,0,3.8,0,3.6,0,3.8,0,2,1,2,2,3,1,1,2,1,2,3,3,2,3,1,3,1,2,1,2,0.7880689256524124,1.9,0,2,1,2,2,3,1,1,2,1,2,3,3,2,3,1,3,1,2,1,2,0.7880689256524124,1.9,0,"I lived with my mother, but not father, most of the time.",0,"White, Caucasian, Anglo, European American",0,25,1,1,NA,1,4,8,law associate,6,130,65,2,5,2,0,0,0,0,0,"I lived with my mother, but not father, most of the time.",0,TRUE,TRUE,TRUE,TRUE,TRUE,1,0.5367500000000036,0.47984375,0.5463437500000009,0.616031249999989,0.5723870967741916,0.6695937499999982,1,1,1,1,0.96875,1,0.117,0.317,0.498,0.013,1.529,55.230213275995936,1835.0713325910458,0.12,0.316,0.499,0.014,1.599,64.40332468759053,1848.6681624534947,420,1.2444444444444445,0,3,0,0,3,FALSE
51,2022-03-18T16:26:37Z,2022-03-18T16:50:45Z,1447,1,2022-03-18T16:50:47Z,0.8999999761581421,Firefox,98.0,Windows NT 10.0,2133,1200,I sneezed a few times during the game and couldn't see well,1.7775,708,51,332,98,47,75,0.06128625678951865,-0.3694560160697399,-0.2890019074418408,-0.002601549752585081,-0.28591184310789053,-0.2633430330455156,2,2,1,2,3,1,1,3,1,1,2,1,1,1,2,2,1,1,2,2,1.025978352085154,0,0,4,4,4,1.6,0,2,2,2,1,4,3,1,2,2,2,2,1,2,2,2,2,2,5,1,1,1,1,2,0,1,0,0,1,0,1,1,1,1,2,2,2,1,1,3,2,1,1,1,3,1,2,1,1,1,1,4,1,1,1,2,1,1,1,1,1,1,2,2,1,1,1,1,1,1,1,1.7093630164251017,1.2344267996967353,1.875,0,1,0,2,0,1.3333333333333333,0,1.5,0,1.6666666666666667,0,1.2857142857142858,0,1,0,1.4054054054054055,0,0,0,0,-0.5977959709298738,-0.6205191861769039,-0.6091575785533889,2,4,3,2,2,2,3,8,1,0.8997354108424374,2.5714285714285716,0,4.5,1.304424673778915,5,5,5,4,2,2,4,3,9,2,2,1.5118578920369088,6,3.857142857142857,0,-0.3357509005400053,0,0.020507022281833154,3,3,4,3,4,2,3,3,4,2,1,3,4,3,4,2,3,3,2,2,0.9154754164341269,3.4,0,2.4,0,2.6,0,3.2,0,2.7333333333333334,0,1,1,1,1,3,1,1,1,1,1,2,1,1,1,1,1,1,1,1,2,1.2396943596157715,1.2,0,1,1,1,1,3,1,1,1,1,1,2,1,1,1,1,1,1,1,1,2,1.2396943596157715,1.2,0,"I lived with my mother, but not father, most of the time.",0,"Hispanic of Latino (e.g., Mexican American, Central American, and others)",0,27,0,1,NA,1,3,6,Data Analyst,5,173,69,2,5,2,0,0,0,0,0,"I lived with my mother, but not father, most of the time.",0,TRUE,TRUE,TRUE,TRUE,TRUE,3,0.37078125,0.36346875,0.40228125,0.48974074074074075,0.43143478260869567,0.5100416666666666,1,1,1,0.84375,0.71875,0.7741935483870968,0.051,0.295,0.482,0.015,1.888,69.86357624325593,1934.8664316868499,0.056,0.291,0.557,0.015,1.984,80.493993465503,1929.6129398054297,325,0.9629629629629629,0,3,0,9,12,FALSE
52,2022-03-18T16:29:37Z,2022-03-18T16:51:22Z,1304,1,2022-03-18T16:51:22Z,0.8999999761581421,Chrome,99.0.4844.74,Windows NT 10.0,1280,720,NA,1.7777777777777777,637,83,351,57,39,85,-0.08443917500445733,-0.19306654708277926,-0.22007046215965478,-0.5074143375193041,-0.4497376506656016,-0.15101662084600656,2,2,1,1,2,1,1,2,1,2,4,1,1,1,1,2,1,1,2,3,1.0711528467275955,0,0,2,4,3,1.6,0,3,2,4,1,4,4,2,4,3,3,4,4,1,3,2,1,4,2,1,1,2,3,2,0,1,1,0,1,0,1,2,4,1,4,1,3,3,2,2,1,2,1,4,3,1,4,2,2,2,2,4,2,1,1,3,2,1,1,1,1,2,2,3,1,1,3,1,1,1,1,1.34566370643293,0.990430401872025,2,0,1,0,2.933333333333333,0,2.3333333333333335,0,2.1666666666666665,0,2.1666666666666665,0,1.5714285714285714,0,1.6666666666666667,0,2.054054054054054,0,0,0,0,0.14816209189389698,-0.6205191861769039,-0.2361785471415035,5,4,5,3,3,2,3,4,3,1.1338934190276817,3.5714285714285716,0,3.5,1.4979981108481673,1,5,5,5,5,5,4,1,1,2,2,1.7320508075688772,1,4.285714285714286,0,-1.2391899714376922,0,-0.29790628196113916,2,3,3,4,3,3,3,3,3,3,3,3,3,5,5,2,3,3,3,3,0.7237468644557459,3,0,3,0,2.8,0,3.8,0,3.2,0,2,1,4,4,1,4,3,4,4,1,2,4,1,2,1,3,1,4,2,3,1.190974832912761,2.55,0,2,1,4,4,1,4,3,4,4,1,2,4,1,2,1,3,1,4,2,3,1.190974832912761,2.55,0,I lived with my mother and father an equal amount of time (joint custody),0,"Hispanic of Latino (e.g., Mexican American, Central American, and others)",0,28,0,1,NA,1,2,6,educator,3,180,65,2,5,2,0,0,1,0,0,I lived with my mother and father an equal amount of time (joint custody),0,TRUE,TRUE,TRUE,TRUE,TRUE,4,0.5358499999940395,0.527921875,0.5470312500223518,0.6036935483947877,0.5487124999985099,0.6203838709785092,1,1,1,0.96875,1,1,0.121,0.345,0.63,0.017,1.573,6.884655463094286,1799.3209331915189,0.126,0.339,0.627,0.019,1.704,11.673501110544224,1793.5603968384291,356,1.0548148148148149,0,3,0,0,3,FALSE
53,2022-03-18T16:33:04Z,2022-03-18T16:51:38Z,1113,1,2022-03-18T16:51:39Z,0.8999999761581421,Chrome,99.0.4844.51,Windows NT 10.0,1280,720,NA,1.7777777777777777,536,61,319,43,24,61,-0.291738732908564,-0.3143343070113147,-0.3361655278980733,-0.6797894357811106,-0.7569110398363099,-0.4206000101248282,1,1,1,1,1,1,1,1,1,1,1,1,1,1,1,1,1,1,1,1,1.538967528127731,0,1,1,5,4,1,0,5,3,2,3,1,3,3,3,2,1,3,5,2,5,2,5,5,5,1,5,5,5,5,2,2,0,0,0,0,1,3,1,1,1,3,3,3,5,2,3,5,1,4,1,5,2,5,5,5,5,5,1,1,2,1,1,1,3,1,1,1,1,3,1,1,5,1,2,2,1,1.7005563477556078,1.01418510567422,4.5,0,1.5,0,2.8666666666666667,0,2.3333333333333335,0,3.5833333333333335,0,1.8333333333333333,0,1.5714285714285714,0,2.3333333333333335,0,2.5135135135135136,0,1,0,0,1.412324297845673,-0.22899200544817064,0.5916661461987511,1,1,2,1,1,1,1,1,1,1.7320508075688772,1.1428571428571428,0,1,-0.8770273057233877,5,5,5,5,5,5,5,8,7,6,4,1.5118578920369088,7.5,5,0,1.480127753347792,0,1.746793692269112,1,1,1,1,1,5,5,5,5,5,5,5,5,5,5,5,5,5,5,5,2.065591117977289,1,0,5,0,5,0,5,0,5,0,1,1,1,1,1,1,1,1,1,1,1,1,1,1,1,1,1,1,1,1,1.231174022502185,1,0,1,1,1,1,1,1,1,1,1,1,1,1,1,1,1,1,1,1,1,1,1.231174022502185,1,0,I lived with my mother and father an equal amount of time (joint custody),0,"White, Caucasian, Anglo, European American",0,29,1,2,NA,1,2,3,customer service representative,2,155,69,2,5,2,0,0,1,0,0,I lived with my mother and father an equal amount of time (joint custody),0,TRUE,TRUE,TRUE,TRUE,TRUE,5,0.438754838689681,0.41692187498509886,0.4017687500119209,0.49001724138753167,0.46270645160828866,0.4871551724096824,0.96875,1,1,0.90625,0.96875,0.90625,0.058,0.315,0.711,0.014,1.606,40.00983729052631,1910.6392458863502,0.058,0.315,0.728,0.015,1.668,60.882945411000875,1919.008845836485,392,1.1614814814814816,0,3,0,0,3,FALSE
54,2022-03-18T16:34:06Z,2022-03-18T16:53:07Z,1140,1,2022-03-18T16:53:07Z,0.8999999761581421,Firefox,98.0,Windows NT 10.0,1280,720,NA,1.7777777777777777,482,83,302,72,39,84,-0.40257215990679923,-0.19306654708277926,-0.39784103157160816,-0.32272673223879716,-0.4497376506656016,-0.16224926206595747,1,2,1,1,1,1,1,3,1,1,3,1,1,1,1,1,1,1,2,1,1.3611140947574412,0,1,1,4,4,1.3,0,2,1,1,1,1,1,2,1,1,1,1,1,3,2,1,1,1,1,1,1,2,1,1,2,2,0,0,0,0,1,4,1,2,1,1,4,3,1,1,1,1,1,3,1,1,2,2,2,2,2,2,1,1,1,1,1,1,2,2,1,1,1,1,1,1,1,2,2,2,2,1.6047040459458795,1.820517979665599,1.125,0,2,0,1.3333333333333333,0,2,0,1.5833333333333333,0,1.1666666666666667,0,1.2857142857142858,0,1,0,1.5135135135135136,0,1,0,0,-1.1696413786361817,-0.05662557557742737,-0.6131334771068045,1,1,3,1,1,3,2,1,1,1.4960264830861913,1.7142857142857142,0,1,-0.5455537974051633,5,5,5,5,2,2,3,4,4,2,2,1.4638501094227998,4,3.857142857142857,0,-0.69712652889908,0,-0.19977033755496199,2,2,2,3,2,4,5,3,4,3,5,4,5,4,4,5,4,5,4,4,1.3870146083619754,2.2,0,4.4,0,4.4,0,3.8,0,4.2,0,1,1,1,1,2,1,1,1,1,1,3,1,1,1,1,1,2,1,1,2,1.2258187382102494,1.25,0,1,1,1,1,2,1,1,1,1,1,3,1,1,1,1,1,2,1,1,2,1.2258187382102494,1.25,0,"I lived with my mother, but not father, most of the time. & I lived with my extended family on mother's side (grandparents, aunts ,uncles, cousins)",1,"White, Caucasian, Anglo, European American",0,30,1,2,NA,1,4,6,Cytotechnologist,6,160,65,3,5,2,0,0,1,0,0,"I lived with my mother, but not father, most of the time. & I lived with my extended family on mother's side (grandparents, aunts ,uncles, cousins)",1,TRUE,TRUE,TRUE,TRUE,TRUE,1,0.599875,0.54271875,0.5488125,0.7033548387096774,0.6355806451612903,0.6475625,1,1,1,1,1,1,0.116,0.381,0.682,0.009,1.278,73.72569783266867,1874.8736513359631,0.121,0.38,0.724,0.011,1.383,88.93005156105896,1873.402605783466,470,1.3925925925925926,0,3,0,0,3,FALSE
56,2022-03-18T16:32:41Z,2022-03-18T16:55:25Z,1363,1,2022-03-18T16:55:25Z,0.8999999761581421,Chrome,99.0.4844.51,Windows NT 10.0,1536,864,NA,1.7777777777777777,469,66,255,68,30,63,-0.4292542812211892,-0.2867734524821021,-0.5683556593749104,-0.371976760313599,-0.6340416841680265,-0.3981347276849264,2,2,2,1,2,1,1,2,1,1,3,1,1,1,2,2,1,1,2,2,1.050062654772261,0,1,1,3,3,1.55,0,3,2,2,2,2,3,3,3,2,2,2,4,2,3,2,2,5,1,1,4,5,4,4,1,2,0,0,0,0,1,5,4,4,5,2,3,1,3,2,1,3,1,4,2,2,2,5,5,5,3,4,1,1,1,2,1,1,2,2,1,3,4,2,1,1,3,2,2,2,2,1.4263711068773564,0.7988086367179802,3.25,0,2,0,2.466666666666667,0,3.111111111111111,0,2.9166666666666665,0,1.6666666666666667,0,2.142857142857143,0,1.6666666666666667,0,2.5135135135135136,0,1,0,0,0.691267592706876,-0.05662557557742737,0.31732100856472434,1,1,2,1,1,1,1,2,1,1.7320508075688772,1.1428571428571428,0,1.5,-0.6837747044795675,5,5,5,5,5,5,5,4,6,6,4,1.5118578920369088,5,5,0,1.0284082178989484,0,1.4714469924731182,3,2,3,3,3,3,2,5,4,2,3,3,2,4,4,3,4,3,3,3,0.8837151016885368,2.8,0,3.2,0,2.4,0,4,0,3.2,0,1,1,1,2,2,1,1,2,1,1,2,2,1,1,1,2,1,1,1,1,0.8271701918685112,1.3,0,1,1,1,2,2,1,1,2,1,1,2,2,1,1,1,2,1,1,1,1,0.8271701918685112,1.3,0,I lived with my mother and father an equal amount of time (joint custody),0,"White, Caucasian, Anglo, European American",0,22,1,2,NA,1,4,4,Pharmacy Intern,6,160,60,3,5,2,0,0,0,0,0,I lived with my mother and father an equal amount of time (joint custody),0,TRUE,TRUE,TRUE,TRUE,TRUE,1,0.5271258064546893,0.44159375000186263,0.4787249999959022,0.6188633333305518,0.4843766666710377,0.5484531250037253,0.96875,1,1,0.967741935483871,0.967741935483871,1,0.132,0.289,0.704,0.026,1.76,18.974385737331712,1807.1165280979292,0.132,0.289,0.716,0.025,1.84,28.827116253437623,1812.9428314814252,388,1.1496296296296296,0,3,0,3,6,FALSE
57,2022-03-18T16:35:47Z,2022-03-18T16:56:46Z,1259,1,2022-03-18T16:56:47Z,0.4000000059604645,Chrome,99.0.4844.51,Windows NT 10.0,1366,768,N/A,1.7786458333333333,615,73,280,57,32,88,-0.12959353415188649,-0.24818825614120446,-0.47765638926677095,-0.5074143375193041,-0.5930852322785988,-0.11731869718615386,3,3,2,1,3,1,1,3,1,3,4,1,1,2,3,3,1,1,3,3,0.5104177855340404,0,0,1,3,3,2.15,0,4,2,3,3,3,4,3,3,3,4,3,4,3,4,3,4,4,2,1,3,3,3,3,1,2,0,0,0,0,2,3,4,4,4,3,4,4,5,3,3,4,2,3,3,3,4,4,4,4,4,4,3,2,1,3,3,2,2,1,1,4,4,2,1,3,4,1,1,1,1,1.005988077470112,0.6546536707079771,2.875,0,1,0,3.2666666666666666,0,3.6666666666666665,0,3.4166666666666665,0,2.6666666666666665,0,2.2857142857142856,0,2.6666666666666665,0,3.081081081081081,0,1,0,0,1.125023653251058,-0.4013584353189139,0.36183260896607206,3,3,5,2,2,3,3,3,2,0.7867957924694432,3,0,2.5,0.7800194000423024,4,4,5,5,1,1,3,5,2,3,2,1.7043362064926932,3.5,3.2857142857142856,0,-0.5733927454649965,0,-0.43405491414093966,2,2,3,2,2,4,3,4,5,3,4,3,4,3,4,4,3,3,3,3,0.7367883976130072,2.2,0,3.4,0,3.4,0,3.8,0,3.533333333333333,0,2,1,2,2,2,3,3,3,1,3,2,3,2,2,1,3,2,3,1,3,0.7181848464596079,2.2,0,2,1,2,2,2,3,3,3,1,3,2,3,2,2,1,3,2,3,1,3,0.7181848464596079,2.2,0,I lived with my mother and father an equal amount of time (joint custody),0,"White, Caucasian, Anglo, European American",0,28,1,2,NA,1,3,6,Educational services,4,215,69,2,5,2,0,0,1,0,0,I lived with my mother and father an equal amount of time (joint custody),0,TRUE,TRUE,TRUE,TRUE,TRUE,5,0.48913548386866046,0.4435096774216621,0.4946031249994412,0.5206612903216192,0.48580322580664387,0.5713533333301545,1,1,1,1,1,0.967741935483871,0.071,0.346,0.467,0.025,1.883,123.01135699198468,1964.4228653410255,0.072,0.348,0.513,0.023,2.067,150.22181488607313,1980.4404661382132,244,0.7229629629629629,0,3,0,0,3,FALSE
58,2022-03-18T16:36:09Z,2022-03-18T16:56:49Z,1240,1,2022-03-18T16:56:50Z,0.8999999761581421,Chrome,99.0.4844.74,Macintosh,1280,800,NA,1.6,574,111,306,73,44,75,-0.21374483983573178,-0.03872576171918871,-0.38332914835430587,-0.3104142252200967,-0.34734652094203217,-0.2633430330455156,2,2,1,1,3,1,1,1,1,2,2,1,2,1,1,1,1,1,2,2,1.1821033884786185,0,0,4,3,3,1.45,0,3,2,2,2,2,2,2,1,2,1,1,1,2,1,1,1,2,1,1,1,2,2,1,0,2,0,0,0,0,1,2,1,1,1,1,1,1,2,1,1,1,1,1,1,1,1,1,1,2,2,1,1,1,1,2,1,1,1,1,1,1,1,1,1,2,1,1,1,1,1,1.849031886939465,1.505545305418162,1.375,0,1,0,1.6666666666666667,0,1.2222222222222223,0,1.1666666666666667,0,1.1666666666666667,0,1,0,1.3333333333333333,0,1.162162162162162,0,0,0,0,-1.0682643098001237,-0.6205191861769039,-0.8443917479885138,2,1,3,1,1,2,1,1,1,1.2149857925879117,1.5714285714285714,0,1,-0.6284221744847194,5,4,4,5,2,3,3,3,3,3,2,1.1126972805283737,3,3.7142857142857144,0,-0.6637366525547652,0,-0.25684415875112265,2,2,3,3,2,4,3,3,4,2,5,4,4,3,3,5,4,4,3,3,0.9154754164341269,2.4,0,4.2,0,3.4,0,3.2,0,3.6,0,2,2,1,1,2,1,1,2,1,1,2,1,2,1,1,2,1,1,1,1,1.019545822516343,1.35,0,2,2,1,1,2,1,1,2,1,1,2,1,2,1,1,2,1,1,1,1,1.019545822516343,1.35,0,I lived with my mother and father an equal amount of time (joint custody) & Prefer not to say.,1,"White, Caucasian, Anglo, European American",0,29,0,1,NA,1,2,6,Teacher,4,165,68,2,5,2,0,0,3,0,0,I lived with my mother and father an equal amount of time (joint custody) & Prefer not to say.,1,TRUE,TRUE,TRUE,TRUE,TRUE,6,0.7225593750006519,0.5936968750017695,0.6570125000006519,0.7617843749998138,0.7966750000012107,0.7519838709667805,1,1,1,1,1,1,0.086,0.465,0.441,0.017,1.744,33.04759452988152,1822.4976534534194,0.084,0.466,0.436,0.018,1.787,37.10328242712246,1821.9904531019006,316,0.9362962962962963,0,3,0,0,3,FALSE
60,2022-03-18T16:42:53Z,2022-03-18T16:58:46Z,953,1,2022-03-18T16:58:47Z,1,Chrome,99.0.4844.51,Macintosh,1440,900,NA,1.6,495,53,209,44,38,71,-0.37589003859240927,-0.35843167425805483,-0.735242316373887,-0.6674769287624102,-0.4702158766103155,-0.3082735979253192,1,1,1,1,1,1,1,1,1,1,1,1,1,1,1,1,1,1,1,1,1.538967528127731,0,1,1,5,5,1,0,3,2,3,2,3,3,2,4,3,2,3,2,3,3,3,2,3,1,1,1,2,3,3,4,2,0,0,0,0,2,2,2,2,2,1,1,1,2,1,2,4,1,2,1,2,1,4,4,4,2,3,1,4,1,3,2,1,3,4,3,2,1,2,1,1,1,1,2,2,2,1.4410331628996524,0.5936168397046637,2,0,1.75,0,2.7333333333333334,0,1.6666666666666667,0,2.3333333333333335,0,2.3333333333333335,0,2.2857142857142856,0,1,0,2.054054054054054,0,2,0,0,0.06076127914980008,0.07635196034519101,0.06855661974749555,1,1,1,1,1,1,1,1,1,1.9518001458970664,1,0,1,-0.9598956828029438,5,5,5,5,2,2,5,6,7,6,4,1.8126539343499315,6.5,4.142857142857143,0,1.2994399391682545,0,1.1720948216526836,4,4,4,3,3,3,5,3,3,4,4,5,3,4,4,4,4,4,3,3,0.9759000729485332,3.6,0,4,0,3.8,0,3.4,0,3.7333333333333334,0,2,2,1,2,3,2,2,2,1,2,2,2,1,2,2,2,2,2,2,1,0.6863327411532597,1.85,0,2,2,1,2,3,2,2,2,1,2,2,2,1,2,2,2,2,2,2,1,0.6863327411532597,1.85,0,I lived with my mother and father an equal amount of time (joint custody),0,"Asian or Asian American (e.g., Chinese, Japanese, and others)",0,21,1,2,NA,1,3,4,Student,6,154,72,4,5,2,0,0,1,0,0,I lived with my mother and father an equal amount of time (joint custody),0,TRUE,TRUE,TRUE,TRUE,TRUE,4,0.4765156250074506,0.4315156249850988,0.48867500000447034,0.5484899999936421,0.4867846154341331,0.5219666666543042,1,1,1,0.9375,0.8125,0.84375,0.051,0.341,0.361,0.024,1.982,80.21456144491853,1999.166206807889,0.05,0.342,0.362,0.029,2.062,103.21016345532982,2008.3160730232896,438,1.2977777777777777,0,3,0,3,6,FALSE
62,2022-03-18T16:39:49Z,2022-03-18T17:00:13Z,1224,1,2022-03-18T17:00:14Z,0.8999999761581421,Chrome,99.0.4844.51,Macintosh,1440,900,na,1.6,487,64,235,28,14,48,-0.3923098055551108,-0.2977977942937871,-0.640915075461422,-0.8644770410616176,-0.9616932992834487,-0.56662434598419,2,4,1,3,2,2,2,3,3,2,3,2,2,2,3,2,2,2,2,2,0.6569466853317864,0,1,2,5,4,2.3,0,2,2,2,2,2,1,1,2,2,2,1,2,2,2,2,2,2,3,2,2,2,2,2,1,1,1,0,0,0,2,2,1,2,2,2,3,2,2,2,2,1,1,2,4,2,4,2,2,3,4,3,3,3,2,3,3,1,2,2,1,1,1,1,2,2,1,2,2,2,2,1.2508255532105843,1.3020130933435712,2.125,0,2,0,1.8,0,2,0,2.4166666666666665,0,2.8333333333333335,0,1.2857142857142858,0,1.6666666666666667,0,2.108108108108108,0,1,0,0,-0.26886183107540174,-0.05662557557742737,-0.16274370332641455,2,1,3,1,1,1,1,1,1,1.2535663410560174,1.4285714285714286,0,1,-0.7112905515642753,4,4,4,4,3,3,4,6,6,3,3,0.7867957924694432,6,3.7142857142857144,0,0.22259487524538815,0,0.28342129791640636,3,3,3,3,3,4,3,3,3,4,3,3,4,3,3,3,3,3,2,3,0.5163977794943222,3,0,3.2,0,3.2,0,3,0,3.1333333333333333,0,2,3,2,3,2,3,3,2,2,2,2,2,3,2,2,3,2,2,2,2,0.47016234598162726,2.3,0,2,3,2,3,2,3,3,2,2,2,2,2,3,2,2,3,2,2,2,2,0.47016234598162726,2.3,0,"I lived with my mother, but not father, most of the time.",0,Black or African American,0,21,1,2,NA,1,3,6,retail,2,125,69,3,5,3,0,0,0,1,0,"I lived with my mother, but not father, most of the time.",0,TRUE,TRUE,TRUE,TRUE,TRUE,1,0.620903225806692,0.6089928571430168,0.5805258064512764,0.7734319999995828,0.7162374999995033,0.6654280000001193,0.96875,0.875,0.96875,0.8333333333333334,0.7741935483870968,0.8064516129032258,0.062,0.308,0.23,0.009,1.509,152.3027223600826,2126.332177564083,0.062,0.308,0.235,0.01,1.524,160.14090576774723,2105.575411134309,354,1.0488888888888888,0,3,0,0,3,FALSE
63,2022-03-18T16:43:26Z,2022-03-18T17:00:25Z,1019,1,2022-03-18T17:00:26Z,1,Chrome,98.0.4758.109,Macintosh,1440,900,n/a,1.6,477,49,311,48,33,52,-0.41283451425848766,-0.3804803578814249,-0.36518929433267794,-0.6182269006876083,-0.572607006333885,-0.5216937811043864,3,3,3,3,3,1,3,3,1,3,3,3,4,2,4,3,2,1,3,3,0.7880689256524124,0,0,3,1,1,2.7,0,4,3,3,4,4,3,4,3,2,3,2,3,3,4,4,2,2,1,1,1,1,1,1,0,2,0,0,0,0,3,3,3,3,4,2,2,2,2,2,2,1,1,2,3,1,3,1,1,1,1,2,1,1,1,3,2,2,1,3,1,5,2,3,2,3,1,2,1,3,2,1.23268792462631,0.6324555320336759,1.25,0,2,0,3.2666666666666666,0,2.6666666666666665,0,1.5833333333333333,0,1.6666666666666667,0,2.4285714285714284,0,2,0,2.054054054054054,0,0,0,0,-0.03392293465630426,-0.2757863264354174,-0.15485463054586082,3,3,4,4,3,3,4,6,3,0.6900655593423543,3.4285714285714284,0,4.5,1.8016349362562514,3,3,5,4,3,2,3,6,6,3,2,0.9511897312113419,6,3.2857142857142856,0,-0.12167321001615315,0,-0.1587082143449458,2,1,2,2,2,4,4,4,3,3,4,2,3,3,3,3,4,4,4,3,0.7432233529572065,1.8,0,3.6,0,3.4,0,3.2,0,3.4,0,3,1,2,3,3,2,2,3,1,1,3,2,2,2,1,2,1,1,1,2,0.7880689256524124,1.9,0,3,1,2,3,3,2,2,3,1,1,3,2,2,2,1,2,1,1,1,2,0.7880689256524124,1.9,0,I lived with my mother and father an equal amount of time (joint custody),0,"White, Caucasian, Anglo, European American",0,29,0,1,NA,1,3,6,Sports Reporter,3,175,70,3,5,2,0,0,1,0,0,I lived with my mother and father an equal amount of time (joint custody),0,TRUE,TRUE,TRUE,TRUE,TRUE,6,0.47419999999552964,0.44308125000819565,0.5306387096758811,0.5533107143087046,0.5337999999893123,0.6440709677357828,1,1,1,0.9032258064516129,0.90625,0.96875,0.071,0.373,0.468,0.012,1.502,41.088793776354905,1875.7169423716095,0.073,0.371,0.49,0.013,1.564,50.96834464155519,1878.7162527049827,358,1.0607407407407408,0,3,3,0,3,FALSE
64,2022-03-18T16:08:51Z,2022-03-18T17:00:52Z,3120,1,2022-03-18T17:00:53Z,1,Firefox,98.0,Windows NT 10.0,1920,1080,NA,1.7777777777777777,735,600,572,106,100,93,0.11670297028863627,2.6567258112378034,0.5817110855962984,0.09589850639701863,0.7994341319619453,-0.061155491086399345,2,2,1,1,2,1,1,2,1,2,3,1,1,2,1,2,1,1,3,2,1.025978352085154,0,0,1,4,4,1.6,0,2,2,1,2,1,1,1,1,1,1,1,2,1,1,2,1,1,5,1,1,1,1,1,2,2,0,0,0,0,2,1,1,1,2,2,3,3,3,1,2,1,1,1,1,1,1,2,2,2,1,5,1,1,1,2,1,1,2,1,1,1,1,1,1,1,1,1,1,1,1,1.5749541201192117,1.7265434778633235,1.5,0,1,0,1.3333333333333333,0,2,0,1.3333333333333333,0,1.8333333333333333,0,1.1428571428571428,0,1,0,1.5135135135135136,0,1,0,0,-1.0057648547410005,-0.4013584353189139,-0.7035616450299572,1,1,3,1,1,1,1,1,1,1.5735915849388864,1.2857142857142858,0,1,-0.7941589286438315,5,4,4,3,3,3,5,4,10,2,3,1.2535663410560174,7,3.857142857142857,0,0.18920499890107342,0,0.34049511911256714,3,2,3,3,2,4,2,3,3,3,5,2,5,3,3,3,2,5,3,1,1.0600988273786194,2.6,0,3.6,0,3.2,0,2.6,0,3.1333333333333333,0,1,1,2,3,2,2,2,3,1,2,2,3,2,2,1,3,2,2,1,2,0.4442616583193193,1.95,0,1,1,2,3,2,2,2,3,1,2,2,3,2,2,1,3,2,2,1,2,0.4442616583193193,1.95,0,"I lived with my father, but not mother, most of the time.",0,"Asian or Asian American (e.g., Chinese, Japanese, and others)",0,27,1,2,NA,1,4,2,piano accompanist,3,105,60,1,5,2,0,0,1,0,0,"I lived with my father, but not mother, most of the time.",0,TRUE,TRUE,TRUE,TRUE,TRUE,1,0.4587741935483871,0.39126666666666665,0.44593548387096776,0.5558461538461539,0.4573333333333333,0.54964,1,0.967741935483871,0.96875,0.8125,0.84375,0.78125,0.05,0.32,0.392,0.012,1.601,87.62198070103621,1990.2432041705179,0.051,0.319,0.412,0.013,1.737,100.38104518807579,1997.9994498632338,298,0.882962962962963,0,3,0,6,9,FALSE
65,2022-03-18T16:44:18Z,2022-03-18T17:01:40Z,1041,1,2022-03-18T17:01:40Z,0.8999999761581421,Chrome,99.0.4844.51,Macintosh,1280,800,NA,1.6,515,72,236,58,37,74,-0.3348406211856555,-0.253700427047047,-0.6372871046570965,-0.49510183050060363,-0.4906941025550294,-0.2745756742654665,2,3,1,1,3,3,2,4,1,3,4,1,1,2,3,4,2,2,4,4,0.6805570473787206,0,1,1,3,3,2.5,0,2,2,2,2,2,2,3,2,2,3,2,3,3,2,3,2,1,1,1,1,1,1,2,0,2,0,0,0,0,2,3,2,2,2,3,4,2,1,1,2,3,1,2,3,3,1,2,1,2,1,1,2,1,1,1,1,2,1,1,1,1,1,2,1,1,1,1,1,1,1,1.415274886021441,0.8338093878327919,1.25,0,1,0,2.3333333333333335,0,2.3333333333333335,0,1.8333333333333333,0,1.1666666666666667,0,1.2857142857142858,0,1,0,1.6756756756756757,0,0,0,0,-0.6071462831040733,-0.6205191861769039,-0.6138327346404886,1,1,3,1,1,1,1,1,1,1.5735915849388864,1.2857142857142858,0,1,-0.7941589286438315,5,5,5,5,2,3,5,7,7,6,4,1.7043362064926932,7,4.285714285714286,0,1.3897838462580232,0,1.304590860061554,4,4,3,3,4,2,3,3,2,2,4,2,3,3,3,1,3,3,3,3,0.7988086367179802,3.6,0,2.8,0,2.4,0,2.8,0,2.6666666666666665,0,1,3,4,4,3,4,2,4,4,1,2,4,2,4,1,4,1,4,4,3,1.3088765773505315,2.95,0,1,3,4,4,3,4,2,4,4,1,2,4,2,4,1,4,1,4,4,3,1.3088765773505315,2.95,0,I lived with my mother and father an equal amount of time (joint custody),0,Black or African American,0,25,0,1,NA,1,4,4,Warehouse worker,6,195,71,1,5,2,0,0,0,0,0,I lived with my mother and father an equal amount of time (joint custody),0,TRUE,TRUE,TRUE,TRUE,TRUE,3,0.4658935483847895,0.4624533333301544,0.4771968750031665,0.5395806451564835,0.5069466666648785,0.53515,1,1,1,0.96875,0.9375,1,0.087,0.32,0.547,0.015,1.293,28.190638659054784,1829.4843026347571,0.089,0.321,0.561,0.017,1.345,43.00615861750992,1825.5300032292057,380,1.125925925925926,0,3,0,0,3,FALSE
66,2022-03-18T16:42:50Z,2022-03-18T17:02:13Z,1163,1,2022-03-18T17:02:14Z,1,Opera,84.0.4316.31,Macintosh,1440,900,N/A,1.6,546,66,291,55,46,95,-0.2712140242051871,-0.2867734524821021,-0.43774871041918956,-0.532039351556705,-0.3063900690526044,-0.03869020864649754,2,2,3,3,2,2,2,3,2,2,2,3,3,3,2,3,3,2,3,2,0.4893604849295929,0,1,1,4,3,2.45,0,3,2,3,2,3,3,2,2,2,2,2,3,2,2,2,2,3,1,1,1,2,1,1,1,1,3,0,2,0,2,2,1,2,2,1,1,1,1,2,2,2,2,2,2,2,3,2,3,4,4,2,1,1,1,3,2,1,1,1,1,1,2,2,1,1,1,2,2,2,2,1.5002502293786697,0.8451542547285166,1.5,0,2,0,2.3333333333333335,0,1.4444444444444444,0,2.5,0,1.6666666666666667,0,1.2857142857142858,0,1,0,1.7567567567567568,0,1,0,0,-0.4624625052506699,-0.05662557557742737,-0.25954404041404866,2,2,2,4,2,2,2,2,2,1.0690449676496976,2.2857142857142856,0,2,0.1724249134007015,5,5,5,5,3,3,4,7,8,6,4,1.2909944487358056,7.5,4.285714285714286,0,1.480127753347792,0,1.3596602000207527,3,3,3,2,2,3,4,4,4,3,4,3,4,2,4,4,3,4,3,3,0.7237468644557459,2.6,0,3.4,0,3.6,0,3.4,0,3.466666666666667,0,3,1,1,3,3,1,3,3,1,2,1,2,2,2,1,2,1,2,2,2,0.7880689256524124,1.9,0,3,1,1,3,3,1,3,3,1,2,1,2,2,2,1,2,1,2,2,2,0.7880689256524124,1.9,0,I lived with my mother and father an equal amount of time (joint custody),0,"Asian or Asian American (e.g., Chinese, Japanese, and others)",0,22,1,2,NA,1,3,6,Research Assistant,2,117,65,3,5,2,0,0,2,0,0,I lived with my mother and father an equal amount of time (joint custody),0,TRUE,TRUE,TRUE,TRUE,TRUE,6,0.674754838689681,0.5193258064254638,0.5191000000046145,0.6442035714217594,0.5996933333396911,0.5849793103645587,1,1,1,0.875,0.9375,0.90625,0.059,0.349,0.356,0.012,1.402,80.13804098151735,1991.7966249437577,0.059,0.349,0.356,0.012,1.437,110.78023405723444,1994.7662465354178,432,1.28,0,3,0,3,6,FALSE
67,2022-03-18T16:37:09Z,2022-03-18T17:02:44Z,1534,1,2022-03-18T17:02:48Z,1,Edge,99.0.1150.39,Windows NT 10.0,1366,768,n/a,1.7786458333333333,549,125,529,97,67,83,-0.26505661159417404,0.038444630962606564,0.4257083410102984,-0.014914056771285544,0.12365267578638717,-0.17348190328590837,1,2,1,1,1,1,2,3,1,3,2,1,1,1,2,2,2,1,2,2,1.0711528467275955,1,1,1,3,3,1.6,0,3,3,2,2,1,1,3,3,2,1,2,3,2,3,3,4,4,3,1,2,3,3,2,5,2,0,0,0,0,2,3,3,2,2,1,3,2,2,2,2,2,2,3,2,4,3,3,2,3,3,3,2,4,1,4,4,2,5,3,1,2,2,2,3,3,2,2,2,3,2,1.0134234194190634,0.9102589898327995,2.75,0,2.25,0,2.2666666666666666,0,2.2222222222222223,0,2.5833333333333335,0,3,0,2.4285714285714284,0,2.6666666666666665,0,2.5405405405405403,0,3,0,0,0.3971756687436318,0.46787914107392425,0.43252740490877806,2,1,4,2,1,1,1,1,1,1.1126972805283737,1.7142857142857142,0,1,-0.5455537974051633,3,3,3,3,2,2,2,3,3,2,2,0.6900655593423543,3,2.5714285714285716,0,-0.8778143430786174,0,-1.0067493035204065,2,2,2,1,1,4,4,4,4,3,4,3,4,4,4,4,3,4,3,3,0.7988086367179802,1.6,0,3.6,0,3.6,0,3.8,0,3.6666666666666665,0,1,2,2,3,3,2,3,3,3,1,2,2,3,3,1,2,1,2,1,1,0.8255779474818965,2.05,0,1,2,2,3,3,2,3,3,3,1,2,2,3,3,1,2,1,2,1,1,0.8255779474818965,2.05,0,"I lived with my mother, but not father, most of the time.",0,"White, Caucasian, Anglo, European American",0,29,0,1,NA,1,1,6,disabled,1,145,72,3,5,2,0,0,1,0,0,"I lived with my mother, but not father, most of the time.",0,TRUE,TRUE,TRUE,TRUE,TRUE,4,0.625438709666652,0.6262125000040978,0.748028124999255,0.715453125,0.6122687499970197,0.8122733333329359,1,1,1,1,1,0.967741935483871,0.088,0.392,0.259,0.04,1.248,89.92700409000958,1937.1892787906484,0.084,0.399,0.258,0.012,1.375,76.2670527399362,1900.2495964013376,304,0.9007407407407407,1,3,0,0,3,FALSE
68,2022-03-18T16:47:20Z,2022-03-18T17:03:30Z,969,1,2022-03-18T17:03:32Z,0.8999999761581421,Chrome,99.0.4844.51,Macintosh,1440,900,NA,1.6,469,42,232,49,30,106,-0.4292542812211892,-0.41906555422232256,-0.6517989878743987,-0.6059143936689079,-0.6340416841680265,0.0848688447729624,2,2,1,1,2,1,1,2,1,2,2,1,1,1,2,2,3,1,2,2,1.0208355710680808,0,1,1,4,4,1.6,0,4,2,3,2,3,2,2,2,1,1,2,2,2,2,2,2,3,1,1,1,2,2,1,2,2,0,0,0,0,1,1,1,1,1,1,1,1,1,1,1,1,1,1,1,1,2,1,3,2,2,2,1,1,1,3,3,1,3,1,1,1,1,1,1,1,1,1,1,2,1,1.8125355955912383,1.1464230084422218,1.625,0,1.25,0,2.1333333333333333,0,1,0,1.4166666666666667,0,1.8333333333333333,0,1.2857142857142858,0,1,0,1.3243243243243243,0,1,0,0,-0.6842125402872127,-0.3151752203835423,-0.4996938803353775,2,1,3,1,1,2,1,3,3,1.2149857925879117,1.5714285714285714,0,3,0.1445882304905615,5,5,5,5,2,2,3,6,6,5,3,1.4638501094227998,6,3.857142857142857,0,0.6507502562930925,0,0.6218311107098957,2,2,2,2,2,4,4,4,4,3,5,4,5,4,4,5,3,5,4,3,1.2421180068162376,2,0,4.2,0,4.2,0,3.8,0,4.066666666666666,0,1,2,1,1,1,1,2,2,1,1,1,2,1,1,1,2,1,2,1,1,0.9403246919632545,1.3,0,1,2,1,1,1,1,2,2,1,1,1,2,1,1,1,2,1,2,1,1,0.9403246919632545,1.3,0,I lived with my mother and father an equal amount of time (joint custody),0,"White, Caucasian, Anglo, European American",0,21,1,3,NA,1,3,4,University student,1,130,66,2,5,2,0,0,1,0,0,I lived with my mother and father an equal amount of time (joint custody),0,TRUE,TRUE,TRUE,TRUE,TRUE,3,0.526421875,0.5147906250040978,0.5360406250078231,0.6102806451628285,0.5645124999992549,0.6163312500026077,1,1,1,0.96875,1,1,0.211,0.274,0.807,0.016,1.462,9.682005554699805,1799.2227889439407,0.201,0.285,0.811,0.018,1.562,18.306645152549216,1801.6325263299811,453,1.3422222222222222,0,3,0,0,3,FALSE
69,2022-03-18T16:43:12Z,2022-03-18T17:05:07Z,1314,1,2022-03-18T17:05:08Z,0.8999999761581421,Chrome,99.0.4844.74,Windows NT 10.0,1536,864,NA,1.7777777777777777,580,81,290,43,64,92,-0.20143001461370563,-0.2040908888944643,-0.44137668122351514,-0.6797894357811106,0.062217997952245516,-0.07238813230635024,2,2,2,2,2,1,2,2,1,2,3,1,2,2,2,2,2,1,2,3,0.7677718959499145,0,0,3,3,2,1.9,0,2,2,2,2,2,1,2,2,2,2,2,2,3,2,3,2,2,1,1,1,1,1,2,2,2,0,0,0,0,2,3,3,4,4,3,4,3,3,2,3,1,1,3,2,4,3,2,3,1,2,3,3,1,2,2,2,2,1,1,2,2,2,2,2,2,2,2,2,2,2,0.7960110763259728,1.0600988273786194,1.375,0,2,0,2.066666666666667,0,3.2222222222222223,0,2.25,0,2.1666666666666665,0,1.7142857142857142,0,2,0,2.3513513513513513,0,1,0,0,-0.37378217610378806,-0.05662557557742737,-0.2152038758406077,2,2,4,2,1,2,2,3,1,0.8997354108424374,2.142857142857143,0,2,0.08955653632114546,3,4,4,3,3,2,3,5,3,2,2,0.6900655593423543,4,3.142857142857143,0,-0.69712652889908,0,-0.5869038298033216,2,2,2,2,2,4,3,4,3,2,2,2,3,2,3,4,2,2,3,3,0.7237468644557459,2,0,2.4,0,3,0,3,0,2.8,0,2,2,2,2,2,2,2,3,3,2,2,3,3,2,2,3,1,2,2,3,0.4893604849295929,2.25,0,2,2,2,2,2,2,2,3,3,2,2,3,3,2,2,3,1,2,2,3,0.4893604849295929,2.25,0,I lived with my mother and father an equal amount of time (joint custody),0,"White, Caucasian, Anglo, European American",0,28,0,1,NA,1,2,6,IT Associate,2,149,65,1,5,2,0,0,0,0,0,I lived with my mother and father an equal amount of time (joint custody),0,TRUE,TRUE,TRUE,TRUE,TRUE,5,0.5463516129032379,0.587981250000128,0.6313419354837988,0.6030700000002359,0.6269937499998487,0.690983870967802,1,1,0.96875,0.967741935483871,1,0.96875,0.062,0.378,0.214,0.088,1.644,192.6553005517738,2106.331477167364,0.067,0.364,0.244,0.042,1.699,199.08391770287162,2066.781878741251,541,1.6029629629629631,0,3,0,3,6,FALSE
70,2022-03-18T16:45:34Z,2022-03-18T17:05:50Z,1216,1,2022-03-18T17:05:52Z,0.8999999761581421,Chrome,99.0.4844.74,Windows NT 10.0,1536,864,NA,1.7777777777777777,693,69,242,56,30,73,0.0304991937344533,-0.2702369397645745,-0.615519279831143,-0.5197268445380046,-0.6340416841680265,-0.2858083154854174,2,2,1,1,1,1,1,3,1,2,1,1,1,1,1,2,1,1,1,1,1.3218806379747876,0,1,3,4,4,1.3,0,2,2,2,1,4,3,1,2,1,1,1,2,2,1,1,2,3,5,1,1,2,1,1,0,2,0,0,0,0,1,1,1,1,1,1,1,1,1,3,1,1,1,1,1,1,1,1,2,2,2,4,1,5,5,2,3,1,1,1,1,1,1,1,1,1,1,2,1,1,1,1.8583469679942586,1.5675276256394517,2,0,1.25,0,1.7333333333333334,0,1,0,1.4166666666666667,0,3.3333333333333335,0,1,0,1,0,1.5135135135135136,0,0,0,0,-0.6124611973925657,-0.5343359712415323,-0.573398584317049,5,5,5,3,5,5,3,4,1,1.7994708216848747,4.428571428571429,0,2.5,1.6087031708378634,4,4,4,4,1,3,3,6,7,2,3,1.1126972805283737,6.5,3.2857142857142856,0,0.09886109181130473,0,-0.024281014645319364,2,2,2,2,2,4,4,4,5,1,5,3,3,5,3,5,4,4,5,3,1.3972762620115438,2,0,4,0,3.6,0,4,0,3.8666666666666667,0,2,1,1,1,1,1,1,1,1,1,1,1,1,1,1,1,1,1,1,1,1.2258187382102494,1.05,0,2,1,1,1,1,1,1,1,1,1,1,1,1,1,1,1,1,1,1,1,1.2258187382102494,1.05,0,"I lived with my mother, but not father, most of the time.",0,"White, Caucasian, Anglo, European American",0,18,1,2,NA,1,3,4,Student --- part time job at campus gym front desk,3,130,66,4,5,2,0,1,0,0,1,"I lived with my mother, but not father, most of the time.",0,TRUE,TRUE,TRUE,TRUE,TRUE,6,0.5177593749761581,0.49789062498509884,0.4808218750357628,0.5965724138227002,0.5481884615237896,0.5881071428741728,1,1,1,0.9354838709677419,0.8387096774193549,0.875,0.058,0.354,0.462,0.006,1.262,51.7321212494296,1970.0543701390363,0.058,0.354,0.478,0.006,1.189,65.43733367405785,1963.2355629248034,376,1.114074074074074,0,3,0,0,3,FALSE
71,2022-03-18T16:30:29Z,2022-03-18T17:05:53Z,2124,1,2022-03-18T17:05:54Z,0.8999999761581421,Chrome,99.0.4844.51,Windows NT 6.3,1366,768,Fun study!,1.7786458333333333,807,163,510,128,104,143,0.2644808729529499,0.2479071253846223,0.3567768957281124,0.3667736608084288,0.8813470357408009,0.5004765699111458,1,1,1,1,1,1,1,1,1,1,1,1,1,1,1,1,1,1,1,1,1.538967528127731,0,0,2,3,2,1,0,3,1,1,1,1,1,3,2,1,1,2,1,3,2,2,1,3,1,1,2,3,2,2,0,2,0,0,0,0,1,1,3,2,3,1,1,1,1,2,1,2,1,2,3,3,3,2,2,3,2,3,2,1,1,4,1,1,1,4,2,5,2,2,1,1,1,1,2,1,4,1.4694077579620841,1.5796322658258457,1.875,0,2,0,1.6666666666666667,0,1.5555555555555556,0,2.1666666666666665,0,2,0,2.4285714285714284,0,1,0,1.945945945945946,0,0,0,0,-0.507245579348152,-0.2757863264354174,-0.39151595289178465,1,1,2,1,1,1,1,2,1,1.7320508075688772,1.1428571428571428,0,1.5,-0.6837747044795675,5,5,5,4,3,2,4,4,7,4,4,1.3801311186847085,5.5,4,0,0.6905967439410129,0,0.7235463289407964,2,2,2,3,2,4,4,4,5,3,5,4,3,4,4,5,5,5,4,3,1.3732131246511903,2.2,0,4.6,0,3.8,0,4,0,4.133333333333334,0,1,1,1,1,2,1,4,2,2,2,4,3,1,1,1,3,1,1,1,2,1.0894228312566052,1.75,0,1,1,1,1,2,1,4,2,2,2,4,3,1,1,1,3,1,1,1,2,1.0894228312566052,1.75,0,I lived with my mother and father an equal amount of time (joint custody),0,Black or African American,0,24,1,2,NA,1,2,4,Preschool Teacher,1,180,65,3,5,2,0,0,1,0,0,I lived with my mother and father an equal amount of time (joint custody),0,TRUE,TRUE,TRUE,TRUE,TRUE,5,0.6805874999761582,0.5735781249403954,0.6803562499284744,0.7489290320488714,0.6531156249642373,0.792200000166893,1,1,1,0.96875,1,1,0.118,0.417,0.47,0.006,1.138,54.19838724389918,1850.6147221790395,0.124,0.415,0.463,0.008,1.201,78.05135740699745,1860.9715326343974,344,1.0192592592592593,0,3,0,0,3,FALSE
72,2022-03-18T16:51:35Z,2022-03-18T17:07:14Z,938,1,2022-03-18T17:07:15Z,0.8999999761581421,Chrome,99.0.4844.51,Macintosh,1440,900,NA,1.6,434,63,199,48,40,58,-0.5010907616830084,-0.30330996519962966,-0.7715220244171429,-0.6182269006876083,-0.42925942472088774,-0.454297933784681,2,1,1,1,2,1,3,3,1,1,3,1,1,1,2,2,2,1,3,2,1.0711528467275955,0,1,1,4,5,1.7,0,3,1,4,1,4,2,3,3,1,3,5,3,2,4,2,2,4,1,1,3,4,2,5,4,2,0,0,0,0,2,1,1,1,1,2,5,1,4,4,2,4,1,2,1,1,1,5,5,5,5,1,1,1,1,3,1,1,3,4,1,2,3,1,1,1,3,2,1,2,2,1.7058458048457692,1.2227992865708155,2.75,0,1.75,0,2.7333333333333334,0,2,0,3,0,1.3333333333333333,0,2.142857142857143,0,1.6666666666666667,0,2.2162162162162162,0,2,0,0,0.4593798507867277,0.07635196034519101,0.26786590556595935,2,2,3,1,1,2,1,1,1,1.1547005383792515,1.7142857142857142,0,1,-0.5455537974051633,5,5,5,5,5,5,5,6,8,6,4,1.5118578920369088,7,5,0,1.3897838462580232,0,1.6917243523099135,3,4,3,3,3,2,5,4,4,5,5,5,5,5,5,5,5,5,5,5,1.8973665961010275,3.2,0,4.4,0,5,0,4.6,0,4.666666666666667,0,3,3,3,3,4,3,3,3,3,4,3,1,2,1,1,1,2,3,2,3,0.910465468000326,2.55,0,3,3,3,3,4,3,3,3,3,4,3,1,2,1,1,1,2,3,2,3,0.910465468000326,2.55,0,I lived with my mother and father an equal amount of time (joint custody),0,"White, Caucasian, Anglo, European American",0,24,1,2,NA,1,3,6,Writer/Director,5,145,68,5,5,2,0,0,1,0,0,I lived with my mother and father an equal amount of time (joint custody),0,TRUE,TRUE,TRUE,TRUE,TRUE,5,0.44041875000018627,0.43377812499925494,0.4494374999953434,0.5404037037006131,0.5231354838696218,0.5365483870967742,1,1,1,0.84375,1,0.96875,0.075,0.332,0.645,0.021,1.937,81.16202996255645,1925.279702591768,0.075,0.343,0.724,0.022,2.005,74.20275687405555,1900.1126209585016,394,1.1674074074074074,0,3,0,0,3,FALSE
73,2022-03-18T16:17:04Z,2022-03-18T17:08:08Z,3063,1,2022-03-18T17:08:09Z,1,Chrome,99.0.4844.51,Windows NT 10.0,1280,720,NA,1.7777777777777777,1107,323,914,196,194,177,0.8802221340542569,1.1298544703194255,1.8224771006756466,1.2040241380800605,2.7243873707650508,0.8823863713894765,2,3,2,2,2,1,1,2,1,1,3,2,2,3,2,2,2,1,3,2,0.8506963092234007,0,0,3,4,4,1.95,0,1,1,2,1,1,1,1,1,1,1,1,1,2,1,2,1,1,1,1,1,1,1,1,0,1,1,0,0,0,1,1,1,1,1,1,1,1,1,1,1,1,1,1,2,1,2,1,1,1,3,1,1,1,1,3,1,1,2,1,1,1,1,1,1,1,1,1,1,1,1,1.8836263026534876,1.9073791542572855,1,0,1,0,1.2,0,1,0,1.3333333333333333,0,1.3333333333333333,0,1.1428571428571428,0,1,0,1.1891891891891893,0,0,0,0,-1.424265142790436,-0.6205191861769039,-1.02239216448367,1,1,1,1,1,1,1,3,1,1.9518001458970664,1,0,2,-0.5733904803153034,5,5,5,5,3,2,5,7,7,5,4,1.7043362064926932,7,4.285714285714286,0,1.175706155734171,0,1.1740993028896451,4,3,4,4,4,2,3,3,2,1,5,4,2,4,4,2,4,4,4,1,1.1832159566199232,3.8,0,3.8,0,2.4,0,2.8,0,3,0,1,3,3,3,3,3,3,2,4,1,2,2,4,3,3,2,1,2,3,2,0.8825799501580878,2.5,0,1,3,3,3,3,3,3,2,4,1,2,2,4,3,3,2,1,2,3,2,0.8825799501580878,2.5,0,I lived with my mother and father an equal amount of time (joint custody),0,"White, Caucasian, Anglo, European American",0,29,0,1,NA,1,3,4,program generalist,4,215,66,2,5,2,0,0,0,0,0,I lived with my mother and father an equal amount of time (joint custody),0,TRUE,TRUE,TRUE,TRUE,TRUE,2,0.951204000005722,0.9885612903179661,1.0276615384633725,1.0385827586198675,1.0925678571505206,1.0091043478250503,1,1,0.896551724137931,0.9354838709677419,0.9032258064516129,0.8846153846153846,NA,NA,NA,NA,NA,NA,NA,NA,NA,NA,NA,NA,NA,NA,361,1.0696296296296297,0,3,0,0,3,FALSE
76,2022-03-18T16:53:16Z,2022-03-18T17:09:24Z,967,1,2022-03-18T17:09:25Z,0.8999999761581421,Chrome,99.0.4844.74,Windows NT 10.0,1920,1080,NA,1.7777777777777777,486,64,226,63,29,55,-0.39436227642544847,-0.2977977942937871,-0.6735668127003522,-0.43353929540710134,-0.6545199101127405,-0.48799585744453366,2,2,3,2,3,2,3,3,2,2,2,2,2,3,3,3,2,1,1,2,0.6863327411532597,0,1,1,5,4,2.25,0,1,1,1,1,1,5,1,1,1,1,3,1,2,1,4,1,1,1,1,1,1,1,1,0,2,0,0,0,0,1,3,2,1,1,1,1,1,1,1,1,1,1,1,1,1,2,1,1,2,1,2,1,1,1,1,1,1,1,1,1,1,1,1,1,1,1,1,1,1,1,1.834766024965136,1.88477610139267,1,0,1,0,1.6666666666666667,0,1.3333333333333333,0,1.1666666666666667,0,1.1666666666666667,0,1,0,1,0,1.162162162162162,0,0,0,0,-1.2321408336953048,-0.6205191861769039,-0.9263300099361044,2,1,4,1,1,1,1,2,1,1.1338934190276817,1.5714285714285714,0,1.5,-0.4351695732408991,4,4,4,4,3,3,5,3,3,3,3,1.1126972805283737,3,3.857142857142857,0,-0.3194685672932239,0,0.030431956610885574,1,3,2,1,1,5,1,5,3,3,5,5,5,5,5,5,5,1,5,1,1.9223002094465098,1.6,0,4.2,0,3.8,0,3.8,0,3.933333333333333,0,1,1,1,4,1,2,1,1,2,1,1,2,2,2,1,3,1,2,1,1,0.8255779474818965,1.55,0,1,1,1,4,1,2,1,1,2,1,1,2,2,2,1,3,1,2,1,1,0.8255779474818965,1.55,0,I lived with my mother and father an equal amount of time (joint custody),0,"White, Caucasian, Anglo, European American",0,20,0,1,NA,1,3,4,"Student, also a part time nurse aide",4,155,72,3,5,2,0,0,1,0,0,I lived with my mother and father an equal amount of time (joint custody),0,TRUE,TRUE,TRUE,TRUE,TRUE,5,0.5975999999995033,0.5145161290332194,0.5506000000005588,0.64732413793124,0.5782733333334327,0.6200633333330353,0.9375,0.96875,1,0.90625,0.9375,0.9375,NA,NA,NA,NA,NA,NA,NA,NA,NA,NA,NA,NA,NA,NA,304,0.9007407407407407,1,3,0,0,3,FALSE
78,2022-03-18T16:25:53Z,2022-03-18T17:10:06Z,2652,1,2022-03-18T17:10:07Z,0.8999999761581421,Firefox,98.0,Macintosh,1440,900,NA,1.6,1882,57,368,72,43,68,2.4708870585659666,-0.3363829906346848,-0.15839495848611992,-0.32272673223879716,-0.36782474688674605,-0.3419715215851719,3,4,1,2,3,1,1,3,1,3,4,1,1,2,3,3,1,1,3,3,0.512989176042577,0,1,1,2,1,2.2,0,2,2,2,2,2,1,1,2,2,1,2,2,2,2,2,1,1,1,1,1,1,1,1,0,1,1,0,0,0,1,2,2,2,3,1,1,1,1,2,1,1,1,3,1,2,2,1,1,1,1,1,1,1,1,2,1,1,1,1,1,1,1,1,1,1,1,1,1,1,1,1.7054056433612528,1.3020130933435712,1,0,1,0,1.8,0,1.5555555555555556,0,1.4166666666666667,0,1.1666666666666667,0,1,0,1,0,1.2972972972972974,0,0,0,0,-1.1148190219937697,-0.6205191861769039,-0.8676691040853368,3,3,3,2,3,3,2,1,1,0.4879500364742666,2.7142857142857144,0,1,0.03452484215172952,5,5,5,5,3,3,5,6,7,5,3,1.5735915849388864,6.5,4.428571428571429,0,0.7410941633828612,0,0.9866072444677823,2,2,2,2,2,4,5,4,4,4,4,5,4,3,4,2,4,4,3,2,1.1464230084422218,2,0,4.2,0,3.6,0,3.4,0,3.7333333333333334,0,2,1,1,3,4,2,2,3,3,1,2,3,1,2,1,2,1,2,2,2,0.7880689256524124,2,0,2,1,1,3,4,2,2,3,3,1,2,3,1,2,1,2,1,2,2,2,0.7880689256524124,2,0,I lived with my mother and father an equal amount of time (joint custody),0,Black or African American,0,30,1,2,NA,1,3,6,consultant,4,145,65,4,5,2,0,0,1,0,0,I lived with my mother and father an equal amount of time (joint custody),0,TRUE,TRUE,TRUE,TRUE,TRUE,6,0.5929375,0.49665625,0.5120333333333333,0.6497,0.5590625,0.5707741935483871,1,1,1,0.967741935483871,1,0.96875,NA,NA,NA,NA,NA,NA,NA,NA,NA,NA,NA,NA,NA,NA,490,1.451851851851852,0,3,0,3,6,FALSE
80,2022-03-18T16:51:58Z,2022-03-18T17:10:49Z,1131,1,2022-03-18T17:10:51Z,0.8999999761581421,Chrome,99.0.4844.51,Macintosh,1440,900,NA,1.6,553,82,252,51,32,54,-0.2568467281128233,-0.19857871798862178,-0.5792395717878872,-0.581289379631507,-0.5930852322785988,-0.49922849866448454,3,3,1,1,3,1,3,3,1,3,4,2,1,4,3,3,2,1,2,3,0.812727700887249,0,1,4,3,3,2.35,0,4,1,4,1,5,2,2,2,2,1,1,3,2,3,2,2,4,1,2,1,2,2,3,0,1,1,0,2,0,1,2,1,3,2,1,4,3,2,2,2,4,1,1,2,2,5,4,4,5,5,4,1,1,1,1,1,2,1,3,1,1,3,3,1,1,1,1,1,1,2,1.5701800742161598,1.4142135623730951,2.125,0,1.25,0,2.3333333333333335,0,2.111111111111111,0,3.0833333333333335,0,1.5,0,2,0,1,0,2.2162162162162162,0,0,0,0,0.011450685473232336,-0.5343359712415323,-0.26144264288415,1,1,1,1,1,1,1,1,1,1.9518001458970664,1,0,1,-0.9598956828029438,5,5,5,5,3,1,5,6,7,6,5,1.9023794624226837,6.5,4.142857142857143,0,1.6437080244297957,0,1.38194423856502,4,4,3,2,4,2,4,4,4,3,5,5,4,3,4,1,5,5,3,2,1.3732131246511903,3.4,0,4.4,0,3,0,3.4,0,3.6,0,2,3,3,4,4,2,3,3,4,2,3,2,2,4,1,3,1,3,4,3,0.99472291830968,2.8,0,2,3,3,4,4,2,3,3,4,2,3,2,2,4,1,3,1,3,4,3,0.99472291830968,2.8,0,I lived with my mother and father an equal amount of time (joint custody),0,"White, Caucasian, Anglo, European American",0,24,1,2,NA,1,3,4,Dog Walker,4,135,63,2,5,2,0,0,1,0,0,I lived with my mother and father an equal amount of time (joint custody),0,TRUE,TRUE,TRUE,TRUE,TRUE,5,0.5270624999925494,0.4617125000022352,0.5015000000074505,0.5934899999976158,0.5380586206871888,0.5812125000022351,1,1,1,0.967741935483871,0.9354838709677419,1,NA,NA,NA,NA,NA,NA,NA,NA,NA,NA,NA,NA,NA,NA,434,1.285925925925926,0,3,0,0,3,FALSE
81,2022-03-18T16:52:07Z,2022-03-18T17:12:07Z,1199,1,2022-03-18T17:12:08Z,0.8999999761581421,Chrome,99.0.4844.51,Macintosh,1440,900,no,1.6,689,73,232,23,36,85,0.022289310253102542,-0.24818825614120446,-0.6517989878743987,-0.9260395761551199,-0.5111723284997433,-0.15101662084600656,2,3,2,2,3,2,3,3,1,3,3,1,1,2,3,3,1,2,3,3,0.5525062514530825,0,1,1,4,4,2.3,0,2,3,3,2,3,1,4,2,2,2,2,2,2,3,2,2,2,1,1,1,1,1,1,0,1,1,0,0,0,2,2,2,2,2,2,3,3,1,3,4,3,3,2,4,3,2,2,3,3,2,2,1,1,1,1,1,2,1,1,1,2,2,2,1,1,1,1,2,2,2,1.2603922360077393,0.9611501047232549,1.25,0,1.75,0,2.3333333333333335,0,2.111111111111111,0,2.8333333333333335,0,1.1666666666666667,0,1.5714285714285714,0,1,0,2,0,0,0,0,-0.46541523541094354,-0.361969541370789,-0.4136923883908663,2,2,3,1,1,2,1,1,1,1.1547005383792515,1.7142857142857142,0,1,-0.5455537974051633,5,5,5,5,3,3,5,8,7,4,3,1.5735915849388864,7.5,4.428571428571429,0,0.7077042870385463,0,0.9662543672142709,4,4,4,2,2,2,3,3,2,2,4,3,2,5,3,4,2,4,1,3,1.0600988273786194,3.2,0,3,0,2.4,0,3.2,0,2.8666666666666667,0,4,2,4,3,4,4,3,2,3,3,3,3,2,4,3,3,3,4,3,3,0.7591546545162482,3.15,0,4,2,4,3,4,4,3,2,3,3,3,3,2,4,3,3,3,4,3,3,0.7591546545162482,3.15,0,I lived with my mother and father an equal amount of time (joint custody),0,Black or African American,0,19,1,2,NA,1,3,4,Student,3,140,66,3,5,4,0,0,2,1,0,I lived with my mother and father an equal amount of time (joint custody),0,TRUE,TRUE,TRUE,TRUE,TRUE,3,0.5938548387116002,0.4948124999990687,0.5750343750016764,0.6146593749998137,0.5368966666688522,0.6037548387117924,1,1,1,1,0.967741935483871,0.96875,NA,NA,NA,NA,NA,NA,NA,NA,NA,NA,NA,NA,NA,NA,442,1.3096296296296297,0,3,0,0,3,FALSE
83,2022-03-18T16:33:39Z,2022-03-18T17:13:29Z,2390,1,2022-03-18T17:13:30Z,1,Chrome,99.0.4844.57,CrOS x86_64 14469.41.0,1536,864,No,1.7777777777777777,558,133,566,703,75,127,-0.24658437376113482,0.08254199820934673,0.5599432607703448,7.4464651965611965,0.28747848334409826,0.32075431039193136,2,2,2,1,2,1,2,2,1,2,3,2,1,2,2,2,2,1,2,2,0.8335087534664907,1,1,1,4,4,1.8,0,2,2,2,1,1,2,2,1,1,1,1,2,2,2,2,1,1,1,1,2,1,2,1,0,2,0,0,0,0,1,1,1,1,1,1,1,1,1,1,1,1,1,1,1,1,1,1,2,1,3,1,1,1,1,1,1,1,1,1,1,1,1,2,1,1,1,1,1,1,1,1.9199443185119163,1.4960264830861913,1.25,0,1,0,1.6,0,1,0,1.25,0,1,0,1.1428571428571428,0,1,0,1.1081081081081081,0,0,0,0,-1.1756452632954046,-0.6205191861769039,-0.8980822247361543,1,1,2,1,1,2,1,1,1,1.6761634196950514,1.2857142857142858,0,1,-0.7941589286438315,5,5,5,5,3,2,5,6,7,6,4,1.7043362064926932,6.5,4.285714285714286,0,1.2994399391682545,0,1.249521520102355,1,3,2,3,2,5,5,4,4,1,5,5,2,5,5,4,5,4,5,5,1.791514389985135,2.2,0,4.8,0,3.4,0,4.6,0,4.266666666666667,0,2,1,1,2,2,1,3,1,1,3,2,2,1,2,2,2,1,1,2,2,0.9176629354822471,1.7,0,2,1,1,2,2,1,3,1,1,3,2,2,1,2,2,2,1,1,2,2,0.9176629354822471,1.7,0,I lived with my mother and father an equal amount of time (joint custody),0,"White, Caucasian, Anglo, European American",0,23,1,2,NA,1,3,7,Music Teacher,6,230,64,1,5,2,0,1,3,0,1,I lived with my mother and father an equal amount of time (joint custody),0,TRUE,TRUE,TRUE,TRUE,TRUE,1,0.5353812500000932,0.4559999999999418,0.45418437499998254,0.5898777777777502,0.5382774193548868,0.5295032258065597,1,1,1,0.8709677419354839,0.96875,0.96875,NA,NA,NA,NA,NA,NA,NA,NA,NA,NA,NA,NA,NA,NA,788,2.334814814814815,0,3,0,0,3,FALSE
84,2022-03-18T16:52:32Z,2022-03-18T17:14:42Z,1330,1,2022-03-18T17:14:44Z,0.8999999761581421,Chrome,99.0.4844.51,Macintosh,1280,800,NA,1.6,514,98,284,55,37,95,-0.33689309205599316,-0.11038398349514147,-0.4631445060494686,-0.532039351556705,-0.4906941025550294,-0.03869020864649754,2,2,2,1,2,1,1,2,1,2,3,1,1,1,2,2,1,1,2,2,0.9733285267845752,0,1,1,4,3,1.6,0,1,1,1,3,1,1,1,1,1,1,1,1,3,1,1,1,2,1,1,1,1,1,1,0,2,0,0,0,0,1,1,1,1,1,1,2,1,1,1,1,1,1,1,1,1,1,1,1,1,3,1,1,1,1,1,1,1,1,1,1,1,1,1,1,1,1,1,1,1,1,1.9234603452371197,1.9223002094465098,1.125,0,1,0,1.2666666666666666,0,1.1111111111111112,0,1.1666666666666667,0,1,0,1,0,1,0,1.0810810810810811,0,0,0,0,-1.3877497131417202,-0.6205191861769039,-1.004134449659312,5,5,5,3,4,5,3,5,1,1.6761634196950514,4.285714285714286,0,3,1.7190873950021273,5,5,5,5,1,1,1,1,3,1,1,1.9518001458970664,2,3.2857142857142856,0,-1.6168479330435481,0,-1.07009546527469,2,2,2,3,2,5,5,5,5,1,5,5,4,5,5,5,4,5,5,5,1.9198214202665531,2.2,0,4.8,0,4,0,5,0,4.6,0,1,1,1,2,1,1,2,1,1,1,1,1,1,2,1,2,1,1,1,2,1.0399898784932577,1.25,0,1,1,1,2,1,1,2,1,1,1,1,1,1,2,1,2,1,1,1,2,1.0399898784932577,1.25,0,I lived with my mother and father an equal amount of time (joint custody),0,"White, Caucasian, Anglo, European American",0,27,1,2,NA,1,3,3,Daycare Director,2,135,64,2,5,2,0,0,1,0,0,I lived with my mother and father an equal amount of time (joint custody),0,TRUE,TRUE,TRUE,TRUE,TRUE,1,0.601245161293495,0.47063124999869616,0.5162718750010244,0.687875,0.5403562500006519,0.5939687499990687,1,1,1,1,1,1,NA,NA,NA,NA,NA,NA,NA,NA,NA,NA,NA,NA,NA,NA,386,1.1437037037037037,0,3,0,0,3,FALSE
85,2022-03-18T16:54:34Z,2022-03-18T17:14:50Z,1215,1,2022-03-18T17:14:50Z,0.8999999761581421,Chrome,99.0.4844.51,Windows NT 10.0,1280,720,NA,1.7777777777777777,569,79,312,66,50,90,-0.22400719418742024,-0.21511523070614935,-0.3615613235283524,-0.3966017743509999,-0.22447716527374886,-0.09485341474625206,3,1,3,2,3,1,1,3,1,3,2,2,3,1,3,3,1,1,3,3,0.8255779474818965,0,1,1,4,4,2.15,0,2,2,2,3,2,2,3,2,2,2,1,2,2,2,2,2,3,3,1,1,2,2,1,1,2,0,0,0,0,2,2,2,2,2,1,1,1,1,1,1,1,1,2,2,3,4,3,1,1,2,2,1,3,2,3,1,1,2,2,2,3,4,3,1,1,1,2,2,2,2,1.4606962838433024,1.0327955589886444,1.875,0,2,0,2.066666666666667,0,1.5555555555555556,0,1.8333333333333333,0,2,0,2.4285714285714284,0,1,0,1.837837837837838,0,1,0,0,-0.37968763642433506,-0.05662557557742737,-0.21815660600088121,2,2,3,2,2,2,2,2,1,0.7867957924694432,2.142857142857143,0,1.5,-0.10369606492267476,4,4,4,4,2,2,3,3,4,3,2,0.9511897312113419,3.5,3.2857142857142856,0,-0.5733927454649965,0,-0.43405491414093966,2,2,3,2,2,3,4,3,4,3,2,3,4,3,3,3,3,3,3,3,0.5345224838248488,2.2,0,2.8,0,3.4,0,3.2,0,3.1333333333333333,0,3,1,3,2,3,2,2,3,2,3,2,2,2,2,1,3,3,3,2,2,0.6569466853317864,2.3,0,3,1,3,2,3,2,2,3,2,3,2,2,2,2,1,3,3,3,2,2,0.6569466853317864,2.3,0,I lived with my mother and father an equal amount of time (joint custody),0,"White, Caucasian, Anglo, European American",0,23,1,2,NA,1,3,6,Receptionist,4,170,67,2,5,2,0,0,0,0,0,I lived with my mother and father an equal amount of time (joint custody),0,TRUE,TRUE,TRUE,TRUE,TRUE,4,0.5725406250134111,0.5094781249836087,0.5232593749761582,0.6274999999769272,0.5664124999791383,0.5817250000238419,1,1,1,1,1,1,NA,NA,NA,NA,NA,NA,NA,NA,NA,NA,NA,NA,NA,NA,372,1.1022222222222222,0,3,0,0,3,FALSE
86,2022-03-18T16:53:01Z,2022-03-18T17:14:52Z,1310,1,2022-03-18T17:14:52Z,0.8999999761581421,Chrome,99.0.4844.74,Windows NT 10.0,1536,864,none,1.7777777777777777,617,87,328,104,56,67,-0.12548859241121113,-0.17101786345940917,-0.30351379065914313,0.0712734923596177,-0.10160780960546556,-0.35320416280512285,2,2,2,2,3,1,3,3,3,3,3,3,1,1,3,3,3,2,3,3,0.6708203932499369,0,1,2,3,2,2.45,0,4,3,2,3,3,3,3,3,2,4,4,3,2,3,3,2,4,1,1,1,2,2,3,0,2,0,0,0,0,2,2,2,2,2,1,1,1,1,2,2,3,3,3,2,2,3,3,5,5,3,4,1,2,1,1,1,1,1,1,1,1,2,2,1,3,3,2,2,1,1,1.460182225659569,0.6399404734221844,2,0,1.5,0,3,0,1.5555555555555556,0,3,0,1.6666666666666667,0,1.2857142857142858,0,2.3333333333333335,0,2.054054054054054,0,0,0,0,0.17729569614192908,-0.44815275630616064,-0.13542853008211578,1,1,3,2,1,1,1,3,2,1.5275252316519468,1.4285714285714286,0,2.5,-0.13153274783281477,3,3,3,4,2,2,3,3,3,4,3,0.6900655593423543,3,2.857142857142857,0,-0.1053908767693718,0,-0.381063375364909,2,3,2,2,2,4,4,3,4,2,4,3,2,3,4,3,3,3,4,4,0.7988086367179802,2.2,0,3.4,0,3,0,3.6,0,3.3333333333333335,0,1,1,3,4,2,4,3,4,4,4,3,4,2,4,2,3,1,4,4,4,1.2763022245616642,3.05,0,1,1,3,4,2,4,3,4,4,4,3,4,2,4,2,3,1,4,4,4,1.2763022245616642,3.05,0,I lived with my mother and father an equal amount of time (joint custody),0,"White, Caucasian, Anglo, European American",0,25,0,1,NA,1,2,6,unemployed,3,156,67,3,5,2,0,0,1,0,0,I lived with my mother and father an equal amount of time (joint custody),0,TRUE,TRUE,TRUE,TRUE,TRUE,3,0.5193906249999418,0.49326874999995923,0.5555500000000902,0.6237933333333271,0.5825689655172414,0.6714166666665735,1,1,1,0.9375,0.9354838709677419,0.9375,NA,NA,NA,NA,NA,NA,NA,NA,NA,NA,NA,NA,NA,NA,376,1.114074074074074,0,3,0,3,6,FALSE
88,2022-03-18T16:57:37Z,2022-03-18T17:15:41Z,1084,1,2022-03-18T17:15:42Z,1,Chrome,99.0.4844.74,Windows NT 10.0,1920,1080,NA,1.7777777777777777,494,83,287,63,43,56,-0.37794250946274693,-0.19306654708277926,-0.45226059363649185,-0.43353929540710134,-0.36782474688674605,-0.47676321622458273,2,2,1,1,2,1,2,3,1,2,2,1,1,1,2,2,1,2,2,2,0.9445132413883326,0,1,2,3,2,1.65,0,3,2,3,3,4,4,3,3,3,3,2,3,2,3,4,3,3,3,2,2,2,4,2,1,1,1,0,0,0,2,4,4,2,3,2,3,2,2,2,2,2,2,3,3,2,4,3,2,2,3,3,2,1,2,3,1,1,2,1,1,3,3,4,1,1,1,2,2,2,2,1.0953080387268688,0.6546536707079771,2.625,0,2,0,3,0,2.6666666666666665,0,2.5,0,2,0,2.142857142857143,0,1,0,2.27027027027027,0,1,0,0,0.544910601095984,-0.05662557557742737,0.2441425127592783,2,2,3,2,1,2,2,2,1,0.9511897312113419,2,0,1.5,-0.18656444200223082,4,4,4,4,2,2,4,6,6,4,3,1.0690449676496976,6,3.4285714285714284,0,0.4366725657692403,0,0.25905945818897114,3,3,3,3,3,3,3,2,3,4,4,3,3,3,4,4,4,4,3,3,0.7037315505489968,3,0,3.6,0,3.4,0,3,0,3.3333333333333335,0,1,1,1,2,2,1,2,2,1,1,1,2,2,2,2,2,1,2,2,2,0.7677718959499145,1.6,0,1,1,1,2,2,1,2,2,1,1,1,2,2,2,2,2,1,2,2,2,0.7677718959499145,1.6,0,Prefer not to say.,0,"White, Caucasian, Anglo, European American",0,21,0,1,NA,1,3,4,Student,4,140,71,2,5,2,0,0,1,0,0,Prefer not to say.,0,TRUE,TRUE,TRUE,TRUE,TRUE,5,0.5368483870933133,0.5086125000026077,0.5473062500059604,0.6005468749962747,0.5531774193471478,0.6264032258045289,0.96875,1,1,1,0.96875,1,NA,NA,NA,NA,NA,NA,NA,NA,NA,NA,NA,NA,NA,NA,276,0.8177777777777777,0,3,0,0,3,FALSE
89,2022-03-18T16:52:39Z,2022-03-18T17:16:00Z,1401,1,2022-03-18T17:16:01Z,0.8999999761581421,Chrome,99.0.4844.74,Macintosh,1440,900,Thank you!,1.6,669,83,350,96,56,87,-0.018760107153651253,-0.19306654708277926,-0.22369843296398037,-0.02722656378998601,-0.10160780960546556,-0.12855133840610475,2,2,2,2,2,2,3,2,2,2,3,2,1,2,2,2,2,2,2,2,0.6048053188292994,0,1,4,4,4,2.05,0,3,3,2,3,2,2,3,3,2,2,4,3,1,3,2,2,2,2,1,1,2,2,3,4,2,0,0,0,0,2,2,2,1,1,3,2,2,3,2,2,3,2,2,2,1,3,3,2,3,3,2,1,1,1,3,2,1,3,3,1,2,2,2,1,3,3,1,2,2,2,1.196842693269434,0.816496580927726,1.875,0,1.75,0,2.533333333333333,0,2,0,2.3333333333333335,0,1.6666666666666667,0,2,0,2.3333333333333335,0,2.081081081081081,0,2,0,0,-0.06945412091826242,0.07635196034519101,0.0034489197134642963,2,2,3,1,1,2,1,1,1,1.1547005383792515,1.7142857142857142,0,1,-0.5455537974051633,3,3,3,3,3,3,4,5,5,3,3,0.3779644730092272,5,3.142857142857143,0,0.041907061065850786,0,-0.13642417580067887,2,3,3,3,3,4,3,4,4,3,4,3,3,2,4,3,3,5,3,2,0.816496580927726,2.8,0,3.8,0,3,0,3.2,0,3.3333333333333335,0,1,1,1,3,2,1,2,2,2,2,1,2,2,1,2,2,1,1,3,1,0.7863975156570492,1.65,0,1,1,1,3,2,1,2,2,2,2,1,2,2,1,2,2,1,1,3,1,0.7863975156570492,1.65,0,NA,NA,"Black or African American & White, Caucasian, Anglo, European American",1,30,1,3,NA,1,3,6,Internet Safety Evaluator,3,120,62,3,5,2,0,0,0,0,0,NA,NA,TRUE,TRUE,TRUE,TRUE,TRUE,3,0.6816774193548312,0.7870062499999876,0.5743718749999971,0.7573468749999883,0.8498687499999978,0.6374566666666573,1,1,1,1,1,1,0.209,0.301,0.779,0.026,1.697,32.40614321066309,1825.7492963884167,0.195,0.325,0.802,0.025,1.767,38.357514502754505,1820.1426026305908,431,1.2770370370370372,0,3,0,0,3,FALSE
90,2022-03-18T16:55:20Z,2022-03-18T17:16:28Z,1268,1,2022-03-18T17:16:29Z,1,Firefox,98.0,Windows NT 10.0,2560,1440,N/A - No technical issues or otherwise!,1.7777777777777777,585,69,400,60,41,50,-0.1911676602620172,-0.2702369397645745,-0.04229989274770138,-0.4704768164632027,-0.40878119877617386,-0.5441590635442882,1,2,1,1,2,1,2,2,1,1,3,1,1,1,2,1,1,1,4,2,1.190974832912761,0,0,2,3,3,1.55,0,3,2,2,3,2,2,3,3,3,2,2,2,3,3,4,2,2,2,1,2,2,3,2,3,1,1,0,2,0,1,2,3,2,3,3,1,2,1,1,2,1,1,3,3,2,2,2,1,1,1,2,1,1,1,3,1,1,3,3,3,2,2,1,2,4,1,2,2,2,2,1.3852504895934594,0.7037315505489968,2,0,2,0,2.6,0,2,0,1.6666666666666667,0,1.5,0,2.142857142857143,0,2.3333333333333335,0,1.864864864864865,0,2,0,0,-0.08018237383392285,0.16253517528056266,0.041176400723319906,4,4,5,4,2,4,5,3,3,1.4638501094227998,4,0,3,1.5533506408430153,2,3,4,4,1,1,2,6,6,2,1,1.3801311186847085,6,2.4285714285714284,0,-0.6800189858015465,0,-0.9636093791272222,2,2,3,3,3,4,5,3,5,4,4,4,4,3,5,3,4,4,4,3,1.1872336794093274,2.6,0,4,0,4,0,3.8,0,3.933333333333333,0,2,1,1,2,2,4,2,3,2,1,4,3,1,4,1,3,1,4,2,2,1.0894228312566052,2.25,0,2,1,1,2,2,4,2,3,2,1,4,3,1,4,1,3,1,4,2,2,1.0894228312566052,2.25,0,"I lived with my mother, but not father, most of the time.",0,"White, Caucasian, Anglo, European American",0,28,0,1,NA,1,2,4,"Unemployed, free-lance web developer",2,145,68,2,5,2,0,0,1,0,0,"I lived with my mother, but not father, most of the time.",0,TRUE,TRUE,TRUE,TRUE,TRUE,3,0.626875,0.576375,0.5336875,0.6825517241379311,0.7073666666666667,0.7047741935483871,1,1,1,0.90625,0.967741935483871,0.96875,0.108,0.335,0.531,0.009,1.632,48.68214742626613,1881.455433907697,0.108,0.335,0.578,0.009,1.722,49.36200404625037,1874.5995798305646,226,0.6696296296296296,0,3,0,0,3,FALSE
91,2022-03-18T16:50:55Z,2022-03-18T17:16:36Z,1541,1,2022-03-18T17:16:37Z,1,Chrome,99.0.4844.51,Macintosh,1440,900,No feedback,1.6,569,120,386,116,86,139,-0.22400719418742024,0.010883776433393964,-0.09309148400825949,0.21902357658402327,0.512738968735951,0.4555460050313422,2,2,1,1,3,1,2,2,1,2,4,1,1,1,2,2,1,1,3,3,0.8944271909999159,0,1,1,4,2,1.8,0,2,1,1,1,1,1,5,1,1,1,1,1,1,5,1,1,1,1,1,1,1,1,1,1,2,0,0,0,0,1,1,2,1,1,1,1,1,1,2,1,1,1,1,1,1,1,1,1,2,2,1,1,1,1,2,2,1,2,2,1,1,1,1,1,1,1,2,1,1,1,1.8265640794498113,1.869555587629877,1,0,1.25,0,1.6,0,1.1111111111111112,0,1.25,0,1.3333333333333333,0,1.2857142857142858,0,1,0,1.2162162162162162,0,1,0,0,-1.2376525966611487,-0.3151752203835423,-0.7764139085223455,1,1,1,1,1,1,1,3,1,1.9518001458970664,1,0,2,-0.5733904803153034,5,5,5,5,3,3,4,1,4,3,2,1.2909944487358056,2.5,4.285714285714286,0,-0.7540805596445339,0,-0.0022067049116339943,2,3,2,1,2,4,4,4,5,1,2,4,4,4,4,3,2,5,2,1,1.3345232785352157,2,0,3.4,0,2.8,0,3.6,0,3.2666666666666666,0,1,1,1,1,2,1,1,2,2,2,2,2,2,2,1,2,2,2,2,1,0.8522416262267903,1.6,0,1,1,1,1,2,1,1,2,2,2,2,2,2,2,1,2,2,2,2,1,0.8522416262267903,1.6,0,I lived with my mother and father an equal amount of time (joint custody),0,"Hispanic of Latino (e.g., Mexican American, Central American, and others)",0,23,1,2,NA,1,4,4,Restaurant employee,4,122,61,3,5,2,0,0,1,0,0,I lived with my mother and father an equal amount of time (joint custody),0,TRUE,TRUE,TRUE,TRUE,TRUE,2,0.5551968749995576,0.4955531249997439,0.5627437500002561,0.6007500000001165,0.5775548387095332,0.6536406249998836,1,1,1,1,0.96875,1,0.236,0.238,0.738,0.013,1.443,9.261532328232182,1795.3454318108638,0.238,0.24,0.743,0.014,1.505,15.663765050630445,1798.0737503702173,444,1.3155555555555554,0,3,0,0,3,FALSE
92,2022-03-18T16:54:29Z,2022-03-18T17:16:43Z,1334,1,2022-03-18T17:16:44Z,1,Chrome,98.0.4758.107,CrOS x86_64 14388.61.0,1366,768,NA,1.7786458333333333,486,80,231,57,42,80,-0.39436227642544847,-0.20960305980030683,-0.6554269586787244,-0.5074143375193041,-0.38830297283146,-0.2071798269457611,3,3,3,3,4,2,1,3,1,3,3,2,2,2,3,3,2,1,4,3,0.5871429486123998,0,1,4,3,2,2.55,0,2,2,1,1,1,1,2,1,1,1,1,2,1,2,2,1,1,1,1,1,1,1,1,0,2,0,0,0,0,1,1,1,1,1,1,1,1,1,1,1,1,1,1,1,1,1,1,1,1,1,1,1,1,1,1,1,1,1,1,1,1,1,1,1,1,1,1,1,1,1,1.9666895707934864,1.6417180315870614,1,0,1,0,1.4,0,1,0,1,0,1,0,1,0,1,0,1,0,0,0,0,-1.4195407745339985,-0.6205191861769039,-1.0200299803554511,1,1,2,1,1,1,1,1,2,1.7320508075688772,1.1428571428571428,0,1.5,-0.6837747044795675,5,5,5,5,5,5,5,7,8,6,4,1.5118578920369088,7.5,5,0,1.480127753347792,0,1.746793692269112,2,3,2,2,2,4,4,4,4,2,4,4,4,4,4,4,4,4,4,4,1.01418510567422,2.2,0,4,0,3.6,0,4,0,3.8666666666666667,0,2,1,1,2,2,2,2,2,1,1,2,2,1,1,1,2,1,1,2,2,0.7863975156570492,1.55,0,2,1,1,2,2,2,2,2,1,1,2,2,1,1,1,2,1,1,2,2,0.7863975156570492,1.55,0,I lived with my mother and father an equal amount of time (joint custody),0,"White, Caucasian, Anglo, European American",0,29,1,2,NA,1,3,7,Homemaker,5,120,69,3,5,2,0,0,1,0,0,I lived with my mother and father an equal amount of time (joint custody),0,TRUE,TRUE,TRUE,TRUE,TRUE,4,0.5560125000015832,0.45362187499925494,0.4688187499991618,0.6622533333331346,0.5542580645156483,0.5569178571429636,1,1,1,0.967741935483871,0.96875,0.875,0.053,0.368,0.492,0.01,1.429,117.67683763358527,2069.7436624156867,0.056,0.367,0.525,0.012,1.485,135.162975544424,2070.253029657963,346,1.0251851851851852,0,3,0,0,3,FALSE
93,2022-03-18T16:44:45Z,2022-03-18T17:16:45Z,1920,1,2022-03-18T17:16:46Z,1,Firefox,98.0,Windows NT 10.0,1366,768,i left just to brush my teeth lol,1.7786458333333333,770,137,560,120,72,134,0.18853945075045542,0.1045906818327168,0.5381754359443913,0.26827360465882516,0.2260438055099566,0.3993827989315877,2,2,1,1,2,1,1,3,1,2,2,1,1,2,2,1,1,1,3,2,1.025978352085154,0,0,2,5,4,1.6,0,3,4,3,1,1,2,4,3,3,1,1,1,4,3,3,1,1,1,1,1,1,1,1,1,2,0,0,0,0,2,2,3,1,2,1,2,3,4,1,1,2,1,4,3,3,5,5,4,5,4,3,5,1,1,2,1,1,1,2,1,5,3,4,1,1,1,2,2,1,2,1.548029843509613,1.2798809468443688,1,0,1.75,0,2.466666666666667,0,2.2222222222222223,0,3.1666666666666665,0,2.1666666666666665,0,2.4285714285714284,0,1,0,2.4594594594594597,0,1,0,0,-0.31561339194639937,-0.14280879051279902,-0.2292110912295992,2,2,3,1,1,5,3,3,2,1.4960264830861913,2.4285714285714284,0,2.5,0.44854589172407777,4,5,5,5,5,5,3,1,3,1,2,0.7867957924694432,2,4.571428571428571,0,-1.272579847782007,0,-0.16340576231530668,4,4,3,2,3,4,5,4,2,1,4,5,2,3,5,4,5,4,4,1,1.4540583599999397,3.2,0,4.4,0,3.2,0,3,0,3.533333333333333,0,1,2,1,1,3,2,3,1,1,1,1,1,1,2,1,1,1,1,1,1,1.234376040972246,1.35,0,1,2,1,1,3,2,3,1,1,1,1,1,1,2,1,1,1,1,1,1,1.234376040972246,1.35,0,I lived with my mother and father an equal amount of time (joint custody),0,"Hispanic of Latino (e.g., Mexican American, Central American, and others)",0,21,1,2,NA,1,2,1,freelance digital artist but planning to do delivery n shit after i get a bike,1,120,62,3,5,2,1,0,2,0,1,I lived with my mother and father an equal amount of time (joint custody),0,TRUE,TRUE,TRUE,TRUE,TRUE,6,0.598,0.54646875,0.5670322580645162,0.6860344827586207,0.5861333333333333,0.6082,0.9375,1,1,0.9354838709677419,0.9375,0.9375,0.069,0.348,0.312,0.046,1.94,80.43989476464188,1934.6976917067284,0.066,0.351,0.317,0.036,2.116,96.79156069577822,1943.078995227823,348,1.031111111111111,0,3,0,3,6,FALSE
94,2022-03-18T17:01:09Z,2022-03-18T17:16:51Z,942,1,2022-03-18T17:16:52Z,0.8999999761581421,Chrome,98.0.4758.102,Macintosh,1440,900,"I accidentally put 2 women in the household that were romantically invovled. It should only be 2 men, both romantically involved nothing more! Sorry!!",1.6,434,40,274,52,24,63,-0.5010907616830084,-0.4300898960340076,-0.4994242140927244,-0.5689768726128064,-0.7569110398363099,-0.3981347276849264,2,2,2,1,2,1,2,2,1,2,2,2,1,1,3,2,2,1,2,2,0.8750939799154206,0,1,2,3,3,1.75,0,1,1,3,2,3,1,4,1,1,1,1,3,1,3,3,1,1,5,3,1,1,1,1,1,1,2,2,2,2,2,1,1,2,2,2,4,2,2,2,2,1,1,2,4,1,2,1,1,1,1,4,3,1,1,2,1,1,1,1,1,1,2,2,1,1,1,3,1,1,1,1.517663764904237,1.4573295865416045,1.75,0,1.5,0,1.9333333333333333,0,2,0,1.5833333333333333,0,2,0,1.2857142857142858,0,1,0,1.6486486486486487,0,1,2,2,-0.5752567973731191,2.9763858872737474,1.2005645449503142,1,1,1,1,1,1,1,1,1,1.9518001458970664,1,0,1,-0.9598956828029438,5,5,5,5,2,2,5,8,8,3,3,1.8126539343499315,8,4.142857142857143,0,0.5839705036044629,0,0.7359787531022173,3,3,3,3,2,5,3,5,5,4,5,4,5,4,1,5,4,3,4,1,1.5522640914238175,2.8,0,4.2,0,4.2,0,3.2,0,3.8666666666666667,0,1,1,1,4,1,1,1,1,1,1,1,1,1,1,1,1,1,1,2,1,1.1002392084403616,1.2,0,1,1,1,4,1,1,1,1,1,1,1,1,1,1,1,1,1,1,2,1,1.1002392084403616,1.2,0,"I lived with my mother, but not father, most of the time.",0,"White, Caucasian, Anglo, European American",0,25,1,2,NA,1,4,6,Medical Student/researcher,5,130,68,2,5,2,0,0,1,0,0,"I lived with my mother, but not father, most of the time.",0,TRUE,TRUE,TRUE,TRUE,TRUE,2,0.4552241379330898,0.48573225806413156,0.5227366666694482,0.5508360000014305,0.464007999997139,0.6326479999923706,1,1,1,0.78125,0.78125,0.78125,0.055,0.343,0.347,0.014,1.966,75.12751731062467,1989.6373841660504,0.055,0.343,0.354,0.015,1.992,89.6527050268787,1987.5428380494236,372,1.1022222222222222,0,3,0,0,3,FALSE
95,2022-03-18T16:57:27Z,2022-03-18T17:17:24Z,1196,1,2022-03-18T17:17:25Z,1,Chrome,99.0.4844.74,Windows NT 10.0,1366,768,NA,1.7786458333333333,599,72,284,51,37,67,-0.16243306807728952,-0.253700427047047,-0.4631445060494686,-0.581289379631507,-0.4906941025550294,-0.35320416280512285,1,4,1,1,1,1,1,1,1,1,1,1,1,1,1,1,1,1,1,1,1.5312533566021211,0,1,1,3,3,1.15,0,3,3,4,2,4,2,4,3,2,1,1,5,1,3,3,3,5,5,5,3,5,4,4,3,1,2,2,3,2,4,2,2,3,3,1,1,2,2,3,3,2,3,4,3,4,5,5,5,5,5,3,4,2,3,5,5,3,1,1,1,3,4,4,2,5,2,3,4,4,4,1.2985323200391226,1.1254628677422756,4.25,0,3.75,0,2.7333333333333334,0,2.2222222222222223,0,3.9166666666666665,0,3.6666666666666665,0,2.4285714285714284,0,3,0,3.108108108108108,0,2,2,2,1.5046463275235586,3.9711955725500823,2.7379209500368207,3,2,5,1,1,4,2,1,1,1.1547005383792515,2.5714285714285716,0,1,-0.048343534927826504,2,3,2,4,1,1,1,6,6,1,1,1.5118578920369088,6,2,0,-0.8940966763253987,0,-1.3263810316481466,1,1,2,2,4,2,2,4,3,4,2,3,2,2,3,2,1,4,3,4,0.990430401872025,2,0,2.4,0,2.6,0,3.2,0,2.7333333333333334,0,2,1,1,3,2,1,2,3,1,2,2,3,2,2,2,3,3,3,4,4,0.8522416262267903,2.3,0,2,1,1,3,2,1,2,3,1,2,2,3,2,2,2,3,3,3,4,4,0.8522416262267903,2.3,0,I lived with my mother and father an equal amount of time (joint custody),0,"White, Caucasian, Anglo, European American",0,23,1,2,NA,1,2,6,receptionist,3,97,60,1,5,2,0,0,1,0,0,I lived with my mother and father an equal amount of time (joint custody),0,TRUE,TRUE,TRUE,TRUE,TRUE,5,0.6688812500024215,0.7324193548358255,0.677719354841017,0.6710645161290323,0.7283766666700443,0.6503903225823756,1,0.96875,1,0.96875,0.967741935483871,0.96875,0.083,0.348,0.268,0.122,1.127,101.59646644221428,1987.0392935443078,0.08,0.359,0.264,0.108,1.184,119.52701491327217,1945.0895493319551,304,0.9007407407407407,1,3,0,0,3,FALSE
96,2022-03-18T16:50:16Z,2022-03-18T17:17:25Z,1629,1,2022-03-18T17:17:26Z,0.8999999761581421,Safari,14.0.3,Macintosh,1440,900,After I finished the game the survey did give me some issues. It stayed in full screen and wouldn't allow me to scroll to see the rest of the questions. I exited full screen and it was even worse. I had to refresh almost every screen during the questions because the words were cut off. Once I finished the questions and moved on to the demographics I did not have the issue anymore.,1.6,641,300,279,84,79,76,-0.07622929152310656,1.0030745394850475,-0.4812843600710965,-0.17497664801439158,0.3693913871229538,-0.2521103918255647,3,3,1,1,4,1,2,4,1,3,3,2,1,1,2,3,2,1,4,3,0.6048053188292994,0,0,4,3,2,2.25,0,4,5,5,5,5,5,5,4,5,3,2,5,3,4,5,5,3,1,1,3,2,5,3,2,1,1,0,1,0,5,4,4,4,5,2,3,3,4,2,2,2,1,5,5,2,5,5,3,1,2,2,5,1,1,1,2,1,1,1,1,5,5,5,5,5,3,1,2,2,2,1.5872994422979931,1.6676187756655838,2.875,0,1.75,0,4.333333333333333,0,3.7777777777777777,0,2.9166666666666665,0,2,0,2.7142857142857144,0,4.333333333333333,0,3.054054054054054,0,1,0,0,1.5793504005784789,-0.14280879051279902,0.7182708050328399,4,3,5,4,2,4,3,4,1,1.1126972805283737,3.5714285714285716,0,2.5,1.1114929083605267,1,1,1,1,1,1,1,3,4,1,1,1.5118578920369088,3.5,1,0,-1.345816211774242,0,-2.143714620591844,3,4,3,5,3,4,5,3,3,4,3,3,2,3,2,2,4,4,3,4,0.9154754164341269,3.6,0,3.6,0,3.2,0,3,0,3.2666666666666666,0,1,3,1,1,1,1,3,2,1,2,1,3,2,1,1,4,1,1,1,2,0.9333020044867296,1.65,0,1,3,1,1,1,1,3,2,1,2,1,3,2,1,1,4,1,1,1,2,0.9333020044867296,1.65,0,"I lived with my mother, but not father, most of the time. & I lived with my extended family on mother's side (grandparents, aunts ,uncles, cousins)",1,Black or African American,0,28,1,2,NA,1,1,6,call center rep,1,90,61,1,5,2,0,0,0,0,0,"I lived with my mother, but not father, most of the time. & I lived with my extended family on mother's side (grandparents, aunts ,uncles, cousins)",1,TRUE,TRUE,TRUE,TRUE,TRUE,5,0.5739000000000014,0.4765937499999927,0.5282187500000036,0.6312812500000013,0.5353437500000037,0.5878709677419317,0.967741935483871,1,1,1,1,0.96875,0.069,0.394,0.528,0.022,1.735,83.73514469915668,1915.382672404861,0.071,0.409,0.659,0.03,2.178,65.17447901304783,1891.9917083086302,434,1.285925925925926,0,3,0,0,3,FALSE
97,2022-03-18T17:00:28Z,2022-03-18T17:18:17Z,1068,1,2022-03-18T17:18:17Z,0.8999999761581421,Safari,14.1.2,Macintosh,1440,900,NA,1.6,620,109,169,37,21,58,-0.11933117980019806,-0.04975010353087375,-0.8803611485469103,-0.7536644778933134,-0.8183457176704515,-0.454297933784681,2,2,1,1,2,1,2,3,1,2,2,1,4,3,2,2,1,1,3,2,1.0052493799000692,0,1,2,3,3,1.9,0,3,2,3,2,4,1,2,1,1,1,3,1,1,3,2,1,1,1,1,1,3,1,1,1,2,0,0,0,0,2,2,1,1,1,1,1,1,1,3,2,1,1,2,5,1,4,1,1,2,1,1,1,1,1,1,1,1,1,1,1,3,3,1,1,1,1,1,1,1,1,1.7803566130608974,1.424279266355945,1.25,0,1,0,2,0,1.2222222222222223,0,2,0,1,0,1.5714285714285714,0,1,0,1.4864864864864864,0,1,0,0,-0.8354907488318933,-0.4013584353189139,-0.6184245920754037,1,1,2,1,1,1,1,1,1,1.7320508075688772,1.1428571428571428,0,1,-0.8770273057233877,5,5,5,5,5,5,5,6,6,6,4,1.5118578920369088,6,5,0,1.2090960320784858,0,1.5815856723915158,5,2,4,3,3,3,5,2,4,2,4,4,2,3,3,5,4,3,4,4,1.0997835284835873,3.4,0,3.6,0,3.6,0,3.2,0,3.466666666666667,0,1,1,1,4,1,1,1,1,1,1,1,1,1,2,2,1,1,1,1,1,1.0990426455975697,1.25,0,1,1,1,4,1,1,1,1,1,1,1,1,1,2,2,1,1,1,1,1,1.0990426455975697,1.25,0,I lived with my mother and father an equal amount of time (joint custody),0,"White, Caucasian, Anglo, European American",0,21,1,2,NA,1,4,4,student,6,140,69,3,5,2,0,0,1,0,0,I lived with my mother and father an equal amount of time (joint custody),0,TRUE,TRUE,TRUE,TRUE,TRUE,1,0.47216129032258064,0.46356249999999727,0.4838064516129051,0.5698260869565294,0.5507499999999987,0.6736399999999977,0.96875,1,1,0.71875,0.75,0.78125,0.061,0.34,0.412,0.01,1.656,118.30345010902275,1987.5599851013394,0.06,0.343,0.41,0.011,1.753,143.14741634245735,1998.099048088226,364,1.0785185185185184,0,3,0,0,3,FALSE
98,2022-03-18T17:00:44Z,2022-03-18T17:19:52Z,1147,1,2022-03-18T17:20:02Z,0.8999999761581421,Chrome,99.0.4844.51,Macintosh,1440,900,NA,1.6,572,52,320,74,29,60,-0.21784978157640716,-0.3639438451638974,-0.33253755709374777,-0.29810171820139625,-0.6545199101127405,-0.43183265134477916,2,1,1,2,2,1,1,2,1,2,1,1,2,1,2,2,1,1,2,2,1.105012502906165,0,1,2,4,5,1.5,0,4,1,2,2,1,2,3,3,2,3,3,4,3,3,5,2,4,5,1,3,3,4,3,1,1,1,0,0,0,2,5,4,2,2,1,3,2,1,2,5,3,1,4,2,4,4,4,4,3,5,4,2,1,1,3,2,1,1,1,1,2,2,2,1,1,2,1,3,1,1,1.346221494521727,1.0555973258234952,3.125,0,1.5,0,2.7333333333333334,0,2.4444444444444446,0,3.4166666666666665,0,2.1666666666666665,0,1.4285714285714286,0,1.3333333333333333,0,2.4324324324324325,0,1,0,0,0.7177437398106616,-0.22899200544817064,0.2443758671812455,1,1,1,2,1,1,2,3,1,1.8126539343499315,1.2857142857142858,0,2,-0.40765372615619105,5,5,5,5,4,3,5,6,3,6,5,1.5275252316519468,4.5,4.571428571428571,0,1.282332396070721,0,1.3939469740772399,3,4,3,4,2,3,3,2,3,2,4,3,3,4,3,2,4,4,3,3,0.7037315505489968,3.2,0,3.6,0,2.6,0,3,0,3.066666666666667,0,1,2,1,1,2,1,1,1,1,1,2,2,1,1,1,2,1,1,1,2,1.0310954828418375,1.3,0,1,2,1,1,2,1,1,1,1,1,2,2,1,1,1,2,1,1,1,2,1.0310954828418375,1.3,0,I lived with my mother and father an equal amount of time (joint custody),0,"White, Caucasian, Anglo, European American",0,28,1,2,NA,1,5,6,paid search specialist,6,120,61,3,5,2,0,0,1,0,0,I lived with my mother and father an equal amount of time (joint custody),0,TRUE,TRUE,TRUE,TRUE,TRUE,4,0.5495645161328777,0.5161218750011176,0.48279687500186264,0.5989193548367869,0.5450354838698142,0.553106249999255,0.96875,1,1,0.96875,0.96875,1,0.092,0.369,0.855,0.012,1.246,14.074781876619173,1802.9400026999176,0.094,0.372,0.913,0.016,1.4,19.21447924530021,1803.1725969549718,433,1.282962962962963,0,3,0,0,3,FALSE
99,2022-03-18T16:50:56Z,2022-03-18T17:20:19Z,1762,1,2022-03-18T17:20:20Z,1,Chrome,99.0.4844.74,Windows NT 6.3,1366,768,NA,1.7786458333333333,547,78,155,32,22,891,-0.2691615533348494,-0.22062740161199185,-0.9311527398074684,-0.8152270129868158,-0.7978674917257377,8.902492202434422,2,2,1,1,2,1,1,2,1,2,2,1,1,1,2,2,1,1,2,2,1.025978352085154,0,1,1,3,3,1.5,0,2,2,2,2,2,2,2,2,2,2,2,2,2,2,2,1,1,1,1,1,1,1,1,1,1,1,0,0,0,2,3,2,2,5,2,2,2,2,4,2,4,4,2,4,2,2,2,2,2,2,2,1,1,1,4,4,1,1,1,1,2,1,1,1,1,1,1,1,1,1,1.3987338762096442,1.0327955589886444,1,0,1,0,2,0,2.4444444444444446,0,2.6666666666666665,0,2.1666666666666665,0,1.1428571428571428,0,1,0,2.108108108108108,0,1,0,0,-0.673090590016849,-0.4013584353189139,-0.5372245126678814,2,2,2,2,2,2,2,1,1,0.9759000729485332,2,0,1,-0.37981704324605103,4,4,4,4,2,2,4,6,7,3,3,1.0690449676496976,6.5,3.4285714285714284,0,0.3129387823351568,0,0.1836372409762612,1,1,1,1,1,5,4,5,5,1,5,2,5,1,4,5,4,2,4,2,1.486446705914413,1,0,3.6,0,3.8,0,3.4,0,3.6,0,1,1,1,2,1,1,1,2,1,1,1,2,1,1,1,2,1,1,1,1,0.8207826816681233,1.2,0,1,1,1,2,1,1,1,2,1,1,1,2,1,1,1,2,1,1,1,1,0.8207826816681233,1.2,0,I lived with my mother and father an equal amount of time (joint custody),0,"White, Caucasian, Anglo, European American",0,30,0,1,NA,1,3,8,Attorney,5,185,70,2,5,2,0,0,1,0,0,I lived with my mother and father an equal amount of time (joint custody),0,TRUE,TRUE,TRUE,TRUE,TRUE,1,1.3077625000029802,1.1256062499918043,0.6522322580660543,1.2793843750096858,1.0554599999984104,0.7559642857355731,1,1,1,1,0.9375,0.875,0.083,0.399,0.339,0.01,1.487,142.98747420231217,2096.5582989316454,0.082,0.398,0.326,0.009,1.634,147.03216280292634,2079.5787481000043,304,0.9007407407407407,1,3,0,3,6,FALSE
100,2022-03-18T16:57:44Z,2022-03-18T17:21:09Z,1404,1,2022-03-18T17:21:11Z,0.8999999761581421,Chrome,99.0.4844.74,Macintosh,1440,900,NA,1.6,523,94,375,102,82,87,-0.31842085422295396,-0.13243266711851154,-0.13299916285584087,0.046648478322216774,0.43082606495709547,-0.12855133840610475,4,4,3,4,4,1,2,4,1,4,4,2,2,2,4,4,2,1,4,4,0.8271701918685112,0,1,4,2,2,3,0,5,2,4,4,4,5,5,4,4,5,3,5,1,5,5,2,5,1,3,4,5,5,2,0,2,0,0,0,0,3,4,2,2,3,4,4,4,5,4,2,4,1,5,1,3,4,5,5,5,5,4,1,3,1,5,5,2,1,1,1,3,5,4,1,5,5,2,3,1,1,1.572091432287407,1.624221425205085,3.375,0,1.75,0,4.066666666666666,0,3.4444444444444446,0,3.6666666666666665,0,3.1666666666666665,0,2.4285714285714284,0,3.6666666666666665,0,3.2972972972972974,0,0,0,0,1.7876163012164392,-0.361969541370789,0.7128233799228251,2,3,4,3,2,3,2,3,6,0.7559289460184544,2.7142857142857144,0,4.5,1.387293050858471,1,1,3,3,1,1,2,3,3,2,1,1.2909944487358056,3,1.7142857142857142,0,-1.2220824283401586,0,-1.6811589111307743,2,3,2,2,2,4,2,4,4,3,5,4,5,4,4,5,5,4,4,4,1.2983506020002016,2.2,0,4.4,0,3.8,0,4,0,4.066666666666666,0,1,2,1,2,2,1,2,1,1,1,2,3,2,1,1,2,1,1,1,2,0.8645047258706176,1.5,0,1,2,1,2,2,1,2,1,1,1,2,3,2,1,1,2,1,1,1,2,0.8645047258706176,1.5,0,I lived with my mother and father an equal amount of time (joint custody),0,"White, Caucasian, Anglo, European American",0,29,1,2,NA,1,3,6,administrative assistant and homemaker,5,122,63,4,5,2,0,0,1,0,0,I lived with my mother and father an equal amount of time (joint custody),0,TRUE,TRUE,TRUE,TRUE,TRUE,3,0.6693483870967982,0.6295218750000349,0.5549968749999534,0.7022709677418875,0.6165741935484712,0.7027483870968102,0.96875,1,1,0.96875,1,0.96875,0.08,0.412,0.571,0.007,1.318,12.344934369545907,1851.8916191653714,0.081,0.412,0.575,0.007,1.384,25.605388680297683,1849.4996303224405,442,1.3096296296296297,0,3,0,0,3,FALSE
101,2022-03-18T16:57:08Z,2022-03-18T17:21:17Z,1448,1,2022-03-18T17:21:18Z,1,Chrome,87.0.4280.88,Macintosh,1280,800,interesting study,1.6,798,83,305,67,59,68,0.24600863511991072,-0.19306654708277926,-0.38695711915863146,-0.38428926733229946,-0.04017313177132391,-0.3419715215851719,4,4,4,4,4,3,4,4,2,4,4,4,3,2,4,4,4,3,4,4,1.3088765773505315,0,0,2,4,3,3.65,0,4,3,5,3,3,3,4,4,3,4,4,5,1,4,4,2,3,1,1,2,4,4,3,0,2,0,0,0,0,3,4,3,4,4,2,2,2,4,3,2,4,1,5,1,5,5,4,4,5,5,3,3,1,1,2,5,2,1,1,1,5,5,4,1,3,2,1,1,1,1,1.4503805030417376,1.1464230084422218,2.5,0,1,0,3.6,0,3.111111111111111,0,3.6666666666666665,0,2.5,0,2.7142857142857144,0,2,0,3.027027027027027,0,0,0,0,1.08319330931385,-0.6205191861769039,0.231337061568473,2,2,3,1,1,3,2,2,1,1.1126972805283737,2,0,1.5,-0.18656444200223082,2,3,4,4,1,1,2,7,7,3,3,1.3801311186847085,7,2.4285714285714284,0,0.4032826894249255,0,-0.3032803082122433,1,2,1,1,1,5,5,5,5,3,5,5,4,4,5,5,5,5,5,5,1.869555587629877,1.2,0,5,0,4.4,0,4.8,0,4.733333333333333,0,4,4,4,4,4,4,4,1,3,4,2,4,3,4,4,4,4,4,4,4,1.1367080817685316,3.65,0,4,4,4,4,4,4,4,1,3,4,2,4,3,4,4,4,4,4,4,4,1.1367080817685316,3.65,0,I lived with my mother and father an equal amount of time (joint custody),0,Middle Eastern,0,25,1,2,NA,1,3,6,piano teacher,4,240,64,1,5,2,0,0,1,0,0,I lived with my mother and father an equal amount of time (joint custody),0,TRUE,TRUE,TRUE,TRUE,TRUE,5,0.7668056451615074,0.6913479999995713,0.711545166666959,0.7891898333337546,0.6946745161293449,0.801214354839636,1,0.967741935483871,1,0.9375,0.96875,0.96875,0.069,0.48,0.254,0.024,1.573,86.40077019088488,1924.2599369318284,0.081,0.452,0.306,0.009,1.183,76.5281679695288,1902.1167655582665,272,0.8059259259259259,0,3,0,6,9,FALSE
102,2022-03-18T16:39:23Z,2022-03-18T17:21:30Z,2527,1,2022-03-18T17:21:31Z,0.8999999761581421,Edge,99.0.1150.39,Windows NT 10.0,1920,1080,no,1.7777777777777777,935,154,415,96,58,74,0.5271971443561743,0.19829758723203963,0.012119669317182318,-0.02722656378998601,-0.060651357716037795,-0.2745756742654665,2,2,1,1,3,1,2,3,1,2,2,1,1,1,2,2,2,1,2,2,0.9176629354822471,0,1,1,4,3,1.7,0,5,2,3,2,4,1,2,1,2,1,1,2,2,2,2,1,3,5,1,2,1,3,1,0,2,0,0,0,0,1,2,2,1,1,1,1,1,1,2,2,1,1,3,1,2,2,3,1,1,1,2,1,1,1,2,1,1,1,1,1,3,5,1,1,1,1,1,1,1,1,1.6934780387911346,1.3972762620115438,2.125,0,1,0,2.1333333333333333,0,1.2222222222222223,0,1.6666666666666667,0,1.3333333333333333,0,1.8571428571428572,0,1,0,1.4864864864864864,0,0,0,0,-0.3948449845804063,-0.6205191861769039,-0.5076820853786551,1,2,2,1,1,2,1,1,1,1.6035674514745464,1.4285714285714286,0,1,-0.7112905515642753,5,5,5,5,2,2,3,3,4,2,3,1.4638501094227998,3.5,3.857142857142857,0,-0.44320235072730735,0,-0.04499026060182437,2,2,2,1,2,5,3,4,5,3,5,4,2,2,4,5,4,5,4,1,1.4474937289114918,1.8,0,4.6,0,3.4,0,3.2,0,3.7333333333333334,0,1,3,3,1,3,2,3,4,2,1,3,3,1,3,1,3,2,2,1,3,0.9333020044867296,2.25,0,1,3,3,1,3,2,3,4,2,1,3,3,1,3,1,3,2,2,1,3,0.9333020044867296,2.25,0,I lived with my mother and father an equal amount of time (joint custody),0,"White, Caucasian, Anglo, European American",0,29,1,2,NA,1,3,3,Administrative Assistant,3,150,68,1,5,2,0,0,1,0,0,I lived with my mother and father an equal amount of time (joint custody),0,TRUE,TRUE,TRUE,TRUE,TRUE,4,0.5875593749992549,0.5433343749828636,0.5074000000039737,0.6267709677488573,0.6210357142771993,0.591556666680177,1,1,1,0.96875,0.9333333333333333,0.9375,0.07,0.362,0.472,0.02,1.782,70.29830126849663,1914.5289703343253,0.074,0.36,0.557,0.019,1.978,79.01089438404617,1924.0159595387388,280,0.8296296296296296,0,3,0,3,6,FALSE
103,2022-03-18T16:47:48Z,2022-03-18T17:21:30Z,2021,1,2022-03-18T17:21:32Z,1,Safari,15.3,Macintosh,1440,900,NA,1.6,961,252,435,85,69,131,0.5805613869849542,0.7384903360046066,0.08467908540369391,-0.16266414099569113,0.16460912767581495,0.365684875271735,3,2,1,2,3,2,1,2,2,3,3,3,1,3,3,2,2,2,3,3,0.6407232755171874,0,1,4,3,3,2.3,0,2,2,1,2,1,1,3,3,1,2,1,2,2,3,1,3,1,1,1,3,3,3,1,0,1,1,0,0,0,1,1,1,1,1,1,1,1,1,1,1,1,1,1,2,1,1,1,1,1,3,2,2,1,1,3,1,3,1,1,1,1,1,1,1,1,3,2,3,1,1,1.8318995212226723,1.4040757000349275,2,0,1.75,0,1.8,0,1,0,1.25,0,1.6666666666666667,0,1.2857142857142858,0,1.6666666666666667,0,1.2972972972972974,0,0,0,0,-0.6778149582732866,-0.361969541370789,-0.5198922498220379,3,3,4,2,2,2,2,1,1,0.4879500364742666,2.5714285714285716,0,1,-0.048343534927826504,3,3,4,3,2,2,3,5,3,3,2,0.6900655593423543,4,2.857142857142857,0,-0.4830488383752279,0,-0.6112656695307566,2,3,2,3,2,4,3,4,4,3,3,4,4,5,4,3,4,4,3,3,0.9258200997725514,2.4,0,3.8,0,3.2,0,4,0,3.6666666666666665,0,1,2,3,3,3,3,3,2,1,3,4,2,2,3,1,2,3,3,3,3,0.8207826816681233,2.5,0,1,2,3,3,3,3,3,2,1,3,4,2,2,3,1,2,3,3,3,3,0.8207826816681233,2.5,0,NA,NA,"White, Caucasian, Anglo, European American",0,30,1,2,NA,1,3,3,"no full or part time job, just side work in the creative field to help supplement husband's income",3,160,67,1,5,2,0,0,0,0,0,NA,NA,TRUE,TRUE,TRUE,TRUE,TRUE,2,0.49396875000001456,0.46015625000000365,0.47065625000001093,0.573064516129021,0.5200624999999782,0.5602812499999945,1,1,1,0.96875,1,1,0.076,0.365,0.685,0.016,1.567,43.50766750442785,1828.5145493338282,0.08,0.368,0.79,0.018,1.686,43.245460019586034,1826.9870826902986,436,1.2918518518518518,0,3,0,0,3,FALSE
104,2022-03-18T16:51:31Z,2022-03-18T17:21:47Z,1816,1,2022-03-18T17:21:48Z,0.8999999761581421,Chrome,99.0.4844.74,Windows NT 10.0,1920,1080,NA,1.7777777777777777,679,132,656,162,49,61,0.0017646015497256454,0.0770298273035042,0.886460633159647,0.7853988994442447,-0.24495539121846277,-0.4206000101248282,3,2,1,2,3,1,1,3,1,3,3,1,1,1,3,2,1,1,3,3,0.6708203932499369,0,0,1,3,1,1.95,0,2,3,2,3,2,1,2,2,2,2,2,2,3,2,2,1,1,1,2,1,1,1,1,3,1,2,0,2,0,2,3,3,2,4,3,4,4,4,3,4,2,1,4,2,4,1,1,1,1,1,2,1,2,1,4,3,1,3,3,1,1,1,2,1,2,1,2,1,2,2,1.109608593708264,1.01418510567422,1.125,0,1.75,0,2.1333333333333333,0,3.2222222222222223,0,2.0833333333333335,0,2.1666666666666665,0,1.7142857142857142,0,1.3333333333333333,0,2.2432432432432434,0,2,0,0,-0.5011432703502533,0.07635196034519101,-0.21239565500253116,2,2,4,2,2,2,2,1,1,0.7559289460184544,2.2857142857142856,0,1,-0.2140802890869389,2,2,4,1,1,1,1,3,3,2,2,1.6035674514745464,3,1.7142857142857142,0,-0.8778143430786174,0,-1.471309494218438,3,3,4,2,3,2,2,3,3,2,1,2,4,3,3,2,2,2,2,3,0.9611501047232549,3,0,1.8,0,2.4,0,3,0,2.4,0,1,1,1,2,2,1,2,3,2,1,1,3,1,2,2,3,1,2,2,1,0.5982430416161189,1.7,0,1,1,1,2,2,1,2,3,2,1,1,3,1,2,2,3,1,2,2,1,0.5982430416161189,1.7,0,"I lived with my mother, but not father, most of the time. & I lived with my mother and father an equal amount of time (joint custody) & I lived with my extended family on mother's side (grandparents, aunts ,uncles, cousins)",1,"Asian or Asian American (e.g., Chinese, Japanese, and others)",0,25,0,1,NA,1,2,6,Receptionist,2,190,70,3,5,2,0,0,1,0,0,"I lived with my mother, but not father, most of the time. & I lived with my mother and father an equal amount of time (joint custody) & I lived with my extended family on mother's side (grandparents, aunts ,uncles, cousins)",1,TRUE,TRUE,TRUE,TRUE,TRUE,3,0.4882968750000073,0.439441935483877,0.41841249999999125,0.5322374999999956,0.49089374999999563,0.47422333333333955,1,0.96875,1,1,1,0.9375,0.051,0.331,0.621,0.02,1.834,96.66122493117874,1961.4737330549945,0.053,0.33,0.652,0.026,1.91,120.25059838734816,1964.2355337712204,328,0.9718518518518519,0,3,0,3,6,FALSE
105,2022-03-18T16:59:18Z,2022-03-18T17:22:29Z,1390,1,2022-03-18T17:22:29Z,0.8999999761581421,Chrome,99.0.4844.51,Windows NT 6.1,1920,1080,"On the first scale from 1-5/6 scales during the family questions (I think) there was a 6th option that read something like ""Click to write text"" so I think that 6th column was not meant to be there and didn't get caught when reviewing the study before posting it.",1.7777777777777777,559,99,387,79,63,73,-0.24453190289079713,-0.10487181258929895,-0.0894635132039339,-0.2365391831078939,0.04173977200753163,-0.2858083154854174,3,2,2,1,2,1,1,3,1,2,3,1,2,1,2,2,1,1,2,3,0.8522416262267903,0,0,2,3,3,1.8,0,4,2,2,3,2,2,3,3,2,2,3,3,2,3,3,2,3,1,2,2,3,1,3,8,1,1,0,0,0,2,2,4,4,4,2,4,3,3,3,3,2,3,4,4,2,4,4,3,2,3,4,1,2,2,4,2,2,3,3,3,2,1,2,1,3,2,3,3,2,2,0.9388191419977446,0.6324555320336759,2.125,0,2.5,0,2.6,0,3.111111111111111,0,3.0833333333333335,0,2.5,0,2.2857142857142856,0,2,0,2.7567567567567566,0,4,0,0,0.36420351528724404,0.7732231068672859,0.568713311077265,2,2,3,1,1,2,1,6,1,1.1547005383792515,1.7142857142857142,0,3.5,0.4207092088139378,3,3,4,4,2,2,3,4,4,3,2,0.816496580927726,4,3,0,-0.4830488383752279,0,-0.5338389710810847,1,2,1,2,1,5,5,4,5,4,5,5,5,4,5,4,5,5,3,4,1.6987390281365427,1.4,0,5,0,4.2,0,4.4,0,4.533333333333333,0,1,2,1,2,1,1,2,3,2,1,4,3,2,1,3,4,1,1,3,1,0.910465468000326,1.95,0,1,2,1,2,1,1,2,3,2,1,4,3,2,1,3,4,1,1,3,1,0.910465468000326,1.95,0,I lived with my mother and father an equal amount of time (joint custody),0,"White, Caucasian, Anglo, European American",0,23,1,1,NA,1,4,6,Unemployed,5,148,62,1,5,2,0,0,1,0,0,I lived with my mother and father an equal amount of time (joint custody),0,TRUE,TRUE,TRUE,TRUE,TRUE,5,0.4692258064525743,0.4145062500024214,0.4398968750024214,0.5409580645109376,0.4829500000009934,0.5446516129057254,0.96875,1,1,0.96875,0.9375,0.96875,0.071,0.324,0.567,0.013,1.556,78.9236526941945,1899.279035319663,0.07,0.324,0.64,0.012,1.619,73.10712371362798,1899.3413752463632,320,0.9481481481481481,0,3,0,0,3,FALSE
106,2022-03-18T17:05:49Z,2022-03-18T17:22:47Z,1017,1,2022-03-18T17:22:48Z,0.8999999761581421,Chrome,99.0.4844.51,Windows NT 10.0,1366,768,NA,1.7786458333333333,497,66,235,53,41,65,-0.3717850968517339,-0.2867734524821021,-0.640915075461422,-0.5566643655941059,-0.40878119877617386,-0.3756694452450246,2,2,2,2,2,1,3,3,1,3,3,2,2,1,3,3,1,1,3,3,0.6863327411532597,0,1,1,2,2,2.15,0,1,1,3,2,3,3,4,2,1,3,2,3,1,3,3,1,2,1,1,1,1,1,2,1,2,0,0,0,0,2,2,5,2,3,2,3,2,4,1,2,3,1,2,2,2,3,2,2,2,3,1,1,1,1,4,3,1,2,1,1,2,2,2,2,2,1,2,3,1,1,1.238763308519644,1.1872336794093274,1.25,0,1.75,0,2.3333333333333335,0,2.7777777777777777,0,2.0833333333333335,0,1.8333333333333333,0,1.5714285714285714,0,1.6666666666666667,0,2.081081081081081,0,1,0,0,-0.42998247348766117,-0.14280879051279902,-0.2863956320002301,2,2,3,3,1,3,2,3,1,0.9759000729485332,2.2857142857142856,0,2,0.1724249134007015,4,4,4,4,3,4,4,6,3,4,3,0.7867957924694432,4.5,3.857142857142857,0,0.16564084449993424,0,0.3261315336603906,2,3,3,2,3,4,4,4,4,3,3,4,5,4,4,3,4,4,4,3,1,2.6,0,3.8,0,3.8,0,3.8,0,3.8,0,2,1,4,3,4,4,3,3,3,1,3,4,3,4,1,3,2,4,2,3,1.0990426455975697,2.85,0,2,1,4,3,4,4,3,3,3,1,3,4,3,4,1,3,2,4,2,3,1.0990426455975697,2.85,0,I lived with my mother and father an equal amount of time (joint custody),0,"White, Caucasian, Anglo, European American",0,22,0,1,NA,1,3,6,Unemployed,1,200,69,2,5,2,0,0,1,0,0,I lived with my mother and father an equal amount of time (joint custody),0,TRUE,TRUE,TRUE,TRUE,TRUE,2,0.43823125000670554,0.48160624999180435,0.4135343750007451,0.49495862069212154,0.49586250000819565,0.4975071428673608,1,1,1,0.90625,1,0.9032258064516129,0.057,0.329,0.687,0.019,1.759,37.62283844724539,1911.542173225255,0.057,0.33,0.696,0.021,1.848,53.15370796025803,1911.9800100254583,430,1.2740740740740741,0,3,0,0,3,FALSE
108,2022-03-18T17:06:16Z,2022-03-18T17:22:51Z,995,1,2022-03-18T17:22:52Z,0.8999999761581421,Chrome,99.0.4844.51,Windows NT 10.0,1280,720,NA,1.7777777777777777,493,78,217,51,33,69,-0.37999498033308465,-0.22062740161199185,-0.7062185499392825,-0.581289379631507,-0.572607006333885,-0.33073888036522103,2,2,1,1,1,1,1,3,1,1,3,1,1,1,1,1,1,1,2,2,1.2523661815266247,0,1,2,3,3,1.4,0,2,1,2,1,2,1,1,1,1,1,1,1,2,1,1,1,1,1,1,1,2,2,1,0,2,0,0,0,0,1,1,1,1,2,1,1,1,1,1,1,1,1,2,1,1,2,2,1,1,1,3,1,1,1,1,1,1,1,1,1,1,1,1,1,1,1,1,1,1,1,1.834766024965136,1.8516401995451028,1.25,0,1,0,1.2666666666666666,0,1.1111111111111112,0,1.25,0,1.3333333333333333,0,1,0,1,0,1.162162162162162,0,0,0,0,-1.2976914432533773,-0.6205191861769039,-0.9591053147151406,1,1,3,1,1,1,1,1,1,1.5735915849388864,1.2857142857142858,0,1,-0.7941589286438315,5,5,5,5,3,3,5,6,4,4,4,1.5735915849388864,5,4.428571428571429,0,0.6002528368512442,0,0.9007570843306134,2,2,2,3,2,4,3,5,5,3,5,4,4,2,3,3,4,5,3,4,1.0465362369445672,2.2,0,4.4,0,3.2,0,3.8,0,3.8,0,1,1,1,3,1,1,3,3,1,1,2,3,1,3,1,3,1,1,1,3,0.7591546545162482,1.75,0,1,1,1,3,1,1,3,3,1,1,2,3,1,3,1,3,1,1,1,3,0.7591546545162482,1.75,0,I lived with my mother and father an equal amount of time (joint custody),0,"White, Caucasian, Anglo, European American",0,29,1,2,NA,1,4,6,healthcare worker,5,110,61,3,5,2,0,0,1,0,0,I lived with my mother and father an equal amount of time (joint custody),0,TRUE,TRUE,TRUE,TRUE,TRUE,2,0.5542906250022351,0.48684375,0.5756437500007451,0.6133375000003726,0.5436687500057742,0.6194343750001863,1,1,1,1,1,1,0.097,0.385,0.493,0.069,1.888,25.7071402801359,1819.847830713181,0.094,0.387,0.492,0.055,1.977,38.16556457232511,1823.1606659064446,292,0.8651851851851852,0,3,0,0,3,FALSE
109,2022-03-18T16:57:44Z,2022-03-18T17:24:24Z,1600,1,2022-03-18T17:24:25Z,1,Chrome,97.0.4692.99,Macintosh,1440,900,N/A,1.6,578,133,464,129,114,113,-0.20553495635438102,0.08254199820934673,0.1898902387291357,0.3790861678271293,1.0861292951879398,0.1634973333126187,2,1,1,1,1,1,2,2,1,1,2,1,1,1,2,1,1,1,2,1,1.3018205875255096,0,1,1,4,5,1.3,0,4,2,3,3,5,4,3,4,3,4,4,3,2,3,4,2,3,1,1,2,3,3,2,2,2,0,0,0,0,2,4,1,2,2,2,2,2,1,3,1,3,2,3,2,1,4,3,3,4,2,2,1,1,1,3,1,2,2,2,1,3,3,2,2,4,2,2,1,2,2,1.2460146678721533,0.8837151016885368,2.125,0,1.75,0,3.4,0,2,0,2.5833333333333335,0,1.5,0,2.142857142857143,0,2.6666666666666665,0,2.189189189189189,0,1,0,0,0.4657774328006532,-0.14280879051279902,0.16148432114392708,2,2,3,1,1,2,1,2,1,1.1547005383792515,1.7142857142857142,0,1.5,-0.3523011961613431,3,3,3,2,1,1,2,6,6,3,2,1.1338934190276817,6,2.142857142857143,0,-0.12167321001615315,0,-0.778121801942321,3,2,3,3,4,3,5,3,4,1,5,4,3,4,3,5,3,4,4,4,1.2227992865708155,3,0,3.8,0,3.6,0,3.6,0,3.6666666666666665,0,2,2,1,2,3,1,2,1,1,1,2,1,1,2,1,1,1,1,1,3,1.1239029738980326,1.5,0,2,2,1,2,3,1,2,1,1,1,2,1,1,2,1,1,1,1,1,3,1.1239029738980326,1.5,0,I lived with my mother and father an equal amount of time (joint custody),0,"White, Caucasian, Anglo, European American",0,22,1,2,NA,1,3,6,Editor,4,150,66,3,5,2,0,0,1,0,0,I lived with my mother and father an equal amount of time (joint custody),0,TRUE,TRUE,TRUE,TRUE,TRUE,1,0.6563187499998894,0.5772187500000291,0.5949343749998952,0.6826387096773232,0.610649999999965,0.6193838709676638,1,1,1,1,1,1,0.065,0.468,0.531,0.044,1.543,64.76968230882169,1883.665891504494,0.068,0.46,0.521,0.04,1.63,81.59340069960018,1864.742128629588,432,1.28,0,3,0,0,3,FALSE
110,2022-03-18T17:05:36Z,2022-03-18T17:24:48Z,1151,1,2022-03-18T17:24:50Z,1,Chrome,97.0.4692.71,Windows NT 10.0,1920,1080,"Thanks for the survey, I hope you have a wonderful day.",1.7777777777777777,520,81,298,62,35,100,-0.324578266833967,-0.2040908888944643,-0.4123529147889105,-0.4458518024258018,-0.5316505544444572,0.017472997453256978,2,2,2,3,3,1,1,3,1,3,3,1,2,2,3,3,1,1,3,3,0.6708203932499369,0,0,2,4,4,2.15,0,3,2,2,2,2,1,2,2,1,1,2,2,2,2,3,5,4,4,2,3,4,3,4,3,2,0,0,0,0,1,2,1,2,3,1,1,1,2,5,2,5,3,1,2,2,2,3,5,4,3,3,2,2,1,4,3,1,2,1,1,2,2,2,1,2,2,1,2,1,1,1.4110248016923697,1.1832159566199232,3.625,0,1.25,0,1.9333333333333333,0,1.5555555555555556,0,3.0833333333333335,0,2.5,0,1.5714285714285714,0,1.6666666666666667,0,2.2162162162162162,0,2,0,0,0.49215515556576384,-0.09601446952555226,0.1980703430201058,2,2,3,1,1,1,1,4,4,1.2149857925879117,1.5714285714285714,0,4,0.5310934329782019,5,5,5,5,3,2,3,6,6,5,4,1.2909944487358056,6,4,0,0.9950183415546338,0,0.909107226071904,2,2,3,2,2,4,4,2,4,3,3,3,4,4,3,2,3,4,3,3,0.7559289460184544,2.2,0,3.4,0,3.2,0,3.2,0,3.2666666666666666,0,1,3,3,3,3,2,3,2,2,2,1,3,1,1,1,3,1,2,2,2,0.7591546545162482,2.05,0,1,3,3,3,3,2,3,2,2,2,1,3,1,1,1,3,1,2,2,2,0.7591546545162482,2.05,0,"I lived with my mother, but not father, most of the time. & I lived with my mother and father an equal amount of time (joint custody)",1,"Hispanic of Latino (e.g., Mexican American, Central American, and others) & White, Caucasian, Anglo, European American",1,23,0,1,NA,1,1,5,self-employed,2,145,71,2,5,2,0,0,1,0,0,"I lived with my mother, but not father, most of the time. & I lived with my mother and father an equal amount of time (joint custody)",1,TRUE,TRUE,TRUE,TRUE,TRUE,3,0.45244193548252504,0.40443125000130387,0.450984374997206,0.5776833333363136,0.49233448275409897,0.5399906250014901,0.96875,1,1,0.9375,0.90625,1,0.11,0.291,0.699,0.022,1.964,14.649830617871164,1808.5529482392762,0.11,0.291,0.702,0.022,2.061,21.522796492413804,1804.5197906545454,284,0.8414814814814815,0,3,0,3,6,FALSE
111,2022-03-18T17:08:42Z,2022-03-18T17:25:44Z,1022,1,2022-03-18T17:25:45Z,0.8999999761581421,Firefox,98.0,Windows NT 10.0,1366,768,I had a great time completing the survey.,1.7786458333333333,486,59,248,55,31,67,-0.39436227642544847,-0.32535864882299975,-0.5937514550051894,-0.532039351556705,-0.6135634582233127,-0.35320416280512285,1,1,1,1,1,1,1,1,1,1,1,1,1,1,1,1,1,1,1,1,1.538967528127731,0,1,1,5,5,1,0,1,1,1,1,1,1,1,1,1,1,1,1,1,1,1,1,1,1,1,1,1,1,1,0,2,0,0,0,0,1,1,1,1,1,1,1,1,1,1,1,1,1,1,1,1,1,1,1,1,1,1,1,1,1,1,1,1,1,1,1,1,1,1,1,1,1,1,1,1,1,1.9666895707934864,2.065591117977289,1,0,1,0,1,0,1,0,1,0,1,0,1,0,1,0,1,0,0,0,0,-1.5943424000221917,-0.6205191861769039,-1.1074307930995477,1,1,5,1,1,1,1,1,1,1.5118578920369088,1.5714285714285714,0,1,-0.6284221744847194,5,5,5,5,1,1,5,4,3,3,3,2.138089935299395,3.5,3.857142857142857,0,-0.22912466020345523,0,0.08550129657008435,1,1,1,1,1,5,5,5,5,5,5,5,5,5,5,5,5,5,5,5,2.065591117977289,1,0,5,0,5,0,5,0,5,0,1,1,1,1,1,1,1,1,1,1,1,1,1,1,1,1,1,1,1,1,1.231174022502185,1,0,1,1,1,1,1,1,1,1,1,1,1,1,1,1,1,1,1,1,1,1,1.231174022502185,1,0,I lived with my mother and father an equal amount of time (joint custody),0,Black or African American,0,29,0,1,NA,1,3,3,Trnasportation,3,170,66,4,5,2,0,0,1,0,0,I lived with my mother and father an equal amount of time (joint custody),0,TRUE,TRUE,TRUE,TRUE,TRUE,5,0.53703125,0.4908125,0.5074375,0.6039687499999999,0.53575,0.58315625,1,1,1,1,1,1,0.142,0.335,0.828,0.018,1.603,4.438404744159339,1789.9172499863073,0.144,0.334,0.844,0.019,1.671,7.449277192256529,1788.4583924948388,334,0.9896296296296296,0,3,0,0,3,FALSE
112,2022-03-18T17:10:01Z,2022-03-18T17:26:06Z,965,1,2022-03-18T17:26:07Z,1,Chrome,98.0.4758.109,Macintosh,1440,900,NA,1.6,497,60,204,53,32,75,-0.3717850968517339,-0.3198464779171572,-0.753382170395515,-0.5566643655941059,-0.5930852322785988,-0.2633430330455156,1,2,1,1,2,1,1,1,1,2,2,1,1,1,1,1,1,1,3,2,1.268027892769755,0,0,2,3,2,1.35,0,4,1,1,2,1,1,2,2,1,1,1,2,3,2,2,1,1,1,1,1,1,1,1,1,2,0,0,0,0,1,1,1,1,1,1,1,1,1,1,1,1,1,1,1,1,1,1,1,1,1,1,1,1,1,1,1,1,2,1,1,1,1,1,1,1,1,1,1,1,1,1.9521298140264163,1.505545305418162,1,0,1,0,1.7333333333333334,0,1,0,1,0,1,0,1.1428571428571428,0,1,0,1.027027027027027,0,1,0,0,-1.2620618326527433,-0.4013584353189139,-0.8317101339858286,1,1,3,1,1,1,1,1,1,1.5735915849388864,1.2857142857142858,0,1,-0.7941589286438315,5,5,5,4,2,2,5,3,2,4,3,1.7182493859684491,2.5,4,0,-0.1957347838591405,0,0.1832808722732674,1,1,1,1,1,5,4,5,5,2,5,3,5,3,4,5,4,5,3,3,1.2649110640673518,1,0,4.4,0,3.8,0,4,0,4.066666666666666,0,1,2,1,1,1,1,1,1,1,1,2,2,1,1,1,1,2,1,1,1,1.1285761872936695,1.2,0,1,2,1,1,1,1,1,1,1,1,2,2,1,1,1,1,2,1,1,1,1.1285761872936695,1.2,0,I lived with my mother and father an equal amount of time (joint custody),0,"White, Caucasian, Anglo, European American",0,22,1,2,NA,1,3,6,student,5,88,59,2,5,2,0,0,0,0,0,I lived with my mother and father an equal amount of time (joint custody),0,TRUE,TRUE,TRUE,TRUE,TRUE,1,0.5780468749962747,0.5045843749977649,0.5134875000044703,0.7153064516109805,0.5982466666638852,0.6454107142899718,1,1,1,0.96875,0.967741935483871,0.875,0.082,0.272,0.318,0.011,1.708,91.69128511839575,2013.6951474805292,0.082,0.274,0.337,0.01,1.836,117.67529449166051,2021.3176729618183,431,1.2770370370370372,0,0,0,0,3,FALSE
113,2022-03-18T17:05:44Z,2022-03-18T17:26:27Z,1242,1,2022-03-18T17:26:28Z,0.8999999761581421,Chrome,99.0.4844.74,Windows NT 10.0,1440,900,NA,1.6,501,65,365,103,38,76,-0.3635752133703831,-0.2922856233879446,-0.16927887089909666,0.05896098534091724,-0.4702158766103155,-0.2521103918255647,1,1,1,1,1,1,1,1,1,1,1,1,1,1,1,1,1,1,1,1,1.538967528127731,1,0,1,4,5,1,0,3,1,1,1,1,2,1,3,1,1,1,2,2,2,3,3,3,3,1,3,3,3,2,2,2,0,0,0,0,3,1,4,1,1,1,1,1,1,1,5,1,1,2,1,1,3,3,3,3,3,3,1,3,2,2,1,1,2,2,2,1,1,1,1,1,1,1,2,2,2,1.5849328099361222,1.5796322658258457,2.625,0,1.75,0,1.6666666666666667,0,1.5555555555555556,0,2.25,0,2,0,1.4285714285714286,0,1,0,1.7837837837837838,0,1,0,0,-0.2503580554043546,-0.14280879051279902,-0.19658342295857678,1,2,2,1,1,1,1,1,1,1.6761634196950514,1.2857142857142858,0,1,-0.7941589286438315,5,5,5,5,4,4,5,6,5,4,4,1.4638501094227998,5.5,4.714285714285714,0,0.6905967439410129,0,1.110679821189156,3,1,3,3,3,3,4,2,5,2,3,4,3,5,5,2,4,4,4,1,1.1872336794093274,2.6,0,3.6,0,3,0,3.6,0,3.4,0,1,1,1,1,2,1,1,1,1,1,1,1,1,1,1,1,3,2,1,1,1.2396943596157715,1.2,0,1,1,1,1,2,1,1,1,1,1,1,1,1,1,1,1,3,2,1,1,1.2396943596157715,1.2,0,I lived with my mother and father an equal amount of time (joint custody),0,"White, Caucasian, Anglo, European American",0,26,1,2,NA,1,2,5,Housekeeper,1,160,69,3,5,2,0,0,1,0,0,I lived with my mother and father an equal amount of time (joint custody),0,TRUE,TRUE,TRUE,TRUE,TRUE,6,0.6774281250024214,0.513422580644969,0.5617812499990686,0.7403258064504593,0.6074580645186286,0.646971875000745,1,1,1,0.96875,0.96875,1,0.199,0.216,0.606,0.012,1.402,17.27512155320229,1803.16267282591,0.198,0.213,0.601,0.012,1.468,24.493261951245636,1806.823418950857,294,0.8711111111111112,0,3,0,0,3,FALSE
114,2022-03-18T17:06:38Z,2022-03-18T17:27:06Z,1228,1,2022-03-18T17:27:07Z,0.8999999761581421,Chrome,99.0.4844.74,Windows NT 10.0,1536,864,I got up from my computer to take a bathroom break during the attention game fyi,1.7777777777777777,671,92,233,58,45,66,-0.014655165412975873,-0.14345700893019658,-0.6481710170700732,-0.49510183050060363,-0.3268682949973183,-0.3644368040250737,4,3,3,2,4,1,2,4,2,3,3,2,1,2,4,4,3,1,4,4,0.6805570473787206,0,0,4,3,3,2.8,0,5,2,5,2,5,5,3,5,4,4,5,5,1,5,3,4,5,3,1,4,5,4,5,2,2,0,0,0,0,2,5,5,3,4,2,3,1,5,2,2,5,2,4,4,3,4,5,5,5,5,5,1,5,1,3,3,1,1,1,1,2,4,2,1,5,5,2,5,1,1,1.5976709775647027,1.6388149028228556,3.875,0,2.25,0,3.933333333333333,0,3.3333333333333335,0,3.8333333333333335,0,3,0,1.7142857142857142,0,3.6666666666666665,0,3.1621621621621623,0,1,0,0,1.8887965213751456,0.029557639357944268,0.9591770803665449,1,1,3,1,1,1,1,4,4,1.5735915849388864,1.2857142857142858,0,4,0.3653566788190898,2,5,5,4,2,2,1,7,6,NA,2,1.5118578920369088,6.5,3,0,0.03163334552504804,1,-0.220113241597364,4,2,3,3,3,3,2,3,3,2,4,4,4,3,3,1,4,4,3,4,0.9154754164341269,3,0,3.8,0,2.4,0,3.2,0,3.1333333333333333,0,2,2,3,3,4,4,4,3,4,3,3,3,3,3,1,3,3,4,3,3,0.8750939799154206,3.05,0,2,2,3,3,4,4,4,3,4,3,3,3,3,3,1,3,3,4,3,3,0.8750939799154206,3.05,0,NA,NA,"White, Caucasian, Anglo, European American",0,30,1,2,NA,1,3,6,Admin,3,180,69,2,5,2,1,0,0,0,1,NA,NA,TRUE,TRUE,TRUE,TRUE,TRUE,4,0.537584999999986,0.437046875,0.44379375000001164,0.580809523809546,0.5165799999999814,0.523113793103474,0.6451612903225806,1,1,0.65625,0.9375,0.9354838709677419,0.056,0.333,0.488,0.012,1.408,111.77017861306233,1988.0463596571099,0.057,0.333,0.569,0.013,1.559,127.03488308630224,1975.924764752649,408,1.208888888888889,0,3,0,0,3,FALSE
115,2022-03-18T17:05:56Z,2022-03-18T17:28:25Z,1348,1,2022-03-18T17:28:26Z,0.8999999761581421,Chrome,99.0.4844.74,Windows NT 10.0,1920,1080,NA,1.7777777777777777,593,86,331,60,51,62,-0.17474789329931567,-0.1765300343652517,-0.2926298782461664,-0.4704768164632027,-0.20399893932903498,-0.40936736890487735,3,3,3,3,3,2,4,3,1,3,4,3,1,1,3,3,4,2,3,4,0.9119095061289915,0,0,2,3,2,2.8,0,4,2,5,3,5,3,4,4,4,5,4,3,1,3,4,2,4,1,1,3,4,4,3,3,1,3,0,0,0,3,1,1,2,3,1,2,1,5,4,1,3,1,4,3,1,5,5,5,5,5,4,1,1,1,5,5,1,1,1,1,2,2,3,1,3,2,4,4,1,1,1.6585387395990336,1.2344267996967353,2.75,0,2.5,0,3.6,0,2.111111111111111,0,3.5,0,2.8333333333333335,0,1.5714285714285714,0,2,0,2.5675675675675675,0,2,0,0,0.9916586743453703,0.3349016051513059,0.6632801397483381,1,1,4,1,1,1,1,1,1,1.4960264830861913,1.4285714285714286,0,1,-0.7112905515642753,3,3,4,4,1,2,1,3,5,NA,3,1.3451854182690985,4,2.5714285714285716,0,-0.12954382975590517,1,-0.5506392612718659,1,2,1,3,1,5,5,4,5,4,5,5,4,4,5,5,5,5,4,3,1.709915063331955,1.6,0,5,0,4.4,0,4.2,0,4.533333333333333,0,1,3,3,4,2,4,4,2,4,4,3,3,4,2,1,3,3,4,4,4,1.1192102478745307,3.1,0,1,3,3,4,2,4,4,2,4,4,3,3,4,2,1,3,3,4,4,4,1.1192102478745307,3.1,0,NA,NA,"White, Caucasian, Anglo, European American",0,21,1,2,NA,1,3,3,unemployed,3,162,68,3,5,2,1,0,1,0,1,NA,NA,TRUE,TRUE,TRUE,TRUE,TRUE,4,0.5866187499985098,0.4239031249899417,0.5067218750044703,0.6599258064531511,0.4906321428545884,0.796181249992922,1,1,1,1,0.875,1,0.112,0.25,0.335,0.009,1.808,252.23029932071847,2119.6074316483027,0.121,0.263,0.427,0.012,2.113,260.8835921002525,2051.6899799633447,254,0.7525925925925925,0,3,0,0,3,FALSE
117,2022-03-18T17:04:36Z,2022-03-18T17:29:10Z,1473,1,2022-03-18T17:29:11Z,1,Chrome,99.0.4844.74,Windows NT 6.1,2560,1080,NA,2.3703703703703702,824,69,360,60,49,69,0.29937287774869065,-0.2702369397645745,-0.18741872492072456,-0.4704768164632027,-0.24495539121846277,-0.33073888036522103,1,2,2,2,2,1,2,2,1,2,2,2,2,2,2,2,2,1,2,3,0.812727700887249,0,0,2,3,3,1.85,0,2,3,3,3,2,2,2,2,2,3,3,3,2,3,3,2,4,3,3,3,4,3,2,5,2,0,0,0,0,2,3,3,3,3,2,3,2,2,3,1,2,1,2,3,2,3,3,4,2,4,3,2,1,1,2,2,2,3,2,1,2,2,2,4,5,2,1,2,2,1,1.100095545945992,0.6761234037828132,3,0,1.5,0,2.533333333333333,0,2.5555555555555554,0,2.5,0,1.8333333333333333,0,2,0,3.6666666666666665,0,2.4054054054054053,0,3,0,0,0.5639064984604105,0.2093294962678094,0.38661799736410996,2,2,5,2,2,2,2,3,2,0.8997354108424374,2.4285714285714284,0,2.5,0.44854589172407777,3,3,3,3,1,1,2,7,4,2,2,1.1338934190276817,5.5,2.2857142857142856,0,-0.426094807629774,0,-0.8862560006237565,2,3,3,2,2,4,4,2,3,4,4,4,3,4,3,4,4,4,4,3,0.8618916073713346,2.4,0,4,0,3.8,0,3,0,3.6,0,2,3,2,2,2,2,2,2,1,1,2,2,3,2,2,2,1,1,1,2,0.7591546545162482,1.85,0,2,3,2,2,2,2,2,2,1,1,2,2,3,2,2,2,1,1,1,2,0.7591546545162482,1.85,0,"I lived with my mother, but not father, most of the time.",0,"White, Caucasian, Anglo, European American",0,27,0,1,NA,1,2,7,Legal Intern/Student,1,230,74,1,5,2,0,0,0,0,0,"I lived with my mother, but not father, most of the time.",0,TRUE,TRUE,TRUE,TRUE,TRUE,1,0.4895843750005588,0.5381312499996275,0.5009281249998603,0.5539678571429104,0.5553903225809336,0.6217888888898823,1,1,1,0.9032258064516129,1,0.9,0.067,0.331,0.474,0.015,1.917,128.34915901237522,2030.0453171031943,0.069,0.331,0.461,0.017,2.009,138.33967971934504,2027.336690809086,326,0.965925925925926,0,3,3,3,6,FALSE
118,2022-03-18T16:59:34Z,2022-03-18T17:29:29Z,1794,1,2022-03-18T17:29:30Z,0.8999999761581421,Chrome,99.0.4844.74,Windows NT 10.0,1920,1080,NA,1.7777777777777777,556,272,421,119,75,111,-0.2506893155018102,0.8487337541214569,0.03388749414313579,0.25596109764012465,0.28747848334409826,0.14103205087271692,1,2,1,1,2,1,3,2,1,2,2,1,1,1,2,2,2,1,2,1,1.118033988749895,0,1,1,2,3,1.55,0,4,4,4,4,5,4,4,4,2,4,2,5,1,4,5,4,4,1,1,4,3,4,3,2,2,0,0,0,0,3,5,5,4,4,3,2,2,4,2,2,4,1,4,3,3,4,4,3,3,2,1,1,1,2,3,1,1,3,3,1,3,4,2,1,1,1,1,1,2,3,1.1911838308669735,1.3020130933435712,3,0,1.75,0,3.7333333333333334,0,3.5555555555555554,0,2.9166666666666665,0,1.5,0,2.4285714285714284,0,1,0,2.5945945945945947,0,1,0,0,1.1709878194126495,-0.14280879051279902,0.5140895144499252,1,1,2,1,1,1,1,3,1,1.7320508075688772,1.1428571428571428,0,2,-0.49052210323574724,3,5,5,5,4,3,4,3,3,4,3,1.2149857925879117,3,4.142857142857143,0,-0.1053908767693718,0,0.31577691068213826,3,1,3,4,4,4,5,2,3,3,1,3,5,4,3,5,3,5,4,3,1.3093073414159542,3,0,3.2,0,4.4,0,3,0,3.533333333333333,0,1,2,2,4,3,1,2,2,2,1,2,1,1,1,1,2,2,2,1,1,0.8944271909999159,1.7,0,1,2,2,4,3,1,2,2,2,1,2,1,1,1,1,2,2,2,1,1,0.8944271909999159,1.7,0,"I lived with my father, but not mother, most of the time.",0,"White, Caucasian, Anglo, European American",0,24,1,2,NA,1,3,6,Logistics coordinator,3,215,64,3,5,2,0,0,1,0,0,"I lived with my father, but not mother, most of the time.",0,TRUE,TRUE,TRUE,TRUE,TRUE,1,0.8339129032266717,0.5479031249997206,0.5797875000005588,0.8877677419363491,0.6838906249990687,0.681425000000745,1,1,1,1,1,1,0.246,0.221,0.684,0.004,0.823,62.69008515671205,1866.6052299308262,0.246,0.22,0.685,0.004,0.836,82.28879075254112,1863.4850670819424,390,1.1555555555555557,0,3,0,6,9,FALSE
119,2022-03-18T17:01:02Z,2022-03-18T17:29:46Z,1723,1,2022-03-18T17:29:48Z,0.8999999761581421,Chrome,99.0.4844.74,Windows NT 10.0,1366,768,no,1.7786458333333333,561,180,506,115,123,71,-0.24042696115012174,0.34161403078394514,0.34226501251081004,0.2067110695653228,1.2704333286903646,-0.3082735979253192,2,1,4,4,2,3,4,2,3,2,1,3,3,4,4,4,1,3,4,4,1.1516578439248717,0,1,1,3,3,2.9,0,4,3,2,3,2,1,4,2,2,2,3,4,2,4,4,2,3,1,1,1,3,3,2,2,2,0,0,0,0,3,3,3,4,4,3,4,4,3,3,4,2,2,4,2,1,3,3,3,2,2,3,3,1,1,1,1,1,5,5,1,2,1,1,1,1,1,1,1,1,1,1.1753218203459772,0.5163977794943222,2,0,1,0,2.8,0,3.4444444444444446,0,2.5833333333333335,0,1.6666666666666667,0,2.2857142857142856,0,1,0,2.4594594594594597,0,1,0,0,0.2670586930142448,-0.4013584353189139,-0.06714987115233456,3,3,4,3,3,3,3,3,2,0.3779644730092272,3.142857142857143,0,2.5,0.8628877771218584,4,4,4,3,3,3,4,4,4,1,2,0.7559289460184544,4,3.5714285714285716,0,-0.9112042194229322,0,-0.4851152916262145,1,1,1,1,1,5,5,5,5,1,5,5,5,1,4,5,5,5,5,4,1.8387366263150307,1,0,5,0,4.2,0,3.8,0,4.333333333333333,0,2,1,1,4,1,1,1,4,2,1,2,3,1,3,2,2,2,3,3,2,0.7863975156570492,2.05,0,2,1,1,4,1,1,1,4,2,1,2,3,1,3,2,2,2,3,3,2,0.7863975156570492,2.05,0,I lived with my mother and father an equal amount of time (joint custody),0,"Hispanic of Latino (e.g., Mexican American, Central American, and others)",0,22,1,2,NA,1,2,4,self employed,1,132,64,2,5,2,0,0,1,0,0,I lived with my mother and father an equal amount of time (joint custody),0,TRUE,TRUE,TRUE,TRUE,TRUE,2,0.7261937500000931,0.6798437500000583,0.7022281250003143,0.6822687500001048,0.6714758620692481,0.8104774193545623,1,1,1,1,0.9666666666666667,1,0.172,0.32,0.479,0.014,1.651,95.73076685919017,1928.755452531611,0.175,0.32,0.469,0.019,1.723,116.0385436363417,1903.5979066410525,304,0.9007407407407407,1,3,0,0,3,FALSE
120,2022-03-18T17:13:36Z,2022-03-18T17:29:56Z,980,1,2022-03-18T17:29:57Z,0.8999999761581421,Chrome,99.0.4844.51,Macintosh,1440,900,No,1.6,482,79,219,55,40,60,-0.40257215990679923,-0.21511523070614935,-0.6989626083306313,-0.532039351556705,-0.42925942472088774,-0.43183265134477916,3,3,3,2,3,1,1,4,1,3,4,1,1,1,3,3,1,1,3,4,0.6069769786668839,0,0,4,2,2,2.3,0,3,2,4,3,4,4,3,2,3,2,3,3,2,4,3,2,2,1,1,2,3,3,3,0,2,0,0,0,0,2,2,1,2,1,1,2,1,1,2,2,2,1,2,2,1,3,3,3,3,5,3,1,1,1,1,1,1,1,1,1,3,3,2,1,1,1,1,1,1,1,1.5572170448993052,0.7559289460184544,2.125,0,1,0,3,0,1.4444444444444444,0,2.4166666666666665,0,1.3333333333333333,0,1.7142857142857142,0,1,0,1.7567567567567568,0,0,0,0,0.10200107705495393,-0.6205191861769039,-0.259259054560975,1,2,3,1,1,2,2,1,1,1.3801311186847085,1.7142857142857142,0,1,-0.5455537974051633,5,4,4,4,2,3,4,7,7,4,4,1.1338934190276817,7,3.7142857142857144,0,0.961628465210319,0,0.733900951919049,2,2,2,4,3,4,5,4,5,1,5,4,3,4,5,5,4,4,5,4,1.5675276256394517,2.6,0,4.2,0,3.8,0,4.4,0,4.133333333333334,0,2,3,1,3,3,2,4,3,2,3,3,2,1,2,1,2,2,2,2,3,0.8013147091860318,2.3,0,2,3,1,3,3,2,4,3,2,3,3,2,1,2,1,2,2,2,2,3,0.8013147091860318,2.3,0,I lived with my mother and father an equal amount of time (joint custody),0,"White, Caucasian, Anglo, European American",0,25,1,2,NA,1,3,7,Speech Therapist,2,155,68,1,5,2,0,0,0,0,0,I lived with my mother and father an equal amount of time (joint custody),0,TRUE,TRUE,TRUE,TRUE,TRUE,1,0.5606062499997206,0.4886031250001397,0.5222156249994878,0.6312999999996635,0.5672387096766502,0.584490625000326,1,1,1,0.96875,0.96875,1,0.102,0.329,0.577,0.02,1.633,87.48382254373453,1889.5435528923585,0.104,0.328,0.579,0.02,1.765,103.89186905568293,1888.1153111050503,428,1.268148148148148,0,3,0,0,3,FALSE
121,2022-03-18T17:08:46Z,2022-03-18T17:30:04Z,1278,1,2022-03-18T17:30:05Z,0.800000011920929,Chrome,99.0.4844.51,Windows NT 10.0,1536,864,no,1.7777777777777777,761,216,113,20,18,84,0.1700672129174162,0.5400521833942759,-1.0835275135891427,-0.9629770972112213,-0.8797803955045932,-0.16224926206595747,2,2,2,2,2,1,2,3,2,3,2,1,1,2,2,2,2,2,3,2,0.6958523739384593,0,1,3,4,4,2,0,4,4,1,4,2,3,3,2,2,2,2,2,4,2,3,2,3,4,4,4,4,1,3,1,2,0,0,0,0,3,2,2,3,4,3,4,3,4,3,2,2,2,2,2,3,3,2,3,2,3,2,3,3,4,3,3,3,2,2,2,4,2,2,1,1,1,2,2,2,2,0.861244298524955,0.9154754164341269,3.125,0,2,0,2.6666666666666665,0,3.111111111111111,0,2.4166666666666665,0,3,0,2.4285714285714284,0,1,0,2.5675675675675675,0,1,0,0,0.7476647387681002,-0.05662557557742737,0.34551958159533647,2,4,2,3,2,2,4,2,2,0.9511897312113419,2.7142857142857144,0,2,0.42103004463936994,3,4,3,3,3,3,2,6,6,2,4,0.4879500364742666,6,3,0,0.3527852699830773,0,-0.024354334591525528,3,3,2,3,3,3,3,2,3,4,2,3,2,4,3,2,3,4,2,3,0.7037315505489968,2.8,0,3,0,2.6,0,3,0,2.8666666666666667,0,3,2,3,3,3,2,3,2,2,2,2,1,3,1,1,2,2,2,1,2,0.8013147091860318,2.1,0,3,2,3,3,3,2,3,2,2,2,2,1,3,1,1,2,2,2,1,2,0.8013147091860318,2.1,0,"I lived with my mother, but not father, most of the time. & I lived with my father, but not mother, most of the time.",1,"Asian or Asian American (e.g., Chinese, Japanese, and others)",0,22,0,1,NA,1,4,6,sales consultant,3,198,77,4,5,2,0,0,1,0,0,"I lived with my mother, but not father, most of the time. & I lived with my father, but not mother, most of the time.",1,TRUE,TRUE,TRUE,TRUE,TRUE,4,0.46813437500596045,0.4408500000014901,0.4581096774224312,0.5688549999833107,0.5428576923425381,0.5667040000247955,1,1,0.96875,0.625,0.8387096774193549,0.78125,0.057,0.343,0.633,0.006,1.31,140.17688402813224,2055.601414250097,0.057,0.343,0.636,0.007,1.356,156.31155964046246,2075.658634580295,390,1.1555555555555557,0,3,0,15,18,FALSE
122,2022-03-18T17:12:41Z,2022-03-18T17:30:29Z,1067,1,2022-03-18T17:30:30Z,0.8999999761581421,Chrome,99.0.4844.74,Windows NT 10.0,1920,1080,Great!,1.7777777777777777,551,72,219,60,31,73,-0.26095166985349866,-0.253700427047047,-0.6989626083306313,-0.4704768164632027,-0.6135634582233127,-0.2858083154854174,1,1,1,1,1,1,1,1,1,1,1,1,1,1,1,1,1,1,1,1,1.538967528127731,0,0,2,3,4,1,0,1,1,1,1,1,1,1,1,1,1,1,1,1,1,1,1,1,1,1,1,1,1,1,0,2,0,0,0,0,1,1,1,1,1,1,1,1,1,1,1,1,1,1,1,1,1,1,1,1,1,1,1,1,1,1,1,1,1,1,1,1,1,1,1,1,1,1,1,1,1,1.9666895707934864,2.065591117977289,1,0,1,0,1,0,1,0,1,0,1,0,1,0,1,0,1,0,0,0,0,-1.5943424000221917,-0.6205191861769039,-1.1074307930995477,2,2,2,2,2,1,2,1,1,1.1338934190276817,1.8571428571428572,0,1,-0.4626854203256071,5,5,5,5,3,3,5,5,3,3,3,1.5735915849388864,4,4.428571428571429,0,-0.1387807531136866,0,0.45027743032797085,1,1,2,2,2,5,4,4,5,2,5,5,5,4,5,5,4,4,4,1,1.65615734242165,1.6,0,4.6,0,4,0,3.8,0,4.133333333333334,0,1,1,1,1,1,1,1,1,1,1,1,1,1,1,1,1,1,1,1,1,1.231174022502185,1,0,1,1,1,1,1,1,1,1,1,1,1,1,1,1,1,1,1,1,1,1,1.231174022502185,1,0,I lived with my mother and father an equal amount of time (joint custody),0,"White, Caucasian, Anglo, European American",0,29,1,2,NA,1,3,6,Manager,2,132,68,3,5,2,0,0,1,0,0,I lived with my mother and father an equal amount of time (joint custody),0,TRUE,TRUE,TRUE,TRUE,TRUE,5,0.4985750000011176,0.4674968749987893,0.5020968750002794,0.5545156249990687,0.5592838709662038,0.5624225806468918,1,1,1,1,0.96875,0.96875,0.066,0.383,0.556,0.013,1.182,13.20845663084113,1841.08685351056,0.066,0.383,0.555,0.014,1.236,21.355038400523693,1845.8375261440056,328,0.9718518518518519,0,3,0,0,3,FALSE
123,2022-03-18T17:05:10Z,2022-03-18T17:30:30Z,1519,1,2022-03-18T17:30:30Z,0.4000000059604645,Chrome,99.0.4844.74,Windows NT 10.0,1280,720,no,1.7777777777777777,570,91,441,89,115,126,-0.22195472331708255,-0.1489691798360391,0.10644691022964739,-0.11341411292088927,1.1066075211326536,0.30952166917198043,1,1,1,1,1,1,1,1,1,1,1,1,1,1,1,1,1,1,1,1,1.538967528127731,0,1,1,5,5,1,0,2,5,1,5,1,1,2,1,1,1,1,2,1,2,2,1,1,5,1,1,1,1,1,2,2,0,0,0,0,1,2,2,1,1,1,2,2,2,1,1,1,1,2,1,2,1,1,1,1,1,1,1,1,1,1,1,1,2,1,1,5,1,1,1,1,1,1,1,2,1,1.6899277664609975,1.4638501094227998,1.5,0,1.25,0,1.8666666666666667,0,1.5555555555555556,0,1.1666666666666667,0,1,0,1.7142857142857142,0,1,0,1.3243243243243243,0,1,0,0,-0.8553724652444018,-0.3151752203835423,-0.5852738428139721,3,3,5,3,3,3,3,3,1,0.7559289460184544,3.2857142857142856,0,2,0.7525035529575942,4,4,4,4,1,1,4,3,10,2,2,1.4638501094227998,6.5,3.142857142857143,0,-0.24540699345023656,0,-0.3115571300073276,1,1,1,1,1,5,5,5,5,5,5,5,5,5,3,5,5,5,3,1,1.9223002094465098,1,0,5,0,4.6,0,3.8,0,4.466666666666667,0,1,1,1,1,1,1,1,1,1,1,1,1,1,1,1,1,1,1,1,1,1.231174022502185,1,0,1,1,1,1,1,1,1,1,1,1,1,1,1,1,1,1,1,1,1,1,1.231174022502185,1,0,"I lived with my mother, but not father, most of the time.",0,Black or African American,0,28,0,1,NA,1,3,6,computer programmer,3,130,67,3,5,2,0,0,1,0,0,"I lived with my mother, but not father, most of the time.",0,TRUE,TRUE,TRUE,TRUE,TRUE,1,0.5889187500000116,0.46575312500004656,0.5304843750000582,0.6902999999999884,0.5362448275863225,0.6037687500002212,1,1,1,1,0.9354838709677419,1,0.096,0.362,0.555,0.024,1.616,61.539672636540814,1850.8196865929722,0.093,0.363,0.555,0.023,1.701,71.80454513843043,1861.4239598347024,352,1.0429629629629629,0,3,0,3,6,FALSE
125,2022-03-18T17:13:49Z,2022-03-18T17:32:47Z,1137,1,2022-03-18T17:32:47Z,0.8999999761581421,Chrome,99.0.4844.51,Windows NT 10.0,1280,720,n/a,1.7777777777777777,448,79,360,67,25,61,-0.4723561694982807,-0.21511523070614935,-0.18741872492072456,-0.38428926733229946,-0.736432813891596,-0.4206000101248282,3,4,1,1,3,1,1,4,1,4,4,1,1,1,3,4,1,1,3,4,0.41039134083406165,0,1,1,3,2,2.3,0,4,4,2,4,3,1,4,1,2,NA,1,4,1,3,5,1,3,1,1,1,2,1,3,0,2,0,0,0,0,1,1,1,3,3,3,3,3,3,1,2,2,1,4,1,4,2,2,2,2,3,4,1,4,1,4,5,2,1,1,1,5,5,4,1,3,3,1,1,1,1,1.3633997428703215,0.6992932067530679,1.625,0,1,0,2.7857142857142856,1,2.3333333333333335,0,2.1666666666666665,0,3.1666666666666665,0,2.7142857142857144,0,2.3333333333333335,0,2.4864864864864864,0,0,0,0,0.10875017456415076,-0.6205191861769039,-0.25588450580637656,4,3,5,1,1,2,2,1,1,0.7559289460184544,2.5714285714285716,0,1,-0.048343534927826504,5,2,2,5,1,1,3,3,3,1,2,1.7043362064926932,3,2.7142857142857144,0,-1.0918920336024696,0,-1.0598141622426434,3,3,4,5,2,2,3,2,3,3,2,4,2,4,3,3,4,2,4,2,0.4879500364742666,3.4,0,2.8,0,3,0,2.8,0,2.8666666666666667,0,1,1,1,4,1,1,4,4,1,1,1,4,1,2,1,4,1,1,1,1,0.6958523739384593,1.8,0,1,1,1,4,1,1,4,4,1,1,1,4,1,2,1,4,1,1,1,1,0.6958523739384593,1.8,0,I lived with my mother and father an equal amount of time (joint custody),0,"Asian or Asian American (e.g., Chinese, Japanese, and others)",0,22,1,2,NA,1,2,3,Financial Assistant,1,114,64,2,5,2,0,0,1,0,0,I lived with my mother and father an equal amount of time (joint custody),0,TRUE,TRUE,TRUE,TRUE,TRUE,2,0.47923437508940697,0.42599062505364416,0.4281281251013279,0.5412933334032695,0.5243708333969116,0.49176538471075204,1,1,1,0.9375,0.75,0.8125,0.047,0.344,0.568,0.02,1.733,29.07728480116926,1941.5860517184992,0.046,0.344,0.566,0.02,1.751,42.57144361291845,1940.00135539978,304,0.9007407407407407,1,3,0,0,3,FALSE
126,2022-03-18T16:54:52Z,2022-03-18T17:33:08Z,2295,1,2022-03-18T17:33:08Z,1,Chrome,97.0.4692.71,Windows NT 10.0,1600,900,N/A,1.7777777777777777,594,218,807,164,115,250,-0.17269542242897798,0.5510765252059608,1.4342842246128096,0.8100239134816456,1.1066075211326536,1.7023691804458922,2,3,1,2,1,2,1,2,1,1,2,2,2,1,1,2,3,1,3,2,1.0399898784932577,0,1,2,4,4,1.75,0,5,2,3,3,2,4,4,5,2,3,4,4,1,5,3,3,5,1,1,3,4,4,3,1,2,0,0,0,0,1,4,2,1,2,3,2,2,1,2,2,5,1,2,1,1,4,5,4,5,5,3,4,1,1,2,3,1,1,3,2,4,5,4,1,3,2,2,3,1,2,1.4745081126172803,1.2344267996967353,3,0,2,0,3.3333333333333335,0,2,0,3.0833333333333335,0,2.3333333333333335,0,2.857142857142857,0,2,0,2.5675675675675675,0,1,0,0,0.9843752732833623,-0.05662557557742737,0.4638748488529675,1,1,2,2,1,2,1,3,1,1.6035674514745464,1.4285714285714286,0,2,-0.324785349076635,5,4,5,3,2,2,5,8,7,NA,4,1.5735915849388864,7.5,3.7142857142857144,0,1.335469322578978,1,0.961776521265601,3,2,4,5,4,2,3,1,3,1,3,2,2,3,4,3,3,2,2,4,1.0327955589886444,3.6,0,2.4,0,2.2,0,3,0,2.533333333333333,0,2,4,3,3,4,4,3,3,3,3,1,3,4,4,2,3,1,3,4,3,1.0052493799000692,3,0,2,4,3,3,4,4,3,3,3,3,1,3,4,4,2,3,1,3,4,3,1.0052493799000692,3,0,I lived with my mother and father an equal amount of time (joint custody),0,"Asian or Asian American (e.g., Chinese, Japanese, and others)",0,22,0,1,NA,1,3,6,Software Engineer,4,120,63,2,5,2,0,0,1,0,0,I lived with my mother and father an equal amount of time (joint custody),0,TRUE,TRUE,TRUE,TRUE,TRUE,6,0.5308935483732531,0.4727062499858439,0.5056968750059605,0.5800187499970197,0.558780000003179,0.7133999999894036,0.96875,1,1,1,0.9375,0.84375,0.069,0.353,0.378,0.007,1.621,180.74853240497123,2174.1100675846396,0.069,0.353,0.37,0.007,1.638,198.51660887063053,2136.98838026513,322,0.9540740740740741,0,3,0,0,3,FALSE
128,2022-03-18T17:07:43Z,2022-03-18T17:34:01Z,1577,1,2022-03-18T17:34:01Z,1,Chrome,99.0.4844.74,Windows NT 10.0,2560,1440,None,1.7777777777777777,516,116,394,65,377,56,-0.3327881503153178,-0.011164907189976115,-0.06406771757365486,-0.4089142813697004,6.471902718647692,-0.47676321622458273,2,2,2,2,2,2,3,3,2,3,3,3,3,3,3,3,3,2,3,3,0.5026246899500346,0,1,1,2,2,2.6,0,2,2,3,2,3,1,2,2,3,4,2,2,3,3,2,1,1,1,1,1,1,1,1,2,1,2,1,1,1,2,3,3,3,3,2,2,2,2,2,2,4,4,2,3,2,2,2,2,2,2,2,1,1,1,3,1,2,3,2,1,3,2,3,1,1,1,3,3,3,3,1.138989594902999,0.9411239481143202,1,0,3,0,2.4,0,2.4444444444444446,0,2.4166666666666665,0,1.5,0,2.2857142857142856,0,1,0,2.135135135135135,0,1,1,1,-0.48647804388756144,1.8907962305250183,0.7021590933187285,2,2,2,2,2,2,4,1,1,1.0690449676496976,2.2857142857142856,0,1,-0.2140802890869389,4,4,4,4,3,3,5,6,6,5,3,1.1126972805283737,6,3.857142857142857,0,0.6507502562930925,0,0.6218311107098957,3,3,3,3,3,3,3,3,4,3,4,3,3,3,3,4,4,4,3,3,0.560611910581388,3,0,3.6,0,3.2,0,3.2,0,3.3333333333333335,0,3,2,3,3,2,3,3,3,3,2,3,3,2,3,3,3,1,3,3,3,0.6069769786668839,2.7,0,3,2,3,3,2,3,3,3,3,2,3,3,2,3,3,3,1,3,3,3,0.6069769786668839,2.7,0,"I lived with my mother and father an equal amount of time (joint custody) & I lived with my extended family on father's side (grandparents, aunts ,uncles, cousins)",1,"Asian or Asian American (e.g., Chinese, Japanese, and others)",0,28,0,1,NA,1,4,8,Pharmacist,6,170,66,3,5,2,0,0,0,0,0,"I lived with my mother and father an equal amount of time (joint custody) & I lived with my extended family on father's side (grandparents, aunts ,uncles, cousins)",1,TRUE,TRUE,TRUE,TRUE,TRUE,4,0.5848937500000029,0.9469093749999739,0.5377806451613264,0.6794566666666418,0.8127645161290984,0.6470000000000621,1,1,1,1,0.96875,0.967741935483871,0.069,0.381,0.4,0.022,1.741,151.80179350161262,1994.1631639684929,0.068,0.38,0.444,0.017,1.862,149.28917503648705,1974.924416484638,328,0.9718518518518519,0,3,3,3,6,FALSE
129,2022-03-18T16:25:33Z,2022-03-18T17:34:13Z,4120,1,2022-03-18T17:34:14Z,0.8999999761581421,Chrome,99.0.4844.74,Windows NT 10.0,1920,1080,NA,1.7777777777777777,2406,53,438,235,29,56,3.5463817946229157,-0.35843167425805483,0.09556299781667064,1.6842119118093786,-0.6545199101127405,-0.47676321622458273,1,1,1,1,1,1,1,1,1,1,1,1,1,1,1,1,1,1,1,1,1.538967528127731,0,1,1,5,5,1,0,1,1,2,1,1,1,1,1,1,1,1,1,1,1,3,1,1,1,1,1,1,1,1,5,2,0,0,0,0,2,1,1,1,1,1,1,1,1,1,1,1,1,1,1,1,1,1,1,1,1,1,1,1,1,3,1,1,4,4,2,1,1,1,1,1,1,2,1,3,3,1.895149490565742,1.9346465162548798,1,0,2.25,0,1.2,0,1.1111111111111112,0,1,0,1.3333333333333333,0,2,0,1,0,1.2702702702702702,0,3,0,0,-1.3888323808671539,0.46787914107392425,-0.4604766198966148,1,1,2,1,1,1,2,1,1,1.6761634196950514,1.2857142857142858,0,1,-0.7941589286438315,5,5,5,5,3,3,5,8,6,3,3,1.5735915849388864,7,4.428571428571429,0,0.4032826894249255,0,0.7806934700831635,2,2,2,2,2,4,5,4,4,1,5,3,3,4,3,4,3,3,2,2,1.1126972805283737,2,0,3.6,0,3,0,3.4,0,3.3333333333333335,0,1,1,1,1,1,1,1,1,1,1,1,1,1,1,1,1,1,1,1,1,1.231174022502185,1,0,1,1,1,1,1,1,1,1,1,1,1,1,1,1,1,1,1,1,1,1,1.231174022502185,1,0,I lived with my mother and father an equal amount of time (joint custody),0,"White, Caucasian, Anglo, European American",0,22,0,1,NA,1,2,3,Unemployed,1,220,70,3,5,2,0,0,1,0,0,I lived with my mother and father an equal amount of time (joint custody),0,TRUE,TRUE,TRUE,TRUE,TRUE,5,0.6859838709687033,0.6435999999998603,0.6086656249999068,0.6100482758625314,0.6576166666664183,0.6845518518520726,1,1,1,0.90625,0.9375,0.8709677419354839,0.067,0.373,0.285,0.01,1.617,118.3485433767334,2121.03097497656,0.067,0.372,0.303,0.013,1.666,138.30915274750558,2070.764242133799,472,1.3985185185185185,0,3,3,24,27,FALSE
130,2022-03-18T16:57:54Z,2022-03-18T17:34:34Z,2199,1,2022-03-18T17:34:35Z,0.8999999761581421,Chrome,99.0.4844.51,Macintosh,1280,800,n/a,1.6,835,215,678,109,97,140,0.3219500573224052,0.5345400124884333,0.9662759908548098,0.13283602745312004,0.7379994541278038,0.4667786462512931,3,3,1,2,4,1,2,3,1,3,4,2,2,1,3,3,2,1,4,3,0.5026246899500346,0,1,1,3,3,2.4,0,2,2,1,2,2,1,3,1,1,2,3,3,2,3,2,1,3,1,1,1,2,1,2,0,2,0,0,0,0,1,1,1,1,1,1,3,1,1,2,2,1,1,2,1,1,2,1,1,1,1,2,1,1,1,3,1,1,1,1,1,1,1,1,1,1,1,2,1,1,1,1.7891900964406218,1.1872336794093274,1.5,0,1.25,0,2,0,1.2222222222222223,0,1.3333333333333333,0,1.5,0,1,0,1,0,1.2432432432432432,0,0,0,0,-0.8325380186716197,-0.5343359712415323,-0.683436994956576,1,1,2,1,1,1,1,1,1,1.7320508075688772,1.1428571428571428,0,1,-0.8770273057233877,4,4,5,3,1,1,4,7,3,NA,3,1.5735915849388864,5,3.142857142857143,0,0.1414878915134009,1,-0.07572444759558214,2,4,2,3,2,5,3,4,4,3,5,4,4,3,3,3,4,4,3,3,0.9102589898327995,2.6,0,4.4,0,3.2,0,3.4,0,3.6666666666666665,0,2,2,3,4,2,3,3,4,2,2,1,3,1,2,1,3,2,3,2,1,0.7181848464596079,2.3,0,2,2,3,4,2,3,3,4,2,2,1,3,1,2,1,3,2,3,2,1,0.7181848464596079,2.3,0,NA,NA,"White, Caucasian, Anglo, European American",0,30,1,2,NA,1,3,8,unemployed,3,111,63,2,5,2,1,1,0,0,2,NA,NA,TRUE,TRUE,TRUE,TRUE,TRUE,5,0.5813419355730857,0.5158312499970198,0.5789875000268221,0.6271218750625849,0.5749937500357628,0.6352156251370906,1,1,1,1,1,1,0.12,0.413,0.716,0.025,1.639,44.80591484667639,1851.3687696412587,0.115,0.419,0.729,0.029,1.731,65.25076369874425,1847.519737558033,388,1.1496296296296296,0,3,0,0,3,FALSE
131,2022-03-18T17:08:40Z,2022-03-18T17:35:19Z,1598,1,2022-03-18T17:35:20Z,0.8999999761581421,Chrome,99.0.4844.51,Windows NT 6.1,1920,1080,NA,1.7777777777777777,532,99,539,216,22,100,-0.29994861638991477,-0.10487181258929895,0.4619880490535542,1.4502742784540696,-0.7978674917257377,0.017472997453256978,3,3,2,2,3,2,2,3,2,3,3,2,2,3,3,3,2,2,3,3,0.22360679774997896,0,1,1,3,2,2.55,0,4,4,3,3,2,1,3,4,2,3,3,4,3,4,3,2,1,1,1,2,1,1,1,2,2,0,0,0,0,3,3,2,2,3,3,2,3,4,4,3,2,4,3,3,2,2,3,2,3,3,1,1,1,1,3,1,1,3,3,1,2,2,3,1,2,1,2,2,3,4,1.1109609508143095,0.7432233529572065,1.25,0,2.75,0,3.066666666666667,0,2.7777777777777777,0,2.8333333333333335,0,1.3333333333333333,0,2.142857142857143,0,1.3333333333333333,0,2.324324324324324,0,1,0,0,-0.003214540989459816,0.2019240692286875,0.09935476411961384,2,2,2,2,2,2,2,1,1,0.9759000729485332,2,0,1,-0.37981704324605103,4,3,3,3,3,2,4,6,6,4,3,0.6900655593423543,6,3.142857142857143,0,0.4366725657692403,0,0.10420606128962742,3,4,2,3,3,3,2,4,3,3,4,3,4,3,3,3,3,3,4,3,0.560611910581388,3,0,3.2,0,3.2,0,3.2,0,3.2,0,2,3,3,3,2,2,2,3,3,3,2,3,2,2,2,2,2,3,2,2,0.47016234598162726,2.4,0,2,3,3,3,2,2,2,3,3,3,2,3,2,2,2,2,2,3,2,2,0.47016234598162726,2.4,0,I lived with my mother and father an equal amount of time (joint custody),0,"White, Caucasian, Anglo, European American",0,23,0,1,NA,1,2,6,Student,2,150,71,2,5,2,0,0,0,0,0,I lived with my mother and father an equal amount of time (joint custody),0,TRUE,TRUE,TRUE,TRUE,TRUE,2,0.6041806451612858,0.5383187499999876,0.6395937499999982,0.6673062500000014,0.5884468750000015,0.6995531249999949,1,1,1,1,1,1,0.091,0.403,0.365,0.033,1.279,4.381193768258397,1786.436833625616,0.092,0.404,0.368,0.041,1.314,8.383415261267775,1788.8385852507413,304,0.9007407407407407,1,3,0,0,3,FALSE
132,2022-03-18T16:54:40Z,2022-03-18T17:36:09Z,2489,1,2022-03-18T17:36:10Z,0.8999999761581421,Chrome,99.0.4844.74,Windows NT 10.0,1366,768,No,1.7786458333333333,1031,96,1039,57,93,99,0.7242343479085924,-0.1214083253068265,2.275973451216344,-0.5074143375193041,0.6560865503489481,0.006240356233306075,1,2,1,1,3,1,2,2,1,2,2,3,1,1,2,2,2,1,2,2,1.0052493799000692,0,0,3,3,3,1.7,0,3,3,3,3,2,2,4,3,2,3,3,3,3,4,3,2,3,3,1,2,2,3,2,1,2,0,0,0,0,3,4,3,3,5,3,3,3,3,4,3,3,3,3,2,3,3,1,2,3,2,3,2,3,4,3,2,2,2,1,1,3,3,4,3,3,2,4,3,3,3,0.7941225539113158,0.4879500364742666,2.25,0,3.25,0,2.933333333333333,0,3.3333333333333335,0,2.6666666666666665,0,2.8333333333333335,0,2.2857142857142856,0,2.6666666666666665,0,2.7837837837837838,0,1,0,0,0.5763079651335594,0.37429049909943074,0.47529923211649505,3,2,5,2,1,3,2,3,2,0.816496580927726,2.5714285714285716,0,2.5,0.5314142688036341,4,4,5,4,3,3,4,3,3,2,2,0.9759000729485332,3,3.857142857142857,0,-0.8778143430786174,0,-0.3099090174733595,3,3,3,3,3,3,3,4,4,3,3,3,4,3,3,3,3,3,3,3,0.4140393356054125,3,0,3,0,3.2,0,3.4,0,3.2,0,3,2,2,2,2,2,2,3,3,1,2,2,2,2,1,3,1,1,1,2,0.6863327411532597,1.95,0,3,2,2,2,2,2,2,3,3,1,2,2,2,2,1,3,1,1,1,2,0.6863327411532597,1.95,0,"I lived with my mother, but not father, most of the time.",0,"Hispanic of Latino (e.g., Mexican American, Central American, and others)",0,30,1,2,NA,1,2,3,stocker,2,165,64,3,5,2,0,0,0,0,0,"I lived with my mother, but not father, most of the time.",0,TRUE,TRUE,TRUE,TRUE,TRUE,3,0.56353125,0.4767903225921815,0.4975093749947846,0.5723937500007451,0.5029516129186077,0.5517499999957425,1,0.96875,1,1,0.96875,0.875,0.05,0.384,0.451,0.013,1.418,69.63177608259163,1949.109600092042,0.051,0.384,0.505,0.015,1.553,78.809318371654,1937.228220139729,522,1.5466666666666666,0,3,0,0,3,FALSE
133,2022-03-18T17:18:17Z,2022-03-18T17:37:12Z,1134,1,2022-03-18T17:37:14Z,0.8999999761581421,Chrome,99.0.4844.51,Macintosh,1440,900,No,1.6,505,79,280,106,42,68,-0.35536532988903236,-0.21511523070614935,-0.47765638926677095,0.09589850639701863,-0.38830297283146,-0.3419715215851719,1,1,1,1,1,1,2,1,1,1,2,1,1,1,1,1,1,1,1,3,1.4290224851827542,0,1,1,3,3,1.2,0,1,1,2,1,1,1,2,1,1,1,1,2,2,1,1,5,2,1,1,1,1,1,1,1,2,0,0,0,0,1,1,1,1,1,1,1,1,1,1,1,1,1,1,1,1,1,1,1,1,2,1,1,1,1,1,1,1,1,1,1,1,1,1,1,1,1,1,1,1,1,1.9521298140264163,1.8464895909600492,1.625,0,1,0,1.2666666666666666,0,1,0,1.0833333333333333,0,1,0,1,0,1,0,1.027027027027027,0,1,0,0,-1.1928695225636667,-0.4013584353189139,-0.7971139789412903,1,1,2,1,1,5,2,1,1,1.889822365046136,1.8571428571428572,0,1,-0.4626854203256071,5,5,5,5,2,3,5,6,6,4,3,1.7043362064926932,6,4.285714285714286,0,0.4366725657692403,0,0.7236196488870026,2,2,3,3,2,5,3,3,4,2,5,2,3,4,5,3,3,4,5,2,1.245945806357946,2.4,0,3.8,0,3.2,0,3.6,0,3.533333333333333,0,1,1,1,1,1,1,1,1,1,1,1,1,1,1,1,1,1,1,1,1,1.231174022502185,1,0,1,1,1,1,1,1,1,1,1,1,1,1,1,1,1,1,1,1,1,1,1.231174022502185,1,0,I lived with my mother and father an equal amount of time (joint custody),0,"White, Caucasian, Anglo, European American",0,30,1,2,NA,1,3,7,Social Worker,3,143,66,3,5,2,0,0,1,0,0,I lived with my mother and father an equal amount of time (joint custody),0,TRUE,TRUE,TRUE,TRUE,TRUE,2,0.5140250000022352,0.4583375000031665,0.5102531249988824,0.5722741935464644,0.5352933333347241,0.5870774193531082,1,1,1,0.96875,0.9375,0.96875,0.07,0.364,0.457,0.021,1.703,31.250059364821624,1865.0446467825404,0.069,0.363,0.466,0.02,1.796,37.75362469812185,1859.3577757100447,416,1.2325925925925925,0,3,0,0,3,FALSE
134,2022-03-18T17:20:15Z,2022-03-18T17:38:52Z,1117,1,2022-03-18T17:38:53Z,1,Firefox,98.0,Windows NT 10.0,1536,864,NA,1.7777777777777777,553,59,289,73,32,60,-0.2568467281128233,-0.32535864882299975,-0.44500465202784073,-0.3104142252200967,-0.5930852322785988,-0.43183265134477916,1,1,1,1,1,1,1,2,1,1,3,1,1,1,1,1,1,1,1,1,1.460893742308382,0,1,1,4,4,1.15,0,3,1,2,2,1,1,5,3,2,1,1,3,3,2,2,2,3,1,1,3,2,3,2,3,2,0,0,0,0,1,3,5,1,1,3,4,4,2,3,4,1,4,4,4,4,5,5,4,4,2,3,1,1,1,5,5,1,3,3,1,1,1,1,3,3,2,4,2,2,2,1.4866775743954068,1.3557637102737474,2.125,0,2.5,0,2.1333333333333333,0,2.6666666666666665,0,3.6666666666666665,0,2.6666666666666665,0,1.5714285714285714,0,2.6666666666666665,0,2.7837837837837838,0,2,0,0,0.17207920619211273,0.3349016051513059,0.25349040567170933,2,2,5,2,1,2,2,2,1,1,2.2857142857142856,0,1.5,-0.020827687843118697,4,4,4,4,1,1,1,5,3,4,2,1.6035674514745464,4,2.7142857142857144,0,-0.26897114785137577,0,-0.5582008108085196,2,3,2,3,3,3,5,3,4,5,5,2,5,4,4,4,5,5,4,5,1.5522640914238175,2.6,0,4,0,4.6,0,4,0,4.2,0,1,1,1,4,1,1,1,2,1,1,1,2,1,2,1,2,1,1,1,1,0.7451598203705946,1.35,0,1,1,1,4,1,1,1,2,1,1,1,2,1,2,1,2,1,1,1,1,0.7451598203705946,1.35,0,I lived with my mother and father an equal amount of time (joint custody),0,"White, Caucasian, Anglo, European American",0,28,1,2,NA,1,3,7,Museum Technician,2,195,67,2,5,2,0,0,1,0,0,I lived with my mother and father an equal amount of time (joint custody),0,TRUE,TRUE,TRUE,TRUE,TRUE,2,0.57003125,0.54678125,0.5622258064516129,0.67046875,0.6150645161290322,0.6289677419354839,1,1,1,1,1,0.96875,0.072,0.394,0.426,0.019,1.55,60.9872271531164,1893.3000816132303,0.071,0.394,0.44,0.018,1.632,68.42877709809554,1893.8146847198252,360,1.0666666666666667,0,3,0,0,3,FALSE
135,2022-03-18T17:22:55Z,2022-03-18T17:38:58Z,962,1,2022-03-18T17:39:00Z,0.8999999761581421,Chrome,99.0.4844.51,Windows NT 10.0,1280,720,NA,1.7777777777777777,440,76,244,47,43,69,-0.4887759364609822,-0.2316517434236769,-0.6082633382224918,-0.6305394077063088,-0.36782474688674605,-0.33073888036522103,2,2,2,1,3,1,1,2,1,2,3,1,2,2,2,3,1,1,2,3,0.8255779474818965,0,1,1,3,3,1.85,0,4,4,4,3,4,4,2,4,2,2,3,3,1,3,3,3,3,1,1,4,3,4,2,1,2,0,0,0,0,1,1,1,1,2,1,1,1,1,1,1,2,1,1,1,1,4,1,1,2,3,2,1,1,1,1,1,1,1,1,1,3,3,2,1,2,2,2,2,1,1,1.7424224619867699,0.9611501047232549,2.625,0,1.5,0,3.066666666666667,0,1.1111111111111112,0,1.5833333333333333,0,1.1666666666666667,0,1.7142857142857142,0,1.6666666666666667,0,1.4324324324324325,0,1,0,0,0.20790566547009803,-0.22899200544817064,-0.010543169989036302,2,2,3,3,1,2,2,1,6,0.9759000729485332,2.142857142857143,0,3.5,0.6693143400526061,4,4,5,4,3,3,3,6,4,2,3,0.7559289460184544,5,3.7142857142857144,0,-0.17217062945800132,0,0.0427910608261001,1,2,1,1,2,4,3,4,5,4,5,5,5,5,5,1,5,5,3,4,1.6903085094570331,1.4,0,4.8,0,3.2,0,4.6,0,4.2,0,3,1,2,3,4,2,3,4,2,1,1,2,2,2,1,2,2,2,1,3,0.8870412083230169,2.15,0,3,1,2,3,4,2,3,4,2,1,1,2,2,2,1,2,2,2,1,3,0.8870412083230169,2.15,0,I lived with my mother and father an equal amount of time (joint custody),0,"White, Caucasian, Anglo, European American",0,27,1,1,NA,1,4,6,Junior Researcher,3,115,63,1,5,2,0,0,1,0,0,I lived with my mother and father an equal amount of time (joint custody),0,TRUE,TRUE,TRUE,TRUE,TRUE,5,0.4700062500005588,0.39989687499962745,0.4389499999973923,0.5343793103427722,0.4784733333339294,0.5376321428567171,1,1,1,0.90625,0.9375,0.875,0.058,0.328,0.525,0.01,1.541,138.634411180155,2018.7575193956386,0.059,0.328,0.63,0.01,1.614,131.39975812670724,2000.9559557573116,318,0.9422222222222223,0,3,0,0,3,FALSE
136,2022-03-18T17:03:56Z,2022-03-18T17:39:45Z,2148,1,2022-03-18T17:39:46Z,1,Chrome,99.0.4844.74,Windows NT 10.0,1536,864,Thank you for the opportunity to participate and good luck. I enjoyed the Flanker game.,1.7777777777777777,917,105,863,44,28,51,0.4902526686900958,-0.07179878715424383,1.637450589655042,-0.6674769287624102,-0.6749981360574544,-0.5329264223243373,2,2,2,1,2,1,2,3,1,2,4,2,2,1,3,2,2,1,2,3,0.7947194142390263,0,0,4,3,3,2,0,3,2,2,2,4,1,4,3,2,3,4,3,3,3,2,3,4,2,1,3,3,3,3,2,2,0,0,0,0,2,3,1,2,2,1,2,2,3,2,3,3,2,2,3,2,4,4,3,5,4,3,1,2,1,3,3,1,2,2,1,2,3,3,2,2,2,3,2,2,2,1.1422805280686548,0.9258200997725514,2.75,0,2.25,0,2.7333333333333334,0,2,0,3.0833333333333335,0,2.1666666666666665,0,2,0,2,0,2.3783783783783785,0,1,0,0,0.5302453746332925,0.029557639357944268,0.2799015069956184,2,2,4,3,2,3,2,3,3,0.7867957924694432,2.5714285714285716,0,3,0.7246668700474543,4,4,5,4,1,1,3,6,4,3,2,1.5735915849388864,5,3.142857142857143,0,-0.3023610241956905,0,-0.3462735927130152,2,2,2,2,2,4,4,4,4,4,5,4,1,3,4,5,4,4,4,2,1.2798809468443688,2,0,4.2,0,3.6,0,3.4,0,3.7333333333333334,0,3,2,2,4,2,3,1,3,2,1,3,3,3,3,2,4,1,3,3,1,0.8255779474818965,2.45,0,3,2,2,4,2,3,1,3,2,1,3,3,3,3,2,4,1,3,3,1,0.8255779474818965,2.45,0,I lived with my mother and father an equal amount of time (joint custody),0,"White, Caucasian, Anglo, European American",0,30,0,1,NA,1,2,6,Data Analyst,2,170,73,3,5,2,0,0,0,0,0,I lived with my mother and father an equal amount of time (joint custody),0,TRUE,TRUE,TRUE,TRUE,TRUE,1,0.592441935479641,0.43120999999841053,0.42648387096966467,0.585890322583337,0.5124967742004702,0.5159799999992053,1,0.9375,0.96875,0.96875,0.96875,0.967741935483871,0.063,0.314,0.601,0.009,1.246,107.10294082718941,2019.631150385593,0.064,0.314,0.626,0.009,1.261,150.70215488266317,2032.0365230574587,400,1.1851851851851851,0,3,0,3,6,FALSE
137,2022-03-18T17:07:17Z,2022-03-18T17:39:46Z,1948,1,2022-03-18T17:39:46Z,0.8999999761581421,Chrome,99.0.4844.74,Windows NT 10.0,1504,1003,NA,1.4995014955134596,724,122,921,20,19,48,0.09412579071492168,0.021908118245079003,1.8478728963059257,-0.9629770972112213,-0.8593021695598793,-0.56662434598419,2,2,1,1,2,1,1,2,1,1,3,2,1,2,1,1,1,1,2,2,1.1516578439248717,0,1,1,3,3,1.5,0,3,4,3,3,3,4,3,3,4,3,3,4,2,4,3,2,1,1,1,1,1,3,1,2,2,0,0,0,0,3,2,3,2,3,2,3,3,3,4,3,4,2,3,3,3,2,3,2,2,4,2,1,2,1,1,2,3,2,1,1,3,2,3,2,2,2,2,1,1,1,0.9531046156684,0.6399404734221844,1.375,0,1.25,0,3.2666666666666666,0,2.6666666666666665,0,2.9166666666666665,0,1.5,0,2.142857142857143,0,2,0,2.4054054054054053,0,1,0,0,0.17424454164297992,-0.3151752203835423,-0.07046533937028118,3,3,4,3,2,3,3,3,1,0.4879500364742666,3,0,2,0.5867667987984821,3,2,4,4,2,2,4,1,1,2,2,0.9511897312113419,1,3,0,-1.2391899714376922,0,-0.9947465680081862,3,2,3,4,3,3,2,3,3,3,3,4,3,3,3,2,2,3,2,3,0.5936168397046637,3,0,3,0,2.4,0,3,0,2.8,0,2,1,1,3,2,1,1,2,2,1,1,2,2,1,1,2,2,1,1,2,0.7451598203705946,1.55,0,2,1,1,3,2,1,1,2,2,1,1,2,2,1,1,2,2,1,1,2,0.7451598203705946,1.55,0,I lived with my mother and father an equal amount of time (joint custody),0,"Asian or Asian American (e.g., Chinese, Japanese, and others)",0,26,1,2,NA,1,3,7,auditor,3,120,64,2,5,2,0,0,0,0,0,I lived with my mother and father an equal amount of time (joint custody),0,TRUE,TRUE,TRUE,TRUE,TRUE,2,0.4636218750000116,0.40673749999993014,0.43298387096774194,0.5178555555556107,0.4704399999999131,0.5040160000001639,1,1,0.96875,0.9,0.9375,0.78125,0.045,0.352,0.589,0.01,1.324,146.79553606299822,2170.419776404662,0.046,0.348,0.592,0.01,1.38,164.33422819557313,2151.5650388012264,428,1.268148148148148,0,3,0,0,3,FALSE
138,2022-03-18T17:21:18Z,2022-03-18T17:40:45Z,1166,1,2022-03-18T17:40:45Z,0.8999999761581421,Chrome,99.0.4844.51,Windows NT 10.0,1536,864,NA,1.7777777777777777,498,86,291,69,48,89,-0.3697326259813962,-0.1765300343652517,-0.43774871041918956,-0.35966425329489854,-0.26543361716317665,-0.10608605596620295,1,1,1,1,1,1,1,2,1,1,1,1,1,1,1,1,1,1,1,1,1.5035046776746235,0,1,1,3,3,1.05,0,3,1,3,2,4,3,1,3,1,1,1,1,3,2,1,1,4,1,1,1,1,3,1,0,2,0,0,0,0,1,1,1,1,1,1,1,1,1,1,1,1,1,2,1,4,5,3,2,3,4,3,1,1,1,5,5,1,1,2,1,2,5,2,1,1,1,2,1,1,2,1.7870908465138793,1.4474937289114918,1.625,0,1.5,0,2,0,1,0,2.3333333333333335,0,2.6666666666666665,0,2,0,1,0,1.8918918918918919,0,0,0,0,-0.49445041532030015,-0.44815275630616064,-0.4713015858132304,1,1,3,1,1,1,1,1,1,1.5735915849388864,1.2857142857142858,0,1,-0.7941589286438315,5,5,5,5,1,1,2,7,7,2,2,1.889822365046136,7,3.4285714285714284,0,-0.15506308636046787,0,-0.10163439314878508,1,2,1,1,1,5,4,5,5,4,5,4,3,4,3,4,3,5,3,3,1.245945806357946,1.2,0,4.4,0,3.6,0,4,0,4,0,1,1,1,1,2,1,2,1,1,1,3,1,1,1,1,1,1,1,1,2,1.2258187382102494,1.25,0,1,1,1,1,2,1,2,1,1,1,3,1,1,1,1,1,1,1,1,2,1.2258187382102494,1.25,0,I lived with my mother and father an equal amount of time (joint custody),0,"White, Caucasian, Anglo, European American",0,25,1,2,NA,1,2,6,"Full-time master's student, part-time university teaching assistant",3,125,68,2,5,2,0,0,1,0,0,I lived with my mother and father an equal amount of time (joint custody),0,TRUE,TRUE,TRUE,TRUE,TRUE,3,0.47141562500223516,0.4302843749895692,0.4242750000208616,0.5654999999884636,0.49868387096543465,0.5144812500067055,1,1,1,0.96875,1,1,0.096,0.286,0.647,0.027,1.875,77.49128863388152,1886.430901275245,0.104,0.29,0.737,0.027,2.066,86.67086261608631,1873.6480693198318,384,1.1377777777777778,0,3,0,0,3,FALSE
139,2022-03-18T17:26:39Z,2022-03-18T17:41:47Z,908,1,2022-03-18T17:41:49Z,0.8999999761581421,Chrome,99.0.4844.51,Windows NT 10.0,1536,864,I do not,1.7777777777777777,453,53,197,42,28,89,-0.46209381514659226,-0.35843167425805483,-0.7787779660257941,-0.6921019427998111,-0.6749981360574544,-0.10608605596620295,3,3,2,1,3,1,1,3,1,3,4,1,1,1,3,3,1,1,3,3,0.512989176042577,0,1,1,3,2,2.1,0,5,2,1,2,1,3,3,3,3,1,3,4,1,4,4,1,3,1,1,1,2,2,1,1,2,0,0,0,0,2,2,3,3,3,2,3,2,3,1,2,1,2,4,2,3,3,1,1,1,1,3,2,1,1,1,1,1,2,2,2,3,3,2,1,1,1,1,1,2,2,1.0932498320124249,1.0997835284835873,1.5,0,1.5,0,2.6666666666666665,0,2.5555555555555554,0,1.8333333333333333,0,1.5,0,2.142857142857143,0,1,0,1.945945945945946,0,1,0,0,-0.23411803952285007,-0.22899200544817064,-0.23155502248551035,3,1,3,1,1,1,1,1,1,0.9759000729485332,1.5714285714285714,0,1,-0.6284221744847194,4,4,4,4,1,1,4,3,2,3,3,1.4638501094227998,2.5,3.142857142857143,0,-0.4098124743829926,0,-0.4117708755966728,1,1,1,1,1,5,4,5,5,1,5,4,5,3,3,5,4,5,4,4,1.3557637102737474,1,0,4.6,0,3.8,0,4,0,4.133333333333334,0,1,1,1,3,1,1,1,3,2,1,2,3,1,2,1,3,1,1,1,2,0.5026246899500346,1.6,0,1,1,1,3,1,1,1,3,2,1,2,3,1,2,1,3,1,1,1,2,0.5026246899500346,1.6,0,I lived with my mother and father an equal amount of time (joint custody),0,"White, Caucasian, Anglo, European American",0,23,2,2,NA,1,3,6,Food Inspector,2,140,67,4,5,2,0,0,1,0,0,I lived with my mother and father an equal amount of time (joint custody),0,TRUE,TRUE,TRUE,TRUE,TRUE,2,0.509728125013411,0.4292709677411664,0.46788750000298024,0.6181965517298929,0.5208225806374703,0.6305344827462886,1,1,1,0.9354838709677419,0.96875,0.90625,0.075,0.323,0.45,0.011,1.769,66.91336544161472,1931.0495774796102,0.074,0.323,0.498,0.011,1.791,63.22254546807301,1918.8765734083586,422,1.2503703703703704,0,3,0,0,3,FALSE
142,2022-03-18T17:24:43Z,2022-03-18T17:42:20Z,1057,1,2022-03-18T17:42:21Z,1,Chrome,98.0.4758.107,CrOS x86_64 14388.61.0,1536,864,NA,1.7777777777777777,493,93,242,68,40,71,-0.37999498033308465,-0.13794483802435406,-0.615519279831143,-0.371976760313599,-0.42925942472088774,-0.3082735979253192,2,3,1,2,2,1,1,2,1,1,3,1,1,1,2,2,1,1,3,2,0.998683343734455,0,0,2,3,3,1.65,0,5,3,3,5,1,5,5,4,4,4,3,5,2,5,5,5,5,1,1,5,5,5,1,0,2,0,0,0,0,2,5,5,4,5,2,3,3,3,4,2,5,1,4,1,2,5,5,5,5,5,4,1,1,1,2,1,1,1,1,1,5,5,4,1,4,5,1,1,1,1,1.6644128905623958,1.4474937289114918,3.5,0,1,0,3.933333333333333,0,3.5555555555555554,0,3.6666666666666665,0,1.6666666666666667,0,2.5714285714285716,0,3.3333333333333335,0,3.081081081081081,0,0,0,0,1.689487235556682,-0.6205191861769039,0.534484024689889,1,2,3,1,1,2,1,1,1,1.4638501094227998,1.5714285714285714,0,1,-0.6284221744847194,5,3,5,2,1,2,3,4,3,2,2,1.5275252316519468,3.5,3,0,-0.7874704359888487,0,-0.7193998682121922,1,3,1,4,1,5,4,5,5,3,5,5,4,2,5,1,5,5,4,3,1.6846647257229665,2,0,5,0,3.2,0,4,0,4.066666666666666,0,3,1,2,4,2,3,2,4,3,4,2,3,2,4,1,4,1,3,3,3,1.0052493799000692,2.7,0,3,1,2,4,2,3,2,4,3,4,2,3,2,4,1,4,1,3,3,3,1.0052493799000692,2.7,0,NA,NA,"White, Caucasian, Anglo, European American",0,29,1,4,Genderqueer,1,1,5,Phone Interviewer,1,280,68,1,4,2,0,0,1,1,0,NA,NA,TRUE,TRUE,TRUE,TRUE,TRUE,4,0.5629516129003417,0.5026774193558001,0.5301374999983236,0.6677781250020489,0.5903933333347241,0.638374999997206,1,1,1,1,0.9375,1,0.164,0.264,0.606,0.016,1.669,41.2403297598866,1839.8011528641523,0.163,0.268,0.609,0.016,1.758,55.7799832353791,1839.9132376364391,304,0.9007407407407407,1,0,0,0,3,FALSE
143,2022-03-18T17:22:41Z,2022-03-18T17:42:33Z,1191,1,2022-03-18T17:42:34Z,0.8999999761581421,Chrome,99.0.4844.51,Macintosh,1280,800,NA,1.6,626,72,186,62,26,80,-0.10701635457817191,-0.253700427047047,-0.8186856448733754,-0.4458518024258018,-0.7159545879468822,-0.2071798269457611,2,1,2,3,1,1,1,2,1,2,2,1,1,2,2,2,1,1,2,2,1.0809352675491624,0,1,1,3,2,1.6,0,1,1,2,1,2,1,1,1,1,1,1,1,1,1,2,1,1,1,1,1,1,1,1,1,2,0,0,0,0,1,1,1,1,1,1,1,1,1,1,1,1,1,1,1,1,1,1,1,1,1,1,1,1,1,2,1,1,1,1,1,1,1,1,1,1,1,1,1,1,1,1.9521298140264163,1.9073791542572855,1,0,1,0,1.2,0,1,0,1,0,1.1666666666666667,0,1,0,1,0,1.027027027027027,0,1,0,0,-1.495130666637001,-0.4013584353189139,-0.9482445509779575,1,1,1,1,1,1,2,1,1,1.889822365046136,1.1428571428571428,0,1,-0.8770273057233877,5,5,5,5,4,3,5,5,6,5,4,1.5275252316519468,5.5,4.571428571428571,0,0.9046744344648651,0,1.1637446799113924,1,2,2,3,2,4,3,3,5,1,5,4,4,3,4,5,4,5,4,3,1.245945806357946,2,0,4.4,0,3.4,0,3.6,0,3.8,0,1,1,1,4,1,1,1,1,1,1,1,1,1,1,1,1,1,1,1,1,1.0990426455975697,1.15,0,1,1,1,4,1,1,1,1,1,1,1,1,1,1,1,1,1,1,1,1,1.0990426455975697,1.15,0,I lived with my mother and father an equal amount of time (joint custody),0,"Asian or Asian American (e.g., Chinese, Japanese, and others)",0,22,1,2,NA,1,4,6,Consultant,3,140,66,3,5,2,0,0,1,0,0,I lived with my mother and father an equal amount of time (joint custody),0,TRUE,TRUE,TRUE,TRUE,TRUE,6,0.6643500000014901,0.48912812500074504,0.5473531249994412,0.660531249997206,0.577406250002794,0.6821586206894497,1,1,1,1,1,0.90625,0.076,0.416,0.596,0.011,1.782,16.926393083734528,1874.7421636614342,0.08,0.415,0.662,0.012,1.875,17.003292732922684,1872.1908611486783,388,1.1496296296296296,0,3,0,0,3,FALSE
144,2022-03-18T17:17:52Z,2022-03-18T17:42:43Z,1490,1,2022-03-18T17:42:44Z,0.8999999761581421,Chrome,99.0.4844.74,Macintosh,1440,900,No,1.6,623,292,286,133,31,64,-0.11317376718918498,0.9589771722383074,-0.45588856444081743,0.42833619590193117,-0.6135634582233127,-0.38690208646497554,3,3,1,1,3,1,1,3,1,3,3,1,1,1,3,3,1,1,3,3,0.512989176042577,0,0,3,3,3,2,0,1,1,1,1,1,1,1,1,1,1,1,1,2,1,1,1,2,1,1,1,1,1,1,1,2,0,0,0,0,1,1,1,1,1,1,1,1,1,1,1,1,1,1,1,1,1,1,1,1,1,1,1,1,1,2,1,1,1,1,1,1,1,1,1,1,1,1,1,1,1,1.9521298140264163,2.016597794967223,1.125,0,1,0,1.0666666666666667,0,1,0,1,0,1.1666666666666667,0,1,0,1,0,1.027027027027027,0,1,0,0,-1.498772367168005,-0.4013584353189139,-0.9500654012434595,1,1,2,1,1,1,1,1,1,1.7320508075688772,1.1428571428571428,0,1,-0.8770273057233877,5,5,5,5,3,3,5,8,6,6,4,1.5735915849388864,7,4.428571428571429,0,1.3897838462580232,0,1.382017558511226,1,1,1,2,2,5,4,5,5,1,5,3,5,4,5,5,5,5,5,3,1.7265434778633235,1.4,0,4.6,0,4,0,4.4,0,4.333333333333333,0,1,1,1,1,1,1,1,1,1,1,1,1,1,1,1,1,1,1,1,1,1.231174022502185,1,0,1,1,1,1,1,1,1,1,1,1,1,1,1,1,1,1,1,1,1,1,1.231174022502185,1,0,I lived with my mother and father an equal amount of time (joint custody),0,"Asian or Asian American (e.g., Chinese, Japanese, and others)",0,26,1,2,NA,1,4,6,social media and marketing manager,6,140,63,2,5,2,0,0,1,0,0,I lived with my mother and father an equal amount of time (joint custody),0,TRUE,TRUE,TRUE,TRUE,TRUE,3,0.613815625000163,0.5221437500003958,0.5538124999996508,0.7462999999996973,0.5947967741937648,0.6714903225806211,1,1,1,1,1,0.96875,0.109,0.331,0.487,0.016,1.778,34.76371534564685,1869.5364933012088,0.104,0.335,0.503,0.015,1.949,43.41438990100045,1865.9846179855992,436,1.2918518518518518,0,3,0,0,3,FALSE
145,2022-03-18T17:25:45Z,2022-03-18T17:43:50Z,1085,1,2022-03-18T17:43:51Z,0.8999999761581421,Chrome,99.0.4844.51,Windows NT 10.0,1920,1080,"My parents were very toxic and controlling. They sometimes smashed things like game consoles and they didn't buy me things that other kids at school had; I didn't have cable, internet, the same clothes that other kids wore, the same toys that other kids wore. They grew up in poverty in a communist country and didn't understand what a 'normal' upbringing in the Western world was like. So, although I had more money than other kids at school on paper, nobody wanted to come to my house as a kid and I felt poor.",1.7777777777777777,559,94,215,41,26,45,-0.24453190289079713,-0.13243266711851154,-0.7134744915479336,-0.7044144498185115,-0.7159545879468822,-0.6003222696440427,2,3,2,3,3,3,3,2,2,2,2,3,2,2,2,3,3,2,2,2,0.5026246899500346,0,0,3,4,4,2.4,0,3,3,2,2,2,3,4,3,2,2,5,5,1,4,4,3,2,1,1,4,4,3,5,5,1,1,0,1,0,2,2,4,2,2,2,1,1,1,3,3,5,3,3,3,2,2,3,5,5,5,2,1,1,1,3,1,1,3,3,3,3,3,3,1,1,5,2,1,2,2,1.3710871160797478,1.0600988273786194,2.875,0,1.75,0,3,0,1.8888888888888888,0,3.5,0,1.5,0,2.7142857142857144,0,2.3333333333333335,0,2.5405405405405403,0,3,0,0,0.7722708234370463,0.295512711203181,0.5338917673201137,2,2,2,3,1,1,3,4,5,1.2724180205607036,2,0,4.5,0.9729511654606905,5,5,5,5,2,2,4,8,8,5,4,1.6035674514745464,8,4,0,1.3563939699137084,0,1.129384585908699,2,2,2,1,3,3,5,4,4,3,4,4,4,4,4,5,4,5,4,3,1.2227992865708155,2,0,4,0,4.2,0,3.8,0,4,0,4,4,4,2,4,4,4,2,3,2,4,2,3,3,3,2,1,4,3,4,0.8013147091860318,3.1,0,4,4,4,2,4,4,4,2,3,2,4,2,3,3,3,2,1,4,3,4,0.8013147091860318,3.1,0,NA,NA,"Asian or Asian American (e.g., Chinese, Japanese, and others)",0,27,0,1,NA,1,4,4,Gig Worker,6,130,65,3,5,2,0,0,1,0,0,NA,NA,TRUE,TRUE,TRUE,TRUE,TRUE,3,0.4898937499932945,0.4533437499962747,0.5061593749858438,0.5930093749985099,0.5326066666762034,0.5726437500268221,1,1,1,1,0.9375,1,0.076,0.387,0.63,0.018,1.495,70.77445280958314,1868.1393184172528,0.074,0.387,0.673,0.017,1.53,74.36761665022404,1855.094440834441,322,0.9540740740740741,0,3,0,0,3,FALSE
146,2022-03-18T17:28:09Z,2022-03-18T17:44:37Z,988,1,2022-03-18T17:44:38Z,0.8999999761581421,Chrome,99.0.4844.74,Macintosh,1440,900,NA,1.6,452,62,232,69,46,80,-0.4641462860169299,-0.30882213610547216,-0.6517989878743987,-0.35966425329489854,-0.3063900690526044,-0.2071798269457611,3,1,1,2,2,1,1,3,1,1,3,2,1,1,2,2,3,1,3,3,0.998683343734455,0,0,1,3,2,1.85,0,1,1,1,1,1,1,1,1,1,1,1,1,1,1,1,1,1,1,1,1,1,1,1,0,2,0,0,0,0,1,1,1,1,1,1,1,1,1,1,1,1,1,1,1,1,1,1,1,1,2,1,1,1,1,3,1,1,1,1,1,1,2,1,1,1,1,1,1,1,1,1.9199443185119163,2.065591117977289,1,0,1,0,1,0,1,0,1.0833333333333333,0,1.3333333333333333,0,1.1428571428571428,0,1,0,1.1081081081081081,0,0,0,0,-1.547098717457815,-0.6205191861769039,-1.0838089518173595,1,1,1,1,1,1,1,1,1,1.9518001458970664,1,0,1,-0.9598956828029438,5,5,5,5,4,3,5,6,8,5,4,1.5275252316519468,7,4.571428571428571,0,1.175706155734171,0,1.328952699788989,1,2,1,1,1,5,5,4,4,2,5,5,4,5,4,4,5,5,4,5,1.65615734242165,1.2,0,5,0,3.8,0,4.4,0,4.4,0,2,1,3,3,1,4,2,4,2,3,4,3,1,2,1,2,1,2,1,3,0.998683343734455,2.25,0,2,1,3,3,1,4,2,4,2,3,4,3,1,2,1,2,1,2,1,3,0.998683343734455,2.25,0,I lived with my mother and father an equal amount of time (joint custody),0,"White, Caucasian, Anglo, European American",0,28,1,2,NA,1,4,6,Unemployed,5,140,63,3,5,2,0,0,0,0,0,I lived with my mother and father an equal amount of time (joint custody),0,TRUE,TRUE,TRUE,TRUE,TRUE,4,0.478858064516117,0.4338781250000029,0.46277187500000583,0.5670799999999969,0.5363333333333411,0.5801499999999875,0.96875,1,1,0.9375,0.9375,0.8387096774193549,0.058,0.365,0.633,0.01,1.458,93.34945070827129,1974.0107473451437,0.058,0.365,0.605,0.011,1.515,99.18851593457583,1962.2066122731765,436,1.2918518518518518,0,3,0,3,6,FALSE
147,2022-03-18T17:18:31Z,2022-03-18T17:44:59Z,1587,1,2022-03-18T17:45:00Z,1,Firefox,98.0,Windows NT 10.0,1536,864,N/A,1.7777777777777777,602,86,544,160,47,80,-0.15627565546627648,-0.1765300343652517,0.4801279030751821,0.7607738854068437,-0.28591184310789053,-0.2071798269457611,1,1,1,1,1,1,1,1,1,1,1,1,1,1,1,1,1,1,1,1,1.538967528127731,0,1,1,5,5,1,0,1,1,1,1,1,1,1,1,2,1,1,1,1,1,2,1,1,5,1,1,1,1,1,2,2,0,0,0,0,1,4,1,1,1,4,2,2,3,2,1,2,1,3,2,1,1,1,1,2,2,3,1,1,3,1,1,2,2,2,1,1,1,2,1,1,1,2,2,2,2,1.5007505629691607,1.9591057240729093,1.5,0,2,0,1.1333333333333333,0,2.111111111111111,0,1.5833333333333333,0,1.6666666666666667,0,1.5714285714285714,0,1,0,1.6756756756756757,0,1,0,0,-1.0223001436385322,-0.05662557557742737,-0.5394628596079798,1,1,2,2,1,1,1,2,2,1.6761634196950514,1.2857142857142858,0,2,-0.40765372615619105,5,5,5,5,2,2,5,5,5,3,3,1.8126539343499315,5,4.142857142857143,0,0.041907061065850786,0,0.40556271334702465,3,1,3,2,3,3,3,2,4,1,5,3,3,5,5,4,5,4,3,1,1.4074631010979937,2.4,0,4,0,2.8,0,3.4,0,3.4,0,1,1,1,1,1,1,1,1,1,1,1,1,1,1,1,1,1,1,1,1,1.231174022502185,1,0,1,1,1,1,1,1,1,1,1,1,1,1,1,1,1,1,1,1,1,1,1.231174022502185,1,0,I lived with my mother and father an equal amount of time (joint custody),0,"White, Caucasian, Anglo, European American",0,27,0,1,NA,1,2,4,Retail Associate,1,180,75,2,5,2,0,0,1,0,0,I lived with my mother and father an equal amount of time (joint custody),0,TRUE,TRUE,TRUE,TRUE,TRUE,6,0.6797096774193548,0.541,0.6417419354838709,0.7123125,0.6019375,0.768625,1,1,1,1,1,1,0.117,0.289,0.336,0.021,1.691,43.44873402885018,1834.4612609817352,0.115,0.29,0.339,0.018,1.817,43.95690246001431,1826.2279139651125,393,1.1644444444444444,0,3,0,0,3,FALSE
148,2022-03-18T17:13:12Z,2022-03-18T17:46:54Z,2021,1,2022-03-18T17:46:56Z,1,Firefox,98.0,Windows NT 10.0,2144,1206,NA,1.7777777777777777,888,131,625,128,53,120,0.4307310134503028,0.07151765639766168,0.7739935382255541,0.3667736608084288,-0.16304248743960723,0.24212582185227505,2,2,1,1,2,1,1,3,1,2,4,1,1,2,2,2,1,1,2,2,0.9679060415469871,0,1,2,3,3,1.7,0,5,5,5,4,3,4,5,4,3,3,4,5,3,5,3,3,3,1,2,2,3,3,2,2,2,0,0,0,0,3,5,3,5,5,4,3,4,4,3,3,3,1,3,3,3,5,3,2,2,3,3,2,2,1,3,2,2,3,2,1,4,2,2,2,3,2,3,3,4,4,0.8516015648325367,1.3522468075656264,2.375,0,3.5,0,4.066666666666666,0,4,0,2.8333333333333335,0,2.1666666666666665,0,2.2857142857142856,0,2.3333333333333335,0,2.864864864864865,0,1,0,0,1.1616375072384497,0.46047371403480236,0.811055610636626,3,3,5,3,2,3,2,1,2,0.7867957924694432,3,0,1.5,0.39351419755466194,2,3,2,1,1,1,2,3,1,1,2,1.1547005383792515,2,1.7142857142857142,0,-1.272579847782007,0,-1.7119397313087443,3,2,3,3,3,4,1,4,5,1,4,2,3,3,3,5,3,5,4,4,0.9611501047232549,2.8,0,3.6,0,2.8,0,3.8,0,3.4,0,2,1,1,1,2,1,1,2,1,1,2,2,1,1,1,1,1,1,1,1,1.0399898784932577,1.25,0,2,1,1,1,2,1,1,2,1,1,2,2,1,1,1,1,1,1,1,1,1.0399898784932577,1.25,0,I lived with my mother and father an equal amount of time (joint custody),0,Prefer not to say,0,29,0,1,NA,1,2,3,customer service worker,2,280,67,1,5,2,0,0,3,0,0,I lived with my mother and father an equal amount of time (joint custody),0,TRUE,TRUE,TRUE,TRUE,TRUE,3,0.6332258064516129,0.4738125,0.541125,0.62103125,0.5006333333333334,0.6092333333333333,1,1,1,1,0.9375,0.9375,0.075,0.32,0.352,0.009,1.199,90.88564279496724,1991.512219237974,0.076,0.317,0.36,0.009,1.286,118.01520136504394,1981.5113971883168,546,1.6177777777777778,0,3,0,0,3,FALSE
149,2022-03-18T17:27:54Z,2022-03-18T17:47:09Z,1154,1,2022-03-18T17:47:10Z,0.8999999761581421,Chrome,99.0.4844.51,Windows NT 10.0,1920,1080,NA,1.7777777777777777,489,70,309,62,45,72,-0.3882048638144354,-0.26472476885873203,-0.3724452359413291,-0.4458518024258018,-0.3268682949973183,-0.2970409567053683,3,2,1,2,2,1,1,3,1,2,2,1,1,2,2,3,1,1,3,3,0.812727700887249,0,0,5,2,2,1.85,0,4,2,3,2,3,2,3,3,3,4,3,4,3,4,2,2,2,1,1,1,3,3,2,0,2,0,0,0,0,3,2,2,2,2,1,2,2,2,1,4,4,1,5,2,3,1,1,2,5,5,4,1,1,1,1,1,1,1,3,1,2,1,2,1,1,1,1,1,1,2,1.4760347823404023,0.7559289460184544,1.875,0,1.25,0,3,0,2,0,2.8333333333333335,0,1.5,0,1.5714285714285714,0,1,0,2.027027027027027,0,0,0,0,0.11085926753577487,-0.5343359712415323,-0.21173835185287873,3,2,3,3,2,4,3,4,4,0.6900655593423543,2.857142857142857,0,4,1.2769088266942068,4,5,5,4,3,3,5,8,7,5,4,1.3972762620115438,7.5,4.142857142857143,0,1.2660500628239397,0,1.1517419443991723,4,4,4,3,4,2,2,3,2,3,2,2,4,1,2,4,1,3,4,3,1.0465362369445672,3.8,0,2,0,3.4,0,2.2,0,2.533333333333333,0,2,1,2,3,2,3,4,3,2,1,3,4,2,3,1,4,1,1,1,3,0.9119095061289915,2.3,0,2,1,2,3,2,3,4,3,2,1,3,4,2,3,1,4,1,1,1,3,0.9119095061289915,2.3,0,I lived with my mother and father an equal amount of time (joint custody),0,Filipino & Middle Eastern,1,30,0,1,NA,0,4,6,Software Engineer,3,145,68,4,5,2,0,0,1,0,0,I lived with my mother and father an equal amount of time (joint custody),0,TRUE,TRUE,TRUE,TRUE,TRUE,2,0.5941812500059604,0.5362437499947846,0.5492937499955296,0.6790031250044704,0.6329781249985099,0.6626838709731255,1,1,1,1,1,0.96875,0.081,0.407,0.599,0.005,1.075,93.64929387003706,1945.843855005022,0.085,0.41,0.599,0.006,1.111,112.3408736537208,1946.0555808768938,440,1.3037037037037038,0,3,0,3,6,FALSE
150,2022-03-18T17:28:46Z,2022-03-18T17:47:22Z,1115,1,2022-03-18T17:47:23Z,0.8999999761581421,Chrome,99.0.4844.74,Macintosh,1440,900,No,1.6,587,47,221,30,74,56,-0.18706271852134182,-0.39150469969310997,-0.6917066667219801,-0.8398520270242167,0.2670002573993844,-0.47676321622458273,2,3,3,2,3,2,2,2,2,2,3,2,3,3,3,3,3,4,3,3,0.6048053188292994,0,1,1,3,3,2.65,0,4,3,3,2,3,4,2,3,3,4,5,2,3,3,2,1,2,2,1,1,1,1,1,1,2,0,0,0,0,2,3,2,2,3,3,2,3,3,4,3,3,4,2,3,3,2,4,3,3,3,2,4,4,3,3,3,3,4,2,3,4,3,2,2,2,2,3,3,3,3,0.7134486730024866,0.7432233529572065,1.25,0,3,0,3.066666666666667,0,2.5555555555555554,0,3.0833333333333335,0,3.1666666666666665,0,3,0,2,0,2.864864864864865,0,1,0,0,0.23300387183242346,0.2881072841640591,0.2605555779982413,2,2,2,4,4,4,4,8,4,0.7559289460184544,3.142857142857143,0,6,2.2156559858286,3,3,3,4,3,3,3,6,4,4,4,0.3779644730092272,5,3.142857142857143,0,0.6002528368512442,0,0.2039167982835662,3,3,3,3,3,2,3,3,3,3,3,4,3,2,3,2,3,2,3,2,0.5936168397046637,3,0,2.8,0,2.8,0,2.6,0,2.7333333333333334,0,3,4,3,3,3,3,3,3,2,3,3,3,2,2,3,2,2,2,2,2,0.6048053188292994,2.65,0,3,4,3,3,3,3,3,3,2,3,3,3,2,2,3,2,2,2,2,2,0.6048053188292994,2.65,0,I lived with my mother and father an equal amount of time (joint custody),0,"White, Caucasian, Anglo, European American",0,29,0,1,NA,1,3,6,Marketing,3,210,75,3,5,2,0,0,2,0,0,I lived with my mother and father an equal amount of time (joint custody),0,TRUE,TRUE,TRUE,TRUE,TRUE,4,0.7700645161280709,0.8369749999996274,0.8194620689672643,0.8549482758605275,0.7947379310346883,0.98972857142772,1,1,1,0.90625,0.9666666666666667,0.9655172413793104,0.087,0.34,0.226,0.149,1.218,252.21979535838534,2092.6982091654104,0.093,0.326,0.185,0.139,1.329,320.1540002473963,2158.7933892100705,304,0.9007407407407407,1,3,0,0,3,FALSE
151,2022-03-18T17:24:40Z,2022-03-18T17:48:03Z,1403,1,2022-03-18T17:48:04Z,0.8999999761581421,Chrome,99.0.4844.74,Windows NT 10.0,1600,900,NA,1.7777777777777777,773,95,247,55,40,123,0.1946968633614685,-0.12692049621266902,-0.5973794258095151,-0.532039351556705,-0.42925942472088774,0.27582374551212774,3,3,2,2,3,1,3,4,1,3,3,2,2,3,3,3,2,1,4,3,0.5871429486123998,0,1,2,3,3,2.55,0,4,3,3,4,3,2,4,3,3,2,3,5,1,4,3,3,3,1,1,3,3,2,3,0,2,0,0,0,0,3,5,4,4,4,4,4,4,4,1,3,3,1,4,3,4,3,3,3,3,3,4,1,1,1,3,2,1,1,2,1,4,3,3,1,3,2,2,2,1,2,0.79506737584442,0.7237468644557459,2.375,0,1.75,0,3.1333333333333333,0,4,0,2.8333333333333335,0,2,0,2.142857142857143,0,2,0,2.7837837837837838,0,0,0,0,0.7183342858427165,-0.361969541370789,0.17818237223596375,2,1,4,1,1,1,1,1,1,1.1338934190276817,1.5714285714285714,0,1,-0.6284221744847194,3,3,3,3,1,1,3,3,5,2,2,0.9759000729485332,4,2.4285714285714284,0,-0.69712652889908,0,-0.974037322051681,2,2,2,2,2,4,4,4,4,3,4,4,4,4,4,4,4,4,4,3,0.9611501047232549,2,0,4,0,3.8,0,3.8,0,3.8666666666666667,0,2,2,2,3,3,2,3,3,2,1,2,3,3,3,1,3,1,2,2,3,0.6407232755171874,2.3,0,2,2,2,3,3,2,3,3,2,1,2,3,3,3,1,3,1,2,2,3,0.6407232755171874,2.3,0,I lived with my mother and father an equal amount of time (joint custody),0,"White, Caucasian, Anglo, European American",0,27,1,2,NA,1,3,8,Psychologist,3,103,60,3,5,2,0,0,1,0,0,I lived with my mother and father an equal amount of time (joint custody),0,TRUE,TRUE,TRUE,TRUE,TRUE,4,0.5177374999994645,0.4862593750002561,0.4846593749995809,0.5535843749997439,0.5234354838713283,0.551510000000149,1,1,1,1,0.96875,0.967741935483871,0.067,0.339,0.431,0.026,1.877,52.0303250511111,1892.9435430244139,0.068,0.341,0.526,0.024,2.088,46.948698829607196,1873.7981625987,323,0.9570370370370371,0,3,0,9,12,FALSE
152,2022-03-18T17:22:01Z,2022-03-18T17:48:09Z,1567,1,2022-03-18T17:48:10Z,0.8999999761581421,Chrome,99.0.4844.74,Windows NT 10.0,2560,1440,Thanks for the survey,1.7777777777777777,433,102,179,50,24,718,-0.503143232553346,-0.08833529987177138,-0.8440814405036545,-0.5936018866502074,-0.7569110398363099,6.9592452713829145,1,1,1,1,1,1,1,1,1,1,1,1,1,1,1,1,1,4,1,1,1.5312533566021211,0,0,2,5,5,1.15,0,1,1,1,1,1,1,1,1,1,1,1,1,1,1,5,1,1,1,1,1,1,1,1,1,2,0,0,0,0,2,3,1,1,1,1,1,1,1,1,1,1,1,1,1,1,1,1,1,1,1,1,1,1,1,1,2,1,3,2,1,1,1,1,1,1,1,2,1,1,1,1.849843756083719,2.02837021134844,1,0,1.25,0,1.2666666666666666,0,1.3333333333333333,0,1,0,1.1666666666666667,0,1.4285714285714286,0,1,0,1.1891891891891893,0,1,0,0,-1.3951315385424041,-0.3151752203835423,-0.8551533794629732,1,1,3,1,1,1,1,1,1,1.5735915849388864,1.2857142857142858,0,1,-0.7941589286438315,4,5,5,5,1,1,4,3,3,3,3,1.889822365046136,3,3.5714285714285716,0,-0.3194685672932239,0,-0.12442144028845815,1,1,1,1,1,5,3,5,5,2,5,1,5,3,3,3,5,4,2,4,1.162919151265879,1,0,4,0,3,0,4,0,3.6666666666666665,0,1,1,1,1,1,1,1,1,1,1,1,1,1,1,1,1,1,1,1,1,1.231174022502185,1,0,1,1,1,1,1,1,1,1,1,1,1,1,1,1,1,1,1,1,1,1,1.231174022502185,1,0,I lived with my mother and father an equal amount of time (joint custody),0,"White, Caucasian, Anglo, European American",0,29,0,1,NA,1,3,5,Unemployed,3,170,71,2,5,2,0,0,1,0,0,I lived with my mother and father an equal amount of time (joint custody),0,TRUE,TRUE,TRUE,TRUE,TRUE,1,0.5175354838709652,0.440593548387105,0.48853750000000035,0.6418741935483901,0.4964343750000062,0.5650374999999994,0.96875,0.96875,1,0.96875,1,1,0.088,0.315,0.507,0.028,1.905,24.656199901634185,1807.5184447199128,0.086,0.316,0.509,0.028,1.917,32.98622885680016,1814.9598525399979,304,0.9007407407407407,1,3,0,0,3,FALSE
153,2022-03-18T17:28:58Z,2022-03-18T17:49:09Z,1210,1,2022-03-18T17:49:10Z,1,Chrome,96.0.4664.110,Macintosh,1440,900,N/A,1.6,508,150,280,82,46,90,-0.3492079172780193,0.17624890360866954,-0.47765638926677095,-0.1996016620517925,-0.3063900690526044,-0.09485341474625206,4,2,2,2,4,1,2,4,1,4,4,2,1,2,4,3,2,1,4,4,0.6048053188292994,0,0,2,2,2,2.65,0,1,1,2,1,2,1,1,1,1,1,1,2,1,2,1,1,1,1,1,1,1,1,1,2,2,0,0,0,0,1,1,1,1,3,1,1,1,1,2,1,1,1,1,1,1,2,1,1,1,1,1,1,1,1,2,1,1,2,2,1,1,1,1,1,1,1,1,1,2,2,1.8478134143940006,1.8464895909600492,1,0,1.5,0,1.2666666666666666,0,1.2222222222222223,0,1.1666666666666667,0,1.1666666666666667,0,1.2857142857142858,0,1,0,1.1891891891891893,0,1,0,0,-1.3951315385424041,-0.22899200544817064,-0.8120617719952874,2,2,3,1,1,2,1,1,1,1.1547005383792515,1.7142857142857142,0,1,-0.5455537974051633,5,5,5,5,2,2,4,8,7,6,4,1.6035674514745464,7.5,4,0,1.480127753347792,0,1.204806803121409,2,3,2,4,2,4,4,4,4,3,5,4,4,4,4,4,4,4,3,3,1.01418510567422,2.6,0,4.2,0,3.6,0,3.8,0,3.8666666666666667,0,1,1,1,1,2,1,2,2,1,1,3,2,1,1,1,2,1,1,1,2,0.9787209698591858,1.4,0,1,1,1,1,2,1,2,2,1,1,3,2,1,1,1,2,1,1,1,2,0.9787209698591858,1.4,0,I lived with my mother and father an equal amount of time (joint custody),0,"White, Caucasian, Anglo, European American",0,26,1,2,NA,1,4,6,Business Manager,6,130,66,3,5,2,0,0,1,0,0,I lived with my mother and father an equal amount of time (joint custody),0,TRUE,TRUE,TRUE,TRUE,TRUE,4,0.6068187500163913,0.5599612903210425,0.5722468750104308,0.8312366666555404,0.6034928571156093,0.6699499999920527,1,0.96875,1,0.9375,0.9333333333333333,0.967741935483871,0.079,0.388,0.468,0.014,1.675,30.177079349340975,1858.1210239251664,0.08,0.386,0.464,0.015,1.765,31.92323289161542,1856.1272573013832,438,1.2977777777777777,0,3,0,0,3,FALSE
154,2022-03-18T17:20:34Z,2022-03-18T17:49:19Z,1724,1,2022-03-18T17:49:20Z,0.8999999761581421,Chrome,99.0.4844.51,Windows NT 10.0,1536,864,"I find it funny that 13 is your cutoff point for questions because 13 was the start of The Terrible Era of my life with a decent amount of trauma, abuse, uncertainty, and insecurity. My life before 13 feels like an entirely different person than I am now.
Also - I was homeschooled K-12, so that somewhat affected how I responded to questions about school.",1.7777777777777777,869,89,321,72,41,67,0.3917340669138867,-0.15999352164772415,-0.3289095862894222,-0.32272673223879716,-0.40878119877617386,-0.35320416280512285,2,2,2,1,2,2,2,2,1,2,3,1,1,1,2,2,2,1,3,2,0.8522416262267903,0,1,1,2,1,1.8,0,4,2,2,2,2,1,3,1,2,1,1,1,1,2,4,2,1,2,1,1,2,2,1,2,2,0,0,0,0,4,3,1,2,2,1,1,1,1,1,1,2,1,2,3,2,4,2,2,2,3,2,1,1,1,1,1,1,2,1,1,2,3,2,1,1,2,2,2,2,1,1.513205138039714,1.3451854182690985,1.5,0,1.75,0,1.9333333333333333,0,1.7777777777777777,0,2.0833333333333335,0,1.1666666666666667,0,1.7142857142857142,0,1.3333333333333333,0,1.7297297297297298,0,1,0,0,-0.6490750513799575,-0.14280879051279902,-0.39594192094637826,1,2,3,1,1,1,1,1,1,1.5275252316519468,1.4285714285714286,0,1,-0.7112905515642753,5,5,5,5,3,2,5,6,4,3,3,1.7043362064926932,5,4.285714285714286,0,0.041907061065850786,0,0.48298941179669624,2,3,2,1,2,4,5,5,5,3,5,5,5,3,5,4,5,5,4,3,1.65615734242165,2,0,4.8,0,4.2,0,4.2,0,4.4,0,3,4,2,3,2,2,4,3,2,2,4,2,3,2,1,2,2,2,1,2,0.8825799501580878,2.4,0,3,4,2,3,2,2,4,3,2,2,4,2,3,2,1,2,2,2,1,2,0.8825799501580878,2.4,0,I lived with my mother and father an equal amount of time (joint custody),0,"White, Caucasian, Anglo, European American",0,28,1,3,NA,1,2,6,operations coordinator,2,165,64,1,5,2,1,0,1,0,1,I lived with my mother and father an equal amount of time (joint custody),0,TRUE,TRUE,TRUE,TRUE,TRUE,6,0.5445624999925495,0.4924593749940395,0.4994937499910593,0.588790000017484,0.5455062500014901,0.5642499999920527,1,1,1,0.9375,1,0.9375,NA,NA,NA,NA,NA,NA,NA,NA,NA,NA,NA,NA,NA,NA,220,0.6518518518518519,0,3,0,3,6,FALSE
155,2022-03-18T17:24:24Z,2022-03-18T17:50:04Z,1540,1,2022-03-18T17:50:05Z,0.8999999761581421,Chrome,99.0.4844.51,Macintosh,1512,982,"There were instructions during the flanker game that displayed examples of the arrows, however, since pushing any key moved on to the next section, I missed the first set of changed instructions since I saw the arrow display and clicked the right arrow thinking it was still apart of the test. I reacted too fast to the direction of the arrow before realizing there were written instructions on the page. It may be good to have to push the spacebar or something specific instead of any key so reactions to the arrows don't cause direction bypass.",1.539714867617108,654,75,334,69,54,91,-0.0495471702087166,-0.23716391432951942,-0.2817459658331896,-0.35966425329489854,-0.14256426149489335,-0.08362077352630115,3,3,2,2,4,1,1,3,1,4,4,1,3,1,4,3,1,1,3,3,0.6069769786668839,0,1,1,3,3,2.4,0,1,1,3,2,2,2,1,2,2,1,1,3,2,2,2,2,1,1,1,1,2,1,1,1,2,0,0,0,0,2,1,1,1,1,1,1,1,1,1,2,1,1,3,1,1,1,1,1,1,2,1,1,1,1,2,1,1,2,2,1,1,1,1,1,1,1,2,2,2,2,1.8046486518867757,1.4142135623730951,1.25,0,2,0,1.8,0,1.1111111111111112,0,1.3333333333333333,0,1.1666666666666667,0,1.2857142857142858,0,1,0,1.2162162162162162,0,1,0,0,-1.0410007679869313,-0.05662557557742737,-0.5488131717821794,1,1,1,1,1,1,2,1,1,1.889822365046136,1.1428571428571428,0,1,-0.8770273057233877,4,5,5,4,2,2,5,7,6,4,3,1.6035674514745464,6.5,3.857142857142857,0,0.527016472859009,0,0.5464088934971858,1,1,1,1,1,5,4,5,5,3,5,5,5,3,5,5,5,5,2,5,1.6761634196950514,1,0,5,0,3.8,0,4.6,0,4.466666666666667,0,1,2,2,4,1,2,3,4,2,1,3,2,1,3,1,4,1,2,2,2,0.7863975156570492,2.15,0,1,2,2,4,1,2,3,4,2,1,3,2,1,3,1,4,1,2,2,2,0.7863975156570492,2.15,0,I lived with my mother and father an equal amount of time (joint custody),0,"Asian or Asian American (e.g., Chinese, Japanese, and others) & White, Caucasian, Anglo, European American",1,19,1,2,NA,1,4,4,Sales Associate,6,158,66,3,5,2,0,0,1,0,0,I lived with my mother and father an equal amount of time (joint custody),0,TRUE,TRUE,TRUE,TRUE,TRUE,3,0.5367374999970198,0.5312499999990686,0.5357750000013038,0.6118870967741935,0.6016343750003725,0.669045161285708,1,1,1,0.96875,1,0.96875,NA,NA,NA,NA,NA,NA,NA,NA,NA,NA,NA,NA,NA,NA,436,1.2918518518518518,0,3,0,0,3,FALSE
156,2022-03-18T17:32:46Z,2022-03-18T17:50:06Z,1040,1,2022-03-18T17:50:09Z,0.8999999761581421,Safari,13.1.2,Macintosh,1440,900,None,1.6,441,163,234,47,36,64,-0.4867234655906445,0.2479071253846223,-0.6445430462657475,-0.6305394077063088,-0.5111723284997433,-0.38690208646497554,2,2,2,4,2,2,2,3,1,3,3,1,1,2,2,2,2,1,2,2,0.8506963092234007,0,1,2,3,3,2.05,0,3,3,4,3,3,3,3,3,3,3,3,3,4,3,3,2,1,1,1,1,1,2,1,0,2,0,0,0,0,3,3,3,3,4,2,3,3,3,4,2,1,1,2,1,2,2,1,1,1,2,2,1,1,1,1,1,1,1,1,1,2,1,2,2,3,1,1,1,2,2,1.20559257357262,0.3518657752744984,1.25,0,1.5,0,3.1333333333333333,0,3,0,1.6666666666666667,0,1.1666666666666667,0,1.2857142857142858,0,2,0,1.864864864864865,0,0,0,0,-0.17486658764002777,-0.44815275630616064,-0.3115096719730942,2,2,4,3,2,3,3,3,2,0.7559289460184544,2.7142857142857144,0,2.5,0.6142826458831901,3,3,3,3,2,2,3,4,4,3,3,0.4879500364742666,4,2.7142857142857144,0,-0.1387807531136866,0,-0.47884295106809194,2,3,3,2,2,4,3,3,4,3,4,3,3,3,3,3,3,3,3,3,0.4140393356054125,2.4,0,3.4,0,3,0,3.2,0,3.2,0,2,1,2,3,2,1,2,2,2,1,1,2,3,1,1,2,1,2,1,3,0.812727700887249,1.75,0,2,1,2,3,2,1,2,2,2,1,1,2,3,1,1,2,1,2,1,3,0.812727700887249,1.75,0,"I lived with my mother, but not father, most of the time.",0,"White, Caucasian, Anglo, European American",0,30,0,1,NA,1,3,6,operations manager,5,185,74,4,5,2,0,0,1,0,0,"I lived with my mother, but not father, most of the time.",0,TRUE,TRUE,TRUE,TRUE,TRUE,5,0.6422903225806454,0.4211612903225769,0.46550000000000363,0.6453000000000018,0.5329677419354858,0.5595555555555501,1,1,1,0.9375,0.96875,0.84375,NA,NA,NA,NA,NA,NA,NA,NA,NA,NA,NA,NA,NA,NA,304,0.9007407407407407,1,3,0,0,3,FALSE
157,2022-03-18T17:15:16Z,2022-03-18T17:50:09Z,2093,1,2022-03-18T17:50:10Z,1,Chrome,98.0.4758.102,Windows NT 10.0,1920,1080,Nope! All good.,1.7777777777777777,634,606,383,163,181,72,-0.09059658761547039,2.6897988366728587,-0.10397539642123622,0.7977114064629451,2.45817043348377,-0.2970409567053683,2,2,1,1,2,1,1,2,1,2,3,1,1,1,2,2,1,1,2,2,0.998683343734455,0,0,1,3,3,1.55,0,1,2,4,1,5,4,1,3,2,1,1,1,2,3,1,1,2,1,1,1,1,3,1,1,2,0,0,0,0,1,1,1,1,1,1,1,1,1,2,1,1,1,1,2,1,3,1,1,2,3,1,1,1,1,2,1,1,2,1,1,2,3,3,1,1,1,1,1,1,1,1.7719028301912156,1.5023790657297036,1.375,0,1,0,2.1333333333333333,0,1,0,1.5833333333333333,0,1.1666666666666667,0,1.8571428571428572,0,1,0,1.3783783783783783,0,1,0,0,-0.769841714935145,-0.4013584353189139,-0.5856000751270294,1,1,1,1,1,1,1,1,1,1.9518001458970664,1,0,1,-0.9598956828029438,5,5,5,5,4,5,5,8,6,6,4,1.4960264830861913,7,4.857142857142857,0,1.3897838462580232,0,1.6142976538602414,2,2,3,4,3,4,4,4,4,3,5,4,4,4,4,3,5,4,4,4,1.162919151265879,2.8,0,4.4,0,3.6,0,4,0,4,0,1,2,1,3,3,1,2,2,2,1,2,2,2,3,1,2,2,2,2,3,0.7591546545162482,1.95,0,1,2,1,3,3,1,2,2,2,1,2,2,2,3,1,2,2,2,2,3,0.7591546545162482,1.95,0,I lived with my mother and father an equal amount of time (joint custody),0,"White, Caucasian, Anglo, European American",0,28,1,2,NA,1,3,7,Archivist,3,150,62,3,5,2,0,0,1,0,0,I lived with my mother and father an equal amount of time (joint custody),0,TRUE,TRUE,TRUE,TRUE,TRUE,1,0.6332874999344349,0.5187750000208616,0.5839781249761581,0.66891612908148,0.5865406250208616,0.6865624999701977,1,1,1,0.96875,1,1,NA,NA,NA,NA,NA,NA,NA,NA,NA,NA,NA,NA,NA,NA,302,0.8948148148148148,0,3,0,0,3,FALSE
158,2022-03-18T17:31:36Z,2022-03-18T17:51:41Z,1205,1,2022-03-18T17:51:42Z,1,Chrome,98.0.4758.109,Macintosh,1440,900,no comments,1.6,530,91,347,63,37,78,-0.30405355813059015,-0.1489691798360391,-0.2345823453769571,-0.43353929540710134,-0.4906941025550294,-0.22964510938566288,3,3,3,1,3,1,1,3,1,3,3,2,1,1,3,3,1,1,3,4,0.5982430416161189,0,1,4,3,3,2.2,0,2,2,2,2,2,2,2,3,2,2,2,2,2,2,2,2,4,1,1,1,1,2,2,1,2,0,0,0,0,2,2,2,2,2,2,3,2,1,2,2,2,1,2,2,2,1,3,3,3,3,4,1,1,1,1,1,1,1,1,1,1,1,1,1,3,1,1,2,1,1,1.4062281029326207,1,1.75,0,1.25,0,2.066666666666667,0,2,0,2.1666666666666665,0,1.5,0,1,0,1.6666666666666667,0,1.7567567567567568,0,1,0,0,-0.46974590631267793,-0.3151752203835423,-0.3924605633481101,1,1,2,1,1,2,2,2,1,1.6035674514745464,1.4285714285714286,0,1.5,-0.5180379503204552,5,4,5,4,2,2,4,6,3,4,4,1.3972762620115438,4.5,3.7142857142857144,0,0.5099089297614755,0,0.4585542521230551,2,2,2,3,2,4,4,4,4,5,4,4,4,4,4,4,5,4,4,3,1.1872336794093274,2.2,0,4.2,0,4.2,0,3.8,0,4.066666666666666,0,2,1,1,1,1,1,2,2,1,1,2,2,1,1,1,2,1,1,1,2,0.9333020044867296,1.35,0,2,1,1,1,1,1,2,2,1,1,2,2,1,1,1,2,1,1,1,2,0.9333020044867296,1.35,0,I lived with my mother and father an equal amount of time (joint custody),0,"Asian or Asian American (e.g., Chinese, Japanese, and others) & White, Caucasian, Anglo, European American",1,28,1,2,NA,1,3,6,medical assistant supervisor,4,150,63,2,5,2,0,0,1,0,0,I lived with my mother and father an equal amount of time (joint custody),0,TRUE,TRUE,TRUE,TRUE,TRUE,5,0.6413656249949709,0.5587625000001862,0.5938781250026077,0.7347838709652423,0.6619500000009935,0.721323333332936,1,1,1,0.96875,0.9375,0.9375,NA,NA,NA,NA,NA,NA,NA,NA,NA,NA,NA,NA,NA,NA,424,1.2562962962962962,0,3,0,0,3,FALSE
159,2022-03-18T17:36:37Z,2022-03-18T17:52:40Z,962,1,2022-03-18T17:52:40Z,1,Chrome,99.0.4844.51,Windows NT 10.0,1504,1003,NA,1.4995014955134596,497,62,224,43,35,56,-0.3717850968517339,-0.30882213610547216,-0.6808227543090034,-0.6797894357811106,-0.5316505544444572,-0.47676321622458273,2,2,2,2,2,1,2,2,1,2,3,2,2,2,2,2,2,2,2,2,0.6708203932499369,0,1,3,3,3,1.95,0,4,2,4,3,2,3,4,4,2,3,3,5,2,4,2,2,4,1,1,2,4,4,3,2,2,0,0,0,0,2,2,2,2,4,2,2,2,2,3,2,5,2,2,4,3,4,4,5,5,5,4,1,3,1,1,1,2,3,3,1,2,1,2,2,3,4,2,2,2,2,1.2944789205219511,0.9611501047232549,2.625,0,2,0,3.1333333333333333,0,2.2222222222222223,0,3.6666666666666665,0,1.8333333333333333,0,2,0,3,0,2.6486486486486487,0,1,0,0,0.7685306985673668,-0.05662557557742737,0.3559525614949697,2,2,3,1,1,2,2,8,8,1.0690449676496976,1.8571428571428572,0,8,2.242850997087876,4,4,4,4,2,2,3,8,6,5,3,0.9511897312113419,7,3.2857142857142856,0,0.8314380704726299,0,0.42226299682960555,2,2,3,2,3,4,4,4,5,4,5,5,4,4,5,4,4,2,4,1,1.4375905768565218,2.4,0,4,0,4,0,3.8,0,3.933333333333333,0,1,1,4,4,2,4,2,3,1,1,3,4,1,4,2,4,1,4,3,2,1.190974832912761,2.55,0,1,1,4,4,2,4,2,3,1,1,3,4,1,4,2,4,1,4,3,2,1.190974832912761,2.55,0,I lived with my mother and father an equal amount of time (joint custody),0,"Asian or Asian American (e.g., Chinese, Japanese, and others)",0,20,1,2,NA,1,4,4,Student,6,140,67,3,5,2,0,0,1,0,0,I lived with my mother and father an equal amount of time (joint custody),0,TRUE,TRUE,TRUE,TRUE,TRUE,1,0.565654838710062,0.5084593749986962,0.5783903225809336,0.6890310344824503,0.5805464285723865,0.6306000000010245,0.96875,1,1,0.9354838709677419,0.9032258064516129,1,NA,NA,NA,NA,NA,NA,NA,NA,NA,NA,NA,NA,NA,NA,476,1.4103703703703703,0,3,0,0,3,FALSE
160,2022-03-18T17:30:13Z,2022-03-18T17:52:57Z,1363,1,2022-03-18T17:52:59Z,1,Chrome,98.0.4758.102,Windows NT 10.0,1920,1080,NA,1.7777777777777777,508,86,324,105,56,161,-0.3492079172780193,-0.1765300343652517,-0.3180256738764454,0.08358599937831816,-0.10160780960546556,0.702664111870262,1,2,2,1,2,1,3,2,1,1,4,2,1,1,2,1,2,1,3,2,1.118033988749895,0,1,1,4,4,1.75,0,2,2,2,2,2,2,2,1,2,1,1,2,4,2,2,1,1,1,1,2,2,2,3,0,2,0,0,0,0,1,3,4,2,2,1,1,1,2,1,1,1,1,3,4,1,1,1,1,1,2,1,1,1,1,3,2,2,1,1,1,1,1,1,3,4,1,2,1,1,1,1.65763317647414,1.3020130933435712,1.625,0,1.25,0,1.9333333333333333,0,1.8888888888888888,0,1.5,0,1.5,0,1.1428571428571428,0,2.6666666666666665,0,1.6216216216216217,0,0,0,0,-0.6416932259792736,-0.5343359712415323,-0.588014598610403,1,1,4,1,1,1,1,1,1,1.4960264830861913,1.4285714285714286,0,1,-0.7112905515642753,4,4,3,3,1,1,3,3,3,1,2,1.2535663410560174,3,2.7142857142857144,0,-1.0918920336024696,0,-1.0598141622426434,1,3,1,3,1,5,4,5,5,3,5,4,3,2,5,1,5,5,3,4,1.5796322658258457,1.8,0,4.8,0,2.8,0,4.2,0,3.933333333333333,0,1,1,3,2,2,1,2,4,3,3,3,2,2,2,2,2,1,2,2,3,0.812727700887249,2.15,0,1,1,3,2,2,1,2,4,3,3,3,2,2,2,2,2,1,2,2,3,0.812727700887249,2.15,0,I lived with my mother and father an equal amount of time (joint custody),0,"White, Caucasian, Anglo, European American",0,26,1,2,NA,1,2,4,Disabled,1,147,61,2,5,2,0,0,1,0,0,I lived with my mother and father an equal amount of time (joint custody),0,TRUE,TRUE,TRUE,TRUE,TRUE,6,0.5644968749955297,0.47886562503129243,0.4926531250104308,0.6495548387342883,0.5863562499880791,0.5875516129232222,1,1,1,0.96875,1,1,NA,NA,NA,NA,NA,NA,NA,NA,NA,NA,NA,NA,NA,NA,422,1.2503703703703704,0,3,0,0,3,FALSE
161,2022-03-18T17:33:37Z,2022-03-18T17:53:35Z,1197,1,2022-03-18T17:53:35Z,1,Chrome,98.0.4758.109,Macintosh,1366,768,"No, thank you!",1.7786458333333333,496,103,299,78,61,105,-0.3738375677220716,-0.08282312896592887,-0.4087249439845849,-0.24885169012659436,7.833201181038607e-4,0.0736362035530115,4,4,2,2,4,2,4,4,2,4,3,3,3,2,4,4,3,2,4,4,0.8944271909999159,0,0,1,3,3,3.2,0,2,1,2,1,2,2,1,2,2,1,1,1,2,1,2,1,1,1,1,1,1,2,1,0,2,0,0,0,0,1,1,2,1,1,1,1,1,1,1,1,1,1,1,1,1,1,1,1,1,3,1,1,1,1,2,1,1,1,1,1,2,1,2,1,1,1,1,1,1,1,1.8639942259766993,1.5976172734359604,1.125,0,1,0,1.5333333333333334,0,1.1111111111111112,0,1.1666666666666667,0,1.1666666666666667,0,1.2857142857142858,0,1,0,1.162162162162162,0,0,0,0,-1.235782534226309,-0.6205191861769039,-0.9281508602016064,1,1,3,1,1,2,2,1,1,1.4638501094227998,1.5714285714285714,0,1,-0.6284221744847194,5,4,4,5,3,3,4,4,3,3,3,1.1126972805283737,3.5,4,0,-0.22912466020345523,0,0.16292799501975622,2,2,2,2,2,4,5,4,5,3,5,3,4,3,4,2,4,3,4,3,1.162919151265879,2,0,3.8,0,3.6,0,3.8,0,3.7333333333333334,0,3,3,1,3,2,1,1,1,1,2,2,2,3,1,2,1,2,2,2,2,0.9333020044867296,1.85,0,3,3,1,3,2,1,1,1,1,2,2,2,3,1,2,1,2,2,2,2,0.9333020044867296,1.85,0,I lived with my mother and father an equal amount of time (joint custody),0,"White, Caucasian, Anglo, European American",0,28,1,2,NA,1,3,6,Strength Coach,4,144,66,4,5,2,0,0,2,0,0,I lived with my mother and father an equal amount of time (joint custody),0,TRUE,TRUE,TRUE,TRUE,TRUE,4,0.5211812500022351,0.4593500000014901,0.45197812499850987,0.5798866666674614,0.5623733333329359,0.5830666666686535,1,1,1,0.9375,0.9375,0.9375,NA,NA,NA,NA,NA,NA,NA,NA,NA,NA,NA,NA,NA,NA,390,1.1555555555555557,0,3,0,0,3,FALSE
162,2022-03-18T17:36:29Z,2022-03-18T17:53:55Z,1046,1,2022-03-18T17:53:56Z,1,Firefox,95.0,Macintosh,1280,800,NA,1.6,488,68,292,42,43,66,-0.3902573346847731,-0.2757491106704171,-0.43412073961486397,-0.6921019427998111,-0.36782474688674605,-0.3644368040250737,3,3,2,1,3,1,1,3,1,3,3,1,1,1,3,3,1,1,3,3,0.5104177855340404,0,0,4,4,4,2.05,0,2,2,2,2,2,2,3,2,2,2,2,3,2,3,3,2,2,1,1,1,2,1,1,1,2,0,0,0,0,3,3,3,3,3,3,3,3,3,2,3,3,2,4,2,3,2,3,4,4,4,3,1,1,1,3,2,1,3,3,1,2,2,2,1,2,2,2,2,2,2,0.9012837024557319,0.816496580927726,1.375,0,2,0,2.2666666666666666,0,3,0,3,0,1.8333333333333333,0,2,0,1.6666666666666667,0,2.5135135135135136,0,1,0,0,-0.21551583951312675,-0.05662557557742737,-0.13607070754527706,2,2,3,2,2,2,2,1,1,0.7867957924694432,2.142857142857143,0,1,-0.29694866616649496,4,4,4,2,1,1,3,6,6,3,3,1.3801311186847085,6,2.7142857142857144,0,0.22259487524538815,0,-0.25856559123129685,4,4,4,4,4,2,4,2,2,4,4,3,4,3,3,3,3,3,3,3,0.6761234037828132,4,0,3,0,3.6,0,2.6,0,3.066666666666667,0,2,1,2,3,2,2,2,3,2,2,2,3,2,2,1,3,1,2,2,2,0.36634754853252327,2.05,0,2,1,2,3,2,2,2,3,2,2,2,3,2,2,1,3,1,2,2,2,0.36634754853252327,2.05,0,I lived with my mother and father an equal amount of time (joint custody),0,"White, Caucasian, Anglo, European American",0,28,0,1,NA,1,2,6,dog walker,1,150,68,2,5,2,0,0,1,0,0,I lived with my mother and father an equal amount of time (joint custody),0,TRUE,TRUE,TRUE,TRUE,TRUE,6,0.4990322580645161,0.491,0.5640000000000001,0.5579642857142857,0.5514,0.6276774193548387,0.96875,1,1,0.875,0.967741935483871,0.96875,NA,NA,NA,NA,NA,NA,NA,NA,NA,NA,NA,NA,NA,NA,387,1.1466666666666667,0,3,0,3,6,FALSE
164,2022-03-18T17:37:22Z,2022-03-18T17:56:18Z,1136,1,2022-03-18T17:56:19Z,0.8999999761581421,Chrome,100.0.4896.30,Macintosh,1536,960,NA,1.6,530,96,273,68,45,68,-0.30405355813059015,-0.1214083253068265,-0.50305218489705,-0.371976760313599,-0.3268682949973183,-0.3419715215851719,3,3,3,2,3,1,2,3,1,3,3,2,2,1,3,3,1,1,3,3,0.5231483637805969,0,1,1,2,2,2.3,0,2,2,2,2,2,2,2,1,2,2,4,3,3,3,2,2,3,1,1,2,3,3,1,0,2,0,0,0,0,2,2,1,1,2,1,1,1,2,2,4,1,1,1,1,3,2,1,1,2,4,2,1,1,1,2,1,1,1,3,1,2,2,2,1,1,1,2,1,1,2,1.5744773669313188,1.0327955589886444,2,0,1.5,0,2.2666666666666666,0,1.4444444444444444,0,1.9166666666666667,0,1.3333333333333333,0,1.7142857142857142,0,1,0,1.5945945945945945,0,0,0,0,-0.3439596014850256,-0.44815275630616064,-0.3960561788955931,1,1,3,1,1,2,1,1,1,1.5275252316519468,1.4285714285714286,0,1,-0.7112905515642753,5,5,5,5,3,3,4,7,7,6,4,1.2909944487358056,7,4.285714285714286,0,1.3897838462580232,0,1.304590860061554,1,2,2,3,1,5,5,5,5,2,5,5,3,4,5,5,5,4,5,4,1.7674302033770737,1.8,0,4.8,0,4,0,4.6,0,4.466666666666667,0,1,1,2,3,3,4,4,3,1,1,4,3,1,2,1,3,3,3,3,2,1.0563093645728086,2.4,0,1,1,2,3,3,4,4,3,1,1,4,3,1,2,1,3,3,3,3,2,1.0563093645728086,2.4,0,I lived with my mother and father an equal amount of time (joint custody),0,"White, Caucasian, Anglo, European American",0,23,1,2,NA,1,3,6,Researcher,2,160,64,1,5,2,0,0,1,0,0,I lived with my mother and father an equal amount of time (joint custody),0,TRUE,TRUE,TRUE,TRUE,TRUE,3,0.5615031249988824,0.5062531249991152,0.514625,0.6522281250006053,0.5560250000006054,0.5880000000004967,1,1,1,1,1,0.9375,NA,NA,NA,NA,NA,NA,NA,NA,NA,NA,NA,NA,NA,NA,384,1.1377777777777778,0,3,0,0,3,FALSE
165,2022-03-18T17:34:34Z,2022-03-18T17:57:03Z,1348,1,2022-03-18T17:57:04Z,0.8999999761581421,Chrome,98.0.4758.80,Macintosh,1440,900,NA,1.6,496,80,465,87,62,82,-0.3738375677220716,-0.20960305980030683,0.1935182095334613,-0.13803912695829018,0.021261546062817747,-0.18471454450585928,3,2,2,2,3,2,3,3,1,2,2,2,2,2,3,2,2,1,3,3,0.5871429486123998,0,1,2,1,1,2.25,0,4,1,3,3,3,3,2,3,3,2,4,2,2,2,3,4,3,5,4,3,3,4,3,8,1,1,0,1,0,1,2,1,1,1,1,2,1,1,3,1,2,1,2,2,1,2,2,3,3,3,4,2,2,5,3,2,3,5,1,1,2,3,2,2,2,1,2,3,4,2,1.4305755997312923,0.8618916073713346,3.625,0,2.75,0,2.6666666666666665,0,1.2222222222222223,0,2.0833333333333335,0,3,0,2.4285714285714284,0,1.6666666666666667,0,2.054054054054054,0,4,0,0,0.74175927844755285,0.8594063218026575,0.8005828001251052,2,2,2,2,2,2,4,4,1,1.0690449676496976,2.2857142857142856,0,2.5,0.3656775146445217,4,5,5,5,4,4,4,6,7,3,3,1.0690449676496976,6.5,4.428571428571429,0,0.3129387823351568,0,0.7256241301239648,2,3,3,3,3,4,4,4,3,3,4,4,3,4,4,4,3,3,4,3,0.7988086367179802,2.8,0,3.6,0,3.6,0,3.6,0,3.6,0,2,2,2,1,2,1,2,2,1,1,3,2,2,2,1,1,1,2,1,3,0.9679060415469871,1.7,0,2,2,2,1,2,1,2,2,1,1,3,2,2,2,1,1,1,2,1,3,0.9679060415469871,1.7,0,I lived with my mother and father an equal amount of time (joint custody),0,"White, Caucasian, Anglo, European American",0,21,1,2,NA,1,3,4,Student,4,118,61,1,5,2,0,0,1,0,0,I lived with my mother and father an equal amount of time (joint custody),0,TRUE,TRUE,TRUE,TRUE,TRUE,3,0.544212499992922,0.44487500000558794,0.4761562500093132,0.6008827586132904,0.5233187500033527,0.5506625000014901,1,1,1,0.9354838709677419,1,1,NA,NA,NA,NA,NA,NA,NA,NA,NA,NA,NA,NA,NA,NA,430,1.2740740740740741,0,3,0,0,3,FALSE
166,2022-03-18T17:25:45Z,2022-03-18T17:58:27Z,1961,1,2022-03-18T17:58:29Z,0.8999999761581421,Chrome,99.0.4844.51,Macintosh,1440,900,na,1.6,734,151,481,149,139,148,0.11465049941829858,0.18176107451451207,0.25156574240267054,0.6253363082011386,1.598084943805787,0.5566397760109003,2,2,2,2,2,1,2,2,1,3,3,2,2,2,2,2,2,2,3,2,0.6386663736585051,0,1,1,3,2,2.05,0,2,2,1,2,2,1,2,2,1,1,1,2,2,1,1,1,2,1,1,1,2,1,1,1,2,0,0,0,0,1,1,1,1,1,1,1,1,1,1,1,1,1,1,1,2,1,1,1,1,1,2,3,1,1,1,1,1,1,1,1,1,1,2,1,1,1,1,1,1,1,1.879636409796595,1.5796322658258457,1.25,0,1,0,1.5333333333333334,0,1,0,1.0833333333333333,0,1.5,0,1.1428571428571428,0,1,0,1.135135135135135,0,1,0,0,-1.1929679469023426,-0.4013584353189139,-0.7971631911106283,1,1,2,1,1,1,1,1,1,1.7320508075688772,1.1428571428571428,0,1,-0.8770273057233877,5,5,5,5,3,4,4,6,7,6,4,1.2149857925879117,6.5,4.428571428571429,0,1.2994399391682545,0,1.3269482185520274,2,2,2,2,2,4,4,4,5,2,3,2,4,4,4,3,3,4,3,2,0.9611501047232549,2,0,3.2,0,3.2,0,3.8,0,3.4,0,1,2,1,2,1,1,2,2,1,2,4,4,2,2,1,1,2,2,1,3,0.998683343734455,1.85,0,1,2,1,2,1,1,2,2,1,2,4,4,2,2,1,1,2,2,1,3,0.998683343734455,1.85,0,I lived with my mother and father an equal amount of time (joint custody),0,"White, Caucasian, Anglo, European American",0,29,1,2,NA,1,3,6,cottage baker,3,230,69,2,5,2,0,0,1,0,0,I lived with my mother and father an equal amount of time (joint custody),0,TRUE,TRUE,TRUE,TRUE,TRUE,3,0.7481709677480882,0.643974193530698,0.5853968749940396,0.8139281249903142,0.7013749999888241,0.6873709677342446,1,1,1,1,1,1,0.088,0.436,0.532,0.022,1.672,49.97416304503353,1847.5022457718983,0.088,0.436,0.534,0.02,1.688,69.49166710459677,1855.5116694725348,380,1.125925925925926,0,3,0,0,3,FALSE
167,2022-03-18T17:37:10Z,2022-03-18T17:58:48Z,1297,1,2022-03-18T17:58:49Z,0.8999999761581421,Chrome,99.0.4844.74,Windows NT 10.0,1805,1204,n/a,1.4991694352159468,525,83,380,86,55,116,-0.3143159124822786,-0.19306654708277926,-0.11485930883421297,-0.15035163397699064,-0.12208603555017945,0.19719525697247142,2,2,1,1,2,1,1,2,1,2,2,1,1,1,2,4,1,1,3,2,0.9880869341680844,0,1,1,2,1,1.65,0,2,2,2,1,2,1,2,3,3,2,3,3,2,3,2,2,2,1,1,1,3,2,3,0,2,0,0,0,0,1,2,1,1,1,1,4,1,2,3,1,3,1,2,4,4,2,3,4,4,4,1,1,1,1,1,1,1,1,3,1,1,1,2,1,1,3,2,2,2,4,1.622384705343382,1.0690449676496976,1.875,0,2.5,0,2.2,0,1.5555555555555556,0,2.9166666666666665,0,1,0,1.4285714285714286,0,1.6666666666666667,0,1.8918918918918919,0,0,0,0,-0.29779858664608255,-0.10341989656467412,-0.20060924160537835,3,3,3,2,2,5,4,6,1,1.0690449676496976,3.142857142857143,0,3.5,1.2493929796094987,5,5,5,5,3,3,5,6,7,6,4,1.5735915849388864,6.5,4.428571428571429,0,1.2994399391682545,0,1.3269482185520274,3,3,3,3,3,2,4,2,3,4,1,2,4,3,3,4,2,3,4,3,0.9411239481143202,3,0,2,0,4,0,2.8,0,2.933333333333333,0,1,1,3,3,3,4,4,3,3,3,2,4,2,4,2,3,2,4,3,2,1,2.8,0,1,1,3,3,3,4,4,3,3,3,2,4,2,4,2,3,2,4,3,2,1,2.8,0,I lived with my mother and father an equal amount of time (joint custody),0,"Hispanic of Latino (e.g., Mexican American, Central American, and others) & White, Caucasian, Anglo, European American",1,23,1,2,NA,1,3,6,real estate agent,3,125,65,2,4,2,0,0,0,1,0,I lived with my mother and father an equal amount of time (joint custody),0,TRUE,TRUE,TRUE,TRUE,TRUE,5,0.6915093749947846,0.5344999999962747,0.6089499999992549,0.7591218750011176,0.6294874999914318,0.682590624993667,1,1,1,1,1,1,0.193,0.313,0.657,0.015,1.396,12.39698506367966,1813.3641986490538,0.193,0.313,0.656,0.015,1.406,25.34200239786975,1807.2167939073881,450,1.3333333333333335,0,3,0,0,3,FALSE
168,2022-03-18T17:28:44Z,2022-03-18T17:59:02Z,1817,1,2022-03-18T17:59:03Z,1,Chrome,99.0.4844.51,Windows NT 10.0,1600,900,n/a,1.7777777777777777,992,94,395,99,53,97,0.6441879839654225,-0.13243266711851154,-0.060439746769329276,0.009710957266115384,-0.16304248743960723,-0.01622492620659573,2,1,2,2,2,1,2,1,1,2,1,2,1,1,2,1,2,1,2,2,1.0990426455975697,0,1,1,5,5,1.55,0,4,1,3,3,2,2,4,3,1,2,2,3,2,3,3,1,3,3,1,1,2,3,1,1,1,0,0,1,0,2,1,1,1,1,1,2,1,3,1,1,1,1,2,1,1,3,1,2,3,3,3,1,1,2,5,1,1,2,1,1,2,3,2,1,1,1,2,2,1,1,1.643989873053573,0.9154754164341269,1.875,0,1.5,0,2.533333333333333,0,1.4444444444444444,0,1.6666666666666667,0,2.1666666666666665,0,1.7142857142857142,0,1,0,1.6486486486486487,0,1,0,0,-0.258428851175769,-0.22899200544817064,-0.24371042831196982,1,1,2,1,1,1,3,1,1,1.7043362064926932,1.4285714285714286,0,1,-0.7112905515642753,5,5,5,5,4,3,5,5,3,4,3,1.5275252316519468,4,4.571428571428571,0,0.07529693741016555,0,0.6581956859495511,1,2,2,2,2,4,5,4,4,5,5,5,4,5,5,5,5,5,5,3,1.7511900715418263,1.8,0,4.8,0,4.8,0,4.2,0,4.6,0,1,1,1,1,1,1,1,1,1,1,2,1,1,1,1,1,1,2,1,2,1.2085223687584246,1.15,0,1,1,1,1,1,1,1,1,1,1,2,1,1,1,1,1,1,2,1,2,1.2085223687584246,1.15,0,I lived with my mother and father an equal amount of time (joint custody),0,"White, Caucasian, Anglo, European American",0,27,1,2,NA,1,4,6,nurse care manager,6,122,63,3,5,2,0,0,1,0,0,I lived with my mother and father an equal amount of time (joint custody),0,TRUE,TRUE,TRUE,TRUE,TRUE,5,0.4941812500022352,0.4844781249947846,0.4677375000026077,0.5705875000078231,0.5707562499959021,0.6079343750085682,1,1,1,1,1,1,0.115,0.287,0.612,0.01,1.447,78.40939280329741,1889.353321771888,0.115,0.287,0.645,0.009,1.521,82.52459633890152,1865.5480275745244,364,1.0785185185185184,0,3,0,0,3,FALSE
169,2022-03-18T17:35:31Z,2022-03-18T17:59:31Z,1439,1,2022-03-18T17:59:32Z,NA,Chrome,99.0.4844.74,Windows NT 10.0,1366,768,NA,1.7786458333333333,816,67,308,69,41,83,0.28295311078598917,-0.28126128157625957,-0.3760732067456547,-0.35966425329489854,-0.40878119877617386,-0.17348190328590837,2,3,3,2,2,1,2,3,1,2,4,3,1,2,3,2,1,1,3,3,0.7947194142390263,0,0,1,3,2,2.2,0,2,1,1,2,1,2,2,1,1,1,1,1,1,3,1,2,1,1,4,2,2,2,1,3,1,1,0,3,0,1,2,1,1,1,1,1,1,1,2,1,1,1,2,1,3,1,1,1,1,1,1,1,1,1,1,1,3,3,2,2,1,1,1,1,1,1,1,2,2,2,1.7866707005467437,1.7237832147426693,1.875,0,1.75,0,1.4,0,1.1111111111111112,0,1.3333333333333333,0,1,0,1.8571428571428572,0,1,0,1.2972972972972974,0,2,0,0,-0.9072420917265402,0.07635196034519101,-0.41544506569067463,1,1,3,1,1,2,2,1,1,1.4638501094227998,1.5714285714285714,0,1,-0.6284221744847194,5,5,5,5,2,2,5,3,3,3,4,1.8126539343499315,3,4.142857142857143,0,0.024799517968317347,0,0.3951347704225659,3,3,3,4,2,4,5,5,4,2,5,2,5,5,5,1,5,5,3,4,1.6987390281365427,3,0,4.2,0,3.2,0,4.6,0,4,0,2,1,1,4,2,2,3,3,3,2,4,3,1,1,1,2,2,2,2,3,0.8583950752789521,2.2,0,2,1,1,4,2,2,3,3,3,2,4,3,1,1,1,2,2,2,2,3,0.8583950752789521,2.2,0,I lived with my mother and father an equal amount of time (joint custody),0,"Hispanic of Latino (e.g., Mexican American, Central American, and others)",0,25,1,2,NA,1,2,3,unemployed,2,125,62,3,5,2,0,0,1,0,0,I lived with my mother and father an equal amount of time (joint custody),0,TRUE,TRUE,TRUE,TRUE,TRUE,1,0.4751374999992549,0.4811187499985099,0.5204375000037252,0.5843433333317439,0.5772900000055631,0.5849758620755425,1,1,1,0.967741935483871,0.967741935483871,0.90625,0.059,0.361,0.364,0.017,1.651,48.65376690932801,1931.4126266513574,0.062,0.365,0.423,0.025,2.039,59.24154373423173,1916.6154778231169,328,0.9718518518518519,0,3,0,3,6,FALSE
170,2022-03-18T17:26:08Z,2022-03-18T17:59:33Z,2005,1,2022-03-18T17:59:34Z,1,Chrome,98.0.4758.81,Windows NT 10.0,1536,864,NA,1.7777777777777777,1169,102,491,81,40,80,1.0074753280151936,-0.08833529987177138,0.28784545044592635,-0.21191416907049299,-0.42925942472088774,-0.2071798269457611,3,2,2,1,3,1,2,3,1,2,3,2,1,1,3,3,2,1,4,3,0.6386663736585051,0,0,3,4,3,2.15,0,4,1,2,2,1,1,1,1,2,1,2,2,1,2,1,1,3,1,1,1,3,2,1,0,1,2,0,2,0,1,1,1,1,1,1,1,1,1,2,1,3,1,3,2,4,2,2,3,3,3,3,1,1,1,4,1,1,1,1,1,1,1,1,1,2,2,1,1,1,1,1.652189374657073,1.632993161855452,1.625,0,1,0,1.6,0,1,0,2.4166666666666665,0,1.8333333333333333,0,1,0,1.6666666666666667,0,1.6486486486486487,0,0,0,0,-0.7755503265783404,-0.6205191861769039,-0.6980347563776221,1,1,3,1,1,1,1,1,1,1.5735915849388864,1.2857142857142858,0,1,-0.7941589286438315,5,5,5,5,2,2,5,6,7,3,3,1.8126539343499315,6.5,4.142857142857143,0,0.3129387823351568,0,0.570770733224621,2,3,2,2,1,4,4,5,5,3,4,4,3,3,4,3,3,4,3,3,0.9611501047232549,2,0,3.8,0,3.2,0,4,0,3.6666666666666665,0,3,2,3,2,3,2,2,3,1,1,3,2,1,2,1,3,1,1,1,1,0.8522416262267903,1.9,0,3,2,3,2,3,2,2,3,1,1,3,2,1,2,1,3,1,1,1,1,0.8522416262267903,1.9,0,I lived with my mother and father an equal amount of time (joint custody),0,"Asian or Asian American (e.g., Chinese, Japanese, and others)",0,22,1,2,NA,1,3,3,full time student,4,185,67,2,5,2,0,0,1,0,0,I lived with my mother and father an equal amount of time (joint custody),0,TRUE,TRUE,TRUE,TRUE,TRUE,1,0.5061468750238418,0.4648937500119209,0.5160999999940395,0.5675250000442777,0.561564516144414,0.5853148148324755,1,1,1,0.875,0.96875,0.84375,0.054,0.391,0.56,0.012,1.716,75.74252220576953,1983.751288964257,0.053,0.392,0.502,0.015,1.785,95.45348721546469,1959.9798676156538,356,1.0548148148148149,0,3,0,0,3,FALSE
171,2022-03-18T16:42:40Z,2022-03-18T18:00:43Z,4683,1,2022-03-18T18:00:44Z,0.8999999761581421,Chrome,99.0.4844.51,Macintosh,1440,900,Only breaks I took were during the questions after the game!,1.6,705,71,3457,112,53,63,0.05512884417850558,-0.2592125979528895,11.048406856075596,0.1697735485092214,-0.16304248743960723,-0.3981347276849264,4,3,4,3,4,2,4,4,2,4,4,4,4,3,4,4,4,2,4,4,1.268027892769755,0,1,2,2,1,3.55,0,2,1,1,1,1,1,2,2,2,2,2,2,3,2,1,1,3,2,2,2,3,2,2,0,2,0,0,0,0,1,1,3,1,1,1,2,1,3,1,1,3,1,4,1,5,1,3,3,3,3,4,1,3,1,1,1,1,1,3,1,1,1,1,1,1,1,1,2,1,2,1.6093756833288149,1.5118578920369088,2.125,0,1.5,0,1.6666666666666667,0,1.5555555555555556,0,2.4166666666666665,0,1.8333333333333333,0,1.2857142857142858,0,1,0,1.7837837837837838,0,0,0,0,-0.46886008726459594,-0.44815275630616064,-0.45850642178537826,1,1,1,1,1,1,3,1,2,1.9023794624226837,1.2857142857142858,0,1.5,-0.6009063274000113,5,5,5,5,3,3,5,6,7,5,4,1.5735915849388864,6.5,4.428571428571429,0,1.0853622486444023,0,1.1964566613801186,3,2,4,3,3,3,5,3,4,3,4,3,3,5,3,5,3,3,4,3,1.0327955589886444,3,0,3.2,0,4,0,3.6,0,3.6,0,1,2,4,3,3,4,4,3,4,2,2,3,1,4,1,3,4,4,2,3,1.1367080817685316,2.85,0,1,2,4,3,3,4,4,3,4,2,2,3,1,4,1,3,4,4,2,3,1.1367080817685316,2.85,0,"I lived with my mother, but not father, most of the time.",0,"White, Caucasian, Anglo, European American",0,27,1,2,NA,1,4,8,Editor (currently),4,120,65,2,5,2,1,0,1,0,1,"I lived with my mother, but not father, most of the time.",0,TRUE,TRUE,TRUE,TRUE,TRUE,4,0.4925031250002794,0.455568749998929,0.4798343749998603,0.5601580645158406,0.5164387096784288,0.5830290322575358,1,1,1,0.96875,0.96875,0.96875,0.068,0.362,0.579,0.018,1.937,100.91701585540159,1948.9232823047587,0.068,0.365,0.657,0.018,2.035,107.14878895032449,1938.4006970757216,404,1.1970370370370371,0,3,0,0,3,FALSE
172,2022-03-18T17:31:12Z,2022-03-18T18:01:22Z,1810,1,2022-03-18T18:01:23Z,1,Edge,99.0.1150.39,Windows NT 10.0,1366,768,NA,1.7786458333333333,781,90,489,132,76,116,0.21111663032417,-0.15448135074188163,0.2805895088372752,0.4160236888832307,0.30795670928881214,0.19719525697247142,3,2,2,2,3,1,1,4,1,3,2,2,2,2,3,3,2,1,3,4,0.6155870112510925,0,0,4,3,3,2.3,0,5,2,5,3,4,5,1,5,5,5,5,5,1,5,5,5,5,1,2,5,5,5,5,1,1,2,0,2,0,3,5,3,4,5,4,5,4,4,1,2,5,1,4,3,3,4,5,4,5,5,5,1,1,3,2,1,2,3,3,3,2,1,1,1,1,5,1,5,1,2,1.4263711068773564,1.8439088914585775,4.125,0,2.25,0,4.066666666666666,0,4.111111111111111,0,3.5,0,2.1666666666666665,0,2.142857142857143,0,2.3333333333333335,0,3.081081081081081,0,1,0,0,2.020881983878048,0.029557639357944268,1.0252198116179962,2,2,5,2,2,2,2,8,5,0.8997354108424374,2.4285714285714284,0,6.5,1.9945667016746393,4,4,5,4,1,1,4,3,2,2,2,1.632993161855452,2.5,3.2857142857142856,0,-0.9681582501683861,0,-0.6746851512312461,2,3,3,1,3,3,3,2,4,3,3,3,3,3,4,3,5,5,3,2,0.9154754164341269,2.4,0,3.8,0,3,0,3,0,3.2666666666666666,0,1,4,1,1,3,1,2,1,2,2,3,3,1,2,2,2,1,2,1,2,1.0399898784932577,1.85,0,1,4,1,1,3,1,2,1,2,2,3,3,1,2,2,2,1,2,1,2,1.0399898784932577,1.85,0,"I lived with my extended family on father's side (grandparents, aunts ,uncles, cousins)",0,"White, Caucasian, Anglo, European American",0,25,0,1,NA,1,3,4,fractured spine rn so I do not work.,4,155,69,1,5,2,0,0,1,0,0,"I lived with my extended family on father's side (grandparents, aunts ,uncles, cousins)",0,TRUE,TRUE,TRUE,TRUE,TRUE,4,0.7122133333305518,0.6882290322559496,0.8320656249960885,0.8774468750040978,0.7995406250003725,1.2237343750037253,0.9375,1,1,1,1,1,0.159,0.215,0.205,0.01,1.796,79.86481775668436,1886.9347949471141,0.158,0.181,0.209,0.007,1.955,88.22500282208361,1871.785172759751,362,1.0725925925925925,0,3,0,0,3,FALSE
173,2022-03-18T17:27:30Z,2022-03-18T18:01:29Z,2038,1,2022-03-18T18:01:30Z,1,Safari,15.3,Macintosh,1440,900,NA,1.6,569,241,652,133,119,109,-0.22400719418742024,0.6778564560403388,0.8719487499423447,0.42833619590193117,1.188520424911509,0.1185667684328151,2,2,2,1,2,1,1,3,1,1,2,2,1,2,2,1,1,3,1,1,1.142481141154959,1,1,1,3,4,1.6,0,3,2,1,5,3,5,5,4,4,3,1,4,1,4,5,5,3,5,1,3,5,5,5,2,1,1,0,1,0,5,5,5,1,5,5,5,5,5,1,1,5,1,4,3,4,5,5,5,5,5,4,3,2,1,2,1,1,2,1,1,5,5,5,1,1,4,2,3,2,1,1.724666482098633,1.4040757000349275,4,0,2,0,3.3333333333333335,0,4.555555555555555,0,3.6666666666666665,0,2.1666666666666665,0,2.857142857142857,0,2,0,3.3513513513513513,0,1,0,0,1.763896035595575,-0.05662557557742737,0.8536352300090738,5,5,3,3,1,5,1,2,1,1.7994708216848747,3.2857142857142856,0,1.5,0.559250951713774,5,5,5,3,1,1,2,4,3,NA,2,1.8126539343499315,3.5,3.142857142857143,0,-0.7814618182828701,1,-0.6383106027804811,2,4,2,1,1,5,5,5,5,2,5,5,4,5,5,1,5,5,3,1,1.88477610139267,2,0,5,0,3,0,4.2,0,4.066666666666666,0,4,2,3,1,4,2,4,1,1,4,3,2,3,1,1,2,3,3,1,3,1.105012502906165,2.4,0,4,2,3,1,4,2,4,1,1,4,3,2,3,1,1,2,3,3,1,3,1.105012502906165,2.4,0,"I lived with my father, but not mother, most of the time. & I lived with my mother and father an equal amount of time (joint custody)",1,"White, Caucasian, Anglo, European American",0,22,0,2,NA,1,2,1,Unemployed,2,109,70,2,5,2,0,0,0,0,0,"I lived with my father, but not mother, most of the time. & I lived with my mother and father an equal amount of time (joint custody)",1,TRUE,TRUE,TRUE,TRUE,TRUE,3,0.4927187499999964,0.44381249999999817,0.4396562499999982,0.5573333333333256,0.5186451612903207,0.5099000000000078,1,1,1,0.9375,0.96875,0.9375,0.056,0.358,0.646,0.024,1.817,87.0289223176744,1944.5374658808225,0.056,0.358,0.696,0.024,1.886,89.57540870169143,1936.993958197959,360,1.0666666666666667,0,3,0,0,3,FALSE
174,2022-03-18T17:21:20Z,2022-03-18T18:01:46Z,2426,1,2022-03-18T18:01:47Z,1,Chrome,97.0.4692.71,Windows NT 10.0,1920,1200,NA,1.6,639,125,270,168,43,79,-0.08033423326378195,0.038444630962606564,-0.5139360973100268,0.8592739415564474,-0.36782474688674605,-0.218412468165712,3,2,1,1,3,1,1,3,1,3,3,1,1,1,3,3,1,1,3,3,0.6048053188292994,0,1,1,3,3,1.95,0,1,2,2,2,2,1,3,2,2,1,2,2,2,2,2,1,1,1,1,1,1,1,1,1,1,2,0,0,0,1,1,1,1,1,1,1,1,1,1,1,1,1,2,1,2,2,1,1,1,1,1,1,1,1,2,1,1,1,1,1,1,1,1,1,2,1,2,1,1,1,1.8647995810481826,1.2649110640673518,1,0,1.25,0,1.8666666666666667,0,1,0,1.25,0,1.1666666666666667,0,1,0,1.3333333333333333,0,1.135135135135135,0,1,0,0,-1.1565509415923023,-0.3151752203835423,-0.7358630809879223,2,1,3,2,1,2,3,1,1,1.1126972805283737,2,0,1,-0.37981704324605103,4,4,4,4,2,2,3,4,6,3,2,0.9511897312113419,5,3.2857142857142856,0,-0.3023610241956905,0,-0.26884689426334335,3,3,3,3,3,3,4,4,4,3,5,4,3,3,3,5,4,5,4,3,1.0997835284835873,3,0,4.2,0,3.8,0,3.4,0,3.8,0,1,2,2,1,3,2,2,2,2,1,3,2,2,2,1,2,1,2,1,2,0.8522416262267903,1.8,0,1,2,2,1,3,2,2,2,2,1,3,2,2,2,1,2,1,2,1,2,0.8522416262267903,1.8,0,NA,NA,"White, Caucasian, Anglo, European American",0,23,1,2,NA,1,2,5,clerical supervisor,4,125,70,2,5,2,0,0,1,0,0,NA,NA,TRUE,TRUE,TRUE,TRUE,TRUE,3,0.4885437499973923,0.510999999997206,0.4635218750019558,0.5596300000006954,0.5375562499989756,0.5616718750009313,1,1,1,0.967741935483871,1,1,0.084,0.323,0.579,0.015,1.582,15.328714824289133,1797.3251630093578,0.085,0.324,0.595,0.017,1.636,23.165596473206772,1802.7941920017377,323,0.9570370370370371,0,3,0,6,9,FALSE
175,2022-03-18T17:14:09Z,2022-03-18T18:01:59Z,2869,1,2022-03-18T18:01:59Z,1,Safari,13.1.2,Macintosh,1440,900,NA,1.6,462,102,2143,55,26,50,-0.443621577313553,-0.08833529987177138,6.281253219191784,-0.532039351556705,-0.7159545879468822,-0.5441590635442882,3,4,3,2,3,1,2,4,1,3,4,4,1,2,3,4,3,1,4,4,0.8645047258706176,0,1,1,4,3,2.8,0,2,2,3,2,3,1,1,2,2,1,1,2,1,2,2,1,1,1,1,1,1,1,3,1,2,0,0,0,0,1,2,1,3,3,1,3,3,2,2,1,3,1,2,1,2,1,3,3,4,1,1,1,1,1,1,1,1,1,1,1,1,1,1,1,1,1,1,1,1,1,1.5915505122467941,1.4074631010979937,1.25,0,1,0,1.8,0,2.111111111111111,0,2,0,1,0,1,0,1,0,1.5945945945945945,0,1,0,0,-0.8756478790116133,-0.4013584353189139,-0.6385031571652636,1,1,2,1,1,2,2,1,1,1.6035674514745464,1.4285714285714286,0,1,-0.7112905515642753,5,5,5,5,3,3,5,8,8,5,4,1.5735915849388864,8,4.428571428571429,0,1.3563939699137084,0,1.361664681257715,2,2,2,2,2,4,3,3,4,3,5,4,5,3,4,3,3,5,3,5,1.0600988273786194,2,0,4.2,0,3.4,0,3.8,0,3.8,0,2,1,3,4,3,4,4,4,4,1,1,3,1,3,2,4,1,3,4,4,1.260743306232687,2.8,0,2,1,3,4,3,4,4,4,4,1,1,3,1,3,2,4,1,3,4,4,1.260743306232687,2.8,0,I lived with my mother and father an equal amount of time (joint custody),0,"Asian or Asian American (e.g., Chinese, Japanese, and others)",0,20,1,2,NA,1,4,4,student,6,115,65,3,5,2,0,0,1,0,0,I lived with my mother and father an equal amount of time (joint custody),0,TRUE,TRUE,TRUE,TRUE,TRUE,2,0.4814999999999964,0.9029687499999963,0.4890000000000019,0.5750967741935474,0.9097586206896572,0.5388387096774184,1,1,1,0.96875,0.90625,1,0.242,0.194,0.829,0.006,0.77,29.07645299348527,1823.791811092531,0.242,0.194,0.841,0.006,0.787,34.90740090876157,1819.2043028905782,416,1.2325925925925925,0,3,0,0,3,FALSE
176,2022-03-18T17:23:10Z,2022-03-18T18:02:43Z,2372,1,2022-03-18T18:02:44Z,0.8999999761581421,Chrome,99.0.4844.51,Windows NT 10.0,1366,768,no,1.7786458333333333,659,99,838,320,179,115,-0.03928481585702815,-0.10487181258929895,1.5467513195469025,2.730775008398918,2.417213981594342,0.18596261575252052,1,1,2,1,1,1,1,1,1,2,3,1,1,1,2,2,2,1,3,3,1.1821033884786185,0,1,1,3,2,1.55,0,3,3,4,3,4,3,3,3,3,2,2,4,2,4,4,3,4,1,1,3,3,3,3,2,1,0,0,1,0,2,5,2,3,4,1,2,2,4,2,2,4,1,3,3,2,4,3,3,4,3,3,1,1,1,4,1,1,1,1,1,3,3,3,1,1,3,1,1,1,1,1.2793110007486985,0.7037315505489968,2.625,0,1,0,3.1333333333333333,0,2.7777777777777777,0,2.8333333333333335,0,1.8333333333333333,0,1.8571428571428572,0,1.6666666666666667,0,2.3783783783783785,0,1,0,0,0.6504214921564254,-0.4013584353189139,0.12453152841875575,1,2,3,1,1,1,2,2,1,1.4638501094227998,1.5714285714285714,0,1.5,-0.4351695732408991,5,5,5,5,2,2,3,5,5,NA,3,1.4638501094227998,5,3.857142857142857,0,0.1414878915134009,1,0.3114090446527774,3,3,2,2,2,4,2,3,4,3,4,4,4,3,4,3,4,4,3,3,0.7745966692414834,2.4,0,4,0,3,0,3.4,0,3.466666666666667,0,1,3,2,2,2,1,4,3,1,1,4,1,1,2,2,1,1,1,1,3,1.1821033884786185,1.85,0,1,3,2,2,2,1,4,3,1,1,4,1,1,2,2,1,1,1,1,3,1.1821033884786185,1.85,0,"I lived with my extended family on mother's side (grandparents, aunts ,uncles, cousins)",0,"White, Caucasian, Anglo, European American & Native American/Alaskan Native/indigenous",1,29,1,2,NA,1,4,4,Brokerage Manager,4,200,58,2,5,2,0,0,0,0,0,"I lived with my extended family on mother's side (grandparents, aunts ,uncles, cousins)",0,TRUE,TRUE,TRUE,TRUE,TRUE,2,0.7762869565331417,0.6239451612887844,0.8362419354838709,0.7613529411834828,0.9030999999960263,1.4129130434834438,0.7419354838709677,0.96875,0.96875,0.53125,0.9375,0.71875,0.115,0.1,0.094,0.003,1.95,345.09979974202906,2411.267542992696,0.115,0.275,0.094,0.003,2.012,330.6725237872041,2340.273994623422,368,1.0903703703703704,0,3,0,0,3,FALSE
177,2022-03-18T17:42:25Z,2022-03-18T18:02:44Z,1218,1,2022-03-18T18:02:45Z,0.800000011920929,Chrome,99.0.4844.74,Windows NT 10.0,1536,864,No,1.7777777777777777,565,67,351,65,43,66,-0.23221707766877098,-0.28126128157625957,-0.22007046215965478,-0.4089142813697004,-0.36782474688674605,-0.3644368040250737,1,1,1,1,1,1,1,1,1,1,1,1,1,1,1,1,1,1,1,1,1.538967528127731,0,0,3,4,4,1,0,1,1,1,1,2,1,1,1,1,1,1,1,1,1,1,1,1,4,1,1,1,1,1,5,2,0,0,0,0,2,1,1,1,2,1,1,1,1,2,1,1,1,1,1,1,1,1,1,1,1,1,1,1,1,2,1,1,3,2,2,1,1,1,1,1,1,1,1,1,1,1.8310796959315705,2.016597794967223,1.375,0,1,0,1.0666666666666667,0,1.2222222222222223,0,1.0833333333333333,0,1.1666666666666667,0,1.5714285714285714,0,1,0,1.2162162162162162,0,3,0,0,-1.3068449067502252,0.03696306639706612,-0.6349409201765795,1,1,2,1,1,1,1,1,1,1.7320508075688772,1.1428571428571428,0,1,-0.8770273057233877,5,5,5,5,1,1,5,7,7,4,3,2.138089935299395,7,3.857142857142857,0,0.6173603799487777,0,0.6014782334563846,3,3,2,2,2,3,4,2,3,3,5,3,4,5,4,4,4,5,2,1,1.2798809468443688,2.4,0,4,0,3.4,0,3,0,3.466666666666667,0,1,2,2,1,2,3,3,2,1,1,2,1,2,2,1,2,1,2,1,3,0.9880869341680844,1.75,0,1,2,2,1,2,3,3,2,1,1,2,1,2,2,1,2,1,2,1,3,0.9880869341680844,1.75,0,"I lived with my father, but not mother, most of the time.",0,"White, Caucasian, Anglo, European American",0,30,0,1,NA,1,2,6,Umemployed,1,170,68,1,5,2,0,0,1,0,0,"I lived with my father, but not mother, most of the time.",0,TRUE,TRUE,TRUE,TRUE,TRUE,6,0.5852812499981374,0.5471593749988825,0.5870468750037253,0.6923250000048429,0.5970633333365123,0.655319354841786,1,1,1,1,1,1,0.097,0.371,0.489,0.017,1.694,26.60238211355049,1819.5953695416306,0.097,0.375,0.495,0.019,1.771,35.3913776676267,1817.1601111343036,388,1.1496296296296296,0,3,0,0,3,FALSE
178,2022-03-18T17:45:53Z,2022-03-18T18:04:20Z,1106,1,2022-03-18T18:04:21Z,0.800000011920929,Chrome,99.0.4844.74,Windows NT 10.0,1920,1080,NA,1.7777777777777777,438,57,397,66,59,50,-0.4928808782016576,-0.3363829906346848,-0.05318380516067812,-0.3966017743509999,-0.04017313177132391,-0.5441590635442882,3,3,1,2,3,1,1,3,1,3,4,3,3,1,4,3,1,1,4,3,0.6805570473787206,0,1,2,3,3,2.4,0,4,2,3,3,2,3,2,3,3,1,4,4,3,3,3,3,5,5,3,3,4,4,4,5,1,0,0,1,1,1,2,1,2,4,1,2,1,1,2,2,3,3,3,2,1,5,5,5,4,4,4,4,5,5,5,5,3,5,1,1,2,2,4,1,1,1,3,3,3,1,1.4617238578598342,0.8338093878327919,3.875,0,2.5,0,2.8666666666666667,0,1.6666666666666667,0,3.25,0,4.666666666666667,0,2.5714285714285716,0,1,0,2.7837837837837838,0,3,1,0,1.2573059644313123,1.2522221884464544,1.2547640764388834,2,1,5,1,1,1,1,1,1,1.1338934190276817,1.7142857142857142,0,1,-0.5455537974051633,5,4,5,3,1,1,4,4,2,2,2,1.7320508075688772,3,3.2857142857142856,0,-0.8778143430786174,0,-0.6196158112720472,3,3,3,3,3,4,5,4,4,2,3,3,4,3,5,5,3,5,3,3,1.1751393027860062,3,0,3.6,0,3.8,0,3.8,0,3.7333333333333334,0,2,2,1,3,3,2,2,4,4,1,1,3,3,4,1,4,1,3,3,3,1.0208355710680808,2.5,0,2,2,1,3,3,2,2,4,4,1,1,3,3,4,1,4,1,3,3,3,1.0208355710680808,2.5,0,"I lived with my mother, but not father, most of the time.",0,"White, Caucasian, Anglo, European American",0,22,0,1,NA,1,2,4,unemployed,1,135,76,1,5,2,0,0,1,0,0,"I lived with my mother, but not father, most of the time.",0,TRUE,TRUE,TRUE,TRUE,TRUE,4,0.41057499999995345,0.3671843749997206,0.3868000000003958,0.47911666666666664,0.42699032258074127,0.43744285714346914,1,1,1,0.967741935483871,0.96875,0.9032258064516129,0.046,0.318,0.667,0.024,1.479,58.18302168431724,1953.7305569657105,0.045,0.318,0.687,0.023,1.542,75.97475188344342,1960.4476899369486,304,0.9007407407407407,1,3,0,3,6,FALSE
179,2022-03-18T17:42:48Z,2022-03-18T18:04:26Z,1297,1,2022-03-18T18:04:26Z,1,Chrome,98.0.4758.102,Windows NT 10.0,1280,720,NA,1.7777777777777777,661,96,222,58,50,68,-0.03517987411635277,-0.1214083253068265,-0.6880786959176546,-0.49510183050060363,-0.22447716527374886,-0.3419715215851719,1,2,1,1,1,1,1,2,1,2,2,1,1,1,1,1,1,1,2,2,1.2814465510343749,0,1,1,2,2,1.3,0,1,1,1,2,1,1,1,1,1,1,1,1,1,1,1,1,3,4,1,1,1,1,1,1,2,0,0,0,0,1,2,2,1,1,1,1,1,1,2,2,1,1,2,3,2,4,4,1,3,3,5,5,1,1,2,1,1,2,1,1,1,1,1,1,3,1,1,1,1,1,1.675203362671621,2.007130147392398,1.625,0,1,0,1.0666666666666667,0,1.2222222222222223,0,2.3333333333333335,0,2.5,0,1.1428571428571428,0,1.6666666666666667,0,1.8108108108108107,0,1,0,0,-0.9377536367160334,-0.4013584353189139,-0.6695560360174737,1,1,2,2,1,1,3,1,1,1.618347187425374,1.5714285714285714,0,1,-0.6284221744847194,4,3,4,4,2,2,2,7,3,NA,3,0.9511897312113419,5,3,0,0.1414878915134009,1,-0.15315114604525398,1,1,1,3,2,5,3,4,4,1,5,5,3,4,5,3,5,3,1,2,1.505545305418162,1.6,0,4.6,0,2.2,0,3.8,0,3.533333333333333,0,2,1,1,1,1,2,2,4,1,1,2,2,1,2,1,1,1,1,1,1,0.9880869341680844,1.45,0,2,1,1,1,1,2,2,4,1,1,2,2,1,2,1,1,1,1,1,1,0.9880869341680844,1.45,0,"I lived with my mother, but not father, most of the time.",0,"White, Caucasian, Anglo, European American",0,30,1,2,NA,1,4,7,Teacher,4,137,63,4,5,2,0,0,1,0,0,"I lived with my mother, but not father, most of the time.",0,TRUE,TRUE,TRUE,TRUE,TRUE,5,0.5062064516082887,0.4311312500014901,0.5516937499716877,0.5651241379524099,0.4917689655402611,0.5905033332904179,1,1,1,0.90625,0.9354838709677419,0.967741935483871,0.085,0.321,0.417,0.021,1.869,112.37255032266812,1946.6300685260162,0.086,0.319,0.423,0.02,1.953,134.59837732721277,1956.9159797799427,364,1.0785185185185184,0,3,0,0,3,FALSE
180,2022-03-18T17:17:16Z,2022-03-18T18:04:28Z,2831,1,2022-03-18T18:04:29Z,0.8999999761581421,Chrome,99.0.4844.74,Windows NT 10.0,1366,768,NA,1.7786458333333333,583,73,320,105,55,1374,-0.19527260200269259,-0.24818825614120446,-0.33253755709374777,0.08358599937831816,-0.12208603555017945,14.327857911670709,2,2,1,1,2,1,1,2,1,1,2,1,1,1,2,2,1,1,2,2,1.0990426455975697,0,0,1,5,5,1.45,0,5,3,3,4,3,2,2,5,3,4,5,5,1,4,3,4,4,1,1,3,3,3,4,2,2,0,0,0,0,2,5,5,5,5,3,3,1,5,3,1,1,1,4,2,5,5,3,4,4,4,4,1,1,1,1,2,1,2,2,1,4,5,4,1,1,3,2,4,1,1,1.4311002927985332,1.3201731488169053,2.875,0,2,0,3.466666666666667,0,3.7777777777777777,0,3.0833333333333335,0,1.6666666666666667,0,2.7142857142857144,0,1.6666666666666667,0,2.8378378378378377,0,1,0,0,1.1061261802253075,-0.05662557557742737,0.52475030232394,2,2,4,3,2,2,1,8,4,0.9511897312113419,2.2857142857142856,0,6,1.7184457233512633,2,5,5,5,3,2,5,7,4,4,3,1.7043362064926932,5.5,3.857142857142857,0,0.3463286586794716,0,0.4362702135787882,1,3,2,2,2,4,5,4,4,4,5,4,5,4,4,5,5,5,5,2,1.6035674514745464,2,0,4.6,0,4.8,0,3.6,0,4.333333333333333,0,1,3,3,1,3,3,3,1,1,1,2,2,1,2,2,2,2,2,1,2,0.9787209698591858,1.9,0,1,3,3,1,3,3,3,1,1,1,2,2,1,2,2,2,2,2,1,2,0.9787209698591858,1.9,0,I lived with my mother and father an equal amount of time (joint custody),0,"Asian or Asian American (e.g., Chinese, Japanese, and others)",0,28,1,2,NA,1,4,6,medical student,1,147,64,3,5,2,0,0,1,0,0,I lived with my mother and father an equal amount of time (joint custody),0,TRUE,TRUE,TRUE,TRUE,TRUE,3,0.5695562499995577,0.5281718750003492,0.549950000000419,0.6938516129030575,0.6257354838708716,0.6190906249999535,1,1,1,1,1,1,0.14,0.37,0.759,0.012,1.099,44.397557406635606,1845.5644132954758,0.136,0.372,0.782,0.011,1.177,49.24605428300168,1833.979326703734,398,1.1792592592592592,0,3,0,0,3,FALSE
181,2022-03-18T17:42:38Z,2022-03-18T18:04:36Z,1317,1,2022-03-18T18:04:39Z,0.8999999761581421,Chrome,99.0.4844.74,Macintosh,1600,900,No,1.7777777777777777,571,61,297,44,32,63,-0.21990225244674486,-0.3143343070113147,-0.4159808855932361,-0.6674769287624102,-0.5930852322785988,-0.3981347276849264,1,2,1,1,2,1,1,3,1,3,3,1,1,1,2,2,1,1,2,3,0.9880869341680844,0,1,1,5,5,1.65,0,1,1,1,1,5,1,1,1,1,1,1,1,1,1,1,1,1,1,1,1,1,1,1,0,2,0,0,0,0,1,1,1,1,1,1,1,1,1,1,1,1,1,1,1,1,1,1,1,1,1,1,1,1,1,3,3,1,1,2,1,1,5,1,1,1,1,1,1,1,1,1.9351342963072988,2.065591117977289,1,0,1,0,1.2666666666666666,0,1,0,1,0,1.6666666666666667,0,1.7142857142857142,0,1,0,1.2432432432432432,0,0,0,0,-1.3715096972602157,-0.6205191861769039,-0.9960144417185598,1,1,1,1,1,1,1,1,1,1.9518001458970664,1,0,1,-0.9598956828029438,5,5,5,5,3,3,5,4,6,3,3,1.5735915849388864,5,4.428571428571429,0,0.041907061065850786,0,0.5604161102463684,2,3,2,3,2,5,3,3,4,2,5,1,5,3,3,3,3,5,3,3,0.9411239481143202,2.4,0,3.8,0,3.2,0,3.2,0,3.4,0,3,4,2,3,2,2,2,3,2,1,1,3,2,2,2,3,1,2,2,2,0.6488856845230502,2.2,0,3,4,2,3,2,2,2,3,2,1,1,3,2,2,2,3,1,2,2,2,0.6488856845230502,2.2,0,Prefer not to say.,0,"White, Caucasian, Anglo, European American",0,29,1,2,NA,1,1,4,admin,1,120,69,1,5,2,0,0,1,0,0,Prefer not to say.,0,TRUE,TRUE,TRUE,TRUE,TRUE,4,0.6922774193594533,0.6763218749910593,0.6842406250014901,0.7084379310443484,0.77673793102955,0.7767500000085149,0.96875,1,1,0.9354838709677419,0.90625,0.9032258064516129,0.066,0.414,0.257,0.024,1.658,61.04188564157675,1962.5476260895675,0.066,0.413,0.255,0.02,1.737,73.84365754905184,1959.161955016221,400,1.1851851851851851,0,3,0,6,9,FALSE
182,2022-03-18T17:07:47Z,2022-03-18T18:05:50Z,3483,1,2022-03-18T18:05:51Z,0.8999999761581421,Edge,99.0.1150.39,Windows NT 10.0,1366,768,None,1.7786458333333333,830,90,1770,494,150,67,0.3116877029707168,-0.15448135074188163,4.928020109178343,4.873151229652799,1.8233454291976396,-0.35320416280512285,3,3,3,2,3,3,2,4,1,3,3,1,1,2,2,3,3,2,3,3,0.6488856845230502,0,1,1,2,4,2.5,0,1,1,4,1,2,1,2,2,3,1,3,2,1,2,2,2,3,1,1,2,2,2,3,0,2,0,0,0,0,2,3,2,2,3,2,3,3,3,3,2,3,2,3,4,2,3,2,4,5,5,2,4,5,1,1,1,1,1,1,1,1,1,2,2,2,2,1,2,3,2,1.3288211940534986,1.4735767952260144,2,0,2,0,1.8666666666666667,0,2.5555555555555554,0,3.1666666666666665,0,2.3333333333333335,0,1.1428571428571428,0,2,0,2.4054054054054053,0,0,0,0,-0.16443360774039448,-0.2757863264354174,-0.22010996708790592,1,2,3,1,1,2,1,5,2,1.4638501094227998,1.5714285714285714,0,3.5,0.33784083173438173,5,4,5,5,2,2,1,5,6,5,3,1.4142135623730951,5.5,3.4285714285714284,0,0.5604063492033238,0,0.3344816754016811,3,4,4,3,4,3,5,4,3,4,5,4,4,3,3,3,3,3,3,3,0.9258200997725514,3.6,0,3.6,0,3.8,0,3.2,0,3.533333333333333,0,4,2,4,3,4,4,3,1,3,4,4,4,2,1,1,4,4,4,3,4,1.234376040972246,3.15,0,4,2,4,3,4,4,3,1,3,4,4,4,2,1,1,4,4,4,3,4,1.234376040972246,3.15,0,"I lived with my mother, but not father, most of the time. & I lived with my mother and father an equal amount of time (joint custody)",1,"Asian or Asian American (e.g., Chinese, Japanese, and others) & Black or African American",1,23,1,2,NA,1,3,6,Unemployed,6,140,66,4,5,2,0,0,1,0,0,"I lived with my mother, but not father, most of the time. & I lived with my mother and father an equal amount of time (joint custody)",1,TRUE,TRUE,TRUE,TRUE,TRUE,2,0.5221451612888806,0.44805312499823047,0.4835718749994412,0.6131437499998137,0.4849903225797799,0.5471166666636864,0.96875,1,1,1,0.96875,0.9375,0.062,0.337,0.466,0.011,1.361,73.30829537578519,1939.4925283573275,0.063,0.336,0.477,0.012,1.429,86.5801055658078,1932.7404539689476,374,1.108148148148148,0,3,0,0,3,FALSE
183,2022-03-18T17:47:41Z,2022-03-18T18:06:15Z,1114,1,2022-03-18T18:06:16Z,0.8999999761581421,Chrome,99.0.4844.51,Windows NT 10.0,1920,1080,NA,1.7777777777777777,583,59,205,45,46,83,-0.19527260200269259,-0.32535864882299975,-0.7497541995911894,-0.6551644217437097,-0.3063900690526044,-0.17348190328590837,3,3,2,1,3,1,1,3,1,3,3,1,2,1,3,3,1,1,3,3,0.5026246899500346,0,1,2,4,4,2.1,0,3,2,2,3,2,3,4,4,4,4,4,4,2,3,3,3,4,1,1,2,3,3,2,2,2,0,0,0,0,2,2,2,2,2,2,2,2,2,2,2,2,2,2,2,2,3,3,3,3,3,3,1,1,1,3,3,1,3,3,1,3,1,1,1,1,1,2,2,2,2,1.2030991012578505,0.8451542547285166,2.375,0,2,0,3.1333333333333333,0,2,0,2.4166666666666665,0,2,0,1.8571428571428572,0,1,0,2.027027027027027,0,1,0,0,0.3876285078920805,-0.05662557557742737,0.16550146615732655,2,2,2,2,1,2,1,2,3,1.2535663410560174,1.7142857142857142,0,2.5,0.03420400632629733,4,4,4,4,2,2,4,6,6,3,3,1.0690449676496976,6,3.4285714285714284,0,0.22259487524538815,0,0.12856790101706242,2,2,2,2,2,4,4,4,4,3,4,4,4,4,4,5,5,4,3,2,1.162919151265879,2,0,4.2,0,3.8,0,3.6,0,3.8666666666666667,0,1,1,1,1,1,1,1,1,1,1,2,1,1,1,1,1,1,2,1,1,1.2182817926554552,1.1,0,1,1,1,1,1,1,1,1,1,1,2,1,1,1,1,1,1,2,1,1,1.2182817926554552,1.1,0,I lived with my mother and father an equal amount of time (joint custody),0,"White, Caucasian, Anglo, European American",0,29,0,1,NA,1,4,7,Ops Manager,6,175,73,4,5,2,0,0,1,0,0,I lived with my mother and father an equal amount of time (joint custody),0,TRUE,TRUE,TRUE,TRUE,TRUE,2,0.4723843750003725,0.4509343750048429,0.47243437500484287,0.5333774193544542,0.4784031250067055,0.5119766666710377,1,1,1,1,1,0.967741935483871,0.057,0.367,0.471,0.09,1.819,90.82930041036165,1930.1183344222482,0.056,0.369,0.492,0.063,1.92,98.37933572405944,1926.5903622212172,352,1.0429629629629629,0,3,0,0,3,FALSE
184,2022-03-18T17:47:23Z,2022-03-18T18:07:25Z,1202,1,2022-03-18T18:07:26Z,1,Firefox,98.0,Windows NT 10.0,1451,907,NA,1.5997794928335172,510,132,269,50,34,91,-0.3451029755373439,0.0770298273035042,-0.5175640681143523,-0.5936018866502074,-0.552128780389171,-0.08362077352630115,2,2,1,1,2,1,1,2,1,2,2,1,1,1,2,2,1,1,2,2,1.025978352085154,0,1,1,3,4,1.5,0,5,2,2,2,2,1,3,2,1,2,3,2,1,3,3,2,3,1,1,2,2,2,3,0,1,1,0,1,0,2,1,4,2,3,2,4,4,4,1,1,1,1,4,1,2,1,1,2,1,1,4,1,1,1,1,1,1,1,1,1,1,1,1,1,1,1,1,2,1,1,1.3495633817354862,1.121223821162776,2,0,1.25,0,2.2666666666666666,0,2.888888888888889,0,1.4166666666666667,0,1.5,0,1,0,1,0,1.6756756756756757,0,0,0,0,-0.30852683956174326,-0.5343359712415323,-0.4214314054016378,2,1,2,1,1,1,1,1,1,1.4638501094227998,1.2857142857142858,0,1,-0.7941589286438315,4,4,4,4,3,3,5,1,1,4,3,1.1126972805283737,1,3.857142857142857,0,-0.4667665051284466,0,-0.05935384605400085,2,2,2,3,2,4,5,4,4,3,5,4,3,3,4,5,4,4,3,5,1.2344267996967353,2.2,0,4.2,0,3.8,0,4,0,4,0,1,1,1,2,1,1,2,2,1,1,1,2,1,1,1,2,1,1,1,1,0.8255779474818965,1.25,0,1,1,1,2,1,1,2,2,1,1,1,2,1,1,1,2,1,1,1,1,0.8255779474818965,1.25,0,I lived with my mother and father an equal amount of time (joint custody),0,"Asian or Asian American (e.g., Chinese, Japanese, and others)",0,27,1,2,NA,1,3,6,IT Support,4,130,63,3,5,2,0,0,1,0,0,I lived with my mother and father an equal amount of time (joint custody),0,TRUE,TRUE,TRUE,TRUE,TRUE,4,0.5164193548387097,0.414875,0.48046875,0.5784838709677419,0.4924,0.5650999999999999,0.96875,1,1,0.96875,0.9375,0.9375,0.067,0.378,0.681,0.009,1.23,21.437111988056373,1880.975630176607,0.066,0.378,0.71,0.009,1.264,26.255080568647656,1872.9397892506272,423,1.2533333333333332,0,3,0,0,3,FALSE
185,2022-03-18T17:46:06Z,2022-03-18T18:07:33Z,1286,1,2022-03-18T18:07:34Z,1,Firefox,98.0,Linux x86_64,1920,1080,N/A,1.7777777777777777,502,96,358,79,72,120,-0.36152274250004546,-0.1214083253068265,-0.19467466652937573,-0.2365391831078939,0.2260438055099566,0.24212582185227505,2,2,1,1,2,1,1,2,1,1,2,1,1,1,2,2,1,1,3,2,1.0760551736979407,0,1,1,5,4,1.5,0,3,3,2,3,2,1,2,2,1,1,2,2,1,3,3,2,3,1,1,1,1,1,1,0,2,0,0,0,0,2,2,2,2,5,1,1,1,3,2,2,1,4,3,3,3,2,2,1,1,1,3,1,1,1,1,1,1,1,1,1,2,4,3,1,1,1,1,1,1,1,1.4596679864375428,1.0465362369445672,1.375,0,1,0,2.066666666666667,0,2.111111111111111,0,2.0833333333333335,0,1.3333333333333333,0,1.8571428571428572,0,1,0,1.837837837837838,0,0,0,0,-0.5981896682845768,-0.6205191861769039,-0.6093544272307403,1,1,3,1,1,2,1,1,1,1.5275252316519468,1.4285714285714286,0,1,-0.7112905515642753,4,4,4,3,3,3,4,2,4,1,2,0.7559289460184544,3,3.5714285714285716,0,-1.0918920336024696,0,-0.595253971544612,1,1,1,2,2,4,5,5,5,2,5,4,4,3,4,4,4,5,4,4,1.3557637102737474,1.4,0,4.4,0,3.8,0,4.2,0,4.133333333333334,0,1,1,1,3,1,2,1,2,2,2,1,2,1,2,1,1,1,2,2,3,0.8944271909999159,1.6,0,1,1,1,3,1,2,1,2,2,2,1,2,1,2,1,1,1,2,2,3,0.8944271909999159,1.6,0,I lived with my mother and father an equal amount of time (joint custody),0,"Hispanic of Latino (e.g., Mexican American, Central American, and others)",0,24,1,2,NA,1,2,6,homemaker,2,117,64,3,5,2,0,0,1,0,0,I lived with my mother and father an equal amount of time (joint custody),0,TRUE,TRUE,TRUE,TRUE,TRUE,4,0.482625,0.4211875,0.46884375,0.5298666666666667,0.4595666666666667,0.5182413793103449,1,1,1,0.9375,0.9375,0.90625,0.058,0.324,0.416,0.017,1.675,152.76721636011453,2027.0931252200598,0.058,0.326,0.472,0.016,1.767,165.26540301790112,2024.762386339959,478,1.4162962962962962,0,3,0,0,3,FALSE
186,2022-03-18T17:42:01Z,2022-03-18T18:07:35Z,1533,1,2022-03-18T18:07:36Z,0.8999999761581421,Chrome,99.0.4844.74,Windows NT 10.0,1920,1080,NA,1.7777777777777777,633,177,286,93,94,74,-0.09264905848580808,0.3250775180664176,-0.45588856444081743,-0.0641640848460874,0.6765647762936621,-0.2745756742654665,1,1,1,1,1,1,1,2,1,1,2,1,1,1,1,1,1,1,2,2,1.3803127029389886,0,1,1,4,5,1.2,0,1,1,2,1,1,1,1,1,1,1,1,1,2,1,2,1,1,1,1,1,1,1,1,0,2,0,0,0,0,1,1,1,1,1,1,1,1,1,1,1,1,1,1,1,2,1,1,1,1,1,1,1,1,1,3,1,1,1,1,1,1,1,1,1,1,1,1,2,2,1,1.9234603452371197,1.9073791542572855,1,0,1.5,0,1.2,0,1,0,1.0833333333333333,0,1.3333333333333333,0,1,0,1,0,1.0810810810810811,0,0,0,0,-1.4715088253548128,-0.44815275630616064,-0.9598307908304867,3,2,4,2,2,2,2,3,2,0.3779644730092272,2.4285714285714284,0,2.5,0.44854589172407777,2,2,2,4,1,2,3,1,1,1,1,0.9511897312113419,1,2.2857142857142856,0,-1.7975357472230855,0,-1.7222210343407907,2,1,1,1,1,3,2,3,4,2,3,3,5,3,4,1,4,4,1,1,1.245945806357946,1.2,0,3.4,0,2.2,0,3,0,2.8666666666666667,0,1,1,1,2,1,1,1,2,1,1,1,1,1,1,1,1,1,1,1,1,1.0513149660756937,1.1,0,1,1,1,2,1,1,1,2,1,1,1,1,1,1,1,1,1,1,1,1,1.0513149660756937,1.1,0,NA,NA,"Hispanic of Latino (e.g., Mexican American, Central American, and others)",0,21,0,1,NA,1,2,4,College Student,2,170,68,3,5,2,0,0,1,0,0,NA,NA,TRUE,TRUE,TRUE,TRUE,TRUE,2,0.49159687499993016,0.4398741935483751,0.453918749999837,0.5649379310343928,0.5109966666669274,0.534932142857196,1,1,1,0.90625,0.9375,0.875,0.057,0.337,0.492,0.018,1.971,87.22163318258015,1977.3722620791282,0.057,0.337,0.514,0.02,2.066,110.11475844258422,1971.2527111708785,324,0.96,0,3,0,6,9,FALSE
187,2022-03-18T17:49:18Z,2022-03-18T18:07:56Z,1117,1,2022-03-18T18:07:57Z,0.8999999761581421,Chrome,99.0.4844.51,Windows NT 10.0,1600,900,NA,1.7777777777777777,590,60,261,56,43,54,-0.18090530591032875,-0.3198464779171572,-0.546587834548957,-0.5197268445380046,-0.36782474688674605,-0.49922849866448454,2,4,1,1,3,1,2,4,1,4,4,1,1,1,3,4,1,1,4,4,0.5501196042201808,0,0,2,3,3,2.35,0,3,2,1,1,1,1,1,1,1,1,3,2,1,2,2,3,2,1,1,2,3,2,5,1,2,0,0,0,0,1,4,2,3,5,3,3,4,5,2,2,5,1,4,1,1,1,1,3,5,5,1,1,1,1,2,1,1,2,1,1,2,2,1,1,1,1,1,3,1,1,1.5250658431116428,1.6388149028228556,2.375,0,1.5,0,1.5333333333333334,0,3.3333333333333335,0,2.5833333333333335,0,1.1666666666666667,0,1.4285714285714286,0,1,0,2.189189189189189,0,1,0,0,-0.24071247021412773,-0.22899200544817064,-0.23485223783114917,1,1,3,1,1,1,1,3,1,1.5735915849388864,1.2857142857142858,0,2,-0.40765372615619105,3,2,3,2,1,1,4,3,3,2,2,0.816496580927726,3,2.2857142857142856,0,-0.8778143430786174,0,-1.1616027004197504,1,1,1,1,1,5,5,5,5,3,5,4,5,5,5,5,5,5,2,3,1.7647338933351153,1,0,4.8,0,4,0,4.6,0,4.466666666666667,0,1,1,2,4,2,2,1,4,4,1,2,3,1,4,1,3,1,1,1,1,0.9403246919632545,2,0,1,1,2,4,2,2,1,4,4,1,2,3,1,4,1,3,1,1,1,1,0.9403246919632545,2,0,"I lived with my father, but not mother, most of the time. & I lived with my mother and father an equal amount of time (joint custody)",1,"Asian or Asian American (e.g., Chinese, Japanese, and others)",0,21,0,1,NA,1,2,4,Student,2,230,76,2,5,2,0,0,1,0,0,"I lived with my father, but not mother, most of the time. & I lived with my mother and father an equal amount of time (joint custody)",1,TRUE,TRUE,TRUE,TRUE,TRUE,2,0.5382812500093133,0.538371874999255,0.5027593750059605,0.5823419354923309,0.5931968750059604,0.5919862069035399,1,1,1,1,1,0.90625,0.063,0.368,0.444,0.019,1.871,25.080701383014418,1889.4885593272627,0.062,0.368,0.45,0.018,1.976,43.38192521104981,1898.336222620228,324,0.96,0,3,0,3,6,FALSE
188,2022-03-18T17:49:20Z,2022-03-18T18:08:37Z,1157,1,2022-03-18T18:08:39Z,1,Chrome,99.0.4844.51,Windows NT 10.0,1280,720,NA,1.7777777777777777,510,159,226,60,41,116,-0.3451029755373439,0.22585844176125222,-0.6735668127003522,-0.4704768164632027,-0.40878119877617386,0.19719525697247142,2,2,4,3,3,2,3,3,2,2,2,4,4,3,4,2,3,2,3,3,0.8013147091860318,0,1,3,4,4,2.8,0,2,1,2,1,3,2,1,2,2,1,1,1,3,1,1,2,2,1,1,2,4,3,3,0,2,0,0,0,0,1,1,1,1,1,1,1,1,1,1,1,1,1,1,2,1,2,1,1,1,3,1,1,1,1,1,1,2,1,2,1,1,2,2,1,1,1,1,2,1,2,1.850655269066858,1.5886502207249789,2.25,0,1.5,0,1.6,0,1,0,1.3333333333333333,0,1,0,1.5714285714285714,0,1,0,1.2162162162162162,0,0,0,0,-0.6913975170105449,-0.44815275630616064,-0.5697751366583528,1,1,1,1,1,2,1,2,1,1.889822365046136,1.1428571428571428,0,1.5,-0.6837747044795675,5,5,5,5,4,2,5,6,8,6,3,1.6761634196950514,7,4.428571428571429,0,1.045515760996482,0,1.1721681415988898,3,4,3,2,2,1,5,3,4,4,5,5,3,4,5,3,5,4,4,2,1.2909944487358056,2.8,0,4,0,3.8,0,3.6,0,3.8,0,3,2,3,3,4,3,3,1,3,3,2,2,1,2,1,1,3,3,3,3,0.8506963092234007,2.45,0,3,2,3,3,4,3,3,1,3,3,2,2,1,2,1,1,3,3,3,3,0.8506963092234007,2.45,0,NA,NA,"White, Caucasian, Anglo, European American",0,26,1,2,NA,1,3,4,"Artist + various ""side gigs"" [I'm disabled and can't work, for the most part]",1,190,64,1,5,2,0,1,1,0,1,NA,NA,TRUE,TRUE,TRUE,TRUE,TRUE,3,0.6573875000029802,0.5926499999966472,0.6057843750007451,0.7290031250026077,0.6581468749959022,0.7228354838759669,1,1,1,1,1,1,0.127,0.392,0.585,0.009,1.298,21.116028372752275,1815.058566645043,0.131,0.396,0.609,0.01,1.367,27.4683070693028,1811.388243238814,358,1.0607407407407408,0,3,0,0,3,FALSE
190,2022-03-18T17:50:46Z,2022-03-18T18:10:03Z,1157,1,2022-03-18T18:10:04Z,0.8999999761581421,Chrome,99.0.4844.51,Macintosh,1440,900,n/a,1.6,486,186,243,52,32,106,-0.39436227642544847,0.3746870562190003,-0.6118913090268173,-0.5689768726128064,-0.5930852322785988,0.0848688447729624,3,3,3,1,3,1,2,3,1,3,2,2,1,2,3,3,1,1,3,2,0.6708203932499369,0,1,1,5,5,2.15,0,4,1,1,1,1,2,1,2,1,1,2,3,3,2,3,1,1,1,1,1,2,1,1,0,2,0,0,0,0,2,2,1,1,1,1,1,1,1,1,1,1,1,2,1,1,1,1,1,1,2,1,1,1,1,1,1,1,1,1,1,1,1,1,1,1,1,1,1,1,1,1.8647995810481826,1.4960264830861913,1.125,0,1,0,1.8666666666666667,0,1.2222222222222223,0,1.1666666666666667,0,1,0,1,0,1,0,1.1081081081081081,0,0,0,0,-1.113736354268336,-0.6205191861769039,-0.86712777022262,1,1,1,2,1,1,1,1,1,1.889822365046136,1.1428571428571428,0,1,-0.8770273057233877,5,5,5,5,4,4,5,8,7,6,4,1.4638501094227998,7.5,4.714285714285714,0,1.480127753347792,0,1.5919402953697683,2,3,3,2,3,4,3,4,5,3,4,2,3,3,3,3,3,4,2,4,0.6324555320336759,2.6,0,3.4,0,2.8,0,3.8,0,3.3333333333333335,0,1,1,2,2,2,1,2,2,1,2,2,3,1,2,1,3,1,2,3,2,0.6958523739384593,1.8,0,1,1,2,2,2,1,2,2,1,2,2,3,1,2,1,3,1,2,3,2,0.6958523739384593,1.8,0,I lived with my mother and father an equal amount of time (joint custody),0,"White, Caucasian, Anglo, European American",0,30,0,1,NA,1,3,6,Personal Trainer,3,195,70,4,5,2,0,0,1,0,0,I lived with my mother and father an equal amount of time (joint custody),0,TRUE,TRUE,TRUE,TRUE,TRUE,4,0.6609531249998836,0.6364531249996508,0.6071375000001863,0.7704466666668653,0.6298781249996973,0.7117656249997671,1,1,1,0.9375,1,1,0.129,0.279,0.426,0.015,1.785,70.70152823096083,1863.804789072445,0.13,0.275,0.413,0.02,1.843,74.09062406541318,1857.5313221180813,325,0.9629629629629629,0,3,0,3,6,FALSE
192,2022-03-18T17:47:46Z,2022-03-18T18:12:42Z,1495,1,2022-03-18T18:12:43Z,1,Firefox,98.0,Windows NT 10.0,1366,768,NA,1.7786458333333333,799,57,273,55,32,66,0.24806110599024842,-0.3363829906346848,-0.50305218489705,-0.532039351556705,-0.5930852322785988,-0.3644368040250737,1,1,2,2,1,1,1,3,1,2,3,1,2,2,2,3,1,1,2,3,1.0399898784932577,0,0,2,3,2,1.75,0,2,2,4,2,3,3,1,2,3,2,1,2,3,2,2,1,3,1,2,2,2,2,2,6,1,1,0,0,0,1,2,5,2,3,1,3,4,3,2,2,2,1,3,3,3,3,2,1,4,3,2,3,5,1,1,1,1,5,5,5,2,3,2,2,2,2,1,4,4,4,1.3495633817354862,1.0465362369445672,1.875,0,3.25,0,2.2666666666666666,0,2.6666666666666665,0,2.4166666666666665,0,2.1666666666666665,0,3.2857142857142856,0,2,0,2.5675675675675675,0,3,0,0,0.026608033629303238,0.8126120008154107,0.41961001722235697,2,2,3,2,2,2,3,4,3,0.7867957924694432,2.2857142857142856,0,3.5,0.7521827171321622,4,4,4,3,1,1,3,3,9,NA,3,1.3451854182690985,6,2.857142857142857,0,0.41251961278270693,1,-0.06536982461732951,3,3,3,4,3,1,3,2,3,3,3,3,2,4,5,4,3,3,4,1,0.9102589898327995,3.2,0,2.6,0,3.2,0,3,0,2.933333333333333,0,1,4,4,3,4,4,4,3,3,1,2,3,3,4,1,3,1,4,2,4,1.2182817926554552,2.9,0,1,4,4,3,4,4,4,3,3,1,2,3,3,4,1,3,1,4,2,4,1.2182817926554552,2.9,0,"I lived with my mother, but not father, most of the time.",0,"Black or African American & White, Caucasian, Anglo, European American",1,25,0,1,NA,1,2,3,n/a,2,145,72,2,5,2,0,0,1,0,0,"I lived with my mother, but not father, most of the time.",0,TRUE,TRUE,TRUE,TRUE,TRUE,1,0.5108125,0.4778125,0.4888064516129032,0.5875555555555556,0.5435714285714286,0.5771785714285714,1,1,0.96875,0.84375,0.875,0.875,0.05,0.403,0.611,0.006,1.08,68.94776923707828,2078.3616821432433,0.05,0.403,0.613,0.006,1.115,104.3491035910486,2051.823637795181,282,0.8355555555555556,0,3,0,0,3,FALSE
193,2022-03-18T17:57:24Z,2022-03-18T18:12:46Z,921,1,2022-03-18T18:12:47Z,0.8999999761581421,Chrome,99.0.4844.74,Windows NT 10.0,1920,1080,NA,1.7777777777777777,569,52,152,28,20,59,-0.22400719418742024,-0.3639438451638974,-0.9420366522204451,-0.8644770410616176,-0.8388239436151654,-0.44306529256473004,1,1,2,1,2,2,3,1,1,2,2,3,2,2,1,2,3,2,2,2,0.910465468000326,0,1,1,4,3,1.85,0,5,3,4,2,5,1,5,4,5,4,2,2,2,4,3,5,4,1,1,5,5,5,5,1,2,0,0,0,0,2,3,3,2,2,3,2,2,3,4,3,3,5,3,5,3,3,4,5,3,5,2,1,1,1,1,1,1,3,1,1,1,1,1,1,1,4,1,5,3,4,1.456063226690421,1.4142135623730951,3.875,0,3.25,0,3.4,0,2.4444444444444446,0,3.8333333333333335,0,1.1666666666666667,0,1.2857142857142858,0,2,0,2.4324324324324325,0,1,0,0,1.3368328300813461,0.37429049909943074,0.8555616645903884,1,1,2,1,1,1,1,3,2,1.7320508075688772,1.1428571428571428,0,2.5,-0.29726950199192703,5,5,5,5,5,5,5,6,6,5,5,1.5118578920369088,6,5,0,1.339286426816175,0,1.6609435321319435,3,2,4,5,5,3,4,1,3,4,3,2,2,3,5,1,3,2,2,4,1.0600988273786194,3.8,0,2.6,0,2.6,0,3.2,0,2.8,0,3,2,3,3,3,1,3,4,2,2,2,2,1,2,3,2,2,2,3,2,0.7163503994113789,2.35,0,3,2,3,3,3,1,3,4,2,2,2,2,1,2,3,2,2,2,3,2,0.7163503994113789,2.35,0,I lived with my mother and father an equal amount of time (joint custody),0,"White, Caucasian, Anglo, European American",0,25,1,2,NA,1,3,5,Teacher,3,112,65,3,5,2,0,0,1,0,0,I lived with my mother and father an equal amount of time (joint custody),0,TRUE,TRUE,TRUE,TRUE,TRUE,6,0.471762499999988,0.41039354838711406,0.4614312500000051,0.5078483870967607,0.49318076923078086,0.5640107142857056,1,1,1,0.96875,0.8125,0.9032258064516129,0.062,0.342,0.46,0.011,1.469,30.586689269630234,1904.4394196452931,0.063,0.341,0.51,0.012,1.534,34.07526608873931,1890.834981548631,305,0.9037037037037037,0,3,0,6,9,FALSE
194,2022-03-18T17:33:19Z,2022-03-18T18:12:47Z,2368,1,2022-03-18T18:12:48Z,0.8999999761581421,Chrome,99.0.4844.51,Windows NT 10.0,1280,720,no,1.7777777777777777,878,114,728,162,91,244,0.41020630474692593,-0.022189249001661155,1.1476745310710887,0.7853988994442447,0.6151300984595204,1.6349733331261869,4,4,4,4,4,1,2,4,1,4,4,1,2,1,3,3,2,1,4,4,0.9445132413883326,0,1,1,3,3,2.85,0,2,2,4,2,3,3,3,4,3,3,5,3,2,3,4,2,2,1,1,2,1,1,1,5,2,0,0,0,0,3,5,5,2,3,4,3,3,4,5,3,3,2,3,3,3,4,3,3,3,3,1,1,1,1,5,2,2,3,3,1,1,1,1,1,5,1,2,2,2,3,1.3169032744413063,0.816496580927726,1.375,0,2.25,0,3.066666666666667,0,3.5555555555555554,0,3.1666666666666665,0,1.8333333333333333,0,1.7142857142857142,0,2.3333333333333335,0,2.7027027027027026,0,3,0,0,0.21676385595091896,0.46787914107392425,0.3423214985124216,1,1,2,1,1,1,1,4,3,1.7320508075688772,1.1428571428571428,0,3.5,0.08923570049571344,5,5,5,5,2,3,4,3,3,3,3,1.4638501094227998,3,4.142857142857143,0,-0.3194685672932239,0,0.18528535351022954,2,2,2,3,3,3,2,4,5,3,5,3,4,5,5,2,4,4,3,2,1.2798809468443688,2.4,0,3.8,0,2.8,0,4.2,0,3.6,0,2,3,4,2,4,4,4,2,1,1,1,3,2,1,2,3,1,2,2,4,1.142481141154959,2.4,0,2,3,4,2,4,4,4,2,1,1,1,3,2,1,2,3,1,2,2,4,1.142481141154959,2.4,0,I lived with my mother and father an equal amount of time (joint custody),0,"White, Caucasian, Anglo, European American",0,26,1,1,NA,1,2,6,graphic designer,2,170,69,2,5,2,0,0,1,0,0,I lived with my mother and father an equal amount of time (joint custody),0,TRUE,TRUE,TRUE,TRUE,TRUE,6,0.5778593750093133,0.5368599999984105,0.686024999992922,0.6544548387046784,0.5803034482762731,0.7041033333341281,1,1,1,1,0.90625,0.967741935483871,0.088,0.375,0.275,0.1,1.705,124.46983772293278,1988.1652418021265,0.089,0.375,0.274,0.029,1.839,138.09003189122086,1963.1848636072075,382,1.1318518518518519,0,3,0,0,3,FALSE
195,2022-03-18T17:29:07Z,2022-03-18T18:13:06Z,2639,1,2022-03-18T18:13:07Z,0.8999999761581421,Chrome,99.0.4844.74,Windows NT 10.0,1536,864,"i lived in a well off home with a mentally unstable parent that made my life hell. I was verbally and physically abused constantly and never felt that my home was a safe or stable place to be in. However, it was a well taken care of home and i was clothed and mostly fed, although the taking away of food was a constant punishment. Nothing in my room was actually mine and my things were gone through constantly.",1.7777777777777777,1407,57,217,35,31,74,1.4959633951555638,-0.3363829906346848,-0.7062185499392825,-0.7782894919307143,-0.6135634582233127,-0.2745756742654665,3,3,3,3,4,1,1,3,1,3,3,2,1,2,4,4,1,1,4,4,0.6863327411532597,1,1,1,5,5,2.55,0,5,2,3,3,1,1,5,5,1,2,5,5,1,3,3,3,5,1,1,5,5,5,5,1,2,0,0,0,0,3,3,2,3,3,3,1,1,3,1,2,5,1,2,1,1,5,5,5,5,5,4,1,2,1,1,1,1,1,3,1,1,1,1,2,1,5,1,5,1,3,1.6796789339993883,1.4960264830861913,3.75,0,2.5,0,3,0,2.4444444444444446,0,3.1666666666666665,0,1.6666666666666667,0,1.2857142857142858,0,2.6666666666666665,0,2.3513513513513513,0,1,0,0,1.0719729347048101,0.11574085429331589,0.593856894499063,1,1,1,1,1,1,1,1,3,1.9518001458970664,1,0,2,-0.5733904803153034,5,5,5,5,4,3,4,7,8,4,4,1.2149857925879117,7.5,4.428571428571429,0,1.0519723723000876,0,1.1761037841266073,2,2,2,2,2,4,5,5,5,5,3,5,5,5,5,5,5,5,5,5,1.9444671200491874,2,0,4.4,0,5,0,5,0,4.8,0,2,4,4,4,4,4,4,3,3,2,1,3,3,4,1,4,2,4,3,1,1.231174022502185,3,0,2,4,4,4,4,4,4,3,3,2,1,3,3,4,1,4,2,4,3,1,1.231174022502185,3,0,I lived with my mother and father an equal amount of time (joint custody),0,"White, Caucasian, Anglo, European American",0,20,1,2,NA,1,3,4,student,7,110,67,2,5,2,0,0,1,0,0,I lived with my mother and father an equal amount of time (joint custody),0,TRUE,TRUE,TRUE,TRUE,TRUE,4,0.5312193548393346,0.459996666666617,0.5026666666664183,0.6204807692301961,0.4833892857144986,0.5339137931029344,0.96875,0.9375,0.967741935483871,0.8125,0.9032258064516129,0.90625,0.049,0.389,0.372,0.049,1.636,132.33236031920396,2092.6715786391123,0.046,0.393,0.36,0.074,1.728,168.1074536878107,2102.021687220908,386,1.1437037037037037,0,3,0,0,3,FALSE
196,2022-03-18T17:59:32Z,2022-03-18T18:13:21Z,828,1,2022-03-18T18:13:21Z,0.8999999761581421,Chrome,99.0.4844.51,Macintosh,1280,800,NA,1.6,439,41,193,43,30,53,-0.4908284073313199,-0.4245777251281651,-0.7932898492430963,-0.6797894357811106,-0.6340416841680265,-0.5104611398844354,3,2,3,2,2,1,3,2,1,2,2,1,3,1,2,2,2,1,2,2,0.8750939799154206,0,1,1,5,5,1.95,0,3,1,2,1,3,3,2,4,4,2,3,3,4,2,2,3,3,2,2,2,2,3,1,5,1,2,0,0,0,2,2,2,2,2,1,1,1,1,2,2,4,2,2,3,2,2,4,2,4,4,3,1,1,1,1,1,1,4,4,4,1,1,1,1,1,1,2,2,2,2,1.518158359593888,0.9154754164341269,2.25,0,2,0,2.6,0,1.5555555555555556,0,2.75,0,1.3333333333333333,0,2.2857142857142856,0,1,0,2,0,3,0,0,0.08812324530166823,0.38169592613855263,0.23490958572011045,1,2,2,2,2,2,2,1,1,1.2535663410560174,1.8571428571428572,0,1,-0.4626854203256071,5,5,5,5,3,3,4,8,7,3,3,1.2909944487358056,7.5,4.285714285714286,0,0.49362659651469415,0,0.7583361115926901,2,2,2,2,2,4,4,4,4,4,4,2,4,4,4,5,4,4,4,2,1.1254628677422756,2,0,3.6,0,4.2,0,3.6,0,3.8,0,2,1,1,3,2,2,1,2,1,1,1,1,2,1,2,1,2,1,1,1,0.9665456669582609,1.45,0,2,1,1,3,2,2,1,2,1,1,1,1,2,1,2,1,2,1,1,1,0.9665456669582609,1.45,0,I lived with my mother and father an equal amount of time (joint custody),0,"Asian or Asian American (e.g., Chinese, Japanese, and others)",0,22,1,2,NA,1,3,8,Assistant manager,3,112,66,2,5,2,0,0,1,0,0,I lived with my mother and father an equal amount of time (joint custody),0,TRUE,TRUE,TRUE,TRUE,TRUE,3,0.4996451612903226,0.3927064516111728,0.41350312500074504,0.5792555555579839,0.4794799999988079,0.4793391304353009,1,1,1,0.84375,0.78125,0.7419354838709677,0.047,0.311,0.47,0.009,1.359,76.78831297287614,2066.0632010561135,0.047,0.311,0.481,0.01,1.404,112.19654700910354,2088.8023400271168,390,1.1555555555555557,0,3,0,3,6,FALSE
197,2022-03-18T17:00:24Z,2022-03-18T18:13:29Z,4385,1,2022-03-18T18:13:31Z,0.8999999761581421,Chrome,99.0.4844.74,Windows NT 10.0,1920,1080,No,1.7777777777777777,474,73,421,116,56,71,-0.41899192686950076,-0.24818825614120446,0.03388749414313579,0.21902357658402327,-0.10160780960546556,-0.3082735979253192,3,3,2,1,4,1,1,4,1,3,4,2,1,1,3,4,2,2,4,4,0.5026246899500346,0,0,3,3,2,2.5,0,4,3,5,2,5,3,5,4,4,4,2,4,1,5,5,4,4,3,1,3,4,4,4,4,2,0,0,0,0,4,3,2,4,2,2,2,2,4,1,2,4,2,4,3,2,4,5,5,5,5,5,4,4,2,3,3,1,3,1,1,3,4,2,1,1,3,3,3,2,1,1.322591867980916,1.4735767952260144,3.375,0,2.25,0,3.7333333333333334,0,2.7777777777777777,0,3.5,0,3.5,0,2.142857142857143,0,1.6666666666666667,0,2.918918918918919,0,2,0,0,1.47659539100096,0.24871839021593428,0.8626568906084471,4,2,4,2,1,4,4,1,1,1.1338934190276817,3,0,1,0.20026159631084173,2,3,5,3,1,3,3,3,3,2,2,1.2149857925879117,3,2.857142857142857,0,-0.8778143430786174,0,-0.8518959066210627,1,2,1,2,1,5,3,5,5,3,5,4,5,3,4,2,4,3,3,2,1.2909944487358056,1.4,0,4.2,0,3.2,0,3.8,0,3.7333333333333334,0,3,2,3,4,4,3,4,3,3,1,4,4,2,1,2,3,2,2,2,3,0.9880869341680844,2.75,0,3,2,3,4,4,3,4,3,3,1,4,4,2,1,2,3,2,2,2,3,0.9880869341680844,2.75,0,I lived with my mother and father an equal amount of time (joint custody),0,"Hispanic of Latino (e.g., Mexican American, Central American, and others) & White, Caucasian, Anglo, European American",1,30,1,2,NA,1,2,2,none,1,126,67,1,5,2,1,0,1,0,1,I lived with my mother and father an equal amount of time (joint custody),0,TRUE,TRUE,TRUE,TRUE,TRUE,6,0.5806354838667377,0.5534968749973923,0.5037874999959022,0.5778124999888241,0.5602741935387734,0.5568781249970197,1,1,1,1,1,1,0.191,0.224,0.695,0.017,1.169,91.52125657146442,1896.7878290303854,0.19,0.219,0.688,0.014,1.248,102.13252583673223,1884.2814681229586,304,0.9007407407407407,1,3,0,3,6,FALSE
198,2022-03-18T17:38:20Z,2022-03-18T18:13:31Z,2110,1,2022-03-18T18:13:32Z,0.8999999761581421,Chrome,99.0.4844.74,Windows NT 10.0,1920,1080,None,1.7777777777777777,524,119,513,116,72,98,-0.31636838335261624,0.005371605527551444,0.36766080814108915,0.21902357658402327,0.2260438055099566,-0.004992284986644828,3,2,3,2,3,1,2,4,1,3,3,1,2,2,4,4,1,1,4,3,0.6708203932499369,0,1,1,3,1,2.45,0,3,1,1,3,4,3,3,2,2,3,1,3,2,3,5,2,3,5,1,2,2,2,2,2,1,0,0,1,1,3,3,1,1,2,1,2,2,1,2,2,1,1,2,2,4,3,1,1,1,4,4,2,1,2,4,3,2,2,1,1,1,1,1,1,2,1,1,2,1,1,1.4632638658632766,1.121223821162776,2.375,0,1.25,0,2.6,0,1.7777777777777777,0,2,0,2.6666666666666665,0,1.2857142857142858,0,1.3333333333333333,0,1.864864864864865,0,1,1,0,0.08369415006125834,0.3829846120536163,0.23333938105743732,1,2,3,1,1,2,2,1,1,1.3801311186847085,1.7142857142857142,0,1,-0.5455537974051633,5,4,4,4,2,2,3,3,3,2,2,1.1338934190276817,3,3.4285714285714284,0,-0.8778143430786174,0,-0.5421891128223754,3,3,3,2,2,4,4,4,4,3,4,4,4,3,3,4,3,4,3,3,0.7237468644557459,2.6,0,3.8,0,3.6,0,3.4,0,3.6,0,2,2,3,3,4,3,3,3,2,1,2,3,1,2,1,3,2,3,2,3,0.7677718959499145,2.4,0,2,2,3,3,4,3,3,3,2,1,2,3,1,2,1,3,2,3,2,3,0.7677718959499145,2.4,0,"I lived with my mother, but not father, most of the time.",0,"White, Caucasian, Anglo, European American",0,27,1,2,NA,1,2,6,unemployed,1,120,62,1,5,2,0,0,1,0,0,"I lived with my mother, but not father, most of the time.",0,TRUE,TRUE,TRUE,TRUE,TRUE,5,0.6310100000063579,0.5084483871075415,0.5679718750007451,0.6625312500037253,0.5503281250111759,0.6201312499940396,0.967741935483871,1,1,1,1,1,0.102,0.401,0.641,0.034,1.899,15.381160303680765,1805.860373281084,0.103,0.402,0.654,0.033,2.004,22.589466232469707,1804.387852473959,342,1.0133333333333332,0,0,0,0,3,FALSE
199,2022-03-18T17:57:01Z,2022-03-18T18:13:55Z,1014,1,2022-03-18T18:13:56Z,0.8999999761581421,Chrome,99.0.4844.74,Windows NT 10.0,1366,768,no,1.7786458333333333,474,55,276,55,31,79,-0.41899192686950076,-0.3474073324463698,-0.49216827248407324,-0.532039351556705,-0.6135634582233127,-0.218412468165712,3,3,2,2,3,1,1,3,1,3,3,1,1,1,3,3,1,1,4,4,0.512989176042577,0,0,1,3,2,2.2,0,3,2,4,2,2,1,5,1,1,1,1,5,1,4,1,2,1,5,1,1,3,1,3,4,2,0,0,0,0,1,2,4,1,1,1,1,1,1,2,5,4,1,4,2,2,1,3,5,4,2,5,1,1,2,1,1,1,1,2,1,1,1,1,1,2,2,2,2,1,1,1.65763317647414,1.4573295865416045,2.125,0,1.5,0,2.2666666666666666,0,1.4444444444444444,0,2.9166666666666665,0,1.8333333333333333,0,1.1428571428571428,0,1.6666666666666667,0,1.945945945945946,0,2,0,0,-0.13579212518574113,-0.009831254590180624,-0.07281168988796088,3,3,3,2,1,2,1,1,1,0.8997354108424374,2.142857142857143,0,1,-0.29694866616649496,2,5,5,5,1,1,2,3,3,3,2,1.889822365046136,3,3,0,-0.6637366525547652,0,-0.6439776509994821,2,2,2,2,2,4,2,4,4,2,4,4,4,5,4,4,4,4,3,4,1.0465362369445672,2,0,4,0,3,0,4.2,0,3.7333333333333334,0,2,2,1,2,3,1,1,2,1,1,2,2,2,1,1,2,1,1,1,1,0.8645047258706176,1.5,0,2,2,1,2,3,1,1,2,1,1,2,2,2,1,1,2,1,1,1,1,0.8645047258706176,1.5,0,"I lived with my mother, but not father, most of the time.",0,"White, Caucasian, Anglo, European American",0,27,1,2,NA,1,2,5,GIS Tech,1,145,66,4,5,2,0,0,2,0,0,"I lived with my mother, but not father, most of the time.",0,TRUE,TRUE,TRUE,TRUE,TRUE,5,0.5177064516044432,0.4761562500037253,0.50196875,0.5942799999992053,0.5667906249761582,0.5707566666642825,1,1,1,0.9375,1,0.9375,0.059,0.359,0.356,0.021,1.482,172.17940769620836,2085.753724760913,0.058,0.362,0.381,0.021,1.601,220.94356518198646,2089.769049519468,412,1.2207407407407407,0,0,0,0,3,FALSE
200,2022-03-18T17:57:14Z,2022-03-18T18:14:31Z,1036,1,2022-03-18T18:14:32Z,1,Chrome,98.0.4758.109,Macintosh,1440,900,NA,1.6,452,53,263,126,35,60,-0.4641462860169299,-0.35843167425805483,-0.5393318929403058,0.3421486467710279,-0.5316505544444572,-0.43183265134477916,2,2,2,2,2,1,2,2,1,2,3,1,2,2,2,2,1,1,2,2,0.8335087534664907,0,0,2,4,3,1.8,0,2,3,4,2,3,3,3,3,4,3,3,3,2,4,3,2,4,1,1,2,3,3,3,7,2,0,0,0,0,3,4,4,2,3,2,4,3,3,2,2,4,1,3,4,4,4,3,4,4,4,3,1,1,1,1,2,1,4,3,3,3,4,3,1,2,2,3,2,3,3,1.1021409686218524,0.6399404734221844,2.375,0,2.75,0,3,0,3.111111111111111,0,3.25,0,1.5,0,3,0,1.6666666666666667,0,2.7567567567567566,0,4,0,0,0.6482561567055577,0.8594063218026575,0.7538312392541076,1,1,3,1,1,2,1,4,1,1.5275252316519468,1.4285714285714286,0,2.5,-0.13153274783281477,4,3,5,4,2,1,3,6,3,4,3,1.3451854182690985,4.5,3.142857142857143,0,0.16564084449993424,0,-0.06100195858796892,2,2,2,3,2,4,4,4,4,3,4,4,3,3,5,2,3,4,3,4,0.9611501047232549,2.2,0,3.8,0,3,0,4,0,3.6,0,2,3,4,3,4,4,4,3,2,3,3,3,2,4,2,2,2,2,4,4,0.9119095061289915,3,0,2,3,4,3,4,4,4,3,2,3,3,3,2,4,2,2,2,2,4,4,0.9119095061289915,3,0,I lived with my mother and father an equal amount of time (joint custody),0,"White, Caucasian, Anglo, European American",0,24,1,2,NA,1,2,6,unemployed,1,170,67,2,5,2,0,0,1,0,0,I lived with my mother and father an equal amount of time (joint custody),0,TRUE,TRUE,TRUE,TRUE,TRUE,3,0.48695806451382173,0.4061906249914318,0.4454187500011176,0.5676571428711925,0.509751851843463,0.5541434782665708,0.96875,1,1,0.875,0.84375,0.71875,0.052,0.35,0.498,0.013,1.959,109.16805493260254,2061.906743572505,0.053,0.349,0.538,0.013,1.947,126.64510405309835,2057.625578167522,412,1.2207407407407407,0,3,0,3,6,FALSE
201,2022-03-18T17:52:05Z,2022-03-18T18:15:31Z,1405,1,2022-03-18T18:15:31Z,0.8999999761581421,Chrome,99.0.4844.51,Macintosh,1440,900,no,1.6,546,400,222,52,35,60,-0.2712140242051871,1.5542916300692995,-0.6880786959176546,-0.5689768726128064,-0.5316505544444572,-0.43183265134477916,2,2,2,2,2,1,1,2,2,2,2,2,2,2,2,2,2,2,2,2,0.6805570473787206,0,1,2,4,4,1.9,0,2,2,3,2,3,2,3,2,2,2,2,2,3,3,3,1,1,1,1,1,1,1,1,1,2,0,0,0,0,2,2,2,2,2,1,1,1,1,2,2,2,1,2,2,1,2,2,2,2,2,2,1,1,1,1,1,2,2,2,1,2,2,2,1,1,1,2,2,2,2,1.4596679864375428,0.7988086367179802,1,0,2,0,2.4,0,1.5555555555555556,0,1.8333333333333333,0,1.1666666666666667,0,1.8571428571428572,0,1,0,1.5945945945945945,0,1,0,0,-0.7226964567094445,-0.05662557557742737,-0.38966101614343596,1,2,2,2,2,1,1,1,1,1.5118578920369088,1.5714285714285714,0,1,-0.6284221744847194,4,4,4,4,4,3,4,4,4,6,4,0.7867957924694432,4,3.857142857142857,0,0.847720403719411,0,0.7418947249573457,2,3,3,3,3,3,3,3,3,3,4,3,4,3,3,4,3,4,3,3,0.45773770821706344,2.8,0,3.4,0,3.4,0,3,0,3.2666666666666666,0,1,1,1,2,2,1,1,2,1,1,1,2,1,1,1,2,1,1,1,1,0.8255779474818965,1.25,0,1,1,1,2,2,1,1,2,1,1,1,2,1,1,1,2,1,1,1,1,0.8255779474818965,1.25,0,I lived with my mother and father an equal amount of time (joint custody),0,"White, Caucasian, Anglo, European American",0,25,1,2,NA,1,4,6,Marketing Project Manager,4,110,64,5,5,2,0,0,1,0,0,I lived with my mother and father an equal amount of time (joint custody),0,TRUE,TRUE,TRUE,TRUE,TRUE,6,0.5807129032265755,0.4897937500048429,0.648390625005588,0.612983870967742,0.5688193548379405,0.7722633333305517,0.96875,1,1,0.96875,1,0.9375,0.071,0.409,0.293,0.024,1.979,86.76738217412745,1961.5587828973548,0.07,0.41,0.289,0.024,2.072,102.14937985814046,1945.9947891596357,424,1.2562962962962962,0,3,0,3,6,FALSE
202,2022-03-18T17:55:05Z,2022-03-18T18:15:38Z,1232,1,2022-03-18T18:15:39Z,0.8999999761581421,Chrome,99.0.4844.51,Macintosh,1440,900,NA,1.6,546,70,267,78,106,120,-0.2712140242051871,-0.26472476885873203,-0.5248200097230035,-0.24885169012659436,0.9223034876302287,0.24212582185227505,1,1,1,2,2,1,1,2,1,1,2,1,1,1,1,1,1,1,2,2,1.3018205875255096,0,1,2,2,1,1.3,0,2,1,2,1,2,1,1,1,1,1,1,1,1,1,1,1,1,1,1,1,1,1,1,0,2,0,0,0,0,1,1,1,1,1,1,1,1,1,1,1,2,1,1,1,1,1,1,1,1,3,1,1,1,1,1,1,1,1,1,1,1,1,1,1,1,1,2,1,1,1,1.935910056729844,1.9073791542572855,1,0,1.25,0,1.2,0,1,0,1.25,0,1,0,1,0,1,0,1.0810810810810811,0,0,0,0,-1.4715088253548128,-0.5343359712415323,-1.0029223982981725,1,1,3,1,1,1,1,2,1,1.5735915849388864,1.2857142857142858,0,1.5,-0.6009063274000113,5,5,5,5,3,2,5,3,3,6,3,1.7043362064926932,3,4.285714285714286,0,0.3227645042783325,0,0.6541867234756273,1,2,2,2,2,4,3,3,4,4,4,2,5,4,4,4,4,2,4,2,1.0690449676496976,1.8,0,3.2,0,4,0,3.4,0,3.533333333333333,0,1,1,1,1,2,1,1,1,1,1,2,1,1,1,1,1,1,1,1,1,1.2182817926554552,1.1,0,1,1,1,1,2,1,1,1,1,1,2,1,1,1,1,1,1,1,1,1,1.2182817926554552,1.1,0,I lived with my mother and father an equal amount of time (joint custody),0,"White, Caucasian, Anglo, European American",0,20,0,1,NA,1,4,3,Student/ Part-time employee at Walmart,6,165,70,4,5,2,0,0,1,0,0,I lived with my mother and father an equal amount of time (joint custody),0,TRUE,TRUE,TRUE,TRUE,TRUE,3,0.5488937500016764,0.567890625005588,0.5285906249983237,0.705625806448921,0.7097656249990687,0.644628125003539,1,1,1,0.96875,1,1,0.102,0.3,0.467,0.017,1.897,28.13710637747794,1827.1585642971631,0.102,0.304,0.47,0.017,2.01,35.55460344680299,1820.278200123844,436,1.2918518518518518,0,3,0,0,3,FALSE
203,2022-03-18T17:52:39Z,2022-03-18T18:16:23Z,1423,1,2022-03-18T18:16:23Z,1,Firefox,98.0,Windows NT 10.0,1920,1080,Everything was easy to understand and answer thank you!,1.7777777777777777,531,133,331,139,62,61,-0.30200108726025243,0.08254199820934673,-0.2926298782461664,0.5022112380141339,0.021261546062817747,-0.4206000101248282,1,2,1,1,2,1,2,2,1,2,2,1,1,1,2,2,1,1,2,3,1.050062654772261,0,1,1,3,3,1.55,0,3,1,2,2,1,2,1,3,2,1,2,2,1,2,2,2,2,1,1,1,1,2,2,0,2,0,0,0,0,1,1,2,1,1,1,1,1,1,1,1,2,1,1,2,1,1,2,1,3,3,1,1,1,1,1,1,1,1,1,1,1,1,1,1,1,1,1,1,1,1,1.8567303109087887,1.4074631010979937,1.5,0,1,0,1.8,0,1.1111111111111112,0,1.5833333333333333,0,1,0,1,0,1,0,1.2162162162162162,0,0,0,0,-0.9317497520568107,-0.6205191861769039,-0.7761344691168572,1,1,3,1,1,1,1,1,1,1.5735915849388864,1.2857142857142858,0,1,-0.7941589286438315,5,5,5,5,3,3,5,5,9,3,3,1.5735915849388864,7,4.428571428571429,0,0.4032826894249255,0,0.7806934700831635,2,3,3,1,2,4,5,5,4,3,5,3,5,3,3,5,4,4,5,4,1.3557637102737474,2.2,0,4,0,4.6,0,3.8,0,4.133333333333334,0,2,1,2,4,1,2,1,4,4,2,1,3,1,4,1,3,1,4,4,1,1.1652874052533586,2.3,0,2,1,2,4,1,2,1,4,4,2,1,3,1,4,1,3,1,4,4,1,1.1652874052533586,2.3,0,I lived with my mother and father an equal amount of time (joint custody),0,"Hispanic of Latino (e.g., Mexican American, Central American, and others) & White, Caucasian, Anglo, European American",1,25,0,1,NA,1,3,3,Freelancer,4,185,67,4,5,2,0,0,1,0,0,I lived with my mother and father an equal amount of time (joint custody),0,TRUE,TRUE,TRUE,TRUE,TRUE,1,0.64540625,0.5456875,0.5535,0.6669677419354839,0.6049,0.6010322580645161,1,1,1,1,0.967741935483871,1,0.081,0.417,0.67,0.022,1.551,38.93958359740767,1834.8517435747356,0.081,0.417,0.66,0.023,1.63,51.60105627531341,1833.2692427163083,398,1.1792592592592592,0,3,0,0,3,FALSE
205,2022-03-18T18:01:15Z,2022-03-18T18:16:39Z,924,1,2022-03-18T18:16:40Z,0.8999999761581421,Chrome,99.0.4844.74,Macintosh,1440,900,nope,1.6,465,65,173,66,40,66,-0.43746416470253996,-0.2922856233879446,-0.8658492653296079,-0.3966017743509999,-0.42925942472088774,-0.3644368040250737,3,3,4,3,3,1,2,3,1,3,3,2,3,2,3,3,1,1,3,3,0.7254762501100116,0,1,1,3,3,2.5,0,1,1,1,1,1,1,1,1,1,1,1,1,1,1,1,1,1,1,1,1,1,1,1,0,2,0,0,0,0,1,1,1,1,1,1,1,1,1,1,1,1,1,1,1,1,1,1,1,1,1,1,1,1,1,1,1,1,1,1,1,1,1,1,1,1,1,1,1,1,1,1.9666895707934864,2.065591117977289,1,0,1,0,1,0,1,0,1,0,1,0,1,0,1,0,1,0,0,0,0,-1.5943424000221917,-0.6205191861769039,-1.1074307930995477,1,1,1,1,1,1,1,1,1,1.9518001458970664,1,0,1,-0.9598956828029438,5,5,5,5,3,3,5,6,6,6,4,1.5735915849388864,6,4.428571428571429,0,1.2090960320784858,0,1.2718788785928283,2,2,3,3,2,4,4,4,4,4,5,4,3,5,4,5,4,5,4,3,1.3345232785352157,2.4,0,4.4,0,4,0,4,0,4.133333333333334,0,1,1,1,1,2,1,1,2,1,1,1,1,2,1,1,1,1,1,1,1,1.1367080817685316,1.15,0,1,1,1,1,2,1,1,2,1,1,1,1,2,1,1,1,1,1,1,1,1.1367080817685316,1.15,0,I lived with my mother and father an equal amount of time (joint custody),0,"White, Caucasian, Anglo, European American",0,19,1,2,NA,1,4,4,Student,6,115,67,2,5,2,0,0,1,0,0,I lived with my mother and father an equal amount of time (joint custody),0,TRUE,TRUE,TRUE,TRUE,TRUE,6,0.531528124999255,0.4479580645164655,0.5222000000000961,0.6125785714276135,0.5228193548386616,0.5684032258062113,1,0.96875,1,0.875,0.96875,0.96875,0.075,0.368,0.458,0.061,1.951,84.99397107224505,1944.5568463340537,0.064,0.375,0.425,0.051,2.071,101.1013332884216,1929.3802498192026,438,1.2977777777777777,0,3,0,0,3,FALSE
206,2022-03-18T18:00:38Z,2022-03-18T18:16:45Z,966,1,2022-03-18T18:16:46Z,0.8999999761581421,Chrome,99.0.4844.74,Windows NT 10.0,1920,1080,NA,1.7777777777777777,492,72,221,47,25,57,-0.3820474512034223,-0.253700427047047,-0.6917066667219801,-0.6305394077063088,-0.736432813891596,-0.46553057500463185,1,1,1,1,1,1,1,3,1,1,2,1,1,1,1,1,1,1,1,2,1.4179302929937965,0,1,1,2,1,1.2,0,5,2,3,4,3,3,3,4,2,1,4,3,1,3,5,4,5,1,1,4,4,4,5,0,2,0,0,0,0,3,2,3,1,1,1,1,1,1,1,1,3,1,2,2,1,5,5,4,4,5,5,1,1,1,5,4,2,1,1,1,2,2,2,1,3,1,2,1,1,1,1.6796789339993883,1.1254628677422756,3.5,0,1.25,0,3.066666666666667,0,1.5555555555555556,0,2.8333333333333335,0,2.8333333333333335,0,1.5714285714285714,0,1.6666666666666667,0,2.189189189189189,0,0,0,0,0.9209899991761566,-0.5343359712415323,0.19332701396731217,1,1,3,1,1,1,1,2,1,1.5735915849388864,1.2857142857142858,0,1.5,-0.6009063274000113,2,2,5,2,1,1,1,4,2,1,1,1.7182493859684491,3,2,0,-1.4361601188640107,0,-1.6567970714033393,2,2,2,3,2,4,3,3,5,3,5,4,2,5,5,4,3,3,3,2,1.2227992865708155,2.2,0,3.8,0,3,0,4,0,3.6,0,1,1,1,1,1,1,1,1,1,1,3,1,1,2,1,1,1,1,1,1,1.2513150976809202,1.15,0,1,1,1,1,1,1,1,1,1,1,3,1,1,2,1,1,1,1,1,1,1.2513150976809202,1.15,0,I lived with my mother and father an equal amount of time (joint custody),0,"Hispanic of Latino (e.g., Mexican American, Central American, and others)",0,26,0,1,NA,1,3,6,Manager,4,175,72,3,5,2,0,0,1,0,0,I lived with my mother and father an equal amount of time (joint custody),0,TRUE,TRUE,TRUE,TRUE,TRUE,5,0.51721875,0.4770343750044703,0.5274218750037253,0.5932419354896392,0.5188699999948343,0.6053031250014901,1,1,1,0.96875,0.967741935483871,1,0.163,0.244,0.607,0.022,1.981,13.990196088459648,1797.870772947189,0.164,0.253,0.624,0.025,2.037,17.212180306901093,1799.8020668544045,298,0.882962962962963,0,3,0,0,3,FALSE
207,2022-03-18T17:59:12Z,2022-03-18T18:18:07Z,1135,1,2022-03-18T18:18:08Z,0.8999999761581421,Chrome,99.0.4844.74,Windows NT 10.0,1536,864,no feedback,1.7777777777777777,473,103,300,64,46,70,-0.4210443977398384,-0.08282312896592887,-0.40509697318025933,-0.4212267883884009,-0.3063900690526044,-0.3195062391452701,3,4,3,3,4,2,2,4,1,4,3,2,1,2,4,4,2,1,3,3,0.6708203932499369,0,0,1,3,2,2.75,0,4,2,3,3,2,1,2,3,3,1,3,3,1,3,4,1,3,1,1,2,5,4,3,0,2,0,0,0,0,2,2,3,3,3,1,1,2,4,3,3,4,2,3,3,3,4,4,4,4,4,3,1,1,1,1,1,1,1,3,1,3,4,3,1,1,3,1,2,1,2,1.272249432547965,0.990430401872025,2.5,0,1.5,0,2.533333333333333,0,2.3333333333333335,0,3.4166666666666665,0,1.3333333333333333,0,2.2857142857142856,0,1.6666666666666667,0,2.4594594594594597,0,0,0,0,0.3690263078823572,-0.44815275630616064,-0.039563224211901726,2,2,3,1,1,2,2,1,1,1.0690449676496976,1.8571428571428572,0,1,-0.4626854203256071,5,3,5,5,3,3,3,5,5,NA,3,1.0690449676496976,5,3.857142857142857,0,0.1414878915134009,1,0.3114090446527774,2,2,2,3,2,3,5,4,4,3,2,3,3,5,5,5,3,3,5,5,1.3732131246511903,2.2,0,2.8,0,4.2,0,4.6,0,3.8666666666666667,0,1,1,4,3,4,4,4,4,4,3,4,4,2,4,2,3,1,4,3,4,1.292692009559488,3.15,0,1,1,4,3,4,4,4,4,4,3,4,4,2,4,2,3,1,4,3,4,1.292692009559488,3.15,0,I lived with my mother and father an equal amount of time (joint custody),0,"White, Caucasian, Anglo, European American",0,27,1,2,NA,1,2,4,food delivery,1,125,65,2,5,2,0,0,1,0,0,I lived with my mother and father an equal amount of time (joint custody),0,TRUE,TRUE,TRUE,TRUE,TRUE,2,0.6234468750022352,0.4529843750018626,0.48370000000111757,0.6954064516155951,0.5379812500048429,0.5568437500037253,1,1,1,0.96875,1,1,0.069,0.376,0.642,0.014,1.323,70.56440190809819,1867.4172691311132,0.073,0.375,0.684,0.015,1.366,96.6029050363674,1878.5349707307278,384,1.1377777777777778,0,3,0,0,3,FALSE
208,2022-03-18T17:56:55Z,2022-03-18T18:18:17Z,1282,1,2022-03-18T18:18:18Z,1,Safari,13.1.2,Macintosh,1440,900,NA,1.6,603,102,314,60,39,76,-0.15422318459593878,-0.08833529987177138,-0.35430538191970123,-0.4704768164632027,-0.4497376506656016,-0.2521103918255647,3,3,1,1,3,1,1,3,1,2,4,1,1,1,2,2,1,1,3,3,0.7539370349250519,0,1,2,2,1,1.9,0,4,3,4,4,3,4,4,3,3,3,4,4,2,4,4,2,3,1,1,2,3,4,3,6,2,0,0,0,0,2,2,3,4,3,2,3,3,4,1,2,3,1,3,3,4,2,3,4,3,3,4,1,1,1,2,1,1,3,1,1,4,3,3,2,2,2,2,2,3,1,1.0097125925329047,0.7988086367179802,2.375,0,2,0,3.533333333333333,0,2.888888888888889,0,2.6666666666666665,0,1.6666666666666667,0,2.2857142857142856,0,2,0,2.4324324324324325,0,3,0,0,0.7395939429966857,0.38169592613855263,0.5606449345676192,3,2,3,2,1,2,1,1,1,0.816496580927726,2,0,1,-0.37981704324605103,4,3,3,4,2,3,4,7,2,3,3,0.816496580927726,4.5,3.2857142857142856,0,-0.0484368460239179,0,-0.11406681731020579,2,3,2,3,3,4,4,4,4,3,5,4,3,3,3,1,4,5,2,3,1.1464230084422218,2.6,0,4.4,0,2.6,0,3.4,0,3.466666666666667,0,1,2,2,3,2,2,2,2,1,1,2,3,2,3,1,3,2,2,2,2,0.5525062514530825,2,0,1,2,2,3,2,2,2,2,1,1,2,3,2,3,1,3,2,2,2,2,0.5525062514530825,2,0,I lived with my mother and father an equal amount of time (joint custody),0,"White, Caucasian, Anglo, European American",0,22,1,2,NA,1,3,6,N/A,2,118,66,1,5,2,0,0,0,0,0,I lived with my mother and father an equal amount of time (joint custody),0,TRUE,TRUE,TRUE,TRUE,TRUE,2,0.5145161290322562,0.4465937500000109,0.4933225806451622,0.6332666666666686,0.5612999999999922,0.5892000000000029,0.96875,1,0.96875,0.9375,0.9375,0.9375,0.074,0.337,0.545,0.013,1.816,280.5121132505293,2190.2057312189254,0.077,0.341,0.587,0.013,1.856,285.58672372758116,2175.689567172471,432,1.28,0,3,0,0,3,FALSE
210,2022-03-18T18:04:39Z,2022-03-18T18:19:27Z,887,1,2022-03-18T18:19:28Z,0.8999999761581421,Chrome,99.0.4844.74,Macintosh,1440,900,N/A,1.6,510,47,180,23,31,59,-0.3451029755373439,-0.39150469969310997,-0.8404534696993289,-0.9260395761551199,-0.6135634582233127,-0.44306529256473004,3,3,1,2,3,1,1,3,1,3,3,1,2,1,3,3,1,1,4,3,0.5104177855340404,0,0,2,3,3,2.15,0,5,5,4,5,3,5,5,5,3,5,5,5,1,5,5,5,5,5,5,5,5,5,5,5,2,0,0,0,0,3,4,4,4,4,4,4,4,4,4,3,3,3,5,1,4,1,5,5,5,5,5,5,5,5,5,3,5,5,5,3,3,3,3,4,4,5,3,3,3,3,1.4268973460049732,1.8073922282301278,5,0,3,0,4.4,0,3.888888888888889,0,3.6666666666666665,0,4.666666666666667,0,3.857142857142857,0,4.333333333333333,0,3.972972972972973,0,3,0,0,2.9386889420297386,0.7264287858800391,1.8325588639548889,3,3,4,3,2,3,3,4,1,0.4879500364742666,3,0,2.5,0.7800194000423024,3,2,2,2,1,1,2,2,6,2,3,1.0690449676496976,4,1.8571428571428572,0,-0.3528584436375387,0,-1.073894698938032,2,2,2,2,2,4,2,4,4,2,4,2,4,2,2,4,2,4,2,4,0,2,0,3.2,0,2.8,0,3.2,0,3.066666666666667,0,1,1,1,3,1,1,1,2,1,1,1,4,1,1,2,2,1,2,2,2,0.6863327411532597,1.55,0,1,1,1,3,1,1,1,2,1,1,1,4,1,1,2,2,1,2,2,2,0.6863327411532597,1.55,0,I lived with my mother and father an equal amount of time (joint custody),0,"Hispanic of Latino (e.g., Mexican American, Central American, and others)",0,22,1,2,NA,1,3,4,Technical Support Advisor,2,132,62,1,5,2,0,0,0,0,0,I lived with my mother and father an equal amount of time (joint custody),0,TRUE,TRUE,TRUE,TRUE,TRUE,1,0.48540625,0.4638281250001164,0.5045281249997207,0.591090322580489,0.5314225806452695,0.604174193548279,1,1,1,0.96875,1,0.96875,0.079,0.392,0.687,0.017,1.804,35.787896583083004,1864.8194605003218,0.081,0.391,0.752,0.017,1.867,40.07426729645231,1870.9366438375393,424,1.2562962962962962,0,3,0,3,6,FALSE
212,2022-03-18T17:40:38Z,2022-03-18T18:19:41Z,2342,1,2022-03-18T18:19:42Z,0.800000011920929,Chrome,99.0.4844.74,Windows NT 10.0,1280,1024,Great!,1.25,751,184,629,328,48,152,0.1495425042140393,0.36366271440731524,0.7885054214428564,2.8292750645485216,-0.26543361716317665,0.6015703408907039,1,1,1,1,1,1,1,2,1,1,1,1,1,1,1,1,1,1,1,1,1.5035046776746235,0,1,1,5,5,1.05,0,1,1,1,2,1,1,1,1,1,1,1,1,1,1,2,1,1,1,1,1,1,1,1,0,2,0,0,0,0,2,2,1,1,1,1,1,1,1,1,1,1,1,1,1,1,1,1,1,1,1,1,1,1,1,1,1,1,1,1,1,1,1,1,1,1,1,1,1,1,1,1.9089641547562237,1.9444671200491874,1,0,1,0,1.1333333333333333,0,1.2222222222222223,0,1,0,1,0,1,0,1,0,1.054054054054054,0,0,0,0,-1.5124533502439392,-0.6205191861769039,-1.0664862682104217,1,1,3,1,1,1,1,1,1,1.5735915849388864,1.2857142857142858,0,1,-0.7941589286438315,5,5,5,5,3,3,5,6,6,5,3,1.5735915849388864,6,4.428571428571429,0,0.6507502562930925,0,0.9315379045085834,1,1,1,1,1,5,4,5,5,5,5,4,4,4,5,4,5,5,4,4,1.65615734242165,1,0,4.8,0,4.2,0,4.6,0,4.533333333333333,0,1,1,1,1,1,1,1,1,1,1,1,1,1,1,1,1,1,1,1,1,1.231174022502185,1,0,1,1,1,1,1,1,1,1,1,1,1,1,1,1,1,1,1,1,1,1,1.231174022502185,1,0,I lived with my mother and father an equal amount of time (joint custody),0,"White, Caucasian, Anglo, European American",0,24,0,1,NA,1,3,6,Business Analyst,2,200,72,3,5,2,0,0,1,0,0,I lived with my mother and father an equal amount of time (joint custody),0,TRUE,TRUE,TRUE,TRUE,TRUE,3,0.7039419354892547,0.5964290322680628,0.621877419340995,0.7098781250044703,0.6155906249955296,0.6585843749903142,1,1,1,1,1,1,0.121,0.486,0.878,0.023,1.163,66.36590441795235,1865.6539592467905,0.112,0.493,0.898,0.023,1.248,79.61747044945945,1869.1617833781256,276,0.8177777777777777,0,3,0,0,3,FALSE
213,2022-03-18T18:04:01Z,2022-03-18T18:20:37Z,995,1,2022-03-18T18:20:38Z,0.8999999761581421,Chrome,99.0.4844.51,Windows NT 10.0,1280,720,Thank you!,1.7777777777777777,491,77,203,60,34,76,-0.38409992207376004,-0.22613957251783437,-0.7570101411998406,-0.4704768164632027,-0.552128780389171,-0.2521103918255647,3,3,2,1,3,1,1,2,1,2,3,1,1,1,2,2,1,1,3,2,0.8335087534664907,0,1,1,4,4,1.8,0,1,1,2,1,1,1,1,1,1,1,1,1,1,1,1,1,1,1,1,1,1,1,1,2,2,0,0,0,0,1,1,2,1,1,1,1,1,1,1,1,1,1,2,1,1,1,1,1,1,1,1,1,1,1,1,1,1,2,2,2,5,1,1,1,1,1,1,1,1,2,1.833947481081005,2.016597794967223,1,0,1.25,0,1.0666666666666667,0,1.1111111111111112,0,1.0833333333333333,0,1,0,2,0,1,0,1.2432432432432432,0,1,0,0,-1.4589105100043123,-0.3151752203835423,-0.8870428651939273,1,1,1,1,1,1,1,2,1,1.9518001458970664,1,0,1.5,-0.7666430815591236,5,5,5,5,5,5,5,7,6,6,5,1.5118578920369088,6.5,5,0,1.6437080244297957,0,1.846504429263051,2,1,2,1,2,4,4,3,5,4,4,4,5,4,5,5,5,5,4,2,1.5118578920369088,1.6,0,4.4,0,4.4,0,3.8,0,4.2,0,2,1,1,1,3,1,1,2,1,1,1,2,1,1,1,2,1,1,1,2,0.9880869341680844,1.35,0,2,1,1,1,3,1,1,2,1,1,1,2,1,1,1,2,1,1,1,2,0.9880869341680844,1.35,0,I lived with my mother and father an equal amount of time (joint custody),0,"White, Caucasian, Anglo, European American",0,25,0,1,NA,1,4,6,Resident,3,175,72,4,5,2,0,0,0,0,0,I lived with my mother and father an equal amount of time (joint custody),0,TRUE,TRUE,TRUE,TRUE,TRUE,3,0.4363281250037253,0.39055312500149014,0.4335187500044703,0.49840333333611486,0.46787999999920526,0.529419999998808,1,1,1,0.9375,0.9375,0.9375,0.073,0.321,0.682,0.017,1.893,57.89292984856013,1924.2289555658585,0.073,0.323,0.725,0.016,1.953,68.83837799738966,1919.5394696151072,358,1.0607407407407408,0,3,0,0,3,FALSE
214,2022-03-18T17:58:38Z,2022-03-18T18:20:43Z,1324,1,2022-03-18T18:20:44Z,1,Chrome,97.0.4692.71,Windows NT 10.0,1920,1080,NA,1.7777777777777777,431,61,269,123,330,55,-0.5072481742940215,-0.3143343070113147,-0.5175640681143523,0.30521112571492653,5.509426099246139,-0.48799585744453366,2,1,1,1,1,1,2,2,1,1,2,1,1,1,1,1,1,1,2,1,1.348488432516786,0,1,1,4,3,1.25,0,1,1,3,1,3,2,1,2,2,1,1,1,2,1,1,1,1,1,1,1,1,1,1,0,2,0,0,0,0,1,2,1,1,2,2,2,2,2,2,1,2,1,2,2,1,2,1,1,1,2,1,5,1,1,2,1,2,1,1,1,1,2,2,1,1,1,1,2,1,1,1.633912381270694,1.6388149028228556,1,0,1.25,0,1.5333333333333334,0,1.6666666666666667,0,1.5,0,1.8333333333333333,0,1.4285714285714286,0,1,0,1.5405405405405406,0,0,0,0,-1.1250551532160513,-0.5343359712415323,-0.8296955622287918,1,1,1,1,1,1,1,1,1,1.9518001458970664,1,0,1,-0.9598956828029438,5,5,5,5,2,2,4,4,8,3,3,1.6035674514745464,6,4,0,0.22259487524538815,0,0.4382746948157501,2,2,2,2,2,4,5,3,4,2,5,4,4,3,4,3,4,4,4,3,1.0997835284835873,2,0,4.2,0,3.6,0,3.4,0,3.7333333333333334,0,3,2,3,3,3,3,3,3,3,2,2,3,3,4,2,2,2,3,3,3,0.5871429486123998,2.75,0,3,2,3,3,3,3,3,3,3,2,2,3,3,4,2,2,2,3,3,3,0.5871429486123998,2.75,0,I lived with my mother and father an equal amount of time (joint custody),0,"White, Caucasian, Anglo, European American",0,27,0,1,NA,1,3,6,process engineer,4,125,68,2,5,2,0,0,1,0,0,I lived with my mother and father an equal amount of time (joint custody),0,TRUE,TRUE,TRUE,TRUE,TRUE,5,0.46573225806124746,0.4098718750001863,0.4327812499990687,0.5027838709681265,0.47284062500018625,0.4845290322553727,0.96875,1,1,0.96875,1,0.96875,0.063,0.339,0.614,0.02,1.478,158.35814292967407,2060.4672493107414,0.062,0.339,0.723,0.02,1.534,152.17910177521395,1999.3133120538473,304,0.9007407407407407,1,3,0,3,6,FALSE
215,2022-03-18T17:54:39Z,2022-03-18T18:22:27Z,1668,1,2022-03-18T18:22:28Z,0.8999999761581421,Chrome,99.0.4844.74,Windows NT 10.0,1920,1080,NA,1.7777777777777777,559,108,671,103,62,105,-0.24453190289079713,-0.055262274436716274,0.9408801952245307,0.05896098534091724,0.021261546062817747,0.0736362035530115,1,2,2,2,3,1,1,2,1,2,3,1,1,1,2,3,1,1,2,3,0.9445132413883326,1,1,1,4,4,1.75,0,3,3,3,3,3,2,3,2,2,2,3,4,3,3,3,2,1,1,1,2,1,1,3,1,1,4,0,4,0,1,1,1,1,1,3,1,1,1,2,2,4,2,5,1,1,1,3,3,3,3,2,1,5,3,1,1,2,2,1,1,1,1,3,1,1,1,3,3,3,4,1.6562739034481113,0.4879500364742666,1.5,0,3.25,0,2.8,0,1.2222222222222223,0,2.5,0,2.1666666666666665,0,1.5714285714285714,0,1,0,1.837837837837838,0,1,0,0,-0.22309451359116192,0.37429049909943074,0.07559799275413441,3,2,4,3,1,3,2,4,3,0.7559289460184544,2.5714285714285716,0,3.5,0.9179194712912746,4,4,4,4,3,3,4,1,1,2,2,0.7867957924694432,1,3.7142857142857144,0,-1.2391899714376922,0,-0.6076130757598266,2,2,2,1,1,5,5,5,5,3,2,2,5,1,4,2,3,4,1,5,1.4375905768565218,1.6,0,3.2,0,3.2,0,4,0,3.466666666666667,0,4,1,3,4,1,4,1,4,4,3,3,4,3,1,1,4,4,4,4,4,1.394538218230416,3.05,0,4,1,3,4,1,4,1,4,4,3,3,4,3,1,1,4,4,4,4,4,1.394538218230416,3.05,0,"I lived with my mother, but not father, most of the time.",0,"Asian or Asian American (e.g., Chinese, Japanese, and others)",0,24,1,2,NA,0,1,6,Freelancer,2,105,63,4,5,2,0,0,1,0,0,"I lived with my mother, but not father, most of the time.",0,TRUE,TRUE,TRUE,TRUE,TRUE,3,0.5026322580644891,0.40191249999996215,0.4557874999999767,0.5935718749999651,0.4599482758621011,0.5094699999999721,1,1,1,1,0.90625,0.967741935483871,0.064,0.343,0.571,0.023,1.869,456.63653343039294,2744.695147036861,0.077,0.345,0.606,0.062,1.92,613.9847503531968,2849.9867484394863,328,0.9718518518518519,0,3,0,0,3,FALSE
216,2022-03-18T17:57:49Z,2022-03-18T18:23:01Z,1511,1,2022-03-18T18:23:03Z,0.8999999761581421,Chrome,99.0.4844.74,Windows NT 10.0,1920,1080,NA,1.7777777777777777,532,117,468,121,57,64,-0.29994861638991477,-0.0056527362841335945,0.20440212194643803,0.2805861116775256,-0.08112958366075168,-0.38690208646497554,2,2,1,1,2,1,2,2,1,2,2,1,1,1,2,2,1,1,2,3,0.9733285267845752,0,1,1,3,4,1.6,0,2,1,2,2,2,1,2,2,1,1,1,1,2,3,2,2,1,1,2,1,1,1,1,0,2,0,0,0,0,1,1,1,1,2,1,2,2,1,1,2,1,1,1,1,1,1,1,1,3,3,1,1,1,1,2,1,1,1,2,1,2,1,2,1,1,1,2,1,1,1,1.7406981444322935,1.486446705914413,1.25,0,1.25,0,1.6666666666666667,0,1.3333333333333333,0,1.4166666666666667,0,1.1666666666666667,0,1.4285714285714286,0,1,0,1.3243243243243243,0,0,0,0,-1.052024293918619,-0.5343359712415323,-0.7931801325800757,1,2,2,2,1,2,2,1,1,1.3972762620115438,1.7142857142857142,0,1,-0.5455537974051633,4,5,4,5,2,2,4,8,7,NA,3,1.3972762620115438,7.5,3.7142857142857144,0,0.819067194686666,1,0.6470023958970964,2,3,2,4,2,4,5,2,4,2,5,4,3,4,4,4,5,1,5,3,1.3522468075656264,2.6,0,3.8,0,3.8,0,3.4,0,3.6666666666666665,0,1,1,1,1,1,1,3,2,1,1,1,2,2,1,1,1,1,1,1,1,1.0894228312566052,1.25,0,1,1,1,1,1,1,3,2,1,1,1,2,2,1,1,1,1,1,1,1,1.0894228312566052,1.25,0,I lived with my mother and father an equal amount of time (joint custody),0,"White, Caucasian, Anglo, European American",0,23,0,1,NA,1,4,6,Graduate Student,7,171,68,3,5,2,0,0,0,0,0,I lived with my mother and father an equal amount of time (joint custody),0,TRUE,TRUE,TRUE,TRUE,TRUE,5,0.5580812499999883,0.49208749999993595,0.5629483870966661,0.6174624999999941,0.5688124999999563,0.6055516129031687,1,1,1,1,1,1,0.135,0.337,0.65,0.018,1.389,47.68620337769986,1843.312472806359,0.133,0.343,0.643,0.02,1.47,62.434096512800764,1846.4128458997716,304,0.9007407407407407,1,3,0,3,6,FALSE
217,2022-03-18T17:55:43Z,2022-03-18T18:23:27Z,1663,1,2022-03-18T18:23:27Z,0.8999999761581421,Chrome,95.0.4638.69,Windows NT 10.0,1920,1080,"I had a 2nd monitor connected, but it was not used and simply ignored. I briefly moved my mouse over to it at the very beginning of the experiment to test if it would go over to the other monitor still while in full screen mode on my main monitor.

Bringing back childhood memories for this experiment was very emotionally difficult. That is not your fault, though. I thank you for the study.",1.7777777777777777,651,123,527,91,49,58,-0.05570458281972967,0.027420289150921522,0.41845239940164725,-0.08878909888348833,-0.24495539121846277,-0.454297933784681,3,4,4,4,4,2,2,4,2,4,4,4,2,3,4,4,4,2,4,4,1.1697953037312037,0,0,5,3,2,3.4,0,4,3,3,5,3,4,4,5,5,4,5,5,1,5,5,5,5,4,3,5,5,5,5,3,1,1,0,1,0,3,5,5,4,5,3,4,5,4,5,4,5,2,5,5,5,5,5,5,5,5,5,2,4,3,4,4,5,2,1,1,5,3,3,5,5,5,2,2,1,1,1.6499158227686108,1.5796322658258457,4.625,0,1.5,0,4.066666666666666,0,4.222222222222222,0,4.666666666666667,0,3.6666666666666665,0,2.857142857142857,0,5,0,4.081081081081081,0,2,0,0,2.676388079458773,-0.009831254590180624,1.3332784124342962,5,5,5,5,4,5,4,8,1,1.8126539343499315,4.714285714285714,0,4.5,2.5474503299722566,1,2,2,1,1,1,1,4,1,1,1,1.4638501094227998,2.5,1.2857142857142858,0,-1.5265040259537794,0,-2.0989999036108973,1,1,1,2,2,5,4,4,5,4,5,5,4,5,5,5,5,4,4,5,1.7265434778633235,1.4,0,4.8,0,4.2,0,4.8,0,4.6,0,2,2,2,4,3,4,4,4,4,2,2,4,1,2,3,4,1,4,2,4,1.1742858972247996,2.9,0,2,2,2,4,3,4,4,4,4,2,2,4,1,2,3,4,1,4,2,4,1.1742858972247996,2.9,0,"I lived with my mother, but not father, most of the time.",0,"White, Caucasian, Anglo, European American",0,26,0,1,NA,1,1,1,Physically disabled,1,142,70,1,5,2,0,0,0,0,0,"I lived with my mother, but not father, most of the time.",0,TRUE,TRUE,TRUE,TRUE,TRUE,2,0.46929062500968577,0.4113843750096858,0.48893437499925496,0.5994700000007948,0.523858620676501,0.5773206896535281,1,1,1,0.9375,0.90625,0.90625,0.072,0.323,0.484,0.011,1.55,108.19185207992388,1972.3267108240068,0.074,0.314,0.455,0.012,1.74,112.93782404929397,1970.5484470433175,272,0.8059259259259259,0,3,0,3,6,FALSE
218,2022-03-18T18:08:08Z,2022-03-18T18:26:16Z,1088,1,2022-03-18T18:26:17Z,1,Chrome,99.0.4844.57,CrOS x86_64 14469.41.0,1366,768,None.,1.7786458333333333,528,62,267,78,39,70,-0.30815849987126553,-0.30882213610547216,-0.5248200097230035,-0.24885169012659436,-0.4497376506656016,-0.3195062391452701,3,3,3,2,4,1,2,4,1,4,4,2,1,2,4,4,2,1,4,4,0.6048053188292994,0,1,2,2,2,2.75,0,3,2,3,3,2,2,3,3,2,2,2,3,2,3,3,2,2,1,1,3,2,2,2,0,2,0,0,0,0,2,3,3,2,2,1,2,2,3,1,2,2,1,3,1,1,2,2,2,3,3,2,1,1,1,3,1,1,1,1,1,2,2,2,3,3,2,2,2,1,3,1.28224184307959,0.6172133998483676,1.875,0,2,0,2.533333333333333,0,2.2222222222222223,0,1.9166666666666667,0,1.5,0,1.4285714285714286,0,2.6666666666666665,0,1.8918918918918919,0,0,0,0,-0.1521305654059217,-0.2757863264354174,-0.21395844592066954,2,2,3,2,1,2,2,2,2,0.9511897312113419,2,0,2,0.0066881592415893995,4,3,2,3,2,2,3,1,1,1,2,0.7559289460184544,1,2.7142857142857144,0,-1.4532676619615443,0,-1.2800915220794384,2,3,2,1,2,5,4,4,4,3,4,3,3,3,3,3,3,4,3,4,0.7367883976130072,2,0,3.8,0,3.2,0,3.6,0,3.533333333333333,0,2,1,2,4,2,3,3,4,2,1,2,3,1,2,2,4,3,3,2,3,0.7591546545162482,2.45,0,2,1,2,4,2,3,3,4,2,1,2,3,1,2,2,4,3,3,2,3,0.7591546545162482,2.45,0,I lived with my mother and father an equal amount of time (joint custody),0,"White, Caucasian, Anglo, European American",0,27,1,2,NA,1,1,5,Self-employed,1,195,63,2,5,2,0,0,0,0,0,I lived with my mother and father an equal amount of time (joint custody),0,TRUE,TRUE,TRUE,TRUE,TRUE,3,0.6321906250000138,0.5846562499999995,0.6132812499999982,0.7076064516129141,0.6484250000000047,0.7630483870967761,1,1,1,1,1,0.96875,0.106,0.3,0.316,0.011,1.499,78.91255819121592,1910.8332901900878,0.083,0.365,0.347,0.012,1.55,48.29665848569649,1871.6335628789018,334,0.9896296296296296,0,3,0,0,3,FALSE
219,2022-03-18T18:07:05Z,2022-03-18T18:26:20Z,1155,1,2022-03-18T18:26:21Z,0.8999999761581421,Chrome,99.0.4844.74,Windows NT 10.0,1920,1080,NA,1.7777777777777777,549,58,271,61,36,118,-0.26505661159417404,-0.33087081972884225,-0.5103081265057011,-0.45816430944450226,-0.5111723284997433,0.21966053941237323,2,2,1,1,2,1,1,2,1,2,2,1,1,1,2,2,1,1,2,2,1.025978352085154,0,1,2,3,4,1.5,0,3,2,1,2,1,1,2,1,1,1,1,2,1,2,3,2,2,1,1,1,2,1,1,1,2,0,0,0,0,2,3,3,2,4,3,2,2,2,2,4,1,1,3,1,4,1,1,1,2,2,2,1,1,1,2,2,1,2,2,1,1,1,1,1,1,1,2,2,2,2,1.2105641104317713,1.4375905768565218,1.375,0,2,0,1.6,0,2.5555555555555554,0,1.9166666666666667,0,1.5,0,1.2857142857142858,0,1,0,1.8108108108108107,0,1,0,0,-0.8139358186618963,-0.05662557557742737,-0.4352806971196619,2,2,3,1,1,1,1,2,1,1.2149857925879117,1.5714285714285714,0,1.5,-0.4351695732408991,4,4,4,4,3,3,5,6,6,4,4,1.1126972805283737,6,3.857142857142857,0,0.7809406510307816,0,0.7011889704503234,1,2,2,2,2,5,1,5,5,1,5,4,5,1,3,3,3,3,3,3,1.1338934190276817,1.8,0,4,0,2.6,0,3.4,0,3.3333333333333335,0,1,2,1,1,1,1,2,1,1,1,1,1,3,1,1,1,1,1,1,1,1.2396943596157715,1.2,0,1,2,1,1,1,1,2,1,1,1,1,1,3,1,1,1,1,1,1,1,1.2396943596157715,1.2,0,I lived with my mother and father an equal amount of time (joint custody),0,"Asian or Asian American (e.g., Chinese, Japanese, and others) & Filipino",1,22,0,1,NA,1,4,6,Lab Technician,4,120,66,2,5,2,0,0,1,0,0,I lived with my mother and father an equal amount of time (joint custody),0,TRUE,TRUE,TRUE,TRUE,TRUE,2,0.4708687500283122,0.4580531250163913,0.4383718750178814,0.549496774173552,0.5305677419324075,0.5194499999920527,1,1,1,0.96875,1,0.967741935483871,0.062,0.339,0.635,0.023,1.89,50.61140543881739,1890.6426632292082,0.063,0.34,0.685,0.023,1.881,51.61580845020024,1881.0811041339484,472,1.3985185185185185,0,3,0,0,3,FALSE
220,2022-03-18T17:51:26Z,2022-03-18T18:26:40Z,2113,1,2022-03-18T18:26:42Z,0.800000011920929,Chrome,99.0.4844.74,Windows NT 10.0,1366,768,The study was very engaging and thoughtful. I had no issues with the study.,1.7786458333333333,617,193,626,160,81,180,-0.12548859241121113,0.4132722525598979,0.7776215090298796,0.7607738854068437,0.4103478390123816,0.9160842950493292,2,2,1,1,2,1,1,2,1,2,2,1,1,1,2,2,1,1,2,2,1.025978352085154,0,1,3,5,5,1.5,0,5,3,2,2,1,1,5,1,1,1,1,3,2,3,2,2,1,1,2,1,1,1,1,0,2,0,0,0,0,3,3,3,3,3,3,3,3,3,2,3,1,2,3,1,3,1,1,1,1,1,2,4,1,1,1,1,1,1,1,1,2,1,1,1,2,1,3,2,2,1,1.092562901481509,1.162919151265879,1.25,0,2,0,2.2,0,3,0,1.6666666666666667,0,1.6666666666666667,0,1.1428571428571428,0,1.3333333333333333,0,1.864864864864865,0,0,0,0,-0.5827370471124788,-0.2757863264354174,-0.42926168677394805,2,4,3,3,3,3,3,1,1,0.4879500364742666,3,0,1,0.20026159631084173,3,3,3,3,2,3,3,6,6,2,4,0.3779644730092272,6,2.857142857142857,0,0.3527852699830773,0,-0.1017810330411974,1,1,1,1,1,5,2,5,5,1,5,4,4,4,4,4,4,4,2,2,1.2909944487358056,1,0,4.4,0,2.6,0,4,0,3.6666666666666665,0,1,1,1,3,1,1,1,2,1,1,1,2,2,1,1,2,1,1,1,1,0.7539370349250519,1.3,0,1,1,1,3,1,1,1,2,1,1,1,2,2,1,1,2,1,1,1,1,0.7539370349250519,1.3,0,I lived with my mother and father an equal amount of time (joint custody),0,Black or African American,0,27,1,2,NA,1,3,7,Information technology,3,196.7,67,2,3,2,0,0,1,1,0,I lived with my mother and father an equal amount of time (joint custody),0,TRUE,TRUE,TRUE,TRUE,TRUE,3,0.5718967741843193,0.48523124999552963,0.5723968750201166,0.6472548387281356,0.5318266666769982,0.6325266666611036,1,1,1,0.96875,0.9375,0.9375,0.054,0.465,0.492,0.023,1.848,45.371111667502106,1915.8377450938756,0.055,0.468,0.531,0.028,1.954,53.50867425701129,1923.8539542498881,342,1.0133333333333332,0,0,0,0,3,FALSE
221,2022-03-18T17:49:52Z,2022-03-18T18:27:11Z,2239,1,2022-03-18T18:27:12Z,1,Edge,99.0.1150.30,Windows NT 10.0,1280,720,NA,1.7777777777777777,1761,61,209,54,34,70,2.222538083255106,-0.3143343070113147,-0.735242316373887,-0.5443518585754055,-0.552128780389171,-0.3195062391452701,2,2,2,1,3,2,2,3,1,3,3,2,3,3,3,3,2,1,3,3,0.6048053188292994,0,1,3,2,2,2.35,0,4,3,4,3,5,4,4,3,2,2,4,3,2,3,3,2,3,1,1,2,2,3,3,0,2,0,0,0,0,1,2,2,2,2,1,2,2,2,4,1,4,2,2,3,1,5,4,4,5,5,2,1,1,1,1,1,1,1,1,1,4,4,4,1,3,2,1,3,3,2,1.5368350145223337,0.9258200997725514,2.125,0,2.25,0,3.2666666666666666,0,1.7777777777777777,0,3.3333333333333335,0,1.1666666666666667,0,2.2857142857142856,0,2,0,2.2972972972972974,0,0,0,0,0.4547539068689656,-0.18960311150004575,0.13257539768445992,1,2,2,2,1,4,4,4,1,1.4638501094227998,2.2857142857142856,0,2.5,0.3656775146445217,4,4,4,5,3,3,4,6,7,5,3,0.9759000729485332,6.5,3.857142857142857,0,0.7410941633828612,0,0.6769004506690945,2,2,3,3,2,4,5,4,4,4,4,4,3,5,5,4,5,3,5,2,1.3020130933435712,2.4,0,4,0,4.2,0,4,0,4.066666666666666,0,3,4,3,2,4,2,3,2,1,1,3,2,2,3,1,2,3,3,4,3,0.910465468000326,2.55,0,3,4,3,2,4,2,3,2,1,1,3,2,2,3,1,2,3,3,4,3,0.910465468000326,2.55,0,I lived with my mother and father an equal amount of time (joint custody),0,"White, Caucasian, Anglo, European American",0,21,1,2,NA,1,4,4,front end associate at company/student,1,125,64,3,5,2,0,0,1,0,0,I lived with my mother and father an equal amount of time (joint custody),0,TRUE,TRUE,TRUE,TRUE,TRUE,3,0.5036156250014902,0.47796774192010205,0.5007677419262547,0.5752218750119209,0.5708906249962747,0.5575566666563352,1,0.96875,0.96875,1,1,0.967741935483871,0.052,0.392,0.451,0.025,1.534,102.55144937022395,1966.2234078262331,0.05,0.394,0.443,0.026,1.607,120.8548705382473,1991.1335671306883,339,1.0044444444444445,0,3,0,6,9,FALSE
223,2022-03-18T17:46:30Z,2022-03-18T18:27:25Z,2454,1,2022-03-18T18:27:26Z,1,Opera,84.0.4316.36,Windows NT 10.0,1768,992,N/A,1.782258064516129,993,286,655,142,63,240,0.6462404548357602,0.9259041468032522,0.8828326623553214,0.5391487590702353,0.04173977200753163,1.5900427682463831,3,2,1,1,2,1,1,3,1,3,3,1,2,1,2,3,1,1,3,3,0.7326950970650465,0,0,2,3,2,1.9,0,4,5,3,4,3,5,5,4,3,2,2,4,1,5,5,5,5,5,3,4,4,5,5,4,1,2,0,2,1,2,3,3,3,5,3,5,4,4,2,3,3,1,4,1,3,5,4,4,4,3,5,3,5,3,4,4,3,4,1,1,3,3,3,2,1,3,1,3,3,1,1.1702005680093346,1.2071217242444348,4.5,0,2,0,3.6666666666666665,0,3.5555555555555554,0,3.0833333333333335,0,4,0,2.5714285714285716,0,2,0,3.1621621621621623,0,2,1,0,2.045389644208319,0.8606950077177212,1.45304232596302,5,4,5,3,5,5,5,3,3,1.8126539343499315,4.571428571428571,0,3,1.8848241491612394,2,3,3,4,1,1,1,1,4,1,1,1.4960264830861913,2.5,2.142857142857143,0,-1.5265040259537794,0,-1.634439712912866,3,4,3,2,3,4,5,3,3,3,5,3,4,4,3,5,4,2,5,4,1.2535663410560174,3,0,3.6,0,4.4,0,3.4,0,3.8,0,1,1,1,1,3,1,2,1,1,1,2,2,1,2,2,1,1,1,1,1,1.1367080817685316,1.35,0,1,1,1,1,3,1,2,1,1,1,2,2,1,2,2,1,1,1,1,1,1.1367080817685316,1.35,0,"I lived with my father, but not mother, most of the time. & I lived with my extended family on father's side (grandparents, aunts ,uncles, cousins)",1,"White, Caucasian, Anglo, European American",0,18,0,1,NA,1,1,3,blogger,1,122,72,1,5,2,0,0,1,0,0,"I lived with my father, but not mother, most of the time. & I lived with my extended family on father's side (grandparents, aunts ,uncles, cousins)",1,TRUE,TRUE,TRUE,TRUE,TRUE,4,0.6468406250000044,0.6076124999999738,0.5357749999999942,0.7693150000000489,0.7240709677419339,0.7744772727273045,1,1,1,0.625,0.96875,0.6875,0.066,0.375,0.312,0.007,1.953,131.98927540806255,2132.5649963693863,0.066,0.375,0.344,0.007,1.985,145.09474179780142,2102.3050659071596,304,0.9007407407407407,1,3,0,0,3,FALSE
224,2022-03-18T18:01:59Z,2022-03-18T18:28:11Z,1571,1,2022-03-18T18:28:12Z,1,Chrome,98.0.4758.102,Macintosh,1440,900,no,1.6,519,82,300,58,63,94,-0.32663073770430473,-0.19857871798862178,-0.40509697318025933,-0.49510183050060363,0.04173977200753163,-0.04992284986644844,1,1,1,1,1,1,1,1,1,1,1,1,1,1,1,1,1,1,1,1,1.538967528127731,0,1,1,2,2,1,0,3,3,1,3,1,1,2,2,1,1,2,3,1,3,3,4,1,1,1,3,1,1,3,1,2,0,0,0,0,1,3,2,2,2,1,1,1,1,3,2,3,1,4,1,5,1,1,2,2,2,4,4,3,3,3,3,1,3,1,1,3,3,1,1,3,1,3,3,1,3,1.3955097446623035,1.0600988273786194,1.875,0,2.5,0,2,0,1.5555555555555556,0,2.25,0,3.3333333333333335,0,1.8571428571428572,0,1.6666666666666667,0,2.135135135135135,0,1,0,0,-0.2789011136203318,0.11574085429331589,-0.08158012966350797,2,3,4,1,1,1,2,3,1,1.1547005383792515,2,0,2,0.0066881592415893995,3,2,3,5,1,1,3,6,3,2,1,1.3972762620115438,4.5,2.5714285714285716,0,-0.9510507070708526,0,-1.0513907005551464,1,1,1,1,1,5,5,5,5,3,5,5,4,5,3,4,5,5,4,5,1.7182493859684491,1,0,5,0,4,0,4.6,0,4.533333333333333,0,2,1,1,1,2,2,2,2,1,1,3,2,2,2,2,1,1,1,1,2,0.9733285267845752,1.6,0,2,1,1,1,2,2,2,2,1,1,3,2,2,2,2,1,1,1,1,2,0.9733285267845752,1.6,0,"I lived with my mother, but not father, most of the time. & I lived with my extended family on mother's side (grandparents, aunts ,uncles, cousins)",1,Black or African American,0,28,1,2,NA,1,3,7,Government,2,168,66,2,5,2,0,0,1,0,0,"I lived with my mother, but not father, most of the time. & I lived with my extended family on mother's side (grandparents, aunts ,uncles, cousins)",1,TRUE,TRUE,TRUE,TRUE,TRUE,6,0.5193093750067055,0.49386129032027337,0.5139718749932944,0.5972156250104308,0.5393193548398634,0.5739874999932945,1,1,1,1,0.96875,1,0.087,0.385,0.61,0.034,1.849,84.61734114762929,1889.5626264870575,0.088,0.382,0.645,0.032,1.94,93.013396283364,1894.4451194079613,438,1.2977777777777777,0,3,0,0,3,FALSE
225,2022-03-18T17:40:33Z,2022-03-18T18:28:40Z,2887,1,2022-03-18T18:28:42Z,1,Chrome,99.0.4844.57,CrOS x86_64 14469.41.0,1366,768,no,1.7786458333333333,514,138,1186,304,341,297,-0.33689309205599316,0.11010285273855931,2.8092851594522044,2.5337748960997106,5.734686584637991,2.2303033177835845,1,3,2,2,2,1,4,3,2,1,2,3,1,2,1,2,3,3,3,2,0.9333020044867296,0,1,2,2,3,2.15,0,2,1,1,3,1,2,4,3,2,1,2,3,3,3,3,3,4,3,2,2,3,4,2,2,2,0,0,0,0,2,3,2,3,4,3,1,1,1,1,3,2,2,2,2,1,5,5,3,1,1,4,1,1,1,3,3,1,2,2,1,2,2,2,1,1,1,2,2,2,2,1.4425952589278397,1.1254628677422756,2.875,0,2,0,2.2666666666666666,0,2.2222222222222223,0,2.3333333333333335,0,2.1666666666666665,0,1.7142857142857142,0,1,0,2.054054054054054,0,1,0,0,0.2392046051689973,-0.05662557557742737,0.09128951479578497,1,2,2,1,1,2,2,1,1,1.5118578920369088,1.5714285714285714,0,1,-0.6284221744847194,2,1,1,1,2,1,4,4,6,2,3,0.5345224838248488,5,1.7142857142857142,0,-0.17217062945800132,0,-1.0411827174693065,3,3,4,3,3,3,4,3,3,2,4,2,3,3,3,4,4,4,2,4,0.7237468644557459,3.2,0,3.4,0,3,0,3.2,0,3.2,0,2,3,2,3,2,3,2,3,2,3,3,1,2,2,2,1,2,3,3,3,0.6863327411532597,2.35,0,2,3,2,3,2,3,2,3,2,3,3,1,2,2,2,1,2,3,3,3,0.6863327411532597,2.35,0,"I lived with my father, but not mother, most of the time. & I lived with my mother and father an equal amount of time (joint custody) & I lived with my extended family on father's side (grandparents, aunts ,uncles, cousins)",1,"White, Caucasian, Anglo, European American",0,24,0,1,NA,1,2,2,dishwasher,1,140,68,2,5,2,0,0,0,0,0,"I lived with my father, but not mother, most of the time. & I lived with my mother and father an equal amount of time (joint custody) & I lived with my extended family on father's side (grandparents, aunts ,uncles, cousins)",1,TRUE,TRUE,TRUE,TRUE,TRUE,6,0.5859968750000698,0.7918419354842795,0.4879312500002561,0.6284548387094852,0.963596666666617,0.5450482758620175,1,1,1,0.96875,1,0.90625,0.056,0.348,0.426,0.021,1.818,60.56112287055241,1931.5195201925728,0.055,0.35,0.429,0.023,1.937,73.87599958615219,1933.338969028734,402,1.1911111111111112,0,3,0,0,3,FALSE
226,2022-03-18T17:48:40Z,2022-03-18T18:29:44Z,2464,1,2022-03-18T18:29:45Z,0.800000011920929,Chrome,99.0.4844.51,Macintosh,1280,800,NA,1.6,776,168,1002,111,81,164,0.20085427597248154,0.2754679799138349,2.1417385314562973,0.15746104149052095,0.4103478390123816,0.7363620355301148,2,3,2,1,3,1,2,3,2,3,4,2,1,1,2,3,2,1,3,3,0.6155870112510925,0,1,4,3,2,2.2,0,2,3,2,3,3,2,2,2,2,1,1,3,2,2,2,2,2,3,2,2,2,2,2,2,2,0,0,0,0,2,2,3,2,3,1,1,1,3,2,3,1,3,3,2,3,3,2,1,1,1,3,3,5,1,3,1,2,3,3,3,3,3,3,2,3,3,2,2,2,2,1.1429375776070652,1.0465362369445672,2.125,0,2,0,2.1333333333333333,0,2,0,2.0833333333333335,0,2.6666666666666665,0,2.857142857142857,0,2.6666666666666665,0,2.3513513513513513,0,1,0,0,-0.01689552406539389,-0.05662557557742737,-0.03676054982141063,4,4,5,3,3,4,3,4,1,1.0690449676496976,3.7142857142857144,0,2.5,1.194361285440083,1,3,3,4,1,1,3,6,6,NA,2,1.2535663410560174,6,2.2857142857142856,0,-0.103882515109605,1,-0.6898507437845217,2,2,2,3,2,4,2,5,5,3,2,3,4,3,3,1,3,3,2,5,1.1254628677422756,2.2,0,3,0,2.4,0,4.2,0,3.2,0,2,1,4,4,2,4,4,4,3,2,1,4,2,3,2,4,1,4,1,3,1.1821033884786185,2.75,0,2,1,4,4,2,4,4,4,3,2,1,4,2,3,2,4,1,4,1,3,1.1821033884786185,2.75,0,"I lived with my mother, but not father, most of the time.",0,Black or African American,0,28,1,2,NA,1,2,6,unemployed and unpaid caregiver,7,245,67,1,5,2,0,0,1,0,0,"I lived with my mother, but not father, most of the time.",0,TRUE,TRUE,TRUE,TRUE,TRUE,3,0.7886156249921769,0.6448437499906867,0.6869937500003725,0.8731593750044704,0.6925709677396282,0.7437580645180518,1,1,1,1,1,1,0.111,0.414,0.435,0.01,1.219,151.06606091840382,1966.7315156251611,0.11,0.417,0.435,0.01,1.264,176.16954212103266,1965.7256257470683,253,0.7496296296296296,0,3,0,0,3,FALSE
227,2022-03-18T18:15:19Z,2022-03-18T18:30:54Z,934,1,2022-03-18T18:30:54Z,0.8999999761581421,Chrome,96.0.4664.45,Windows NT 10.0,1536,864,NA,1.7777777777777777,448,63,240,48,34,55,-0.4723561694982807,-0.30330996519962966,-0.6227752214397941,-0.6182269006876083,-0.552128780389171,-0.48799585744453366,4,4,3,2,4,1,1,4,1,4,4,3,3,3,4,4,2,2,4,4,0.8255779474818965,0,1,1,2,2,3.05,0,5,1,2,2,2,2,4,4,3,3,5,5,3,4,4,2,4,4,1,1,5,3,3,6,2,0,0,0,0,1,1,4,3,3,1,2,2,5,1,2,4,1,5,5,5,3,5,5,5,5,5,3,4,3,2,1,1,2,1,1,1,1,1,1,4,1,2,2,2,2,1.6639617690225845,1.2798809468443688,2.875,0,2,0,3.2666666666666666,0,2.4444444444444446,0,3.8333333333333335,0,3,0,1.1428571428571428,0,2,0,2.7027027027027026,0,3,0,0,0.95967076427574,0.38169592613855263,0.6706833452071463,1,1,3,1,1,1,1,2,1,1.5735915849388864,1.2857142857142858,0,1.5,-0.6009063274000113,5,5,5,5,3,3,5,7,7,2,3,1.5735915849388864,7,4.428571428571429,0,0.18920499890107342,0,0.6502019129112548,2,3,2,1,2,4,5,5,5,5,5,4,5,5,5,5,5,5,4,3,1.8309508328682538,2,0,4.6,0,4.8,0,4.6,0,4.666666666666667,0,2,2,4,4,3,2,2,4,4,1,4,3,2,4,4,3,2,3,4,2,1.0990426455975697,2.95,0,2,2,4,4,3,2,2,4,4,1,4,3,2,4,4,3,2,3,4,2,1.0990426455975697,2.95,0,"I lived with my mother, but not father, most of the time.",0,"Asian or Asian American (e.g., Chinese, Japanese, and others)",0,22,1,2,NA,1,3,5,case manager,2,140,62,1,5,2,0,0,1,0,0,"I lived with my mother, but not father, most of the time.",0,TRUE,TRUE,TRUE,TRUE,TRUE,4,0.4384437500005588,0.40048333333333336,0.44068387096543465,0.5384692307733573,0.4583384615377738,0.4610740740740741,1,0.9375,0.96875,0.8125,0.8125,0.84375,0.037,0.342,0.401,0.036,1.801,53.677223641377665,2012.1607110488444,0.038,0.343,0.399,0.04,1.875,70.47692303949962,2016.9917317894085,432,1.28,0,3,0,0,3,FALSE
228,2022-03-18T18:14:12Z,2022-03-18T18:31:40Z,1048,1,2022-03-18T18:31:41Z,0.8999999761581421,Chrome,99.0.4844.51,Macintosh,1440,900,N/A,1.6,495,69,259,58,43,72,-0.37589003859240927,-0.2702369397645745,-0.553843776157608,-0.49510183050060363,-0.36782474688674605,-0.2970409567053683,1,1,2,2,2,1,3,2,1,2,1,2,1,2,2,2,2,1,2,1,1.050062654772261,0,1,1,2,3,1.65,0,4,3,3,2,3,3,4,3,2,3,3,3,2,4,3,2,3,1,1,2,2,3,2,1,2,0,0,0,0,1,4,1,2,2,2,2,1,2,3,2,3,1,2,2,1,4,2,3,3,4,3,1,1,1,2,1,2,1,1,1,4,4,4,1,3,1,2,2,1,1,1.4110248016923697,0.5936168397046637,2,0,1.5,0,3,0,1.8888888888888888,0,2.5,0,1.5,0,2.4285714285714284,0,1.6666666666666667,0,2.108108108108108,0,1,0,0,0.20091753742411714,-0.22899200544817064,-0.01403723401202675,2,3,1,1,1,1,1,3,1,1.7043362064926932,1.4285714285714286,0,2,-0.324785349076635,4,4,5,5,2,1,2,7,7,4,3,1.5118578920369088,7,3.2857142857142856,0,0.6173603799487777,0,0.2917714396576969,4,3,4,4,4,2,5,1,2,2,4,3,3,2,3,3,4,4,3,2,1.0327955589886444,3.8,0,3.4,0,3.2,0,2,0,2.8666666666666667,0,1,3,3,3,4,3,4,3,1,1,3,3,2,3,1,3,2,3,2,4,0.99472291830968,2.6,0,1,3,3,3,4,3,4,3,1,1,3,3,2,3,1,3,2,3,2,4,0.99472291830968,2.6,0,I lived with my mother and father an equal amount of time (joint custody),0,"White, Caucasian, Anglo, European American",0,21,1,2,NA,1,4,4,student,5,105,64,1,5,2,0,0,0,0,0,I lived with my mother and father an equal amount of time (joint custody),0,TRUE,TRUE,TRUE,TRUE,TRUE,6,0.5122718750000932,0.4889593749996275,0.5428156249995809,0.6120366666649779,0.5727806451613865,0.6299903225800203,1,1,1,0.9375,0.96875,0.96875,0.072,0.398,0.523,0.015,1.748,49.30423425997317,1888.5547924901934,0.072,0.398,0.524,0.015,1.747,63.45075926720345,1886.2592161594898,438,1.2977777777777777,0,3,0,0,3,FALSE
229,2022-03-18T18:13:06Z,2022-03-18T18:31:43Z,1117,1,2022-03-18T18:31:44Z,0.8999999761581421,Chrome,99.0.4844.74,Windows NT 10.0,1920,1080,NA,1.7777777777777777,517,121,247,60,42,79,-0.3307356794449801,0.016395947339236484,-0.5973794258095151,-0.4704768164632027,-0.38830297283146,-0.218412468165712,2,2,1,1,2,1,2,3,1,2,3,2,1,2,3,2,2,1,2,3,0.7947194142390263,0,1,3,3,2,1.9,0,3,2,3,3,4,4,4,3,2,3,2,3,2,3,3,2,2,1,1,2,2,2,2,0,2,0,0,0,0,1,2,1,2,2,2,1,1,3,2,2,3,1,1,2,1,2,3,3,4,3,3,1,1,1,1,1,1,1,1,1,1,2,2,1,1,2,1,1,1,1,1.539275598900135,0.7037315505489968,1.75,0,1,0,2.933333333333333,0,1.6666666666666667,0,2.25,0,1.3333333333333333,0,1.2857142857142858,0,1.3333333333333333,0,1.7027027027027026,0,0,0,0,-0.11463089237044799,-0.6205191861769039,-0.36757503927367596,1,1,1,1,1,1,1,1,1,1.9518001458970664,1,0,1,-0.9598956828029438,5,5,5,5,2,2,5,6,6,6,4,1.8126539343499315,6,4.142857142857143,0,1.2090960320784858,0,1.1170254816934846,2,3,2,2,2,4,5,4,5,3,5,5,4,3,5,5,5,5,4,5,1.6676187756655838,2.2,0,4.8,0,4.2,0,4.4,0,4.466666666666667,0,1,1,2,2,2,1,2,3,3,1,1,2,1,2,1,3,1,1,2,2,0.7326950970650465,1.7,0,1,1,2,2,2,1,2,3,3,1,1,2,1,2,1,3,1,1,2,2,0.7326950970650465,1.7,0,NA,NA,"White, Caucasian, Anglo, European American & Middle Eastern",1,25,1,3,NA,1,2,7,Graduate Student,4,175,66,3,5,2,0,0,1,0,0,NA,NA,TRUE,TRUE,TRUE,TRUE,TRUE,5,0.5300193548387577,0.48188749999878927,0.5136468750007916,0.59721666666617,0.5413062499994412,0.6086718750002328,0.96875,1,1,0.967741935483871,1,1,0.129,0.31,0.635,0.018,1.814,63.54068982229072,1855.2863339172611,0.132,0.305,0.65,0.019,1.905,70.0512247042601,1855.559632572621,316,0.9362962962962963,0,3,0,0,3,FALSE
230,2022-03-18T18:01:39Z,2022-03-18T18:32:20Z,1840,1,2022-03-18T18:32:22Z,0.8999999761581421,Chrome,99.0.4844.74,Macintosh,1440,900,NA,1.6,601,184,622,146,65,136,-0.15832812633661417,0.36366271440731524,0.7631096258125772,0.5883987871450372,0.0826962238969594,0.4218480813714895,2,1,1,1,2,1,2,2,1,2,2,1,2,1,1,1,1,1,2,2,1.164157703189193,0,1,1,3,2,1.45,0,3,2,3,3,5,3,2,3,1,2,2,2,1,3,3,3,2,1,2,1,1,2,1,5,1,1,0,1,0,3,4,2,2,3,2,3,4,1,4,2,2,1,2,1,2,4,4,3,2,1,1,1,1,1,2,1,2,4,4,2,3,3,2,2,3,1,2,2,3,3,1.2615829705538957,1.0997835284835873,1.625,0,2.5,0,2.533333333333333,0,2.6666666666666665,0,2.3333333333333335,0,1.1666666666666667,0,2.857142857142857,0,2,0,2.2972972972972974,0,3,0,0,-0.08421777171963009,0.5540623560092959,0.2349222921448329,2,1,3,1,1,1,1,1,1,1.2535663410560174,1.4285714285714286,0,1,-0.7112905515642753,5,4,4,4,2,2,3,6,4,NA,2,1.1338934190276817,5,3.4285714285714284,0,-0.3749142363789111,1,-0.235645176064743,2,3,2,2,2,4,4,4,4,2,4,4,4,4,4,3,4,4,3,1,1.0690449676496976,2.2,0,4,0,3.2,0,3.4,0,3.533333333333333,0,1,1,1,1,2,1,1,2,1,1,1,2,1,1,1,1,1,1,1,1,1.050062654772261,1.15,0,1,1,1,1,2,1,1,2,1,1,1,2,1,1,1,1,1,1,1,1,1.050062654772261,1.15,0,NA,NA,"White, Caucasian, Anglo, European American",0,19,1,2,NA,1,3,4,Student,4,195,65,2,5,2,0,0,0,0,0,NA,NA,TRUE,TRUE,TRUE,TRUE,TRUE,4,0.6040406250002561,0.5845129032258786,0.5562806451615067,0.6710531250004423,0.6069838709682226,0.6614966666664929,1,1,1,1,1,0.9375,0.074,0.377,0.4,0.01,1.466,53.25219200281214,1903.818194319351,0.074,0.378,0.447,0.01,1.525,56.06149796192951,1900.9247185661443,420,1.2444444444444445,0,3,0,0,3,FALSE
231,2022-03-18T18:10:36Z,2022-03-18T18:32:32Z,1315,1,2022-03-18T18:32:33Z,0.8999999761581421,Chrome,99.0.4844.74,Windows NT 10.0,1536,864,NA,1.7777777777777777,645,63,306,109,56,68,-0.06801940804175581,-0.30330996519962966,-0.38332914835430587,0.13283602745312004,-0.10160780960546556,-0.3419715215851719,2,2,1,1,2,1,1,3,1,2,2,1,1,1,2,2,1,1,2,2,0.998683343734455,0,1,1,4,4,1.55,0,2,2,2,2,1,1,3,2,4,1,3,3,2,3,5,2,3,1,1,1,3,2,1,2,2,0,0,0,0,5,3,5,3,5,1,2,2,5,1,2,2,1,5,3,2,3,1,2,3,4,3,2,3,1,3,1,1,2,1,1,3,2,2,2,3,1,2,1,1,1,1.18802837146737,1.1872336794093274,1.75,0,1.25,0,2.4,0,3.4444444444444446,0,2.4166666666666665,0,2.1666666666666665,0,1.7142857142857142,0,2,0,2.4594594594594597,0,1,0,0,-0.016993948404069408,-0.3151752203835423,-0.16608458439380586,1,1,3,1,1,1,1,1,1,1.5735915849388864,1.2857142857142858,0,1,-0.7941589286438315,4,3,3,2,1,1,2,2,1,2,2,1.2724180205607036,1.5,2.2857142857142856,0,-1.1488460643479235,0,-1.3268107202973467,1,1,1,1,1,5,4,5,5,3,5,5,5,4,4,5,5,4,4,4,1.5946338585572373,1,0,4.8,0,4.2,0,4.4,0,4.466666666666667,0,1,1,1,1,2,1,1,1,1,2,1,2,2,1,1,2,1,1,1,2,1.0310954828418375,1.3,0,1,1,1,1,2,1,1,1,1,2,1,2,2,1,1,2,1,1,1,2,1.0310954828418375,1.3,0,I lived with my mother and father an equal amount of time (joint custody),0,"White, Caucasian, Anglo, European American",0,23,1,2,NA,1,3,3,Cashier,4,180,65,2,5,2,0,0,0,0,0,I lived with my mother and father an equal amount of time (joint custody),0,TRUE,TRUE,TRUE,TRUE,TRUE,5,0.6139750000005588,0.5069250000016764,0.6019937499994412,0.6804161290372571,0.6010937499981374,0.7247562500005588,1,1,1,1,1,1,0.089,0.414,0.457,0.013,1.573,57.03061986825104,1850.9079087909322,0.094,0.408,0.501,0.012,1.606,63.500882620261244,1846.2429280720182,360,1.0666666666666667,0,3,0,3,6,FALSE
232,2022-03-18T17:59:28Z,2022-03-18T18:32:39Z,1990,1,2022-03-18T18:32:39Z,1,Chrome,99.0.4844.51,Macintosh,1680,1050,N/A,1.6,962,108,632,69,40,82,0.5826138578552919,-0.055262274436716274,0.7993893338558331,-0.35966425329489854,-0.42925942472088774,-0.18471454450585928,3,3,1,1,3,1,1,3,1,3,3,2,1,1,3,3,1,1,3,2,0.5982430416161189,0,0,2,3,2,2,0,4,2,3,2,3,2,3,3,1,3,3,4,1,4,3,1,3,2,1,3,4,4,3,1,2,0,0,0,0,1,4,4,2,4,1,2,1,2,5,3,2,1,4,3,1,3,5,5,5,5,5,5,1,1,1,1,1,1,1,1,2,1,1,1,1,1,1,1,1,1,1.7137493798501977,0.9102589898327995,2.625,0,1,0,2.7333333333333334,0,2.3333333333333335,0,3.5,0,2.3333333333333335,0,1.1428571428571428,0,1,0,2.3783783783783785,0,1,0,0,0.4756198666682322,-0.4013584353189139,0.03713071567465914,2,1,2,1,1,2,1,3,1,1.4142135623730951,1.4285714285714286,0,2,-0.324785349076635,5,5,5,5,3,3,5,7,4,3,3,1.5735915849388864,5.5,4.428571428571429,0,0.13225096815561946,0,0.6154854502055671,1,1,1,2,2,5,4,5,5,2,5,5,3,3,4,3,5,5,3,2,1.486446705914413,1.4,0,5,0,3,0,3.8,0,3.933333333333333,0,1,1,1,1,1,1,1,3,1,1,1,2,1,1,1,3,1,1,1,1,0.812727700887249,1.25,0,1,1,1,1,1,1,1,3,1,1,1,2,1,1,1,3,1,1,1,1,0.812727700887249,1.25,0,I lived with my mother and father an equal amount of time (joint custody),0,Black or African American,0,21,1,2,NA,1,3,4,Student,4,157,65,1,5,2,1,1,1,0,2,I lived with my mother and father an equal amount of time (joint custody),0,TRUE,TRUE,TRUE,TRUE,TRUE,3,0.521599999997885,0.4346968750022352,0.46584062499925494,0.6274600000003974,0.4883645161294168,0.5412000000005768,0.96875,1,1,0.967741935483871,0.96875,0.96875,0.063,0.36,0.628,0.016,1.565,63.5959154450794,1889.8584741098784,0.068,0.362,0.672,0.019,1.723,63.64365129884743,1892.0989311526855,392,1.1614814814814816,0,3,0,0,3,FALSE
233,2022-03-18T17:41:47Z,2022-03-18T18:33:38Z,3109,1,2022-03-18T18:33:38Z,0.699999988079071,Chrome,99.0.4844.74,Windows NT 10.0,1024,768,No feedback thankyou,1.3333333333333333,1149,402,862,382,88,99,0.9664259106084399,1.5653159718809846,1.6338226188507163,3.4941504435583473,0.5536954206253788,0.006240356233306075,2,2,2,2,3,2,2,3,1,2,2,2,2,2,2,2,2,2,2,2,0.5871429486123998,0,0,2,5,5,2.05,0,5,1,4,2,4,2,5,5,5,4,5,4,3,4,1,4,5,3,1,4,5,5,4,3,2,0,0,0,0,1,2,3,2,1,1,1,1,3,3,2,5,2,2,5,1,5,5,5,5,5,4,1,1,1,1,1,1,3,3,1,2,2,1,1,1,5,1,1,1,1,1.677442640990688,1.505545305418162,3.875,0,1,0,3.6,0,1.6666666666666667,0,3.75,0,1.5,0,1.8571428571428572,0,2.3333333333333335,0,2.4054054054054053,0,2,0,0,1.4124227221843486,-0.18219768446092388,0.6151125188617124,2,2,3,2,1,1,1,1,1,1.1547005383792515,1.7142857142857142,0,1,-0.5455537974051633,5,5,5,5,4,4,5,6,3,1,3,1.4638501094227998,4.5,4.714285714285714,0,-0.47659222707162213,0,0.3992170528426958,3,3,3,2,3,4,4,4,4,2,5,4,3,5,4,4,4,4,4,2,1.1952286093343936,2.8,0,4.2,0,3.4,0,3.8,0,3.8,0,1,2,1,1,2,2,1,1,1,2,1,2,1,3,3,2,1,2,2,1,1.025978352085154,1.6,0,1,2,1,1,2,2,1,1,1,2,1,2,1,3,3,2,1,2,2,1,1.025978352085154,1.6,0,I lived with my mother and father an equal amount of time (joint custody),0,"White, Caucasian, Anglo, European American",0,21,0,1,NA,1,2,1,Doordash delivery driver,1,180,72,2,5,2,1,1,4,0,2,I lived with my mother and father an equal amount of time (joint custody),0,TRUE,TRUE,TRUE,TRUE,TRUE,4,0.7828451612889766,0.9047935483840204,0.9911562499981373,0.8053343750000932,0.7395906249987892,1.131796875001397,1,1,1,1,1,1,NA,NA,NA,NA,NA,NA,NA,NA,NA,NA,NA,NA,NA,NA,338,1.0014814814814814,0,3,0,6,9,FALSE
234,2022-03-18T18:05:24Z,2022-03-18T18:33:51Z,1706,1,2022-03-18T18:33:52Z,1,Chrome,98.0.4758.82,Windows NT 6.1,1920,1080,none,1.7777777777777777,590,135,489,92,61,262,-0.18090530591032875,0.09356634002103176,0.2805895088372752,-0.07647659186478786,7.833201181038607e-4,1.837160875085303,4,4,3,3,4,2,3,3,2,4,3,3,3,2,4,4,3,2,3,4,0.8255779474818965,0,1,2,3,3,3.15,0,1,2,3,2,3,2,1,2,1,2,1,1,2,2,2,2,1,2,1,1,1,1,1,0,2,0,0,0,0,1,1,1,1,1,1,1,1,1,1,2,1,1,1,2,1,2,1,1,1,1,2,1,1,1,2,1,1,1,1,1,1,1,2,1,1,1,1,1,1,1,1.849031886939465,1.4074631010979937,1.25,0,1,0,1.8,0,1,0,1.25,0,1.3333333333333333,0,1.1428571428571428,0,1,0,1.162162162162162,0,0,0,0,-1.0646226092691196,-0.6205191861769039,-0.8425708977230117,1,1,3,2,1,1,1,2,2,1.5275252316519468,1.4285714285714286,0,2,-0.324785349076635,5,5,5,5,3,4,5,6,10,3,3,1.5275252316519468,8,4.571428571428571,0,0.5839705036044629,0,0.9682588484512327,2,2,2,2,2,4,4,4,4,3,4,4,3,4,4,5,5,4,4,3,1.1338934190276817,2,0,4.2,0,3.8,0,3.8,0,3.933333333333333,0,1,1,3,2,2,3,3,3,1,2,3,3,3,1,1,3,1,2,1,4,0.9445132413883326,2.15,0,1,1,3,2,2,3,3,3,1,2,3,3,3,1,1,3,1,2,1,4,0.9445132413883326,2.15,0,"I lived with my mother, but not father, most of the time.",0,"White, Caucasian, Anglo, European American",0,27,0,1,NA,1,2,6,College tutor/Gig worker,2,180,75,1,5,2,0,1,1,0,1,"I lived with my mother, but not father, most of the time.",0,TRUE,TRUE,TRUE,TRUE,TRUE,4,0.8129451612964753,0.5690156250447035,0.6407781249880791,0.8954333333333333,0.6502466666698455,0.8051406249850989,0.96875,1,1,0.967741935483871,0.9375,1,NA,NA,NA,NA,NA,NA,NA,NA,NA,NA,NA,NA,NA,NA,343,1.0162962962962963,0,3,0,0,3,FALSE
236,2022-03-18T18:09:48Z,2022-03-18T18:36:11Z,1583,1,2022-03-18T18:36:13Z,1,Chrome,99.0.4844.51,Macintosh,1440,900,NA,1.6,475,64,235,70,51,72,-0.41693945599916304,-0.2977977942937871,-0.640915075461422,-0.3473517462761981,-0.20399893932903498,-0.2970409567053683,1,1,1,1,1,1,1,1,1,1,1,1,1,1,1,1,1,1,1,1,1.538967528127731,0,1,1,3,3,1,0,1,1,2,1,2,1,1,1,1,1,1,2,1,1,2,1,2,1,1,1,2,1,1,4,1,1,0,0,0,1,2,1,2,3,1,4,1,2,1,1,1,1,2,1,1,1,1,2,2,1,1,1,1,1,1,1,1,4,4,1,1,1,1,1,2,1,2,1,2,2,1.7098021591469066,1.8464895909600492,1.25,0,1.75,0,1.2666666666666666,0,1.8888888888888888,0,1.25,0,1,0,1.8571428571428572,0,1.3333333333333333,0,1.4864864864864864,0,2,0,0,-1.1559603955602478,0.07635196034519101,-0.5398042176075284,1,1,2,1,1,2,1,1,1,1.6761634196950514,1.2857142857142858,0,1,-0.7941589286438315,4,4,4,4,3,3,5,7,6,NA,3,1.1126972805283737,6.5,3.857142857142857,0,0.54803547341736,1,0.5592210744691719,2,2,3,3,3,3,3,4,4,4,5,2,3,4,4,2,3,4,2,1,1.0997835284835873,2.6,0,3.4,0,2.8,0,3.4,0,3.2,0,2,1,2,2,3,1,2,2,1,1,2,2,1,2,1,2,2,2,1,2,0.7880689256524124,1.7,0,2,1,2,2,3,1,2,2,1,1,2,2,1,2,1,2,2,2,1,2,0.7880689256524124,1.7,0,I lived with my mother and father an equal amount of time (joint custody),0,"Asian or Asian American (e.g., Chinese, Japanese, and others)",0,24,1,2,NA,1,3,6,Veterinary assistant,2,135,62,3,5,2,0,0,1,0,0,I lived with my mother and father an equal amount of time (joint custody),0,TRUE,TRUE,TRUE,TRUE,TRUE,5,0.500109677416663,0.45821562498807905,0.4688249999973923,0.5663999999995742,0.531364516135185,0.5532607142903975,0.96875,1,1,0.875,0.96875,0.9032258064516129,NA,NA,NA,NA,NA,NA,NA,NA,NA,NA,NA,NA,NA,NA,436,1.2918518518518518,0,3,0,3,6,FALSE
237,2022-03-18T17:45:56Z,2022-03-18T18:36:30Z,3034,1,2022-03-18T18:36:32Z,0.8999999761581421,Chrome,99.0.4844.74,Windows NT 10.0,1366,768,Very informative survey!,1.7786458333333333,718,103,639,147,69,201,0.08181096549289554,-0.08282312896592887,0.8247851294861122,0.6007112941637377,0.16460912767581495,1.1519697606682981,2,2,1,1,2,1,1,2,1,2,2,1,1,1,2,2,1,1,2,2,1.025978352085154,0,1,1,4,3,1.5,0,4,2,3,3,4,3,2,3,4,3,4,3,4,3,3,3,3,1,2,3,3,3,3,5,1,1,0,0,0,3,3,3,3,3,2,2,2,2,3,3,3,3,4,3,4,4,4,3,5,5,3,1,1,1,4,2,3,4,4,2,3,3,3,2,3,2,3,1,2,3,0.9856325235459062,0.6172133998483676,2.625,0,2.25,0,3.2,0,2.5555555555555554,0,3.6666666666666665,0,2,0,3.142857142857143,0,2.3333333333333335,0,2.918918918918919,0,3,0,0,0.9157735092263403,0.46787914107392425,0.6918263251501322,2,2,3,2,1,2,2,4,1,0.9511897312113419,2,0,2.5,0.1999407604854096,4,4,4,4,3,3,4,4,8,5,4,0.7867957924694432,6,3.7142857142857144,0,0.9950183415546338,0,0.7542538291725602,3,2,3,2,3,3,4,4,4,3,4,4,4,3,3,4,4,5,4,4,0.9611501047232549,2.6,0,4,0,3.8,0,3.6,0,3.8,0,3,2,3,3,2,3,4,3,3,3,2,3,3,4,3,3,3,4,3,4,0.7451598203705946,3.05,0,3,2,3,3,2,3,4,3,3,3,2,3,3,4,3,3,3,4,3,4,0.7451598203705946,3.05,0,I lived with my mother and father an equal amount of time (joint custody),0,"White, Caucasian, Anglo, European American",0,21,0,1,NA,1,2,4,Stocking Associate (Retail),2,180,69,2,5,2,1,1,1,0,2,I lived with my mother and father an equal amount of time (joint custody),0,TRUE,TRUE,TRUE,TRUE,TRUE,5,0.47573750000447035,0.4177343749925494,0.4709406249932945,0.5258851851931324,0.49093000000317893,0.5675677419247166,1,1,1,0.84375,0.9375,0.96875,NA,NA,NA,NA,NA,NA,NA,NA,NA,NA,NA,NA,NA,NA,358,1.0607407407407408,0,3,0,0,3,FALSE
238,2022-03-18T18:17:21Z,2022-03-18T18:36:32Z,1151,1,2022-03-18T18:36:33Z,0.8999999761581421,Firefox,98.0,Windows NT 6.1,1920,1080,NA,1.7777777777777777,632,63,241,53,27,60,-0.09470152935614577,-0.30330996519962966,-0.6191472506354685,-0.5566643655941059,-0.6954763620021682,-0.43183265134477916,2,3,1,1,2,1,1,3,1,2,3,1,1,1,2,3,1,1,2,3,0.8506963092234007,0,1,1,3,3,1.75,0,2,2,1,1,1,1,2,2,1,1,1,2,1,2,2,1,1,1,1,1,1,1,1,1,2,0,0,0,0,2,3,2,2,2,1,2,1,3,2,2,1,1,3,1,3,1,1,1,1,1,2,1,1,1,1,1,1,2,2,2,1,1,2,1,1,1,1,2,2,2,1.4415540496554675,1.5976172734359604,1,0,1.75,0,1.4666666666666666,0,2,0,1.5,0,1.1666666666666667,0,1.5714285714285714,0,1,0,1.5405405405405406,0,1,0,0,-1.1541887574640834,-0.14280879051279902,-0.6484987739884412,2,2,3,1,2,3,2,1,1,0.9759000729485332,2.142857142857143,0,1,-0.29694866616649496,5,4,5,5,1,1,5,5,9,2,3,2.0354009783964297,7,3.7142857142857144,0,0.18920499890107342,0,0.26306842066289526,2,2,1,2,1,4,3,3,5,2,5,3,5,1,1,4,4,5,2,3,1,1.6,0,4.2,0,3.2,0,2.6,0,3.3333333333333335,0,1,1,1,2,1,1,1,4,1,1,2,1,1,1,1,2,1,1,1,1,0.8825799501580878,1.3,0,1,1,1,2,1,1,1,4,1,1,2,1,1,1,1,2,1,1,1,1,0.8825799501580878,1.3,0,"I lived with my mother, but not father, most of the time. & I lived with my extended family on mother's side (grandparents, aunts ,uncles, cousins)",1,"Asian or Asian American (e.g., Chinese, Japanese, and others)",0,26,0,1,NA,1,3,6,Support Associate,3,133,67,2,5,2,0,0,1,0,0,"I lived with my mother, but not father, most of the time. & I lived with my extended family on mother's side (grandparents, aunts ,uncles, cousins)",1,TRUE,TRUE,TRUE,TRUE,TRUE,6,0.5616875,0.4625,0.5656875,0.5814516129032258,0.5767931034482758,0.5856774193548387,1,1,1,0.96875,0.9354838709677419,1,NA,NA,NA,NA,NA,NA,NA,NA,NA,NA,NA,NA,NA,NA,355,1.0518518518518518,0,3,0,3,9,FALSE
239,2022-03-18T18:15:26Z,2022-03-18T18:40:40Z,1514,1,2022-03-18T18:40:42Z,0.8999999761581421,Edge,99.0.1150.39,Windows NT 10.0,1920,1080,No,1.7777777777777777,681,94,449,98,60,78,0.005869543290401025,-0.13243266711851154,0.13547067666425203,-0.002601549752585081,-0.019694905826610026,-0.22964510938566288,3,3,2,1,3,1,3,3,2,3,3,3,1,2,3,3,3,1,3,4,0.6407232755171874,0,1,1,5,5,2.5,0,1,1,1,2,1,1,4,1,1,1,1,1,1,3,4,5,1,1,1,1,3,1,3,3,2,0,0,0,0,3,4,1,4,5,3,3,1,5,2,1,1,1,1,1,1,2,3,4,1,5,1,1,3,1,3,1,1,2,2,1,1,1,1,1,1,3,1,2,1,3,1.5744773669313188,1.6676187756655838,2,0,1.75,0,1.6,0,3.2222222222222223,0,1.9166666666666667,0,1.6666666666666667,0,1.2857142857142858,0,1.6666666666666667,0,2.054054054054054,0,2,0,0,-0.4345099930667472,0.07635196034519101,-0.1790790163607781,1,1,1,1,1,1,1,1,3,1.9518001458970664,1,0,2,-0.5733904803153034,5,5,5,5,5,5,5,7,6,6,4,1.5118578920369088,6.5,5,0,1.2994399391682545,0,1.6366550123507146,2,1,2,2,2,4,5,3,3,3,4,3,4,5,5,3,4,5,3,1,1.2798809468443688,1.8,0,4,0,3.6,0,3.4,0,3.6666666666666665,0,3,1,3,3,4,3,4,3,2,4,1,3,2,1,2,3,1,2,1,4,1.0809352675491624,2.5,0,3,1,3,3,4,3,4,3,2,4,1,3,2,1,2,3,1,2,1,4,1.0809352675491624,2.5,0,I lived with my mother and father an equal amount of time (joint custody),0,"White, Caucasian, Anglo, European American",0,26,1,3,NA,1,2,5,student,7,127,62,3,5,2,0,0,1,0,0,I lived with my mother and father an equal amount of time (joint custody),0,TRUE,TRUE,TRUE,TRUE,TRUE,4,0.591309374999255,0.52665625,0.5771687500011176,0.6447870967791927,0.5600593750011176,0.6344843749962747,1,1,1,1,1,1,NA,NA,NA,NA,NA,NA,NA,NA,NA,NA,NA,NA,NA,NA,530,1.5703703703703704,0,3,0,0,3,FALSE
240,2022-03-18T18:18:40Z,2022-03-18T18:42:07Z,1406,1,2022-03-18T18:42:09Z,0.800000011920929,Chrome,99.0.4844.51,Macintosh,1920,1080,N/A,1.7777777777777777,621,86,361,130,41,60,-0.11727870892986036,-0.1765300343652517,-0.18379075411639897,0.3913986748458298,-0.40878119877617386,-0.43183265134477916,2,2,1,1,2,1,1,3,1,3,2,1,1,1,2,2,1,1,3,2,0.9333020044867296,0,0,4,5,5,1.65,0,1,1,2,2,1,1,3,1,2,1,1,1,1,2,1,1,2,1,1,1,1,1,1,3,2,0,0,0,0,1,1,1,1,1,1,1,1,1,2,1,1,1,1,1,1,1,1,1,1,2,1,1,1,1,3,2,1,3,2,1,1,2,2,1,2,1,2,1,2,2,1.8079736637376023,1.7511900715418263,1.125,0,1.75,0,1.4,0,1,0,1.1666666666666667,0,1.5,0,1.7142857142857142,0,1.3333333333333333,0,1.2972972972972974,0,2,0,0,-1.2349951395169028,0.07635196034519101,-0.5793215895858559,3,2,5,2,1,3,3,4,3,0.8997354108424374,2.7142857142857144,0,3.5,1.0007878483708306,3,3,5,2,1,1,2,6,4,2,1,1.4960264830861913,5,2.4285714285714284,0,-0.8607067999810839,0,-1.0737480590456197,2,2,2,3,3,2,3,2,3,4,3,2,4,5,4,5,3,3,3,1,1.0997835284835873,2.4,0,2.6,0,3.8,0,3,0,3.1333333333333333,0,1,1,3,3,2,4,3,3,4,1,1,3,1,3,1,3,1,3,3,3,1.0399898784932577,2.35,0,1,1,3,3,2,4,3,3,4,1,1,3,1,3,1,3,1,3,3,3,1.0399898784932577,2.35,0,I lived with my mother and father an equal amount of time (joint custody),0,Black or African American,0,30,0,1,NA,1,3,4,Photographer/Business Owner,4,255,70,4,5,2,0,0,1,0,0,I lived with my mother and father an equal amount of time (joint custody),0,TRUE,TRUE,TRUE,TRUE,TRUE,5,0.5012806451628286,0.4382656249944121,0.4702312499955297,0.526643750006333,0.49264193548310187,0.526503125011921,1,1,1,1,1,1,NA,NA,NA,NA,NA,NA,NA,NA,NA,NA,NA,NA,NA,NA,304,0.9007407407407407,1,3,0,0,3,FALSE
241,2022-03-18T18:15:59Z,2022-03-18T18:42:09Z,1570,1,2022-03-18T18:42:10Z,1,Firefox,98.0,Windows NT 10.0,1536,864,NA,1.7777777777777777,568,112,529,90,62,109,-0.22605966505775793,-0.03321359081334619,0.4257083410102984,-0.10110160590218879,0.021261546062817747,0.1185667684328151,3,1,1,1,2,1,1,3,1,3,3,1,1,1,2,2,1,1,2,3,0.9514531821875089,0,0,4,5,5,1.7,0,3,3,2,2,4,4,2,3,1,3,4,3,2,4,3,3,1,1,1,2,2,4,2,2,1,1,0,1,0,1,2,2,3,4,1,2,3,1,2,2,1,1,2,1,1,4,2,1,1,2,1,1,3,1,5,4,1,4,4,4,4,4,4,1,3,1,4,1,1,1,1.4997497288712036,0.9258200997725514,2,0,1.75,0,2.8666666666666667,0,2.111111111111111,0,1.6666666666666667,0,2.5,0,3.5714285714285716,0,1.6666666666666667,0,2.27027027027027,0,1,0,0,0.2135158527746176,-0.14280879051279902,0.03535353113090929,2,2,2,1,1,2,1,1,1,1.3451854182690985,1.5714285714285714,0,1,-0.6284221744847194,4,3,5,3,1,1,1,4,4,2,2,1.6761634196950514,4,2.5714285714285716,0,-0.69712652889908,0,-0.8966106236020089,2,2,1,1,2,5,4,5,5,3,5,5,5,4,4,5,5,5,3,5,1.6388149028228556,1.6,0,5,0,4,0,4.6,0,4.533333333333333,0,2,3,1,2,2,1,4,2,1,1,2,2,2,2,1,2,2,1,1,2,0.9176629354822471,1.8,0,2,3,1,2,2,1,4,2,1,1,2,2,2,2,1,2,2,1,1,2,0.9176629354822471,1.8,0,I lived with my mother and father an equal amount of time (joint custody),0,"White, Caucasian, Anglo, European American",0,22,1,2,NA,1,3,4,None currently,3,115,64,2,5,2,0,0,0,0,0,I lived with my mother and father an equal amount of time (joint custody),0,TRUE,TRUE,TRUE,TRUE,TRUE,2,0.4866875,0.42170967741935483,0.4893125,0.5468666666666666,0.50521875,0.5334193548387097,1,0.96875,1,0.9375,1,0.96875,NA,NA,NA,NA,NA,NA,NA,NA,NA,NA,NA,NA,NA,NA,391,1.1585185185185185,0,3,0,0,3,FALSE
242,2022-03-18T18:21:08Z,2022-03-18T18:42:39Z,1291,1,2022-03-18T18:42:40Z,0.8999999761581421,Firefox,98.0,Windows NT 10.0,1920,1080,NA,1.7777777777777777,596,61,352,72,52,91,-0.1685904806883026,-0.3143343070113147,-0.2164424913553292,-0.32272673223879716,-0.1835207133843211,-0.08362077352630115,1,2,1,1,2,1,1,2,1,1,2,1,1,2,2,2,1,1,2,2,1.1367080817685316,0,0,3,3,3,1.45,0,2,2,3,2,2,2,1,2,3,1,5,2,1,2,2,5,4,4,1,1,3,3,2,5,2,0,0,0,0,1,2,2,4,2,1,5,5,4,2,1,1,1,2,2,1,2,1,1,1,2,5,1,5,4,3,1,1,5,4,1,2,2,2,1,1,1,3,3,3,4,1.5744773669313188,1.3201731488169053,2.875,0,3.25,0,2.1333333333333333,0,2.888888888888889,0,1.4166666666666667,0,3.1666666666666665,0,2.4285714285714284,0,1,0,2.2162162162162162,0,3,0,0,0.2518029205194978,0.8126120008154107,0.5322074606674543,2,1,3,1,1,2,1,3,1,1.2149857925879117,1.5714285714285714,0,2,-0.24191697199707893,2,4,2,2,1,1,2,4,2,2,1,1.2535663410560174,3,2,0,-1.2220824283401586,0,-1.5263055142314306,2,1,1,3,2,5,5,4,5,3,5,4,2,3,4,2,5,4,2,5,1.4735767952260144,1.8,0,4.6,0,2.8,0,4.2,0,3.8666666666666667,0,1,1,3,4,3,2,2,4,2,2,1,2,3,2,1,2,1,2,1,3,0.8522416262267903,2.1,0,1,1,3,4,3,2,2,4,2,2,1,2,3,2,1,2,1,2,1,3,0.8522416262267903,2.1,0,"I lived with my mother, but not father, most of the time.",0,"White, Caucasian, Anglo, European American",0,22,0,1,NA,1,3,5,Student,4,150,72,1,5,2,1,0,1,0,1,"I lived with my mother, but not father, most of the time.",0,TRUE,TRUE,TRUE,TRUE,TRUE,3,0.616516129032258,0.58021875,0.63990625,0.71071875,0.6875333333333333,0.7731333333333333,0.96875,1,1,1,0.9375,0.9375,NA,NA,NA,NA,NA,NA,NA,NA,NA,NA,NA,NA,NA,NA,345,1.0222222222222224,0,3,0,3,6,FALSE
243,2022-03-18T18:28:26Z,2022-03-18T18:43:15Z,888,1,2022-03-18T18:43:16Z,0.8999999761581421,Chrome,99.0.4844.51,Windows NT 10.0,1280,720,NA,1.7777777777777777,547,54,135,21,24,62,-0.2691615533348494,-0.35291950335221234,-1.0037121558939799,-0.9506645901925208,-0.7569110398363099,-0.40936736890487735,2,1,4,3,2,2,3,2,2,3,3,2,1,3,2,3,3,3,1,2,0.7863975156570492,0,1,1,2,2,2.35,0,3,2,4,3,3,3,4,4,3,3,2,3,4,2,2,2,3,1,1,1,1,1,1,0,2,0,0,0,0,2,3,2,2,2,1,3,2,2,2,2,2,3,3,3,4,4,3,2,4,4,2,1,1,1,3,1,1,1,1,1,2,1,1,1,1,1,2,2,2,1,1.3445474360571321,0.7037315505489968,1.375,0,1.75,0,3,0,2.111111111111111,0,3,0,1.5,0,1.1428571428571428,0,1,0,2.027027027027027,0,0,0,0,-0.1076427643244671,-0.361969541370789,-0.23480615284762807,3,4,3,3,4,3,4,1,1,0.5345224838248488,3.4285714285714284,0,1,0.44886672754950985,3,4,4,4,3,3,4,7,8,6,4,0.7559289460184544,7.5,3.5714285714285716,0,1.480127753347792,0,0.9725267077723934,3,2,2,2,2,3,2,2,3,3,3,4,3,2,3,3,4,3,4,2,0.6761234037828132,2.2,0,3.4,0,3,0,2.4,0,2.933333333333333,0,3,2,2,2,2,3,3,4,1,1,3,3,2,2,2,3,1,2,1,1,0.7591546545162482,2.15,0,3,2,2,2,2,3,3,4,1,1,3,3,2,2,2,3,1,2,1,1,0.7591546545162482,2.15,0,I lived with my mother and father an equal amount of time (joint custody),0,"Asian or Asian American (e.g., Chinese, Japanese, and others)",0,22,0,1,NA,1,4,3,unemployed,6,160,68,4,5,2,0,0,1,0,0,I lived with my mother and father an equal amount of time (joint custody),0,TRUE,TRUE,TRUE,TRUE,TRUE,3,1.0674250000072643,0.5069032258054903,0.613674999997951,1.3250137931087922,0.5942333333273728,0.7985346153859909,1,1,1,0.90625,0.9375,0.8387096774193549,NA,NA,NA,NA,NA,NA,NA,NA,NA,NA,NA,NA,NA,NA,356,1.0548148148148149,0,3,0,0,3,FALSE
244,2022-03-18T18:14:32Z,2022-03-18T18:44:00Z,1767,1,2022-03-18T18:44:01Z,0.8999999761581421,Chrome,99.0.4844.74,Windows NT 10.0,1536,864,n/a,1.7777777777777777,773,143,520,107,74,80,0.1946968633614685,0.1376637072677719,0.3930566037713682,0.10821101341571909,0.2670002573993844,-0.2071798269457611,2,3,2,3,3,1,1,3,1,2,3,1,1,2,2,2,1,2,3,3,0.7591546545162482,0,1,2,5,4,2.05,0,3,2,2,2,1,1,3,2,2,1,2,3,4,3,2,2,4,1,1,2,3,2,2,3,2,0,0,0,0,1,2,1,1,2,2,3,3,2,2,2,1,1,2,2,1,2,2,1,1,3,3,1,1,1,2,2,1,3,3,2,1,1,2,1,1,1,1,2,2,2,1.4441556652887477,1.121223821162776,2.125,0,1.75,0,2.2,0,1.8888888888888888,0,1.6666666666666667,0,1.6666666666666667,0,1.8571428571428572,0,1,0,1.7027027027027026,0,2,0,0,-0.27122401520362055,0.07635196034519101,-0.09743602742921477,1,1,1,1,1,1,1,3,1,1.9518001458970664,1,0,2,-0.5733904803153034,4,4,4,5,2,3,5,6,6,5,4,1.3801311186847085,6,3.857142857142857,0,0.9950183415546338,0,0.8316805276222321,2,3,2,4,2,4,4,4,4,3,4,3,3,4,4,3,3,5,4,2,0.9611501047232549,2.6,0,3.8,0,3.4,0,3.6,0,3.6,0,2,2,1,2,2,2,3,2,1,1,3,2,2,2,1,3,1,2,2,3,0.7591546545162482,1.95,0,2,2,1,2,2,2,3,2,1,1,3,2,2,2,1,3,1,2,2,3,0.7591546545162482,1.95,0,I lived with my mother and father an equal amount of time (joint custody),0,"White, Caucasian, Anglo, European American",0,29,1,2,NA,1,3,6,Administrative,5,108,67,2,5,2,0,0,0,0,0,I lived with my mother and father an equal amount of time (joint custody),0,TRUE,TRUE,TRUE,TRUE,TRUE,5,0.515356249997858,0.4846500000008382,0.4533124999995343,0.593939285716308,0.5885161290312967,0.5949333333328918,1,1,1,0.9032258064516129,0.96875,0.8709677419354839,NA,NA,NA,NA,NA,NA,NA,NA,NA,NA,NA,NA,NA,NA,430,1.2740740740740741,0,3,3,15,18,FALSE
245,2022-03-18T18:10:42Z,2022-03-18T18:44:16Z,2013,1,2022-03-18T18:44:18Z,1,Safari,15.1,Macintosh,1440,900,no comments,1.6,722,162,526,127,73,98,0.09002084897424631,0.2423949544787798,0.41482442859732166,0.35446115378972837,0.24652203145467047,-0.004992284986644828,1,1,1,1,1,1,1,1,1,1,2,1,1,2,1,1,1,1,2,2,1.3917047478769187,0,1,1,5,4,1.2,0,2,2,2,3,1,2,2,2,1,2,1,2,2,1,1,3,2,1,1,2,1,2,1,4,1,2,0,2,0,1,1,1,1,2,1,1,1,1,2,2,1,2,1,2,1,3,3,2,2,3,1,1,1,1,3,2,1,3,3,2,1,1,2,1,1,1,2,2,2,2,1.6158932858054431,1.424279266355945,1.625,0,2,0,1.7333333333333334,0,1.1111111111111112,0,2,0,1.5,0,1.8571428571428572,0,1,0,1.5945945945945945,0,2,0,0,-0.7409049593644645,0.16253517528056266,-0.28918489204195097,1,2,3,1,1,1,1,2,1,1.5275252316519468,1.4285714285714286,0,1.5,-0.5180379503204552,4,3,4,3,2,2,4,3,4,NA,2,0.8997354108424374,3.5,3.142857142857143,0,-0.7814618182828701,1,-0.6383106027804811,3,3,4,2,3,3,4,4,4,3,5,3,1,5,4,4,2,5,3,1,1.3627702877384937,3,0,3.6,0,3,0,3.6,0,3.4,0,1,2,1,2,2,2,2,1,1,1,2,2,2,1,4,1,2,1,1,1,1.0760551736979407,1.6,0,1,2,1,2,2,2,2,1,1,1,2,2,2,1,4,1,2,1,1,1,1.0760551736979407,1.6,0,I lived with my mother and father an equal amount of time (joint custody),0,"Hispanic of Latino (e.g., Mexican American, Central American, and others)",0,19,1,2,NA,1,2,3,I'm a full time student,7,125,62,2,5,2,0,1,1,0,1,I lived with my mother and father an equal amount of time (joint custody),0,TRUE,TRUE,TRUE,TRUE,TRUE,5,0.6652187499999991,0.5874193548387097,0.6415483870967742,0.7904516129032183,0.6513124999999891,0.7675333333333392,1,1,0.96875,0.96875,1,0.967741935483871,NA,NA,NA,NA,NA,NA,NA,NA,NA,NA,NA,NA,NA,NA,436,1.2918518518518518,0,3,0,0,3,FALSE
246,2022-03-18T18:23:58Z,2022-03-18T18:44:40Z,1242,1,2022-03-18T18:44:41Z,0.8999999761581421,Safari,15.3,Macintosh,1440,900,:),1.6,541,164,273,60,39,71,-0.2814763785568755,0.25341929629046483,-0.50305218489705,-0.4704768164632027,-0.4497376506656016,-0.3082735979253192,2,2,1,1,3,1,1,3,1,1,4,1,1,1,2,2,1,1,3,2,1.0052493799000692,0,0,2,4,2,1.7,0,4,2,3,3,4,3,3,4,2,3,4,4,1,4,3,1,3,1,1,1,2,3,2,0,2,0,0,0,0,2,2,1,2,1,1,3,4,3,1,1,3,1,3,3,1,2,2,3,5,5,2,1,1,1,1,1,1,1,2,1,3,3,2,1,1,2,2,1,1,1,1.5102254072756096,0.9154754164341269,1.75,0,1.25,0,3.1333333333333333,0,2.111111111111111,0,2.5,0,1.1666666666666667,0,1.8571428571428572,0,1.3333333333333333,0,1.972972972972973,0,0,0,0,0.09087912678459027,-0.5343359712415323,-0.22172842222847103,3,3,2,2,3,4,2,3,1,0.816496580927726,2.7142857142857144,0,2,0.42103004463936994,5,4,4,3,1,1,2,3,3,3,2,1.5735915849388864,3,2.857142857142857,0,-0.6637366525547652,0,-0.721404349449154,4,4,4,5,3,3,5,3,3,2,4,3,1,3,3,5,4,3,4,4,1.0997835284835873,4,0,3.4,0,3.4,0,3.2,0,3.3333333333333335,0,1,2,1,2,2,2,2,2,1,2,2,3,3,3,2,3,3,3,1,2,0.7181848464596079,2.1,0,1,2,1,2,2,2,2,2,1,2,2,3,3,3,2,3,3,3,1,2,0.7181848464596079,2.1,0,I lived with my mother and father an equal amount of time (joint custody),0,"White, Caucasian, Anglo, European American",0,21,1,2,NA,1,3,4,student,5,180,68,2,5,2,0,0,0,0,0,I lived with my mother and father an equal amount of time (joint custody),0,TRUE,TRUE,TRUE,TRUE,TRUE,4,0.5932903225806508,0.47329032258064563,0.49840625000000366,0.6683124999999909,0.5016874999999995,0.5882000000000001,0.96875,1,1,1,1,0.9375,NA,NA,NA,NA,NA,NA,NA,NA,NA,NA,NA,NA,NA,NA,426,1.2622222222222224,0,3,0,0,3,FALSE
247,2022-03-18T18:17:01Z,2022-03-18T18:45:12Z,1690,1,2022-03-18T18:45:13Z,0.8999999761581421,Chrome,99.0.4844.74,Windows NT 10.0,1536,864,NA,1.7777777777777777,485,70,410,73,38,78,-0.3964147472957862,-0.26472476885873203,-0.0060201847044455805,-0.3104142252200967,-0.4702158766103155,-0.22964510938566288,1,1,1,1,1,1,1,1,1,1,1,1,1,1,1,1,1,1,1,1,1.538967528127731,0,0,2,4,4,1,0,2,2,1,3,2,1,3,1,2,1,1,2,2,3,4,2,2,1,1,1,1,1,1,2,2,0,0,0,0,2,3,2,1,1,1,2,2,1,1,1,1,1,2,2,1,2,1,1,1,1,1,1,1,1,2,1,1,2,2,1,2,2,1,1,2,1,2,1,2,2,1.6265440804496034,1.162919151265879,1.25,0,1.75,0,2,0,1.6666666666666667,0,1.25,0,1.1666666666666667,0,1.5714285714285714,0,1.3333333333333333,0,1.4054054054054055,0,1,0,0,-0.8709235107551757,-0.14280879051279902,-0.5068661506339873,3,2,4,1,1,1,1,1,1,0.7867957924694432,1.8571428571428572,0,1,-0.4626854203256071,3,3,3,3,1,1,3,2,4,1,2,0.9759000729485332,3,2.4285714285714284,0,-1.0918920336024696,0,-1.2146675591419873,2,1,3,1,2,4,1,4,5,1,2,3,5,4,5,1,3,3,1,1,1.5796322658258457,1.8,0,3,0,1.8,0,3.8,0,2.8666666666666667,0,1,1,1,1,1,1,2,1,1,1,1,1,1,1,1,1,1,1,1,1,1.2258187382102494,1.05,0,1,1,1,1,1,1,2,1,1,1,1,1,1,1,1,1,1,1,1,1,1.2258187382102494,1.05,0,I lived with my mother and father an equal amount of time (joint custody),0,"White, Caucasian, Anglo, European American",0,29,0,1,NA,1,2,3,supervisor assistant,2,160,72,2,5,2,0,0,1,0,0,I lived with my mother and father an equal amount of time (joint custody),0,TRUE,TRUE,TRUE,TRUE,TRUE,1,0.6003187499996274,0.4828000000016764,0.5317999999998138,0.6314999999980773,0.5562066666657726,0.5707032258073168,1,1,1,1,0.9375,0.96875,0.07,0.38,0.514,0.025,1.941,81.97498549673783,1933.743234787549,0.069,0.382,0.543,0.025,2.041,92.79307962784033,1918.6889382367092,346,1.0251851851851852,0,3,0,0,3,FALSE
248,2022-03-18T18:20:39Z,2022-03-18T18:45:52Z,1512,1,2022-03-18T18:45:52Z,0.8999999761581421,Firefox,98.0,Windows NT 10.0,1920,1080,Survey was very very long,1.7777777777777777,648,93,459,95,63,65,-0.061861995430742736,-0.13794483802435406,0.1717503847075078,-0.039539070808686475,0.04173977200753163,-0.3756694452450246,3,1,4,4,3,1,1,2,1,3,2,4,2,1,3,3,3,1,2,3,1.0894228312566052,0,1,1,4,3,2.35,0,2,1,1,1,2,1,1,1,1,1,1,2,2,1,2,1,1,1,1,1,1,1,2,0,2,0,0,0,0,2,1,1,1,1,1,1,1,1,1,1,1,1,2,1,1,2,1,1,1,1,1,1,1,1,2,1,1,2,1,1,1,1,1,1,1,1,1,1,2,2,1.8647995810481826,1.780850519113991,1.125,0,1.5,0,1.3333333333333333,0,1.1111111111111112,0,1.1666666666666667,0,1.1666666666666667,0,1.1428571428571428,0,1,0,1.135135135135135,0,0,0,0,-1.3349942676114996,-0.44815275630616064,-0.8915735119588302,2,3,4,2,1,2,3,1,2,0.9759000729485332,2.4285714285714284,0,1.5,0.06204068923643738,4,5,5,5,3,3,4,3,3,3,3,1.2149857925879117,3,4.142857142857143,0,-0.3194685672932239,0,0.18528535351022954,1,2,3,3,2,4,5,4,5,3,5,4,4,4,5,4,4,4,5,2,1.4375905768565218,2.2,0,4.2,0,4.2,0,4,0,4.133333333333334,0,1,1,1,3,2,1,2,1,1,2,2,1,2,1,1,2,1,1,1,2,0.9665456669582609,1.45,0,1,1,1,3,2,1,2,1,1,2,2,1,2,1,1,2,1,1,1,2,0.9665456669582609,1.45,0,I lived with my mother and father an equal amount of time (joint custody),0,"White, Caucasian, Anglo, European American",0,29,0,1,NA,1,3,4,DISPATCHER,2,192,72,2,5,2,0,0,2,0,0,I lived with my mother and father an equal amount of time (joint custody),0,TRUE,TRUE,TRUE,TRUE,TRUE,6,0.503625,0.4788125,0.54259375,0.6315,0.5966,0.67425,1,1,1,1,0.9375,1,0.117,0.313,0.485,0.014,1.49,50.564306697051805,1842.3226088367262,0.112,0.314,0.475,0.014,1.596,65.99300295074127,1851.3529698028847,400,1.1851851851851851,0,3,0,6,9,FALSE
249,2022-03-18T18:29:03Z,2022-03-18T18:47:01Z,1077,1,2022-03-18T18:47:02Z,0.8999999761581421,Firefox,98.0,Windows NT 10.0,3440,1440,NA,2.388888888888889,517,77,297,21,17,50,-0.3307356794449801,-0.22613957251783437,-0.4159808855932361,-0.9506645901925208,-0.9002586214493071,-0.5441590635442882,2,2,1,1,2,1,2,1,1,2,1,2,1,3,1,2,1,1,1,1,1.234376040972246,0,0,3,2,2,1.45,0,2,1,1,2,1,3,2,2,1,1,1,3,1,3,3,1,2,1,1,1,1,2,1,0,2,0,0,0,0,1,2,1,2,5,2,3,1,2,1,1,1,1,3,1,1,3,2,1,2,2,1,1,1,1,1,1,1,1,1,1,1,2,1,4,4,1,2,2,1,1,1.6435331457567874,1.4074631010979937,1.25,0,1.5,0,1.8,0,2.111111111111111,0,1.5833333333333333,0,1,0,1.1428571428571428,0,3,0,1.6486486486486487,0,0,0,0,-0.852026037729425,-0.44815275630616064,-0.6500893970177928,5,5,5,4,5,5,4,4,1,1.8126539343499315,4.714285714285714,0,2.5,1.7744399249969756,3,4,2,4,2,2,2,3,3,1,1,1,3,2.7142857142857144,0,-1.4361601188640107,0,-1.2696635791549795,3,2,2,2,3,3,2,2,4,3,2,4,4,2,4,3,4,3,2,2,0.8837151016885368,2.4,0,3.2,0,2.8,0,2.8,0,2.933333333333333,0,3,2,3,1,2,4,3,1,3,2,2,2,2,4,2,3,2,2,3,2,0.8013147091860318,2.4,0,3,2,3,1,2,4,3,1,3,2,2,2,2,4,2,3,2,2,3,2,0.8013147091860318,2.4,0,I lived with my mother and father an equal amount of time (joint custody),0,"White, Caucasian, Anglo, European American",0,20,0,1,NA,1,1,3,sel employed,2,150,68,2,5,2,0,0,1,0,0,I lived with my mother and father an equal amount of time (joint custody),0,TRUE,TRUE,TRUE,TRUE,TRUE,2,0.57803125,0.49059375,0.507625,0.65,0.5418275862068965,0.584,1,1,1,1,0.90625,1,0.196,0.246,0.751,0.028,1.975,48.06414100439171,1841.424240156858,0.194,0.256,0.78,0.032,2.11,61.17005197578892,1849.145817948374,448,1.3274074074074074,0,3,0,0,3,FALSE
251,2022-03-18T18:16:20Z,2022-03-18T18:49:05Z,1965,1,2022-03-18T18:49:06Z,0.8999999761581421,Chrome,99.0.4844.51,Macintosh,1440,900,NA,1.6,625,127,830,167,52,87,-0.1090688254485096,0.0494689727742916,1.5177275531122978,0.846961434537747,-0.1835207133843211,-0.12855133840610475,2,3,1,1,3,1,2,3,1,3,3,1,2,1,3,3,1,1,3,3,0.5871429486123998,0,1,3,4,1,2.05,0,1,1,1,1,2,1,1,1,1,1,1,2,1,1,3,3,1,1,1,1,1,1,1,0,1,1,0,0,0,2,2,4,2,5,2,5,4,2,3,2,1,1,3,2,2,3,1,1,1,1,1,1,1,1,1,1,1,1,1,1,2,2,2,1,1,1,1,1,1,1,1.3322067312451078,1.869555587629877,1.25,0,1,0,1.2666666666666666,0,3.111111111111111,0,1.75,0,1,0,1.4285714285714286,0,1,0,1.837837837837838,0,0,0,0,-1.0024184272260237,-0.6205191861769039,-0.8114688067014638,1,1,2,1,1,1,1,1,1,1.7320508075688772,1.1428571428571428,0,1,-0.8770273057233877,5,5,5,5,3,2,5,1,1,3,2,1.7043362064926932,1,4.285714285714286,0,-1.02511228091384,0,-0.16741472478923042,4,2,4,5,4,2,4,3,3,3,5,3,3,4,4,1,5,5,3,2,1.1751393027860062,3.8,0,4,0,2.8,0,3.2,0,3.3333333333333335,0,1,1,1,2,3,2,3,4,2,1,1,3,1,1,1,3,2,2,1,3,0.8013147091860318,1.9,0,1,1,1,2,3,2,3,4,2,1,1,3,1,1,1,3,2,2,1,3,0.8013147091860318,1.9,0,NA,NA,"Hispanic of Latino (e.g., Mexican American, Central American, and others)",0,19,1,2,NA,1,2,3,office assistant,3,120,62,3,5,2,0,0,0,0,0,NA,NA,TRUE,TRUE,TRUE,TRUE,TRUE,4,1.1090354838710157,0.8791718750000582,1.0813781250001049,1.2043999999998318,0.8841387096776236,1.2771193548385655,0.96875,1,1,1,1,0.96875,0.102,0.664,0.217,0.003,0.882,139.5111918734518,1977.696750597238,0.103,0.7,0.225,0.005,0.919,121.64274994725383,1948.2131417395449,304,0.9007407407407407,1,3,0,0,3,FALSE
252,2022-03-18T18:27:24Z,2022-03-18T18:49:36Z,1331,1,2022-03-18T18:49:37Z,0.8999999761581421,Chrome,98.0.4758.109,Macintosh,1440,900,Nope! Thank you!,1.6,539,89,381,105,61,80,-0.2855813202975509,-0.15999352164772415,-0.11123133802988738,0.08358599937831816,7.833201181038607e-4,-0.2071798269457611,2,3,2,2,2,2,2,3,2,2,3,3,1,2,2,3,3,2,3,2,0.5712405705774795,0,1,1,3,3,2.3,0,4,3,4,3,3,3,4,3,3,3,4,4,3,4,3,2,4,1,1,2,3,3,4,0,2,0,0,0,0,2,3,3,3,3,1,3,3,3,1,2,3,1,4,2,3,5,5,5,5,5,5,1,1,1,1,2,1,1,1,1,3,3,3,2,3,1,2,2,1,1,1.4210979978592326,0.6399404734221844,2.5,0,1.5,0,3.4,0,2.6666666666666665,0,3.4166666666666665,0,1.8333333333333333,0,1.8571428571428572,0,2,0,2.5675675675675675,0,0,0,0,0.7950068456711523,-0.44815275630616064,0.17342704468249584,2,2,3,1,1,2,2,2,2,1.0690449676496976,1.8571428571428572,0,2,-0.07618021783796666,3,4,3,4,2,2,3,4,4,4,3,0.816496580927726,4,3,0,0.07529693741016555,0,-0.19349799699683956,2,2,3,2,2,4,2,3,4,2,5,4,4,4,4,3,3,4,3,2,0.9611501047232549,2.2,0,4,0,2.8,0,3.4,0,3.4,0,2,2,2,3,3,3,3,3,3,3,3,2,1,1,1,2,1,2,1,3,0.8335087534664907,2.2,0,2,2,2,3,3,3,3,3,3,3,3,2,1,1,1,2,1,2,1,3,0.8335087534664907,2.2,0,I lived with my mother and father an equal amount of time (joint custody),0,"White, Caucasian, Anglo, European American",0,23,1,4,genderqueer,1,3,7,unemployed,1,155,63,1,5,2,0,0,1,0,0,I lived with my mother and father an equal amount of time (joint custody),0,TRUE,TRUE,TRUE,TRUE,TRUE,3,0.5818375000013039,0.4986906249998137,0.5461499999985099,0.6666781250005588,0.5471312500042841,0.5956156249977649,1,1,1,1,1,1,0.086,0.368,0.484,0.028,1.805,63.300555392573784,1861.7487639674193,0.09,0.372,0.528,0.034,1.949,79.18523474822753,1865.763704697276,434,1.285925925925926,0,3,0,0,3,FALSE
253,2022-03-18T18:32:02Z,2022-03-18T18:49:55Z,1072,1,2022-03-18T18:49:55Z,0.8999999761581421,Chrome,99.0.4844.74,Windows NT 10.0,1920,1080,no,1.7777777777777777,455,52,306,74,52,62,-0.4579888734059169,-0.3639438451638974,-0.38332914835430587,-0.29810171820139625,-0.1835207133843211,-0.40936736890487735,4,3,2,3,4,1,1,4,1,4,4,1,2,2,4,4,1,1,4,4,0.5712405705774795,0,0,2,3,2,2.7,0,1,1,1,1,1,1,1,1,1,1,1,1,1,1,3,1,1,1,1,1,1,1,1,2,2,0,0,0,0,3,4,2,4,5,2,4,2,3,1,2,1,1,3,1,2,1,1,1,1,1,1,1,1,1,3,2,1,2,1,1,1,1,1,1,1,1,1,1,2,2,1.322591867980916,1.98086080374405,1,0,1.5,0,1.1333333333333333,0,3.2222222222222223,0,1.3333333333333333,0,1.5,0,1.1428571428571428,0,1,0,1.7567567567567568,0,1,0,0,-1.2053694135754915,-0.22899200544817064,-0.7171807095118311,1,1,2,1,1,1,1,3,2,1.7320508075688772,1.1428571428571428,0,2.5,-0.29726950199192703,5,5,5,5,4,3,5,7,6,5,4,1.5275252316519468,6.5,4.571428571428571,0,1.0853622486444023,0,1.27388335982979,2,1,2,3,3,5,3,3,5,4,4,3,4,4,2,4,4,4,3,4,0.990430401872025,2.2,0,4,0,3.6,0,3.6,0,3.7333333333333334,0,2,2,3,3,3,3,3,4,2,1,3,3,2,3,2,3,1,3,3,3,0.7326950970650465,2.6,0,2,2,3,3,3,3,3,4,2,1,3,3,2,3,2,3,1,3,3,3,0.7326950970650465,2.6,0,I lived with my mother and father an equal amount of time (joint custody),0,"White, Caucasian, Anglo, European American",0,26,0,1,NA,1,2,6,retail store manager,2,220,69,1,5,2,0,0,1,0,0,I lived with my mother and father an equal amount of time (joint custody),0,TRUE,TRUE,TRUE,TRUE,TRUE,3,0.53758064516105,0.5186000000002096,0.501203125,0.5991566666665797,0.5650838709678501,0.5679129032257103,0.96875,1,1,0.9375,0.96875,0.96875,0.068,0.364,0.516,0.015,1.331,121.82070847675436,1976.3734049744587,0.065,0.366,0.5,0.015,1.396,151.25202922299567,1979.4092702935277,346,1.0251851851851852,0,3,0,0,3,FALSE
254,2022-03-18T18:35:43Z,2022-03-18T18:50:20Z,877,1,2022-03-18T18:50:21Z,0.8999999761581421,Firefox,98.0,Windows NT 10.0,1707,960,"I had no confusion during the survey, I was able to answer the questions to the best of my abilities.",1.778125,449,37,165,39,22,63,-0.470303698627943,-0.44662640875153514,-0.8948730317642126,-0.7290394638559125,-0.7978674917257377,-0.3981347276849264,1,1,1,1,1,1,1,1,1,1,1,1,1,1,1,1,1,1,1,1,1.538967528127731,0,1,1,5,5,1,0,2,1,1,1,1,1,1,1,1,1,1,1,1,1,1,1,1,1,1,1,1,1,1,0,2,0,0,0,0,1,1,1,1,1,1,1,1,1,1,1,1,1,1,1,1,1,1,1,1,1,1,1,1,1,1,1,1,1,1,1,1,1,1,1,1,1,1,1,1,1,1.9666895707934864,2.007130147392398,1,0,1,0,1.0666666666666667,0,1,0,1,0,1,0,1,0,1,0,1,0,0,0,0,-1.5652087957741596,-0.6205191861769039,-1.0928639909755318,1,1,2,1,1,1,1,1,1,1.7320508075688772,1.1428571428571428,0,1,-0.8770273057233877,5,5,5,5,3,2,5,3,3,3,3,1.7043362064926932,3,4.285714285714286,0,-0.3194685672932239,0,0.2627120519599011,1,1,1,1,1,5,5,5,5,5,5,5,5,5,5,5,5,5,5,5,2.065591117977289,1,0,5,0,5,0,5,0,5,0,1,1,1,1,1,1,1,1,1,1,1,1,1,1,1,1,1,1,1,1,1.231174022502185,1,0,1,1,1,1,1,1,1,1,1,1,1,1,1,1,1,1,1,1,1,1,1.231174022502185,1,0,I lived with my mother and father an equal amount of time (joint custody),0,"Hispanic of Latino (e.g., Mexican American, Central American, and others)",0,26,0,3,NA,1,3,6,Lab Technician,4,165,70,4,5,2,0,0,1,0,0,I lived with my mother and father an equal amount of time (joint custody),0,TRUE,TRUE,TRUE,TRUE,TRUE,3,0.45190625,0.37374999999999997,0.42546875,0.5147419354838709,0.4318214285714286,0.4973666666666667,1,1,1,0.96875,0.9032258064516129,0.9375,0.06,0.34,0.712,0.02,1.661,21.397810218625683,1875.4553975929382,0.06,0.342,0.764,0.021,1.738,19.1509580514795,1864.619816865034,247,0.7318518518518519,0,3,0,3,6,FALSE
255,2022-03-18T18:27:20Z,2022-03-18T18:51:10Z,1430,1,2022-03-18T18:51:11Z,0.8999999761581421,Chrome,99.0.4844.74,Windows NT 10.0,1536,864,NA,1.7777777777777777,641,102,392,81,52,75,-0.07622929152310656,-0.08833529987177138,-0.07132365918230602,-0.21191416907049299,-0.1835207133843211,-0.2633430330455156,3,3,2,1,3,1,1,3,1,2,4,1,1,1,2,2,1,1,3,3,0.7451598203705946,0,1,1,4,3,1.95,0,2,2,2,3,2,2,2,2,2,1,1,2,2,2,3,2,2,1,2,2,2,2,2,1,2,0,0,0,0,1,3,3,2,2,3,3,3,3,2,3,2,1,3,3,3,3,2,3,3,4,3,3,1,2,3,1,2,3,3,1,2,2,2,1,1,1,2,2,2,2,1.0126823418651703,1.1126972805283737,1.875,0,2,0,2,0,2.5555555555555554,0,2.6666666666666665,0,2.1666666666666665,0,2.142857142857143,0,1,0,2.324324324324324,0,1,0,0,-0.1962246691326731,-0.05662557557742737,-0.12642512235505024,2,1,3,1,1,2,1,1,1,1.2149857925879117,1.5714285714285714,0,1,-0.6284221744847194,5,5,5,4,3,3,4,1,6,4,3,1.2149857925879117,3.5,4.142857142857143,0,-0.015046969679603108,0,0.370846250641337,3,2,2,3,2,4,3,3,4,2,4,3,3,3,3,2,3,4,2,4,0.6324555320336759,2.4,0,3.6,0,2.4,0,3.4,0,3.1333333333333333,0,1,1,1,2,2,1,2,3,2,1,1,2,2,1,2,3,1,1,1,2,0.6805570473787206,1.6,0,1,1,1,2,2,1,2,3,2,1,1,2,2,1,2,3,1,1,1,2,0.6805570473787206,1.6,0,I lived with my mother and father an equal amount of time (joint custody),0,"White, Caucasian, Anglo, European American",0,22,1,2,NA,1,3,5,N/A,5,155,63,1,5,2,0,0,1,0,0,I lived with my mother and father an equal amount of time (joint custody),0,TRUE,TRUE,TRUE,TRUE,TRUE,2,0.457453125,0.4252612903204656,0.42237812499981375,0.5227935483897886,0.47961290322484507,0.5167310344813199,1,0.96875,1,1,0.96875,0.9354838709677419,0.072,0.302,0.599,0.017,1.781,48.24897787232542,1908.4668281543168,0.072,0.302,0.622,0.017,1.892,56.93875867264653,1901.7345386193956,382,1.1318518518518519,0,3,0,0,3,FALSE
256,2022-03-18T18:32:07Z,2022-03-18T18:52:45Z,1237,1,2022-03-18T18:52:47Z,0.800000011920929,Chrome,99.0.4844.74,Windows NT 10.0,1536,864,NA,1.7777777777777777,444,94,369,84,29,56,-0.48056605297963145,-0.13243266711851154,-0.15476698768179434,-0.17497664801439158,-0.6545199101127405,-0.47676321622458273,2,2,1,1,2,1,1,2,1,2,2,1,1,1,2,2,1,1,2,2,1.025978352085154,0,0,1,4,5,1.5,0,2,1,1,1,1,1,1,1,1,1,1,2,2,1,2,1,2,1,1,1,1,2,1,0,2,0,0,0,0,1,1,1,1,1,1,1,1,1,1,1,1,1,2,1,1,1,1,1,1,1,1,1,1,1,1,1,1,1,1,1,1,1,1,1,1,1,1,1,1,1,1.9382354750537296,1.8309508328682538,1.25,0,1,0,1.2666666666666666,0,1,0,1.0833333333333333,0,1,0,1,0,1,0,1.027027027027027,0,0,0,0,-1.356746046458848,-0.6205191861769039,-0.988632616317876,1,1,2,1,1,2,1,1,1,1.6761634196950514,1.2857142857142858,0,1,-0.7941589286438315,5,5,5,5,4,4,5,8,6,6,4,1.4638501094227998,7,4.714285714285714,0,1.3897838462580232,0,1.5368709554105697,2,2,2,1,2,5,3,4,5,3,5,4,5,4,3,5,5,5,3,4,1.3451854182690985,1.8,0,4.8,0,3.8,0,4,0,4.2,0,1,1,1,1,1,1,1,1,1,1,1,1,1,1,1,1,1,1,1,1,1.231174022502185,1,0,1,1,1,1,1,1,1,1,1,1,1,1,1,1,1,1,1,1,1,1,1.231174022502185,1,0,NA,NA,"White, Caucasian, Anglo, European American",0,30,0,1,NA,1,4,6,Case Manager,5,150,72,3,5,2,0,0,1,0,0,NA,NA,TRUE,TRUE,TRUE,TRUE,TRUE,6,0.4698419354884855,0.4259249999932945,0.44881874998658894,0.5426806451582139,0.49210333331823347,0.5389133333206176,0.96875,1,1,0.96875,0.9375,0.9375,0.059,0.368,0.747,0.012,1.431,20.666343594721873,1873.388325889245,0.064,0.363,0.743,0.015,1.634,23.850062402305547,1868.542256624449,388,1.1496296296296296,0,3,0,0,3,FALSE
257,2022-03-18T17:29:23Z,2022-03-18T18:53:03Z,5020,1,2022-03-18T18:53:04Z,0.8999999761581421,Chrome,99.0.4844.74,Windows NT 10.0,1920,1080,No comments,1.7777777777777777,1598,343,585,293,33,75,1.8879853313900625,1.2400978884362759,0.6288747060525308,2.3983373188940056,-0.572607006333885,-0.2633430330455156,3,2,1,1,2,1,1,2,1,3,2,2,1,1,2,2,1,1,3,2,0.9119095061289915,0,1,1,3,4,1.7,0,1,2,2,1,2,2,1,2,1,1,2,2,1,2,2,1,1,1,1,1,1,1,1,0,2,0,0,0,0,2,3,3,2,1,1,2,1,1,3,1,1,1,2,2,1,3,1,1,1,1,1,1,1,1,3,1,1,1,1,1,2,2,2,1,1,1,2,1,1,2,1.6265440804496034,1.533747356112131,1,0,1.5,0,1.6,0,1.7777777777777777,0,1.5,0,1.3333333333333333,0,1.4285714285714286,0,1,0,1.4864864864864864,0,0,0,0,-1.1195433902502072,-0.44815275630616064,-0.783848073278184,1,1,2,1,1,2,1,1,1,1.6761634196950514,1.2857142857142858,0,1,-0.7941589286438315,5,5,5,5,4,4,5,7,7,6,4,1.4638501094227998,7,4.714285714285714,0,1.3897838462580232,0,1.5368709554105697,2,2,2,2,2,5,5,4,5,3,4,2,4,4,4,4,5,4,4,3,1.3201731488169053,2,0,4,0,4,0,4,0,4,0,1,1,1,1,1,1,1,1,1,2,2,2,1,1,1,1,1,1,1,1,1.1367080817685316,1.15,0,1,1,1,1,1,1,1,1,1,2,2,2,1,1,1,1,1,1,1,1,1.1367080817685316,1.15,0,I lived with my mother and father an equal amount of time (joint custody),0,"White, Caucasian, Anglo, European American",0,21,1,2,NA,1,3,6,Childcare worker,3,160,65,3,5,2,0,0,0,0,0,I lived with my mother and father an equal amount of time (joint custody),0,TRUE,TRUE,TRUE,TRUE,TRUE,6,0.5659531249995343,0.5213032258064035,0.5163096774201239,0.5976531249997206,0.5639000000001922,0.583153333333383,1,1,0.96875,1,0.96875,0.967741935483871,0.059,0.383,0.421,0.033,1.922,118.94626731723311,2020.721504271096,0.058,0.382,0.414,0.027,2.029,151.11330628145296,2022.0195131092805,447,1.3244444444444445,0,3,0,0,3,FALSE
258,2022-03-18T18:02:02Z,2022-03-18T18:53:07Z,3064,1,2022-03-18T18:53:07Z,0.800000011920929,Chrome,99.0.4844.74,Windows NT 10.0,1920,1080,It was a good study,1.7777777777777777,1032,109,1342,58,41,154,0.7262868187789301,-0.04975010353087375,3.3752486049269947,-0.49510183050060363,-0.40878119877617386,0.6240356233306057,1,1,1,1,1,1,1,2,1,1,1,1,1,1,1,1,1,1,1,1,1.5035046776746235,0,1,1,5,5,1.05,0,2,2,1,1,1,1,1,1,1,1,2,2,2,1,2,2,2,1,1,1,1,2,1,1,2,0,0,0,0,1,1,1,1,2,1,1,1,1,2,1,2,2,1,2,2,1,1,3,2,3,1,5,1,1,2,1,2,2,2,2,1,2,2,1,1,1,4,2,2,2,1.6499158227686108,1.709915063331955,1.375,0,2.5,0,1.4,0,1.1111111111111112,0,1.8333333333333333,0,1.8333333333333333,0,1.8571428571428572,0,1,0,1.5945945945945945,0,1,0,0,-0.9958239965347463,0.11574085429331589,-0.4400415711207152,1,1,3,1,2,1,3,1,2,1.4960264830861913,1.7142857142857142,0,1.5,-0.3523011961613431,5,5,5,4,4,4,4,6,7,5,4,1.0690449676496976,6.5,4.428571428571429,0,1.0853622486444023,0,1.1964566613801186,1,1,2,2,2,5,5,5,4,5,5,5,5,4,5,4,5,5,4,4,1.791514389985135,1.6,0,5,0,4.6,0,4.4,0,4.666666666666667,0,1,1,1,1,1,1,2,2,1,1,2,1,1,1,1,2,1,1,2,2,1.0310954828418375,1.3,0,1,1,1,1,1,1,2,2,1,1,2,1,1,1,1,2,1,1,2,2,1.0310954828418375,1.3,0,I lived with my mother and father an equal amount of time (joint custody),0,"White, Caucasian, Anglo, European American",0,26,0,1,NA,1,3,6,Data scientist,4,167,69,3,5,2,0,0,1,0,0,I lived with my mother and father an equal amount of time (joint custody),0,TRUE,TRUE,TRUE,TRUE,TRUE,5,0.5127374999932944,0.5088843750003725,0.5422437500059605,0.5994433333257834,0.5622096774155094,0.567153124999255,1,1,1,0.9375,1,1,0.176,0.299,0.728,0.041,1.405,127.6505853798125,1923.0731510689961,0.176,0.3,0.735,0.037,1.52,156.85994518982042,1942.374503746549,436,1.2918518518518518,0,3,0,0,3,FALSE
259,2022-03-18T18:07:18Z,2022-03-18T18:53:35Z,2777,1,2022-03-18T18:53:37Z,0.8999999761581421,Chrome,99.0.4844.51,Macintosh,1440,900,None!,1.6,1042,90,241,596,177,347,0.7468115274823071,-0.15448135074188163,-0.6191472506354685,6.129026945560247,2.3762575297049144,2.79193537878113,1,1,2,1,2,1,1,2,1,1,2,1,1,1,1,1,1,1,2,2,1.3018205875255096,0,1,1,3,2,1.3,0,2,1,1,1,1,1,1,1,3,1,1,2,1,2,1,1,1,1,1,1,2,2,3,0,2,0,0,0,0,1,1,1,1,1,1,1,1,1,1,1,1,1,1,3,3,1,1,1,1,1,1,1,1,1,2,1,1,1,1,1,1,1,1,1,1,1,1,1,1,1,1.894357038308404,1.820517979665599,1.5,0,1,0,1.3333333333333333,0,1,0,1.3333333333333333,0,1.1666666666666667,0,1,0,1,0,1.135135135135135,0,0,0,0,-1.1711177437163185,-0.6205191861769039,-0.8958184649466112,1,1,3,1,1,1,1,1,1,1.5735915849388864,1.2857142857142858,0,1,-0.7941589286438315,5,5,5,5,1,1,5,7,3,NA,3,2.138089935299395,5,3.857142857142857,0,0.1414878915134009,1,0.3114090446527774,1,1,1,3,1,5,5,5,5,2,5,5,2,4,5,5,5,5,5,3,1.8309508328682538,1.4,0,5,0,3.8,0,4.4,0,4.4,0,1,1,1,1,2,1,1,1,1,1,1,1,1,2,1,1,1,1,1,1,1.2182817926554552,1.1,0,1,1,1,1,2,1,1,1,1,1,1,1,1,2,1,1,1,1,1,1,1.2182817926554552,1.1,0,I lived with my mother and father an equal amount of time (joint custody),0,"White, Caucasian, Anglo, European American",0,23,1,2,NA,1,3,6,Talent Acquisition Specialist,4,115,64,3,5,2,0,0,1,0,0,I lived with my mother and father an equal amount of time (joint custody),0,TRUE,TRUE,TRUE,TRUE,TRUE,4,0.5988225806466033,0.4737709677406857,0.5466451612912839,0.6547032258063554,0.5434785714282521,0.6354419354839671,0.96875,0.96875,1,0.96875,0.875,0.96875,0.075,0.377,0.457,0.019,1.896,254.74333299988285,2139.0607700948144,0.075,0.379,0.477,0.02,2.076,274.47748086275044,2098.6626527218673,434,1.285925925925926,0,3,0,0,3,FALSE
260,2022-03-18T18:30:48Z,2022-03-18T18:55:29Z,1480,1,2022-03-18T18:55:31Z,0.8999999761581421,Chrome,99.0.4844.74,Windows NT 10.0,1536,864,N/A,1.7777777777777777,970,53,270,48,27,61,0.5990336248179934,-0.35843167425805483,-0.5139360973100268,-0.6182269006876083,-0.6954763620021682,-0.4206000101248282,2,2,1,1,2,1,1,2,1,2,2,1,2,1,2,2,1,1,2,2,0.998683343734455,0,0,2,3,3,1.55,0,4,2,2,2,2,2,4,3,2,1,2,4,1,3,4,2,2,1,1,1,1,2,2,2,2,0,0,0,0,2,3,4,3,4,1,2,2,2,1,3,1,2,2,4,3,2,2,3,1,2,1,1,1,1,3,1,1,2,2,1,2,1,2,1,1,1,1,1,1,2,1.2956383286545203,0.8837151016885368,1.5,0,1.25,0,2.533333333333333,0,2.5555555555555554,0,2.1666666666666665,0,1.3333333333333333,0,1.5714285714285714,0,1,0,1.9189189189189189,0,1,0,0,-0.3041961686600086,-0.3151752203835423,-0.3096856945217754,1,1,1,1,1,2,2,1,1,1.8126539343499315,1.2857142857142858,0,1,-0.7941589286438315,4,4,4,5,3,3,5,6,8,6,4,1.2724180205607036,7,4,0,1.3897838462580232,0,1.1497374631622104,2,2,3,1,2,4,2,3,3,2,5,5,4,3,3,3,5,4,3,2,1.1254628677422756,2,0,4.6,0,2.8,0,2.8,0,3.4,0,1,1,1,1,3,1,1,3,1,1,3,1,1,1,1,1,1,1,1,2,1.164157703189193,1.35,0,1,1,1,1,3,1,1,3,1,1,3,1,1,1,1,1,1,1,1,2,1.164157703189193,1.35,0,I lived with my mother and father an equal amount of time (joint custody),0,Middle Eastern,0,28,0,1,NA,1,3,7,Real Estate Analyst,6,145,74,2,5,2,1,0,0,0,1,I lived with my mother and father an equal amount of time (joint custody),0,TRUE,TRUE,TRUE,TRUE,TRUE,2,0.5312033333381017,0.48760625000484287,0.55009375,0.5804249999932944,0.5760656250007451,0.5935031249970197,1,1,1,1,1,1,0.091,0.364,0.515,0.033,1.722,126.35029166474135,1926.5417901558171,0.092,0.361,0.536,0.026,1.869,149.1107159559569,1935.1389769317434,346,1.0251851851851852,0,3,3,12,15,FALSE
261,2022-03-18T18:33:47Z,2022-03-18T18:55:54Z,1326,1,2022-03-18T18:55:56Z,0.8999999761581421,Chrome,99.0.4844.74,Windows NT 10.0,1536,864,NA,1.7777777777777777,566,126,361,78,44,61,-0.23016460679843329,0.04395680186844908,-0.18379075411639897,-0.24885169012659436,-0.34734652094203217,-0.4206000101248282,2,2,1,1,1,1,1,4,1,1,3,1,1,1,1,2,1,1,2,2,1.2139539573337679,0,0,2,4,3,1.5,0,3,1,2,2,5,2,2,2,2,2,2,2,2,2,1,2,4,5,1,1,2,2,1,1,2,0,0,0,0,1,1,1,1,2,1,1,1,1,4,1,1,1,2,1,1,4,4,5,5,5,3,1,5,3,1,1,1,2,3,1,1,2,2,1,1,1,2,3,2,2,1.7424224619867699,1.2649110640673518,2.25,0,2.25,0,2.1333333333333333,0,1.1111111111111112,0,2.8333333333333335,0,2.3333333333333335,0,1.7142857142857142,0,1,0,1.972972972972973,0,1,0,0,-0.1276229050756511,0.029557639357944268,-0.04903263285885342,2,3,3,1,1,4,2,1,1,1.2724180205607036,2.2857142857142856,0,1,-0.2140802890869389,4,5,5,4,2,2,4,4,4,NA,3,1.3972762620115438,4,3.7142857142857144,0,-0.12954382975590517,1,0.06877432632550919,3,3,3,3,3,3,5,5,4,3,3,4,3,3,4,3,4,3,2,3,0.9611501047232549,3,0,3.4,0,3.2,0,3.8,0,3.466666666666667,0,3,2,3,3,3,3,2,2,2,1,3,3,2,3,1,2,2,3,3,2,0.6805570473787206,2.4,0,3,2,3,3,3,3,2,2,2,1,3,3,2,3,1,2,2,3,3,2,0.6805570473787206,2.4,0,NA,NA,"White, Caucasian, Anglo, European American",0,30,1,2,NA,1,3,4,virtual assistant,3,180,65,3,5,2,0,0,0,0,0,NA,NA,TRUE,TRUE,TRUE,TRUE,TRUE,6,0.7283874999880791,0.5631437500044704,0.6148062500208616,0.8664774193609914,0.7056466666777929,0.7949499999920527,1,1,1,1,1,0.967741935483871,0.064,0.459,0.357,0.005,1.17,104.78337305249175,1935.8744001516523,0.065,0.46,0.426,0.005,1.253,88.38439596718493,1912.6726211477662,350,1.0370370370370372,0,3,0,0,3,FALSE
262,2022-03-18T18:36:17Z,2022-03-18T18:58:02Z,1305,1,2022-03-18T18:58:03Z,0.8999999761581421,Chrome,99.0.4844.74,Windows NT 10.0,1920,1080,N/a,1.7777777777777777,530,96,343,92,64,79,-0.30405355813059015,-0.1214083253068265,-0.24909422859425942,-0.07647659186478786,0.062217997952245516,-0.218412468165712,3,2,2,1,3,1,1,2,1,3,2,1,1,1,3,2,1,1,2,2,0.8750939799154206,0,1,1,3,2,1.75,0,1,1,1,1,2,1,1,1,2,1,1,2,1,1,1,1,2,1,1,1,1,1,1,1,2,0,0,0,0,1,1,1,1,3,1,1,1,1,1,1,1,1,3,2,1,3,1,1,2,1,2,1,1,1,1,1,1,2,2,1,1,1,1,1,1,1,1,1,2,2,1.7731734670201176,1.9073791542572855,1.125,0,1.5,0,1.2,0,1.2222222222222223,0,1.5,0,1.1666666666666667,0,1.2857142857142858,0,1,0,1.2972972972972974,0,1,0,0,-1.3223959522609994,-0.22899200544817064,-0.775693978854585,1,1,3,1,1,1,1,1,1,1.5735915849388864,1.2857142857142858,0,1,-0.7941589286438315,5,5,5,5,3,2,5,6,6,4,3,1.7043362064926932,6,4.285714285714286,0,0.4366725657692403,0,0.7236196488870026,1,1,2,2,2,5,4,4,5,4,5,5,5,3,4,4,5,5,3,4,1.5023790657297036,1.6,0,5,0,4,0,4,0,4.333333333333333,0,2,1,4,4,4,4,4,3,4,1,2,3,3,4,1,3,1,4,1,4,1.3168942730211068,2.85,0,2,1,4,4,4,4,4,3,4,1,2,3,3,4,1,3,1,4,1,4,1.3168942730211068,2.85,0,I lived with my mother and father an equal amount of time (joint custody),0,"Asian or Asian American (e.g., Chinese, Japanese, and others)",0,26,0,1,NA,1,1,6,Unemployed,2,143,62,1,5,2,0,0,1,0,0,I lived with my mother and father an equal amount of time (joint custody),0,TRUE,TRUE,TRUE,TRUE,TRUE,4,0.553199999999255,0.45119374999403955,0.47482187499850986,0.6312749999836087,0.49880000001384367,0.5380718750022352,1,1,1,1,1,1,0.147,0.293,0.795,0.025,1.659,30.506715012197542,1825.3099836107679,0.145,0.293,0.807,0.024,1.709,39.068917379222256,1823.1222944567967,298,0.882962962962963,0,3,0,3,6,FALSE
263,2022-03-18T18:42:55Z,2022-03-18T18:58:12Z,916,1,2022-03-18T18:58:13Z,1,Chrome,99.0.4844.74,Windows NT 10.0,1280,720,NA,1.7777777777777777,444,68,195,51,32,66,-0.48056605297963145,-0.2757491106704171,-0.7860339076344453,-0.581289379631507,-0.5930852322785988,-0.3644368040250737,2,2,1,1,2,1,1,1,1,1,2,1,1,1,1,1,1,1,1,1,1.3803127029389886,0,1,1,4,4,1.2,0,1,1,2,1,1,1,5,1,1,1,1,1,1,5,2,1,1,1,1,1,1,1,1,0,2,0,0,0,0,1,1,1,1,1,1,1,1,1,1,1,1,1,2,1,1,1,1,1,1,1,1,1,1,1,1,1,1,1,1,1,1,1,1,1,1,1,1,1,1,1,1.9382354750537296,1.8387366263150307,1,0,1,0,1.6666666666666667,0,1,0,1.0833333333333333,0,1,0,1,0,1,0,1.027027027027027,0,0,0,0,-1.2911954369007754,-0.6205191861769039,-0.9558573115388397,1,1,1,1,1,2,1,1,1,1.889822365046136,1.1428571428571428,0,1,-0.8770273057233877,5,5,5,5,5,5,5,6,6,6,4,1.5118578920369088,6,5,0,1.2090960320784858,0,1.5815856723915158,1,1,1,1,1,5,3,5,5,1,5,5,5,4,3,5,5,5,4,5,1.61245154965971,1,0,5,0,3.6,0,4.4,0,4.333333333333333,0,1,1,1,1,1,1,1,1,1,1,1,1,1,1,1,1,1,1,1,1,1.231174022502185,1,0,1,1,1,1,1,1,1,1,1,1,1,1,1,1,1,1,1,1,1,1,1.231174022502185,1,0,I lived with my mother and father an equal amount of time (joint custody),0,"White, Caucasian, Anglo, European American",0,25,1,2,NA,1,4,6,senior financial analyst,6,130,68,3,5,2,0,0,1,0,0,I lived with my mother and father an equal amount of time (joint custody),0,TRUE,TRUE,TRUE,TRUE,TRUE,6,0.4855806451535994,0.5540187499895692,0.5204354838594314,0.5339607142891203,0.5736896551724138,0.5948862069146387,1,1,1,0.9032258064516129,0.9354838709677419,0.90625,0.072,0.327,0.394,0.012,1.616,46.41837071791839,1986.4442610806323,0.07,0.33,0.386,0.014,1.682,56.50348745497716,1939.9748232495685,304,0.9007407407407407,1,3,0,0,3,FALSE
264,2022-03-18T17:55:56Z,2022-03-18T18:58:27Z,3750,1,2022-03-18T18:58:28Z,0.8999999761581421,Chrome,99.0.4844.51,Windows NT 10.0,1366,768,NA,1.7786458333333333,3215,48,226,106,30,82,5.206830728726107,-0.3859925287872675,-0.6735668127003522,0.09589850639701863,-0.6340416841680265,-0.18471454450585928,2,3,1,2,2,1,1,2,1,2,2,1,1,1,2,2,1,1,3,3,0.9119095061289915,0,1,2,3,3,1.7,0,2,2,3,3,4,2,3,2,2,2,3,2,2,3,3,2,2,2,2,1,2,3,2,5,1,1,0,3,0,2,1,3,2,2,1,2,2,2,2,2,1,1,2,3,2,3,1,1,2,3,2,1,3,1,4,4,3,4,4,5,2,2,2,1,1,1,3,4,4,5,1.3639502778182058,0.7988086367179802,2,0,4,0,2.533333333333333,0,1.8888888888888888,0,1.9166666666666667,0,2.5,0,3.142857142857143,0,1,0,2.1621621621621623,0,3,0,0,0.020604148970080418,1.0711616456215256,0.545882897295803,2,1,3,1,1,1,1,5,4,1.2535663410560174,1.4285714285714286,0,4.5,0.6414776571424661,5,5,4,4,3,2,3,8,6,2,2,1.1126972805283737,7,3.7142857142857144,0,-0.15506308636046787,0,0.053219003750558866,2,3,3,3,3,3,5,4,4,5,4,4,4,4,5,5,5,5,3,4,1.486446705914413,2.8,0,4.2,0,4.4,0,4.2,0,4.266666666666667,0,2,3,3,3,3,4,3,3,3,2,3,4,2,4,2,3,1,4,4,3,0.9333020044867296,2.95,0,2,3,3,3,3,4,3,3,3,2,3,4,2,4,2,3,1,4,4,3,0.9333020044867296,2.95,0,I lived with my mother and father an equal amount of time (joint custody),0,"Hispanic of Latino (e.g., Mexican American, Central American, and others)",0,19,0,1,NA,1,3,4,Location manager,3,160,66,3,5,2,0,0,0,0,0,I lived with my mother and father an equal amount of time (joint custody),0,TRUE,TRUE,TRUE,TRUE,TRUE,6,0.5340906250476837,0.4356900000413259,0.43142187501490115,0.6523999999523162,0.5176933333237966,0.5209074073897468,1,1,1,0.9375,0.967741935483871,0.8709677419354839,0.056,0.322,0.497,0.009,1.306,27.888434714797476,1930.8629619280769,0.056,0.322,0.508,0.009,1.352,34.526341593849445,1930.7768868346816,342,1.0133333333333332,0,3,3,30,33,FALSE
266,2022-03-18T18:37:22Z,2022-03-18T18:59:19Z,1317,1,2022-03-18T18:59:20Z,0.8999999761581421,Chrome,99.0.4844.51,Windows NT 10.0,1366,768,NA,1.7786458333333333,496,85,414,104,65,97,-0.3738375677220716,-0.18204220527109422,0.008491698512856739,0.0712734923596177,0.0826962238969594,-0.01622492620659573,3,3,3,3,3,1,1,2,1,3,3,1,2,1,3,3,1,1,3,3,0.6958523739384593,0,1,1,4,3,2.2,0,2,1,3,1,2,2,3,3,2,2,2,3,1,2,2,3,1,3,3,2,2,2,2,0,1,0,0,1,1,2,4,1,1,3,1,1,1,1,2,1,1,1,1,2,1,1,3,3,3,3,3,3,1,1,3,2,3,1,1,1,1,2,2,1,3,1,2,3,1,1,1.5485147393221343,1.1952286093343936,2.25,0,1.75,0,2.066666666666667,0,1.6666666666666667,0,1.8333333333333333,0,2.1666666666666665,0,1.5714285714285714,0,1.6666666666666667,0,1.7837837837837838,0,0,1,0,-0.23943295381134252,0.33619029106636955,0.04837866862751351,1,1,1,1,1,1,1,1,1,1.9518001458970664,1,0,1,-0.9598956828029438,5,5,5,5,2,2,3,6,6,NA,3,1.4638501094227998,6,3.857142857142857,0,0.41251961278270693,1,0.4766170645303738,4,2,3,4,3,3,5,4,3,2,4,3,2,3,5,4,4,3,4,5,1.162919151265879,3.2,0,3.4,0,3.4,0,4,0,3.6,0,3,2,3,2,1,2,2,2,1,1,2,2,1,3,1,3,1,2,2,3,0.8255779474818965,1.95,0,3,2,3,2,1,2,2,2,1,1,2,2,1,3,1,3,1,2,2,3,0.8255779474818965,1.95,0,I lived with my mother and father an equal amount of time (joint custody),0,"White, Caucasian, Anglo, European American",0,23,1,2,NA,1,4,7,Restaurant Server,5,150,67,2,5,2,0,0,1,0,0,I lived with my mother and father an equal amount of time (joint custody),0,TRUE,TRUE,TRUE,TRUE,TRUE,5,0.5466312499940396,0.44835937495529654,0.43328749997913835,0.6326156249940396,0.5515517241461524,0.5434733333428701,1,1,1,1,0.90625,0.9375,0.072,0.302,0.585,0.007,1.349,148.75767035505606,2020.2781573969849,0.072,0.302,0.606,0.007,1.344,162.92084980303255,2010.1485657987373,382,1.1318518518518519,0,3,0,0,3,FALSE
267,2022-03-18T18:21:08Z,2022-03-18T18:59:30Z,2301,1,2022-03-18T18:59:31Z,0.8999999761581421,Firefox,98.0,Windows NT 10.0,1536,864,"I am living with my parents, so I reported their income for the household income since I am unemployed.",1.7777777777777777,589,149,859,178,133,205,-0.18295777678066644,0.17073673270282702,1.6229387064377396,0.982399011743452,1.4752155881375035,1.1969003255481019,3,2,2,2,3,1,1,3,1,3,2,2,1,1,3,3,2,1,2,3,0.6708203932499369,0,1,1,3,4,2.05,0,3,2,3,2,1,1,3,2,2,2,2,3,1,3,3,1,2,1,1,2,2,1,3,1,2,0,0,0,0,1,2,4,1,2,1,1,1,1,2,2,3,1,3,3,3,2,3,3,3,3,2,1,1,1,3,1,1,2,1,1,2,1,1,1,3,3,1,1,2,1,1.4415540496554675,0.990430401872025,1.625,0,1.25,0,2.2,0,1.5555555555555556,0,2.5833333333333335,0,1.5,0,1.2857142857142858,0,2.3333333333333335,0,1.8918918918918919,0,1,0,0,-0.4070496025762032,-0.3151752203835423,-0.3611124114798727,1,1,3,1,1,2,3,2,1,1.4960264830861913,1.7142857142857142,0,1.5,-0.3523011961613431,4,4,4,3,1,1,3,3,3,2,2,1.3451854182690985,3,2.857142857142857,0,-0.8778143430786174,0,-0.8518959066210627,3,2,3,2,3,3,3,3,3,3,4,3,3,3,4,3,4,4,3,3,0.5345224838248488,2.6,0,3.6,0,3,0,3.2,0,3.2666666666666666,0,1,1,1,1,1,1,1,3,1,2,1,2,1,1,2,3,1,1,2,1,0.8271701918685112,1.4,0,1,1,1,1,1,1,1,3,1,2,1,2,1,1,2,3,1,1,2,1,0.8271701918685112,1.4,0,I lived with my mother and father an equal amount of time (joint custody),0,"Asian or Asian American (e.g., Chinese, Japanese, and others)",0,28,1,2,NA,1,2,7,currently unemployed,2,120,63,1,5,2,0,0,0,0,0,I lived with my mother and father an equal amount of time (joint custody),0,TRUE,TRUE,TRUE,TRUE,TRUE,1,0.531483870967742,0.46325,0.52696875,0.61809375,0.5195161290322581,0.5650937500000001,1,1,1,1,1,1,0.1,0.377,0.676,0.029,1.535,102.49016083022536,1900.2627394210408,0.093,0.381,0.678,0.028,1.669,113.9151695074271,1901.3747495600796,386,1.1437037037037037,0,3,0,0,3,FALSE
268,2022-03-18T18:34:16Z,2022-03-18T18:59:53Z,1536,1,2022-03-18T18:59:54Z,0.8999999761581421,Chrome,99.0.4844.74,Windows NT 10.0,1920,1080,"Nope, everything worked on my end.",1.7777777777777777,610,94,454,86,87,81,-0.13985588850357494,-0.13243266711851154,0.15361053068587993,-0.15035163397699064,0.5332171946806649,-0.19594718572581019,3,3,3,3,3,1,2,2,4,3,3,3,2,4,3,2,4,2,3,3,0.8271701918685112,0,0,3,2,2,2.8,0,5,3,4,4,2,1,4,3,3,2,5,3,1,3,3,3,5,4,2,3,4,4,2,1,2,0,0,0,0,3,5,3,3,5,5,3,2,5,2,2,3,3,3,4,2,3,2,4,5,3,4,3,1,1,3,4,1,1,1,1,2,2,3,1,1,2,2,1,4,4,1.2155153135512022,1.1254628677422756,3.375,0,2.75,0,3.066666666666667,0,3.7777777777777777,0,3,0,2.6666666666666665,0,1.5714285714285714,0,1.3333333333333333,0,2.72972972972973,0,1,0,0,1.102582904032979,0.2019240692286875,0.6522534866308333,4,4,4,3,2,3,4,4,3,0.8997354108424374,3.4285714285714284,0,3.5,1.415129733768611,5,4,4,3,1,1,3,1,1,3,1,1.5275252316519468,1,3,0,-1.3693803661753812,0,-1.0741044277486136,1,4,2,1,2,2,5,5,3,4,5,4,5,3,5,5,4,5,5,3,1.6035674514745464,2,0,4,0,4.8,0,3.8,0,4.2,0,1,3,4,4,2,4,3,3,3,4,4,3,3,4,1,2,4,3,4,4,1.0990426455975697,3.15,0,1,3,4,4,2,4,3,3,3,4,4,3,3,4,1,2,4,3,4,4,1.0990426455975697,3.15,0,I lived with my mother and father an equal amount of time (joint custody),0,"Hispanic of Latino (e.g., Mexican American, Central American, and others)",0,22,0,1,NA,1,2,4,Self-employed,4,315,72,1,5,2,0,0,0,0,0,I lived with my mother and father an equal amount of time (joint custody),0,TRUE,TRUE,TRUE,TRUE,TRUE,2,0.5499451612897458,0.4854968749992549,0.5236187499985099,0.6435137931005708,0.5635258064500747,0.5844129032271523,1,1,1,0.9354838709677419,0.96875,0.96875,0.055,0.406,0.433,0.022,1.392,78.64097051426027,1929.799732066079,0.056,0.405,0.43,0.021,1.464,111.17496512602946,1935.8924603574196,282,0.8355555555555556,0,0,0,3,6,FALSE
269,2022-03-18T18:44:06Z,2022-03-18T19:00:32Z,986,1,2022-03-18T19:00:33Z,0.8999999761581421,Chrome,99.0.4844.51,Windows NT 10.0,1920,1080,NA,1.7777777777777777,486,54,250,64,34,55,-0.39436227642544847,-0.35291950335221234,-0.5864955133965383,-0.4212267883884009,-0.552128780389171,-0.48799585744453366,1,2,2,2,2,1,1,4,1,2,2,2,1,1,1,2,1,1,2,2,1.0894228312566052,0,0,2,3,3,1.65,0,2,2,2,4,1,1,1,1,1,1,1,2,2,1,2,2,1,1,1,1,1,1,2,1,2,0,0,0,0,2,1,2,1,2,2,1,1,1,1,3,1,1,2,1,1,1,1,1,1,1,1,1,1,1,1,1,1,2,2,1,1,1,1,1,1,1,1,1,1,1,1.7376764714754929,1.5976172734359604,1.25,0,1,0,1.6,0,1.4444444444444444,0,1.25,0,1,0,1.2857142857142858,0,1,0,1.2432432432432432,0,1,0,0,-1.1165906600899338,-0.4013584353189139,-0.7589745477044239,2,2,3,1,1,2,3,1,1,1.1126972805283737,2,0,1,-0.37981704324605103,4,4,5,4,2,2,4,3,1,1,2,1.2535663410560174,2,3.5714285714285716,0,-1.272579847782007,0,-0.7053926514630097,3,3,3,3,3,5,4,3,3,4,5,5,2,3,4,5,3,5,4,2,1.3627702877384937,3,0,4.6,0,3.8,0,3,0,3.8,0,1,2,2,1,2,2,2,2,1,1,2,3,1,2,1,2,2,2,2,2,0.7591546545162482,1.75,0,1,2,2,1,2,2,2,2,1,1,2,3,1,2,1,2,2,2,2,2,0.7591546545162482,1.75,0,I lived with my mother and father an equal amount of time (joint custody),0,"Hispanic of Latino (e.g., Mexican American, Central American, and others) & White, Caucasian, Anglo, European American",1,29,0,1,NA,1,2,6,Mturker,1,185,69,1,5,2,0,0,1,0,0,I lived with my mother and father an equal amount of time (joint custody),0,TRUE,TRUE,TRUE,TRUE,TRUE,5,0.4839290322574877,0.46126562500279394,0.48352187500149013,0.5639590909115293,0.5815666666689018,0.5915481481474859,0.96875,1,1,0.6875,0.75,0.84375,0.057,0.355,0.43,0.007,1.257,35.8473277040323,1942.8923241032726,0.058,0.354,0.448,0.007,1.301,44.389770693817745,1946.6494466766806,278,0.8237037037037037,0,3,0,0,3,FALSE
270,2022-03-18T18:39:28Z,2022-03-18T19:01:40Z,1331,1,2022-03-18T19:01:40Z,0.8999999761581421,Chrome,99.0.4844.51,Macintosh,1440,900,no,1.6,562,96,373,86,67,84,-0.23837449027978405,-0.1214083253068265,-0.14025510446449202,-0.15035163397699064,0.12365267578638717,-0.16224926206595747,2,3,4,4,3,1,3,4,2,4,2,4,4,2,4,3,4,1,4,3,1.1821033884786185,0,1,1,4,2,3.05,0,4,3,3,3,3,3,4,4,3,2,4,4,3,5,3,2,4,1,1,3,3,2,3,1,2,0,0,0,0,3,4,3,3,3,2,2,2,3,3,2,3,2,3,3,2,4,4,4,5,5,3,1,2,1,5,5,3,2,1,1,4,5,4,3,3,3,2,2,1,1,1.166988372633533,0.7988086367179802,2.375,0,1.5,0,3.4,0,2.7777777777777777,0,3.3333333333333335,0,2.8333333333333335,0,2.857142857142857,0,3,0,3,0,1,0,0,0.9293560679635983,-0.22899200544817064,0.3501820312577138,1,1,4,2,1,1,2,3,1,1.4142135623730951,1.7142857142857142,0,2,-0.15904859491752288,3,3,3,2,1,1,2,4,4,4,2,1.1338934190276817,4,2.142857142857143,0,-0.26897114785137577,0,-0.8679076046072073,2,3,3,4,3,3,5,4,4,3,4,5,3,5,5,5,4,4,5,5,1.52127765851133,3,0,4,0,4.2,0,4.6,0,4.266666666666667,0,3,3,4,3,4,4,3,4,3,4,2,3,2,3,2,3,3,3,3,3,0.8335087534664907,3.1,0,3,3,4,3,4,4,3,4,3,4,2,3,2,3,2,3,3,3,3,3,0.8335087534664907,3.1,0,I lived with my mother and father an equal amount of time (joint custody),0,"White, Caucasian, Anglo, European American",0,25,1,2,NA,1,2,6,Grader,4,240,68,3,5,2,1,0,1,0,1,I lived with my mother and father an equal amount of time (joint custody),0,TRUE,TRUE,TRUE,TRUE,TRUE,2,0.5827531250002794,0.47529677419316385,0.6261031249994412,0.6975645161280709,0.5386843749983237,0.657483870967742,1,0.96875,1,1,1,1,0.087,0.411,0.409,0.06,1.577,41.886933964227744,1840.587953325654,0.084,0.414,0.404,0.04,1.721,60.38635231807514,1846.7330501733588,444,1.3155555555555554,0,3,0,0,3,FALSE
271,2022-03-18T18:42:46Z,2022-03-18T19:01:44Z,1137,1,2022-03-18T19:01:44Z,1,Edge,99.0.1150.39,Windows NT 10.0,1920,1080,NA,1.7777777777777777,541,61,276,57,78,59,-0.2814763785568755,-0.3143343070113147,-0.49216827248407324,-0.5074143375193041,0.3489131611782399,-0.44306529256473004,2,2,1,1,3,1,1,2,1,3,4,1,1,1,2,2,1,1,2,3,0.910465468000326,0,0,1,5,2,1.75,0,1,1,1,1,1,1,2,1,1,1,1,2,1,2,1,2,4,5,1,1,3,1,1,2,2,0,0,0,0,1,4,3,1,1,4,5,2,4,2,3,2,1,2,2,1,1,2,2,1,1,3,1,1,1,3,1,2,3,1,1,1,1,1,1,2,1,2,4,2,1,1.40248599528372,1.8771812708978117,2.25,0,2.25,0,1.2,0,2.7777777777777777,0,1.6666666666666667,0,1.6666666666666667,0,1.4285714285714286,0,1.3333333333333333,0,1.864864864864865,0,1,0,0,-0.5827370471124788,0.029557639357944268,-0.2765897038772672,3,3,5,4,2,1,2,3,2,1.1126972805283737,2.857142857142857,0,2.5,0.6971510229627462,5,5,5,5,1,1,3,9,9,NA,3,1.9023794624226837,9,3.5714285714285716,0,1.2256147765906251,1,0.817387727263819,2,2,2,2,3,4,5,4,4,4,5,5,5,3,5,3,5,4,5,1,1.5886502207249789,2.2,0,4.6,0,4.4,0,3.4,0,4.133333333333334,0,2,2,4,1,1,4,4,4,1,2,3,3,2,2,1,3,1,4,2,2,1.1285761872936695,2.4,0,2,2,4,1,1,4,4,4,1,2,3,3,2,2,1,3,1,4,2,2,1.1285761872936695,2.4,0,I lived with my mother and father an equal amount of time (joint custody),0,Prefer not to say,0,23,3,5,NA,1,4,6,manager,7,164,74,1,5,2,0,0,1,0,0,I lived with my mother and father an equal amount of time (joint custody),0,TRUE,TRUE,TRUE,TRUE,TRUE,1,0.6593064516109804,0.5663999999975786,0.5925187499998137,0.7243700000007948,0.653151851851631,0.6809814814803777,0.96875,1,1,0.9375,0.84375,0.9,0.069,0.404,0.394,0.013,1.892,125.06963750124609,2018.5636459058765,0.074,0.401,0.425,0.012,1.921,141.76484409213808,2038.5721112690728,431,1.2770370370370372,0,3,3,21,24,FALSE
272,2022-03-18T18:27:07Z,2022-03-18T19:02:34Z,2126,1,2022-03-18T19:02:35Z,0.8999999761581421,Chrome,99.0.4844.51,Macintosh,1440,900,n/a,1.6,759,167,676,134,92,105,0.16596227117674084,0.2699558090079924,0.9590200492461586,0.44064870292063163,0.6356083244042343,0.0736362035530115,3,1,1,1,1,1,1,2,1,1,3,1,1,2,1,1,1,1,2,2,1.2814465510343749,0,1,5,3,2,1.4,0,4,2,3,3,4,2,3,5,2,1,5,3,1,3,3,4,5,1,1,1,5,3,3,1,2,0,0,0,0,1,1,2,1,3,3,1,1,2,2,2,5,1,3,1,1,2,5,5,4,4,3,1,1,1,1,1,1,2,2,1,4,4,3,1,1,2,2,2,1,1,1.5948490660697467,1.2227992865708155,2.875,0,1.5,0,2.933333333333333,0,1.6666666666666667,0,2.9166666666666665,0,1.3333333333333333,0,2.4285714285714284,0,1.3333333333333333,0,2.135135135135135,0,1,0,0,0.5659734095726022,-0.22899200544817064,0.16849070206221578,1,1,5,1,1,3,1,2,1,1.5735915849388864,1.8571428571428572,0,1.5,-0.2694328190817869,3,4,4,4,3,3,4,5,5,NA,2,0.7559289460184544,5,3.5714285714285716,0,-0.3749142363789111,1,-0.1582184776150709,2,3,2,5,2,4,3,3,4,2,4,5,3,3,3,3,4,5,2,3,0.9611501047232549,2.8,0,4.4,0,2.6,0,3.2,0,3.4,0,1,3,1,3,3,1,4,3,1,1,2,2,1,1,1,2,1,1,2,3,0.9880869341680844,1.85,0,1,3,1,3,3,1,4,3,1,1,2,2,1,1,1,2,1,1,2,3,0.9880869341680844,1.85,0,I lived with my mother and father an equal amount of time (joint custody),0,"Asian or Asian American (e.g., Chinese, Japanese, and others)",0,22,1,2,NA,1,3,6,unemployed,3,93,60,1,5,2,0,0,3,0,0,I lived with my mother and father an equal amount of time (joint custody),0,TRUE,TRUE,TRUE,TRUE,TRUE,1,0.5794580645164655,0.4729548387097255,0.4869312499992084,0.5882187499997672,0.5181625000007917,0.5845250000001397,1,1,1,1,1,1,0.115,0.328,0.712,0.01,1.272,13.955810555072802,1801.934009339574,0.117,0.328,0.728,0.011,1.332,18.43346574459196,1799.5322628865429,424,1.2562962962962962,0,3,0,0,3,FALSE
273,2022-03-18T18:43:59Z,2022-03-18T19:03:32Z,1172,1,2022-03-18T19:03:33Z,1,Firefox,98.0,Macintosh,1280,800,NA,1.6,479,84,352,75,54,73,-0.40872957251781233,-0.18755437617693674,-0.2164424913553292,-0.28578921118269573,-0.14256426149489335,-0.2858083154854174,2,2,2,1,2,1,2,4,1,2,4,1,1,2,3,3,1,1,4,2,0.8506963092234007,0,1,4,1,1,2.05,0,4,2,5,2,3,3,3,5,5,2,4,4,2,4,4,1,3,1,1,4,5,5,4,4,1,2,0,1,0,1,3,1,3,4,2,2,2,4,4,2,5,1,3,3,1,3,3,5,5,4,3,1,1,1,3,3,1,3,3,3,3,4,3,1,4,4,2,1,2,2,1.2657417201396586,1.2071217242444348,3,0,1.75,0,3.466666666666667,0,2.4444444444444446,0,3.25,0,2,0,2.857142857142857,0,3,0,2.7567567567567566,0,2,0,0,1.125318926267085,0.07635196034519101,0.600835443306138,3,4,5,3,2,3,3,3,4,0.9511897312113419,3.2857142857142856,0,3.5,1.3322613566890549,4,3,3,2,1,1,2,6,4,3,2,1.2724180205607036,5,2.2857142857142856,0,-0.3023610241956905,0,-0.8108337834110466,3,2,3,3,3,4,5,4,4,3,5,5,3,2,5,5,5,5,5,5,1.6846647257229665,2.8,0,4.8,0,4.2,0,4,0,4.333333333333333,0,2,1,3,2,4,3,4,2,3,3,4,2,1,1,1,2,1,3,2,3,1.050062654772261,2.35,0,2,1,3,2,4,3,4,2,3,3,4,2,1,1,1,2,1,3,2,3,1.050062654772261,2.35,0,I lived with my mother and father an equal amount of time (joint custody),0,"Asian or Asian American (e.g., Chinese, Japanese, and others)",0,29,1,2,NA,1,2,6,Tutor,5,95,62,3,5,2,0,0,1,0,0,I lived with my mother and father an equal amount of time (joint custody),0,TRUE,TRUE,TRUE,TRUE,TRUE,5,0.5011333333333333,0.44865625,0.47346875,0.585625,0.543125,0.5788125,1,1,1,1,1,1,0.115,0.304,0.673,0.01,1.407,126.11961069326858,1954.3175516134033,0.116,0.305,0.719,0.01,1.482,133.84396318992992,1924.4318489698712,388,1.1496296296296296,0,3,0,0,3,FALSE
276,2022-03-18T18:43:42Z,2022-03-18T19:07:53Z,1451,1,2022-03-18T19:07:54Z,0.8999999761581421,Chrome,99.0.4844.51,Macintosh,1440,900,NA,1.6,866,102,240,70,35,64,0.38557665430287363,-0.08833529987177138,-0.6227752214397941,-0.3473517462761981,-0.5316505544444572,-0.38690208646497554,2,2,1,1,2,1,1,3,1,2,2,1,1,1,2,2,1,1,2,2,0.998683343734455,0,1,2,3,3,1.55,0,2,1,1,2,1,1,1,1,1,1,1,1,2,2,2,1,1,1,1,1,1,1,1,1,2,0,0,0,0,1,1,1,1,1,1,1,1,1,1,1,1,1,1,1,1,2,1,1,1,2,1,1,1,1,2,2,1,2,1,1,1,1,1,1,1,1,1,1,1,1,1.88880056320607,1.7593288763724921,1,0,1,0,1.3333333333333333,0,1,0,1.1666666666666667,0,1.3333333333333333,0,1.1428571428571428,0,1,0,1.135135135135135,0,1,0,0,-1.38961977557656,-0.4013584353189139,-0.895489105447737,1,1,2,1,1,2,1,1,1,1.6761634196950514,1.2857142857142858,0,1,-0.7941589286438315,5,5,5,5,3,3,5,7,4,6,4,1.5735915849388864,5.5,4.428571428571429,0,1.1187521249887171,0,1.2168095386336297,2,2,2,3,2,4,2,3,4,3,5,3,4,4,3,5,3,4,1,3,0.8997354108424374,2.2,0,3.8,0,3,0,3.4,0,3.4,0,1,1,1,1,1,1,1,4,1,1,2,1,1,2,1,2,1,1,1,1,1,1.3,0,1,1,1,1,1,1,1,4,1,1,2,1,1,2,1,2,1,1,1,1,1,1.3,0,NA,NA,"White, Caucasian, Anglo, European American",0,27,1,2,NA,1,3,6,student,3,152,64,3,5,2,0,0,1,0,0,NA,NA,TRUE,TRUE,TRUE,TRUE,TRUE,5,0.5445437500048429,0.5049625000022352,0.5330843749977648,0.5923250000011175,0.5679516128993803,0.5936437499988824,1,1,1,1,1,1,0.12,0.35,0.652,0.023,1.538,82.08107525140785,1883.377048777017,0.127,0.34,0.676,0.019,1.605,104.58792023175,1890.2579423082784,435,1.2888888888888888,0,3,0,3,6,FALSE
277,2022-03-18T18:48:39Z,2022-03-18T19:08:14Z,1175,1,2022-03-18T19:08:15Z,0.8999999761581421,Chrome,99.0.4844.74,Windows NT 10.0,1536,864,Thank you for letting me participate!,1.7777777777777777,527,67,320,62,51,83,-0.3102109707416032,-0.28126128157625957,-0.33253755709374777,-0.4458518024258018,-0.20399893932903498,-0.17348190328590837,2,2,1,1,2,1,1,2,1,2,2,1,1,1,2,2,1,1,2,2,1.025978352085154,0,1,3,3,3,1.5,0,3,3,3,3,4,1,4,4,3,3,2,4,2,4,3,4,4,1,1,1,4,4,1,0,2,0,0,0,0,3,2,2,2,2,2,2,2,2,2,2,2,2,4,3,3,3,3,3,3,3,4,2,1,1,1,1,3,1,1,1,1,1,1,1,1,1,1,1,1,1,1.2609877438302444,0.816496580927726,2.5,0,1,0,3.066666666666667,0,2.111111111111111,0,2.75,0,1.6666666666666667,0,1.2857142857142858,0,1,0,2,0,0,0,0,0.40130949096801455,-0.6205191861769039,-0.1096048476044447,2,2,3,1,1,1,1,1,1,1.2149857925879117,1.5714285714285714,0,1,-0.6284221744847194,3,3,3,3,2,2,3,7,1,3,3,0.4879500364742666,4,2.7142857142857144,0,-0.1387807531136866,0,-0.47884295106809194,3,3,3,3,3,3,3,4,3,3,5,3,4,3,3,5,3,4,3,3,0.7432233529572065,3,0,3.6,0,3.6,0,3.2,0,3.466666666666667,0,2,2,2,2,2,2,3,2,1,2,2,2,1,2,2,2,2,2,2,2,0.5871429486123998,1.95,0,2,2,2,2,2,2,3,2,1,2,2,2,1,2,2,2,2,2,2,2,0.5871429486123998,1.95,0,I lived with my mother and father an equal amount of time (joint custody),0,Middle Eastern,0,24,1,2,NA,1,1,5,Student,1,218,61,2,5,2,0,0,1,0,0,I lived with my mother and father an equal amount of time (joint custody),0,TRUE,TRUE,TRUE,TRUE,TRUE,1,0.700271875000035,0.5045531249998894,0.5609093750000466,0.6978387096773893,0.5603451612903887,0.5925870967742597,1,1,1,0.96875,0.96875,0.96875,0.073,0.364,0.33,0.134,1.373,67.85915942217736,1918.7637427772697,0.071,0.369,0.335,0.041,1.483,99.17176765960188,1926.3326091666515,382,1.1318518518518519,0,3,0,0,3,FALSE
278,2022-03-18T18:38:49Z,2022-03-18T19:08:57Z,1807,1,2022-03-18T19:08:59Z,0.8999999761581421,Chrome,99.0.4844.74,Windows NT 10.0,2560,1440,no,1.7777777777777777,731,150,517,202,85,62,0.10849308680728552,0.17624890360866954,0.38217269135839144,1.2778991801922632,0.4922607427912371,-0.40936736890487735,1,2,2,1,2,1,2,2,2,2,3,3,2,2,3,2,2,1,3,2,0.8013147091860318,0,0,3,4,4,2,0,3,2,3,2,3,2,2,2,2,1,1,2,4,2,4,3,3,1,1,3,2,2,4,1,2,0,0,0,0,1,2,1,1,1,1,3,2,2,3,2,4,1,4,2,1,5,4,4,5,5,2,1,1,1,2,1,2,2,1,1,1,1,2,2,3,3,1,1,2,1,1.5485147393221343,1.1254628677422756,2.375,0,1.25,0,2.3333333333333335,0,1.5555555555555556,0,3.3333333333333335,0,1.3333333333333333,0,1.4285714285714286,0,2.6666666666666665,0,2.1621621621621623,0,1,0,0,0.0970798601211647,-0.3151752203835423,-0.10904768013118879,2,1,5,1,1,1,2,4,4,1.1338934190276817,1.8571428571428572,0,4,0.6968301871373141,3,3,3,4,1,1,2,4,5,1,2,1.2535663410560174,4.5,2.4285714285714284,0,-0.8208603123331635,0,-1.049459539264391,1,1,2,3,2,3,5,1,5,2,5,4,2,5,5,5,5,5,5,4,1.7511900715418263,1.8,0,4.4,0,3.8,0,4,0,4.066666666666666,0,2,2,1,1,2,1,2,1,4,2,2,2,1,1,1,2,1,2,1,2,1.050062654772261,1.65,0,2,2,1,1,2,1,2,1,4,2,2,2,1,1,1,2,1,2,1,2,1.050062654772261,1.65,0,I lived with my mother and father an equal amount of time (joint custody),0,"White, Caucasian, Anglo, European American",0,23,0,1,NA,1,2,6,self-employed,1,170,66,1,5,2,1,0,1,0,1,I lived with my mother and father an equal amount of time (joint custody),0,TRUE,TRUE,TRUE,TRUE,TRUE,3,0.6131161290320658,0.43330624999944123,0.5408031250000931,0.7571766666655739,0.4864999999994481,0.5594068965505937,0.96875,1,1,0.967741935483871,0.84375,0.9354838709677419,0.07,0.306,0.382,0.019,1.798,40.244624672182184,1905.2299952439737,0.07,0.307,0.386,0.017,1.851,46.75300202583635,1891.233074864004,304,0.9007407407407407,1,3,0,0,3,FALSE
279,2022-03-18T18:53:11Z,2022-03-18T19:10:02Z,1011,1,2022-03-18T19:10:03Z,0.8999999761581421,Chrome,99.0.4844.51,Macintosh,1440,900,no,1.6,446,52,290,53,35,63,-0.47646111123895607,-0.3639438451638974,-0.44137668122351514,-0.5566643655941059,-0.5316505544444572,-0.3981347276849264,2,2,2,1,2,1,2,2,1,2,3,1,1,3,2,2,2,1,1,2,0.9665456669582609,0,1,2,3,2,1.75,0,4,1,5,3,4,3,3,4,3,2,4,4,4,3,1,4,5,5,3,1,4,3,3,3,1,0,0,1,1,1,4,4,2,1,1,1,1,2,2,1,4,1,3,2,1,4,4,4,5,5,5,4,4,5,1,1,1,4,1,1,1,1,1,3,3,2,2,3,2,1,1.6009569210516137,1.0600988273786194,3.5,0,2,0,3.2,0,1.8888888888888888,0,3,0,3.3333333333333335,0,1.4285714285714286,0,2.6666666666666665,0,2.4594594594594597,0,2,1,0,1.0973664140831627,0.8606950077177212,0.9790307109004419,1,1,2,1,1,1,1,3,1,1.7320508075688772,1.1428571428571428,0,2,-0.49052210323574724,3,3,3,3,2,1,3,6,4,5,3,0.7867957924694432,5,2.5714285714285716,0,0.4700624421135551,0,-0.18514785525554878,1,1,1,1,1,5,5,5,5,3,4,5,4,4,4,5,5,5,4,5,1.6761634196950514,1,0,4.8,0,4.2,0,4.6,0,4.533333333333333,0,1,2,2,2,2,2,2,3,3,3,4,3,3,3,1,3,1,3,3,2,0.8013147091860318,2.4,0,1,2,2,2,2,2,2,3,3,3,4,3,3,3,1,3,1,3,3,2,0.8013147091860318,2.4,0,"I lived with my mother, but not father, most of the time.",0,"Black or African American & White, Caucasian, Anglo, European American",1,22,1,2,NA,1,2,4,dancer,3,130,68,3,5,2,0,0,1,0,0,"I lived with my mother, but not father, most of the time.",0,TRUE,TRUE,TRUE,TRUE,TRUE,3,0.4585312499983702,0.4213281250002328,0.4419838709670209,0.5713275862076673,0.49918928571497756,0.5522759999987483,1,1,0.96875,0.90625,0.875,0.8064516129032258,0.051,0.332,0.398,0.016,1.917,53.471965813202516,2012.6598761943167,0.052,0.332,0.415,0.017,2.044,81.21381741459459,2027.5231871955216,412,1.2207407407407407,0,3,0,3,6,FALSE
280,2022-03-18T18:29:01Z,2022-03-18T19:10:31Z,2490,1,2022-03-18T19:10:32Z,0.800000011920929,Chrome,99.0.4844.74,Windows NT 10.0,1920,1080,NA,1.7777777777777777,550,77,381,883,40,188,-0.2630041407238363,-0.22613957251783437,-0.11123133802988738,9.66271645992728,-0.42925942472088774,1.0059454248089363,3,3,2,1,3,1,2,4,1,3,4,2,2,2,3,4,2,1,4,4,0.5104177855340404,0,1,1,4,3,2.55,0,4,2,2,2,1,3,3,3,3,2,3,3,2,3,3,3,3,5,1,3,3,3,2,1,2,0,0,0,0,2,2,2,1,3,1,1,1,1,1,1,1,2,2,3,2,3,2,3,2,2,3,1,4,3,2,4,1,2,2,2,2,2,2,1,1,3,2,2,2,2,1.3528970139409469,0.7988086367179802,2.875,0,2,0,2.6,0,1.5555555555555556,0,2,0,2.8333333333333335,0,1.8571428571428572,0,1.6666666666666667,0,1.972972972972973,0,1,0,0,0.3494398644858764,-0.05662557557742737,0.1464071444542245,1,1,2,1,1,1,1,4,1,1.7320508075688772,1.1428571428571428,0,2.5,-0.29726950199192703,5,5,5,5,2,2,4,4,3,3,3,1.6035674514745464,3.5,4,0,-0.22912466020345523,0,0.16292799501975622,2,2,2,2,2,4,5,4,4,3,5,4,5,3,4,5,4,4,4,4,1.2909944487358056,2,0,4.2,0,4.4,0,3.8,0,4.133333333333334,0,2,1,2,3,2,2,2,3,3,1,1,2,1,1,1,2,1,2,2,2,0.6958523739384593,1.8,0,2,1,2,3,2,2,2,3,3,1,1,2,1,1,1,2,1,2,2,2,0.6958523739384593,1.8,0,"I lived with my mother, but not father, most of the time. & I lived with my mother and father an equal amount of time (joint custody) & I lived with my extended family on mother's side (grandparents, aunts ,uncles, cousins)",1,"White, Caucasian, Anglo, European American",0,28,1,2,NA,1,1,3,unemployed,1,293,66,1,5,2,0,0,1,0,0,"I lived with my mother, but not father, most of the time. & I lived with my mother and father an equal amount of time (joint custody) & I lived with my extended family on mother's side (grandparents, aunts ,uncles, cousins)",1,TRUE,TRUE,TRUE,TRUE,TRUE,6,0.5445322580645161,0.44582580645622744,0.45606562500447034,0.5682906250059605,0.4778812500052154,0.5408677419231784,0.96875,1,1,1,1,0.96875,0.07,0.33,0.566,0.015,1.63,89.91935668354849,1935.3711215356477,0.071,0.333,0.639,0.017,1.77,92.1480435945437,1914.3999295165922,352,1.0429629629629629,0,3,0,0,3,FALSE
281,2022-03-18T18:44:26Z,2022-03-18T19:10:48Z,1582,1,2022-03-18T19:10:49Z,0.8999999761581421,Chrome,99.0.4844.74,Windows NT 10.0,1280,720,Thanks!! :),1.7777777777777777,729,62,403,150,119,68,0.10438814506661014,-0.30882213610547216,-0.03141598033472464,0.6376488152198391,1.188520424911509,-0.3419715215851719,3,1,1,2,3,2,2,3,1,2,3,2,2,4,2,3,2,1,2,3,0.8335087534664907,0,0,4,2,3,2.2,0,4,2,4,3,3,5,4,4,4,3,2,5,2,5,5,4,3,2,4,2,1,3,2,4,2,0,0,0,0,4,4,3,5,5,4,5,5,5,1,3,1,1,4,3,3,4,1,1,1,1,4,1,1,2,3,3,1,3,3,3,4,4,3,2,2,1,2,2,2,2,0.9702790533869323,1.2798809468443688,2.625,0,2,0,3.6666666666666665,0,4.444444444444445,0,2,0,2.3333333333333335,0,3,0,1.6666666666666667,0,2.810810810810811,0,2,0,0,1.072465056398189,0.16253517528056266,0.6175001158393758,3,1,5,3,1,3,1,2,2,1.0690449676496976,2.4285714285714284,0,2,0.2552932904802576,2,3,4,3,1,1,3,3,3,2,2,1.1338934190276817,3,2.4285714285714284,0,-0.8778143430786174,0,-1.0841760019700786,4,3,4,3,3,3,3,3,3,3,3,3,2,4,2,3,4,3,3,3,0.5163977794943222,3.4,0,3.2,0,2.8,0,3,0,3,0,3,2,3,3,2,4,3,4,4,2,4,3,3,3,1,3,1,3,3,3,0.9445132413883326,2.85,0,3,2,3,3,2,4,3,4,4,2,4,3,3,3,1,3,1,3,3,3,0.9445132413883326,2.85,0,"I lived with my mother, but not father, most of the time.",0,"White, Caucasian, Anglo, European American",0,29,0,1,NA,1,2,6,Dispatcher,1,150,70,2,5,2,0,1,1,0,1,"I lived with my mother, but not father, most of the time.",0,TRUE,TRUE,TRUE,TRUE,TRUE,4,0.5272566666655243,0.5026843750004191,0.7278593750004657,0.5306483870961013,0.5316967741928754,0.845306666666766,1,1,1,0.96875,0.96875,0.967741935483871,0.074,0.33,0.262,0.024,1.67,265.58946572228876,2113.302414185542,0.074,0.323,0.273,0.018,1.858,259.52453376800935,2087.26133592611,304,0.9007407407407407,1,3,0,0,3,FALSE
282,2022-03-18T18:53:54Z,2022-03-18T19:11:25Z,1050,1,2022-03-18T19:11:26Z,0.8999999761581421,Chrome,99.0.4844.74,Windows NT 10.0,1536,864,NA,1.7777777777777777,508,49,224,58,37,75,-0.3492079172780193,-0.3804803578814249,-0.6808227543090034,-0.49510183050060363,-0.4906941025550294,-0.2633430330455156,2,1,1,1,2,1,1,2,1,2,1,1,2,1,3,2,1,1,2,2,1.1192102478745307,0,1,1,3,2,1.5,0,1,1,2,1,2,1,1,1,1,1,1,2,2,2,3,1,1,1,1,1,1,1,1,1,2,0,0,0,0,1,3,2,1,2,2,1,2,1,2,1,1,1,2,2,2,2,1,1,1,1,1,1,1,1,2,1,1,2,1,1,1,1,1,1,1,1,1,1,1,1,1.6589913357978252,1.6987390281365427,1,0,1,0,1.4666666666666666,0,1.6666666666666667,0,1.4166666666666667,0,1.1666666666666667,0,1.1428571428571428,0,1,0,1.3513513513513513,0,1,0,0,-1.2368652019517423,-0.4013584353189139,-0.8191118186353281,1,1,1,1,1,1,1,1,1,1.9518001458970664,1,0,1,-0.9598956828029438,5,5,5,5,4,4,5,4,3,6,4,1.4638501094227998,3.5,4.714285714285714,0,0.7573764966296425,0,1.1513855756961782,2,2,2,2,2,4,5,4,4,4,5,4,4,5,5,4,5,5,4,3,1.505545305418162,2,0,4.6,0,4.2,0,4.2,0,4.333333333333333,0,1,2,1,1,1,1,1,1,1,2,2,1,2,1,1,1,1,1,1,2,1.1821033884786185,1.25,0,1,2,1,1,1,1,1,1,1,2,2,1,2,1,1,1,1,1,1,2,1.1821033884786185,1.25,0,I lived with my mother and father an equal amount of time (joint custody),0,"White, Caucasian, Anglo, European American",0,25,0,1,NA,1,3,6,Quality Assurance Specialist,5,150,70,2,5,2,0,0,0,0,0,I lived with my mother and father an equal amount of time (joint custody),0,TRUE,TRUE,TRUE,TRUE,TRUE,5,0.5057312500048429,0.4007687499951571,0.4681374999973923,0.5381709677403973,0.45139062500186267,0.5591187500003725,1,1,1,0.96875,1,1,0.145,0.223,0.596,0.016,1.735,18.438578939832297,1810.297602685411,0.137,0.243,0.613,0.017,1.818,23.08915903332022,1805.6219335248707,414,1.2266666666666668,0,3,0,0,3,FALSE
283,2022-03-18T18:53:14Z,2022-03-18T19:12:06Z,1132,1,2022-03-18T19:12:07Z,1,Firefox,90.0,Windows NT 10.0,1920,1080,NA,1.7777777777777777,486,137,262,47,44,69,-0.39436227642544847,0.1045906818327168,-0.5429598637446313,-0.6305394077063088,-0.34734652094203217,-0.33073888036522103,2,3,2,2,2,1,3,2,1,2,4,2,1,4,2,2,3,1,3,2,0.9233805168766387,0,0,1,4,3,2.2,0,3,3,2,2,4,3,4,4,2,1,1,2,2,3,4,2,1,3,1,1,1,2,1,1,2,0,0,0,0,3,1,1,1,2,1,2,2,1,3,1,4,3,1,2,1,5,3,3,3,2,3,1,1,1,3,1,1,2,1,1,1,1,2,1,2,1,2,2,2,1,1.572091432287407,1.0465362369445672,1.5,0,1.75,0,2.6666666666666665,0,1.5555555555555556,0,2.5833333333333335,0,1.6666666666666667,0,1.2857142857142858,0,1.3333333333333333,0,1.837837837837838,0,1,0,0,-0.2813617220872267,-0.14280879051279902,-0.21208525630001285,1,1,3,2,1,1,1,3,1,1.5275252316519468,1.4285714285714286,0,2,-0.324785349076635,3,4,4,4,2,2,3,4,4,NA,3,0.8997354108424374,4,3.142857142857143,0,-0.12954382975590517,1,-0.24093246747317848,2,2,2,2,2,4,5,4,4,3,5,4,4,3,5,3,4,4,3,5,1.2649110640673518,2,0,4.2,0,3.6,0,4.2,0,4,0,2,1,1,4,3,3,2,4,4,2,1,2,2,3,1,2,1,2,3,3,0.9679060415469871,2.3,0,2,1,1,4,3,3,2,4,4,2,1,2,2,3,1,2,1,2,3,3,0.9679060415469871,2.3,0,I lived with my mother and father an equal amount of time (joint custody),0,"Asian or Asian American (e.g., Chinese, Japanese, and others)",0,27,1,2,NA,1,3,3,n/a,3,110,61,1,5,2,1,0,1,0,1,I lived with my mother and father an equal amount of time (joint custody),0,TRUE,TRUE,TRUE,TRUE,TRUE,6,0.5179677419354839,0.483875,0.47803125,0.5613333333333334,0.52134375,0.5471935483870968,1,1,1,0.9375,1,1,0.109,0.335,0.769,0.018,1.41,13.877842681672897,1813.94131859823,0.106,0.336,0.775,0.018,1.476,25.193591290341175,1809.110565991469,348,1.031111111111111,0,3,0,3,6,FALSE
284,2022-03-18T18:54:04Z,2022-03-18T19:14:01Z,1197,1,2022-03-18T19:14:03Z,1,Edge,92.0.902.62,Macintosh,1440,900,"I enjoyed playing the Flanker game and I was fully attentive, missing only 1 question if I recall correctly. I felt encouraged not to take any breaks whatsoever. That said, thank you for giving me the opportunity to participate in this survey. I had a lot of fun taking part and I hope my input will contribute to your research.",1.6,514,77,290,56,24,84,-0.33689309205599316,-0.22613957251783437,-0.44137668122351514,-0.5197268445380046,-0.7569110398363099,-0.16224926206595747,1,1,1,1,2,1,1,1,1,1,2,1,1,1,1,1,1,1,1,1,1.465390194130093,0,0,2,4,4,1.1,0,3,2,4,1,3,1,2,3,1,1,2,2,1,2,4,1,3,1,1,1,1,1,1,0,2,0,0,0,0,2,4,3,2,2,2,3,5,3,3,1,1,1,4,3,1,3,1,1,2,1,1,1,1,1,1,1,1,1,1,1,2,2,2,1,1,1,1,2,2,1,1.3911992795553898,1.3732131246511903,1.25,0,1.5,0,2.1333333333333333,0,2.888888888888889,0,1.8333333333333333,0,1,0,1.4285714285714286,0,1,0,1.8108108108108107,0,0,0,0,-0.6354924926426991,-0.44815275630616064,-0.5418226244744299,1,1,2,1,1,1,3,4,1,1.7043362064926932,1.4285714285714286,0,2.5,-0.13153274783281477,5,4,4,5,2,2,5,9,9,3,3,1.6035674514745464,9,3.857142857142857,0,0.7646583177840003,0,0.691264036121271,1,1,3,1,1,5,5,5,5,3,5,5,5,5,5,5,5,5,4,3,1.8593393604027366,1.4,0,5,0,4.4,0,4.6,0,4.666666666666667,0,1,1,1,4,1,1,1,1,1,1,1,1,3,1,1,1,1,1,1,1,1.145931016569864,1.25,0,1,1,1,4,1,1,1,1,1,1,1,1,3,1,1,1,1,1,1,1,1.145931016569864,1.25,0,I lived with my mother and father an equal amount of time (joint custody),0,"Asian or Asian American (e.g., Chinese, Japanese, and others)",0,19,0,1,NA,1,2,5,Student,3,150,69,3,5,2,0,0,1,0,0,I lived with my mother and father an equal amount of time (joint custody),0,TRUE,TRUE,TRUE,TRUE,TRUE,3,0.5637999999979811,0.5699687500009313,0.5929625000013039,0.6612935483864238,0.6230062500019558,0.6033937500012108,0.96875,1,1,1,1,1,0.179,0.318,0.686,0.051,1.3,78.38315117735738,1871.987591481373,0.183,0.317,0.69,0.063,1.373,95.58893079314208,1882.4960936060172,374,1.108148148148148,0,3,0,0,3,FALSE
285,2022-03-18T18:42:38Z,2022-03-18T19:15:06Z,1947,1,2022-03-18T19:15:08Z,0.8999999761581421,Chrome,99.0.4844.74,Windows NT 10.0,1920,1080,NA,1.7777777777777777,768,262,620,58,64,44,0.18443450900978003,0.7936120450630317,0.7558536842039262,-0.49510183050060363,0.062217997952245516,-0.6115549108639936,2,2,2,2,3,1,1,2,1,2,2,1,1,1,2,2,1,1,2,2,0.9445132413883326,0,0,4,3,3,1.65,0,2,1,2,2,2,2,2,3,4,3,2,2,4,3,2,2,1,1,1,1,1,2,1,2,2,0,0,0,0,2,2,2,3,2,1,2,1,2,3,2,4,4,3,2,3,2,2,2,2,2,5,1,1,1,3,2,2,3,3,1,2,2,2,1,1,1,2,1,2,2,1.248422427929969,0.9759000729485332,1.25,0,1.75,0,2.4,0,1.8888888888888888,0,2.5833333333333335,0,2.1666666666666665,0,2.142857142857143,0,1,0,2.135135135135135,0,1,0,0,-0.37722702795744073,-0.14280879051279902,-0.26001790923511986,2,2,2,2,1,2,2,1,1,1.1338934190276817,1.8571428571428572,0,1,-0.4626854203256071,3,4,4,4,3,3,3,6,6,4,3,0.5345224838248488,6,3.4285714285714284,0,0.4366725657692403,0,0.25905945818897114,3,4,3,3,3,3,4,3,3,4,3,2,3,4,3,3,4,2,3,2,0.6172133998483676,3.2,0,2.8,0,3.4,0,3,0,3.066666666666667,0,2,3,2,1,2,1,2,2,1,1,1,1,2,1,2,1,1,1,1,1,1.0990426455975697,1.45,0,2,3,2,1,2,1,2,2,1,1,1,1,2,1,2,1,1,1,1,1,1.0990426455975697,1.45,0,I lived with my mother and father an equal amount of time (joint custody),0,"White, Caucasian, Anglo, European American",0,22,0,1,NA,1,3,4,Student,1,150,72,2,5,2,0,0,0,0,0,I lived with my mother and father an equal amount of time (joint custody),0,TRUE,TRUE,TRUE,TRUE,TRUE,3,0.5793343750005588,0.505125,0.5180875000013039,0.5855187499998137,0.5387064516121342,0.5899187499983236,1,1,1,1,0.96875,1,0.065,0.332,0.337,0.018,1.22,103.58071341091528,1894.682366740109,0.068,0.335,0.353,0.019,1.281,112.21904649853644,1898.6020302105787,257,0.7614814814814815,0,3,3,6,9,FALSE
286,2022-03-18T18:39:05Z,2022-03-18T19:15:09Z,2163,1,2022-03-18T19:15:11Z,0.8999999761581421,Chrome,99.0.4844.74,Windows NT 10.0,1536,864,no feedback,1.7777777777777777,678,218,846,120,94,129,-2.878693206120444e-4,0.5510765252059608,1.5757750859815072,0.26827360465882516,0.6765647762936621,0.3432195928318332,4,4,4,3,4,2,2,4,2,4,4,2,1,2,4,4,3,3,4,4,0.9233805168766387,0,0,2,4,2,3.2,0,5,3,2,3,2,3,4,4,3,4,2,5,3,5,5,3,4,5,3,4,5,5,5,3,1,1,0,1,1,2,5,4,4,3,2,3,3,4,1,2,1,1,2,3,1,4,4,4,5,5,4,2,3,1,4,3,3,3,3,3,2,1,1,1,3,4,2,3,2,2,1.2728393929008168,1.0465362369445672,4.25,0,2.25,0,3.533333333333333,0,3.3333333333333335,0,2.75,0,2.8333333333333335,0,2.2857142857142856,0,2.6666666666666665,0,2.810810810810811,0,2,1,0,1.7243294514479097,0.9468782226530928,1.3356038370505012,2,2,4,2,1,2,2,4,1,0.8997354108424374,2.142857142857143,0,2.5,0.2828091375649657,3,4,5,5,2,1,3,4,5,3,3,1.4960264830861913,4.5,3.2857142857142856,0,-0.0484368460239179,0,-0.11406681731020579,2,4,3,4,3,3,3,3,4,2,5,4,2,3,3,5,4,4,3,2,1.01418510567422,3.2,0,4,0,3,0,3,0,3.3333333333333335,0,3,2,4,2,4,4,3,4,1,2,2,3,4,3,2,3,1,4,3,4,1.0809352675491624,2.9,0,3,2,4,2,4,4,3,4,1,2,2,3,4,3,2,3,1,4,3,4,1.0809352675491624,2.9,0,"I lived with my mother, but not father, most of the time. & I lived with my mother and father an equal amount of time (joint custody)",1,"White, Caucasian, Anglo, European American",0,25,1,2,NA,1,2,4,student,2,145,68,2,5,2,1,0,0,0,1,"I lived with my mother, but not father, most of the time. & I lived with my mother and father an equal amount of time (joint custody)",1,TRUE,TRUE,TRUE,TRUE,TRUE,6,0.7256032258072688,0.6663999999999068,0.5877312500008848,0.6815281250008848,0.6265562499996741,0.6568937500009779,1,1,1,1,1,1,0.119,0.389,0.621,0.01,1.148,72.31755262632583,1861.3491849671411,0.12,0.389,0.627,0.01,1.211,95.58801706200879,1882.5463990430653,393,1.1644444444444444,0,3,0,0,3,FALSE
287,2022-03-18T18:28:08Z,2022-03-18T19:15:14Z,2825,1,2022-03-18T19:15:14Z,1,Chrome,97.0.4692.71,Macintosh,1280,800,NA,1.6,2215,67,265,69,42,64,3.154359858388417,-0.28126128157625957,-0.5320759513316546,-0.35966425329489854,-0.38830297283146,-0.38690208646497554,2,2,1,1,1,1,2,2,1,2,4,1,1,1,2,2,2,1,2,2,1.050062654772261,0,1,2,4,3,1.65,0,3,2,3,3,3,2,3,2,2,2,3,3,2,4,4,2,1,1,1,1,2,2,1,0,2,0,0,0,0,2,2,2,2,2,2,2,2,2,3,2,3,1,3,2,2,3,3,3,3,3,2,3,3,1,4,3,2,1,3,2,3,3,3,2,3,2,2,2,2,3,0.9112246322012648,0.6324555320336759,1.375,0,2.25,0,2.7333333333333334,0,2,0,2.5833333333333335,0,2.6666666666666665,0,2.4285714285714284,0,2.3333333333333335,0,2.4054054054054053,0,0,0,0,-0.058824292341278096,-0.18960311150004575,-0.12421370192066192,4,3,4,2,3,4,2,3,2,0.7867957924694432,3.142857142857143,0,2.5,0.8628877771218584,4,4,4,4,4,5,4,3,3,2,3,0.8997354108424374,3,4.142857142857143,0,-0.5335462578170761,0,0.054793796338320766,2,3,3,3,3,3,4,3,4,2,5,3,4,4,3,5,4,4,3,4,0.9856107606091623,2.8,0,3.8,0,3.6,0,3.6,0,3.6666666666666665,0,2,2,3,3,2,3,3,2,2,2,2,2,2,3,2,2,2,2,2,2,0.4893604849295929,2.25,0,2,2,3,3,2,3,3,2,2,2,2,2,2,3,2,2,2,2,2,2,0.4893604849295929,2.25,0,"I lived with my mother, but not father, most of the time.",0,"White, Caucasian, Anglo, European American",0,29,1,2,NA,1,4,4,front desk manager,4,115,62,3,5,2,0,0,1,0,0,"I lived with my mother, but not father, most of the time.",0,TRUE,TRUE,TRUE,TRUE,TRUE,1,0.6105406249910593,0.5779937499798834,0.5977156249955297,0.6617935483801749,0.6331483870860068,0.6429677419277929,1,1,1,1,0.96875,1,0.15,0.332,0.627,0.013,1.205,47.08292439826507,1840.4844671378269,0.145,0.346,0.641,0.015,1.298,52.511303934901775,1835.274783306133,384,1.1377777777777778,0,3,0,0,3,FALSE
288,2022-03-18T17:11:00Z,2022-03-18T19:15:54Z,7494,1,2022-03-18T19:15:55Z,0.800000011920929,Chrome,99.0.4844.51,Windows NT 10.0,1368,912,NA,1.5,6768,86,357,62,53,78,12.499259731035918,-0.1765300343652517,-0.1983026373337013,-0.4458518024258018,-0.16304248743960723,-0.22964510938566288,3,2,4,3,3,3,4,3,1,3,2,2,3,1,3,3,4,1,3,3,0.9403246919632545,0,0,3,5,4,2.7,0,3,1,4,2,3,1,4,3,1,2,3,3,1,2,1,1,4,1,1,2,2,4,2,3,1,0,0,1,0,1,1,1,1,1,3,1,1,1,5,1,4,1,1,4,2,2,1,4,5,4,2,1,1,1,1,1,4,4,4,1,1,2,4,1,1,1,2,2,2,1,1.7005563477556078,1.3345232785352157,2.125,0,1.75,0,2.2666666666666666,0,1.2222222222222223,0,2.8333333333333335,0,1.1666666666666667,0,2.857142857142857,0,1,0,2.027027027027027,0,2,0,0,-0.10035936326245906,0.07635196034519101,-0.012003701458634025,2,3,1,1,1,2,1,3,2,1.618347187425374,1.5714285714285714,0,2.5,-0.04866437075325872,5,5,5,5,4,4,5,6,7,6,3,1.4638501094227998,6.5,4.714285714285714,0,0.9551718539067132,0,1.2719521985390345,3,4,4,2,3,2,3,3,3,4,2,3,2,3,4,3,3,3,4,3,0.50709255283711,3.2,0,2.6,0,3.2,0,3.2,0,3,0,3,2,2,2,2,3,2,1,3,2,2,2,3,4,3,2,2,3,4,3,0.6958523739384593,2.5,0,3,2,2,2,2,3,2,1,3,2,2,2,3,4,3,2,2,3,4,3,0.6958523739384593,2.5,0,"I lived with my mother and father an equal amount of time (joint custody) & I lived with my extended family on mother's side (grandparents, aunts ,uncles, cousins)",1,"Asian or Asian American (e.g., Chinese, Japanese, and others)",0,21,1,2,NA,1,3,6,student,4,156,61,2,5,2,1,0,1,0,1,"I lived with my mother and father an equal amount of time (joint custody) & I lived with my extended family on mother's side (grandparents, aunts ,uncles, cousins)",1,TRUE,TRUE,TRUE,TRUE,TRUE,4,0.5435593750001863,0.5360562499994412,0.5333281250009313,0.6420566666682561,0.5892062499979511,0.5715031250016763,1,1,1,0.9375,1,1,0.103,0.387,0.748,0.018,1.272,59.75217225279302,1869.1177239561491,0.103,0.384,0.759,0.02,1.358,81.54479720859932,1871.1262228910791,460,1.3629629629629632,0,3,3,6,9,FALSE
289,2022-03-18T18:54:41Z,2022-03-18T19:16:05Z,1283,1,2022-03-18T19:16:06Z,1,Firefox,98.0,Windows NT 10.0,1366,768,N/A,1.7786458333333333,651,71,288,75,38,78,-0.05570458281972967,-0.2592125979528895,-0.4486326228321663,-0.28578921118269573,-0.4702158766103155,-0.22964510938566288,2,2,1,2,2,1,1,3,1,2,3,1,1,2,1,2,1,1,1,2,1.0711528467275955,0,0,4,3,2,1.6,0,3,1,2,2,1,1,2,3,1,1,2,2,2,3,2,2,2,1,1,2,2,1,2,3,2,0,0,0,0,1,1,1,2,3,1,2,1,1,2,2,2,1,3,2,4,3,2,4,3,2,2,1,1,1,4,2,1,3,2,1,2,3,2,1,2,1,1,2,2,2,1.4110248016923697,1.3451854182690985,1.625,0,1.75,0,1.8666666666666667,0,1.4444444444444444,0,2.5,0,1.8333333333333333,0,2,0,1.3333333333333333,0,1.945945945945946,0,2,0,0,-0.529095782534176,0.07635196034519101,-0.2263719110944925,2,2,3,1,1,3,2,1,2,1.1126972805283737,2,0,1.5,-0.18656444200223082,4,4,5,3,3,4,4,7,7,3,3,0.9759000729485332,7,3.857142857142857,0,0.4032826894249255,0,0.47098667628447577,2,2,2,3,1,5,2,5,5,2,2,3,4,3,2,1,2,4,3,2,1.1872336794093274,2,0,3.2,0,2.4,0,3.4,0,3,0,1,1,1,2,2,2,2,3,1,3,1,4,2,1,1,3,1,2,1,3,0.7451598203705946,1.85,0,1,1,1,2,2,2,2,3,1,3,1,4,2,1,1,3,1,2,1,3,0.7451598203705946,1.85,0,I lived with my mother and father an equal amount of time (joint custody),0,"Asian or Asian American (e.g., Chinese, Japanese, and others)",0,24,0,1,NA,1,3,4,student,3,229,70,2,5,2,0,0,1,0,0,I lived with my mother and father an equal amount of time (joint custody),0,TRUE,TRUE,TRUE,TRUE,TRUE,1,0.48629032258064514,0.43146875,0.45659375,0.6414074074074074,0.5248461538461539,0.55068965517241375,0.96875,1,1,0.84375,0.8125,0.90625,0.059,0.353,0.604,0.012,1.571,43.226672728905974,1920.4023741626356,0.059,0.353,0.618,0.013,1.613,63.39615708844861,1920.996720465909,340,1.0074074074074075,0,3,0,0,3,FALSE
290,2022-03-18T18:59:16Z,2022-03-18T19:16:14Z,1018,1,2022-03-18T19:16:14Z,1,Firefox,98.0,Windows NT 10.0,1536,864,NA,1.7777777777777777,459,53,218,37,35,79,-0.4497789899245661,-0.35843167425805483,-0.7025905791349568,-0.7536644778933134,-0.5316505544444572,-0.218412468165712,2,2,2,1,4,1,3,2,1,2,2,2,2,3,2,2,1,2,1,2,0.9333020044867296,0,1,2,4,4,1.95,0,2,2,2,2,1,2,3,3,2,3,2,2,4,3,2,2,2,2,2,2,2,1,2,1,2,0,0,0,0,2,4,4,2,2,2,2,2,2,4,3,3,4,2,3,2,2,2,3,4,3,4,2,2,3,4,1,1,2,1,1,2,1,3,1,1,1,2,3,3,3,1.1937021927285403,1,1.875,0,2.75,0,2.3333333333333335,0,2.4444444444444446,0,2.9166666666666665,0,2.6666666666666665,0,1.5714285714285714,0,1,0,2.3513513513513513,0,1,0,0,-0.03874572725141797,0.2019240692286875,0.08158917098863476,2,1,3,3,1,2,3,2,1,1.1338934190276817,2.142857142857143,0,1.5,-0.10369606492267476,4,3,4,4,2,2,4,3,6,5,2,1,4.5,3.2857142857142856,0,0.03545044976224509,0,-0.06293311987872467,4,3,3,3,4,2,1,2,3,2,2,4,5,3,4,3,4,3,3,3,1.0327955589886444,3.4,0,3,0,2.8,0,3,0,2.933333333333333,0,1,2,1,3,3,1,1,2,2,3,2,2,2,2,1,3,1,1,1,2,0.7677718959499145,1.8,0,1,2,1,3,3,1,1,2,2,3,2,2,2,2,1,3,1,1,1,2,0.7677718959499145,1.8,0,I lived with my mother and father an equal amount of time (joint custody),0,"White, Caucasian, Anglo, European American",0,24,0,1,NA,1,2,6,assistant manager,4,174,69,2,5,2,0,0,1,0,0,I lived with my mother and father an equal amount of time (joint custody),0,TRUE,TRUE,TRUE,TRUE,TRUE,5,0.5860666666666666,0.4855625,0.48746875,0.6417692307692308,0.5563333333333333,0.5983,0.9375,1,1,0.8387096774193549,0.967741935483871,0.967741935483871,0.076,0.337,0.463,0.018,1.925,23.92825498255314,1851.0112359231018,0.079,0.339,0.505,0.019,2.03,29.913095386117853,1852.2238366992644,357,1.0577777777777777,0,3,0,0,3,FALSE
292,2022-03-18T18:49:16Z,2022-03-18T19:18:28Z,1752,1,2022-03-18T19:18:29Z,NA,Chrome,98.0.4758.102,Windows NT 6.3,1366,768,Not that I can think of,1.7786458333333333,543,123,549,97,111,167,-0.2773714368162002,0.027420289150921522,0.49826775709681,-0.014914056771285544,1.024694617353798,0.7700599591899675,1,1,1,1,1,1,1,1,1,1,1,1,1,1,1,1,1,1,4,1,1.5312533566021211,0,0,2,5,5,1.15,0,5,3,5,3,1,5,1,3,2,1,5,5,1,5,3,1,5,5,1,5,5,5,5,6,1,2,1,1,1,1,3,1,1,5,1,5,3,3,3,3,5,1,5,3,3,1,3,5,5,5,4,3,1,5,3,2,3,3,2,2,1,1,3,1,3,5,1,5,5,5,1.489704406658992,1.6761634196950514,4,0,4,0,3.2,0,2.5555555555555554,0,3.5,0,3,0,2.142857142857143,0,3,0,2.891891891891892,0,3,1,1,1.5048431762009107,2.6738505919824846,2.0893468840916976,3,2,3,3,1,1,5,2,3,1.3972762620115438,2.5714285714285716,0,2.5,0.5314142688036341,3,3,3,5,3,1,3,4,6,2,3,1.1547005383792515,5,3,0,-0.17217062945800132,0,-0.3443424314222594,3,3,5,1,2,3,5,3,3,3,3,3,4,3,3,3,5,3,3,3,0.7745966692414834,2.8,0,3.4,0,3.6,0,3,0,3.3333333333333335,0,2,1,1,4,2,2,4,3,2,4,1,4,1,2,3,4,4,4,1,2,1.145931016569864,2.55,0,2,1,1,4,2,2,4,3,2,4,1,4,1,2,3,4,4,4,1,2,1.145931016569864,2.55,0,"I lived with my father, but not mother, most of the time.",0,"White, Caucasian, Anglo, European American",0,21,0,1,NA,1,2,5,"Working at retail store stocking items, doing logistics, and do some cashier work",1,140,66,2,5,2,0,1,0,0,1,"I lived with my father, but not mother, most of the time.",0,TRUE,TRUE,TRUE,TRUE,TRUE,3,0.5831968750357628,0.5014781250059605,0.5375903226175616,0.761862499922514,0.5933586207093864,0.6816692308279184,1,1,0.96875,1,0.9354838709677419,0.8666666666666667,0.071,0.326,0.37,0.012,1.989,61.01411116005521,1993.8177353147014,0.071,0.327,0.342,0.013,2.159,87.87497261186503,1993.0332172667866,304,0.9007407407407407,1,0,0,0,3,FALSE
293,2022-03-18T18:55:47Z,2022-03-18T19:18:43Z,1376,1,2022-03-18T19:18:44Z,0.8999999761581421,Chrome,99.0.4844.74,Windows NT 10.0,1920,1080,NA,1.7777777777777777,486,90,458,115,79,85,-0.39436227642544847,-0.15448135074188163,0.16812241390318225,0.2067110695653228,0.3693913871229538,-0.15101662084600656,2,3,2,2,3,1,1,3,1,3,2,1,2,2,2,2,1,1,2,3,0.7591546545162482,0,1,2,3,3,1.95,0,2,2,2,1,1,1,1,2,1,1,1,2,2,1,1,1,1,1,1,1,2,1,1,0,2,0,0,0,0,2,1,1,2,2,1,2,2,4,1,1,2,1,3,1,1,1,1,2,1,3,2,1,1,1,1,1,1,1,1,1,1,1,2,1,1,1,1,1,2,2,1.619605854250695,1.7265434778633235,1.125,0,1.5,0,1.4,0,1.8888888888888888,0,1.5,0,1.1666666666666667,0,1.1428571428571428,0,1,0,1.4324324324324325,0,0,0,0,-1.175940536311432,-0.44815275630616064,-0.8120466463087963,1,1,3,2,1,1,1,1,2,1.5275252316519468,1.4285714285714286,0,1.5,-0.5180379503204552,5,5,5,5,3,3,5,3,6,NA,3,1.5735915849388864,4.5,4.428571428571429,0,0.005972030878747869,1,0.538511828512667,2,3,3,2,2,4,2,3,4,2,2,4,3,3,4,4,5,5,2,3,1.082325538564332,2.4,0,4,0,2.6,0,3.4,0,3.3333333333333335,0,1,1,1,2,3,1,2,4,2,1,1,2,1,2,1,3,1,2,1,2,0.7539370349250519,1.7,0,1,1,1,2,3,1,2,4,2,1,1,2,1,2,1,3,1,2,1,2,0.7539370349250519,1.7,0,I lived with my mother and father an equal amount of time (joint custody),0,"White, Caucasian, Anglo, European American",0,27,0,1,NA,1,3,3,Unemployed,4,177,69,4,5,2,0,0,1,0,0,I lived with my mother and father an equal amount of time (joint custody),0,TRUE,TRUE,TRUE,TRUE,TRUE,6,0.4314218750046566,0.40602187499869613,0.4065124999983236,0.5112218749960884,0.48259354838440494,0.5136906249998138,1,1,1,1,0.96875,1,0.117,0.284,0.96,0.012,1.446,22.68180474124445,1811.929043249078,0.114,0.285,0.961,0.012,1.491,31.002999874357023,1816.0492740831164,312,0.9244444444444444,0,3,0,0,3,FALSE
294,2022-03-18T18:47:27Z,2022-03-18T19:18:45Z,1878,1,2022-03-18T19:18:46Z,0.8999999761581421,Chrome,99.0.4844.51,Windows NT 10.0,1463,823,NA,1.7776427703523694,707,216,554,109,79,105,0.05923378591918096,0.5400521833942759,0.5164076111184379,0.13283602745312004,0.3693913871229538,0.0736362035530115,4,4,3,3,4,2,4,4,2,4,4,4,4,3,4,4,4,2,4,4,1.234376040972246,1,1,2,4,3,3.55,0,5,4,5,4,5,4,4,5,5,5,5,5,1,5,3,3,5,1,1,3,5,5,4,0,2,0,0,0,0,1,4,5,3,3,1,2,2,5,1,1,3,1,3,2,1,5,5,5,5,5,4,1,1,1,2,1,1,1,1,1,4,5,4,2,3,4,1,1,1,1,1.641704965940956,1.7674302033770737,3.375,0,1,0,4.333333333333333,0,2.888888888888889,0,3.0833333333333335,0,1.6666666666666667,0,2.4285714285714284,0,3,0,2.675675675675676,0,0,0,0,1.6324995434634029,-0.6205191861769039,0.5059901786432495,2,2,3,2,2,3,2,1,1,0.7867957924694432,2.2857142857142856,0,1,-0.2140802890869389,1,4,4,1,1,1,2,5,3,2,2,1.6035674514745464,4,2,0,-0.69712652889908,0,-1.2063174174006965,3,3,5,5,5,2,5,5,3,4,4,3,1,5,3,5,3,4,5,3,1.3870146083619754,4.2,0,3.2,0,4,0,3.8,0,3.6666666666666665,0,3,3,4,3,3,4,4,3,3,3,3,3,4,4,2,3,2,4,4,3,0.8255779474818965,3.25,0,3,3,4,3,3,4,4,3,3,3,3,3,4,4,2,3,2,4,4,3,0.8255779474818965,3.25,0,NA,NA,"White, Caucasian, Anglo, European American",0,24,1,3,NA,1,2,6,Unemployed,1,230,67,1,5,2,0,0,3,0,0,NA,NA,TRUE,TRUE,TRUE,TRUE,TRUE,2,0.556421875,0.4654781250022352,0.5379593750033528,0.6739800000091394,0.5602483870944669,0.6156655172315137,1,1,1,0.967741935483871,0.96875,0.9354838709677419,0.058,0.388,0.397,0.013,1.505,69.93653241984273,1929.7236061175236,0.058,0.388,0.462,0.014,1.622,75.15597574028963,1925.3502016814928,368,1.0903703703703704,0,3,0,0,3,FALSE
295,2022-03-18T18:43:48Z,2022-03-18T19:19:52Z,2163,1,2022-03-18T19:19:53Z,1,Chrome,99.0.4844.51,Macintosh,1792,1120,NA,1.6,895,80,470,561,43,66,0.44509830954266666,-0.20960305980030683,0.2116580635550892,5.698089199905731,-0.36782474688674605,-0.3644368040250737,2,3,1,2,2,1,3,3,1,3,3,2,1,2,3,3,2,1,3,3,0.6407232755171874,0,0,2,3,3,2.2,0,2,1,2,1,2,1,3,1,1,1,2,2,3,2,3,1,1,1,1,1,1,1,1,0,2,0,0,0,0,1,1,1,1,1,3,2,1,2,2,3,2,3,3,2,3,3,2,3,3,2,1,1,1,1,1,1,1,1,1,1,2,1,2,1,1,1,1,1,1,1,1.517663764904237,1.4375905768565218,1,0,1,0,1.8,0,1.4444444444444444,0,2.5833333333333335,0,1,0,1.2857142857142858,0,1,0,1.6756756756756757,0,0,0,0,-0.9494661330184516,-0.6205191861769039,-0.7849926595976777,1,1,1,1,1,1,1,1,1,1.9518001458970664,1,0,1,-0.9598956828029438,5,5,5,5,4,4,5,7,7,6,5,1.4638501094227998,7,4.714285714285714,0,1.7340519315195644,0,1.746720372322906,2,2,2,2,2,4,4,3,4,4,5,2,5,4,4,4,4,4,3,3,1.0997835284835873,2,0,3.8,0,4,0,3.6,0,3.8,0,1,1,2,1,2,2,2,2,1,2,1,3,1,2,1,2,1,2,1,2,0.8335087534664907,1.6,0,1,1,2,1,2,2,2,2,1,2,1,3,1,2,1,2,1,2,1,2,0.8335087534664907,1.6,0,I lived with my mother and father an equal amount of time (joint custody),0,"White, Caucasian, Anglo, European American",0,28,1,2,NA,1,3,6,Marketer,4,115,64,4,5,2,0,0,1,0,0,I lived with my mother and father an equal amount of time (joint custody),0,TRUE,TRUE,TRUE,TRUE,TRUE,1,0.45230937500298024,0.467484375,0.528470000076294,0.5619100000063578,0.5553874999880791,0.6128156250268221,1,1,1,0.9375,1,1,0.212,0.279,0.895,0.02,1.819,21.58561570304456,1802.8371528758778,0.214,0.277,0.893,0.021,1.865,31.649426847477027,1812.113161126613,400,1.1851851851851851,0,3,0,21,24,FALSE
296,2022-03-18T18:50:12Z,2022-03-18T19:20:12Z,1799,1,2022-03-18T19:20:12Z,0.8999999761581421,Firefox,98.0,Windows NT 10.0,1536,864,None,1.7777777777777777,777,98,356,121,35,66,0.20290674684281923,-0.11038398349514147,-0.20193060813802688,0.2805861116775256,-0.5316505544444572,-0.3644368040250737,3,2,2,1,4,1,2,3,1,3,3,1,1,1,4,3,1,1,4,3,0.6069769786668839,0,1,2,3,2,2.2,0,5,4,3,3,2,2,5,5,5,3,4,5,1,5,4,4,5,5,1,4,5,5,4,4,1,2,1,0,0,2,5,4,5,5,4,3,3,4,2,4,5,4,5,4,5,4,5,5,5,3,5,2,4,5,4,1,1,3,1,1,2,2,3,1,1,5,2,4,2,1,1.5102254072756096,1.4040757000349275,4.125,0,2.25,0,3.7333333333333334,0,3.888888888888889,0,4.25,0,3.5,0,1.8571428571428572,0,2.3333333333333335,0,3.4324324324324325,0,2,0,1,2.0287559309721113,1.1532475041397348,1.591001717555923,1,1,4,1,1,1,1,3,1,1.4960264830861913,1.4285714285714286,0,2,-0.324785349076635,3,3,3,2,1,1,3,7,6,2,2,0.9511897312113419,6.5,2.2857142857142856,0,-0.24540699345023656,0,-0.776117320705359,3,3,4,2,3,3,2,4,4,1,5,4,5,3,5,1,3,5,2,2,1.4040757000349275,3,0,4,0,2.2,0,3.6,0,3.2666666666666666,0,1,2,1,1,2,1,3,3,1,1,2,1,1,1,1,2,1,1,1,2,1.019545822516343,1.45,0,1,2,1,1,2,1,3,3,1,1,2,1,1,1,1,2,1,1,1,2,1.019545822516343,1.45,0,I lived with my mother and father an equal amount of time (joint custody),0,"White, Caucasian, Anglo, European American",0,24,1,1,NA,1,2,6,Rater,1,160,70,3,5,2,0,0,1,0,0,I lived with my mother and father an equal amount of time (joint custody),0,TRUE,TRUE,TRUE,TRUE,TRUE,6,0.4942666666666667,0.42071875,0.52859375,0.53753125,0.47433333333333333,0.5758214285714286,0.967741935483871,1,1,1,0.9375,0.875,0.064,0.287,0.342,0.006,1.165,133.94224108991494,2070.364812659579,0.064,0.287,0.364,0.006,1.168,148.08081640094818,2044.7900883261777,386,1.1437037037037037,0,3,0,0,3,FALSE
297,2022-03-18T18:57:21Z,2022-03-18T19:20:25Z,1383,1,2022-03-18T19:20:25Z,0.8999999761581421,Chrome,98.0.4758.107,CrOS x86_64 14388.61.0,1200,750,no,1.6,509,77,514,82,53,66,-0.3471554464076816,-0.22613957251783437,0.3712887789454147,-0.1996016620517925,-0.16304248743960723,-0.3644368040250737,3,3,3,2,3,2,2,3,1,3,3,2,2,2,3,3,2,2,3,3,0.3244428422615251,1,0,2,3,2,2.5,0,3,2,2,3,2,2,3,3,2,2,3,3,2,3,4,3,4,1,1,4,4,4,3,1,2,0,0,0,0,2,4,4,3,3,2,3,3,3,2,2,2,2,3,2,3,2,3,4,4,3,3,1,1,1,1,1,1,2,3,1,2,1,1,1,1,2,1,3,1,1,1.0815126766107135,0.6324555320336759,3,0,1.5,0,2.6,0,3,0,2.6666666666666665,0,1.3333333333333333,0,1.5714285714285714,0,1.3333333333333333,0,2.2162162162162162,0,1,0,0,0.5103636582207839,-0.22899200544817064,0.1406858263863066,1,1,3,1,1,2,1,1,1,1.5275252316519468,1.4285714285714286,0,1,-0.7112905515642753,5,5,5,5,3,3,5,6,3,6,4,1.5735915849388864,4.5,4.428571428571429,0,0.9380643108091797,0,1.106670858715232,4,4,4,4,4,3,3,3,2,3,4,3,4,3,3,3,4,3,3,3,0.5345224838248488,4,0,3.4,0,3.2,0,2.8,0,3.1333333333333333,0,2,2,3,3,3,3,3,3,2,2,3,3,2,3,2,4,1,3,2,2,0.6386663736585051,2.55,0,2,2,3,3,3,3,3,3,2,2,3,3,2,3,2,4,1,3,2,2,0.6386663736585051,2.55,0,I lived with my mother and father an equal amount of time (joint custody),0,"White, Caucasian, Anglo, European American",0,26,1,2,NA,1,3,6,retail,2,117,67,3,5,2,0,0,1,0,0,I lived with my mother and father an equal amount of time (joint custody),0,TRUE,TRUE,TRUE,TRUE,TRUE,4,0.47767499999987195,0.41910624999995344,0.4565374999999767,0.5482906249997904,0.5187535714286247,0.5477516129032498,1,1,1,1,0.875,0.96875,0.078,0.277,0.421,0.017,1.647,69.95316283311863,1912.4137290622248,0.075,0.288,0.427,0.02,1.757,93.25362076010383,1916.3616321983088,403,1.194074074074074,0,3,0,0,3,FALSE
298,2022-03-18T18:31:14Z,2022-03-18T19:20:32Z,2957,1,2022-03-18T19:20:32Z,0.8999999761581421,Chrome,99.0.4844.51,Macintosh,2560,1440,N/A,1.7777777777777777,848,196,845,604,272,66,0.34863217863679524,0.42980876527742545,1.5721471151771815,6.22752700170985,4.3216889944527335,-0.3644368040250737,4,4,3,3,4,2,2,4,1,4,4,3,3,4,4,4,2,1,4,4,0.9787209698591858,0,1,4,2,1,3.2,0,1,2,2,2,2,1,3,2,1,1,1,2,2,1,1,2,2,1,1,1,1,1,2,0,2,0,0,0,0,1,1,3,1,2,1,1,1,1,2,2,1,1,3,2,2,1,1,1,1,1,1,1,1,1,2,1,1,1,3,1,2,1,1,1,1,1,2,1,2,2,1.692147559571376,1.5675276256394517,1.375,0,1.75,0,1.6,0,1.3333333333333333,0,1.5,0,1.1666666666666667,0,1.4285714285714286,0,1,0,1.3513513513513513,0,0,0,0,-1.0147214695604967,-0.361969541370789,-0.6883455054656429,2,2,3,1,2,3,2,2,1,0.9759000729485332,2.142857142857143,0,1.5,-0.10369606492267476,5,5,5,4,2,3,4,7,6,5,4,1.3801311186847085,6.5,4,0,1.0853622486444023,0,0.9641765660311027,2,2,1,3,2,4,4,5,5,5,5,4,5,3,4,5,5,5,4,5,1.6417180315870614,2,0,4.6,0,4.6,0,4.4,0,4.533333333333333,0,3,1,2,4,4,4,3,4,3,2,4,3,3,2,1,3,1,4,1,3,1.1367080817685316,2.75,0,3,1,2,4,4,4,3,4,3,2,4,3,3,2,1,3,1,4,1,3,1.1367080817685316,2.75,0,I lived with my mother and father an equal amount of time (joint custody),0,Black or African American,0,29,1,2,NA,1,3,6,Software engineer,4,180,67,2,5,2,0,0,1,0,0,I lived with my mother and father an equal amount of time (joint custody),0,TRUE,TRUE,TRUE,TRUE,TRUE,3,0.5332612903228691,0.481593749998603,0.5017687499998137,0.5931290322566225,0.5192896551726194,0.5668066666662693,1,1,1,0.96875,0.90625,0.967741935483871,0.063,0.347,0.445,0.018,1.658,118.58238457479008,1960.4859150020302,0.064,0.347,0.464,0.017,1.714,136.1448088011982,1960.2474715294932,365,1.0814814814814815,0,3,0,3,6,FALSE
299,2022-03-18T19:02:39Z,2022-03-18T19:21:17Z,1117,1,2022-03-18T19:21:18Z,1,Chrome,97.0.4692.71,Macintosh,1440,900,Nothing,1.6,513,87,276,57,33,86,-0.3389455629263309,-0.17101786345940917,-0.49216827248407324,-0.5074143375193041,-0.572607006333885,-0.13978397962605565,2,2,2,1,2,1,1,2,1,2,2,1,2,1,2,2,1,1,2,2,0.9679060415469871,0,1,1,4,4,1.6,0,2,2,2,2,2,2,2,2,2,2,2,2,2,2,2,2,1,3,1,1,2,2,1,2,1,1,0,1,0,2,2,2,1,1,1,1,1,1,2,2,1,1,2,2,2,2,2,1,1,2,3,1,4,1,3,1,1,2,1,1,1,1,1,1,1,1,1,2,2,2,1.6237723475403307,1.0327955589886444,1.625,0,1.75,0,2,0,1.3333333333333333,0,1.6666666666666667,0,2.1666666666666665,0,1.1428571428571428,0,1,0,1.5135135135135136,0,1,0,0,-0.6598033042956178,-0.14280879051279902,-0.40130604740420844,2,2,3,2,1,3,3,2,1,0.9759000729485332,2.2857142857142856,0,1.5,-0.020827687843118697,4,4,4,4,3,3,4,8,8,3,3,0.7867957924694432,8,3.7142857142857144,0,0.5839705036044629,0,0.5036986577532014,3,3,3,3,3,3,2,3,3,4,2,2,3,3,2,2,2,4,2,2,0.8338093878327919,3,0,2.6,0,2.6,0,2.6,0,2.6,0,1,1,1,3,2,1,2,3,1,1,2,3,1,1,1,3,1,2,1,2,0.5104177855340404,1.65,0,1,1,1,3,2,1,2,3,1,1,2,3,1,1,1,3,1,2,1,2,0.5104177855340404,1.65,0,"I lived with my mother, but not father, most of the time. & I lived with my extended family on mother's side (grandparents, aunts ,uncles, cousins)",1,"Asian or Asian American (e.g., Chinese, Japanese, and others)",0,20,1,2,NA,1,4,3,Student,4,95,62,2,5,2,0,0,1,0,0,"I lived with my mother, but not father, most of the time. & I lived with my extended family on mother's side (grandparents, aunts ,uncles, cousins)",1,TRUE,TRUE,TRUE,TRUE,TRUE,3,0.6875281249955296,0.6253749999850988,0.5836161290599454,0.770459374986589,0.6747124999985099,0.7101000000163913,1,1,1,1,1,1,0.122,0.409,0.666,0.011,1.507,72.09220750881907,1872.5935323666579,0.124,0.408,0.681,0.012,1.573,96.98797736286943,1880.966521801336,432,1.28,0,3,0,0,3,FALSE
300,2022-03-18T18:53:00Z,2022-03-18T19:23:26Z,1825,1,2022-03-18T19:23:26Z,0.800000011920929,Chrome,96.0.4664.110,Macintosh,1440,900,"No feedback, just hope you have a great day :)",1.6,437,314,772,85,58,96,-0.49493334907199527,1.0802449321668428,1.3073052464614143,-0.16266414099569113,-0.060651357716037795,-0.027457567426546634,2,2,1,1,2,1,2,3,1,2,4,2,2,1,3,3,2,1,3,4,0.7677718959499145,0,0,2,3,3,2.1,0,4,3,4,4,4,5,4,3,3,3,4,4,3,3,4,4,4,3,2,4,3,5,4,1,2,0,0,0,0,3,4,2,5,5,5,4,5,5,4,4,4,3,4,3,1,5,5,5,3,5,3,2,3,2,4,5,4,2,1,1,4,5,4,4,4,4,2,3,1,1,1.4237369936287485,0.9258200997725514,3.625,0,1.75,0,3.6666666666666665,0,4.222222222222222,0,3.8333333333333335,0,3.1666666666666665,0,3,0,4,0,3.675675675675676,0,1,0,0,1.887418580633685,-0.14280879051279902,0.872304895060443,3,2,3,2,2,2,2,4,3,0.4879500364742666,2.2857142857142856,0,3.5,0.7521827171321622,2,2,2,2,1,1,2,6,1,2,1,1,3.5,1.7142857142857142,0,-1.1317385212503899,0,-1.6260895711715757,3,2,2,4,3,3,5,4,4,3,5,3,3,5,4,2,4,5,5,3,1.3201731488169053,2.8,0,4,0,3.6,0,4,0,3.8666666666666667,0,2,3,3,3,4,3,3,3,3,1,4,3,2,3,1,3,1,2,4,3,0.9459053029269173,2.7,0,2,3,3,3,4,3,3,3,3,1,4,3,2,3,1,3,1,2,4,3,0.9459053029269173,2.7,0,I lived with my mother and father an equal amount of time (joint custody),0,"White, Caucasian, Anglo, European American",0,29,1,2,NA,1,1,4,Supervisor at a catering company,3,150,66,2,5,2,1,0,0,0,1,I lived with my mother and father an equal amount of time (joint custody),0,TRUE,TRUE,TRUE,TRUE,TRUE,5,0.4429062500018626,0.41756129031892747,0.4424906249977648,0.5235333333335541,0.5157777777777778,0.5091071428635291,1,0.96875,1,0.84375,0.84375,0.875,0.051,0.345,0.427,0.027,1.882,90.15738643690399,2038.01421333502,0.049,0.347,0.429,0.032,2.019,118.44253866491972,2044.0598836479687,328,0.9718518518518519,0,3,0,0,3,FALSE
302,2022-03-18T19:06:16Z,2022-03-18T19:25:10Z,1133,1,2022-03-18T19:25:11Z,0.8999999761581421,Chrome,99.0.4844.74,Windows NT 10.0,1536,864,NA,1.7777777777777777,469,83,374,30,28,101,-0.4292542812211892,-0.19306654708277926,-0.13662713366016643,-0.8398520270242167,-0.6749981360574544,0.02870563867320788,2,2,1,1,2,1,1,3,1,2,2,1,1,1,1,2,1,1,3,2,1.050062654772261,0,1,5,4,5,1.55,0,2,2,2,2,2,1,3,2,3,1,1,2,2,2,2,1,1,1,1,1,1,1,1,0,2,0,0,0,0,1,2,1,1,1,2,2,2,2,2,2,2,1,3,1,2,2,2,2,1,3,2,1,1,1,2,1,1,1,1,1,2,2,1,1,1,1,1,1,1,1,1.5017507300664965,1.2227992865708155,1,0,1,0,1.9333333333333333,0,1.5555555555555556,0,1.9166666666666667,0,1.3333333333333333,0,1.2857142857142858,0,1,0,1.5405405405405406,0,0,0,0,-0.9502535277278581,-0.6205191861769039,-0.785386356952381,2,1,3,1,1,2,2,1,1,1.1547005383792515,1.7142857142857142,0,1,-0.5455537974051633,5,5,5,5,2,2,5,6,7,NA,3,1.8126539343499315,6.5,4.142857142857143,0,0.54803547341736,1,0.7140744713685159,3,3,2,3,2,3,3,3,3,2,3,2,3,2,3,3,2,4,3,3,0.4879500364742666,2.6,0,2.8,0,2.8,0,2.8,0,2.8,0,2,2,1,4,1,1,1,3,1,2,2,1,2,2,2,1,1,2,2,1,0.8944271909999159,1.7,0,2,2,1,4,1,1,1,3,1,2,2,1,2,2,2,1,1,2,2,1,0.8944271909999159,1.7,0,I lived with my mother and father an equal amount of time (joint custody),0,"White, Caucasian, Anglo, European American",0,19,1,2,NA,1,3,3,student,3,140,66,2,5,2,0,0,0,0,0,I lived with my mother and father an equal amount of time (joint custody),0,TRUE,TRUE,TRUE,TRUE,TRUE,6,0.5438774193794497,0.43875312501192093,0.4697677418801092,0.6175599999427795,0.5232066665967305,0.583278125077486,0.96875,1,0.96875,0.967741935483871,0.967741935483871,1,0.087,0.328,0.605,0.013,1.592,133.59256992215,1971.4296950723337,0.094,0.315,0.617,0.013,1.736,146.73134844656732,1970.1228268424595,304,0.9007407407407407,1,3,0,0,3,FALSE
303,2022-03-18T19:09:06Z,2022-03-18T19:27:50Z,1123,1,2022-03-18T19:27:51Z,0.8999999761581421,Chrome,99.0.4844.74,Windows NT 10.0,2560,1440,NA,1.7777777777777777,558,61,260,62,33,80,-0.24658437376113482,-0.3143343070113147,-0.5502158053532825,-0.4458518024258018,-0.572607006333885,-0.2071798269457611,2,2,1,1,2,1,1,2,1,2,2,1,1,1,2,2,1,1,2,2,1.025978352085154,0,1,1,3,3,1.5,0,2,2,3,2,3,2,4,2,2,2,2,2,2,2,3,2,2,1,1,2,2,2,2,2,2,0,0,0,0,2,2,3,2,3,1,1,1,1,2,1,2,1,2,1,2,1,1,2,3,2,2,1,1,1,2,1,1,3,3,1,1,1,1,1,1,1,1,1,2,2,1.5562525251134285,0.9154754164341269,1.75,0,1.5,0,2.3333333333333335,0,1.7777777777777777,0,1.6666666666666667,0,1.3333333333333333,0,1.5714285714285714,0,1,0,1.5675675675675675,0,1,0,0,-0.43588793380820823,-0.22899200544817064,-0.33243996962818945,3,3,3,3,3,4,4,2,2,0.4879500364742666,3.2857142857142856,0,2,0.7525035529575942,5,5,5,5,2,2,5,4,5,4,3,1.8126539343499315,4.5,4.142857142857143,0,0.16564084449993424,0,0.48098493055973457,3,2,3,2,3,4,3,4,4,4,4,4,3,4,4,3,3,4,2,2,0.8837151016885368,2.6,0,3.8,0,3,0,3.6,0,3.466666666666667,0,1,1,1,4,1,1,1,2,1,1,1,2,1,3,1,3,2,2,1,1,0.7591546545162482,1.55,0,1,1,1,4,1,1,1,2,1,1,1,2,1,3,1,3,2,2,1,1,0.7591546545162482,1.55,0,I lived with my mother and father an equal amount of time (joint custody),0,"White, Caucasian, Anglo, European American",0,21,0,2,NA,1,3,4,Software developer,4,115,67,2,5,2,0,0,1,0,0,I lived with my mother and father an equal amount of time (joint custody),0,TRUE,TRUE,TRUE,TRUE,TRUE,5,0.5209281250014901,0.4428354838740441,0.46337500000186266,0.5653781249988824,0.5264032258083744,0.5530593750085682,1,1,1,1,1,1,0.115,0.289,0.659,0.008,1.112,38.89545661629643,1834.2092004111778,0.118,0.29,0.688,0.01,1.203,53.9187263086425,1839.4552776150222,372,1.1022222222222222,0,3,0,3,6,FALSE
304,2022-03-18T18:35:33Z,2022-03-18T19:29:16Z,3222,1,2022-03-18T19:29:17Z,0.8999999761581421,Chrome,99.0.4844.51,Windows NT 10.0,1280,720,None,1.7777777777777777,1831,76,587,202,44,153,2.366211044178744,-0.2316517434236769,0.636130647661182,1.2778991801922632,-0.34734652094203217,0.6128029821106549,3,1,4,3,3,4,3,1,3,4,1,2,2,4,3,4,2,2,4,4,1.145931016569864,0,0,2,4,4,2.85,0,2,5,2,5,2,1,2,3,5,3,2,2,5,4,3,4,3,5,4,5,1,5,6,0,2,0,0,0,0,1,2,4,1,4,4,1,2,1,1,2,1,5,1,4,2,2,5,5,3,4,2,5,5,4,4,5,4,1,1,1,1,1,1,1,1,1,4,4,1,4,1.6608004871923232,1.3732131246511903,4.125,0,3.25,0,3.066666666666667,0,2.2222222222222223,0,2.9166666666666665,0,4.166666666666667,0,1.4285714285714286,0,1,0,2.5135135135135136,0,0,0,0,1.3358485866945888,0.15512974824144074,0.7454891674680147,1,3,1,5,1,4,4,1,3,1.4638501094227998,2.7142857142857144,0,2,0.42103004463936994,3,1,5,2,1,5,2,5,5,2,3,1.7320508075688772,5,2.7142857142857144,0,-0.17217062945800132,0,-0.49919582832160314,3,3,5,3,4,1,4,2,3,2,3,4,3,3,4,5,5,2,4,3,1.0600988273786194,3.6,0,3,0,3.6,0,3,0,3.2,0,1,3,4,1,1,3,1,2,4,3,2,2,2,3,1,1,1,1,4,3,1.190974832912761,2.15,0,1,3,4,1,1,3,1,2,4,3,2,2,2,3,1,1,1,1,4,3,1.190974832912761,2.15,0,"I lived with my mother and father an equal amount of time (joint custody) & I lived with my extended family on mother's side (grandparents, aunts ,uncles, cousins)",1,Native American/Alaskan Native/indigenous,0,30,0,1,NA,1,3,6,Software developer,3,160,72,2,5,2,0,0,1,0,0,"I lived with my mother and father an equal amount of time (joint custody) & I lived with my extended family on mother's side (grandparents, aunts ,uncles, cousins)",1,TRUE,TRUE,TRUE,TRUE,TRUE,1,1.8376499999985099,1.8574129032223454,1.9719343750011176,1.9319499999980132,2.1022357142823083,1.9864718749988823,1,1,1,0.967741935483871,0.9333333333333333,1,0.445,0.158,0.239,0.193,0.993,80.40571925642408,1868.0237731770214,0.438,0.16,0.24,0.254,0.974,103.26250501008309,1885.0826634419884,266,0.788148148148148,0,3,0,0,3,FALSE
305,2022-03-18T18:37:50Z,2022-03-18T19:29:15Z,3085,1,2022-03-18T19:29:17Z,0.8999999761581421,Firefox,98.0,Windows NT 10.0,1920,1080,No comments.,1.7777777777777777,475,68,453,100,43,87,-0.41693945599916304,-0.2757491106704171,0.14998255988155434,0.022023464284815848,-0.36782474688674605,-0.12855133840610475,2,1,2,1,3,1,1,2,1,2,1,2,2,1,2,1,1,2,4,2,1.105012502906165,0,1,4,5,4,1.7,0,4,2,1,4,1,1,4,1,1,2,1,2,1,2,3,1,2,2,1,2,1,1,1,2,2,0,0,0,0,2,3,2,2,3,3,2,2,2,1,2,1,1,2,3,2,1,2,2,1,3,2,2,1,1,3,1,1,1,2,1,2,1,2,1,1,1,2,1,2,2,1.2956383286545203,1.1952286093343936,1.375,0,1.75,0,2,0,2.3333333333333335,0,1.75,0,1.6666666666666667,0,1.4285714285714286,0,1,0,1.7567567567567568,0,1,0,0,-0.6627560344558915,-0.14280879051279902,-0.40278241248434526,2,1,3,1,2,1,1,2,1,1.2149857925879117,1.5714285714285714,0,1.5,-0.4351695732408991,4,4,5,4,4,4,4,7,7,6,5,0.8997354108424374,7,4.142857142857143,0,1.7340519315195644,0,1.4370135785242186,1,1,2,1,2,5,3,5,5,3,5,4,4,3,4,5,4,3,4,2,1.2983506020002016,1.4,0,4.2,0,3.8,0,3.8,0,3.933333333333333,0,1,2,1,4,2,2,1,2,1,1,1,2,2,1,1,2,1,2,1,1,0.7591546545162482,1.55,0,1,2,1,4,2,2,1,2,1,1,1,2,2,1,1,2,1,2,1,1,0.7591546545162482,1.55,0,I lived with my mother and father an equal amount of time (joint custody),0,"White, Caucasian, Anglo, European American",0,29,1,2,NA,1,5,6,IT Expert,6,162,65,4,5,2,0,0,1,0,0,I lived with my mother and father an equal amount of time (joint custody),0,TRUE,TRUE,TRUE,TRUE,TRUE,4,0.5295161290322581,0.48453125,0.49235483870967744,0.6156774193548387,0.5700714285714286,0.5527777777777778,0.96875,1,0.96875,0.96875,0.875,0.84375,0.049,0.376,0.463,0.005,0.951,146.7698553249513,2175.411476168943,0.048,0.377,0.44,0.005,1.021,167.8229599462823,2117.8087018399624,320,0.9481481481481481,0,3,0,0,3,FALSE
306,2022-03-18T19:04:27Z,2022-03-18T19:29:26Z,1498,1,2022-03-18T19:29:28Z,0.8999999761581421,Chrome,99.0.4844.74,Windows NT 10.0,1920,1080,n/a,1.7777777777777777,525,183,463,92,56,93,-0.3143159124822786,0.3581505435014727,0.18626226792481013,-0.07647659186478786,-0.10160780960546556,-0.061155491086399345,3,3,3,3,3,1,2,3,1,3,2,2,3,2,3,3,2,2,3,3,0.5525062514530825,0,1,1,4,5,2.5,0,4,3,3,4,3,2,4,4,5,4,3,4,2,3,5,3,4,1,2,3,4,4,4,0,1,0,0,1,0,3,3,4,3,3,3,5,5,5,2,4,3,1,3,5,3,4,4,4,4,4,3,1,1,1,3,2,3,1,2,1,3,1,2,2,3,3,2,2,1,3,1.1203817453240013,1.0327955589886444,3.125,0,2,0,3.533333333333333,0,3.7777777777777777,0,3.4166666666666665,0,1.8333333333333333,0,1.8571428571428572,0,2.6666666666666665,0,2.891891891891892,0,0,0,0,1.2681326416856487,-0.2757863264354174,0.4961731576251156,2,3,5,2,1,2,2,1,1,1.0690449676496976,2.4285714285714284,0,1,-0.13121191200738283,2,2,3,2,1,1,2,3,3,2,2,1.0690449676496976,3,1.8571428571428572,0,-0.8778143430786174,0,-1.393882795768766,3,3,4,2,3,3,2,2,3,3,4,3,4,4,3,3,4,5,3,2,0.8837151016885368,3,0,3.8,0,3,0,2.8,0,3.2,0,1,1,2,3,3,3,3,3,2,2,2,2,1,2,1,3,1,2,2,4,0.8255779474818965,2.15,0,1,1,2,3,3,3,3,3,2,2,2,2,1,2,1,3,1,2,2,4,0.8255779474818965,2.15,0,NA,NA,"White, Caucasian, Anglo, European American",0,25,0,3,NA,1,2,2,n/a,2,128,66,5,5,2,0,0,0,0,0,NA,NA,TRUE,TRUE,TRUE,TRUE,TRUE,5,0.48307419355838527,0.3985031250044703,0.4356031249947846,0.5289965517233158,0.5157071428639548,0.5036548387081392,0.96875,1,1,0.90625,0.875,0.96875,0.058,0.339,0.663,0.022,1.775,94.61118687015393,1935.6096983306995,0.058,0.336,0.675,0.022,1.941,96.19545371497884,1923.594260131759,282,0.8355555555555556,0,3,0,3,6,FALSE
307,2022-03-18T19:16:03Z,2022-03-18T19:29:27Z,804,1,2022-03-18T19:29:28Z,0.8999999761581421,Chrome,99.0.4844.51,Macintosh,1280,800,NA,1.6,475,38,156,27,21,49,-0.41693945599916304,-0.44111423784569265,-0.9275247690031428,-0.8767895480803181,-0.8183457176704515,-0.555391704764239,2,2,1,1,2,1,1,2,1,2,2,1,1,1,2,2,1,1,2,2,1.025978352085154,0,1,1,4,4,1.5,0,2,2,2,2,2,2,2,2,2,2,2,2,2,2,2,2,2,1,1,2,2,2,2,3,2,0,0,0,0,1,1,2,2,2,2,2,2,2,2,4,2,2,2,2,2,2,2,2,2,2,3,2,1,1,3,2,2,2,2,1,2,2,2,2,2,1,2,2,2,2,1.1598902298689069,1.0327955589886444,1.75,0,2,0,2,0,1.7777777777777777,0,2.1666666666666665,0,2,0,1.8571428571428572,0,1.6666666666666667,0,1.945945945945946,0,2,0,0,-0.4162030660730513,0.16253517528056266,-0.12683394539624432,2,2,3,2,2,2,2,1,1,0.7867957924694432,2.142857142857143,0,1,-0.29694866616649496,4,4,4,4,2,2,3,6,4,2,3,0.9511897312113419,5,3.2857142857142856,0,-0.17217062945800132,0,-0.1894890345229157,2,2,2,2,2,4,4,4,4,4,4,4,4,4,3,4,4,3,3,2,0.9258200997725514,2,0,3.8,0,3.8,0,3.4,0,3.6666666666666665,0,1,2,1,4,1,1,2,4,1,1,1,2,1,1,1,2,1,1,1,1,0.6569466853317864,1.5,0,1,2,1,4,1,1,2,4,1,1,1,2,1,1,1,2,1,1,1,1,0.6569466853317864,1.5,0,I lived with my mother and father an equal amount of time (joint custody),0,"White, Caucasian, Anglo, European American",0,24,1,2,NA,1,3,6,buyer,3,155,66,1,5,2,0,0,1,0,0,I lived with my mother and father an equal amount of time (joint custody),0,TRUE,TRUE,TRUE,TRUE,TRUE,3,0.6745032257956843,0.5562218749858439,0.6554124999903143,0.7346562499813736,0.6244967742043157,0.7302531249932945,0.96875,1,1,1,0.96875,1,0.161,0.446,0.75,0.011,1.129,28.25949449307891,1826.339642670233,0.161,0.446,0.755,0.012,1.156,41.83201017479568,1825.056045630995,361,1.0696296296296297,0,3,3,3,6,FALSE
308,2022-03-18T19:03:34Z,2022-03-18T19:31:50Z,1696,1,2022-03-18T19:31:51Z,0.8999999761581421,Chrome,99.0.4844.74,Windows NT 10.0,1366,768,NA,1.7786458333333333,519,98,648,138,84,147,-0.32663073770430473,-0.11038398349514147,0.8574368667250424,0.48989873099543346,0.4717825168465232,0.5454071347909494,4,4,3,1,4,1,1,4,1,3,4,1,1,1,3,4,1,1,4,4,0.5231483637805969,0,1,1,5,5,2.5,0,3,3,3,2,3,3,2,3,2,2,4,3,1,3,2,2,4,1,1,5,5,4,5,7,1,1,0,1,0,1,3,5,3,4,1,2,2,3,2,1,5,1,5,5,5,5,5,4,5,5,1,3,1,1,3,1,3,5,5,1,2,3,3,1,1,3,1,1,3,3,1.6075086575456083,0.8451542547285166,3.375,0,2,0,2.6,0,2.6666666666666665,0,4,0,1.6666666666666667,0,3.142857142857143,0,1.6666666666666667,0,2.945945945945946,0,4,0,0,0.9931350394255071,0.6008566769965427,0.7969958582110248,2,3,3,3,2,3,2,4,2,0.6900655593423543,2.5714285714285716,0,3,0.7246668700474543,5,5,5,5,1,1,4,1,3,2,2,1.9880595947760098,2,3.7142857142857144,0,-1.0585021572581548,0,-0.49747439584142894,1,2,3,1,1,5,5,3,5,3,5,5,3,5,4,1,5,3,5,5,1.6761634196950514,1.6,0,4.6,0,3.4,0,4.4,0,4.133333333333334,0,1,1,3,1,2,2,3,3,2,1,1,3,1,1,1,3,1,3,2,3,0.9119095061289915,1.9,0,1,1,3,1,2,2,3,3,2,1,1,3,1,1,1,3,1,3,2,3,0.9119095061289915,1.9,0,I lived with my mother and father an equal amount of time (joint custody),0,"White, Caucasian, Anglo, European American",0,22,0,1,NA,1,2,1,Unemployed,1,160,71,3,5,2,0,0,1,0,0,I lived with my mother and father an equal amount of time (joint custody),0,TRUE,TRUE,TRUE,TRUE,TRUE,6,0.5244206896554037,0.45687142857110924,0.4854120000003278,0.5819090909087522,0.43992380952427074,0.4612476190474062,0.9354838709677419,0.875,0.78125,0.6875,0.65625,0.65625,0.039,0.313,0.155,0.019,1.674,195.08997727100902,2395.355921456911,0.039,0.31,0.12,0.118,1.74,238.23008932026588,2395.84958200682,338,1.0014814814814814,0,3,0,0,3,FALSE
309,2022-03-18T19:13:55Z,2022-03-18T19:32:09Z,1094,1,2022-03-18T19:32:10Z,1,Firefox,98.0,Windows NT 10.0,1920,1080,NA,1.7777777777777777,438,53,385,74,39,63,-0.4928808782016576,-0.35843167425805483,-0.09671945481258507,-0.29810171820139625,-0.4497376506656016,-0.3981347276849264,1,1,1,1,1,1,1,2,1,1,1,1,1,1,1,1,1,1,1,2,1.465390194130093,0,0,3,5,5,1.1,0,1,3,1,2,1,1,1,1,1,1,1,1,1,1,5,1,1,1,1,1,1,1,1,1,2,0,0,0,0,2,5,5,3,4,2,5,3,5,1,1,1,1,5,1,5,3,1,1,1,1,5,1,5,1,1,1,1,1,1,1,2,2,2,3,4,1,1,1,2,1,1.3019966187341636,1.8439088914585775,1,0,1.25,0,1.4666666666666666,0,3.7777777777777777,0,1.8333333333333333,0,2.3333333333333335,0,1.4285714285714286,0,2.6666666666666665,0,2.3783783783783785,0,1,0,0,-0.788050217590165,-0.3151752203835423,-0.5516127189868536,1,1,5,1,1,1,1,1,1,1.5118578920369088,1.5714285714285714,0,1,-0.6284221744847194,2,2,2,5,1,1,1,3,10,1,1,1.7182493859684491,6.5,2,0,-0.80375276923563,0,-1.2713116916889478,1,1,1,1,1,5,3,2,5,3,2,3,4,2,4,4,3,4,1,2,1.121223821162776,1,0,3.4,0,3,0,3,0,3.1333333333333333,0,1,1,1,1,1,1,1,3,1,1,1,2,1,2,1,1,1,1,1,1,1,1.2,0,1,1,1,1,1,1,1,3,1,1,1,2,1,2,1,1,1,1,1,1,1,1.2,0,"I lived with my mother, but not father, most of the time.",0,"White, Caucasian, Anglo, European American",0,20,0,1,NA,1,1,4,Retail Front End Associate,1,125,66,1,5,2,0,0,1,0,0,"I lived with my mother, but not father, most of the time.",0,TRUE,TRUE,TRUE,TRUE,TRUE,4,0.417625,0.337,0.422875,0.4835625,0.41510714285714284,0.47238709677419355,1,1,1,1,0.9032258064516129,0.96875,0.057,0.324,0.585,0.016,1.323,77.57692800383074,1930.4493183308407,0.058,0.325,0.605,0.018,1.37,108.96587005387002,1935.6235523555665,320,0.9481481481481481,0,3,0,3,6,FALSE
310,2022-03-18T19:06:14Z,2022-03-18T19:32:11Z,1556,1,2022-03-18T19:32:11Z,0.8999999761581421,Chrome,99.0.4844.74,Macintosh,1280,800,No thanks for the opportunity.,1.6,884,87,314,49,47,76,0.422521129968952,-0.17101786345940917,-0.35430538191970123,-0.6059143936689079,-0.28591184310789053,-0.2521103918255647,1,2,1,2,2,1,2,2,1,2,2,1,1,2,1,1,1,2,2,2,1.0894228312566052,0,0,3,3,3,1.55,0,4,3,4,2,3,3,3,3,2,3,3,3,4,3,2,3,3,1,3,3,3,3,3,3,1,2,0,4,0,2,3,2,2,3,2,2,3,2,1,3,2,1,3,4,2,2,2,4,3,3,2,1,1,1,2,2,2,3,3,3,2,2,2,2,4,1,2,3,3,3,1.0904995136125413,0.6399404734221844,2.75,0,2.75,0,3,0,2.3333333333333335,0,2.5,0,1.5,0,2.4285714285714284,0,2.3333333333333335,0,2.27027027027027,0,2,0,0,0.5995361090610448,0.4210848200866775,0.5103104645738612,3,3,4,2,3,3,4,3,3,0.6900655593423543,3.142857142857143,0,3,1.0561403783656784,4,4,4,3,3,3,3,3,3,4,3,0.5345224838248488,3,3.4285714285714284,0,-0.1053908767693718,0,-0.07135658156622153,3,2,3,4,3,3,4,3,3,3,4,3,4,3,3,5,3,3,3,3,0.6761234037828132,3,0,3.2,0,3.8,0,3,0,3.3333333333333335,0,2,3,2,2,2,1,2,2,1,1,2,2,2,2,1,3,1,2,1,1,0.7451598203705946,1.75,0,2,3,2,2,2,1,2,2,1,1,2,2,2,2,1,3,1,2,1,1,0.7451598203705946,1.75,0,"I lived with my extended family on mother's side (grandparents, aunts ,uncles, cousins)",0,"Hispanic of Latino (e.g., Mexican American, Central American, and others)",0,29,0,1,NA,1,3,3,Music Producer,3,240,74,2,5,2,0,0,1,0,0,"I lived with my extended family on mother's side (grandparents, aunts ,uncles, cousins)",0,TRUE,TRUE,TRUE,TRUE,TRUE,3,0.6002612903291179,0.6436749999951571,0.597009374992922,0.686400000001703,0.7170322580664389,0.6891600000123183,1,1,1,0.875,1,0.967741935483871,0.086,0.444,0.583,0.014,1.614,80.63247196071399,1929.3177936746395,0.088,0.448,0.658,0.015,1.754,90.58926010633438,1918.8889831871184,514,1.522962962962963,0,3,0,3,6,FALSE
311,2022-03-18T19:11:52Z,2022-03-18T19:34:08Z,1335,1,2022-03-18T19:34:09Z,0.8999999761581421,Chrome,99.0.4844.74,Windows NT 10.0,1920,1080,NA,1.7777777777777777,514,87,407,80,34,146,-0.33689309205599316,-0.17101786345940917,-0.01690409711742232,-0.22422667608919344,-0.552128780389171,0.5341744935709986,1,1,4,4,1,4,4,1,1,1,1,1,2,1,2,2,1,1,2,1,1.2977713690461004,0,1,2,3,3,1.8,0,5,2,2,1,1,1,2,1,3,1,1,2,1,1,2,2,2,1,1,1,1,3,1,1,2,0,0,0,0,1,1,1,1,1,2,1,2,2,1,1,1,1,2,1,1,1,1,1,1,1,1,1,1,1,1,1,1,3,3,3,1,1,1,1,1,1,1,1,1,1,1.8034001919297482,1.6417180315870614,1.5,0,1,0,1.7333333333333334,0,1.3333333333333333,0,1.0833333333333333,0,1,0,1.8571428571428572,0,1,0,1.2702702702702702,0,1,0,0,-0.9372615150226544,-0.4013584353189139,-0.6693099751707842,2,1,3,1,1,4,3,1,1,1.3972762620115438,2.142857142857143,0,1,-0.29694866616649496,5,5,5,5,4,4,5,9,10,NA,4,1.4638501094227998,9.5,4.714285714285714,0,1.87753276511759,1,1.8341794501684967,3,3,3,1,3,4,2,4,5,2,4,2,2,2,4,4,2,1,1,3,1.121223821162776,2.6,0,2.6,0,2.2,0,3.6,0,2.8,0,1,4,2,2,1,2,3,4,3,2,4,4,3,2,1,3,3,2,4,3,1.0399898784932577,2.65,0,1,4,2,2,1,2,3,4,3,2,4,4,3,2,1,3,3,2,4,3,1.0399898784932577,2.65,0,Prefer not to say.,0,Prefer not to say,0,21,3,5,NA,1,4,3,walmart,2,140,67,1,5,2,0,0,1,0,0,Prefer not to say.,0,TRUE,TRUE,TRUE,TRUE,TRUE,6,0.5680677419247165,0.5313531249687076,0.6060387096481938,0.6394218750223517,0.6205781249850988,0.6102032257818406,1,1,1,1,1,0.96875,0.068,0.369,0.338,0.032,1.813,119.58372736491205,1952.6723948884699,0.067,0.37,0.357,0.025,1.957,124.38498993295384,1950.3822417166107,304,0.9007407407407407,1,3,0,0,3,FALSE
312,2022-03-18T19:03:33Z,2022-03-18T19:38:03Z,2069,1,2022-03-18T19:38:05Z,1,Chrome,96.0.4664.110,Macintosh,1440,900,Thank you!,1.6,671,137,774,150,133,91,-0.014655165412975873,0.1045906818327168,1.3145611880700654,0.6376488152198391,1.4752155881375035,-0.08362077352630115,2,2,1,1,2,1,1,2,1,1,2,1,1,2,2,2,1,1,2,2,1.0711528467275955,0,1,1,4,4,1.5,0,2,2,2,2,3,1,2,2,2,1,3,2,1,2,2,2,2,1,1,1,2,1,1,2,2,0,0,0,0,2,4,1,2,3,2,2,3,2,1,3,1,1,1,2,2,2,2,3,1,3,2,1,1,1,1,1,1,2,1,1,1,2,2,1,2,1,1,1,2,2,1.3814515584733358,1.245945806357946,1.375,0,1.5,0,1.9333333333333333,0,2.3333333333333335,0,1.8333333333333333,0,1.1666666666666667,0,1.4285714285714286,0,1.3333333333333333,0,1.7297297297297298,0,1,0,0,-0.703700559345018,-0.22899200544817064,-0.4663462823965943,1,2,2,1,1,1,1,1,1,1.6761634196950514,1.2857142857142858,0,1,-0.7941589286438315,5,5,5,5,3,3,4,7,8,6,4,1.2909944487358056,7.5,4.285714285714286,0,1.480127753347792,0,1.3596602000207527,2,3,3,1,2,4,4,4,4,3,4,4,4,4,4,3,4,4,3,3,0.8837151016885368,2.2,0,4,0,3.4,0,3.8,0,3.7333333333333334,0,2,1,2,2,2,2,2,3,1,2,2,2,2,3,1,2,1,2,1,2,0.6863327411532597,1.85,0,2,1,2,2,2,2,2,3,1,2,2,2,2,3,1,2,1,2,1,2,0.6863327411532597,1.85,0,NA,NA,"White, Caucasian, Anglo, European American",0,23,0,1,NA,1,4,6,Knife maker,5,180,75,4,5,2,0,0,0,0,0,NA,NA,TRUE,TRUE,TRUE,TRUE,TRUE,3,0.5938968749493361,0.4969625000208616,0.5823937499821186,0.6537000000317892,0.5670562499314546,0.6204687499701976,1,1,1,0.9375,1,1,0.083,0.377,0.434,0.024,1.421,71.32202608913367,1881.574069642879,0.085,0.372,0.44,0.02,1.49,84.01635531013955,1865.9010391096667,516,1.528888888888889,0,3,0,0,3,FALSE
313,2022-03-18T19:15:14Z,2022-03-18T19:38:27Z,1392,1,2022-03-18T19:38:28Z,0.8999999761581421,Chrome,99.0.4844.74,Windows NT 10.0,1536,864,I took a stretch break during the game when you said I could take a break,1.7777777777777777,668,91,338,85,58,73,-0.02081257802398894,-0.1489691798360391,-0.2672340826158873,-0.16266414099569113,-0.060651357716037795,-0.2858083154854174,4,4,2,2,4,1,1,4,1,4,4,2,3,2,4,4,1,2,4,4,0.5871429486123998,0,1,2,2,1,2.85,0,3,3,5,3,5,1,5,3,3,4,3,4,2,4,5,2,4,1,1,3,3,3,4,1,2,0,0,0,0,4,5,5,5,5,2,5,5,4,2,2,2,1,3,3,4,5,3,3,3,3,5,1,5,1,4,3,1,2,1,1,2,5,4,1,3,2,2,2,1,1,1.3378302544754286,1.2798809468443688,2.625,0,1.5,0,3.533333333333333,0,4.444444444444445,0,2.8333333333333335,0,3.1666666666666665,0,2.2857142857142856,0,2,0,3.108108108108108,0,1,0,0,1.1441179749541601,-0.22899200544817064,0.45756298475299473,4,4,5,3,2,3,2,5,1,0.9759000729485332,3.2857142857142856,0,3,1.1390087554452346,3,3,5,4,1,1,2,5,4,NA,2,1.5275252316519468,4.5,2.7142857142857144,0,-0.5104300970135641,1,-0.7053826782519004,3,3,3,2,3,3,1,2,4,1,3,3,4,3,3,5,3,4,1,3,0.9759000729485332,2.8,0,3.2,0,2.4,0,3,0,2.8666666666666667,0,1,1,1,1,2,1,2,4,1,1,3,2,1,1,1,1,1,1,1,2,1.0399898784932577,1.45,0,1,1,1,1,2,1,2,4,1,1,3,2,1,1,1,1,1,1,1,2,1.0399898784932577,1.45,0,I lived with my mother and father an equal amount of time (joint custody),0,"White, Caucasian, Anglo, European American",0,30,1,3,NA,1,2,6,Worker,7,160,65,1,5,2,1,0,1,0,1,I lived with my mother and father an equal amount of time (joint custody),0,TRUE,TRUE,TRUE,TRUE,TRUE,2,0.506362500000745,0.5187281250022352,0.47487187499552963,0.5830199999968211,0.5816400000055632,0.5831807692326032,1,1,1,0.9375,0.967741935483871,0.8125,NA,NA,NA,NA,NA,NA,NA,NA,NA,NA,NA,NA,NA,NA,396,1.1733333333333333,0,3,0,0,3,FALSE
314,2022-03-18T19:09:16Z,2022-03-18T19:40:23Z,1867,1,2022-03-18T19:40:24Z,0.8999999761581421,Chrome,99.0.4844.51,Windows NT 10.0,1920,1080,No probz,1.7777777777777777,588,114,731,169,108,95,-0.18501024765100413,-0.022189249001661155,1.1585584434840654,0.8715864485751479,0.9632599395196565,-0.03869020864649754,1,2,2,2,1,1,2,1,1,1,3,1,1,3,1,1,2,2,2,1,1.1821033884786185,0,1,1,4,2,1.55,0,1,1,3,1,2,3,3,3,1,1,1,2,1,2,2,2,1,2,1,1,3,1,3,2,2,0,0,0,0,1,3,4,1,2,2,1,1,3,3,2,2,1,2,1,1,4,1,3,1,1,2,2,1,2,4,2,1,2,1,1,4,4,3,2,2,1,2,2,1,1,1.4311002927985332,1.5118578920369088,1.75,0,1.5,0,1.8,0,2,0,1.8333333333333333,0,2.1666666666666665,0,2.2857142857142856,0,1.6666666666666667,0,2,0,1,0,0,-0.4799820375349596,-0.22899200544817064,-0.35448702149156514,1,1,4,1,1,3,1,1,2,1.5275252316519468,1.7142857142857142,0,1.5,-0.3523011961613431,4,4,4,4,3,2,3,6,4,4,3,0.7867957924694432,5,3.4285714285714284,0,0.2559847515897029,0,0.14892077827057357,4,1,2,5,3,3,5,4,3,5,3,3,1,3,5,5,2,3,4,3,1.2344267996967353,3,0,2.8,0,4,0,3.6,0,3.466666666666667,0,1,1,4,3,3,4,4,3,3,1,1,3,1,4,4,4,1,3,4,2,1.2732056517228265,2.7,0,1,1,4,3,3,4,4,3,3,1,1,3,1,4,4,4,1,3,4,2,1.2732056517228265,2.7,0,I lived with my mother and father an equal amount of time (joint custody),0,"White, Caucasian, Anglo, European American",0,21,0,1,NA,1,3,3,Student(Software Engineering Major),3,330,71,1,5,2,0,0,1,0,0,I lived with my mother and father an equal amount of time (joint custody),0,TRUE,TRUE,TRUE,TRUE,TRUE,2,0.6768709677457809,0.6697281250134111,0.6329499999992549,0.8342000000067056,0.680800000000745,0.7377718750052153,1,1,1,1,1,1,NA,NA,NA,NA,NA,NA,NA,NA,NA,NA,NA,NA,NA,NA,328,0.9718518518518519,0,0,0,3,6,FALSE
315,2022-03-18T19:24:22Z,2022-03-18T19:44:34Z,1211,1,2022-03-18T19:44:36Z,1,Firefox,98.0,Windows NT 10.0,1920,1080,NA,1.7777777777777777,502,70,377,83,66,66,-0.36152274250004546,-0.26472476885873203,-0.1257432212471897,-0.18728915503309204,0.10317444984167329,-0.3644368040250737,1,1,1,1,1,1,1,1,1,1,1,1,1,1,1,1,1,1,1,1,1.538967528127731,0,1,2,2,1,1,0,4,2,4,3,3,3,3,2,2,2,1,2,1,2,2,4,3,4,1,1,3,2,1,2,1,1,1,2,2,1,2,1,1,1,1,1,1,1,2,2,2,1,1,2,1,1,1,2,3,2,4,4,1,2,2,2,2,2,1,1,1,1,2,1,2,2,2,2,1,1,1.6014257911512992,1.082325538564332,2.375,0,1.5,0,2.4,0,1.1111111111111112,0,1.6666666666666667,0,2.5,0,1.4285714285714286,0,1.6666666666666667,0,1.6216216216216217,0,1,2,1,-0.1100049484526859,2.071856773349947,0.9809259124486306,2,2,4,1,1,2,1,2,2,1.0690449676496976,1.8571428571428572,0,2,-0.07618021783796666,4,4,4,4,1,1,3,1,1,2,2,1.4142135623730951,1,3,0,-1.2391899714376922,0,-0.9947465680081862,2,3,2,2,2,4,4,4,4,1,5,5,4,4,5,3,5,5,2,2,1.505545305418162,2.2,0,4.8,0,2.8,0,3.8,0,3.8,0,1,2,2,2,2,1,3,1,1,2,2,1,2,2,1,2,1,2,2,2,0.9119095061289915,1.7,0,1,2,2,2,2,1,3,1,1,2,2,1,2,2,1,2,1,2,2,2,0.9119095061289915,1.7,0,I lived with my mother and father an equal amount of time (joint custody),0,"Hispanic of Latino (e.g., Mexican American, Central American, and others)",0,19,0,1,NA,1,2,4,Full-Time Student,2,170,65,2,5,2,0,0,1,0,0,I lived with my mother and father an equal amount of time (joint custody),0,TRUE,TRUE,TRUE,TRUE,TRUE,1,0.54265625,0.45428125,0.4852666666666667,0.57284375,0.49989655172413794,0.5268387096774194,1,1,0.9375,1,0.90625,0.96875,NA,NA,NA,NA,NA,NA,NA,NA,NA,NA,NA,NA,NA,NA,488,1.4459259259259258,0,3,0,3,6,FALSE
316,2022-03-18T19:00:42Z,2022-03-18T19:44:58Z,2655,1,2022-03-18T19:44:59Z,0.8999999761581421,Chrome,99.0.4844.74,Windows NT 10.0,1920,1080,I really enjoyed taking part in this research study,1.7777777777777777,645,154,811,59,51,131,-0.06801940804175581,0.19829758723203963,1.448796107830112,-0.4827893234819032,-0.20399893932903498,0.365684875271735,1,1,1,1,2,1,1,3,1,1,1,1,1,1,1,1,1,2,1,1,1.4290224851827542,0,1,1,5,5,1.2,0,4,1,2,2,1,2,2,1,1,1,1,1,2,2,2,6,1,1,2,1,1,1,1,2,2,0,0,0,0,2,1,1,1,1,1,1,1,1,2,1,1,2,2,2,1,3,2,2,2,2,1,1,1,1,3,2,2,2,2,2,2,1,1,2,2,1,2,2,2,2,1.5701800742161598,1.5491933384829668,1.75,0,2,0,1.6666666666666667,0,1.1111111111111112,0,1.8333333333333333,0,1.5,0,1.7142857142857142,0,1.6666666666666667,0,1.5675675675675675,0,1,0,0,-0.7272239762885304,-0.05662557557742737,-0.3919247759329789,1,1,3,1,1,1,2,2,1,1.5275252316519468,1.4285714285714286,0,1.5,-0.5180379503204552,5,5,5,5,3,4,4,6,6,5,3,1.2149857925879117,6,4.428571428571429,0,0.6507502562930925,0,0.9315379045085834,1,1,2,2,1,5,5,5,5,4,4,4,4,4,5,5,4,4,5,3,1.5796322658258457,1.4,0,4.2,0,4.6,0,4.4,0,4.4,0,1,1,1,2,1,2,1,1,1,1,2,1,2,1,1,2,1,2,1,1,1.0310954828418375,1.3,0,1,1,1,2,1,2,1,1,1,1,2,1,2,1,1,2,1,2,1,1,1.0310954828418375,1.3,0,I lived with my mother and father an equal amount of time (joint custody),0,"White, Caucasian, Anglo, European American",0,26,0,1,NA,1,3,6,Analyst,5,170,67,2,5,2,0,0,1,0,0,I lived with my mother and father an equal amount of time (joint custody),0,TRUE,TRUE,TRUE,TRUE,TRUE,5,0.610653124999255,0.5126156249959022,0.5970156250055879,0.6235666666785876,0.5825137931067368,0.6719741935480026,1,1,1,0.967741935483871,0.9666666666666667,1,NA,NA,NA,NA,NA,NA,NA,NA,NA,NA,NA,NA,NA,NA,438,1.2977777777777777,0,3,0,0,3,FALSE
317,2022-03-18T19:22:26Z,2022-03-18T19:47:16Z,1489,1,2022-03-18T19:47:16Z,0.8999999761581421,Chrome,99.0.4844.74,Windows NT 10.0,1280,800,None,1.6,597,90,408,118,53,130,-0.1665380098179649,-0.15448135074188163,-0.01327612631309674,0.24364859062142422,-0.16304248743960723,0.35445223405178405,1,2,1,1,2,1,2,1,1,2,1,2,1,1,1,1,1,1,1,1,1.3562719801759993,0,1,3,5,4,1.25,0,5,1,2,2,1,1,1,1,1,2,1,1,1,1,2,1,1,1,2,1,1,1,1,1,2,0,0,0,0,2,1,2,1,1,2,1,2,1,1,3,4,1,2,1,1,1,4,3,2,3,1,1,2,1,2,1,1,2,3,1,1,1,1,1,1,1,4,2,2,2,1.6398747480186373,1.804755622554715,1.125,0,2.5,0,1.5333333333333334,0,1.4444444444444444,0,2.1666666666666665,0,1.3333333333333333,0,1.4285714285714286,0,1,0,1.6216216216216217,0,1,0,0,-1.0349968833277086,0.11574085429331589,-0.4596280145171963,1,1,2,1,1,1,1,2,1,1.7320508075688772,1.1428571428571428,0,1.5,-0.6837747044795675,5,4,4,5,4,3,5,6,6,2,3,1.3801311186847085,6,4.285714285714286,0,0.008517184721536036,0,0.4626365345431851,1,1,1,1,1,4,3,1,5,1,5,5,5,3,4,3,5,5,3,1,1.6417180315870614,1,0,4.8,0,3,0,2.8,0,3.533333333333333,0,1,1,1,1,1,1,4,1,1,2,1,1,2,1,1,1,1,1,1,1,1.3088765773505315,1.25,0,1,1,1,1,1,1,4,1,1,2,1,1,2,1,1,1,1,1,1,1,1.3088765773505315,1.25,0,I lived with my mother and father an equal amount of time (joint custody),0,"White, Caucasian, Anglo, European American",0,27,0,1,NA,1,4,6,Data Scientist,3,130,68,3,5,2,0,0,1,0,0,I lived with my mother and father an equal amount of time (joint custody),0,TRUE,TRUE,TRUE,TRUE,TRUE,1,0.8568333333333333,0.6058064516129033,0.6137096774193549,0.8770645161290322,0.6008709677419355,0.6408,0.9375,0.96875,0.96875,0.96875,1,0.967741935483871,NA,NA,NA,NA,NA,NA,NA,NA,NA,NA,NA,NA,NA,NA,338,1.0014814814814814,0,3,0,0,3,FALSE
318,2022-03-18T19:32:13Z,2022-03-18T19:47:23Z,909,1,2022-03-18T19:47:24Z,0.8999999761581421,Chrome,99.0.4844.51,Windows NT 10.0,1920,1080,NA,1.7777777777777777,482,57,204,38,40,56,-0.40257215990679923,-0.3363829906346848,-0.753382170395515,-0.7413519708746129,-0.42925942472088774,-0.47676321622458273,3,3,3,3,3,1,3,3,2,2,4,2,2,3,3,3,3,2,3,3,0.6155870112510925,0,1,2,2,1,2.7,0,3,3,4,3,5,4,2,3,3,2,4,3,2,3,5,3,2,3,4,3,4,4,4,2,1,2,2,1,1,2,2,2,2,2,2,2,2,2,2,3,1,2,3,3,2,5,4,4,2,3,3,4,2,3,3,3,2,2,2,1,2,2,3,1,1,2,2,2,2,3,1.092562901481509,0.990430401872025,3.375,0,2.25,0,3.2666666666666666,0,2,0,2.8333333333333335,0,3,0,2,0,1.3333333333333333,0,2.3783783783783785,0,1,1,2,1.036441748442852,2.5367756996427038,1.786608724042778,3,2,3,1,1,1,1,1,1,0.9511897312113419,1.7142857142857142,0,1,-0.5455537974051633,4,4,4,4,2,2,4,4,8,2,2,1.0690449676496976,6,3.4285714285714284,0,-0.3357509005400053,0,-0.21177307306718268,4,4,4,4,4,2,4,1,2,2,2,2,4,3,4,1,2,3,4,5,1.2227992865708155,4,0,2.2,0,3,0,3,0,2.7333333333333334,0,2,3,3,4,4,4,3,3,4,4,4,4,2,3,1,4,2,4,3,3,1.1285761872936695,3.2,0,2,3,3,4,4,4,3,3,4,4,4,4,2,3,1,4,2,4,3,3,1.1285761872936695,3.2,0,I lived with my mother and father an equal amount of time (joint custody),0,"White, Caucasian, Anglo, European American",0,20,0,1,NA,1,2,4,student,3,130,71,1,5,2,0,0,0,0,0,I lived with my mother and father an equal amount of time (joint custody),0,TRUE,TRUE,TRUE,TRUE,TRUE,4,0.4406250000074506,0.3630062500089407,0.3903593749850988,0.5540375000052155,0.4446100000063578,0.5532137930968712,1,1,1,1,0.9375,0.90625,NA,NA,NA,NA,NA,NA,NA,NA,NA,NA,NA,NA,NA,NA,348,1.031111111111111,0,3,0,3,6,FALSE
319,2022-03-18T19:19:30Z,2022-03-18T19:48:29Z,1738,1,2022-03-18T19:48:30Z,0.8999999761581421,Chrome,99.0.4844.74,Windows NT 10.0,1280,720,no,1.7777777777777777,659,120,524,116,51,130,-0.03928481585702815,0.010883776433393964,0.4075684869886705,0.21902357658402327,-0.20399893932903498,0.35445223405178405,1,1,1,1,1,1,2,2,2,2,1,3,1,1,1,1,1,1,3,2,1.2763022245616642,0,0,4,3,1,1.45,0,4,3,1,2,2,1,3,2,1,1,1,1,1,2,4,1,3,4,1,1,1,1,1,2,2,0,0,0,0,1,4,5,3,4,4,5,2,5,2,1,3,1,4,1,4,1,1,1,1,1,3,3,4,2,5,2,1,2,1,1,1,2,1,2,3,1,2,2,2,1,1.3231593822177095,1.3201731488169053,1.625,0,1.75,0,1.9333333333333333,0,3.6666666666666665,0,1.75,0,3.1666666666666665,0,1.2857142857142858,0,2,0,2.3783783783783785,0,1,0,0,-0.3109874480286376,-0.14280879051279902,-0.2268981192707183,3,3,5,4,3,1,2,5,2,1.1338934190276817,3,0,3.5,1.1665246025299427,2,5,5,3,3,4,2,4,7,1,2,1.1126972805283737,5.5,3.4285714285714284,0,-0.6401724981536261,0,-0.3973339701982902,2,2,3,4,4,5,4,4,4,1,3,4,2,2,3,3,2,2,3,3,1.0327955589886444,3,0,3.2,0,2.6,0,3.2,0,3,0,1,2,2,4,1,1,2,4,1,2,3,3,2,1,1,1,1,1,2,2,0.812727700887249,1.85,0,1,2,2,4,1,1,2,4,1,2,3,3,2,1,1,1,1,1,2,2,0.812727700887249,1.85,0,"I lived with my mother, but not father, most of the time.",0,Black or African American,0,20,0,1,NA,1,3,4,Trader,2,105,67,1,5,2,0,0,0,0,0,"I lived with my mother, but not father, most of the time.",0,TRUE,TRUE,TRUE,TRUE,TRUE,6,0.5874483870940823,0.5753906250018627,0.5650906249983236,0.6205812499979511,0.5914322580656698,0.5967187499981373,1,1,1,1,1,1,NA,NA,NA,NA,NA,NA,NA,NA,NA,NA,NA,NA,NA,NA,354,1.0488888888888888,0,3,0,0,3,FALSE
320,2022-03-18T19:27:19Z,2022-03-18T19:48:38Z,1279,1,2022-03-18T19:48:39Z,1,Chrome,99.0.4844.51,Windows NT 10.0,1536,864,No,1.7777777777777777,509,90,334,108,52,122,-0.3471554464076816,-0.15448135074188163,-0.2817459658331896,0.12052352043441956,-0.1835207133843211,0.26459110429217686,2,2,1,1,2,1,1,2,1,2,2,1,1,1,2,2,1,1,2,2,1.025978352085154,0,1,1,5,5,1.5,0,2,1,3,2,3,3,2,2,2,2,2,2,2,3,3,1,1,1,1,1,2,3,1,1,2,0,0,0,0,1,1,1,1,1,1,1,1,1,1,1,1,1,2,1,1,3,1,2,2,2,1,1,1,1,1,1,1,2,2,1,2,2,2,1,1,1,1,2,1,2,1.7774023627640307,0.9611501047232549,1.375,0,1.5,0,2.2666666666666666,0,1,0,1.5,0,1,0,1.7142857142857142,0,1,0,1.2972972972972974,0,1,0,0,-0.7470072683623631,-0.22899200544817064,-0.4879996369052669,1,1,1,1,1,2,1,1,1,1.889822365046136,1.1428571428571428,0,1,-0.8770273057233877,5,5,5,5,3,3,5,8,8,5,4,1.5735915849388864,8,4.428571428571429,0,1.3563939699137084,0,1.361664681257715,1,2,2,2,2,4,3,3,4,3,5,4,4,4,4,3,4,4,3,2,0.9611501047232549,1.8,0,4.2,0,3.2,0,3.4,0,3.6,0,1,1,1,1,2,1,2,1,1,1,1,1,1,2,1,1,1,1,1,1,1.2085223687584246,1.15,0,1,1,1,1,2,1,2,1,1,1,1,1,1,2,1,1,1,1,1,1,1.2085223687584246,1.15,0,I lived with my mother and father an equal amount of time (joint custody),0,"White, Caucasian, Anglo, European American",0,19,1,2,NA,1,4,3,Student,5,115,63,4,5,2,0,0,1,0,0,I lived with my mother and father an equal amount of time (joint custody),0,TRUE,TRUE,TRUE,TRUE,TRUE,1,0.6223718750104308,0.5138062499985099,0.649800000000745,0.768465624999255,0.592584375012666,0.7210406250096858,1,1,1,1,1,1,NA,NA,NA,NA,NA,NA,NA,NA,NA,NA,NA,NA,NA,NA,336,0.9955555555555555,0,3,0,0,3,FALSE
321,2022-03-18T19:32:24Z,2022-03-18T19:48:47Z,982,1,2022-03-18T19:48:49Z,0.699999988079071,Safari,15.2,Macintosh,1440,900,NA,1.6,478,183,154,23,17,76,-0.41078204338815,0.3581505435014727,-0.9347807106117939,-0.9260395761551199,-0.9002586214493071,-0.2521103918255647,1,1,1,1,1,1,1,1,1,1,1,1,2,1,2,3,3,3,3,2,1.2763022245616642,0,1,1,2,2,1.55,0,3,3,3,3,3,3,4,3,3,2,2,4,3,3,4,4,1,1,1,3,2,2,2,12,2,0,0,0,0,4,3,4,3,2,3,3,4,3,2,3,2,2,4,3,4,2,2,3,3,3,4,3,3,2,3,3,2,3,3,3,2,2,3,3,2,3,4,3,3,3,0.5876609101729886,0.4879500364742666,2,0,3.25,0,3.066666666666667,0,3.2222222222222223,0,2.75,0,3,0,2.5714285714285716,0,2.6666666666666665,0,2.864864864864865,0,6,0,0,0.5607569196227858,1.4700942533893808,1.0154255865060833,3,3,5,2,3,3,3,4,1,0.7867957924694432,3.142857142857143,0,2.5,0.8628877771218584,1,2,2,2,1,1,1,4,5,1,2,1.4142135623730951,4.5,1.4285714285714286,0,-0.8208603123331635,0,-1.5914464284120942,3,3,3,3,4,3,4,4,3,2,2,2,3,3,3,2,4,4,4,3,0.7988086367179802,3.2,0,3,0,3,0,3.2,0,3.066666666666667,0,2,3,2,3,4,4,4,2,4,3,2,2,3,4,4,1,4,3,4,4,0.8013147091860318,3.1,0,2,3,2,3,4,4,4,2,4,3,2,2,3,4,4,1,4,3,4,4,0.8013147091860318,3.1,0,"I lived with my mother, but not father, most of the time.",0,"Black or African American & White, Caucasian, Anglo, European American",1,20,1,2,NA,1,2,4,medical scribe,1,112,67,1,5,2,0,0,1,0,0,"I lived with my mother, but not father, most of the time.",0,TRUE,TRUE,TRUE,TRUE,TRUE,1,0.5229062500000091,0.48471874999999726,0.5629375000000009,0.6371249999999982,0.5505000000000009,0.6485806451612908,1,1,1,1,1,1,NA,NA,NA,NA,NA,NA,NA,NA,NA,NA,NA,NA,NA,NA,368,1.0903703703703704,0,3,0,0,3,FALSE
322,2022-03-18T19:24:55Z,2022-03-18T19:49:24Z,1468,1,2022-03-18T19:49:25Z,1,Chrome,97.0.4692.102,CrOS x86_64 14324.80.0,1517,853,"not really. One thing that wasnt asked about that heavily impacted my childhood was sibling abuse from my older brother. One caregiver may have been scary and unpredictable, but my older brother was a monster to me. He physically, mentally and sexually abused me during the majority my childhood. He created more of my unsafe home life than my caregivers (however their neglect allowed for him to do what he did...)",1.7784290738569755,628,97,328,70,35,98,-0.10291141283749654,-0.11589615440098398,-0.30351379065914313,-0.3473517462761981,-0.5316505544444572,-0.004992284986644828,4,3,2,2,4,1,1,4,1,4,4,1,1,2,4,3,1,1,4,4,0.4442616583193193,0,1,2,2,2,2.55,0,3,3,4,3,5,3,4,3,5,3,3,4,2,3,3,2,3,1,1,2,3,2,5,0,2,0,0,0,0,2,4,3,4,3,4,3,2,4,1,3,5,2,4,3,3,4,4,5,5,5,3,1,3,1,2,1,1,1,1,1,4,5,5,1,2,5,1,2,1,2,1.4415540496554675,0.9154754164341269,2.375,0,1.5,0,3.4,0,3.2222222222222223,0,3.6666666666666665,0,1.8333333333333333,0,2.5714285714285716,0,2.6666666666666665,0,2.972972972972973,0,0,0,0,0.9175451473225043,-0.44815275630616064,0.2346961955081718,3,1,4,1,1,3,2,3,5,0.8997354108424374,2.142857142857143,0,4,0.8625669412964263,5,3,3,3,1,1,4,8,7,3,2,1.3972762620115438,7.5,2.857142857142857,0,0.14935851125315286,0,-0.22578028981636505,2,3,2,2,2,4,5,4,3,3,3,4,4,3,4,3,5,4,4,4,1.0600988273786194,2.2,0,4,0,3.8,0,3.6,0,3.8,0,3,3,3,4,4,3,4,3,4,3,4,3,3,3,1,3,2,2,4,4,0.9880869341680844,3.15,0,3,3,3,4,4,3,4,3,4,3,4,3,3,3,1,3,2,2,4,4,0.9880869341680844,3.15,0,I lived with my mother and father an equal amount of time (joint custody),0,"White, Caucasian, Anglo, European American",0,19,1,1,NA,1,2,3,cannabis farmer,3,205,67,2,5,2,0,0,1,0,0,I lived with my mother and father an equal amount of time (joint custody),0,TRUE,TRUE,TRUE,TRUE,TRUE,3,0.6047531249942258,0.47854193548233276,0.4887531249970198,0.6611354838696218,0.5061645161230718,0.5380033333351215,1,1,1,0.96875,0.96875,0.9375,NA,NA,NA,NA,NA,NA,NA,NA,NA,NA,NA,NA,NA,NA,506,1.4992592592592593,0,3,0,0,3,FALSE
323,2022-03-18T19:34:24Z,2022-03-18T19:50:19Z,955,1,2022-03-18T19:50:21Z,0.8999999761581421,Chrome,99.0.4844.74,Windows NT 10.0,2560,1080,NA,2.3703703703703702,444,54,266,64,36,52,-0.48056605297963145,-0.35291950335221234,-0.528447980527329,-0.4212267883884009,-0.5111723284997433,-0.5216937811043864,2,3,2,1,3,1,1,2,1,3,3,1,2,1,2,2,1,1,2,3,0.812727700887249,0,1,1,2,1,1.85,0,3,2,2,3,1,4,4,3,3,3,4,3,3,3,4,2,3,1,1,3,3,3,3,0,2,0,0,0,0,3,2,3,2,1,3,3,2,2,1,2,3,1,3,2,2,3,3,5,5,5,2,1,1,1,2,1,1,1,1,1,1,2,2,1,2,2,1,1,2,2,1.4311002927985332,0.8338093878327919,2.375,0,1.5,0,3,0,2.3333333333333335,0,2.9166666666666665,0,1.3333333333333333,0,1.2857142857142858,0,1.6666666666666667,0,2.108108108108108,0,0,0,0,0.3647940613192983,-0.44815275630616064,-0.04167934749343116,1,2,4,2,2,2,2,1,2,1.1338934190276817,2.142857142857143,0,1.5,-0.10369606492267476,4,4,4,3,1,1,4,6,3,4,3,1.3801311186847085,4.5,3,0,0.16564084449993424,0,-0.13842865703764076,2,3,2,2,3,4,5,5,4,3,2,4,3,3,5,5,4,3,4,4,1.2798809468443688,2.4,0,3.4,0,4,0,4.2,0,3.8666666666666667,0,2,1,2,4,4,4,4,4,2,2,4,4,1,2,1,3,1,2,2,4,1.1821033884786185,2.65,0,2,1,2,4,4,4,4,4,2,2,4,4,1,2,1,3,1,2,2,4,1.1821033884786185,2.65,0,I lived with my mother and father an equal amount of time (joint custody),0,"White, Caucasian, Anglo, European American",0,30,0,1,NA,1,2,6,Logistics Analyst,3,150,67,3,5,2,0,0,1,0,0,I lived with my mother and father an equal amount of time (joint custody),0,TRUE,TRUE,TRUE,TRUE,TRUE,4,0.4621187500007218,0.4204750000006752,0.44403437500097787,0.5656937500006752,0.48795806451670587,0.5053200000007947,1,1,1,1,1,0.967741935483871,NA,NA,NA,NA,NA,NA,NA,NA,NA,NA,NA,NA,NA,NA,406,1.202962962962963,0,3,0,0,3,FALSE
324,2022-03-18T19:05:36Z,2022-03-18T19:51:08Z,2732,1,2022-03-18T19:51:09Z,0.8999999761581421,Chrome,99.0.4844.74,Windows NT 10.0,1920,1080,NA,1.7777777777777777,913,249,409,273,53,67,0.48204278520874505,0.721953823287079,-0.00964815550877116,2.152087178519996,-0.16304248743960723,-0.35320416280512285,2,3,2,1,2,1,1,2,1,3,3,1,1,2,3,3,1,1,3,4,0.7326950970650465,0,1,1,3,3,2,0,4,2,3,3,1,2,2,2,1,1,1,2,1,3,2,1,1,1,1,1,1,2,1,0,2,0,0,0,0,1,2,5,2,2,2,2,2,3,1,2,1,1,4,1,2,2,1,2,3,2,5,1,1,1,1,1,1,1,1,1,2,1,2,1,1,2,1,1,1,1,1.3495633817354862,1.2421180068162376,1.125,0,1,0,2,0,2.3333333333333335,0,1.8333333333333333,0,1.6666666666666667,0,1.2857142857142858,0,1.3333333333333333,0,1.7837837837837838,0,0,0,0,-0.7601961297449181,-0.6205191861769039,-0.690357657960911,2,1,3,1,1,1,2,1,1,1.2149857925879117,1.5714285714285714,0,1,-0.6284221744847194,1,1,1,1,3,3,5,6,6,5,3,0.9759000729485332,6,2.142857142857143,0,0.6507502562930925,0,-0.30728927068616707,3,2,1,3,1,4,3,2,3,4,3,3,4,2,2,2,3,4,2,2,0.8338093878327919,2,0,3.4,0,3,0,2.2,0,2.8666666666666667,0,1,3,1,4,3,2,3,4,3,1,1,3,1,2,1,4,1,1,1,3,0.8750939799154206,2.15,0,1,3,1,4,3,2,3,4,3,1,1,3,1,2,1,4,1,1,1,3,0.8750939799154206,2.15,0,I lived with my mother and father an equal amount of time (joint custody),0,Black or African American & Native American/Alaskan Native/indigenous,1,23,1,2,NA,1,3,3,Student,5,140,70,1,5,2,0,0,0,0,0,I lived with my mother and father an equal amount of time (joint custody),0,TRUE,TRUE,TRUE,TRUE,TRUE,4,0.5822937499973923,0.49818437500298024,0.5686548386985256,0.6074451612868617,0.5581625000033528,0.616862500000745,1,1,1,0.96875,1,1,NA,NA,NA,NA,NA,NA,NA,NA,NA,NA,NA,NA,NA,NA,476,1.4103703703703703,0,3,0,0,3,FALSE
325,2022-03-18T19:07:05Z,2022-03-18T19:52:17Z,2711,1,2022-03-18T19:52:18Z,0.8999999761581421,Chrome,101.0.4911.0,Windows NT 10.0,1095,730,NA,1.5,1288,121,741,237,46,100,1.2517193615853788,0.016395947339236484,1.1948381515273212,1.7088369258467795,-0.3063900690526044,0.017472997453256978,3,4,3,2,4,3,3,4,2,4,4,2,3,2,4,4,2,2,4,4,0.7863975156570492,0,0,4,4,4,3.15,0,5,3,5,5,5,4,5,5,4,5,5,5,2,5,5,5,5,5,4,5,5,5,5,3,1,4,0,2,0,4,4,5,4,4,4,4,4,5,5,5,5,4,5,5,4,5,5,5,5,4,5,4,4,4,3,5,4,4,4,3,4,4,4,2,4,5,2,2,3,3,1.4415540496554675,1.8309508328682538,4.875,0,2.5,0,4.533333333333333,0,4.222222222222222,0,4.75,0,4.166666666666667,0,3.857142857142857,0,3.6666666666666665,0,4.27027027027027,0,2,0,0,3.072250769612778,0.3349016051513059,1.7035761873820419,2,2,4,2,1,3,2,8,3,0.9511897312113419,2.2857142857142856,0,5.5,1.525193122107443,3,2,3,3,1,1,2,1,1,1,2,1.1338934190276817,1,2.142857142857143,0,-1.4532676619615443,0,-1.5897983158781264,5,5,5,5,5,1,5,3,1,3,2,2,2,3,3,3,3,3,3,5,1.1126972805283737,5,0,2.2,0,3.2,0,3,0,2.8,0,4,4,4,4,4,4,4,4,4,4,4,4,4,4,4,4,4,4,4,4,1.231174022502185,4,0,4,4,4,4,4,4,4,4,4,4,4,4,4,4,4,4,4,4,4,4,1.231174022502185,4,0,I lived with my mother and father an equal amount of time (joint custody),0,"Asian or Asian American (e.g., Chinese, Japanese, and others)",0,18,3,2,NA,1,3,4,Student,2,120,67,2,5,2,1,1,1,0,2,I lived with my mother and father an equal amount of time (joint custody),0,TRUE,TRUE,TRUE,TRUE,TRUE,4,0.5324718749998137,0.4796161290324263,0.5036562499997672,0.5918387096769386,0.5555225806446565,0.5711129032256863,1,1,1,1,1,1,0.149,0.286,0.66,0.01,1.052,167.665248082143,1985.410224603762,0.155,0.285,0.752,0.009,1.171,155.2239109370159,1948.4992231448512,304,0.9007407407407407,1,3,3,15,18,FALSE
328,2022-03-18T19:31:08Z,2022-03-18T19:54:26Z,1398,1,2022-03-18T19:54:27Z,0.800000011920929,Chrome,99.0.4844.74,Windows NT 10.0,3440,1440,n/a,2.388888888888889,621,134,395,97,33,50,-0.11727870892986036,0.08805416911518923,-0.060439746769329276,-0.014914056771285544,-0.572607006333885,-0.5441590635442882,2,1,1,1,1,1,1,2,1,1,1,1,1,1,1,1,1,1,1,1,1.465390194130093,0,1,2,3,3,1.1,0,5,2,1,3,1,2,5,3,3,3,2,4,1,5,2,5,5,1,1,1,3,5,2,1,2,0,0,0,0,1,3,3,3,3,1,3,2,2,1,1,2,1,4,3,2,4,4,3,5,5,5,2,1,1,2,1,1,1,1,1,3,3,2,1,1,1,2,1,1,1,1.4441556652887477,1.1254628677422756,2.875,0,1.25,0,2.8,0,2.3333333333333335,0,2.9166666666666665,0,2,0,1.7142857142857142,0,1,0,2.2432432432432434,0,1,0,0,0.554949883640914,-0.3151752203835423,0.11988733162868587,1,1,3,1,1,1,1,3,1,1.5735915849388864,1.2857142857142858,0,2,-0.40765372615619105,5,4,4,3,3,3,5,6,1,3,3,1.2535663410560174,3.5,3.857142857142857,0,-0.22912466020345523,0,0.08550129657008435,1,1,2,3,2,4,4,5,5,5,4,3,2,5,4,5,3,4,4,4,1.4074631010979937,1.8,0,3.6,0,4,0,4.6,0,4.066666666666666,0,1,2,2,4,4,1,1,4,2,1,4,4,1,2,1,4,1,2,1,2,0.9403246919632545,2.2,0,1,2,2,4,4,1,1,4,2,1,4,4,1,2,1,4,1,2,1,2,0.9403246919632545,2.2,0,I lived with my mother and father an equal amount of time (joint custody),0,"Hispanic of Latino (e.g., Mexican American, Central American, and others)",0,23,1,2,NA,1,3,5,Student,5,145,64,2,5,2,0,0,2,0,0,I lived with my mother and father an equal amount of time (joint custody),0,TRUE,TRUE,TRUE,TRUE,TRUE,6,0.45522187500074507,0.48646562499180435,0.4668656250145286,0.5004281250014901,0.5011875000037253,0.5623700000007947,1,1,1,1,1,0.967741935483871,0.076,0.332,0.55,0.018,1.835,100.008151346045,1927.8445693058163,0.078,0.33,0.614,0.018,1.962,100.45586618550878,1932.9129234747668,364,1.0785185185185184,0,3,0,9,12,FALSE
329,2022-03-18T18:38:28Z,2022-03-18T19:55:25Z,4617,1,2022-03-18T19:55:26Z,0.8999999761581421,Chrome,99.0.4844.51,Windows NT 10.0,1366,768,no,1.7786458333333333,1868,465,1227,170,385,197,2.4421524663812386,1.9125827389490633,2.958031962429553,0.8838989555938483,6.635728526205402,1.1070391957884946,3,3,1,1,3,1,2,4,1,3,3,1,1,1,3,3,2,1,3,4,0.512989176042577,0,1,1,3,3,2.2,0,5,5,1,5,3,1,5,3,5,3,3,5,1,4,5,1,6,1,1,1,3,1,1,3,1,5,0,3,3,3,5,5,5,5,5,5,5,5,5,4,1,4,5,1,5,5,1,1,4,4,5,1,5,2,3,1,2,2,2,1,5,5,5,4,5,4,5,2,1,1,1.5962606453985038,1.245945806357946,1.875,0,2.25,0,3.6,0,4.777777777777778,0,3.3333333333333335,0,2.8333333333333335,0,3.142857142857143,0,4.333333333333333,0,3.6486486486486487,0,2,3,0,1.0817169442337131,2.3431978875274098,1.7124574158805614,2,1,2,1,1,1,3,3,1,1.4638501094227998,1.5714285714285714,0,2,-0.24191697199707893,1,1,1,1,1,1,1,1,2,1,1,1.5118578920369088,1.5,1,0,-1.7071918401333168,0,-2.363991980428639,4,4,3,3,3,3,5,5,4,3,4,1,4,3,3,3,3,4,3,3,0.9856107606091623,3.4,0,3,0,3.6,0,3.6,0,3.4,0,3,1,3,4,3,3,3,3,2,2,2,3,2,2,1,3,2,2,1,2,0.6863327411532597,2.35,0,3,1,3,4,3,3,3,3,2,2,2,3,2,2,1,3,2,2,1,2,0.6863327411532597,2.35,0,"I lived with my mother, but not father, most of the time.",0,"Hispanic of Latino (e.g., Mexican American, Central American, and others) & White, Caucasian, Anglo, European American",1,28,1,2,NA,1,2,6,sales,3,122,60,3,5,2,0,0,1,0,0,"I lived with my mother, but not father, most of the time.",0,TRUE,TRUE,TRUE,TRUE,TRUE,3,0.5434187499997206,0.534078124998603,0.5716875,0.6070774193545503,0.5874344827584151,0.6196566666672627,1,1,1,0.96875,0.90625,0.967741935483871,0.086,0.388,0.478,0.022,1.535,100.89544473083674,1936.82409607144,0.078,0.4,0.468,0.019,1.591,125.76453772348232,1955.0656661049475,638,1.8903703703703705,0,3,0,6,9,FALSE
330,2022-03-18T19:31:25Z,2022-03-18T19:55:58Z,1473,1,2022-03-18T19:55:59Z,1,Chrome,97.0.4692.71,Windows NT 6.2,1366,768,Thanks for doing studies like these. I use the money to feed my cats and myself and every little bit helps. Best of luck with your research!,1.7786458333333333,497,79,548,90,60,89,-0.3717850968517339,-0.21511523070614935,0.4946397862924844,-0.10110160590218879,-0.019694905826610026,-0.10608605596620295,3,3,3,3,3,2,3,4,1,3,4,2,2,2,3,4,2,2,4,4,0.6708203932499369,0,0,4,3,3,2.85,0,4,4,4,5,4,1,4,3,4,4,4,5,1,4,5,4,1,1,1,2,2,2,3,5,2,0,0,0,0,3,5,5,4,4,4,5,5,5,3,4,2,4,5,2,4,3,5,2,1,3,2,1,1,1,4,3,3,4,2,2,4,4,3,4,5,2,2,3,3,2,1.2124231810593074,1.2983506020002016,2,0,2.5,0,3.7333333333333334,0,4.444444444444445,0,3.1666666666666665,0,2,0,3.142857142857143,0,3.6666666666666665,0,3.324324324324324,0,3,0,0,1.052878613001708,0.5540623560092959,0.803470484505502,4,4,5,2,2,4,4,3,1,1.2535663410560174,3.5714285714285716,0,2,0.9182403071167066,1,1,2,1,1,1,1,3,6,2,1,1.4960264830861913,4.5,1.1428571428571428,0,-0.9510507070708526,0,-1.8256576850518655,2,3,2,3,3,4,4,4,4,1,3,3,4,4,5,5,5,4,4,2,1.3345232785352157,2.6,0,3.8,0,3.6,0,3.8,0,3.7333333333333334,0,3,2,3,4,2,3,3,4,3,1,3,3,3,3,3,3,1,3,2,3,0.812727700887249,2.75,0,3,2,3,4,2,3,3,4,3,1,3,3,3,3,3,3,1,3,2,3,0.812727700887249,2.75,0,"I lived with my mother, but not father, most of the time.",0,"White, Caucasian, Anglo, European American",0,26,0,1,NA,1,1,4,Bank Teller,3,145,77,1,5,2,0,0,1,0,0,"I lived with my mother, but not father, most of the time.",0,TRUE,TRUE,TRUE,TRUE,TRUE,3,0.5911499999761581,0.466515624910593,0.4776516128970731,0.6344516130262805,0.5120129032750284,0.5214580646022674,1,1,1,0.96875,0.96875,0.96875,0.06,0.35,0.512,0.026,1.774,21.758550257527013,1850.7948219977552,0.062,0.351,0.544,0.027,1.879,34.21218037644641,1856.7541534604527,370,1.0962962962962963,0,3,0,0,3,FALSE
331,2022-03-18T19:37:13Z,2022-03-18T19:56:47Z,1174,1,2022-03-18T19:56:48Z,1,Chrome,99.0.4844.51,Windows NT 6.1,1920,1080,NA,1.7777777777777777,583,86,280,72,52,61,-0.19527260200269259,-0.1765300343652517,-0.47765638926677095,-0.32272673223879716,-0.1835207133843211,-0.4206000101248282,2,2,1,1,1,1,2,2,1,2,2,1,1,1,2,2,2,1,1,2,1.105012502906165,1,1,2,4,3,1.5,0,2,2,3,2,3,2,2,3,2,1,1,2,1,2,2,2,2,4,1,1,2,2,1,0,2,0,0,0,0,1,2,1,1,1,1,1,1,1,2,1,1,1,2,1,1,2,1,1,2,2,3,1,1,1,1,1,1,1,1,1,2,1,1,1,1,1,1,2,1,1,1.7735968103392739,1.2227992865708155,1.875,0,1.25,0,2,0,1.1111111111111112,0,1.4166666666666667,0,1.3333333333333333,0,1.1428571428571428,0,1,0,1.2432432432432432,0,0,0,0,-0.6686614947764385,-0.5343359712415323,-0.6014987330089854,1,1,2,1,1,1,1,1,1,1.7320508075688772,1.1428571428571428,0,1,-0.8770273057233877,5,5,5,5,3,3,4,7,6,3,3,1.2909944487358056,6.5,4.285714285714286,0,0.3129387823351568,0,0.6481974316742926,2,2,2,2,2,4,3,4,4,4,4,4,4,2,4,4,4,4,3,3,0.8837151016885368,2,0,4,0,3.6,0,3.4,0,3.6666666666666665,0,2,2,1,1,1,1,2,2,1,1,2,1,3,2,1,1,1,2,1,2,1.0760551736979407,1.5,0,2,2,1,1,1,1,2,2,1,1,2,1,3,2,1,1,1,2,1,2,1.0760551736979407,1.5,0,I lived with my mother and father an equal amount of time (joint custody),0,"White, Caucasian, Anglo, European American",0,27,0,1,NA,1,3,7,Accountant,3,161,68,3,5,2,0,0,1,0,0,I lived with my mother and father an equal amount of time (joint custody),0,TRUE,TRUE,TRUE,TRUE,TRUE,2,0.487090624993667,0.4400843750014901,0.48552500000596044,0.588689285710454,0.5385064516048278,0.5812566666642824,1,1,1,0.9032258064516129,0.96875,0.9375,0.068,0.345,0.453,0.016,1.863,98.97677297848105,1968.78606778694,0.069,0.345,0.522,0.015,1.937,94.45743968301606,1943.5067454770335,352,1.0429629629629629,0,3,0,9,12,FALSE
332,2022-03-18T19:36:00Z,2022-03-18T19:57:28Z,1287,1,2022-03-18T19:57:29Z,0.8999999761581421,Chrome,99.0.4844.74,Windows NT 10.0,1920,1080,"Everything went well, thank you.",1.7777777777777777,536,74,395,82,42,92,-0.291738732908564,-0.24267608523536194,-0.060439746769329276,-0.1996016620517925,-0.38830297283146,-0.07238813230635024,4,4,2,2,4,1,1,4,1,4,4,2,2,1,4,4,1,1,4,4,0.41039134083406165,0,1,1,2,1,2.7,0,4,4,3,4,2,2,5,3,2,3,3,5,2,5,5,4,3,1,1,3,3,3,3,1,2,0,0,0,0,4,5,5,4,4,3,4,3,5,2,5,4,2,4,2,5,2,4,4,4,3,3,1,2,1,4,3,1,2,1,2,3,1,3,3,4,3,3,2,2,4,1.0505253940784125,0.7559289460184544,2.625,0,2.75,0,3.466666666666667,0,4.111111111111111,0,3.4166666666666665,0,2.3333333333333335,0,1.8571428571428572,0,3.3333333333333335,0,3.108108108108108,0,1,0,0,1.114984370706128,0.2019240692286875,0.6584542199674077,3,3,5,2,2,1,2,4,5,0.816496580927726,2.5714285714285716,0,4.5,1.304424673778915,2,2,2,2,1,1,3,3,3,3,2,0.6900655593423543,3,1.8571428571428572,0,-0.6637366525547652,0,-1.2633912385968573,2,2,2,2,2,4,4,4,5,2,5,4,5,3,4,1,4,4,3,5,1.3522468075656264,2,0,4.2,0,3,0,4.2,0,3.8,0,2,2,4,4,4,4,4,1,4,2,4,4,2,4,2,4,2,4,3,4,1.2096106376585989,3.2,0,2,2,4,4,4,4,4,1,4,2,4,4,2,4,2,4,2,4,3,4,1.2096106376585989,3.2,0,I lived with my mother and father an equal amount of time (joint custody),0,"White, Caucasian, Anglo, European American",0,29,0,1,NA,1,2,3,Gig worker/MTurk/Prolific/DoorDash,2,220,67,1,5,2,0,0,1,0,0,I lived with my mother and father an equal amount of time (joint custody),0,TRUE,TRUE,TRUE,TRUE,TRUE,1,0.5298312499970198,0.4612343750167638,0.5038093749992549,0.5784645161186495,0.5316714285782406,0.5789620689729165,1,1,1,0.96875,0.875,0.90625,0.06,0.367,0.396,0.007,1.025,54.069185571318386,1951.3257547371106,0.058,0.37,0.438,0.007,1.066,60.79087634049731,1946.9602413306206,274,0.8118518518518519,0,3,0,3,6,FALSE
334,2022-03-18T19:39:51Z,2022-03-18T19:59:18Z,1166,1,2022-03-18T19:59:19Z,0.8999999761581421,Chrome,99.0.4844.51,Windows NT 10.0,1280,720,NA,1.7777777777777777,461,44,104,20,19,52,-0.4456740481838907,-0.4080412124106375,-1.116179250828073,-0.9629770972112213,-0.8593021695598793,-0.5216937811043864,2,2,2,2,3,1,1,3,1,3,3,3,2,2,3,2,3,2,3,3,0.6407232755171874,0,1,1,2,3,2.3,0,2,1,4,3,3,1,4,1,2,3,3,3,3,3,2,4,3,1,1,1,1,1,1,1,2,0,0,0,0,2,2,1,2,2,2,2,2,1,4,3,3,1,3,2,3,3,3,3,4,4,2,5,4,5,4,3,3,2,2,2,2,2,3,1,1,1,4,2,2,3,1.1644122362187095,1.0997835284835873,1.625,0,2.75,0,2.533333333333333,0,1.7777777777777777,0,3,0,3.8333333333333335,0,2.2857142857142856,0,1,0,2.5405405405405403,0,1,0,0,0.022080514050216663,0.2019240692286875,0.11200229163945208,2,2,3,2,2,5,4,1,1,1.2149857925879117,2.857142857142857,0,1,0.1173932192312856,3,2,3,3,2,3,3,5,2,2,2,0.4879500364742666,3.5,2.7142857142857144,0,-0.7874704359888487,0,-0.8742532651115358,5,4,4,3,2,1,3,4,4,2,4,4,3,2,2,4,2,3,3,1,1.082325538564332,3.6,0,2.8,0,3,0,2.6,0,2.8,0,3,1,1,4,1,1,1,2,1,1,1,3,2,1,1,4,1,1,1,3,0.7539370349250519,1.7,0,3,1,1,4,1,1,1,2,1,1,1,3,2,1,1,4,1,1,1,3,0.7539370349250519,1.7,0,"I lived with my extended family on mother's side (grandparents, aunts ,uncles, cousins)",0,"Asian or Asian American (e.g., Chinese, Japanese, and others)",0,24,1,2,NA,1,4,8,auditor,5,113,65,1,5,2,0,0,0,0,0,"I lived with my extended family on mother's side (grandparents, aunts ,uncles, cousins)",0,TRUE,TRUE,TRUE,TRUE,TRUE,2,0.5685806451574449,0.5160344827586207,0.527949999999255,0.6344370370418937,0.569280645166674,0.6208799999976158,0.96875,0.9666666666666667,1,0.8709677419354839,0.96875,0.8064516129032258,0.062,0.39,0.462,0.014,1.937,46.92292075517658,1921.468838485084,0.062,0.391,0.469,0.015,2.051,64.24121989052614,1923.5834288822546,291,0.8622222222222223,0,3,0,0,3,FALSE
335,2022-03-18T19:41:09Z,2022-03-18T19:59:24Z,1095,1,2022-03-18T19:59:25Z,0.8999999761581421,Chrome,99.0.4844.74,Windows NT 10.0,1366,768,NA,1.7786458333333333,528,74,272,54,39,76,-0.30815849987126553,-0.24267608523536194,-0.5066801557013756,-0.5443518585754055,-0.4497376506656016,-0.2521103918255647,3,3,3,1,3,1,1,4,1,3,4,1,1,1,3,3,1,1,3,4,0.6048053188292994,0,1,4,4,4,2.25,0,1,1,1,2,1,1,2,1,1,1,1,2,4,2,2,1,1,1,1,1,2,1,2,1,2,0,0,0,0,2,3,4,2,2,2,2,2,2,1,2,2,1,3,1,2,1,1,3,3,3,4,2,2,2,2,1,1,2,2,1,1,1,1,1,2,1,1,1,1,1,1.2550199500705457,1.709915063331955,1.25,0,1,0,1.5333333333333334,0,2.3333333333333335,0,1.9166666666666667,0,2.1666666666666665,0,1.2857142857142858,0,1.3333333333333333,0,1.8918918918918919,0,1,0,0,-0.8622621689517066,-0.4013584353189139,-0.6318103021353103,2,1,4,1,1,2,2,2,2,1.0690449676496976,1.8571428571428572,0,2,-0.07618021783796666,3,3,5,3,1,2,4,3,3,2,2,1.2535663410560174,3,3,0,-0.8778143430786174,0,-0.7744692081713909,3,3,3,3,3,3,3,3,3,3,5,3,3,3,3,3,4,5,3,5,0.8997354108424374,3,0,4,0,3,0,3.4,0,3.466666666666667,0,1,1,1,2,1,1,2,3,2,1,1,1,1,1,1,2,1,1,1,2,0.8870412083230169,1.35,0,1,1,1,2,1,1,2,3,2,1,1,1,1,1,1,2,1,1,1,2,0.8870412083230169,1.35,0,"I lived with my mother, but not father, most of the time.",0,"White, Caucasian, Anglo, European American",0,26,1,2,NA,1,1,6,unemployed,1,130,66,2,5,2,0,0,1,0,0,"I lived with my mother, but not father, most of the time.",0,TRUE,TRUE,TRUE,TRUE,TRUE,2,0.5402374999895692,0.37445624999701976,0.5307625000048429,0.6323448275779856,0.4963599999964237,0.6481281249951572,1,1,1,0.90625,0.3125,1,0.158,0.317,0.698,0.016,1.801,49.20492979613008,1872.651821533057,0.159,0.321,0.758,0.015,1.871,52.53805782267272,1834.4810620830006,376,1.114074074074074,0,3,0,0,3,FALSE
336,2022-03-18T19:11:05Z,2022-03-18T20:00:15Z,2950,1,2022-03-18T20:00:16Z,0.8999999761581421,Firefox,98.0,Windows NT 10.0,1366,768,NA,1.7786458333333333,1875,92,493,224,87,92,2.4565197624736026,-0.14345700893019658,0.2951013920545775,1.5487743346036733,0.5332171946806649,-0.07238813230635024,3,4,4,4,4,3,4,4,3,4,4,2,2,3,4,4,4,2,4,4,1.2096106376585989,1,1,3,3,2,3.5,0,4,3,3,3,4,3,4,3,2,2,4,3,2,3,3,2,3,1,1,1,3,2,3,3,1,2,0,0,0,3,3,4,4,3,3,3,3,3,2,3,4,2,3,2,3,3,4,4,5,5,3,1,1,1,3,2,1,3,3,3,4,4,4,1,1,2,1,1,2,2,1.0766425401028696,0.6761234037828132,2,0,1.5,0,3.066666666666667,0,3.2222222222222223,0,3.3333333333333335,0,1.8333333333333333,0,3.142857142857143,0,1.3333333333333333,0,2.864864864864865,0,2,0,0,0.5607569196227858,-0.009831254590180624,0.2754628325163026,1,2,2,2,2,3,1,1,3,1.3801311186847085,1.8571428571428572,0,2,-0.07618021783796666,5,5,5,5,5,5,5,6,8,6,4,1.5118578920369088,7,5,0,1.3897838462580232,0,1.6917243523099135,4,4,3,3,2,3,5,1,4,3,4,3,3,5,2,5,5,4,5,5,1.505545305418162,3.2,0,3.8,0,4.2,0,3.4,0,3.8,0,3,2,4,4,4,4,4,4,4,4,3,4,2,2,3,3,3,4,4,4,1.145931016569864,3.45,0,3,2,4,4,4,4,4,4,4,4,3,4,2,2,3,3,3,4,4,4,1.145931016569864,3.45,0,"I lived with my mother and father an equal amount of time (joint custody) & I lived with my extended family on mother's side (grandparents, aunts ,uncles, cousins)",1,"White, Caucasian, Anglo, European American",0,22,1,2,NA,1,3,4,student,5,354,62,1,5,2,0,0,1,0,0,"I lived with my mother and father an equal amount of time (joint custody) & I lived with my extended family on mother's side (grandparents, aunts ,uncles, cousins)",1,TRUE,TRUE,TRUE,TRUE,TRUE,1,0.6311612903225806,0.5335333333333333,0.5419375,0.7514666666666666,0.598375,0.6263461538461539,0.96875,0.967741935483871,1,0.9375,1,0.8125,0.054,0.412,0.41,0.013,1.824,50.337922049805,1929.4045194704834,0.054,0.412,0.436,0.013,1.9,73.12055611908583,1934.7593529872522,357,1.0577777777777777,0,3,0,0,3,FALSE
337,2022-03-18T19:36:01Z,2022-03-18T20:01:11Z,1509,1,2022-03-18T20:01:11Z,0.8999999761581421,Chrome,95.0.4638.69,Macintosh,1440,900,N/A,1.6,596,119,443,95,60,74,-0.1685904806883026,0.005371605527551444,0.11370285183829855,-0.039539070808686475,-0.019694905826610026,-0.2745756742654665,2,2,2,2,2,2,1,3,1,3,3,3,2,3,3,2,2,1,2,3,0.6958523739384593,0,1,2,3,3,2.2,0,3,2,3,3,4,3,3,3,3,2,2,3,2,3,4,3,3,5,2,2,3,3,2,1,1,1,0,1,0,3,4,2,3,3,2,1,1,2,2,3,2,3,3,3,2,4,4,3,3,3,4,4,5,3,3,4,2,2,3,1,2,2,2,2,2,2,2,2,1,2,0.9984973695493629,0.6399404734221844,2.875,0,1.75,0,2.8666666666666667,0,2.3333333333333335,0,2.9166666666666665,0,3.8333333333333335,0,2,0,2,0,2.675675675675676,0,1,0,0,0.7730582181464528,-0.14280879051279902,0.3151247138168269,1,2,3,1,2,2,1,2,1,1.3801311186847085,1.7142857142857142,0,1.5,-0.3523011961613431,5,4,5,4,1,1,3,7,3,2,2,1.7043362064926932,5,3.2857142857142856,0,-0.5164387147195426,0,-0.39933845143525204,3,2,3,3,3,3,4,3,4,4,4,4,3,3,4,4,3,4,4,3,0.7988086367179802,2.8,0,3.6,0,3.8,0,3.4,0,3.6,0,2,3,2,3,2,2,3,2,1,2,2,2,2,3,3,2,1,3,2,3,0.6708203932499369,2.25,0,2,3,2,3,2,2,3,2,1,2,2,2,2,3,3,2,1,3,2,3,0.6708203932499369,2.25,0,"I lived with my mother, but not father, most of the time.",0,"White, Caucasian, Anglo, European American",0,23,0,1,NA,1,2,6,Educational Services,2,145,66,3,5,2,0,0,2,0,0,"I lived with my mother, but not father, most of the time.",0,TRUE,TRUE,TRUE,TRUE,TRUE,2,0.4893437500447035,0.4201656249910593,0.4321749999821186,0.5868000000098655,0.5304275862430704,0.5443249999455043,1,1,1,0.90625,0.90625,0.875,0.066,0.348,0.836,0.016,1.901,30.32253822814956,1910.8729956534773,0.066,0.348,0.836,0.017,1.993,34.186813777419175,1901.8238318507647,438,1.2977777777777777,0,3,0,0,3,FALSE
338,2022-03-18T19:42:09Z,2022-03-18T20:01:50Z,1180,1,2022-03-18T20:01:52Z,0.8999999761581421,Chrome,99.0.4844.74,Windows NT 10.0,1920,1080,"I slept less than usual, but did not have trouble falling or staying asleep.",1.7777777777777777,442,67,378,83,55,59,-0.48467099472030684,-0.28126128157625957,-0.12211525044286413,-0.18728915503309204,-0.12208603555017945,-0.44306529256473004,3,3,2,2,4,2,1,4,1,3,4,1,1,1,3,3,1,1,3,3,0.512989176042577,0,1,1,1,1,2.3,0,1,1,4,2,5,2,2,2,2,3,1,3,2,3,2,2,4,1,1,2,3,3,2,1,1,1,0,0,0,1,1,1,1,3,1,2,2,2,3,1,1,1,3,1,2,4,3,4,4,4,3,1,1,1,2,1,1,2,1,1,3,3,2,1,5,3,1,3,3,2,1.5161790127814059,1.2798809468443688,2.25,0,2.25,0,2.3333333333333335,0,1.5555555555555556,0,2.5833333333333335,0,1.5,0,1.8571428571428572,0,3,0,2.054054054054054,0,1,0,0,-0.004789330408272158,0.029557639357944268,0.012384154474836056,2,2,5,1,1,2,2,1,1,1.0690449676496976,2.142857142857143,0,1,-0.29694866616649496,4,4,4,2,1,1,5,5,5,2,2,1.5118578920369088,5,3,0,-0.5164387147195426,0,-0.5541918483345958,2,2,1,2,2,5,5,4,5,3,5,4,3,4,5,3,5,5,3,1,1.5796322658258457,1.8,0,4.8,0,3.4,0,3.8,0,4,0,1,1,1,1,1,1,1,1,1,1,1,2,3,1,1,1,1,1,1,1,1.1821033884786185,1.15,0,1,1,1,1,1,1,1,1,1,1,1,2,3,1,1,1,1,1,1,1,1.1821033884786185,1.15,0,I lived with my mother and father an equal amount of time (joint custody),0,"Asian or Asian American (e.g., Chinese, Japanese, and others)",0,27,0,1,NA,1,2,4,Unemployed student,2,153,72,2,5,2,0,0,1,0,0,I lived with my mother and father an equal amount of time (joint custody),0,TRUE,TRUE,TRUE,TRUE,TRUE,2,0.44789375000074505,0.37739375000819564,0.4230937500074506,0.539696428575686,0.47291481482982634,0.4963033333222071,1,1,1,0.875,0.8709677419354839,0.9375,0.047,0.345,0.599,0.02,1.7,75.6776403043557,1945.3220629322298,0.05,0.349,0.653,0.023,1.819,90.7778034256135,1941.1630539300538,428,1.268148148148148,0,3,0,0,3,FALSE
339,2022-03-18T19:48:31Z,2022-03-18T20:03:35Z,904,1,2022-03-18T20:03:36Z,1,Chrome,98.0.4758.109,Macintosh,1440,900,Thank you for the opportunity!,1.6,537,61,149,23,23,62,-0.2896862620382263,-0.3143343070113147,-0.9529205646334219,-0.9260395761551199,-0.7773892657810237,-0.40936736890487735,2,2,3,3,2,3,4,2,3,2,2,3,3,4,2,2,3,2,2,2,0.3940344628262062,0,1,1,4,4,2.55,0,2,3,4,3,2,1,4,2,2,2,2,3,2,2,3,2,1,1,1,1,2,1,1,4,2,0,0,0,0,2,3,4,2,3,3,4,3,4,3,4,2,2,4,2,3,2,2,3,2,2,2,2,3,2,3,3,2,2,3,1,2,3,2,2,2,2,2,2,2,2,0.7311186870368822,0.9102589898327995,1.25,0,2,0,2.466666666666667,0,3.111111111111111,0,2.5833333333333335,0,2.5,0,2.142857142857143,0,2,0,2.5675675675675675,0,2,0,0,-0.15911869345190202,0.16253517528056266,0.0017082409143303195,3,2,4,3,3,3,3,1,2,0.4879500364742666,3,0,1.5,0.39351419755466194,4,4,4,4,3,2,3,6,3,2,2,0.7867957924694432,4.5,3.4285714285714284,0,-0.6067826218093113,0,-0.376981092944779,3,2,3,2,3,4,3,4,3,2,4,3,4,3,2,4,3,4,3,3,0.5163977794943222,2.6,0,3.6,0,3.2,0,3,0,3.2666666666666666,0,3,2,2,2,2,1,2,2,3,2,2,2,3,2,2,2,2,2,3,2,0.5871429486123998,2.15,0,3,2,2,2,2,1,2,2,3,2,2,2,3,2,2,2,2,2,3,2,0.5871429486123998,2.15,0,Prefer not to say.,0,"Asian or Asian American (e.g., Chinese, Japanese, and others)",0,20,1,2,NA,1,3,4,"Student, part-time teacher",2,131,62,3,5,2,0,0,1,0,0,Prefer not to say.,0,TRUE,TRUE,TRUE,TRUE,TRUE,6,0.6608374999947846,0.5040250000022352,0.5850562500096858,0.6959843749813736,0.5493499999977648,0.5958999999992309,1,1,1,1,1,1,0.137,0.303,0.478,0.029,0.865,40.978237060092006,1846.9375603515055,0.138,0.312,0.514,0.044,0.875,54.28713552204971,1837.5765244062673,430,1.2740740740740741,0,3,0,0,3,FALSE
340,2022-03-18T19:12:43Z,2022-03-18T20:05:04Z,3140,1,2022-03-18T20:05:06Z,1,Chrome,94.0.4606.114,Windows NT 10.0,1504,1003,Thank you for the study,1.4995014955134596,785,175,1349,393,214,141,0.21932651380552076,0.31405317625473256,3.400644400557274,3.6295880207640523,3.133951889659328,0.478011287471244,4,3,2,3,4,3,4,4,2,4,4,3,3,4,4,4,4,4,3,4,1.1964860832322377,0,1,2,4,4,3.5,0,4,4,4,2,5,4,5,4,5,3,1,5,2,4,4,4,3,4,4,5,3,2,4,0,2,0,0,0,0,3,2,2,3,3,2,3,2,2,2,4,1,3,3,3,2,1,1,2,3,3,4,1,5,1,1,1,4,1,2,1,4,4,5,5,5,3,5,4,3,3,1.3361456826578775,1.424279266355945,3.625,0,3.75,0,3.7333333333333334,0,2.4444444444444446,0,2.3333333333333335,0,2.1666666666666665,0,3,0,4.333333333333333,0,2.6216216216216215,0,0,0,0,1.4559262798790455,0.327496178112184,0.8917112289956148,5,5,5,4,4,5,5,7,7,1.8126539343499315,4.714285714285714,0,7,3.5137133361913575,1,2,2,3,1,1,1,1,10,1,1,1.4638501094227998,5.5,1.5714285714285714,0,-0.9844405834151674,0,-1.613730466956361,2,2,2,1,2,5,5,5,5,3,5,5,5,4,5,5,5,5,5,5,1.9148542155126762,1.8,0,5,0,4.6,0,4.8,0,4.8,0,4,4,4,4,4,4,3,4,4,4,3,4,2,4,3,4,4,4,4,3,1.2096106376585989,3.7,0,4,4,4,4,4,4,3,4,4,4,3,4,2,4,3,4,4,4,4,3,1.2096106376585989,3.7,0,"I lived with my mother, but not father, most of the time.",0,"Hispanic of Latino (e.g., Mexican American, Central American, and others)",0,21,0,1,NA,1,2,5,Retail associate,2,165,71,3,5,2,0,0,1,0,0,"I lived with my mother, but not father, most of the time.",0,TRUE,TRUE,TRUE,TRUE,TRUE,6,0.9395656250044704,1.181503225812989,1.257358620688833,1.0302531250026077,1.2613774193582996,1.3158677419443285,1,1,1,1,1,1,0.2,0.133,0.174,0.094,1.474,61.061046253977906,1871.9385535839926,0.208,0.096,0.185,0.112,1.584,85.59116440433216,1871.34028330452,304,0.9007407407407407,1,3,0,0,3,FALSE
341,2022-03-18T19:37:03Z,2022-03-18T20:08:57Z,1913,1,2022-03-18T20:08:59Z,0.8999999761581421,Chrome,99.0.4844.51,Macintosh,1440,900,NA,1.6,703,110,637,109,57,219,0.0510239024378302,-0.04423793262503123,0.817529187877461,0.13283602745312004,-0.08112958366075168,1.3541573026274145,2,3,2,3,3,1,1,3,3,3,4,2,1,3,3,3,1,1,2,3,0.7591546545162482,0,0,2,1,1,2.35,0,4,3,2,4,1,1,3,3,3,2,4,4,1,4,5,5,2,3,1,5,4,5,4,12,1,1,0,1,1,4,3,3,2,4,4,3,3,4,3,5,2,5,4,3,3,5,5,4,2,3,4,2,5,1,4,1,3,5,5,1,3,3,3,5,5,4,1,3,5,3,1.2991103446927392,0.9154754164341269,3.625,0,3,0,2.933333333333333,0,3.3333333333333335,0,3.6666666666666665,0,2.8333333333333335,0,3.2857142857142856,0,4.666666666666667,0,3.4594594594594597,0,6,1,0,1.4724615687765772,2.0820708708911675,1.7772662198338725,3,1,4,1,1,2,1,3,1,0.7867957924694432,1.8571428571428572,0,2,-0.07618021783796666,2,2,2,1,2,3,1,4,3,2,1,1.2724180205607036,3.5,1.8571428571428572,0,-1.1317385212503899,0,-1.5486628727219036,2,3,3,5,3,4,4,4,5,4,3,3,4,5,4,2,3,4,5,2,1.2071217242444348,3.2,0,3.4,0,3.8,0,4,0,3.7333333333333334,0,2,3,2,3,3,3,3,3,1,3,4,3,3,2,1,2,3,3,2,3,0.7608859102526822,2.6,0,2,3,2,3,3,3,3,3,1,3,4,3,3,2,1,2,3,3,2,3,0.7608859102526822,2.6,0,"I lived with my mother, but not father, most of the time. & I lived with my extended family on mother's side (grandparents, aunts ,uncles, cousins) & I lived with my extended family on father's side (grandparents, aunts ,uncles, cousins)",1,"White, Caucasian, Anglo, European American",0,22,1,2,NA,1,2,4,Sales Associate,2,102,64,3,5,2,0,0,0,0,0,"I lived with my mother, but not father, most of the time. & I lived with my extended family on mother's side (grandparents, aunts ,uncles, cousins) & I lived with my extended family on father's side (grandparents, aunts ,uncles, cousins)",1,TRUE,TRUE,TRUE,TRUE,TRUE,5,0.5303903225814143,0.4594437499968335,0.47393437499925495,0.5768125000004657,0.533403448275451,0.5438483870981201,0.96875,1,1,1,0.90625,0.96875,0.059,0.364,0.539,0.016,1.521,30.83812568310465,1861.457392633559,0.06,0.364,0.564,0.018,1.575,38.85459017631302,1865.3397406701556,436,1.2918518518518518,0,3,0,0,3,FALSE
342,2022-03-18T19:44:48Z,2022-03-18T20:15:01Z,1812,1,2022-03-18T20:15:03Z,0.8999999761581421,Chrome,99.0.4844.74,Windows NT 10.0,1366,768,NA,1.7786458333333333,1031,95,331,79,54,112,0.7242343479085924,-0.12692049621266902,-0.2926298782461664,-0.2365391831078939,-0.14256426149489335,0.15226469209266782,2,3,1,1,3,1,1,3,1,2,3,1,1,2,2,2,1,1,3,3,0.7863975156570492,0,1,3,4,3,1.85,0,5,4,4,4,4,5,5,5,5,4,5,4,2,5,5,5,5,5,3,4,5,5,5,4,2,0,0,0,0,5,5,5,5,5,5,5,5,5,3,2,2,3,4,4,5,5,5,4,4,4,4,2,5,5,5,5,4,4,4,4,4,5,5,4,5,3,2,3,2,2,1.5877723454642423,1.6676187756655838,4.625,0,2.25,0,4.4,0,5,0,3.75,0,4.333333333333333,0,4.285714285714286,0,4,0,4.27027027027027,0,2,0,0,2.9047325451865933,0.24871839021593428,1.5767254677012639,5,5,5,5,3,4,4,8,1,1.7043362064926932,4.428571428571429,0,4.5,2.3817135758131442,1,1,2,1,1,1,1,3,1,2,1,1.4960264830861913,2,1.1428571428571428,0,-1.402770242519696,0,-2.1010043848478595,2,2,2,1,2,3,5,5,4,4,5,4,5,5,5,5,4,4,5,5,1.709915063331955,1.8,0,4,0,4.8,0,4.8,0,4.533333333333333,0,2,2,3,4,2,3,4,3,2,1,2,3,1,2,1,3,1,2,3,4,0.9119095061289915,2.4,0,2,2,3,4,2,3,4,3,2,1,2,3,1,2,1,3,1,2,3,4,0.9119095061289915,2.4,0,"I lived with my father, but not mother, most of the time. & I lived with my mother and father an equal amount of time (joint custody)",1,"White, Caucasian, Anglo, European American",0,20,1,2,NA,1,1,3,Google Rater,1,210,62,1,5,2,0,0,0,0,0,"I lived with my father, but not mother, most of the time. & I lived with my mother and father an equal amount of time (joint custody)",1,TRUE,TRUE,TRUE,TRUE,TRUE,2,0.4965437499843538,0.4154937499910593,0.4599562500119209,0.5865379310476369,0.4811172413784882,0.532752000002861,1,1,1,0.90625,0.90625,0.78125,0.055,0.342,0.499,0.015,1.741,82.08326836471802,2009.242522497496,0.053,0.344,0.5,0.016,1.845,116.44936769605627,2016.9549147219434,390,1.1555555555555557,0,3,0,0,3,FALSE
343,2022-03-18T19:53:00Z,2022-03-18T20:16:17Z,1397,1,2022-03-18T20:16:17Z,0.8999999761581421,Chrome,99.0.4844.74,Windows NT 10.0,1366,768,NA,1.7786458333333333,520,136,372,93,60,101,-0.324578266833967,0.09907851092687428,-0.1438830752688176,-0.0641640848460874,-0.019694905826610026,0.02870563867320788,1,1,1,1,1,1,2,1,1,1,2,1,1,1,2,1,1,1,2,2,1.348488432516786,0,1,1,5,5,1.25,0,2,1,2,1,2,1,2,2,2,1,2,2,2,2,3,1,1,1,1,1,3,1,2,1,2,0,0,0,0,3,1,1,1,1,1,1,1,1,1,1,2,1,1,2,1,1,2,3,2,2,1,1,1,1,1,1,1,2,1,1,1,1,2,1,1,1,2,1,1,1,1.7929625525132182,1.3557637102737474,1.375,0,1.25,0,1.8,0,1.2222222222222223,0,1.5833333333333333,0,1,0,1.2857142857142858,0,1,0,1.2972972972972974,0,1,0,0,-0.9509424980985884,-0.3151752203835423,-0.6330588592410653,2,2,2,1,1,2,1,1,1,1.3451854182690985,1.5714285714285714,0,1,-0.6284221744847194,5,5,5,5,2,2,5,6,6,2,2,1.8126539343499315,6,4.142857142857143,0,-0.3357509005400053,0,0.17536041918117712,2,2,2,2,2,4,4,3,4,3,5,4,4,3,3,2,4,4,3,3,0.9154754164341269,2,0,4.2,0,3.2,0,3.2,0,3.533333333333333,0,1,1,1,1,3,1,1,2,1,1,1,1,1,1,1,1,1,1,1,1,1.1821033884786185,1.15,0,1,1,1,1,3,1,1,2,1,1,1,1,1,1,1,1,1,1,1,1,1.1821033884786185,1.15,0,NA,NA,"White, Caucasian, Anglo, European American",0,26,0,1,NA,1,2,5,Data analyst,3,130,69,3,5,2,0,0,1,0,0,NA,NA,TRUE,TRUE,TRUE,TRUE,TRUE,4,0.5031156249940395,0.46040312499925495,0.4783999999910593,0.5655843749977648,0.5210937499962747,0.579735483873275,1,1,1,1,1,0.96875,0.085,0.307,0.541,0.016,1.855,86.85949456629473,1929.1125483928417,0.088,0.313,0.589,0.017,1.987,105.52164363396645,1933.2546152630966,279,0.8266666666666667,0,3,0,3,6,FALSE
344,2022-03-18T19:36:35Z,2022-03-18T20:20:00Z,2604,1,2022-03-18T20:20:01Z,0.8999999761581421,Chrome,99.0.4844.51,Windows NT 10.0,1272,716,NA,1.776536312849162,1396,133,395,96,43,85,1.4733862155818491,0.08254199820934673,-0.060439746769329276,-0.02722656378998601,-0.36782474688674605,-0.15101662084600656,2,2,2,1,2,1,2,2,1,2,4,2,2,2,3,2,1,1,3,3,0.7947194142390263,0,1,1,3,2,2,0,5,3,5,4,5,5,3,5,5,3,5,4,1,4,5,3,5,1,1,3,5,5,4,5,2,0,0,0,0,2,4,3,4,5,3,3,2,5,2,2,2,2,3,2,4,5,4,5,3,5,5,1,1,1,3,1,1,5,3,1,3,5,3,2,4,3,3,3,3,2,1.3512312258920847,1.65615734242165,3.375,0,2.75,0,4.133333333333334,0,3.4444444444444446,0,3.25,0,2,0,3,0,3,0,3.027027027027027,0,3,0,0,1.6986406990535305,0.6402455709446675,1.169443134999099,2,1,3,1,1,2,1,1,3,1.2149857925879117,1.5714285714285714,0,2,-0.24191697199707893,3,3,4,4,1,1,1,3,5,4,3,1.5275252316519468,4,2.4285714285714284,0,0.07529693741016555,0,-0.5032047907955272,2,2,2,4,2,3,5,1,5,1,5,5,3,4,5,5,4,4,5,3,1.65615734242165,2.4,0,4.2,0,3.8,0,3.6,0,3.8666666666666667,0,1,2,3,4,2,4,2,2,3,1,3,2,2,3,2,2,3,3,3,2,0.8255779474818965,2.45,0,1,2,3,4,2,4,2,2,3,1,3,2,2,3,2,2,3,3,3,2,0.8255779474818965,2.45,0,I lived with my mother and father an equal amount of time (joint custody),0,"Hispanic of Latino (e.g., Mexican American, Central American, and others) & White, Caucasian, Anglo, European American",1,26,1,2,NA,1,2,5,Data Entry Specialist,2,220,65,1,5,2,0,0,1,0,0,I lived with my mother and father an equal amount of time (joint custody),0,TRUE,TRUE,TRUE,TRUE,TRUE,1,0.48573870968241845,0.47464062499254944,0.5585374999959022,0.5292516128997649,0.537146874986589,0.6001312500033528,1,1,1,1,1,1,0.167,0.261,0.566,0.041,1.52,38.49898588587814,1828.349786415066,0.169,0.262,0.574,0.032,1.647,45.33192381345083,1827.2353581192797,310,0.9185185185185185,0,3,0,0,3,FALSE
346,2022-03-18T20:03:16Z,2022-03-18T20:22:20Z,1144,1,2022-03-18T20:22:21Z,0.8999999761581421,Chrome,99.0.4844.74,Windows NT 10.0,1280,720,NA,1.7777777777777777,545,54,297,65,36,85,-0.2732664950755248,-0.35291950335221234,-0.4159808855932361,-0.4089142813697004,-0.5111723284997433,-0.15101662084600656,2,2,1,1,2,1,1,2,1,2,2,1,1,1,2,2,1,1,2,2,1.025978352085154,0,0,3,3,3,1.5,0,1,1,2,2,2,1,1,2,2,1,1,1,1,1,1,1,1,2,1,1,1,1,1,0,2,0,0,0,0,1,1,2,1,3,1,1,1,1,1,1,1,1,2,1,1,2,1,1,1,1,4,1,1,2,2,1,1,1,1,1,1,1,1,1,1,1,1,1,1,1,1.7710552325200466,1.791514389985135,1.125,0,1,0,1.3333333333333333,0,1.3333333333333333,0,1.1666666666666667,0,1.8333333333333333,0,1,0,1,0,1.2702702702702702,0,0,0,0,-1.275939664406029,-0.6205191861769039,-0.9482294252914665,1,1,2,1,1,1,1,1,1,1.7320508075688772,1.1428571428571428,0,1,-0.8770273057233877,5,5,5,5,3,3,4,6,6,3,3,1.2909944487358056,6,4.285714285714286,0,0.22259487524538815,0,0.5931280917150938,2,2,3,3,3,4,3,3,4,4,4,3,4,3,4,4,4,3,3,3,0.7432233529572065,2.6,0,3.6,0,3.6,0,3.4,0,3.533333333333333,0,1,1,1,1,1,1,1,1,1,1,1,1,1,1,1,1,1,1,1,1,1.231174022502185,1,0,1,1,1,1,1,1,1,1,1,1,1,1,1,1,1,1,1,1,1,1,1.231174022502185,1,0,"I lived with my mother, but not father, most of the time.",0,"White, Caucasian, Anglo, European American",0,28,0,1,NA,1,3,4,operations manager,2,250,75,3,5,2,0,0,1,0,0,"I lived with my mother, but not father, most of the time.",0,TRUE,TRUE,TRUE,TRUE,TRUE,1,0.5057937499918044,0.4855156250055879,0.48301249999739226,0.5909531249981373,0.5781225806436231,0.5972062499988824,1,1,1,1,1,1,0.077,0.366,0.652,0.005,1.006,42.900125788851724,1836.9029940436797,0.08,0.367,0.669,0.006,1.073,47.408165730435535,1830.0354252045101,295,0.874074074074074,0,3,3,3,6,FALSE
347,2022-03-18T20:03:55Z,2022-03-18T20:26:27Z,1352,1,2022-03-18T20:26:28Z,0.8999999761581421,Chrome,99.0.4844.74,Windows NT 10.0,2560,1440,NA,1.7777777777777777,583,76,398,96,59,79,-0.19527260200269259,-0.2316517434236769,-0.04955583435635254,-0.02722656378998601,-0.04017313177132391,-0.218412468165712,1,2,1,1,2,1,1,3,1,2,2,1,1,2,2,3,2,1,2,2,0.998683343734455,0,0,2,4,4,1.65,0,2,2,1,2,1,2,1,2,1,1,1,2,2,1,3,1,2,1,1,1,1,3,1,1,2,0,0,0,0,1,2,3,2,2,1,2,1,3,1,1,4,1,3,1,1,3,2,2,3,3,2,1,1,1,3,1,1,2,2,2,3,3,2,1,2,1,2,1,2,2,1.3917388177876397,1.5430334996209192,1.375,0,1.75,0,1.6,0,1.8888888888888888,0,2.0833333333333335,0,1.5,0,2.142857142857143,0,1.3333333333333333,0,1.8918918918918919,0,1,0,0,-0.7785030567386141,-0.14280879051279902,-0.46065592362570656,3,3,4,3,2,2,1,1,1,0.7559289460184544,2.5714285714285716,0,1,-0.048343534927826504,4,3,4,3,1,1,1,3,3,4,2,1.5275252316519468,3,2.4285714285714284,0,-0.4496589620309131,0,-0.8231928876262611,3,2,2,2,2,2,5,4,4,4,5,4,3,4,4,4,2,4,3,2,1.162919151265879,2.2,0,3.4,0,3.8,0,3.6,0,3.6,0,1,2,1,2,2,2,2,2,2,2,1,2,1,2,1,2,1,2,2,2,0.7181848464596079,1.7,0,1,2,1,2,2,2,2,2,2,2,1,2,1,2,1,2,1,2,2,2,0.7181848464596079,1.7,0,I lived with my mother and father an equal amount of time (joint custody),0,"White, Caucasian, Anglo, European American",0,27,1,2,NA,1,2,3,artist,2,124,66,2,5,2,0,0,1,0,0,I lived with my mother and father an equal amount of time (joint custody),0,TRUE,TRUE,TRUE,TRUE,TRUE,4,0.4936218749769032,0.4602468750104308,0.45231874998286364,0.5834857142737934,0.5532032258202952,0.5862481481278384,1,1,1,0.9032258064516129,0.96875,0.84375,0.06,0.333,0.504,0.006,1.278,54.02301894262534,1938.6344880521788,0.06,0.333,0.543,0.006,1.329,74.11092436038642,1933.9131353522287,368,1.0903703703703704,0,3,0,6,9,FALSE
348,2022-03-18T20:08:57Z,2022-03-18T20:29:29Z,1232,1,2022-03-18T20:29:30Z,0.8999999761581421,Chrome,99.0.4844.74,Windows NT 10.0,1536,864,no,1.7777777777777777,509,80,353,102,55,84,-0.3471554464076816,-0.20960305980030683,-0.2128145205510036,0.046648478322216774,-0.12208603555017945,-0.16224926206595747,1,1,2,1,1,1,1,2,1,1,1,1,1,1,1,1,1,1,1,1,1.4689774459950382,0,1,2,3,4,1.1,0,1,1,1,1,1,1,1,1,1,1,1,1,1,1,1,1,2,1,1,1,1,1,1,1,2,0,0,0,0,1,2,2,2,2,1,2,1,2,1,1,1,1,1,1,1,1,1,1,1,1,1,1,1,1,3,1,1,2,2,1,2,1,1,1,1,1,2,1,2,1,1.7084843923544981,2.065591117977289,1.125,0,1.5,0,1,0,1.6666666666666667,0,1,0,1.3333333333333333,0,1.4285714285714286,0,1,0,1.2972972972972974,0,1,0,0,-1.409796765005096,-0.22899200544817064,-0.8193943852266333,1,1,1,1,1,1,1,1,1,1.9518001458970664,1,0,1,-0.9598956828029438,5,5,5,5,3,3,5,6,6,6,3,1.5735915849388864,6,4.428571428571429,0,0.8648279468169445,0,1.0620294616804922,3,4,4,2,3,4,4,3,4,3,4,3,4,3,2,4,4,4,1,1,1.0465362369445672,3.2,0,3.8,0,3.2,0,2.6,0,3.2,0,1,1,1,1,1,1,1,1,1,1,2,2,1,2,1,1,1,1,1,1,1.1367080817685316,1.15,0,1,1,1,1,1,1,1,1,1,1,2,2,1,2,1,1,1,1,1,1,1.1367080817685316,1.15,0,I lived with my mother and father an equal amount of time (joint custody),0,"White, Caucasian, Anglo, European American",0,22,0,1,NA,1,4,5,student,1,200,70,2,5,2,0,0,1,0,0,I lived with my mother and father an equal amount of time (joint custody),0,TRUE,TRUE,TRUE,TRUE,TRUE,4,0.559406249997206,0.4603875000011176,0.48421562499925497,0.6163593750009313,0.532079999996225,0.5651258064518052,1,1,1,1,0.967741935483871,0.96875,0.066,0.362,0.553,0.013,1.433,43.91014038466167,1882.8928884480138,0.067,0.361,0.582,0.013,1.494,55.652169634686516,1884.9628124320225,386,1.1437037037037037,0,3,3,0,3,FALSE
349,2022-03-18T19:51:04Z,2022-03-18T20:31:47Z,2442,1,2022-03-18T20:31:49Z,0.800000011920929,Chrome,99.0.4844.74,Windows NT 10.0,1360,768,Thank you.,1.7708333333333333,623,175,818,148,81,462,-0.11317376718918498,0.31405317625473256,1.474191903460391,0.6130238011824382,0.4103478390123816,4.083689119075483,1,1,1,1,2,1,1,2,1,1,1,2,1,1,1,1,1,1,1,1,1.4317821063276353,0,1,2,5,4,1.15,0,4,4,4,4,4,3,3,3,3,3,4,4,3,3,3,1,2,3,2,2,3,3,3,0,1,0,0,1,1,3,2,4,1,2,2,2,1,2,2,3,1,1,3,3,1,2,3,3,3,4,2,3,1,2,3,1,2,2,2,1,3,3,3,3,3,3,1,2,2,2,1.1250625608230707,0.7037315505489968,2.375,0,1.75,0,3.466666666666667,0,2.111111111111111,0,2.4166666666666665,0,2,0,2.2857142857142856,0,3,0,2.2972972972972974,0,0,1,0,0.6514057355431829,0.33619029106636955,0.49379801330477624,3,3,4,3,3,3,3,4,5,0.3779644730092272,3.142857142857143,0,4.5,1.6358981820971392,3,4,5,3,1,1,1,5,6,2,2,1.6761634196950514,5.5,2.5714285714285716,0,-0.426094807629774,0,-0.7314026037244126,3,2,2,3,2,4,4,4,4,3,5,5,5,4,4,3,5,4,4,1,1.4074631010979937,2.4,0,4.6,0,3.8,0,3.4,0,3.933333333333333,0,2,1,1,2,2,2,3,2,2,3,1,2,2,1,1,1,1,1,2,3,0.9445132413883326,1.75,0,2,1,1,2,2,2,3,2,2,3,1,2,2,1,1,1,1,1,2,3,0.9445132413883326,1.75,0,"I lived with my mother, but not father, most of the time.",0,"White, Caucasian, Anglo, European American",0,22,0,1,NA,1,2,3,Music Producer,3,124,65,2,5,2,1,0,1,0,1,"I lived with my mother, but not father, most of the time.",0,TRUE,TRUE,TRUE,TRUE,TRUE,1,0.6166812500001397,0.4906483870969424,0.5690562499997904,0.6828249999996042,0.5493656250000931,0.5847875000002095,1,1,1,1,1,1,0.163,0.327,0.685,0.066,1.495,89.16212755291559,1866.8256427448734,0.164,0.332,0.7,0.097,1.545,104.22704544789659,1887.6895725788834,138,0.40888888888888886,0,3,0,0,3,FALSE
350,2022-03-18T20:10:51Z,2022-03-18T20:32:50Z,1318,1,2022-03-18T20:32:51Z,0.8999999761581421,Chrome,99.0.4844.51,Macintosh,1440,900,no,1.6,695,89,324,68,24,57,0.03460413547512868,-0.15999352164772415,-0.3180256738764454,-0.371976760313599,-0.7569110398363099,-0.46553057500463185,3,4,1,1,3,2,4,4,1,3,4,1,1,1,3,4,3,1,3,3,0.8207826816681233,0,1,1,3,1,2.5,0,5,3,4,4,4,4,4,4,5,3,4,5,4,5,5,4,5,5,2,4,5,5,5,6,1,1,0,0,0,2,3,3,4,4,3,4,4,5,3,2,4,4,5,3,4,5,5,5,5,5,5,3,5,4,5,5,2,5,1,1,2,2,1,3,5,3,1,2,3,1,1.4498627873361334,1.4074631010979937,4.375,0,1.75,0,4.2,0,3.5555555555555554,0,4.166666666666667,0,4.5,0,2,0,3.6666666666666665,0,3.6216216216216215,0,3,0,0,2.4246186211261165,0.295512711203181,1.3600656661646489,3,3,5,3,3,4,3,3,1,0.8997354108424374,3.4285714285714284,0,2,0.8353719300371503,1,2,3,3,1,1,1,3,2,1,1,1.4960264830861913,2.5,1.7142857142857142,0,-1.5265040259537794,0,-1.8667198082618819,3,3,3,4,3,3,5,4,4,3,5,3,4,3,3,4,4,5,4,4,1.1126972805283737,3.2,0,4,0,4,0,3.6,0,3.8666666666666667,0,3,2,4,4,4,4,4,4,4,4,4,4,4,4,4,4,4,4,4,4,1.2513150976809202,3.85,0,3,2,4,4,4,4,4,4,4,4,4,4,4,4,4,4,4,4,4,4,1.2513150976809202,3.85,0,"I lived with my mother, but not father, most of the time. & I lived with my mother and father an equal amount of time (joint custody)",1,"Hispanic of Latino (e.g., Mexican American, Central American, and others) & White, Caucasian, Anglo, European American",1,26,1,3,NA,1,2,6,filmmaker,1,163,65,1,5,2,0,0,0,0,0,"I lived with my mother, but not father, most of the time. & I lived with my mother and father an equal amount of time (joint custody)",1,TRUE,TRUE,TRUE,TRUE,TRUE,6,0.46820000004023316,0.40844999998807907,0.4508935483963259,0.5725444444727015,0.5082724137881707,0.5439000000158946,1,1,0.96875,0.8709677419354839,0.90625,0.84375,0.05,0.328,0.402,0.008,1.245,114.81906927689155,2096.5901656898554,0.051,0.327,0.376,0.008,1.322,148.04612899156197,2105.7490711575324,430,1.2740740740740741,0,3,0,3,6,FALSE
351,2022-03-18T20:08:26Z,2022-03-18T20:32:58Z,1472,1,2022-03-18T20:33:00Z,0.8999999761581421,Chrome,99.0.4844.74,Macintosh,1440,900,I got a splitting headache halfway through the game.,1.6,534,97,399,88,66,73,-0.2958436746492394,-0.11589615440098398,-0.04592786355202696,-0.12572661993958972,0.10317444984167329,-0.2858083154854174,3,2,3,2,3,1,2,3,1,2,4,2,2,2,2,3,2,1,3,3,0.6488856845230502,0,1,1,5,5,2.3,0,2,3,3,1,2,2,4,2,2,3,3,2,2,2,1,2,3,1,1,2,3,2,2,0,2,0,0,0,0,1,2,1,2,1,1,4,3,2,2,2,2,1,2,2,1,4,2,4,3,3,2,1,1,1,4,1,2,1,1,1,4,5,5,1,3,1,2,1,1,1,1.5235883044055312,1.0997835284835873,2,0,1.25,0,2.2666666666666666,0,1.8888888888888888,0,2.3333333333333335,0,1.6666666666666667,0,2.7142857142857144,0,1.6666666666666667,0,2.135135135135135,0,0,0,0,-0.10774118866314261,-0.5343359712415323,-0.3210385799523375,2,2,4,2,2,2,2,1,3,0.7559289460184544,2.2857142857142856,0,2,0.1724249134007015,4,5,5,4,2,4,4,6,6,3,3,1.2535663410560174,6,4,0,0.22259487524538815,0,0.4382746948157501,2,3,3,4,3,4,4,4,4,3,3,3,3,3,3,4,4,4,2,4,0.7237468644557459,3,0,3.6,0,3.2,0,3.6,0,3.466666666666667,0,2,3,2,2,3,2,3,4,2,1,2,2,3,4,2,2,1,3,2,4,0.8870412083230169,2.45,0,2,3,2,2,3,2,3,4,2,1,2,2,3,4,2,2,1,3,2,4,0.8870412083230169,2.45,0,I lived with my mother and father an equal amount of time (joint custody),0,"White, Caucasian, Anglo, European American",0,29,1,2,NA,1,2,7,Digital Imaging Technician,2,250,70,1,5,2,0,0,1,0,0,I lived with my mother and father an equal amount of time (joint custody),0,TRUE,TRUE,TRUE,TRUE,TRUE,5,0.49105312500015136,0.44508749999979047,0.4632812499995925,0.5816733333334326,0.520514285714299,0.5946655172415335,1,1,1,0.9375,0.875,0.90625,0.074,0.33,0.555,0.009,1.492,20.350204792588727,1888.8050026695958,0.074,0.33,0.56,0.009,1.546,26.68576454797772,1883.3890002646842,424,1.2562962962962962,0,3,0,0,3,FALSE
353,2022-03-18T20:03:24Z,2022-03-18T20:35:10Z,1905,1,2022-03-18T20:35:10Z,0.8999999761581421,Chrome,99.0.4844.74,Windows NT 10.0,1920,1080,"i dont have any feedback, everything went well thank you :D",1.7777777777777777,986,105,365,81,67,195,0.6318731587433964,-0.07179878715424383,-0.16927887089909666,-0.21191416907049299,0.12365267578638717,1.0845739133485928,3,3,2,2,2,2,3,3,3,3,4,1,1,3,3,2,3,2,2,3,0.6958523739384593,0,1,1,3,2,2.5,0,2,2,2,2,2,1,2,2,1,1,1,1,3,1,4,1,1,1,1,1,1,2,1,4,2,0,0,0,0,3,2,1,2,4,1,2,3,3,2,1,1,2,1,1,4,1,1,1,3,4,1,1,1,1,1,1,1,3,1,1,2,2,2,1,2,1,1,2,1,1,1.4806053465364064,1.486446705914413,1.125,0,1.25,0,1.8,0,2.3333333333333335,0,1.8333333333333333,0,1,0,1.7142857142857142,0,1.3333333333333333,0,1.7567567567567568,0,2,0,0,-0.8594078631301088,-0.09601446952555226,-0.4777111663278305,1,1,1,1,1,2,1,1,3,1.889822365046136,1.1428571428571428,0,2,-0.49052210323574724,5,5,5,5,3,3,4,3,6,NA,3,1.2909944487358056,4.5,4.285714285714286,0,0.005972030878747869,1,0.4610851300629948,3,3,3,4,3,3,5,2,2,2,5,3,1,3,2,5,5,4,4,2,1.3732131246511903,3.2,0,4,0,3.4,0,2.2,0,3.2,0,2,1,4,4,3,4,4,4,4,4,3,4,1,4,1,4,4,4,4,2,1.3869694338832115,3.25,0,2,1,4,4,3,4,4,4,4,4,3,4,1,4,1,4,4,4,4,2,1.3869694338832115,3.25,0,I lived with my mother and father an equal amount of time (joint custody),0,"White, Caucasian, Anglo, European American",0,26,0,1,NA,1,1,3,unemployed,7,292,72,1,5,2,1,0,0,0,1,I lived with my mother and father an equal amount of time (joint custody),0,TRUE,TRUE,TRUE,TRUE,TRUE,6,0.5351406250009313,0.4339031249999534,0.4808187499982305,0.5840733333346745,0.5018096774203643,0.5254999999977924,1,1,1,0.967741935483871,0.96875,0.8709677419354839,0.055,0.345,0.431,0.009,1.106,119.61197560713273,2019.7984003157644,0.052,0.349,0.447,0.011,1.177,147.15472710616322,2026.152086795407,307,0.9096296296296296,0,3,0,33,36,FALSE
354,2022-03-18T20:10:44Z,2022-03-18T20:37:20Z,1595,1,2022-03-18T20:37:21Z,0.8999999761581421,Firefox,98.0,Macintosh,1440,900,n/a,1.6,898,93,335,71,59,87,0.4512557221536797,-0.13794483802435406,-0.27811799502886403,-0.3350392392574976,-0.04017313177132391,-0.12855133840610475,3,3,1,1,3,1,1,4,1,3,4,2,2,2,3,3,1,1,3,3,0.5104177855340404,0,1,1,2,1,2.25,0,4,3,2,3,2,4,3,3,2,3,4,4,1,4,5,3,4,5,3,3,5,4,3,3,1,1,1,0,0,4,5,4,5,5,3,4,4,3,2,2,2,3,3,2,4,5,5,4,3,5,5,3,5,2,4,4,2,1,1,1,5,5,4,2,5,3,1,3,1,1,1.3874166371083074,0.9154754164341269,3.75,0,1.5,0,3.1333333333333333,0,4.111111111111111,0,3.3333333333333335,0,3.8333333333333335,0,2.7142857142857144,0,3.3333333333333335,0,3.4864864864864864,0,2,0,1,1.6262988101268283,0.8946978593336199,1.260498334730224,4,3,5,2,2,3,2,3,1,0.6900655593423543,3,0,2,0.5867667987984821,2,2,4,3,1,1,1,6,4,1,2,1.5118578920369088,5,2,0,-0.7305164052433948,0,-1.2266702946542078,2,2,2,3,2,4,5,5,5,2,4,5,4,3,4,4,5,3,3,5,1.4375905768565218,2.2,0,4.2,0,3.6,0,4.4,0,4.066666666666666,0,4,1,3,4,3,4,4,4,4,3,4,2,2,3,2,3,2,4,4,4,1.1192102478745307,3.2,0,4,1,3,4,3,4,4,4,4,3,4,2,2,3,2,3,2,4,4,4,1.1192102478745307,3.2,0,"I lived with my mother, but not father, most of the time.",0,"White, Caucasian, Anglo, European American",0,29,1,2,NA,1,1,4,"n/a looking for work, artist",1,145,68,2,5,2,0,0,1,0,0,"I lived with my mother, but not father, most of the time.",0,TRUE,TRUE,TRUE,TRUE,TRUE,4,0.47050000000000003,0.41978125,0.4626875,0.5501290322580645,0.48789655172413793,0.5605,1,1,1,0.96875,0.9354838709677419,0.967741935483871,0.069,0.37,0.725,0.006,1.035,36.341186371541426,1869.0090071113657,0.068,0.372,0.772,0.006,1.046,38.56053444073532,1865.4941408267468,434,1.285925925925926,0,3,0,0,3,FALSE
355,2022-03-18T20:10:22Z,2022-03-18T20:37:38Z,1635,1,2022-03-18T20:37:39Z,0.800000011920929,Chrome,99.0.4844.51,Windows NT 10.0,1536,960,NA,1.6,579,134,486,116,67,148,-0.20348248548404332,0.08805416911518923,0.2697055964242985,0.21902357658402327,0.12365267578638717,0.5566397760109003,1,1,1,1,4,1,1,1,1,2,2,1,1,1,1,2,1,1,2,2,1.2937094768634556,0,1,2,3,3,1.4,0,4,3,2,4,3,1,3,1,1,2,1,3,1,3,4,3,1,1,1,1,2,2,2,1,2,0,0,0,0,2,4,4,3,5,3,5,5,4,2,3,3,3,4,2,2,3,3,2,3,3,3,1,5,1,3,3,2,2,1,1,3,2,2,1,2,1,2,2,1,2,0.9962391743414292,0.8451542547285166,1.625,0,1.75,0,2.4,0,3.888888888888889,0,2.75,0,2.6666666666666665,0,1.8571428571428572,0,1.3333333333333333,0,2.72972972972973,0,1,0,0,0.046489750041811745,-0.14280879051279902,-0.048159520235493636,3,2,5,1,2,2,2,1,1,0.6900655593423543,2.4285714285714284,0,1,-0.13121191200738283,2,3,3,2,1,1,4,3,9,2,2,0.816496580927726,6,2.2857142857142856,0,-0.3357509005400053,0,-0.8311866606645577,2,2,3,3,2,4,4,3,4,3,4,3,4,4,5,1,3,5,2,3,1.162919151265879,2.4,0,3.8,0,2.8,0,3.8,0,3.466666666666667,0,1,2,1,3,2,1,2,4,1,1,2,2,3,3,1,2,1,1,2,2,0.7863975156570492,1.85,0,1,2,1,3,2,1,2,4,1,1,2,2,3,3,1,2,1,1,2,2,0.7863975156570492,1.85,0,"I lived with my mother, but not father, most of the time.",0,"Hispanic of Latino (e.g., Mexican American, Central American, and others)",0,23,0,1,NA,1,2,5,Student / retail worker,1,230,72,1,5,2,0,0,0,0,0,"I lived with my mother, but not father, most of the time.",0,TRUE,TRUE,TRUE,TRUE,TRUE,6,0.588118749999965,0.5219562499999884,0.5494874999998137,0.6526125000000466,0.617425000000163,0.6563375000000233,1,1,1,1,1,1,0.188,0.272,0.666,0.014,1.624,30.03504809765159,1825.5112984360699,0.188,0.27,0.661,0.015,1.706,48.46106069400924,1831.3697631249825,398,1.1792592592592592,0,3,0,0,3,FALSE
356,2022-03-18T19:59:34Z,2022-03-18T20:38:32Z,2337,1,2022-03-18T20:38:34Z,0.8999999761581421,Chrome,99.0.4844.74,Windows NT 10.0,1920,1080,No,1.7777777777777777,1355,60,274,389,79,64,1.389234909898004,-0.3198464779171572,-0.4994242140927244,3.5803379926892505,0.3693913871229538,-0.38690208646497554,3,3,2,2,3,1,2,3,1,3,3,1,1,2,3,3,2,1,3,3,0.4442616583193193,0,1,1,2,2,2.25,0,2,1,2,2,2,1,1,2,1,1,1,2,2,1,2,1,2,1,1,1,1,1,1,1,2,0,0,0,0,2,1,1,1,1,1,1,1,1,2,1,3,1,1,2,4,1,3,3,4,3,1,1,1,1,1,1,1,2,2,1,1,1,3,1,1,1,2,1,2,2,1.7185614488441936,1.5976172734359604,1.125,0,1.75,0,1.5333333333333334,0,1.1111111111111112,0,2.3333333333333335,0,1,0,1.5714285714285714,0,1,0,1.5675675675675675,0,1,0,0,-1.0586187246098968,-0.14280879051279902,-0.6007137575613479,2,2,3,2,1,1,2,1,1,1.0690449676496976,1.8571428571428572,0,1,-0.4626854203256071,4,4,4,4,2,2,3,1,6,3,2,0.9511897312113419,3.5,3.2857142857142856,0,-0.5733927454649965,0,-0.43405491414093966,2,2,3,3,3,4,4,3,4,3,3,3,3,3,3,3,3,3,3,3,0.45773770821706344,2.6,0,3.2,0,3.2,0,3.2,0,3.2,0,1,1,1,3,3,1,1,3,1,1,1,3,2,1,2,3,1,1,1,2,0.6048053188292994,1.65,0,1,1,1,3,3,1,1,3,1,1,1,3,2,1,2,3,1,1,1,2,0.6048053188292994,1.65,0,I lived with my mother and father an equal amount of time (joint custody),0,"Asian or Asian American (e.g., Chinese, Japanese, and others) & White, Caucasian, Anglo, European American",1,26,1,2,NA,1,2,7,Clinical Specialist,3,147,65,1,5,2,0,0,1,0,0,I lived with my mother and father an equal amount of time (joint custody),0,TRUE,TRUE,TRUE,TRUE,TRUE,2,0.5762218750007451,0.6263781249895691,0.5053096774162784,0.6827354838655841,0.6861656250022352,0.6216366666674614,1,1,1,0.96875,1,0.967741935483871,0.084,0.337,0.519,0.016,1.899,30.913233598967125,1859.3872736967498,0.085,0.336,0.548,0.015,1.964,32.53901029275052,1857.7532088436258,304,0.9007407407407407,1,3,0,3,6,FALSE
357,2022-03-18T20:23:08Z,2022-03-18T20:41:16Z,1088,1,2022-03-18T20:41:17Z,1,Firefox,98.0,Macintosh,2048,1152,NA,1.7777777777777777,469,70,309,76,44,76,-0.4292542812211892,-0.26472476885873203,-0.3724452359413291,-0.2734767041639953,-0.34734652094203217,-0.2521103918255647,1,2,1,1,1,1,1,1,1,1,1,1,1,1,1,1,1,1,2,1,1.465390194130093,0,1,2,5,5,1.1,0,1,3,3,3,4,5,2,2,4,2,2,3,2,3,2,2,4,3,1,3,5,2,3,3,2,0,0,0,0,1,3,1,2,2,1,1,1,1,1,1,2,1,2,2,2,2,2,3,4,4,2,1,1,1,2,2,1,3,1,1,2,1,3,1,1,1,2,2,3,1,1.5658709882847794,1.0327955589886444,2.875,0,2,0,2.7333333333333334,0,1.4444444444444444,0,2.1666666666666665,0,1.5,0,1.7142857142857142,0,1,0,1.7027027027027026,0,2,0,0,0.28959786657099923,0.16253517528056266,0.22606652092578094,2,1,3,1,1,1,1,2,4,1.2535663410560174,1.4285714285714286,0,3,0.06171985341100544,5,5,5,4,3,1,4,7,3,4,3,1.618347187425374,5,3.857142857142857,0,0.2559847515897029,0,0.38120087361958943,3,2,2,3,2,5,5,5,5,3,5,5,3,4,4,2,5,4,4,5,1.624221425205085,2.4,0,4.8,0,3.4,0,4.6,0,4.266666666666667,0,3,2,3,2,4,2,2,3,1,1,1,2,3,1,1,2,1,3,1,2,0.9679060415469871,2,0,3,2,3,2,4,2,2,3,1,1,1,2,3,1,1,2,1,3,1,2,0.9679060415469871,2,0,I lived with my mother and father an equal amount of time (joint custody),0,"White, Caucasian, Anglo, European American",0,25,1,3,NA,1,2,5,Graphic Designer,2,228,62,2,5,2,0,0,1,0,0,I lived with my mother and father an equal amount of time (joint custody),0,TRUE,TRUE,TRUE,TRUE,TRUE,1,0.5364193548387097,0.4596875,0.49325,0.606875,0.5299354838709678,0.5511785714285714,0.96875,1,1,1,0.96875,0.9032258064516129,0.051,0.367,0.416,0.013,1.456,167.45209015058788,2064.3838998290134,0.051,0.366,0.451,0.013,1.525,194.13662804735787,2074.215162475707,304,0.9007407407407407,1,3,0,3,6,FALSE
358,2022-03-18T20:05:18Z,2022-03-18T20:42:39Z,2240,1,2022-03-18T20:42:40Z,0.8999999761581421,Firefox,99.0,Windows NT 6.1,1366,768,It was very enjoyable study it feels good.,1.7786458333333333,807,107,570,117,78,187,0.2644808729529499,-0.06077444534255879,0.5744551439876472,0.23133608360272373,0.3489131611782399,0.9947127835889855,2,3,1,2,4,1,1,1,3,2,2,2,2,1,2,2,2,2,3,2,0.8944271909999159,0,1,3,4,4,2,0,3,2,1,3,1,1,3,2,1,1,1,1,3,2,3,1,2,1,3,4,1,2,1,2,1,4,2,3,2,2,3,2,2,3,2,3,2,3,1,2,2,2,2,2,2,1,1,3,4,3,2,3,1,3,4,1,2,3,2,1,1,2,1,1,1,1,4,3,4,4,1.2520253861514021,1.3522468075656264,1.875,0,3.75,0,1.8666666666666667,0,2.4444444444444446,0,2.0833333333333335,0,2.3333333333333335,0,1.7142857142857142,0,1,0,2.054054054054054,0,1,2,2,-0.37260108403967895,3.7520348216920922,1.6897168688262068,2,1,3,1,1,1,1,4,3,1.2535663410560174,1.4285714285714286,0,3.5,0.2549724546548257,3,4,4,4,3,3,5,7,7,3,3,1.0690449676496976,7,3.7142857142857144,0,0.4032826894249255,0,0.3935599778348039,1,1,2,3,2,5,3,5,5,4,4,4,4,3,3,4,4,4,3,2,1.121223821162776,1.8,0,4.2,0,3.6,0,3.6,0,3.8,0,2,2,1,1,3,2,3,3,1,3,1,2,2,2,1,1,1,2,1,2,0.9679060415469871,1.8,0,2,2,1,1,3,2,3,3,1,3,1,2,2,2,1,1,1,2,1,2,0.9679060415469871,1.8,0,"I lived with my extended family on father's side (grandparents, aunts ,uncles, cousins)",0,"White, Caucasian, Anglo, European American",0,28,0,1,NA,1,4,7,Banking,5,145,66,3,5,2,0,0,1,0,0,"I lived with my extended family on father's side (grandparents, aunts ,uncles, cousins)",0,TRUE,TRUE,TRUE,TRUE,TRUE,3,0.73071875,0.71840625,0.6441875,0.7649032258064516,0.7699032258064517,0.71665625,1,1,1,1,1,1,0.181,0.38,0.706,0.015,1.388,32.63236716009536,1818.608371317496,0.188,0.371,0.697,0.018,1.479,43.35186884621791,1828.4354376318768,380,1.125925925925926,0,3,0,0,3,FALSE
359,2022-03-18T20:25:41Z,2022-03-18T20:44:28Z,1127,1,2022-03-18T20:44:29Z,1,Chrome,97.0.4692.99,Windows NT 10.0,1920,1080,No.,1.7777777777777777,497,87,277,62,36,60,-0.3717850968517339,-0.17101786345940917,-0.48854030167974766,-0.4458518024258018,-0.5111723284997433,-0.43183265134477916,2,2,2,1,3,1,3,2,2,2,3,3,1,1,2,2,2,1,3,2,0.8335087534664907,0,0,3,3,3,2,0,1,1,2,1,1,1,2,1,1,1,1,2,3,2,5,1,3,1,1,1,1,1,1,0,2,0,0,0,0,5,5,1,3,3,1,2,1,1,1,1,1,1,2,1,1,1,1,1,3,1,2,1,1,1,1,1,1,1,1,1,2,3,1,1,1,1,1,1,1,1,1.6302323937579137,1.7237832147426693,1.25,0,1,0,1.6666666666666667,0,2.4444444444444446,0,1.25,0,1.1666666666666667,0,1.4285714285714286,0,1,0,1.5405405405405406,0,0,0,0,-0.9575369287898661,-0.6205191861769039,-0.789028057483385,3,3,3,3,3,3,2,3,1,0.3779644730092272,2.857142857142857,0,2,0.5038984217189261,5,5,5,5,4,4,5,3,3,4,3,1.4638501094227998,3,4.714285714285714,0,-0.1053908767693718,0,0.6254837044808257,2,1,2,2,1,4,5,5,5,3,5,4,4,4,3,5,5,3,4,5,1.4960264830861913,1.6,0,4.2,0,4.2,0,4.4,0,4.266666666666667,0,1,1,1,3,2,1,1,2,1,2,1,1,1,1,1,3,1,1,1,1,0.8255779474818965,1.35,0,1,1,1,3,2,1,1,2,1,2,1,1,1,1,1,3,1,1,1,1,0.8255779474818965,1.35,0,I lived with my mother and father an equal amount of time (joint custody),0,"White, Caucasian, Anglo, European American",0,27,1,2,NA,1,2,6,Administrative Assistant,4,130,65,2,5,2,0,0,1,0,0,I lived with my mother and father an equal amount of time (joint custody),0,TRUE,TRUE,TRUE,TRUE,TRUE,1,0.4309218748807907,0.40365937507152555,0.43359375005960465,0.5291516127740183,0.46853703707235833,0.49266428569384985,1,1,1,0.96875,0.8709677419354839,0.875,0.044,0.361,0.619,0.02,1.584,21.078613654987873,1896.4272648510628,0.045,0.36,0.645,0.021,1.674,29.483778316363484,1891.2541745710394,317,0.9392592592592592,0,3,0,3,6,FALSE
360,2022-03-18T20:17:52Z,2022-03-18T20:47:09Z,1757,1,2022-03-18T20:47:10Z,0.8999999761581421,Chrome,99.0.4844.74,Macintosh,1680,1050,none,1.6,1311,75,207,19,19,61,1.2989261916031456,-0.23716391432951942,-0.7424982579825382,-0.9752896042299217,-0.8593021695598793,-0.4206000101248282,2,2,2,3,4,1,2,4,1,2,3,4,4,3,3,2,1,1,3,4,1.0399898784932577,0,1,3,4,4,2.55,0,3,4,1,4,5,2,4,1,4,2,4,2,5,4,3,3,2,2,1,3,2,4,4,1,2,0,0,0,0,2,2,4,5,3,4,4,5,2,2,4,1,4,3,3,4,5,4,2,3,1,2,5,2,2,1,4,3,2,4,4,1,2,3,2,2,1,3,4,2,2,1.2393692089268784,1.3201731488169053,2.625,0,2.75,0,3.2,0,3.4444444444444446,0,3,0,2.6666666666666665,0,2.7142857142857144,0,1.6666666666666667,0,2.891891891891892,0,1,0,0,0.9039625885852463,0.2019240692286875,0.5529433289069668,4,2,5,3,3,2,3,2,3,0.7559289460184544,3.142857142857143,0,2.5,0.8628877771218584,2,4,3,3,2,1,4,7,7,1,2,0.9759000729485332,7,2.7142857142857144,0,-0.36914077688432,0,-0.6192594425690531,4,4,5,3,4,4,3,5,5,4,4,3,1,4,3,5,2,4,4,5,1.3020130933435712,4,0,3.4,0,3.4,0,4.4,0,3.7333333333333334,0,2,2,4,2,4,4,2,3,2,1,3,3,4,3,3,1,3,3,2,3,0.8944271909999159,2.7,0,2,2,4,2,4,4,2,3,2,1,3,3,4,3,3,1,3,3,2,3,0.8944271909999159,2.7,0,I lived with my mother and father an equal amount of time (joint custody),0,Black or African American,0,24,0,1,NA,1,2,7,IT Technician,2,166,68,3,5,2,0,0,1,0,0,I lived with my mother and father an equal amount of time (joint custody),0,TRUE,TRUE,TRUE,TRUE,TRUE,5,0.5497677419355079,0.49233437499997673,0.5355838709679102,0.6386615384615815,0.5672593749998487,0.5885483870967141,0.96875,1,1,0.8125,1,0.96875,0.045,0.466,0.641,0.027,1.761,78.679901534375,1921.693871883196,0.047,0.468,0.708,0.033,1.865,70.67233035677378,1897.2229571104933,392,1.1614814814814816,0,3,0,0,3,FALSE
362,2022-03-18T20:09:34Z,2022-03-18T20:50:07Z,2432,1,2022-03-18T20:50:08Z,1,Chrome,98.0.4758.102,Windows NT 10.0,1366,768,Everything worked fine.,1.7786458333333333,854,124,843,217,87,105,0.36094700385882134,0.03293246005676404,1.5648911735685305,1.46258678547277,0.5332171946806649,0.0736362035530115,1,1,1,1,1,1,1,1,1,1,2,1,1,1,1,1,1,1,1,1,1.5035046776746235,0,1,1,4,4,1.05,0,1,1,2,1,2,1,1,1,2,1,1,2,1,1,2,3,2,5,1,2,2,2,1,4,2,0,0,0,0,1,1,1,1,1,1,2,1,1,2,1,1,1,2,1,2,1,1,1,2,1,3,1,1,2,3,3,1,5,1,1,1,1,1,1,2,1,2,2,2,1,1.7617047435945683,1.791514389985135,2.25,0,1.75,0,1.3333333333333333,0,1.1111111111111112,0,1.3333333333333333,0,2.1666666666666665,0,1.5714285714285714,0,1.3333333333333333,0,1.4594594594594594,0,2,0,0,-0.7016336482328265,0.07635196034519101,-0.31264084394381775,1,1,3,1,1,2,1,2,1,1.5275252316519468,1.4285714285714286,0,1.5,-0.5180379503204552,4,5,5,5,1,1,3,4,3,1,2,1.8126539343499315,3.5,3.4285714285714284,0,-1.0015481265127009,0,-0.6176113300350854,1,2,2,2,2,4,5,3,5,2,4,4,4,4,5,3,4,4,3,1,1.3020130933435712,1.8,0,4,0,3.4,0,3.6,0,3.6666666666666665,0,1,1,1,1,2,1,2,1,1,1,1,1,1,1,1,1,1,1,1,1,1.2182817926554552,1.1,0,1,1,1,1,2,1,2,1,1,1,1,1,1,1,1,1,1,1,1,1,1.2182817926554552,1.1,0,"I lived with my mother, but not father, most of the time.",0,"White, Caucasian, Anglo, European American",0,24,0,1,NA,1,3,4,none,2,180,67,1,5,2,0,0,1,0,0,"I lived with my mother, but not father, most of the time.",0,TRUE,TRUE,TRUE,TRUE,TRUE,1,0.6572032258064305,0.563050000000032,0.6275906250000407,0.7556625000000349,0.6482399999999752,0.6956812500000232,0.96875,1,1,1,0.9375,1,0.118,0.422,0.594,0.008,0.998,116.36784499088536,1926.2932790326272,0.115,0.427,0.586,0.01,1.041,152.62223893443348,1935.3315682032467,338,1.0014814814814814,0,3,0,0,3,FALSE
363,2022-03-18T20:34:24Z,2022-03-18T20:58:27Z,1442,1,2022-03-18T20:58:29Z,1,Chrome,97.0.4692.71,Windows NT 10.0,1920,1080,"No, there is nothing.",1.7777777777777777,558,46,400,98,44,65,-0.24658437376113482,-0.39701687059895246,-0.04229989274770138,-0.002601549752585081,-0.34734652094203217,-0.3756694452450246,1,2,1,1,4,1,1,3,1,3,4,1,1,1,1,4,1,1,4,4,1,0,0,4,3,2,2,0,3,2,1,3,1,1,3,1,1,1,1,3,1,3,5,1,3,1,1,1,2,2,1,0,2,0,0,0,0,2,3,4,3,3,2,1,1,2,1,1,1,1,4,1,5,1,1,2,3,1,3,1,1,2,1,1,1,1,1,1,2,1,1,1,2,1,2,1,1,1,1.3732756044894578,1.1254628677422756,1.5,0,1.25,0,2,0,2.3333333333333335,0,1.8333333333333333,0,1.5,0,1.1428571428571428,0,1.3333333333333333,0,1.7297297297297298,0,0,0,0,-0.6199414471319253,-0.5343359712415323,-0.5771387091867288,1,1,5,1,1,1,1,3,2,1.5118578920369088,1.5714285714285714,0,2.5,-0.04866437075325872,4,5,5,4,1,1,4,3,3,2,2,1.7728105208558367,3,3.4285714285714284,0,-0.8778143430786174,0,-0.5421891128223754,1,2,1,2,2,4,3,4,5,3,3,2,5,3,3,4,1,5,3,4,0.8338093878327919,1.6,0,3,0,3.6,0,3.8,0,3.466666666666667,0,1,1,1,3,1,2,2,2,1,1,2,2,4,2,1,2,1,1,1,1,0.9233805168766387,1.6,0,1,1,1,3,1,2,2,2,1,1,2,2,4,2,1,2,1,1,1,1,0.9233805168766387,1.6,0,"I lived with my extended family on mother's side (grandparents, aunts ,uncles, cousins)",0,"White, Caucasian, Anglo, European American",0,27,0,1,NA,1,4,5,CEO,4,265,71,3,5,2,0,0,1,0,0,"I lived with my extended family on mother's side (grandparents, aunts ,uncles, cousins)",0,TRUE,TRUE,TRUE,TRUE,TRUE,2,0.5642838710661857,0.5030031249523162,0.5646687501370907,0.7263656248748303,0.641406249910593,0.6819299999554952,0.96875,1,1,1,1,1,0.143,0.326,0.601,0.012,1.485,20.052907685604016,1813.7715140118898,0.141,0.328,0.6,0.012,1.549,26.47821779864742,1807.6407745394372,288,0.8533333333333333,0,3,0,6,9,FALSE
367,2022-03-18T20:40:44Z,2022-03-18T21:07:15Z,1591,1,2022-03-18T21:07:16Z,0.8999999761581421,Chrome,99.0.4844.51,Macintosh,1920,1080,None,1.7777777777777777,797,54,245,42,40,53,0.24395616424957303,-0.35291950335221234,-0.6046353674181663,-0.6921019427998111,-0.42925942472088774,-0.5104611398844354,2,1,2,1,3,1,1,2,1,1,1,2,1,1,2,2,1,1,3,1,1.1964860832322377,0,1,4,3,3,1.5,0,2,2,2,2,1,1,2,2,1,2,1,2,2,2,3,1,1,1,1,1,1,1,1,0,2,0,0,0,0,1,2,2,1,2,1,1,1,1,2,1,1,1,3,2,2,1,1,1,1,1,1,1,1,1,1,1,1,1,1,1,1,1,1,1,1,1,2,1,1,1,1.7710552325200466,1.2983506020002016,1,0,1.25,0,1.8,0,1.3333333333333333,0,1.4166666666666667,0,1,0,1,0,1,0,1.2162162162162162,0,0,0,0,-1.150251783917052,-0.5343359712415323,-0.8422938775792922,2,1,4,1,1,3,2,1,1,1.1547005383792515,2,0,1,-0.37981704324605103,2,2,4,3,2,1,4,1,1,2,2,0.9511897312113419,1,2.5714285714285716,0,-1.2391899714376922,0,-1.2270266633572016,2,1,1,2,1,4,4,5,5,2,4,4,5,5,3,4,1,5,4,4,1.3451854182690985,1.4,0,3.6,0,3.8,0,4.4,0,3.933333333333333,0,1,1,1,2,2,1,2,2,1,1,1,2,2,1,1,1,1,2,1,2,0.9233805168766387,1.4,0,1,1,1,2,2,1,2,2,1,1,1,2,2,1,1,1,1,2,1,2,0.9233805168766387,1.4,0,I lived with my mother and father an equal amount of time (joint custody),0,"Asian or Asian American (e.g., Chinese, Japanese, and others)",0,27,0,1,NA,1,4,7,Marketing Manager,6,140,65,4,5,2,0,0,1,0,0,I lived with my mother and father an equal amount of time (joint custody),0,TRUE,TRUE,TRUE,TRUE,TRUE,1,0.49182187499757857,0.48150312499981374,0.5134781250013039,0.5812714285733445,0.5244406249979511,0.5588249999945983,1,1,1,0.9032258064516129,1,1,0.152,0.305,0.752,0.018,1.385,131.54904349833404,1940.1508420607413,0.156,0.3,0.748,0.019,1.411,140.26596659222105,1927.282200116987,314,0.9303703703703704,0,3,0,3,6,FALSE
368,2022-03-18T20:51:13Z,2022-03-18T21:13:57Z,1363,1,2022-03-18T21:13:58Z,0.8999999761581421,Chrome,99.0.4844.74,Windows NT 10.0,1536,864,I would recommend a different color for the background on the flanker game as staring intensively at a white screen is not good for your eyes,1.7777777777777777,558,57,349,35,27,101,-0.24658437376113482,-0.3363829906346848,-0.22732640376830593,-0.7782894919307143,-0.6954763620021682,0.02870563867320788,2,2,3,2,2,2,3,3,3,2,2,2,2,3,2,3,1,2,2,3,0.6069769786668839,0,0,4,3,1,2.3,0,3,4,4,3,3,2,3,5,5,3,3,4,3,3,2,3,3,5,1,3,1,3,2,2,1,1,0,0,0,4,3,1,3,4,2,2,3,3,3,4,3,4,2,2,2,3,2,4,2,4,3,3,2,3,3,4,2,2,4,3,3,2,3,3,3,3,1,2,1,2,0.7988354887823513,0.9411239481143202,2.625,0,1.5,0,3.3333333333333335,0,2.7777777777777777,0,2.9166666666666665,0,3,0,2.7142857142857144,0,3,0,2.864864864864865,0,1,0,0,0.9504188764402164,-0.22899200544817064,0.36071343549602286,3,4,3,2,3,3,2,3,2,0.6900655593423543,2.857142857142857,0,2.5,0.6971510229627462,1,1,3,3,1,2,4,4,1,1,2,0.8997354108424374,2.5,2.142857142857143,0,-1.1822359406922383,0,-1.4245902960005299,3,3,2,2,3,3,1,4,2,3,3,4,4,2,4,4,3,5,2,3,0.9856107606091623,2.6,0,3.6,0,2.8,0,3,0,3.1333333333333333,0,2,2,1,3,3,2,2,2,2,2,1,2,2,3,2,3,3,2,4,3,0.7326950970650465,2.3,0,2,2,1,3,3,2,2,2,2,2,1,2,2,3,2,3,3,2,4,3,0.7326950970650465,2.3,0,"I lived with my father, but not mother, most of the time.",0,"Hispanic of Latino (e.g., Mexican American, Central American, and others)",0,19,0,1,NA,1,2,3,Unemployed looking,1,161,71,2,5,2,0,0,1,0,0,"I lived with my father, but not mother, most of the time.",0,TRUE,TRUE,TRUE,TRUE,TRUE,1,0.4551096774147403,0.40423437500186266,0.5398687500003725,0.5322874999977648,0.445587096773809,0.5612724137922813,1,1,1,1,0.96875,0.9666666666666667,0.074,0.315,0.365,0.024,1.57,97.0100916841609,1937.032061774315,0.071,0.318,0.37,0.02,1.707,115.01872015517412,1940.4277575921406,343,1.0162962962962963,0,3,0,3,6,FALSE
369,2022-03-18T20:52:19Z,2022-03-18T21:14:05Z,1306,1,2022-03-18T21:14:06Z,0.8999999761581421,Chrome,99.0.4844.74,Windows NT 10.0,1280,800,I do not have any,1.6,543,75,283,98,63,106,-0.2773714368162002,-0.23716391432951942,-0.4667724768537942,-0.002601549752585081,0.04173977200753163,0.0848688447729624,1,2,1,1,2,1,1,1,1,2,1,2,1,1,1,1,1,1,2,1,1.348488432516786,0,1,2,4,4,1.25,0,3,1,2,2,1,1,1,1,1,1,1,1,1,1,2,1,1,1,3,1,1,1,1,0,2,0,0,0,0,2,2,1,1,2,1,2,1,2,1,2,3,1,2,1,1,1,4,3,2,3,1,1,1,1,1,1,2,1,2,1,1,1,1,1,2,1,3,2,3,2,1.633912381270694,1.7994708216848747,1.25,0,2.5,0,1.3333333333333333,0,1.5555555555555556,0,2,0,1,0,1.2857142857142858,0,1.3333333333333333,0,1.5405405405405406,0,0,0,0,-1.1032049500300272,-0.10341989656467412,-0.6033124232973507,1,1,2,2,1,1,1,2,2,1.6761634196950514,1.2857142857142858,0,2,-0.40765372615619105,5,5,5,5,4,3,5,6,6,3,3,1.5275252316519468,6,4.571428571428571,0,0.22259487524538815,0,0.7479814886144375,1,2,2,1,1,5,1,5,4,1,5,4,5,3,4,4,5,5,2,2,1.424279266355945,1.4,0,4.8,0,2.6,0,3.6,0,3.6666666666666665,0,1,1,1,1,1,1,3,1,1,1,2,1,3,1,1,1,1,2,1,1,1.2523661815266247,1.3,0,1,1,1,1,1,1,3,1,1,1,2,1,3,1,1,1,1,2,1,1,1.2523661815266247,1.3,0,I lived with my mother and father an equal amount of time (joint custody),0,"White, Caucasian, Anglo, European American",0,26,0,1,NA,1,5,6,Data Programmer,4,139.5,64,4,5,2,0,0,1,0,0,I lived with my mother and father an equal amount of time (joint custody),0,TRUE,TRUE,TRUE,TRUE,TRUE,2,0.7547666666666667,0.6614193548387097,0.6357741935483872,0.7745806451612903,0.6693548387096774,0.6675806451612903,0.9375,0.96875,0.96875,0.96875,0.96875,1,0.077,0.354,0.256,0.086,1.29,88.05903943813813,1953.9056196336767,0.078,0.349,0.274,0.037,1.382,97.53146941748264,1920.9398218939943,336,0.9955555555555555,0,3,0,0,3,FALSE
370,2022-03-18T20:36:35Z,2022-03-18T21:17:11Z,2436,1,2022-03-18T21:17:12Z,0.8999999761581421,Chrome,99.0.4844.51,Windows NT 10.0,1366,768,N/A,1.7786458333333333,1022,185,652,86,124,103,0.7057621100755532,0.36917488531315773,0.8719487499423447,-0.15035163397699064,1.2909115546350787,0.05117092111310969,2,2,3,2,2,1,2,2,1,2,3,3,3,3,2,2,1,2,2,3,0.7591546545162482,0,1,1,3,2,2.15,0,3,3,2,3,2,1,2,2,2,2,2,3,3,2,2,2,3,1,1,1,1,2,1,1,1,2,0,0,0,2,2,3,2,2,1,1,1,1,1,1,3,1,3,1,1,2,2,2,2,2,3,1,1,1,3,1,1,1,1,1,2,3,3,1,1,1,1,1,2,2,1.519147065891847,0.8997354108424374,1.5,0,1.5,0,2.2666666666666666,0,1.6666666666666667,0,1.75,0,1.6666666666666667,0,1.7142857142857142,0,1,0,1.6486486486486487,0,1,0,0,-0.538839792063079,-0.22899200544817064,-0.3839158987556248,3,2,4,2,1,3,2,2,1,0.6900655593423543,2.4285714285714284,0,1.5,0.06204068923643738,3,3,4,4,2,2,4,4,1,NA,2,0.8997354108424374,2.5,3.142857142857143,0,-1.0524935395521762,1,-0.8035186226580776,2,2,2,2,2,4,3,4,4,4,5,3,5,3,4,3,3,4,3,3,0.9102589898327995,2,0,3.8,0,3.6,0,3.6,0,3.6666666666666665,0,2,1,2,2,2,2,3,2,2,1,2,2,4,2,2,2,1,1,1,3,0.8750939799154206,1.95,0,2,1,2,2,2,2,3,2,2,1,2,2,4,2,2,2,1,1,1,3,0.8750939799154206,1.95,0,NA,NA,Black or African American,0,28,0,1,NA,1,3,4,Warehouse Worker,7,140,64,3,5,2,0,0,2,0,0,NA,NA,TRUE,TRUE,TRUE,TRUE,TRUE,3,0.6309656249992549,0.5355656249932945,0.5425468750074506,0.6879281249940395,0.610449999988079,0.6598709677496264,1,1,1,1,1,1,0.219,0.271,0.781,0.009,1.206,19.736757260920186,1813.7784483309333,0.217,0.271,0.794,0.008,1.237,29.67239725363008,1814.2723485459687,449,1.3303703703703704,0,3,0,0,3,FALSE
371,2022-03-18T20:55:27Z,2022-03-18T21:19:13Z,1426,1,2022-03-18T21:19:14Z,1,Firefox,98.0,Windows NT 10.0,1366,768,NA,1.7786458333333333,506,79,230,46,28,469,-0.3533128590186947,-0.21511523070614935,-0.6590549294830499,-0.6428519147250092,-0.6749981360574544,4.16231760761514,1,1,1,1,1,1,1,2,1,1,2,1,1,1,2,2,1,1,2,2,1.2814465510343749,0,1,2,4,3,1.3,0,2,2,3,2,2,2,3,3,3,2,3,3,3,3,2,2,3,3,2,2,2,2,2,0,1,1,0,0,0,1,1,2,1,1,1,1,1,1,1,1,5,1,2,2,1,2,2,3,3,3,3,2,2,2,3,2,2,1,1,1,2,2,2,1,2,2,2,2,1,1,1.518158359593888,0.7037315505489968,2.25,0,1.5,0,2.533333333333333,0,1.1111111111111112,0,2.1666666666666665,0,2.3333333333333335,0,1.5714285714285714,0,1.6666666666666667,0,1.7837837837837838,0,0,0,0,-0.035497724075117185,-0.44815275630616064,-0.24182524019063892,4,4,4,3,3,4,5,6,3,1.1126972805283737,3.857142857142857,0,4.5,2.05024006749492,4,4,4,4,2,2,3,3,3,2,2,0.9511897312113419,3,3.2857142857142856,0,-0.8778143430786174,0,-0.6196158112720472,3,4,3,2,3,4,4,3,3,4,4,3,4,4,4,4,4,4,3,3,0.8451542547285166,3,0,3.8,0,3.8,0,3.4,0,3.6666666666666665,0,1,1,2,2,2,2,2,2,2,2,2,2,2,2,2,2,2,2,2,3,0.5871429486123998,1.95,0,1,1,2,2,2,2,2,2,2,2,2,2,2,2,2,2,2,2,2,3,0.5871429486123998,1.95,0,"I lived with my mother, but not father, most of the time.",0,"White, Caucasian, Anglo, European American",0,27,1,2,NA,1,3,4,artist,2,110,60,2,5,2,0,0,1,0,0,"I lived with my mother, but not father, most of the time.",0,TRUE,TRUE,TRUE,TRUE,TRUE,6,0.546875,0.482,0.54740625,0.6145625,0.5585625,0.68275,1,1,1,1,1,1,0.097,0.381,0.572,0.014,1.787,53.869040992428474,1847.6233787017454,0.1,0.381,0.595,0.015,1.85,52.670358790899485,1837.2540070521165,338,1.0014814814814814,0,3,0,3,6,FALSE
372,2022-03-18T20:52:51Z,2022-03-18T21:19:33Z,1601,1,2022-03-18T21:19:33Z,0.800000011920929,Chrome,99.0.4844.74,Windows NT 10.0,1920,1080,Thank you.,1.7777777777777777,688,98,398,126,56,115,0.020236839382764854,-0.11038398349514147,-0.04955583435635254,0.3421486467710279,-0.10160780960546556,0.18596261575252052,1,3,1,1,2,1,1,1,1,2,2,1,1,1,1,2,1,1,2,2,1.2096106376585989,0,0,1,3,5,1.4,0,1,1,1,2,2,2,1,1,2,1,1,1,1,1,1,1,1,1,1,1,1,1,1,0,2,0,0,0,0,1,1,2,1,2,2,2,2,3,1,2,1,1,4,1,4,3,2,1,1,2,2,1,1,1,1,1,1,1,1,1,2,1,1,1,1,1,1,2,4,4,1.4876872027456622,1.8516401995451028,1,0,2.75,0,1.2666666666666666,0,1.7777777777777777,0,1.9166666666666667,0,1.1666666666666667,0,1.1428571428571428,0,1,0,1.5405405405405406,0,0,0,0,-1.24158957020818,-0.017236681629302503,-0.6294131259187413,4,4,4,3,3,3,4,3,3,0.816496580927726,3.5714285714285716,0,3,1.304745509604347,5,5,5,5,1,1,5,4,3,3,3,2.138089935299395,3.5,3.857142857142857,0,-0.22912466020345523,0,0.08550129657008435,2,3,3,2,2,4,4,4,4,3,4,3,5,3,4,3,5,4,2,3,1.0327955589886444,2.4,0,4,0,3.4,0,3.6,0,3.6666666666666665,0,1,1,1,3,2,1,1,2,1,1,2,2,1,1,1,2,1,1,1,1,0.7591546545162482,1.35,0,1,1,1,3,2,1,1,2,1,1,2,2,1,1,1,2,1,1,1,1,0.7591546545162482,1.35,0,I lived with my mother and father an equal amount of time (joint custody),0,"Hispanic of Latino (e.g., Mexican American, Central American, and others) & White, Caucasian, Anglo, European American",1,30,0,4,they,1,3,6,e commerce,1,240,74,1,5,2,0,0,0,0,0,I lived with my mother and father an equal amount of time (joint custody),0,TRUE,TRUE,TRUE,TRUE,TRUE,1,0.5427312499999826,0.46425161290320477,0.5122968750000109,0.5924580645161275,0.5113966666666403,0.5814322580645169,1,1,1,1,0.9375,1,0.077,0.374,0.527,0.017,1.262,7.550661424862161,1793.7808461191203,0.079,0.371,0.553,0.017,1.327,13.32462245944159,1794.016760415982,279,0.8266666666666667,0,3,0,9,12,FALSE
373,2022-03-18T20:58:03Z,2022-03-18T21:19:47Z,1303,1,2022-03-18T21:19:48Z,0.8999999761581421,Chrome,99.0.4844.51,Windows NT 10.0,1920,1080,NA,1.7777777777777777,530,84,361,67,60,97,-0.30405355813059015,-0.18755437617693674,-0.18379075411639897,-0.38428926733229946,-0.019694905826610026,-0.01622492620659573,1,1,1,1,1,1,4,1,1,1,4,1,1,1,1,4,1,1,3,1,1.4823523268955432,0,1,2,3,3,1.55,0,4,1,3,3,3,1,5,3,3,1,3,5,2,5,5,3,1,2,1,1,2,3,2,0,2,0,0,0,0,1,5,4,1,5,5,3,3,5,1,1,5,5,5,2,1,1,5,5,4,4,5,1,1,1,1,1,1,1,1,1,1,1,1,1,1,2,4,4,3,3,1.7329174830334544,1.2071217242444348,1.875,0,3.5,0,3.1333333333333333,0,3.5555555555555554,0,3.25,0,1.6666666666666667,0,1,0,1.3333333333333333,0,2.4864864864864864,0,0,0,0,0.3699121269304391,0.24131296317681236,0.30561254505362573,4,5,3,3,3,5,5,4,1,1.2535663410560174,4,0,2.5,1.360098039599195,5,3,3,3,1,1,3,9,9,NA,1,1.3801311186847085,9,2.7142857142857144,0,0.19281052080600125,1,-0.27672071417122135,3,3,3,1,3,3,5,5,5,5,1,5,3,1,5,3,3,1,3,2,1.5522640914238175,2.6,0,2.6,0,3.8,0,3.6,0,3.3333333333333335,0,4,2,4,4,4,4,1,4,4,2,2,4,4,2,1,3,4,4,4,4,1.332784974957958,3.25,0,4,2,4,4,4,4,1,4,4,2,2,4,4,2,1,3,4,4,4,4,1.332784974957958,3.25,0,NA,NA,"Asian or Asian American (e.g., Chinese, Japanese, and others)",0,24,0,1,NA,1,2,6,Self-employed (Side-job selling things online slowly) and unemployed,7,280,68,1,5,2,0,0,1,0,0,NA,NA,TRUE,TRUE,TRUE,TRUE,TRUE,6,0.5834218750074506,0.46096874998509885,0.5601343750003726,0.6107827586264446,0.5171064516036741,0.6468133333345254,1,1,1,0.90625,0.96875,0.9375,0.077,0.287,0.312,0.012,1.422,173.9992801281485,2051.0158345144255,0.074,0.29,0.305,0.012,1.528,169.2914284548985,2035.7298768361886,312,0.9244444444444444,0,3,0,0,3,FALSE
374,2022-03-18T20:58:05Z,2022-03-18T21:20:17Z,1332,1,2022-03-18T21:20:18Z,1,Chrome,98.0.4758.109,Macintosh,1440,900,NA,1.6,618,112,334,73,55,72,-0.12343612154087343,-0.03321359081334619,-0.2817459658331896,-0.3104142252200967,-0.12208603555017945,-0.2970409567053683,2,2,1,1,2,1,2,4,1,3,4,2,2,1,2,2,2,1,3,3,0.812727700887249,0,0,4,2,2,2.05,0,5,5,5,4,5,5,5,5,5,5,5,5,2,5,5,4,5,5,4,4,5,5,5,2,1,1,0,2,0,5,5,5,5,5,5,5,5,5,4,4,5,4,5,3,2,5,5,5,5,5,5,3,5,5,5,3,4,2,2,2,4,5,5,5,5,5,2,4,3,2,1.7346495349231237,1.9639610121239315,4.625,0,2.75,0,4.733333333333333,0,5,0,4.333333333333333,0,4.333333333333333,0,3.4285714285714284,0,5,0,4.378378378378378,0,1,0,0,3.097644248991131,0.2019240692286875,1.6497841591099094,5,4,5,4,3,5,5,8,8,1.7043362064926932,4.428571428571429,0,8,3.734481784519886,2,2,2,1,1,1,1,3,3,NA,2,1.4142135623730951,3,1.4285714285714286,0,-0.9169776789175231,1,-1.6500349941153423,3,4,4,5,4,4,5,4,4,4,5,5,1,3,5,5,5,4,5,5,1.6987390281365427,4,0,4.6,0,4,0,4.2,0,4.266666666666667,0,2,4,4,3,4,4,4,3,1,3,4,3,1,2,1,2,3,4,2,4,1.1516578439248717,2.9,0,2,4,4,3,4,4,4,3,1,3,4,3,1,2,1,2,3,4,2,4,1.1516578439248717,2.9,0,NA,NA,"Hispanic of Latino (e.g., Mexican American, Central American, and others)",0,21,1,2,NA,1,2,4,customer service,2,200,63,3,5,2,1,1,1,0,2,NA,NA,TRUE,TRUE,TRUE,TRUE,TRUE,2,0.6968093750006519,0.5699999999990386,0.5346562500004657,0.7774064516127109,0.667087096773809,0.679659374999348,1,1,1,0.96875,1,1,0.094,0.343,0.503,0.012,1.813,37.387764614757295,1831.2625289220102,0.101,0.348,0.54,0.014,1.962,49.417443770010415,1835.0571325563644,434,1.285925925925926,0,3,0,0,3,FALSE
375,2022-03-18T20:54:57Z,2022-03-18T21:20:27Z,1530,1,2022-03-18T21:20:28Z,0.8999999761581421,Chrome,99.0.4844.74,Windows NT 10.0,2560,1080,NA,2.3703703703703702,1001,59,225,43,41,57,0.6626602217984617,-0.32535864882299975,-0.6771947835046778,-0.6797894357811106,-0.40878119877617386,-0.46553057500463185,1,2,1,1,2,1,1,1,1,1,2,1,1,1,1,3,1,1,1,2,1.3218806379747876,0,1,2,3,3,1.3,0,2,1,2,2,1,1,2,2,1,1,1,1,2,2,3,2,3,1,1,1,2,3,2,3,2,0,0,0,0,1,2,1,2,3,3,4,4,3,2,2,3,1,1,3,1,3,2,3,1,2,2,1,1,1,3,2,2,5,4,1,1,1,1,1,2,1,2,1,2,3,1.4311002927985332,1.5430334996209192,1.875,0,2,0,1.6,0,2.5555555555555554,0,2,0,1.6666666666666667,0,2.142857142857143,0,1.3333333333333333,0,2.054054054054054,0,2,0,0,-0.4891355010318077,0.16253517528056266,-0.16330016287562252,1,2,3,2,1,2,2,4,2,1.2724180205607036,1.8571428571428572,0,3,0.31032498464967373,4,3,3,4,5,4,4,6,5,5,4,0.9759000729485332,5.5,3.857142857142857,0,0.9046744344648651,0,0.7766111876630333,2,3,3,4,3,2,3,3,4,3,4,3,2,4,3,5,3,4,3,3,0.8338093878327919,3,0,3.2,0,3.2,0,3.4,0,3.2666666666666666,0,1,1,1,1,2,1,3,2,1,1,2,1,2,1,1,1,1,1,1,1,1.1516578439248717,1.3,0,1,1,1,1,2,1,3,2,1,1,2,1,2,1,1,1,1,1,1,1,1.1516578439248717,1.3,0,I lived with my mother and father an equal amount of time (joint custody),0,"White, Caucasian, Anglo, European American",0,21,0,1,NA,1,4,5,Software Engineer,3,150,68,2,5,2,0,0,1,0,0,I lived with my mother and father an equal amount of time (joint custody),0,TRUE,TRUE,TRUE,TRUE,TRUE,5,0.463906249998603,0.37327419354886776,0.41295312500093134,0.5333551724131765,0.4560875000022352,0.4929107142841177,1,1,1,0.90625,0.75,0.875,0.066,0.277,0.494,0.017,1.931,73.42818917079389,1958.4877921880384,0.066,0.277,0.538,0.018,2.014,93.66622948238823,1961.453530159552,322,0.9540740740740741,0,3,0,15,18,FALSE
376,2022-03-18T21:09:02Z,2022-03-18T21:23:43Z,881,1,2022-03-18T21:23:44Z,0.8999999761581421,Firefox,98.0,Windows NT 10.0,1280,720,NA,1.7777777777777777,450,59,191,47,34,58,-0.4682512277576053,-0.32535864882299975,-0.8005457908517475,-0.6305394077063088,-0.552128780389171,-0.454297933784681,3,3,3,3,3,2,3,3,2,3,4,3,2,4,3,4,3,2,4,3,0.7677718959499145,0,1,2,3,3,3,0,1,1,2,2,2,2,2,2,2,1,1,2,1,2,2,2,1,1,1,1,2,1,1,1,2,0,0,0,0,1,2,1,2,2,1,2,2,2,2,1,1,1,2,2,1,2,2,2,1,2,1,1,1,1,1,1,2,2,1,1,2,2,2,1,1,1,1,1,1,1,1.5552874071755738,1.4573295865416045,1.25,0,1,0,1.6666666666666667,0,1.6666666666666667,0,1.5833333333333333,0,1,0,1.7142857142857142,0,1,0,1.4864864864864864,0,1,0,0,-0.9811587700720544,-0.4013584353189139,-0.6912586026954841,1,2,1,1,1,2,2,1,1,1.7182493859684491,1.4285714285714286,0,1,-0.7112905515642753,4,5,5,5,2,2,4,8,8,4,3,1.5118578920369088,8,3.857142857142857,0,0.798048194128315,0,0.7116169133747821,4,3,2,2,2,3,4,4,4,4,5,5,4,3,5,3,4,4,4,4,1.2227992865708155,2.6,0,4.2,0,3.8,0,4,0,4,0,2,1,3,4,2,2,2,4,3,2,2,3,2,2,2,3,1,3,4,2,0.7591546545162482,2.45,0,2,1,3,4,2,2,2,4,3,2,2,3,2,2,2,3,1,3,4,2,0.7591546545162482,2.45,0,I lived with my mother and father an equal amount of time (joint custody),0,"Asian or Asian American (e.g., Chinese, Japanese, and others) & White, Caucasian, Anglo, European American",1,25,1,2,NA,1,2,6,case manager,2,116,62,1,5,2,0,0,1,0,0,I lived with my mother and father an equal amount of time (joint custody),0,TRUE,TRUE,TRUE,TRUE,TRUE,5,0.44159375,0.42116129032258065,0.4721875,0.5201153846153846,0.5255333333333333,0.5902068965517241,1,0.96875,1,0.8125,0.9375,0.90625,0.07,0.329,0.455,0.008,1.446,48.43242120232988,1917.7800099045228,0.069,0.334,0.513,0.009,1.496,54.21456936987422,1909.205686567085,366,1.0844444444444443,0,3,0,0,3,FALSE
377,2022-03-18T20:59:20Z,2022-03-18T21:25:07Z,1546,1,2022-03-18T21:25:08Z,0.8999999761581421,Chrome,99.0.4844.74,Windows NT 10.0,1366,768,NA,1.7786458333333333,620,113,460,100,77,101,-0.11933117980019806,-0.027701419907503674,0.1753783555118334,0.022023464284815848,0.328434935233526,0.02870563867320788,3,2,2,1,3,1,1,3,1,2,2,1,1,2,3,2,2,1,3,2,0.7880689256524124,0,1,1,4,4,1.9,0,1,3,4,4,3,2,3,2,2,2,4,3,2,4,4,4,4,5,2,3,4,3,5,7,1,0,0,1,1,3,4,3,4,4,4,5,5,4,4,3,4,3,4,2,4,2,4,4,4,4,5,2,4,3,4,3,2,4,3,2,2,1,2,4,4,3,3,3,4,4,1.038305387676515,0.9611501047232549,3.75,0,3.5,0,2.8666666666666667,0,4,0,3.5,0,3.5,0,2.2857142857142856,0,3.6666666666666665,0,3.4054054054054053,0,4,1,0,1.4743316312114174,1.816115799045931,1.6452237151286742,3,2,4,1,1,2,1,3,1,0.7559289460184544,2,0,2,0.0066881592415893995,3,2,3,3,2,2,3,4,1,NA,2,0.5345224838248488,2.5,2.5714285714285716,0,-1.0524935395521762,1,-1.113225416456765,3,2,3,2,3,4,4,3,4,2,5,4,1,3,3,3,4,4,3,3,1.0327955589886444,2.6,0,4.2,0,2.6,0,3.2,0,3.3333333333333335,0,2,1,2,3,3,2,2,3,3,3,3,3,2,1,2,3,1,3,3,3,0.6958523739384593,2.4,0,2,1,2,3,3,2,2,3,3,3,3,3,2,1,2,3,1,3,3,3,0.6958523739384593,2.4,0,"I lived with my mother, but not father, most of the time.",0,"Hispanic of Latino (e.g., Mexican American, Central American, and others) & White, Caucasian, Anglo, European American",1,25,1,2,NA,1,2,2,Nanny,1,270,64,3,5,2,0,0,0,0,0,"I lived with my mother, but not father, most of the time.",0,TRUE,TRUE,TRUE,TRUE,TRUE,2,0.7582966666678588,0.5900250000040979,0.7228874999955297,0.8682566666642825,0.7655062499996275,1.0448062499966473,0.9375,1,1,0.967741935483871,1,1,0.206,0.167,0.329,0.011,1.947,52.11984513695116,1853.0731906617325,0.198,0.15,0.328,0.008,1.899,46.24391417205798,1827.9046488643253,340,1.0074074074074075,0,3,0,0,3,FALSE
378,2022-03-18T21:06:23Z,2022-03-18T21:29:08Z,1365,1,2022-03-18T21:29:09Z,0.8999999761581421,Chrome,99.0.4844.51,Macintosh,1440,900,none,1.6,571,97,364,81,108,76,-0.21990225244674486,-0.11589615440098398,-0.17290684170342224,-0.21191416907049299,0.9632599395196565,-0.2521103918255647,1,2,1,1,3,1,1,2,1,2,2,1,1,1,1,2,1,1,3,2,1.1239029738980326,0,1,1,3,3,1.5,0,2,1,3,2,3,1,2,2,2,1,1,1,3,1,2,1,1,3,1,1,1,2,1,0,1,2,0,2,0,1,1,1,1,1,1,1,1,1,2,1,1,1,2,1,1,2,1,1,1,1,3,1,2,1,3,2,1,1,1,1,1,3,1,1,1,1,2,2,2,1,1.798397685228224,1.4573295865416045,1.375,0,1.75,0,1.8,0,1,0,1.25,0,2,0,1.2857142857142858,0,1,0,1.2972972972972974,0,0,0,0,-0.9509424980985884,-0.361969541370789,-0.6564560197346887,3,3,5,2,2,4,4,3,1,1.1126972805283737,3.2857142857142856,0,2,0.7525035529575942,4,4,4,4,1,1,3,3,3,2,1,1.4142135623730951,3,3,0,-1.2220824283401586,0,-0.98431862508372725,3,3,2,3,3,4,5,3,5,3,5,5,4,5,3,5,5,4,3,4,1.505545305418162,2.8,0,4.6,0,4,0,4,0,4.2,0,1,1,1,2,1,1,2,1,2,1,2,1,1,2,1,2,1,2,1,2,1.0052493799000692,1.4,0,1,1,1,2,1,1,2,1,2,1,2,1,1,2,1,2,1,2,1,2,1.0052493799000692,1.4,0,"I lived with my mother, but not father, most of the time. & I lived with my extended family on mother's side (grandparents, aunts ,uncles, cousins)",1,"Hispanic of Latino (e.g., Mexican American, Central American, and others) & Filipino",1,27,1,2,NA,1,2,6,RN,5,150,65,2,5,2,0,1,2,0,1,"I lived with my mother, but not father, most of the time. & I lived with my extended family on mother's side (grandparents, aunts ,uncles, cousins)",1,TRUE,TRUE,TRUE,TRUE,TRUE,5,0.6663843749947846,0.6061419354831019,0.608106249999255,0.7282838709710105,0.6690999999940396,0.7083781250026077,1,1,1,1,1,1,0.163,0.32,0.558,0.014,1.351,18.73498195055854,1802.2851669665768,0.155,0.326,0.558,0.012,1.402,19.993586291027054,1801.836912473237,440,1.3037037037037038,0,3,0,0,3,FALSE
379,2022-03-18T21:11:41Z,2022-03-18T21:37:01Z,1520,1,2022-03-18T21:37:03Z,1,Chrome,99.0.4844.51,Macintosh,1280,800,"the question ""are you currently sick?"" was too vague. If you're doing a study relating to possible childhood trauma, you have to expect that several of your participants are chronically ill from the stress they have endured. I selected ""yes"" to the question but I am sick with chronic illnesses, one of which is flaring badly today. I am not sick with the flu or a cold or anything acute.",1.6,548,98,340,88,55,83,-0.2671090824645117,-0.11038398349514147,-0.25997814100723615,-0.12572661993958972,-0.12208603555017945,-0.17348190328590837,3,3,2,3,3,1,2,3,1,3,3,2,2,2,3,3,2,1,3,3,0.44721359549995793,1,1,2,3,2,2.4,0,5,3,5,4,5,4,4,5,4,3,5,5,4,5,3,5,5,1,1,5,5,5,5,2,2,0,0,0,0,3,3,3,3,3,3,5,4,4,5,2,5,4,3,5,3,5,5,5,5,5,5,2,1,1,1,1,2,2,2,1,2,3,4,3,1,5,1,5,4,5,1.4719601443879744,1.52127765851133,4,0,3.75,0,4.266666666666667,0,3.4444444444444446,0,4.333333333333333,0,1.8333333333333333,0,2.2857142857142856,0,3,0,3.2162162162162162,0,1,0,0,2.1127118918625554,0.546656928970174,1.3296844104163648,2,2,1,1,1,2,2,8,7,1.5118578920369088,1.5714285714285714,0,7.5,1.8838616416849434,5,5,5,5,2,3,5,7,7,6,4,1.7043362064926932,7,4.285714285714286,0,1.3897838462580232,0,1.304590860061554,3,3,3,3,3,3,3,4,3,2,5,5,2,3,4,2,2,3,3,3,1,3,0,3.6,0,2.4,0,3.4,0,3.1333333333333333,0,2,2,2,3,3,2,4,2,2,3,3,3,4,1,2,2,2,2,4,3,0.8255779474818965,2.55,0,2,2,2,3,3,2,4,2,2,3,3,3,4,1,2,2,2,2,4,3,0.8255779474818965,2.55,0,I lived with my mother and father an equal amount of time (joint custody),0,"White, Caucasian, Anglo, European American",0,28,1,2,NA,1,1,4,Dog Care & Training,2,186,67,2,5,2,0,0,1,0,0,I lived with my mother and father an equal amount of time (joint custody),0,TRUE,TRUE,TRUE,TRUE,TRUE,4,0.6201875000037252,0.5660968749970198,0.5777562500014901,0.6759312500022352,0.6469580645368945,0.6294548386989102,1,1,1,1,1,1,0.117,0.383,0.599,0.016,1.287,150.89781613370522,1988.0651241399923,0.119,0.387,0.63,0.02,1.415,177.1401934084297,1966.550406665099,354,1.0488888888888888,0,3,0,0,3,FALSE
380,2022-03-18T20:58:29Z,2022-03-18T21:37:09Z,2319,1,2022-03-18T21:37:11Z,0.8999999761581421,Chrome,99.0.4844.74,Windows NT 10.0,1920,1080,Very good questions.,1.7777777777777777,850,449,554,203,62,76,0.35273712037747057,1.824388004455583,0.5164076111184379,1.2902116872109637,0.021261546062817747,-0.2521103918255647,3,2,3,2,3,1,2,3,2,2,3,3,2,2,2,3,3,2,3,3,0.5501196042201808,0,1,4,3,3,2.45,0,3,2,2,2,1,1,2,1,1,1,1,2,1,2,3,2,3,2,2,3,2,3,3,0,1,1,0,2,1,2,1,2,1,1,2,3,2,2,1,2,1,2,2,1,2,1,4,1,1,1,4,2,4,4,3,3,1,1,2,2,2,1,1,1,1,1,2,2,2,2,1.4806053465364064,1.3972762620115438,2.5,0,2,0,1.6666666666666667,0,1.7777777777777777,0,1.5833333333333333,0,3.3333333333333335,0,1.4285714285714286,0,1,0,1.837837837837838,0,0,1,0,-0.2813617220872267,0.4223735060017412,0.07050589195725723,1,1,2,1,1,1,2,1,1,1.6761634196950514,1.2857142857142858,0,1,-0.7941589286438315,4,5,5,5,2,2,5,3,7,5,4,1.7182493859684491,5,4,0,0.8143305273750964,0,0.7989685461535063,3,2,2,2,2,5,3,5,5,1,5,3,5,3,4,2,4,4,3,1,1.4074631010979937,2.2,0,4.2,0,2.8,0,3.6,0,3.533333333333333,0,2,2,2,2,3,2,1,2,1,1,3,2,1,2,1,3,3,2,2,1,0.7947194142390263,1.9,0,2,2,2,2,3,2,1,2,1,1,3,2,1,2,1,3,3,2,2,1,0.7947194142390263,1.9,0,"I lived with my father, but not mother, most of the time. & I lived with my mother and father an equal amount of time (joint custody) & I lived with my extended family on father's side (grandparents, aunts ,uncles, cousins)",1,"White, Caucasian, Anglo, European American",0,22,0,1,NA,1,4,3,Student,5,195,68,1,5,2,1,0,0,0,1,"I lived with my father, but not mother, most of the time. & I lived with my mother and father an equal amount of time (joint custody) & I lived with my extended family on father's side (grandparents, aunts ,uncles, cousins)",1,TRUE,TRUE,TRUE,TRUE,TRUE,5,0.5508999999843794,0.4490968750156462,0.435234375,0.6049607142720904,0.5295812499932945,0.5281290322465282,0.9354838709677419,1,1,0.875,1,0.96875,0.065,0.337,0.614,0.015,1.513,72.72093173736577,1910.3013682439027,0.065,0.338,0.677,0.015,1.592,86.23713233882445,1916.6400797794263,326,0.965925925925926,0,3,0,3,6,FALSE
381,2022-03-18T21:19:05Z,2022-03-18T21:38:33Z,1167,1,2022-03-18T21:38:33Z,0.8999999761581421,Chrome,99.0.4844.74,Windows NT 10.0,1536,864,NA,1.7777777777777777,617,64,274,65,37,61,-0.12548859241121113,-0.2977977942937871,-0.4994242140927244,-0.4089142813697004,-0.4906941025550294,-0.4206000101248282,3,2,1,1,3,1,1,3,1,3,2,1,1,2,3,3,1,1,3,3,0.6708203932499369,0,1,1,3,3,1.95,0,2,1,2,2,2,1,1,2,2,2,2,2,2,2,2,1,1,1,1,2,2,2,1,0,2,0,0,0,0,1,1,1,1,3,2,2,2,2,2,2,3,2,3,2,2,3,4,4,3,3,2,1,1,1,3,4,1,1,3,3,2,2,2,1,1,1,2,2,2,2,1.3322067312451078,1.3093073414159542,1.375,0,2,0,1.8,0,1.6666666666666667,0,2.75,0,2,0,2,0,1,0,2.081081081081081,0,0,0,0,-0.6084257995068584,-0.2757863264354174,-0.44210606297113786,2,1,4,2,1,2,3,3,3,1.0690449676496976,2.142857142857143,0,3,0.4760617388087859,4,4,5,4,3,3,5,3,3,3,3,1.2724180205607036,3,4,0,-0.3194685672932239,0,0.10785865506055745,3,3,3,3,3,4,3,5,3,1,2,2,5,4,5,2,2,3,4,2,1.3020130933435712,3,0,2.6,0,3,0,3.8,0,3.1333333333333333,0,2,3,3,2,1,3,3,4,2,2,3,3,2,3,2,3,1,3,2,2,0.7163503994113789,2.45,0,2,3,3,2,1,3,3,4,2,2,3,3,2,3,2,3,1,3,2,2,0.7163503994113789,2.45,0,I lived with my mother and father an equal amount of time (joint custody),0,"White, Caucasian, Anglo, European American",0,27,0,1,NA,1,2,3,Self Employed,2,110,70,3,5,2,0,0,0,0,0,I lived with my mother and father an equal amount of time (joint custody),0,TRUE,TRUE,TRUE,TRUE,TRUE,5,0.5652312500327825,0.4101281249076128,0.46843437503278257,0.619222580709765,0.44261999991734824,0.5148812500685453,1,1,1,0.96875,0.9375,1,0.068,0.341,0.512,0.041,1.818,75.54132559834203,1891.6686231558722,0.07,0.34,0.54,0.04,1.85,96.0134403441342,1882.627849035469,420,1.2444444444444445,0,3,0,3,6,FALSE
382,2022-03-18T21:12:34Z,2022-03-18T21:39:37Z,1622,1,2022-03-18T21:39:39Z,0.8999999761581421,Chrome,99.0.4844.74,Windows NT 10.0,1536,864,N/A,1.7777777777777777,602,96,564,68,53,106,-0.15627565546627648,-0.1214083253068265,0.5526873191616937,-0.371976760313599,-0.16304248743960723,0.0848688447729624,4,4,4,3,4,1,2,4,2,4,4,2,2,2,4,4,3,1,4,4,0.8825799501580878,0,1,1,3,2,3.1,0,4,3,4,3,3,2,4,3,3,4,3,4,2,4,3,2,3,1,1,2,4,2,3,0,2,0,0,0,0,2,1,2,2,4,2,1,1,3,2,2,3,1,4,2,4,3,2,3,3,3,3,1,1,1,3,3,1,1,1,1,2,2,2,3,4,3,2,2,1,2,1.244205790071742,0.7037315505489968,2.25,0,1.75,0,3.2666666666666666,0,2,0,2.6666666666666665,0,2,0,1.4285714285714286,0,3.3333333333333335,0,2.2162162162162162,0,0,0,0,0.4739466529107438,-0.361969541370789,0.05598855576997738,3,2,4,1,1,2,2,1,1,0.6900655593423543,2.142857142857143,0,1,-0.29694866616649496,2,3,3,2,1,1,2,3,4,2,2,1.1126972805283737,3.5,2,0,-0.7874704359888487,0,-1.2613867573598954,2,3,2,2,2,4,4,4,4,3,5,3,4,3,3,4,3,4,3,4,0.7432233529572065,2.2,0,3.8,0,3.6,0,3.6,0,3.6666666666666665,0,2,1,3,4,2,4,4,4,3,2,3,3,2,4,2,4,1,4,4,3,1.145931016569864,2.95,0,2,1,3,4,2,4,4,4,3,2,3,3,2,4,2,4,1,4,4,3,1.145931016569864,2.95,0,I lived with my mother and father an equal amount of time (joint custody),0,"Hispanic of Latino (e.g., Mexican American, Central American, and others) & White, Caucasian, Anglo, European American",1,21,0,1,NA,1,2,4,"Student, unemployed",2,170,66,1,5,2,0,0,2,0,0,I lived with my mother and father an equal amount of time (joint custody),0,TRUE,TRUE,TRUE,TRUE,TRUE,6,0.6429562499999738,0.6802375000000029,0.5439093749999884,0.6941499999999869,0.7275709677419641,0.5897062499999957,1,1,1,1,1,1,0.157,0.309,0.685,0.033,1.667,34.16505850125913,1822.9265522598137,0.16,0.306,0.678,0.032,1.715,56.468710279493195,1842.5585847499744,376,1.114074074074074,0,3,0,3,6,FALSE
383,2022-03-18T21:11:11Z,2022-03-18T21:40:59Z,1788,1,2022-03-18T21:41:00Z,1,Safari,15.3,Macintosh,1440,900,The study was very simple yet interesting,1.6,661,134,573,95,60,94,-0.03517987411635277,0.08805416911518923,0.5853390564006239,-0.039539070808686475,-0.019694905826610026,-0.04992284986644844,1,3,1,2,2,1,1,3,1,3,2,1,2,2,3,3,3,2,2,2,0.8522416262267903,0,1,1,3,3,2,0,4,3,2,4,2,1,3,1,2,1,1,5,1,4,4,2,1,3,1,1,2,3,2,1,2,0,0,0,0,2,4,4,5,4,3,2,2,3,1,2,2,3,4,1,3,2,3,2,3,2,5,1,1,2,2,2,1,2,1,1,3,2,1,1,1,1,2,2,3,2,0.9984973695493629,0.7037315505489968,1.875,0,2.25,0,2.533333333333333,0,3.2222222222222223,0,2.3333333333333335,0,2.1666666666666665,0,1.5714285714285714,0,1,0,2.27027027027027,0,1,0,0,0.013222323569396293,0.029557639357944268,0.02138998146367028,2,1,4,1,1,2,2,3,3,1.0690449676496976,1.8571428571428572,0,3,0.31032498464967373,2,4,3,3,1,1,4,5,3,1,2,1.1126972805283737,4,2.5714285714285716,0,-0.9112042194229322,0,-1.0271021807739178,1,1,2,2,2,5,3,2,5,4,5,4,4,4,4,5,4,4,4,3,1.3201731488169053,1.6,0,4.4,0,4,0,3.6,0,4,0,2,1,1,3,1,2,2,2,1,1,2,3,1,2,1,3,1,1,1,2,0.6048053188292994,1.65,0,2,1,1,3,1,2,2,2,1,1,2,3,1,2,1,3,1,1,1,2,0.6048053188292994,1.65,0,I lived with my mother and father an equal amount of time (joint custody),0,Black or African American,0,21,0,1,NA,1,3,3,DayTrader,2,135,69,3,5,2,0,0,1,0,0,I lived with my mother and father an equal amount of time (joint custody),0,TRUE,TRUE,TRUE,TRUE,TRUE,4,0.4816451612903169,0.4295312499999955,0.5149374999999909,0.5097419354838691,0.5007333333333353,0.5926000000000117,0.96875,1,1,0.96875,0.9375,0.9375,0.066,0.352,0.404,0.024,1.859,33.206040880147164,1875.677232159456,0.067,0.349,0.429,0.021,2.064,41.24843894913052,1884.244775902078,436,1.2918518518518518,0,3,0,0,3,FALSE
384,2022-03-18T21:26:59Z,2022-03-18T21:46:56Z,1196,1,2022-03-18T21:46:57Z,0.8999999761581421,Chrome,99.0.4844.74,Macintosh,1440,900,This study was easy to complete and easy to answer. There were no technical issues.,1.6,613,67,258,67,44,61,-0.13369847589256187,-0.28126128157625957,-0.5574717469619337,-0.38428926733229946,-0.34734652094203217,-0.4206000101248282,3,2,1,1,3,1,1,3,1,2,3,1,1,1,3,3,1,1,3,3,0.6805570473787206,0,0,4,2,3,1.9,0,4,3,1,2,2,2,3,4,2,2,3,3,4,3,4,2,3,1,1,1,1,2,1,0,2,0,0,0,0,2,4,3,2,2,1,2,2,2,1,2,4,1,3,2,2,3,1,3,2,2,2,1,1,1,3,2,1,1,1,1,2,3,1,1,1,2,2,2,1,1,1.3254270092150517,0.8997354108424374,1.5,0,1.5,0,2.8,0,2.2222222222222223,0,2.1666666666666665,0,1.6666666666666667,0,1.4285714285714286,0,1.3333333333333333,0,1.8918918918918919,0,0,0,0,-0.1994726723089739,-0.44815275630616064,-0.32381271430756725,2,1,3,1,1,2,2,2,1,1.1547005383792515,1.7142857142857142,0,1.5,-0.3523011961613431,4,5,4,4,2,2,5,6,4,3,3,1.4638501094227998,5,3.7142857142857144,0,0.041907061065850786,0,0.17328261799800881,3,2,3,2,2,3,3,2,4,3,5,4,5,3,2,3,3,5,4,3,1.0465362369445672,2.4,0,4,0,3.6,0,2.8,0,3.466666666666667,0,1,2,1,1,1,1,2,1,1,1,2,2,2,1,1,2,1,1,1,1,1.0310954828418375,1.3,0,1,2,1,1,1,1,2,1,1,1,2,2,2,1,1,2,1,1,1,1,1.0310954828418375,1.3,0,I lived with my mother and father an equal amount of time (joint custody),0,"White, Caucasian, Anglo, European American",0,20,1,2,NA,1,3,4,Student,4,140,63,3,5,2,0,0,1,0,0,I lived with my mother and father an equal amount of time (joint custody),0,TRUE,TRUE,TRUE,TRUE,TRUE,5,0.5219516129041871,0.43554193548521686,0.4543968749996275,0.5888645161265327,0.4793499999980132,0.5471935483890195,1,0.96875,1,0.96875,0.967741935483871,0.96875,0.073,0.311,0.456,0.018,1.743,59.61630465520495,1885.4915864828465,0.073,0.312,0.513,0.018,1.831,62.88911624906869,1887.6368722631005,386,1.1437037037037037,0,3,0,0,3,FALSE
385,2022-03-18T21:24:24Z,2022-03-18T21:47:04Z,1359,1,2022-03-18T21:47:05Z,0.8999999761581421,Chrome,99.0.4844.51,Windows NT 10.0,1536,864,NA,1.7777777777777777,563,50,355,37,27,261,-0.23632201940944636,-0.37496818697558243,-0.20555857894235247,-0.7536644778933134,-0.6954763620021682,1.8259282338653522,1,2,2,2,2,2,1,2,2,2,2,2,2,2,2,1,2,2,2,2,0.7591546545162482,0,1,1,3,3,1.85,0,1,1,1,1,1,1,1,1,1,1,1,1,1,1,1,1,1,1,1,1,1,1,1,0,2,0,0,0,0,1,1,1,1,1,1,1,1,1,1,1,1,1,1,1,1,1,1,1,1,1,1,1,1,1,1,1,1,1,1,1,1,1,1,1,1,1,1,1,1,1,1.9666895707934864,2.065591117977289,1,0,1,0,1,0,1,0,1,0,1,0,1,0,1,0,1,0,0,0,0,-1.5943424000221917,-0.6205191861769039,-1.1074307930995477,1,1,1,1,1,1,1,2,1,1.9518001458970664,1,0,1.5,-0.7666430815591236,5,5,5,5,3,3,5,6,6,6,4,1.5735915849388864,6,4.428571428571429,0,1.2090960320784858,0,1.2718788785928283,1,1,1,1,1,4,4,4,4,4,3,5,5,4,2,3,4,4,5,4,1.2535663410560174,1,0,4,0,4.2,0,3.6,0,3.933333333333333,0,2,2,1,2,3,2,2,1,1,1,2,2,2,2,1,2,1,2,2,2,0.8255779474818965,1.75,0,2,2,1,2,3,2,2,1,1,1,2,2,2,2,1,2,1,2,2,2,0.8255779474818965,1.75,0,I lived with my mother and father an equal amount of time (joint custody),0,"White, Caucasian, Anglo, European American",0,29,0,1,NA,1,4,6,Engineer,4,145,65,2,5,2,0,0,1,0,0,I lived with my mother and father an equal amount of time (joint custody),0,TRUE,TRUE,TRUE,TRUE,TRUE,3,0.457712499987334,0.3648656250052154,0.3756593749932945,0.507828571417502,0.4052518518500858,0.4459466666976611,1,1,1,0.9032258064516129,0.84375,0.9375,0.056,0.283,0.581,0.016,1.491,38.21053781694888,1897.6227624540124,0.056,0.284,0.628,0.018,1.57,61.56690949260089,1905.7088516802246,304,0.9007407407407407,1,3,0,0,3,FALSE
386,2022-03-18T21:06:16Z,2022-03-18T21:50:05Z,2629,1,2022-03-18T21:50:06Z,1,Firefox,98.0,Macintosh,1440,900,NA,1.6,1041,330,419,66,34,71,0.7447590566119694,1.1684396666603232,0.026631552534484636,-0.3966017743509999,-0.552128780389171,-0.3082735979253192,1,2,2,1,2,1,2,2,1,2,2,1,1,1,2,2,1,1,3,2,1.0208355710680808,0,1,1,3,3,1.6,0,4,2,4,4,5,2,4,4,3,3,1,4,4,4,4,3,4,5,1,2,4,4,3,2,1,1,0,1,0,3,5,5,5,5,5,5,5,5,5,5,1,4,4,3,4,5,3,3,2,2,4,1,1,1,3,1,1,5,5,1,4,4,1,3,1,1,2,2,2,1,1.3819949022734888,1.1464230084422218,3.25,0,1.75,0,3.466666666666667,0,4.777777777777778,0,3.4166666666666665,0,1.8333333333333333,0,3,0,1.6666666666666667,0,3.27027027027027,0,1,0,0,1.4589774343779949,-0.14280879051279902,0.6580843219325979,2,1,2,3,1,1,1,1,1,1.4638501094227998,1.5714285714285714,0,1,-0.6284221744847194,4,5,4,3,1,1,3,2,6,3,2,1.5275252316519468,4,3,0,-0.4830488383752279,0,-0.5338389710810847,1,3,2,1,2,4,4,4,5,1,5,5,5,4,4,4,4,5,4,2,1.4960264830861913,1.8,0,4.6,0,3.6,0,3.8,0,4,0,1,1,1,1,2,2,2,2,1,1,2,2,1,1,1,1,1,1,1,1,1.0310954828418375,1.3,0,1,1,1,1,2,2,2,2,1,1,2,2,1,1,1,1,1,1,1,1,1.0310954828418375,1.3,0,"I lived with my father, but not mother, most of the time.",0,"Asian or Asian American (e.g., Chinese, Japanese, and others)",0,26,1,2,NA,1,2,6,Register Nurse,3,125,62,3,5,2,0,0,1,0,0,"I lived with my father, but not mother, most of the time.",0,TRUE,TRUE,TRUE,TRUE,TRUE,5,0.5594516129032258,0.5176774193548387,0.5286129032258065,0.58821875,0.6062580645161291,0.646896551724138,1,1,1,1,1,0.90625,0.061,0.391,0.385,0.015,1.482,97.73896886414913,2038.216517754607,0.061,0.391,0.375,0.015,1.605,112.03258671352312,2022.527336299888,446,1.3214814814814815,0,3,0,0,3,FALSE
388,2022-03-18T21:32:38Z,2022-03-18T21:53:00Z,1221,1,2022-03-18T21:53:03Z,0.8999999761581421,Chrome,99.0.4844.51,Macintosh,1280,800,NA,1.6,564,55,221,241,37,61,-0.23426954853910867,-0.3474073324463698,-0.6917066667219801,1.7580869539215813,-0.4906941025550294,-0.4206000101248282,2,2,2,2,2,1,2,2,1,3,3,3,1,1,2,2,1,2,2,2,0.8335087534664907,0,1,1,3,4,1.9,0,1,1,2,2,1,1,2,1,1,1,1,2,2,2,2,1,2,1,1,1,1,1,1,0,2,0,0,0,0,1,4,3,4,3,2,2,1,1,1,1,2,1,3,1,1,2,1,1,2,2,2,1,1,1,2,1,2,1,1,1,1,1,1,1,2,1,2,1,1,1,1.506741607001768,1.632993161855452,1.125,0,1.25,0,1.4666666666666666,0,2.3333333333333335,0,1.5,0,1.3333333333333333,0,1.1428571428571428,0,1.3333333333333333,0,1.5945945945945945,0,0,0,0,-1.0759414082168348,-0.5343359712415323,-0.8051386897291836,1,2,3,1,1,1,1,1,1,1.5275252316519468,1.4285714285714286,0,1,-0.7112905515642753,3,3,5,5,1,1,1,6,4,2,2,1.7994708216848747,5,2.7142857142857144,0,-0.5164387147195426,0,-0.7090452452339395,3,4,3,5,3,3,5,2,3,4,5,3,2,3,4,5,3,4,4,4,1.162919151265879,3.6,0,3.6,0,4,0,3.2,0,3.6,0,2,1,1,3,2,1,2,3,1,2,2,2,2,1,1,3,1,1,1,2,0.5982430416161189,1.7,0,2,1,1,3,2,1,2,3,1,2,2,2,2,1,1,3,1,1,1,2,0.5982430416161189,1.7,0,I lived with my mother and father an equal amount of time (joint custody),0,"White, Caucasian, Anglo, European American",0,24,1,2,NA,1,3,6,Lawyer,3,185,64,2,5,2,0,0,0,0,0,I lived with my mother and father an equal amount of time (joint custody),0,TRUE,TRUE,TRUE,TRUE,TRUE,1,0.6261687499999534,0.568890625,0.6264968750000116,0.7336812499997905,0.6482906250000233,0.7323156249999302,1,1,1,1,1,1,0.193,0.377,0.765,0.007,1.185,69.68999271260155,1889.800778324156,0.195,0.378,0.797,0.007,1.239,92.57038129224186,1878.2864410824748,432,1.28,0,3,0,0,3,FALSE
389,2022-03-18T21:40:46Z,2022-03-18T21:57:01Z,975,1,2022-03-18T21:57:03Z,0.8999999761581421,Chrome,99.0.4844.74,Windows NT 10.0,1463,915,NA,1.5989071038251366,496,45,247,51,25,76,-0.3738375677220716,-0.402529041504795,-0.5973794258095151,-0.581289379631507,-0.736432813891596,-0.2521103918255647,2,2,1,2,2,1,1,3,1,2,2,1,2,2,2,2,2,2,3,3,0.7880689256524124,0,1,2,3,3,1.9,0,5,4,3,3,3,3,4,3,3,4,4,5,1,4,5,4,4,1,1,4,4,4,4,1,2,0,0,0,0,3,3,4,3,5,3,2,2,5,1,5,4,3,4,3,2,5,5,5,5,2,3,1,1,1,3,1,1,2,1,1,2,2,3,1,1,3,1,4,2,1,1.3868754174126179,1.0555973258234952,3.25,0,2,0,3.6,0,3.3333333333333335,0,3.6666666666666665,0,1.6666666666666667,0,1.7142857142857142,0,1.6666666666666667,0,2.72972972972973,0,1,0,0,1.2810262300521764,-0.05662557557742737,0.6122003272373745,2,1,3,1,1,1,1,3,1,1.2535663410560174,1.4285714285714286,0,2,-0.324785349076635,5,5,5,5,3,3,5,1,5,4,3,1.5735915849388864,3,4.428571428571429,0,-0.1053908767693718,0,0.470630307581482,4,4,4,2,4,2,2,2,3,2,2,2,4,3,3,3,2,2,2,1,1,3.6,0,2,0,2.6,0,2.4,0,2.3333333333333335,0,1,1,1,4,1,1,1,4,1,1,1,1,1,1,1,2,1,1,1,1,0.7863975156570492,1.35,0,1,1,1,4,1,1,1,4,1,1,1,1,1,1,1,2,1,1,1,1,0.7863975156570492,1.35,0,I lived with my mother and father an equal amount of time (joint custody),0,"Asian or Asian American (e.g., Chinese, Japanese, and others)",0,25,0,1,NA,1,4,6,Software engineer,6,190,68,4,5,2,0,0,1,0,0,I lived with my mother and father an equal amount of time (joint custody),0,TRUE,TRUE,TRUE,TRUE,TRUE,2,0.5089156249947846,0.4218218749947846,0.44425806451612904,0.530653333334128,0.4881000000025545,0.5170535714264427,1,1,1,0.9375,0.875,0.9032258064516129,0.062,0.323,0.543,0.02,1.828,94.98631228242526,1968.1009632299747,0.062,0.323,0.595,0.019,1.949,107.67275882113282,1961.6776100663026,440,1.3037037037037038,0,3,0,3,6,FALSE
390,2022-03-18T21:38:25Z,2022-03-18T22:00:51Z,1345,1,2022-03-18T22:00:52Z,0.8999999761581421,Chrome,99.0.4844.74,Windows NT 10.0,1280,720,"no, it went well",1.7777777777777777,523,134,409,56,77,100,-0.31842085422295396,0.08805416911518923,-0.00964815550877116,-0.5197268445380046,0.328434935233526,0.017472997453256978,1,1,1,1,1,1,1,1,1,1,2,1,1,1,1,1,1,1,1,1,1.5035046776746235,0,1,1,5,5,1.05,0,3,3,3,2,3,2,3,3,3,1,3,3,3,3,3,3,3,1,2,2,2,3,2,0,2,0,0,0,0,1,2,3,1,1,1,2,1,1,2,1,1,1,3,3,3,4,4,3,5,5,2,1,2,1,2,1,2,1,1,1,1,1,1,1,1,1,1,1,1,1,1.6693671815352027,0.6399404734221844,2.25,0,1,0,2.7333333333333334,0,1.4444444444444444,0,2.9166666666666665,0,1.5,0,1.1428571428571428,0,1,0,1.837837837837838,0,0,0,0,0.07552492995116833,-0.6205191861769039,-0.2724971281128678,1,1,2,1,1,1,1,3,1,1.7320508075688772,1.1428571428571428,0,2,-0.49052210323574724,5,5,5,5,3,2,5,6,6,4,4,1.7043362064926932,6,4.285714285714286,0,0.7809406510307816,0,0.933469065799339,1,1,1,3,1,5,5,5,5,3,5,5,3,5,5,5,5,5,5,4,1.869555587629877,1.4,0,5,0,4.2,0,4.8,0,4.666666666666667,0,1,2,1,2,3,1,2,2,2,2,3,2,1,2,1,2,2,2,1,1,0.8255779474818965,1.75,0,1,2,1,2,3,1,2,2,2,2,3,2,1,2,1,2,2,2,1,1,0.8255779474818965,1.75,0,I lived with my mother and father an equal amount of time (joint custody),0,"White, Caucasian, Anglo, European American",0,20,1,2,NA,1,4,4,full time student,1,140,68,4,5,2,0,0,1,0,0,I lived with my mother and father an equal amount of time (joint custody),0,TRUE,TRUE,TRUE,TRUE,TRUE,1,0.6526343749891966,0.5469548387104465,0.5921125000081956,0.7037249999940396,0.5941000000033527,0.7267906250040979,1,1,1,1,1,1,0.136,0.326,0.504,0.015,1.772,29.121094354982034,1822.2965586139344,0.139,0.319,0.493,0.016,1.86,43.22170367091414,1826.053502550967,374,1.108148148148148,0,3,0,0,3,FALSE
391,2022-03-18T21:44:59Z,2022-03-18T22:05:24Z,1224,1,2022-03-18T22:05:25Z,1,Chrome,99.0.4844.51,Windows NT 10.0,1536,864,NA,1.7777777777777777,508,79,349,75,45,88,-0.3492079172780193,-0.21511523070614935,-0.22732640376830593,-0.28578921118269573,-0.3268682949973183,-0.11731869718615386,2,2,2,1,1,1,1,3,1,1,3,1,2,1,2,2,1,1,2,2,1.0711528467275955,0,1,1,4,4,1.6,0,1,1,1,1,2,2,2,1,2,2,1,1,1,2,1,2,1,1,1,1,1,2,2,0,1,2,0,1,0,2,4,1,1,1,1,1,1,1,1,1,3,2,1,2,1,2,2,3,2,2,2,1,1,1,1,1,1,1,1,1,2,3,2,1,2,1,2,1,1,1,1.643989873053573,1.7320508075688772,1.375,0,1.25,0,1.4,0,1.4444444444444444,0,1.8333333333333333,0,1.1666666666666667,0,1.5714285714285714,0,1.3333333333333333,0,1.5405405405405406,0,0,0,0,-1.0194458378169347,-0.5343359712415323,-0.7768909045292335,1,1,2,1,1,1,1,1,1,1.7320508075688772,1.1428571428571428,0,1,-0.8770273057233877,5,5,5,4,2,2,4,6,6,NA,3,1.5118578920369088,6,3.857142857142857,0,0.41251961278270693,1,0.4766170645303738,2,2,2,2,2,3,4,5,5,3,3,2,4,3,5,1,4,4,4,3,1.2535663410560174,2,0,3.2,0,3.2,0,4.2,0,3.533333333333333,0,1,2,1,2,3,2,2,4,1,1,3,1,1,2,1,2,1,3,1,1,0.9880869341680844,1.75,0,1,2,1,2,3,2,2,4,1,1,3,1,1,2,1,2,1,3,1,1,0.9880869341680844,1.75,0,I lived with my mother and father an equal amount of time (joint custody),0,"White, Caucasian, Anglo, European American",0,18,1,3,NA,1,2,4,Student,7,130,61,1,5,2,0,0,0,0,0,I lived with my mother and father an equal amount of time (joint custody),0,TRUE,TRUE,TRUE,TRUE,TRUE,5,0.42678749999590215,0.4212000000034609,0.42399032257641517,0.5494793103501714,0.44925312500633297,0.4657516128997649,1,1,1,0.9354838709677419,1,0.96875,0.058,0.335,0.626,0.043,1.955,151.0917059381093,2008.7027813612974,0.056,0.336,0.691,0.04,2.1,167.12822470957568,2002.4635354583763,388,1.1496296296296296,0,3,0,0,3,FALSE
392,2022-03-18T21:41:47Z,2022-03-18T22:10:40Z,1733,1,2022-03-18T22:10:42Z,1,Chrome,98.0.4758.102,Windows NT 10.0,1536,864,NA,1.7777777777777777,585,213,492,126,90,111,-0.1911676602620172,0.5235156706767483,0.29147342125025194,0.3421486467710279,0.5946518725148066,0.14103205087271692,1,1,2,1,2,1,1,2,1,1,2,1,1,1,1,2,1,1,3,2,1.2396943596157715,0,1,1,3,3,1.4,0,2,3,2,3,1,1,2,2,2,2,2,2,2,2,1,2,2,3,1,2,2,3,2,3,2,0,0,0,0,1,1,1,1,1,1,1,1,1,2,1,1,1,1,2,1,3,2,1,1,1,4,2,2,1,5,2,1,3,2,1,2,3,3,2,3,1,2,2,2,2,1.6499158227686108,1.2227992865708155,2.125,0,2,0,1.9333333333333333,0,1,0,1.4166666666666667,0,2.6666666666666665,0,2.142857142857143,0,2,0,1.7027027027027026,0,2,0,0,-0.38775843219574957,0.16253517528056266,-0.11261162845759345,3,2,3,2,1,2,2,1,2,0.6900655593423543,2.142857142857143,0,1.5,-0.10369606492267476,3,4,4,3,1,2,3,7,9,NA,2,1.0690449676496976,8,2.857142857142857,0,0.43818092742900705,1,-0.04972791023064138,3,2,2,3,2,4,4,3,5,2,5,3,2,3,4,5,4,4,3,4,1.121223821162776,2.4,0,4,0,3.2,0,3.8,0,3.6666666666666665,0,1,1,2,2,3,4,2,2,2,2,3,2,1,4,2,2,2,3,2,2,0.8825799501580878,2.2,0,1,1,2,2,3,4,2,2,2,2,3,2,1,4,2,2,2,3,2,2,0.8825799501580878,2.2,0,NA,NA,"White, Caucasian, Anglo, European American",0,29,1,3,NA,1,2,4,Baker,3,316,67,1,5,2,0,0,0,0,0,NA,NA,TRUE,TRUE,TRUE,TRUE,TRUE,3,0.5832343749850989,0.5153906249701977,0.5386437500268221,0.639865625038743,0.5819258063993147,0.6417718750536442,1,1,1,1,1,1,0.144,0.364,0.79,0.011,1.196,104.60075903672163,1903.5522570144462,0.146,0.37,0.895,0.008,1.199,107.12978279774124,1888.8521558940085,382,1.1318518518518519,0,3,0,0,3,FALSE
393,2022-03-18T21:52:57Z,2022-03-18T22:14:52Z,1314,1,2022-03-18T22:14:53Z,0.8999999761581421,Firefox,98.0,Windows NT 10.0,1920,1080,"I'm curious as to why Filipino was a separate option for race/ethnicity. I've only seen it once before. I'm Filipino and sometimes I mark ""other"" and type in Filipino. I would love if someone could message me on Prolific because I'm very curious.",1.7777777777777777,535,77,338,69,54,84,-0.29379120377890167,-0.22613957251783437,-0.2672340826158873,-0.35966425329489854,-0.14256426149489335,-0.16224926206595747,4,4,2,2,4,1,2,4,3,4,3,2,4,2,4,3,2,2,3,3,0.7677718959499145,0,1,1,2,2,2.9,0,4,3,4,4,4,4,4,2,4,2,1,5,1,4,5,3,4,1,1,2,4,3,3,0,2,0,0,0,0,4,3,4,4,4,3,5,4,4,3,2,4,1,4,3,3,3,4,4,5,3,3,2,1,1,2,1,1,1,1,1,4,3,3,1,1,3,1,2,1,1,1.1021409686218524,1.1751393027860062,2.625,0,1.25,0,3.4,0,3.888888888888889,0,3.25,0,1.6666666666666667,0,2,0,1.6666666666666667,0,2.7837837837837838,0,0,0,0,0.9441197187649659,-0.5343359712415323,0.2048918737617168,2,2,3,2,1,2,2,1,2,0.9511897312113419,2,0,1.5,-0.18656444200223082,4,4,4,4,3,3,4,6,6,3,3,0.7867957924694432,6,3.7142857142857144,0,0.22259487524538815,0,0.28342129791640636,4,2,4,3,4,2,3,4,4,2,4,4,5,3,3,2,3,4,2,3,0.8997354108424374,3.4,0,3.4,0,2.8,0,3.4,0,3.2,0,2,1,1,4,2,2,3,4,3,2,3,4,4,1,1,4,1,3,2,4,1.050062654772261,2.55,0,2,1,1,4,2,2,3,4,3,2,3,4,4,1,1,4,1,3,2,4,1.050062654772261,2.55,0,I lived with my mother and father an equal amount of time (joint custody),0,"Hispanic of Latino (e.g., Mexican American, Central American, and others) & Filipino",1,27,0,1,NA,1,3,5,Unemployed (previously retail),4,185,66,1,5,2,0,0,0,0,0,I lived with my mother and father an equal amount of time (joint custody),0,TRUE,TRUE,TRUE,TRUE,TRUE,2,0.423,0.405875,0.414125,0.527125,0.488125,0.4667,1,1,1,1,1,0.9375,NA,NA,NA,NA,NA,NA,NA,NA,NA,NA,NA,NA,NA,NA,310,0.9185185185185185,0,3,0,3,6,FALSE
394,2022-03-18T21:30:39Z,2022-03-18T22:17:12Z,2792,1,2022-03-18T22:17:14Z,1,Edge,99.0.1150.39,Windows NT 10.0,1920,1080,My socioeconomic status changed at age 10. My parents were in high school when I was born. There was no family support so we were in debt until my father became a doctor. Wanted to explain why some of my answers don't line up with others.,1.7777777777777777,943,325,670,85,111,93,0.5436169113188758,1.1408788121311104,0.9372522244202052,-0.16266414099569113,1.024694617353798,-0.061155491086399345,1,2,1,1,1,1,2,2,1,1,1,1,3,1,2,2,1,1,3,2,1.2182817926554552,0,1,1,4,4,1.5,0,2,1,3,2,2,1,1,1,2,1,1,2,1,3,2,2,1,1,2,1,3,1,3,7,1,1,0,1,0,1,3,3,2,2,4,2,1,2,3,3,4,1,2,2,1,1,3,4,3,1,2,1,1,1,3,1,1,3,3,3,1,1,1,3,3,2,4,4,4,4,1.3506755066722445,1.533747356112131,1.75,0,4,0,1.6666666666666667,0,2.2222222222222223,0,2.3333333333333335,0,1.5,0,1.8571428571428572,0,2.6666666666666665,0,2.108108108108108,0,4,0,0,-0.49100556346664775,1.2903223964795156,0.39965841650643397,4,4,4,5,3,5,5,8,8,1.3801311186847085,4.285714285714286,0,8,3.6516134074403297,2,3,3,2,1,1,2,8,7,2,2,1.1126972805283737,7.5,2,0,-0.06471917927069926,0,-0.8208320376863052,2,2,2,2,2,4,4,4,4,4,5,5,4,4,4,4,5,5,4,3,1.3627702877384937,2,0,4.8,0,4,0,3.8,0,4.2,0,2,2,3,1,2,3,2,3,1,2,3,3,1,3,2,3,1,3,2,2,0.7677718959499145,2.2,0,2,2,3,1,2,3,2,3,1,2,3,3,1,3,2,3,1,3,2,2,0.7677718959499145,2.2,0,I lived with my mother and father an equal amount of time (joint custody),0,"White, Caucasian, Anglo, European American",0,27,0,1,NA,1,2,6,College Tutor,2,250,76,2,5,2,0,0,1,0,0,I lived with my mother and father an equal amount of time (joint custody),0,TRUE,TRUE,TRUE,TRUE,TRUE,5,0.5452499999962747,0.5011624999996275,0.545409375006333,0.6556612903206579,0.5481874999925495,0.6525387096789576,1,1,1,1,1,1,NA,NA,NA,NA,NA,NA,NA,NA,NA,NA,NA,NA,NA,NA,430,1.2740740740740741,0,3,0,6,9,FALSE
395,2022-03-18T21:58:10Z,2022-03-18T22:17:50Z,1179,1,2022-03-18T22:17:51Z,0.8999999761581421,Chrome,99.0.4844.51,Windows NT 10.0,1368,912,no additional feedback.,1.5,504,73,309,69,83,76,-0.3574178007593701,-0.24818825614120446,-0.3724452359413291,-0.35966425329489854,0.45130429090180935,-0.2521103918255647,2,2,2,2,3,1,1,2,1,2,3,2,2,2,2,2,2,1,2,2,0.7677718959499145,0,1,1,3,4,1.9,0,2,2,2,2,2,2,2,2,2,2,2,2,2,2,2,2,2,2,2,1,1,2,1,2,2,0,0,0,0,1,1,2,2,2,1,2,2,2,1,5,1,1,2,3,2,2,2,3,3,3,2,4,1,1,2,1,1,3,1,1,2,2,1,1,3,1,2,2,2,2,1.4379038798082324,1.0327955589886444,1.625,0,2,0,2,0,1.6666666666666667,0,2.3333333333333335,0,1.8333333333333333,0,1.5714285714285714,0,1.6666666666666667,0,1.8918918918918919,0,1,0,0,-0.49445041532030015,-0.05662557557742737,-0.27553799544886376,1,2,3,1,1,2,2,2,1,1.3801311186847085,1.7142857142857142,0,1.5,-0.3523011961613431,4,5,4,4,3,4,4,5,2,3,3,0.9511897312113419,3.5,4,0,-0.22912466020345523,0,0.16292799501975622,2,2,2,2,2,4,5,4,4,3,4,3,2,4,4,5,4,4,3,4,1.1254628677422756,2,0,3.8,0,3.6,0,4,0,3.8,0,2,1,2,3,2,2,4,2,2,2,3,2,2,2,1,2,1,3,1,4,0.910465468000326,2.15,0,2,1,2,3,2,2,4,2,2,2,3,2,2,2,1,2,1,3,1,4,0.910465468000326,2.15,0,NA,NA,"Hispanic of Latino (e.g., Mexican American, Central American, and others)",0,29,1,2,NA,1,3,6,Instructional Assistant,3,240,65,3,5,2,0,0,1,0,0,NA,NA,TRUE,TRUE,TRUE,TRUE,TRUE,2,0.6721937500238419,0.5240937501192093,0.5896968749761582,0.7109468749761582,0.5717375000715256,0.6425437500476837,1,1,1,1,1,1,NA,NA,NA,NA,NA,NA,NA,NA,NA,NA,NA,NA,NA,NA,396,1.1733333333333333,0,3,0,0,3,FALSE
396,2022-03-18T21:46:15Z,2022-03-18T22:20:43Z,2067,1,2022-03-18T22:20:43Z,0.8999999761581421,Chrome,99.0.4844.51,Macintosh,1920,1080,no,1.7777777777777777,620,82,648,291,73,96,-0.11933117980019806,-0.19857871798862178,0.8574368667250424,2.3737123048566047,0.24652203145467047,-0.027457567426546634,2,4,4,3,4,3,4,4,2,4,4,4,4,4,3,2,4,2,3,4,1.2354415362426845,0,1,2,2,1,3.4,0,4,3,5,5,5,3,5,5,4,5,5,5,1,5,5,4,4,1,1,3,5,5,5,3,2,0,0,0,0,1,3,5,5,4,3,2,1,4,5,4,5,4,4,3,1,5,5,5,5,5,4,1,1,1,1,4,1,2,3,1,4,4,5,3,2,3,4,5,2,2,1.5625112612206804,1.8073922282301278,3.5,0,3.25,0,4.333333333333333,0,3.111111111111111,0,4.25,0,2,0,2.857142857142857,0,2.6666666666666665,0,3.2162162162162162,0,2,0,0,1.9233434642503457,0.5934512499574207,1.2583973571038833,3,3,4,3,1,2,1,1,1,0.8997354108424374,2.4285714285714284,0,1,-0.13121191200738283,4,4,5,4,2,3,4,6,7,4,4,1.1338934190276817,6.5,3.7142857142857144,0,0.8712845581205503,0,0.6788316119598502,5,5,5,5,5,1,5,1,1,5,1,4,3,5,5,5,4,4,4,1,1.2649110640673518,5,0,2.8,0,4.4,0,2.6,0,3.2666666666666666,0,4,4,4,4,4,4,3,4,3,3,4,4,3,4,1,4,3,4,4,4,1.2565617248750864,3.6,0,4,4,4,4,4,4,3,4,3,3,4,4,3,4,1,4,3,4,4,4,1.2565617248750864,3.6,0,I lived with my mother and father an equal amount of time (joint custody),0,"Hispanic of Latino (e.g., Mexican American, Central American, and others)",0,26,1,2,NA,1,2,6,Pharmaceutical Customer Service Rep,2,180,61,3,5,2,1,0,1,0,1,I lived with my mother and father an equal amount of time (joint custody),0,TRUE,TRUE,TRUE,TRUE,TRUE,3,0.6077548387435174,0.5444406249970197,0.5771838709615892,0.6332806451705194,0.583313793108381,0.6264806451566758,0.96875,1,0.96875,0.96875,0.9354838709677419,0.96875,NA,NA,NA,NA,NA,NA,NA,NA,NA,NA,NA,NA,NA,NA,324,0.96,0,3,0,0,3,FALSE
397,2022-03-18T22:00:05Z,2022-03-18T22:27:41Z,1655,1,2022-03-18T22:27:41Z,0.8999999761581421,Chrome,99.0.4844.74,Windows NT 10.0,1920,1080,NA,1.7777777777777777,1008,90,319,71,51,68,0.6770275178908256,-0.15448135074188163,-0.3361655278980733,-0.3350392392574976,-0.20399893932903498,-0.3419715215851719,3,4,1,1,3,3,2,4,1,4,2,2,4,2,3,4,1,1,4,4,0.8750939799154206,0,0,5,3,3,2.65,0,5,1,2,3,1,4,4,4,1,4,1,5,1,5,5,3,5,5,2,2,5,5,4,1,2,0,0,0,0,1,5,5,4,5,2,4,2,5,2,1,5,4,3,2,1,5,5,5,5,5,5,5,5,2,2,1,1,1,1,1,1,1,1,1,1,5,1,5,1,1,1.797562580616105,1.4573295865416045,3.875,0,2,0,3.066666666666667,0,3.6666666666666665,0,3.5833333333333335,0,3.3333333333333335,0,1,0,2.3333333333333335,0,2.972972972972973,0,1,0,0,1.4273832216630677,-0.05662557557742737,0.6853788230428202,1,1,2,1,1,1,3,5,5,1.7043362064926932,1.4285714285714286,0,5,0.8347302583862863,5,5,5,5,1,1,5,3,3,5,3,2.138089935299395,3,3.857142857142857,0,0.10868681375448035,0,0.29141507095470304,3,1,3,4,3,3,4,3,3,1,1,4,2,5,2,2,3,4,1,1,1.3345232785352157,2.8,0,3,0,2,0,2.8,0,2.6,0,2,2,2,1,4,1,2,4,2,2,3,2,1,2,4,2,1,2,1,2,1.0052493799000692,2.1,0,2,2,2,1,4,1,2,4,2,2,3,2,1,2,4,2,1,2,1,2,1.0052493799000692,2.1,0,"I lived with my mother, but not father, most of the time.",0,"White, Caucasian, Anglo, European American",0,22,0,1,NA,1,1,4,NA,1,161,74,3,5,2,0,0,1,0,0,"I lived with my mother, but not father, most of the time.",0,TRUE,TRUE,TRUE,TRUE,TRUE,2,0.47891874999552964,0.4801593749988824,0.479003125006333,0.5729233333230018,0.5556033333301544,0.5935000000041106,1,1,1,0.967741935483871,0.9375,0.90625,NA,NA,NA,NA,NA,NA,NA,NA,NA,NA,NA,NA,NA,NA,304,0.9007407407407407,1,3,0,0,3,FALSE
398,2022-03-18T22:09:00Z,2022-03-18T22:31:13Z,1333,1,2022-03-18T22:31:14Z,1,Firefox,98.0,Windows NT 10.0,1920,1080,No,1.7777777777777777,527,94,356,68,53,150,-0.3102109707416032,-0.13243266711851154,-0.20193060813802688,-0.371976760313599,-0.16304248743960723,0.5791050584508022,2,2,1,1,2,1,1,3,1,2,2,1,1,1,2,3,1,1,3,3,0.8944271909999159,0,1,1,3,3,1.7,0,2,2,2,2,3,2,2,2,2,2,2,2,2,3,4,2,2,1,1,2,2,1,3,1,1,1,0,0,0,2,2,2,2,3,2,2,2,3,1,2,2,1,3,2,3,2,2,2,1,2,2,1,1,1,2,1,1,2,2,1,2,2,2,1,1,1,2,2,1,2,1.2030991012578505,0.9411239481143202,1.75,0,1.75,0,2.2666666666666666,0,2.2222222222222223,0,1.9166666666666667,0,1.3333333333333333,0,1.7142857142857142,0,1,0,1.7837837837837838,0,1,0,0,-0.3705341729274873,-0.14280879051279902,-0.25667148172014315,2,2,4,1,1,1,2,3,2,1.0690449676496976,1.8571428571428572,0,2.5,0.11707238340585353,4,4,4,4,2,2,4,3,3,2,2,1.0690449676496976,3,3.4285714285714284,0,-0.8778143430786174,0,-0.5421891128223754,2,3,3,3,2,4,4,4,4,3,3,4,3,4,4,4,4,4,3,2,0.8837151016885368,2.6,0,3.8,0,3.4,0,3.6,0,3.6,0,1,1,1,1,2,1,1,2,1,1,2,1,1,2,2,2,1,1,2,1,1.019545822516343,1.35,0,1,1,1,1,2,1,1,2,1,1,2,1,1,2,2,2,1,1,2,1,1.019545822516343,1.35,0,I lived with my mother and father an equal amount of time (joint custody),0,"Hispanic of Latino (e.g., Mexican American, Central American, and others)",0,25,0,1,NA,1,2,6,Library Assistant,2,175,71,2,5,2,0,0,1,0,0,I lived with my mother and father an equal amount of time (joint custody),0,TRUE,TRUE,TRUE,TRUE,TRUE,3,0.54809375,0.4954375,0.53434375,0.5833,0.5582,0.6335666666666666,1,1,1,0.9375,0.9375,0.9375,NA,NA,NA,NA,NA,NA,NA,NA,NA,NA,NA,NA,NA,NA,436,1.2918518518518518,0,3,0,0,3,FALSE
399,2022-03-18T21:13:42Z,2022-03-18T22:31:36Z,4673,1,2022-03-18T22:31:37Z,0.8999999761581421,Chrome,99.0.4844.51,Windows NT 6.3,1920,1080,NA,1.7777777777777777,3883,79,309,60,53,66,6.577881270111684,-0.21511523070614935,-0.3724452359413291,-0.4704768164632027,-0.16304248743960723,-0.3644368040250737,2,2,2,1,2,1,2,2,1,2,3,2,1,1,2,3,1,1,3,3,0.8255779474818965,0,1,1,4,4,1.85,0,3,3,4,4,3,3,5,3,4,3,3,4,2,3,4,2,3,4,1,3,4,3,3,2,2,0,0,0,0,3,2,3,2,4,2,2,2,3,1,2,3,2,3,3,2,4,3,3,3,4,4,3,3,2,3,2,1,3,1,1,2,2,3,1,2,2,3,2,2,2,1.0037467347431361,0.7988086367179802,2.875,0,2.25,0,3.4,0,2.5555555555555554,0,2.75,0,2.8333333333333335,0,1.8571428571428572,0,1.6666666666666667,0,2.4594594594594597,0,1,0,0,0.9116396870019575,0.029557639357944268,0.4705986631799509,3,3,4,3,3,3,2,3,4,0.4879500364742666,3,0,3.5,1.1665246025299427,4,4,5,2,1,1,3,5,4,2,2,1.5735915849388864,4.5,2.857142857142857,0,-0.6067826218093113,0,-0.6866878867434665,2,2,2,3,2,4,3,3,4,3,5,3,4,4,4,4,4,4,3,3,0.8837151016885368,2.2,0,4,0,3.4,0,3.6,0,3.6666666666666665,0,3,2,2,2,4,3,4,2,2,2,2,2,2,3,2,3,1,4,2,4,0.8750939799154206,2.55,0,3,2,2,2,4,3,4,2,2,2,2,2,2,3,2,3,1,4,2,4,0.8750939799154206,2.55,0,I lived with my mother and father an equal amount of time (joint custody),0,"White, Caucasian, Anglo, European American & Native American/Alaskan Native/indigenous",1,30,0,3,NA,1,1,5,Freelancer,2,152,68,2,5,2,0,0,0,0,0,I lived with my mother and father an equal amount of time (joint custody),0,TRUE,TRUE,TRUE,TRUE,TRUE,3,0.5257093750052154,0.5173593749962747,0.5340812499895692,0.6229633333325386,0.5841199999968211,0.6266033333142599,1,1,1,0.967741935483871,0.9375,0.9375,NA,NA,NA,NA,NA,NA,NA,NA,NA,NA,NA,NA,NA,NA,322,0.9540740740740741,0,3,0,0,3,FALSE
400,2022-03-18T22:11:09Z,2022-03-18T22:33:55Z,1365,1,2022-03-18T22:33:57Z,1,Chrome,99.0.4844.57,CrOS x86_64 14469.41.0,1366,768,No feedback,1.7786458333333333,542,85,391,134,61,91,-0.27942390768653785,-0.18204220527109422,-0.07495162998663159,0.44064870292063163,7.833201181038607e-4,-0.08362077352630115,2,3,1,1,3,1,1,3,1,2,3,1,1,1,3,3,1,1,3,3,0.6805570473787206,0,1,3,3,2,1.9,0,2,3,2,3,2,1,3,2,2,1,2,2,2,3,3,1,1,1,1,1,1,1,1,2,2,0,0,0,0,1,3,2,2,2,2,2,2,2,1,2,2,1,1,2,2,3,1,1,2,2,2,1,4,1,3,1,1,3,3,2,3,4,2,1,1,1,1,1,2,2,1.355114879387108,0.9154754164341269,1,0,1.5,0,2.2,0,2,0,1.6666666666666667,0,2,0,2.5714285714285716,0,1,0,1.9189189189189189,0,1,0,0,-0.668366221760411,-0.22899200544817064,-0.44867911360429086,2,2,3,2,1,1,2,1,1,1.0690449676496976,1.8571428571428572,0,1,-0.4626854203256071,4,4,4,4,4,4,4,5,5,NA,2,0.7559289460184544,5,4,0,-0.3749142363789111,1,0.0740616177339447,2,2,3,3,2,3,3,4,5,2,5,3,5,3,4,4,4,4,3,3,0.990430401872025,2.4,0,3.8,0,3.4,0,3.8,0,3.6666666666666665,0,1,1,1,3,1,1,3,2,1,1,2,2,2,2,2,2,1,1,1,1,0.812727700887249,1.55,0,1,1,1,3,1,1,3,2,1,1,2,2,2,2,2,2,1,1,1,1,0.812727700887249,1.55,0,I lived with my mother and father an equal amount of time (joint custody),0,"White, Caucasian, Anglo, European American",0,22,0,1,NA,1,3,3,none,7,260,66,2,5,2,0,0,1,0,0,I lived with my mother and father an equal amount of time (joint custody),0,TRUE,TRUE,TRUE,TRUE,TRUE,5,0.4917250000000058,0.45495625000003204,0.5156406250000145,0.5496896551724941,0.5511466666667412,0.5803931034482566,1,1,1,0.90625,0.9375,0.90625,NA,NA,NA,NA,NA,NA,NA,NA,NA,NA,NA,NA,NA,NA,400,1.1851851851851851,0,3,0,0,3,FALSE
401,2022-03-18T22:02:59Z,2022-03-18T22:35:13Z,1933,1,2022-03-18T22:35:13Z,1,Chrome,97.0.4692.102,CrOS x86_64 14324.80.0,1366,768,None,1.7786458333333333,647,179,657,147,92,141,-0.06391446630108043,0.33610185987810265,0.8900886039639726,0.6007112941637377,0.6356083244042343,0.478011287471244,2,3,1,1,3,1,1,4,1,2,2,1,1,4,2,3,1,1,3,4,0.9665456669582609,0,1,2,2,2,2.05,0,2,2,1,1,2,2,1,2,1,1,1,2,1,3,3,2,3,1,2,1,1,2,2,1,1,3,0,0,0,1,2,4,2,3,3,3,3,3,2,2,1,1,3,3,1,2,1,1,3,3,3,3,1,1,1,1,1,2,1,1,2,2,2,1,1,1,1,1,1,1,1.244205790071742,1.5023790657297036,1.75,0,1,0,1.6666666666666667,0,2.6666666666666665,0,1.9166666666666667,0,1.6666666666666667,0,1.5714285714285714,0,1,0,1.9189189189189189,0,1,0,0,-0.5736820079543065,-0.4013584353189139,-0.4875202216366102,2,2,3,1,1,2,2,6,1,1.0690449676496976,1.8571428571428572,0,3.5,0.503577585893494,4,5,5,5,2,2,5,6,4,NA,4,1.7182493859684491,5,4,0,0.6578900194057128,1,0.7036098684709537,1,2,2,1,1,4,3,5,5,3,5,1,4,3,4,4,4,4,3,2,1.121223821162776,1.4,0,3.6,0,3.4,0,3.8,0,3.6,0,1,1,2,1,1,3,3,4,1,1,2,2,3,1,1,3,1,2,1,2,0.9514531821875089,1.8,0,1,1,2,1,1,3,3,4,1,1,2,2,3,1,1,3,1,2,1,2,0.9514531821875089,1.8,0,"I lived with my extended family on mother's side (grandparents, aunts ,uncles, cousins)",0,Black or African American,0,19,1,2,NA,1,3,3,Retail,3,133,67,3,5,2,0,0,1,0,0,"I lived with my extended family on mother's side (grandparents, aunts ,uncles, cousins)",0,TRUE,TRUE,TRUE,TRUE,TRUE,5,0.5021468749998603,0.45552499999955764,0.4800096774197394,0.5890133333329112,0.5118612903229172,0.5563000000008614,1,1,1,0.9375,1,1,NA,NA,NA,NA,NA,NA,NA,NA,NA,NA,NA,NA,NA,NA,460,1.3629629629629632,0,3,0,0,3,FALSE
402,2022-03-18T22:01:56Z,2022-03-18T22:36:05Z,2048,1,2022-03-18T22:36:05Z,1,Opera,84.0.4316.36,Windows NT 10.0,1920,1080,NA,1.7777777777777777,1420,82,314,59,49,67,1.5226455164699537,-0.19857871798862178,-0.35430538191970123,-0.4827893234819032,-0.24495539121846277,-0.35320416280512285,3,3,1,1,3,3,2,3,2,4,4,3,1,1,3,3,3,3,3,4,0.7451598203705946,0,0,2,2,2,2.65,0,3,1,2,1,2,2,2,2,1,1,1,2,1,2,2,2,4,5,1,1,2,2,1,6,2,0,0,0,0,1,5,3,5,2,2,2,3,1,1,1,1,1,2,1,2,1,1,1,4,1,3,4,1,1,1,1,1,4,4,2,2,2,2,1,1,1,2,2,2,2,1.5156837721956706,1.486446705914413,2.25,0,2,0,1.6666666666666667,0,2.6666666666666665,0,1.4166666666666667,0,1.8333333333333333,0,2.4285714285714284,0,1,0,1.945945945945946,0,3,0,0,-0.34336905545297075,0.38169592613855263,0.01916343534279094,2,1,4,2,1,3,1,1,1,1.1547005383792515,2,0,1,-0.37981704324605103,5,5,5,5,1,1,4,5,1,2,2,1.9880595947760098,3,3.7142857142857144,0,-0.8778143430786174,0,-0.3873357159230314,5,5,5,5,5,2,3,2,2,3,5,3,2,2,4,1,4,5,3,4,1.1872336794093274,5,0,3.8,0,2.4,0,2.8,0,3,0,1,3,2,2,3,2,4,2,1,2,4,3,1,1,1,3,1,2,1,3,1.0208355710680808,2.1,0,1,3,2,2,3,2,4,2,1,2,4,3,1,1,1,3,1,2,1,3,1.0208355710680808,2.1,0,"I lived with my mother, but not father, most of the time.",0,"White, Caucasian, Anglo, European American",0,24,1,2,NA,1,2,5,Student,3,150,64,1,5,2,0,0,1,0,0,"I lived with my mother, but not father, most of the time.",0,TRUE,TRUE,TRUE,TRUE,TRUE,1,0.5010645161213413,0.517765625,0.5387124999966473,0.6248758620722541,0.6394964285684483,0.7063387096774194,1,1,1,0.90625,0.875,0.96875,NA,NA,NA,NA,NA,NA,NA,NA,NA,NA,NA,NA,NA,NA,278,0.8237037037037037,0,3,0,3,6,FALSE
403,2022-03-18T22:13:55Z,2022-03-18T22:38:30Z,1474,1,2022-03-18T22:38:30Z,0.8999999761581421,Chrome,99.0.4844.74,Windows NT 10.0,1280,720,none,1.7777777777777777,504,82,581,115,70,81,-0.3574178007593701,-0.19857871798862178,0.6143628228352286,0.2067110695653228,0.18508735362052883,-0.19594718572581019,3,4,3,3,3,1,4,4,2,4,4,3,3,3,3,4,3,2,3,4,0.9445132413883326,0,0,1,3,3,3.15,0,4,4,3,3,3,2,5,4,4,3,3,4,1,3,5,3,4,3,1,4,4,2,4,0,2,0,0,0,0,3,4,4,3,4,5,4,2,5,3,2,3,2,4,3,1,4,4,5,3,4,4,3,1,1,4,5,1,1,1,1,2,1,3,1,3,2,3,4,1,1,1.300842877595981,0.990430401872025,3.125,0,2.25,0,3.4,0,3.7777777777777777,0,3.1666666666666665,0,3,0,1.4285714285714286,0,2,0,2.864864864864865,0,0,0,0,1.1980545125484898,-0.18960311150004575,0.504225700524222,2,2,4,1,1,2,1,2,2,1.0690449676496976,1.8571428571428572,0,2,-0.07618021783796666,3,3,4,4,1,1,3,6,1,2,2,1.2535663410560174,3.5,2.7142857142857144,0,-0.7874704359888487,0,-0.8742532651115358,3,4,3,3,3,4,5,4,3,2,2,2,4,4,3,1,1,3,3,5,1.2649110640673518,3.2,0,2.4,0,3,0,3.8,0,3.066666666666667,0,2,4,4,4,4,4,4,4,4,3,4,4,2,4,1,4,1,4,4,4,1.3869694338832115,3.45,0,2,4,4,4,4,4,4,4,4,3,4,4,2,4,1,4,1,4,4,4,1.3869694338832115,3.45,0,"I lived with my mother, but not father, most of the time.",0,"White, Caucasian, Anglo, European American & Native American/Alaskan Native/indigenous",1,20,1,2,NA,1,3,3,student,3,115,63,3,5,2,0,0,0,0,0,"I lived with my mother, but not father, most of the time.",0,TRUE,TRUE,TRUE,TRUE,TRUE,1,0.4873875000048429,0.4047218750007451,0.46387812500074505,0.5596766666611036,0.4862366666595141,0.5291566666642825,1,1,1,0.9375,0.9375,0.9375,NA,NA,NA,NA,NA,NA,NA,NA,NA,NA,NA,NA,NA,NA,362,1.0725925925925925,0,3,0,0,3,FALSE
404,2022-03-18T22:12:59Z,2022-03-18T22:39:12Z,1572,1,2022-03-18T22:39:14Z,0.8999999761581421,Chrome,99.0.4844.51,Windows NT 10.0,1280,720,NA,1.7777777777777777,645,110,384,111,90,143,-0.06801940804175581,-0.04423793262503123,-0.10034742561691065,0.15746104149052095,0.5946518725148066,0.5004765699111458,2,1,2,1,2,1,2,1,1,1,2,2,2,1,2,1,2,1,1,1,1.190974832912761,0,1,3,4,4,1.45,0,1,1,1,1,1,1,1,1,1,1,1,1,1,1,1,2,1,1,1,1,1,1,1,5,2,0,0,0,0,1,1,2,1,1,1,1,1,1,1,1,1,1,1,1,1,1,1,1,1,1,1,1,2,1,1,1,1,3,3,3,1,1,1,1,1,1,2,1,3,3,1.8716311076178989,2.065591117977289,1.125,0,2.25,0,1,0,1.1111111111111112,0,1,0,1.1666666666666667,0,1.8571428571428572,0,1,0,1.2162162162162162,0,3,0,0,-1.4452295269283781,0.46787914107392425,-0.48867519292722694,1,1,3,1,1,1,1,1,1,1.5735915849388864,1.2857142857142858,0,1,-0.7941589286438315,5,5,5,5,3,3,4,6,6,NA,3,1.2909944487358056,6,4.285714285714286,0,0.41251961278270693,1,0.7088971598793893,1,1,1,3,1,5,4,2,5,2,5,5,3,4,5,5,5,5,4,5,1.6987390281365427,1.4,0,5,0,3.6,0,4.2,0,4.266666666666667,0,1,2,1,1,1,1,2,2,2,1,1,1,1,1,1,1,1,1,1,2,1.118033988749895,1.25,0,1,2,1,1,1,1,2,2,2,1,1,1,1,1,1,1,1,1,1,2,1.118033988749895,1.25,0,"I lived with my mother and father an equal amount of time (joint custody) & I lived with my extended family on mother's side (grandparents, aunts ,uncles, cousins)",1,"White, Caucasian, Anglo, European American",0,27,1,2,NA,1,2,4,Homemaker/Student,2,89,60,2,5,2,0,0,0,0,0,"I lived with my mother and father an equal amount of time (joint custody) & I lived with my extended family on mother's side (grandparents, aunts ,uncles, cousins)",1,TRUE,TRUE,TRUE,TRUE,TRUE,2,0.5675531249865889,0.5143937500119209,0.5916290322273008,0.6303096773855148,0.5657312500029802,0.6471281249895692,1,1,1,0.96875,1,1,NA,NA,NA,NA,NA,NA,NA,NA,NA,NA,NA,NA,NA,NA,382,1.1318518518518519,0,3,0,0,3,FALSE
406,2022-03-18T22:10:26Z,2022-03-18T22:45:33Z,2106,1,2022-03-18T22:45:34Z,0.8999999761581421,Chrome,99.0.4844.74,Macintosh,1440,900,NA,1.6,1127,120,490,142,69,102,0.9212715514610107,0.010883776433393964,0.28421747964160077,0.5391487590702353,0.16460912767581495,0.03993827989315878,2,2,1,1,2,1,2,3,1,2,3,2,1,2,2,3,1,2,3,3,0.7591546545162482,0,0,4,4,3,1.95,0,2,1,1,1,1,1,1,2,2,1,3,1,2,2,2,2,3,1,1,1,2,1,1,0,2,0,0,0,0,1,2,1,2,3,2,3,1,3,1,1,1,1,1,1,1,1,1,2,2,2,2,1,1,1,1,1,1,1,1,1,1,1,1,1,1,1,1,1,1,1,1.6508256192660766,1.647508942095828,1.5,0,1,0,1.5333333333333334,0,2,0,1.25,0,1.1666666666666667,0,1,0,1,0,1.3513513513513513,0,0,0,0,-0.9892295658434687,-0.6205191861769039,-0.8048743760101863,2,2,3,2,2,2,3,3,1,0.7867957924694432,2.2857142857142856,0,2,0.1724249134007015,5,5,5,5,3,3,5,6,4,4,3,1.5735915849388864,5,4.428571428571429,0,0.2559847515897029,0,0.6909076674182771,4,3,3,4,3,4,4,5,4,3,2,3,2,4,4,5,5,4,4,4,1.2535663410560174,3.4,0,3.6,0,3.6,0,4.2,0,3.8,0,1,3,2,3,2,2,3,2,1,1,4,3,2,2,1,2,1,2,2,3,0.8522416262267903,2.1,0,1,3,2,3,2,2,3,2,1,1,4,3,2,2,1,2,1,2,2,3,0.8522416262267903,2.1,0,I lived with my mother and father an equal amount of time (joint custody),0,"White, Caucasian, Anglo, European American",0,29,1,2,NA,1,2,6,RN,3,103,60,3,5,2,0,0,1,0,0,I lived with my mother and father an equal amount of time (joint custody),0,TRUE,TRUE,TRUE,TRUE,TRUE,1,0.57609062500298025,0.5275218749567866,0.5849187499955296,0.6215387096558848,0.5551965517093396,0.6256387096681902,1,1,1,0.96875,0.9354838709677419,0.96875,NA,NA,NA,NA,NA,NA,NA,NA,NA,NA,NA,NA,NA,NA,325,0.9629629629629629,0,3,0,0,3,FALSE
407,2022-03-18T22:16:52Z,2022-03-18T22:45:49Z,1736,1,2022-03-18T22:45:50Z,NA,Chrome,99.0.4844.74,Windows NT 10.0,1366,768,NA,1.7786458333333333,614,124,592,125,130,90,-0.13164600502222418,0.03293246005676404,0.6542705016828099,0.32983613975232745,1.4137809103033618,-0.09485341474625206,3,2,3,1,3,1,1,3,1,2,2,1,1,1,3,3,1,2,3,3,0.7677718959499145,0,1,1,2,3,2,0,2,3,1,2,1,1,5,3,3,2,2,3,3,3,3,3,5,5,1,1,3,2,3,5,2,0,0,0,0,2,5,5,3,5,2,5,5,5,3,2,5,1,5,1,3,4,4,4,3,3,5,4,3,3,3,4,1,3,1,1,2,2,3,3,3,3,3,3,2,1,1.2810703107718722,1.0600988273786194,2.875,0,2.25,0,2.466666666666667,0,4.111111111111111,0,3.1666666666666665,0,3.6666666666666665,0,1.8571428571428572,0,3,0,3.2162162162162162,0,3,0,0,0.8344750054801423,0.46787914107392425,0.6511770732770332,3,2,5,3,1,2,2,4,3,0.816496580927726,2.5714285714285716,0,3.5,0.9179194712912746,3,4,4,3,1,1,3,3,3,2,2,1.2535663410560174,3,2.7142857142857144,0,-0.8778143430786174,0,-0.9293226050707346,3,3,4,4,3,3,4,3,4,4,4,3,3,3,3,4,3,5,3,3,0.7745966692414834,3.4,0,3.6,0,3.6,0,3.2,0,3.466666666666667,0,1,2,1,2,2,1,2,2,1,1,4,2,2,1,1,3,1,1,1,2,0.910465468000326,1.65,0,1,2,1,2,2,1,2,2,1,1,4,2,2,1,1,3,1,1,1,2,0.910465468000326,1.65,0,"I lived with my mother, but not father, most of the time.",0,Black or African American,0,21,1,2,NA,1,2,4,Student,2,180,65,1,5,2,0,0,0,0,0,"I lived with my mother, but not father, most of the time.",0,TRUE,TRUE,TRUE,TRUE,TRUE,1,0.6812275861953867,0.5351624999940395,0.5849906249977648,0.8754115384725424,0.5881838709731255,0.6125428571317877,0.9354838709677419,1,1,0.8387096774193549,0.96875,0.875,NA,NA,NA,NA,NA,NA,NA,NA,NA,NA,NA,NA,NA,NA,446,1.3214814814814815,0,3,0,0,3,FALSE
408,2022-03-18T22:12:07Z,2022-03-18T22:49:52Z,2265,1,2022-03-18T22:49:54Z,1,Chrome,99.0.4844.74,Windows NT 10.0,1536,864,NA,1.7777777777777777,796,299,464,300,67,192,0.24190369337923534,0.997562368579205,0.1898902387291357,2.484524868024909,0.12365267578638717,1.05087598968874,1,1,1,1,1,1,1,1,1,1,1,1,1,1,1,1,1,1,1,1,1.538967528127731,0,1,2,4,4,1,0,4,2,2,2,2,3,4,4,2,3,4,3,3,4,3,2,3,1,1,3,3,3,4,0,2,0,0,0,0,1,1,4,2,5,1,4,4,3,2,1,4,4,1,4,2,4,4,4,4,4,4,1,1,1,1,1,1,1,1,1,3,3,3,1,1,3,1,1,1,1,1.4982472241738827,0.8338093878327919,2.5,0,1,0,3,0,2.7777777777777777,0,3.1666666666666665,0,1.5,0,1.8571428571428572,0,1.6666666666666667,0,2.4324324324324325,0,0,0,0,0.5611506169774885,-0.6205191861769039,-0.029684284599707733,1,1,2,1,1,1,1,3,2,1.7320508075688772,1.1428571428571428,0,2.5,-0.29726950199192703,5,5,5,5,2,2,4,5,5,3,3,1.6035674514745464,5,4,0,0.041907061065850786,0,0.32813601489735256,1,1,3,2,2,4,3,4,4,2,4,2,4,3,2,3,3,3,2,4,0.4879500364742666,1.8,0,3.2,0,2.8,0,3.4,0,3.1333333333333333,0,1,1,2,4,1,2,1,4,1,1,1,2,1,1,1,2,1,1,1,1,0.6569466853317864,1.5,0,1,1,2,4,1,2,1,4,1,1,1,2,1,1,1,2,1,1,1,1,0.6569466853317864,1.5,0,NA,NA,Black or African American,0,28,0,1,NA,1,3,5,technical support,2,175,71,3,5,2,0,0,1,0,0,NA,NA,TRUE,TRUE,TRUE,TRUE,TRUE,6,0.5109483871075414,0.46388064515975214,0.4708812499903142,0.604440625000745,0.5461593749970197,0.5472516128978422,1,1,1,1,1,0.96875,0.058,0.376,0.659,0.014,1.528,40.76391632929491,1869.802486615835,0.065,0.376,0.762,0.019,1.751,39.52296331022844,1861.2044283002913,396,1.1733333333333333,0,3,0,0,3,FALSE
409,2022-03-18T22:24:30Z,2022-03-18T22:50:35Z,1564,1,2022-03-18T22:50:37Z,0.8999999761581421,Chrome,99.0.4844.74,Windows NT 10.0,2048,1152,best of luck with your research,1.7777777777777777,684,66,401,181,63,90,0.012026955901414093,-0.2867734524821021,-0.0386719219433758,1.0193365327995534,0.04173977200753163,-0.09485341474625206,2,1,1,2,3,1,2,4,1,3,4,1,2,2,3,2,1,1,4,3,0.8506963092234007,0,1,1,2,2,2.15,0,4,2,5,3,3,3,3,2,2,2,3,2,3,3,5,3,3,1,1,2,2,2,3,2,2,0,0,0,0,2,4,3,4,2,1,4,2,3,2,4,1,1,2,3,1,4,3,2,3,3,2,1,1,1,2,2,1,2,1,1,4,4,4,1,3,3,3,2,1,1,1.2369438265459067,0.990430401872025,2.125,0,1.75,0,3,0,2.7777777777777777,0,2.4166666666666665,0,1.5,0,2.4285714285714284,0,2.3333333333333335,0,2.3513513513513513,0,1,0,0,0.3618413311590252,-0.14280879051279902,0.1095162703231131,1,2,3,2,1,2,2,5,3,1.2724180205607036,1.8571428571428572,0,4,0.6968301871373141,2,3,5,3,1,1,4,6,5,5,2,1.3972762620115438,5.5,2.7142857142857144,0,0.21613826394178245,0,-0.2625012337590145,3,4,3,4,3,3,3,3,4,4,2,3,3,3,2,1,3,3,2,4,0.8451542547285166,3.4,0,2.8,0,2.6,0,3.2,0,2.8666666666666667,0,2,2,3,2,3,3,4,4,3,1,3,4,2,3,3,4,2,3,3,3,0.8870412083230169,2.85,0,2,2,3,2,3,3,4,4,3,1,3,4,2,3,3,4,2,3,3,3,0.8870412083230169,2.85,0,I lived with my mother and father an equal amount of time (joint custody),0,"White, Caucasian, Anglo, European American & Native American/Alaskan Native/indigenous",1,27,1,2,NA,1,3,6,naturalist supervisor`,3,107,65,4,5,2,0,0,0,0,0,I lived with my mother and father an equal amount of time (joint custody),0,TRUE,TRUE,TRUE,TRUE,TRUE,6,0.5693562499987893,0.5535709677420316,0.5927531250012107,0.6036968749989755,0.6700718749999068,0.7369531250006984,1,1,1,1,1,1,0.139,0.349,0.585,0.013,1.708,177.44133919704583,1998.336591773322,0.13,0.359,0.609,0.014,1.886,192.22239388267062,1984.3363451959476,242,0.7170370370370371,0,3,0,0,3,FALSE
410,2022-03-18T22:37:06Z,2022-03-18T22:50:48Z,821,1,2022-03-18T22:50:48Z,0.800000011920929,Chrome,99.0.4844.74,Windows NT 10.0,2926,823,NA,3.555285540704739,478,36,162,37,19,45,-0.41078204338815,-0.4521385796573777,-0.9057569441771893,-0.7536644778933134,-0.8593021695598793,-0.6003222696440427,2,1,1,1,2,1,1,2,1,1,2,1,3,1,2,1,2,1,1,1,1.2732056517228265,0,0,3,3,3,1.4,0,2,1,2,1,3,2,2,2,3,1,2,2,2,2,1,1,1,2,2,2,1,1,2,2,2,0,0,0,0,2,1,1,2,2,2,2,2,1,2,1,2,2,1,1,2,1,2,1,4,3,2,1,1,1,2,1,2,3,3,2,2,2,2,2,2,2,2,2,3,2,1.3847084232492477,1.3201731488169053,1.5,0,2.25,0,1.8666666666666667,0,1.6666666666666667,0,1.8333333333333333,0,1.3333333333333333,0,2.2857142857142856,0,2,0,1.8108108108108107,0,1,0,0,-0.6427758937047072,0.029557639357944268,-0.30660912717338146,2,1,3,1,1,2,2,4,2,1.1547005383792515,1.7142857142857142,0,3,0.22745660757011754,3,4,4,3,1,1,3,3,5,3,2,1.2535663410560174,4,2.7142857142857144,0,-0.4830488383752279,0,-0.6886923679804283,4,5,4,5,5,2,1,2,2,1,2,2,2,1,1,1,3,1,2,1,1.5796322658258457,4.6,0,2,0,1.4,0,1.4,0,1.6,0,3,3,2,4,3,3,3,3,3,4,3,4,3,3,3,4,3,3,4,3,0.8645047258706176,3.2,0,3,3,2,4,3,3,3,3,3,4,3,4,3,3,3,4,3,3,4,3,0.8645047258706176,3.2,0,I lived with my mother and father an equal amount of time (joint custody),0,"Asian or Asian American (e.g., Chinese, Japanese, and others)",0,19,0,1,NA,1,3,4,student,5,142,70,2,5,2,0,0,1,0,0,I lived with my mother and father an equal amount of time (joint custody),0,TRUE,TRUE,TRUE,TRUE,TRUE,1,0.452028124999968,0.4355281250000699,0.424109375,0.5169483870967863,0.48630322580641855,0.4902548387096594,1,1,1,0.96875,1,0.96875,0.062,0.317,0.575,0.015,1.362,57.731374074421,1895.0749187466336,0.061,0.32,0.581,0.018,1.399,74.88550865467705,1900.2370965009613,406,1.202962962962963,0,3,0,0,3,FALSE
411,2022-03-18T22:28:50Z,2022-03-18T22:51:33Z,1363,1,2022-03-18T22:51:34Z,0.8999999761581421,Chrome,99.0.4844.74,Windows NT 10.0,2560,1440,NA,1.7777777777777777,522,103,421,92,51,80,-0.32047332509329163,-0.08282312896592887,0.03388749414313579,-0.07647659186478786,-0.20399893932903498,-0.2071798269457611,1,1,1,1,1,1,1,1,1,1,2,1,1,1,1,1,1,1,1,1,1.5035046776746235,0,1,1,3,3,1.05,0,1,1,1,1,1,1,2,1,2,1,1,1,2,1,2,2,2,5,2,1,1,1,1,1,2,0,0,0,0,1,2,4,2,2,1,3,2,1,1,2,1,1,4,1,2,3,3,1,3,2,1,1,1,1,1,1,1,1,1,1,1,1,1,1,1,1,1,1,1,1,1.5644319887574043,1.8464895909600492,1.875,0,1,0,1.2666666666666666,0,2,0,2,0,1,0,1,0,1,0,1.5675675675675675,0,1,0,0,-0.8474000938116631,-0.4013584353189139,-0.6243792645652886,1,1,3,1,1,1,1,2,1,1.5735915849388864,1.2857142857142858,0,1.5,-0.6009063274000113,4,5,5,5,3,3,5,3,3,3,3,1.4960264830861913,3,4.285714285714286,0,-0.3194685672932239,0,0.2627120519599011,2,1,2,2,2,4,4,4,5,3,5,5,5,5,5,4,5,5,3,4,1.61245154965971,1.8,0,4.8,0,3.8,0,4.6,0,4.4,0,1,1,1,3,1,1,1,2,1,1,1,1,1,1,1,1,1,1,1,1,0.998683343734455,1.15,0,1,1,1,3,1,1,1,2,1,1,1,1,1,1,1,1,1,1,1,1,0.998683343734455,1.15,0,I lived with my mother and father an equal amount of time (joint custody),0,"White, Caucasian, Anglo, European American",0,29,0,1,NA,1,2,6,IT support,2,185,75,2,5,2,0,0,1,0,0,I lived with my mother and father an equal amount of time (joint custody),0,TRUE,TRUE,TRUE,TRUE,TRUE,5,0.49162999999920526,0.5340343749988824,0.5243687500013039,0.5644343749955296,0.6484766666650772,0.5793281250037253,0.967741935483871,1,1,1,0.9375,1,0.085,0.378,0.601,0.03,1.704,41.21837979500289,1825.7554193388892,0.087,0.375,0.597,0.034,1.797,60.88481906039556,1846.4587415482508,304,0.9007407407407407,1,3,0,0,3,FALSE
412,2022-03-18T22:27:21Z,2022-03-18T22:55:58Z,1716,1,2022-03-18T22:55:59Z,0.8999999761581421,Chrome,99.0.4844.51,Windows NT 10.0,1920,1080,No.,1.7777777777777777,616,324,402,108,51,92,-0.12754106328154882,1.1353666412252679,-0.03504395113905022,0.12052352043441956,-0.20399893932903498,-0.07238813230635024,2,3,2,2,3,1,3,4,1,3,4,2,1,1,3,4,2,1,4,4,0.6805570473787206,0,0,3,5,4,2.5,0,4,4,5,5,5,4,4,4,5,3,3,4,3,4,5,4,5,4,2,3,4,3,3,10,2,0,0,0,0,3,5,5,5,5,3,5,5,5,4,4,3,3,4,3,3,5,4,4,3,4,5,4,3,3,5,5,3,5,4,2,5,5,5,2,4,3,2,3,3,3,1.4019505930900225,1.3870146083619754,3.5,0,2.75,0,4.133333333333334,0,4.555555555555555,0,3.6666666666666665,0,4.166666666666667,0,4.142857142857143,0,3,0,4,0,5,0,0,2.1784593500979796,1.0785670726606476,1.6285132113793135,4,4,5,3,2,4,3,4,1,1.1126972805283737,3.5714285714285716,0,2.5,1.1114929083605267,2,3,4,1,1,1,1,5,1,2,1,1.618347187425374,3,1.8571428571428572,0,-1.2220824283401586,0,-1.6037322126811024,1,1,1,1,1,5,4,5,5,4,5,5,5,4,5,5,5,5,4,5,1.804755622554715,1,0,5,0,4.4,0,4.8,0,4.733333333333333,0,2,3,4,4,4,4,4,3,3,3,3,3,4,4,2,2,2,3,2,4,0.9445132413883326,3.15,0,2,3,4,4,4,4,4,3,3,3,3,3,4,4,2,2,2,3,2,4,0.9445132413883326,3.15,0,"I lived with my mother, but not father, most of the time. & I lived with my mother and father an equal amount of time (joint custody) & I lived with my extended family on mother's side (grandparents, aunts ,uncles, cousins)",1,"White, Caucasian, Anglo, European American",0,28,1,2,NA,1,1,3,Keyholder manager,2,278,64,2,5,2,0,0,1,0,0,"I lived with my mother, but not father, most of the time. & I lived with my mother and father an equal amount of time (joint custody) & I lived with my extended family on mother's side (grandparents, aunts ,uncles, cousins)",1,TRUE,TRUE,TRUE,TRUE,TRUE,6,0.5951593749932945,0.5006656250096857,0.5837093749903143,0.6303266666571299,0.5579758620755426,0.6523500000039737,1,1,1,0.9375,0.9354838709677419,0.967741935483871,0.074,0.386,0.404,0.011,1.435,59.638368126010654,1899.6295488664932,0.075,0.388,0.438,0.012,1.527,57.891480854900685,1884.9143574412367,426,1.2622222222222224,0,3,0,0,3,FALSE
413,2022-03-18T22:28:52Z,2022-03-18T22:56:43Z,1671,1,2022-03-18T22:56:45Z,0.8999999761581421,Chrome,99.0.4844.74,Windows NT 10.0,1536,864,thank you,1.7777777777777777,499,97,685,157,78,77,-0.3676801551110585,-0.11589615440098398,0.9916717864850888,0.7238363643507423,0.3489131611782399,-0.24087775060561378,2,2,3,2,3,1,1,2,1,2,3,3,2,2,3,2,3,3,3,1,0.8207826816681233,0,1,2,2,1,2.2,0,2,2,2,2,2,2,2,3,1,1,4,2,4,2,2,2,1,1,1,1,1,2,2,0,1,2,0,2,0,1,1,1,1,1,1,4,3,1,1,1,1,1,1,1,2,1,1,4,3,2,1,1,1,1,2,1,2,1,2,1,1,3,2,1,1,2,2,2,2,2,1.7137493798501977,1.1872336794093274,1.375,0,2,0,2.2,0,1.5555555555555556,0,1.5833333333333333,0,1.1666666666666667,0,1.7142857142857142,0,1.3333333333333333,0,1.5135135135135136,0,0,0,0,-0.6816535074816419,-0.2757863264354174,-0.47871991695852967,1,1,2,1,1,2,2,1,5,1.6035674514745464,1.4285714285714286,0,3,0.06171985341100544,4,4,4,4,2,2,5,4,9,1,2,1.2909944487358056,6.5,3.5714285714285716,0,-0.4594846839740887,0,-0.2097685918302205,5,5,5,5,5,1,1,1,5,3,5,3,2,2,3,4,5,5,5,1,1.6676187756655838,5,0,3.8,0,3,0,2.4,0,3.066666666666667,0,3,1,1,2,2,2,3,2,1,1,4,3,1,2,2,3,1,2,1,2,0.8870412083230169,1.95,0,3,1,1,2,2,2,3,2,1,1,4,3,1,2,2,3,1,2,1,2,0.8870412083230169,1.95,0,"I lived with my mother and father an equal amount of time (joint custody) & I lived with my extended family on mother's side (grandparents, aunts ,uncles, cousins)",1,"Asian or Asian American (e.g., Chinese, Japanese, and others)",0,27,0,1,NA,1,2,4,i am unemployed,1,200,67,2,5,2,0,0,0,0,0,"I lived with my mother and father an equal amount of time (joint custody) & I lived with my extended family on mother's side (grandparents, aunts ,uncles, cousins)",1,TRUE,TRUE,TRUE,TRUE,TRUE,4,0.4227124999994412,0.3841812500000233,0.43276129032250854,0.5048137931033712,0.46680333333338303,0.5090580645161531,1,1,1,0.90625,0.967741935483871,0.96875,0.068,0.318,0.626,0.017,1.56,77.180655826762,1915.1134933645244,0.068,0.321,0.663,0.017,1.65,86.60596688262426,1912.780789991818,506,1.4992592592592593,0,3,0,0,3,FALSE
414,2022-03-18T22:36:38Z,2022-03-18T23:03:06Z,1588,1,2022-03-18T23:03:08Z,1,Firefox,98.0,Windows NT 10.0,1536,864,The highest education level either caregiver had was elementary school.,1.7777777777777777,719,89,387,119,65,118,0.08386343636323323,-0.15999352164772415,-0.0894635132039339,0.25596109764012465,0.0826962238969594,0.21966053941237323,2,1,1,1,2,2,1,3,1,3,3,1,1,1,3,3,2,2,3,3,0.812727700887249,0,1,2,4,4,1.95,0,2,2,2,3,2,2,2,2,2,2,1,2,1,2,3,4,2,1,1,2,1,2,2,0,2,0,0,0,0,1,1,4,2,3,2,3,3,2,1,2,1,1,4,1,3,2,1,1,1,1,2,1,1,1,3,1,1,1,3,1,2,2,2,1,3,1,1,1,1,1,1.3361456826578775,1.1126972805283737,1.875,0,1,0,2,0,2.3333333333333335,0,1.5833333333333333,0,1.5,0,1.7142857142857142,0,1.6666666666666667,0,1.7837837837837838,0,0,0,0,-0.43244308195455583,-0.6205191861769039,-0.5264811340657298,3,3,5,2,1,2,2,1,1,0.816496580927726,2.5714285714285716,0,1,-0.048343534927826504,2,3,4,2,1,1,3,9,9,2,2,1.1126972805283737,9,2.2857142857142856,0,0.20631254199860682,0,-0.5007706209093651,2,2,2,2,2,4,3,4,4,4,3,3,5,3,3,4,3,4,2,3,0.7432233529572065,2,0,3.4,0,3.6,0,3.4,0,3.466666666666667,0,3,2,2,2,1,2,2,2,2,2,1,4,3,3,1,4,2,1,2,2,0.7591546545162482,2.15,0,3,2,2,2,1,2,2,2,2,2,1,4,3,3,1,4,2,1,2,2,0.7591546545162482,2.15,0,I lived with my mother and father an equal amount of time (joint custody),0,"Hispanic of Latino (e.g., Mexican American, Central American, and others)",0,23,1,2,NA,1,3,6,Unemployed,3,120,65,2,5,2,0,0,0,0,0,I lived with my mother and father an equal amount of time (joint custody),0,TRUE,TRUE,TRUE,TRUE,TRUE,3,0.53559375,0.46719354838709676,0.5245625,0.57946875,0.54190625,0.61275,1,1,1,1,1,1,0.141,0.34,0.802,0.014,1.505,27.260211200677787,1814.1211820280027,0.143,0.339,0.811,0.014,1.516,37.453568732353986,1820.1553711971924,435,1.2888888888888888,0,3,0,0,3,FALSE
415,2022-03-18T22:44:56Z,2022-03-18T23:06:07Z,1271,1,2022-03-18T23:06:09Z,0.8999999761581421,Chrome,99.0.4844.51,Macintosh,1280,800,Thank you!,1.6,537,87,319,116,49,99,-0.2896862620382263,-0.17101786345940917,-0.3361655278980733,0.21902357658402327,-0.24495539121846277,0.006240356233306075,2,1,2,1,2,2,4,2,2,2,4,2,1,3,2,2,3,1,3,3,0.9403246919632545,0,1,4,4,4,2.2,0,1,1,1,2,1,1,1,1,1,1,1,1,1,1,3,1,1,1,1,1,1,1,1,3,2,0,0,0,0,2,1,1,1,1,1,2,1,1,2,1,1,1,1,2,5,2,1,1,2,3,1,1,1,1,1,1,1,2,2,1,1,1,1,1,1,1,1,1,1,1,1.772326477018594,1.9148542155126762,1,0,1,0,1.2,0,1.2222222222222223,0,1.8333333333333333,0,1,0,1.2857142857142858,0,1,0,1.3783783783783783,0,2,0,0,-1.3415886983027772,-0.18219768446092388,-0.7618931913818505,1,1,1,1,1,1,3,1,1,1.9023794624226837,1.2857142857142858,0,1,-0.7941589286438315,4,5,5,5,5,5,5,8,8,6,4,1.4960264830861913,8,4.857142857142857,0,1.5704716604375606,0,1.7244363337786388,2,2,2,2,2,4,5,4,5,4,5,4,5,4,4,4,4,5,4,3,1.424279266355945,2,0,4.4,0,4.4,0,4,0,4.266666666666667,0,2,2,1,4,3,2,2,3,3,2,2,4,2,3,1,3,1,3,1,2,0.7181848464596079,2.3,0,2,2,1,4,3,2,2,3,3,2,2,4,2,3,1,3,1,3,1,2,0.7181848464596079,2.3,0,I lived with my mother and father an equal amount of time (joint custody),0,Native American/Alaskan Native/indigenous,0,24,0,1,NA,1,4,6,Health management office worker/Masters student.,6,172,71,3,5,2,0,0,1,0,0,I lived with my mother and father an equal amount of time (joint custody),0,TRUE,TRUE,TRUE,TRUE,TRUE,2,0.6151718750004657,0.5773656250000931,0.6358354838716407,0.663906249998603,0.6390593749997207,0.7024656249992549,1,1,1,1,1,1,0.157,0.421,0.739,0.025,1.777,24.700883573054313,1819.3288723054802,0.152,0.436,0.771,0.025,1.846,33.97320035242262,1817.5206667101952,469,1.3896296296296295,0,3,0,0,3,FALSE
416,2022-03-18T22:38:03Z,2022-03-18T23:06:21Z,1697,1,2022-03-18T23:06:23Z,0.8999999761581421,Chrome,99.0.4844.74,Windows NT 10.0,2560,1440,N/A,1.7777777777777777,547,150,541,111,99,105,-0.2691615533348494,0.17624890360866954,0.46924399066220535,0.15746104149052095,0.7789559060172315,0.0736362035530115,2,2,2,2,2,1,3,2,2,2,2,2,1,2,2,2,2,1,2,2,0.7539370349250519,0,1,2,3,2,1.9,0,4,2,4,2,3,3,3,3,2,2,2,2,2,3,3,3,2,4,1,2,2,3,2,0,1,0,0,0,0,3,2,5,2,2,2,2,2,2,3,2,2,1,3,2,5,3,2,2,2,2,2,1,1,1,3,2,1,1,1,1,1,2,2,1,2,1,2,2,1,1,1.2550199500705457,0.7988086367179802,2.375,0,1.5,0,2.6666666666666665,0,2.4444444444444446,0,2.4166666666666665,0,1.6666666666666667,0,1.2857142857142858,0,1.3333333333333333,0,2,0,0,0,0,0.1718823575147611,-0.44815275630616064,-0.13813519939569976,4,3,4,2,2,3,3,3,1,0.5345224838248488,3,0,2,0.5867667987984821,4,3,4,3,2,2,3,3,3,2,1,0.816496580927726,3,3,0,-1.2220824283401586,0,-0.98431862508372725,2,3,2,2,3,4,4,4,4,2,3,4,4,4,4,4,4,4,4,2,1,2.4,0,3.8,0,3.6,0,3.6,0,3.6666666666666665,0,2,2,1,2,3,1,2,2,1,1,2,2,2,1,1,2,2,2,1,1,0.812727700887249,1.65,0,2,2,1,2,3,1,2,2,1,1,2,2,2,1,1,2,2,2,1,1,0.812727700887249,1.65,0,"I lived with my mother, but not father, most of the time. & I lived with my mother and father an equal amount of time (joint custody) & I lived with my extended family on mother's side (grandparents, aunts ,uncles, cousins)",1,"White, Caucasian, Anglo, European American",0,20,0,1,NA,1,2,5,Data Management,2,155,69,3,5,2,0,0,2,0,0,"I lived with my mother, but not father, most of the time. & I lived with my mother and father an equal amount of time (joint custody) & I lived with my extended family on mother's side (grandparents, aunts ,uncles, cousins)",1,TRUE,TRUE,TRUE,TRUE,TRUE,3,0.48295483871044653,0.40847187500167637,0.45374062500242146,0.5653172413788993,0.48873571428975887,0.5595900000025829,0.96875,1,1,0.90625,0.875,0.9375,0.067,0.359,0.748,0.014,1.748,72.08713141572655,1951.4741226902845,0.07,0.359,0.8,0.014,1.733,82.62653503024879,1929.8695993073636,362,1.0725925925925925,0,0,0,3,6,FALSE
417,2022-03-18T22:49:15Z,2022-03-18T23:10:22Z,1267,1,2022-03-18T23:10:23Z,1,Firefox,98.0,Windows NT 10.0,1280,720,NA,1.7777777777777777,572,92,327,73,49,94,-0.21784978157640716,-0.14345700893019658,-0.30714176146346867,-0.3104142252200967,-0.24495539121846277,-0.04992284986644844,2,3,2,1,3,2,3,4,1,3,4,3,1,3,4,3,4,1,4,4,0.9333020044867296,1,1,2,2,1,2.75,0,4,5,5,4,5,2,4,2,2,2,4,3,3,3,4,1,4,1,3,1,3,2,3,1,1,1,0,1,0,2,5,5,4,5,3,4,4,4,4,2,1,1,2,3,2,5,1,3,5,3,4,4,1,1,2,2,4,2,1,1,2,1,1,4,4,2,1,1,1,1,1.346221494521727,1.1751393027860062,2.25,0,1,0,3.466666666666667,0,4,0,2.6666666666666665,0,2.3333333333333335,0,1.7142857142857142,0,3.3333333333333335,0,2.810810810810811,0,1,0,0,0.8211877197589114,-0.4013584353189139,0.20991464221999873,3,3,4,3,1,2,1,1,1,0.8997354108424374,2.4285714285714284,0,1,-0.13121191200738283,4,4,3,3,1,1,1,1,4,1,1,1.5275252316519468,2.5,2.4285714285714284,0,-1.5265040259537794,0,-1.4795863160135223,2,2,2,5,4,4,5,5,5,4,3,5,3,4,5,5,5,4,5,5,1.6846647257229665,3,0,4.2,0,4.4,0,4.8,0,4.466666666666667,0,3,1,2,3,2,2,2,3,1,1,3,3,2,3,1,3,3,2,3,3,0.7181848464596079,2.3,0,3,1,2,3,2,2,2,3,1,1,3,3,2,3,1,3,3,2,3,3,0.7181848464596079,2.3,0,I lived with my mother and father an equal amount of time (joint custody),0,"Hispanic of Latino (e.g., Mexican American, Central American, and others) & White, Caucasian, Anglo, European American",1,23,1,2,NA,1,2,6,student,2,160,64,2,5,2,0,0,1,0,0,I lived with my mother and father an equal amount of time (joint custody),0,TRUE,TRUE,TRUE,TRUE,TRUE,1,0.76903125,0.5841612903225807,0.56796875,0.9158620689655173,0.617875,0.6635,1,1,1,0.9354838709677419,1,1,0.081,0.385,0.435,0.022,1.665,60.555336888194404,1855.2739082302496,0.084,0.385,0.432,0.021,1.803,76.33959182931969,1863.0205899947302,356,1.0548148148148149,0,3,0,0,3,FALSE
418,2022-03-18T22:48:46Z,2022-03-18T23:13:48Z,1501,1,2022-03-18T23:13:49Z,0.8999999761581421,Chrome,99.0.4844.74,Windows NT 10.0,1536,864,I have no feedback or comments about the survey.,1.7777777777777777,592,114,470,107,34,97,-0.17680036416965336,-0.022189249001661155,0.2116580635550892,0.10821101341571909,-0.552128780389171,-0.01622492620659573,2,2,1,1,3,1,1,2,1,2,2,1,1,1,2,2,1,1,2,2,0.998683343734455,0,1,1,4,4,1.55,0,2,1,1,2,1,1,1,1,1,1,1,1,2,2,2,1,1,1,1,1,1,1,1,0,2,0,0,0,0,2,3,2,1,2,1,3,3,2,1,1,1,1,2,1,1,1,1,1,1,1,1,1,1,1,2,1,1,1,1,1,1,1,1,1,1,1,2,1,1,2,1.6398747480186373,1.7593288763724921,1,0,1.5,0,1.3333333333333333,0,2.111111111111111,0,1.0833333333333333,0,1.1666666666666667,0,1,0,1,0,1.3243243243243243,0,0,0,0,-1.306943331088901,-0.44815275630616064,-0.8775480436975308,1,1,2,1,1,1,1,1,1,1.7320508075688772,1.1428571428571428,0,1,-0.8770273057233877,5,5,5,4,3,3,4,3,3,2,3,1.2149857925879117,3,4.142857142857143,0,-0.5335462578170761,0,0.054793796338320766,1,2,2,1,2,4,3,3,5,3,5,4,4,4,3,4,4,4,3,3,0.9759000729485332,1.6,0,4.2,0,3.4,0,3.6,0,3.7333333333333334,0,1,1,1,1,1,1,1,1,1,1,1,1,1,1,1,1,1,1,1,1,1.231174022502185,1,0,1,1,1,1,1,1,1,1,1,1,1,1,1,1,1,1,1,1,1,1,1.231174022502185,1,0,I lived with my mother and father an equal amount of time (joint custody),0,"White, Caucasian, Anglo, European American",0,26,0,1,NA,1,3,3,Retail store management,2,230,74,3,5,2,0,0,1,0,0,I lived with my mother and father an equal amount of time (joint custody),0,TRUE,TRUE,TRUE,TRUE,TRUE,2,0.5720937500037253,0.5597593749947846,0.5181749999895692,0.6834312499910593,0.6322806451551376,0.641212500013411,1,1,1,1,1,1,0.103,0.364,0.652,0.015,1.859,63.430462605212554,1868.900790474362,0.112,0.369,0.781,0.016,1.955,63.34990334462208,1843.1253415778506,390,1.1555555555555557,0,3,0,0,3,FALSE
419,2022-03-18T22:55:18Z,2022-03-18T23:18:06Z,1367,1,2022-03-18T23:18:06Z,1,Chrome,98.0.4758.107,CrOS x86_64 14388.61.0,1200,800,NA,1.5,535,96,352,128,69,142,-0.29379120377890167,-0.1214083253068265,-0.2164424913553292,0.3667736608084288,0.16460912767581495,0.48924392869119493,2,2,1,1,2,1,1,3,1,2,2,1,1,1,2,3,1,1,3,2,0.9333020044867296,0,1,1,4,4,1.65,0,1,1,1,1,1,1,1,1,1,1,1,1,2,1,1,1,1,1,1,1,1,1,1,0,2,0,0,0,0,1,3,4,2,2,1,3,1,1,1,1,1,1,2,1,1,2,1,1,1,1,2,1,1,1,1,1,1,1,1,1,2,1,1,1,1,1,1,1,1,1,1.635290241570032,2.016597794967223,1,0,1,0,1.0666666666666667,0,2,0,1.1666666666666667,0,1.1666666666666667,0,1.1428571428571428,0,1,0,1.3513513513513513,0,0,0,0,-1.4116668274399355,-0.6205191861769039,-1.0160930068084197,1,1,2,2,1,1,2,3,2,1.6035674514745464,1.4285714285714286,0,2.5,-0.13153274783281477,5,5,5,5,4,4,5,7,7,5,3,1.4638501094227998,7,4.714285714285714,0,0.8314380704726299,0,1.1965299813263246,2,2,1,1,2,4,4,4,4,5,5,5,5,5,5,3,4,4,3,2,1.4735767952260144,1.6,0,4.4,0,4,0,4,0,4.133333333333334,0,1,1,1,1,1,1,1,1,1,1,1,1,1,2,2,1,2,2,1,1,1.1964860832322377,1.2,0,1,1,1,1,1,1,1,1,1,1,1,1,1,2,2,1,2,2,1,1,1.1964860832322377,1.2,0,I lived with my mother and father an equal amount of time (joint custody),0,"White, Caucasian, Anglo, European American",0,25,0,1,NA,1,3,6,Corporate Wellness Performance Coach,3,197,75,5,5,2,0,0,1,0,0,I lived with my mother and father an equal amount of time (joint custody),0,TRUE,TRUE,TRUE,TRUE,TRUE,4,0.49263749999948775,0.4727187499993015,0.48409687500074505,0.6289833333333333,0.5608354838706794,0.6229655172411224,1,1,1,0.9375,0.96875,0.90625,0.068,0.375,0.462,0.008,1.339,254.5737603611794,2208.450764670754,0.067,0.376,0.609,0.007,1.446,202.44683169891877,2095.481843610152,404,1.1970370370370371,0,3,0,0,3,FALSE
421,2022-03-18T23:09:53Z,2022-03-18T23:28:39Z,1126,1,2022-03-18T23:28:40Z,0.8999999761581421,Chrome,99.0.4844.74,Windows NT 10.0,1536,864,NA,1.7777777777777777,543,72,264,51,41,69,-0.2773714368162002,-0.253700427047047,-0.5357039221359802,-0.581289379631507,-0.40878119877617386,-0.33073888036522103,3,4,4,4,3,3,4,4,3,3,3,3,3,2,4,4,3,2,3,4,1.0310954828418375,0,1,1,1,1,3.3,0,2,2,5,3,2,2,5,3,2,1,1,5,3,4,3,2,3,1,1,1,4,2,3,0,2,0,0,0,0,1,5,2,2,3,3,5,3,2,1,2,2,1,3,2,1,5,2,2,2,2,4,1,1,1,1,1,1,1,1,1,5,5,5,2,4,3,1,1,1,1,1.4632638658632766,1.245945806357946,2.125,0,1,0,2.8666666666666667,0,2.888888888888889,0,2.0833333333333335,0,1.5,0,2.7142857142857144,0,3,0,2.3783783783783785,0,0,0,0,0.31538504330405503,-0.6205191861769039,-0.15256707143642445,3,3,5,2,2,3,2,4,1,0.7559289460184544,2.857142857142857,0,2.5,0.6971510229627462,2,2,2,2,1,1,2,3,3,1,1,1,3,1.7142857142857142,0,-1.4361601188640107,0,-1.811650468302683,1,1,1,1,1,5,5,5,5,2,2,5,5,5,5,4,5,4,5,3,1.7674302033770737,1,0,4.2,0,4.2,0,4.6,0,4.333333333333333,0,2,4,4,3,2,4,4,4,4,4,4,3,3,3,2,4,2,3,2,3,1.0563093645728086,3.2,0,2,4,4,3,2,4,4,4,4,4,4,3,3,3,2,4,2,3,2,3,1.0563093645728086,3.2,0,"I lived with my extended family on father's side (grandparents, aunts ,uncles, cousins)",0,"White, Caucasian, Anglo, European American",0,27,0,3,NA,1,1,6,unemployed,1,170,68,2,5,2,0,0,1,0,0,"I lived with my extended family on father's side (grandparents, aunts ,uncles, cousins)",0,TRUE,TRUE,TRUE,TRUE,TRUE,5,0.5673656249999695,0.47267812499999856,0.5092093750000131,0.6377937499999825,0.5549656249999898,0.5811968750000015,1,1,1,1,1,1,0.1,0.33,0.554,0.002,0.558,44.056082965005345,1827.8731065797367,0.1,0.33,0.561,0.002,0.564,59.624806452568905,1842.5800325539583,387,1.1466666666666667,0,3,0,0,3,FALSE
422,2022-03-18T23:12:12Z,2022-03-18T23:31:35Z,1162,1,2022-03-18T23:31:36Z,1,Firefox,97.0,Windows NT 10.0,1920,1080,NA,1.7777777777777777,471,78,279,111,68,102,-0.4251493394805138,-0.22062740161199185,-0.4812843600710965,0.15746104149052095,0.14413090173110105,0.03993827989315878,2,2,2,2,2,1,2,2,1,2,2,2,2,2,2,2,2,2,2,3,0.6708203932499369,0,1,3,3,3,1.95,0,2,3,3,2,3,2,4,2,1,1,2,2,3,3,2,2,3,1,1,1,3,2,2,1,2,0,0,0,0,1,1,1,2,2,2,2,2,2,2,2,2,1,2,3,2,3,3,3,3,3,4,2,1,1,2,1,1,1,1,1,1,1,2,1,1,1,2,2,1,1,1.4379038798082324,1.0327955589886444,1.875,0,1.5,0,2.3333333333333335,0,1.6666666666666667,0,2.4166666666666665,0,1.8333333333333333,0,1.1428571428571428,0,1,0,1.7837837837837838,0,1,0,0,-0.2867750607143947,-0.22899200544817064,-0.25788353308128265,2,2,3,1,2,2,2,3,1,0.9511897312113419,2,0,2,0.0066881592415893995,4,4,4,4,2,2,3,3,2,3,2,0.9511897312113419,2.5,3.2857142857142856,0,-0.7540805596445339,0,-0.5441935940593372,2,3,3,2,3,3,3,3,4,3,3,4,4,4,3,3,4,4,3,3,0.6546536707079771,2.6,0,3.6,0,3.2,0,3.4,0,3.4,0,3,2,2,1,3,2,2,2,1,2,2,2,2,2,3,2,1,2,2,3,0.7451598203705946,2.05,0,3,2,2,1,3,2,2,2,1,2,2,2,2,2,3,2,1,2,2,3,0.7451598203705946,2.05,0,I lived with my mother and father an equal amount of time (joint custody),0,"White, Caucasian, Anglo, European American",0,18,0,1,NA,1,3,5,student,2,180,74,3,5,2,0,0,2,0,0,I lived with my mother and father an equal amount of time (joint custody),0,TRUE,TRUE,TRUE,TRUE,TRUE,4,0.576125,0.56984375,0.5881724137931035,0.6496774193548387,0.6637037037037037,0.775,1,1,0.9666666666666667,0.96875,0.8709677419354839,0.9375,0.064,0.405,0.345,0.018,1.65,194.56196674441057,2267.1634878108653,0.064,0.405,0.298,0.018,1.757,225.96507691771464,2118.3789223154913,476,1.4103703703703703,0,3,0,0,3,FALSE
424,2022-03-18T23:23:10Z,2022-03-18T23:40:36Z,1045,1,2022-03-18T23:40:39Z,0.8999999761581421,Chrome,99.0.4844.51,Macintosh,1440,900,NA,1.6,487,67,263,57,41,84,-0.3923098055551108,-0.28126128157625957,-0.5393318929403058,-0.5074143375193041,-0.40878119877617386,-0.16224926206595747,2,2,1,1,2,1,1,2,1,2,3,1,1,1,2,2,1,1,2,2,0.998683343734455,0,0,3,2,2,1.55,0,4,2,2,3,2,3,4,4,3,3,3,5,1,4,2,3,5,1,1,3,4,4,4,1,2,0,0,0,0,2,4,3,2,2,3,3,3,4,3,3,5,4,3,4,1,4,4,4,4,4,4,4,1,2,2,1,1,3,3,1,3,3,2,3,2,4,2,2,2,2,1.092562901481509,0.9856107606091623,3.125,0,2,0,3,0,2.888888888888889,0,3.5833333333333335,0,2.3333333333333335,0,2.2857142857142856,0,3,0,2.918918918918919,0,1,0,0,1.0468747283424853,-0.05662557557742737,0.49512457638252894,1,2,3,1,1,3,1,3,3,1.4960264830861913,1.7142857142857142,0,3,0.22745660757011754,5,5,5,5,2,2,4,6,9,NA,3,1.6035674514745464,7.5,4,0,0.819067194686666,1,0.8018557927964401,3,3,3,3,3,3,5,4,3,3,4,3,3,3,5,3,4,2,4,5,1.082325538564332,3,0,3.2,0,3.6,0,4,0,3.6,0,2,3,2,2,3,4,3,3,2,3,4,3,2,3,2,3,3,3,2,2,0.6805570473787206,2.7,0,2,3,2,2,3,4,3,3,2,3,4,3,2,3,2,3,3,3,2,2,0.6805570473787206,2.7,0,"I lived with my mother, but not father, most of the time.",0,"White, Caucasian, Anglo, European American",0,20,1,3,NA,1,2,4,student,1,180,64,1,5,2,0,0,1,0,0,"I lived with my mother, but not father, most of the time.",0,TRUE,TRUE,TRUE,TRUE,TRUE,2,0.5667258064516129,0.5019064515982905,0.5378806451712885,0.647235483865584,0.6226999999960263,0.6618633333444596,1,0.96875,1,0.96875,0.967741935483871,0.9375,0.072,0.402,0.533,0.009,1.373,46.70047802159589,1907.1189403528551,0.072,0.402,0.582,0.008,1.414,56.77726777534214,1901.0102201847146,432,1.28,0,3,0,0,3,FALSE
425,2022-03-18T23:28:22Z,2022-03-18T23:47:34Z,1151,1,2022-03-18T23:47:36Z,0.8999999761581421,Chrome,99.0.4844.51,Macintosh,1440,900,None,1.6,548,78,272,67,38,75,-0.2671090824645117,-0.22062740161199185,-0.5066801557013756,-0.38428926733229946,-0.4702158766103155,-0.2633430330455156,3,3,3,3,3,2,2,4,1,3,4,2,3,3,4,4,2,3,4,4,0.7880689256524124,0,1,1,3,3,3,0,4,3,3,4,3,3,4,3,4,3,3,5,3,4,5,3,3,1,1,4,4,3,3,0,2,0,0,0,0,2,5,5,5,5,4,5,5,5,2,4,2,1,4,3,4,5,3,3,4,2,5,1,1,1,2,1,1,1,1,1,4,4,3,1,3,1,3,3,2,2,1.109608593708264,0.8338093878327919,2.75,0,2.5,0,3.6,0,4.555555555555555,0,3.0833333333333335,0,1.8333333333333333,0,2.142857142857143,0,1.6666666666666667,0,2.945945945945946,0,0,0,0,1.1570115633206883,-0.10341989656467412,0.5267958333780071,3,2,5,2,2,1,1,2,1,0.7559289460184544,2.2857142857142856,0,1.5,-0.020827687843118697,3,3,3,2,2,2,3,4,4,3,2,0.5345224838248488,4,2.5714285714285716,0,-0.4830488383752279,0,-0.7661190664301002,2,2,3,3,2,3,4,4,5,2,5,4,4,3,4,3,3,4,3,5,1.0600988273786194,2.4,0,3.8,0,3.2,0,4.2,0,3.7333333333333334,0,3,3,3,4,3,3,2,2,3,3,3,3,3,3,2,3,2,3,4,3,0.6569466853317864,2.9,0,3,3,3,4,3,3,2,2,3,3,3,3,3,3,2,3,2,3,4,3,0.6569466853317864,2.9,0,I lived with my mother and father an equal amount of time (joint custody),0,"White, Caucasian, Anglo, European American",0,21,1,2,NA,1,2,3,Cashier,1,250,67,2,5,2,0,0,3,0,0,I lived with my mother and father an equal amount of time (joint custody),0,TRUE,TRUE,TRUE,TRUE,TRUE,4,0.4744187500048429,0.4436838709673574,0.46875624999962745,0.55819285714307,0.5176896551724138,0.5760699999998014,1,0.96875,1,0.875,0.90625,0.9375,0.062,0.364,0.604,0.01,1.389,51.46303425151515,1929.506826388791,0.063,0.364,0.628,0.011,1.464,66.03976974331098,1915.9515803347183,438,1.2977777777777777,0,3,0,0,3,FALSE
426,2022-03-18T23:37:19Z,2022-03-18T23:56:22Z,1143,1,2022-03-18T23:56:24Z,1,Firefox,98.0,Windows NT 10.0,1920,1080,NA,1.7777777777777777,489,89,318,73,46,68,-0.3882048638144354,-0.15999352164772415,-0.3397934987023989,-0.3104142252200967,-0.3063900690526044,-0.3419715215851719,2,2,1,1,2,1,1,3,1,2,3,1,2,1,1,1,1,1,2,1,1.1652874052533586,1,1,2,3,2,1.5,0,4,3,1,4,1,2,2,3,3,1,3,3,1,4,5,4,4,5,3,4,4,3,3,3,1,1,0,0,0,5,3,4,4,4,2,3,3,3,1,4,1,4,4,3,2,5,4,2,2,3,4,1,3,3,2,5,2,4,3,1,3,3,2,2,1,1,4,4,2,2,1.1203817453240013,0.990430401872025,3.75,0,3,0,2.6666666666666665,0,3.4444444444444446,0,2.9166666666666665,0,3,0,2.5714285714285716,0,1.3333333333333333,0,2.864864864864865,0,2,0,0,1.1507124056454376,0.5072680350220491,0.8289902203337434,1,1,3,1,1,1,1,1,1,1.5735915849388864,1.2857142857142858,0,1,-0.7941589286438315,3,3,3,2,1,1,3,2,3,1,2,0.9511897312113419,2.5,2.2857142857142856,0,-1.1822359406922383,0,-1.347163597550858,4,5,4,1,3,2,2,3,2,3,4,2,5,4,4,1,3,1,3,2,1.162919151265879,3.4,0,2.4,0,2.8,0,3,0,2.7333333333333334,0,1,3,1,3,3,2,3,3,1,1,3,2,2,2,1,2,1,2,2,1,0.8255779474818965,1.95,0,1,3,1,3,3,2,3,3,1,1,3,2,2,2,1,2,1,2,2,1,0.8255779474818965,1.95,0,"I lived with my mother, but not father, most of the time. & I lived with my father, but not mother, most of the time. & I lived with my mother and father an equal amount of time (joint custody)",1,"White, Caucasian, Anglo, European American",0,19,0,3,NA,1,2,3,Unemployed - seeking work,1,145,71,1,5,2,0,0,1,0,0,"I lived with my mother, but not father, most of the time. & I lived with my father, but not mother, most of the time. & I lived with my mother and father an equal amount of time (joint custody)",1,TRUE,TRUE,TRUE,TRUE,TRUE,6,0.5420344827586207,0.45503225806451614,0.4549375,0.5166451612903226,0.4983548387096774,0.5686129032258065,0.90625,1,1,1,0.96875,0.96875,0.066,0.342,0.483,0.017,1.563,60.00465156624069,1901.3605174545178,0.066,0.343,0.51,0.017,1.622,83.04346764019034,1904.1240790418465,304,0.9007407407407407,1,3,0,0,3,FALSE
427,2022-03-18T23:18:01Z,2022-03-18T23:59:34Z,2492,1,2022-03-18T23:59:36Z,0.8999999761581421,Chrome,99.0.4844.51,Windows NT 10.0,1536,864,NA,1.7777777777777777,620,187,1029,209,133,238,-0.11933117980019806,0.3801992271248428,2.2396937431730883,1.3640867293231664,1.4752155881375035,1.5675774858064815,4,3,2,1,3,1,1,3,1,4,3,3,1,1,4,3,1,1,3,3,0.6069769786668839,0,0,1,3,2,2.3,0,3,4,3,4,4,2,5,3,3,2,2,5,2,4,5,2,1,1,1,1,3,2,3,2,1,1,0,1,0,3,4,5,3,3,3,4,3,4,2,3,4,1,4,3,3,4,3,4,5,3,4,1,3,3,3,1,2,2,2,2,3,3,3,1,1,1,1,2,2,2,0.9894336657800659,0.8618916073713346,1.75,0,1.75,0,3.4,0,3.5555555555555554,0,3.25,0,2.5,0,2.4285714285714284,0,1,0,2.864864864864865,0,1,0,0,0.597173924932826,-0.14280879051279902,0.22718256721001345,3,2,4,3,1,3,3,2,1,0.7867957924694432,2.7142857142857144,0,1.5,0.22777744339554973,3,3,3,2,1,1,3,4,9,NA,6,0.9511897312113419,6.5,2.2857142857142856,0,2.097241857094296,1,0.6518497676282946,3,3,3,3,3,3,3,3,3,2,3,2,3,2,1,3,5,4,1,5,1.0600988273786194,3,0,3.4,0,2.4,0,2.8,0,2.8666666666666667,0,2,1,3,4,4,3,2,3,4,2,1,3,1,3,2,3,1,3,3,2,0.9514531821875089,2.5,0,2,1,3,4,4,3,2,3,4,2,1,3,1,3,2,3,1,3,3,2,0.9514531821875089,2.5,0,"I lived with my extended family on mother's side (grandparents, aunts ,uncles, cousins)",0,"Hispanic of Latino (e.g., Mexican American, Central American, and others) & Filipino",1,27,1,2,NA,1,3,6,Customer Representative,3,115,60,2,5,2,0,0,1,0,0,"I lived with my extended family on mother's side (grandparents, aunts ,uncles, cousins)",0,TRUE,TRUE,TRUE,TRUE,TRUE,2,0.4945562500059605,0.41629374998435376,0.45082812499254943,0.538931250013411,0.4656566666563352,0.5060193548356333,1,1,1,1,0.967741935483871,0.96875,0.056,0.346,0.594,0.021,1.711,188.3906263198125,2043.6176404132761,0.057,0.346,0.661,0.022,1.816,209.24201009710836,2043.6952801926916,388,1.1496296296296296,0,3,0,0,3,FALSE
429,2022-03-18T23:29:47Z,2022-03-19T00:03:18Z,2011,1,2022-03-19T00:03:19Z,0.8999999761581421,Chrome,99.0.4844.51,Windows NT 10.0,1366,768,No.,1.7786458333333333,571,125,759,190,115,118,-0.21990225244674486,0.038444630962606564,1.2601416260051816,1.1301490959678577,1.1066075211326536,0.21966053941237323,2,2,1,1,2,1,1,3,1,2,2,1,1,1,2,2,1,1,2,2,0.998683343734455,0,1,1,4,3,1.55,0,2,2,2,2,1,1,2,2,2,1,1,3,2,3,2,2,4,1,1,1,3,1,1,10,2,0,0,0,0,1,2,2,3,2,1,2,2,2,2,2,2,1,3,2,1,1,3,4,4,3,4,2,3,1,4,1,1,5,2,1,2,1,1,1,3,2,2,1,3,1,1.3847084232492477,1.245945806357946,1.75,0,1.75,0,1.8666666666666667,0,1.8888888888888888,0,2.3333333333333335,0,2.5,0,1.8571428571428572,0,2,0,2.135135135135135,0,5,0,0,-0.3917938300814568,0.7338342129191611,0.17102019141885214,3,1,4,1,1,1,1,2,1,0.7867957924694432,1.7142857142857142,0,1.5,-0.3523011961613431,3,3,5,2,2,1,4,4,3,NA,2,1.2724180205607036,3.5,2.857142857142857,0,-0.7814618182828701,1,-0.7931639996798249,1,2,2,2,2,4,5,4,4,2,5,4,4,4,3,5,4,5,4,3,1.2909944487358056,1.8,0,4.4,0,4,0,3.6,0,4,0,1,3,1,1,1,1,3,1,1,1,3,1,2,1,1,2,1,1,1,2,1.190974832912761,1.45,0,1,3,1,1,1,1,3,1,1,1,3,1,2,1,1,2,1,1,1,2,1.190974832912761,1.45,0,"I lived with my mother, but not father, most of the time. & I lived with my extended family on father's side (grandparents, aunts ,uncles, cousins)",1,"White, Caucasian, Anglo, European American & Native American/Alaskan Native/indigenous",1,26,1,2,NA,1,2,5,N/A,2,115,63,2,5,1,0,0,0,1,0,"I lived with my mother, but not father, most of the time. & I lived with my extended family on father's side (grandparents, aunts ,uncles, cousins)",1,TRUE,TRUE,TRUE,TRUE,TRUE,3,0.5666468750014901,0.5438093749973923,0.5212906250022351,0.6323225806441999,0.5710096774178166,0.6069718749998138,1,1,1,0.96875,1,1,0.071,0.426,0.685,0.013,1.364,53.65587991272703,1858.293717059478,0.072,0.425,0.775,0.013,1.454,39.81738538873488,1825.0318715031626,374,1.108148148148148,0,3,0,0,3,FALSE
430,2022-03-18T23:07:41Z,2022-03-19T00:03:36Z,3354,1,2022-03-19T00:03:37Z,0.8999999761581421,Chrome,99.0.4844.51,Macintosh,1440,900,n/a,1.6,2497,65,515,85,68,75,3.7331566438236456,-0.2922856233879446,0.37491674974974026,-0.16266414099569113,0.14413090173110105,-0.2633430330455156,3,3,1,1,3,1,2,3,1,3,3,1,1,1,3,3,2,2,3,3,0.4893604849295929,0,1,1,3,2,2.15,0,3,4,3,4,3,3,4,3,4,3,3,3,3,5,5,4,4,4,1,4,4,4,4,4,1,1,0,1,0,3,4,5,2,5,3,4,4,3,2,3,2,2,4,3,5,4,4,2,3,2,5,3,2,2,1,1,1,2,1,1,4,2,2,1,2,3,2,2,2,2,0.9062677977956192,0.828078671210825,3.625,0,2,0,3.533333333333333,0,3.6666666666666665,0,3,0,2.3333333333333335,0,1.8571428571428572,0,2,0,2.7567567567567566,0,2,0,0,1.4275800703404193,0.16253517528056266,0.795057622810491,3,3,4,2,1,4,3,2,1,0.9759000729485332,2.857142857142857,0,1.5,0.3106458204751058,3,3,3,3,1,1,3,9,9,1,2,0.9759000729485332,9,2.4285714285714284,0,-0.007765148525245309,0,-0.553835479631602,2,1,1,4,2,3,3,3,4,4,2,4,2,4,4,5,5,5,4,3,1.162919151265879,2,0,3.8,0,3.6,0,3.6,0,3.6666666666666665,0,4,1,2,3,2,3,2,3,2,2,3,3,1,4,3,3,3,4,4,4,0.99472291830968,2.8,0,4,1,2,3,2,3,2,3,2,2,3,3,1,4,3,3,3,4,4,4,0.99472291830968,2.8,0,"I lived with my mother, but not father, most of the time.",0,"Hispanic of Latino (e.g., Mexican American, Central American, and others)",0,22,1,2,NA,1,2,3,College Student,1,175,61,2,5,2,0,0,0,0,0,"I lived with my mother, but not father, most of the time.",0,TRUE,TRUE,TRUE,TRUE,TRUE,2,0.56125,0.44460322580678807,0.47159354838656803,0.610218750001397,0.5037933333329856,0.535240625000326,1,1,1,1,0.967741935483871,1,0.128,0.287,0.749,0.016,1.569,73.79665239422417,1862.2482323228314,0.135,0.293,0.778,0.021,1.709,85.2886148568855,1866.7609595234578,304,0.9007407407407407,1,3,0,12,15,FALSE
431,2022-03-18T23:47:09Z,2022-03-19T00:05:55Z,1125,1,2022-03-19T00:05:56Z,0.8999999761581421,Chrome,99.0.4844.51,Windows NT 10.0,1280,1024,NA,1.25,594,66,249,65,50,60,-0.17269542242897798,-0.2867734524821021,-0.5901234842008639,-0.4089142813697004,-0.22447716527374886,-0.43183265134477916,2,2,1,2,2,1,2,2,1,2,3,1,1,1,2,1,2,1,2,2,0.9880869341680844,0,1,1,1,1,1.65,0,5,3,4,5,3,5,4,3,5,3,5,5,5,5,5,5,5,4,1,5,5,5,5,4,2,0,0,0,0,3,4,5,5,5,4,5,5,5,1,4,5,5,5,3,3,5,5,5,5,5,5,5,4,1,4,3,2,4,4,3,4,3,3,3,5,5,3,1,2,2,1.572091432287407,1.6417180315870614,4.375,0,2,0,4.333333333333333,0,4.555555555555555,0,4.25,0,3.6666666666666665,0,3.2857142857142856,0,4.333333333333333,0,4.054054054054054,0,2,0,0,2.6718605598796876,0.16253517528056266,1.4171978675801251,5,5,5,5,5,5,5,8,3,1.9518001458970664,5,0,5.5,3.099692286619009,3,2,4,2,1,1,2,4,4,2,2,1.2724180205607036,4,2.142857142857143,0,-0.69712652889908,0,-1.1288907189510247,3,3,3,3,3,4,3,3,4,3,5,4,3,3,5,3,4,1,4,4,1.1254628677422756,3,0,3.6,0,3.2,0,3.8,0,3.533333333333333,0,3,1,2,3,3,2,3,2,2,3,4,3,1,2,2,3,3,3,3,4,0.8271701918685112,2.6,0,3,1,2,3,3,2,3,2,2,3,4,3,1,2,2,3,3,3,3,4,0.8271701918685112,2.6,0,I lived with my mother and father an equal amount of time (joint custody),0,"Black or African American & Hispanic of Latino (e.g., Mexican American, Central American, and others) & Native American/Alaskan Native/indigenous",1,25,1,3,NA,1,1,4,Disabled,1,247,62,2,5,2,0,0,0,0,0,I lived with my mother and father an equal amount of time (joint custody),0,TRUE,TRUE,TRUE,TRUE,TRUE,6,0.5663031249046325,0.490971874922514,0.493890625,0.6817931035140465,0.5398032258249098,0.6111333333969116,1,1,1,0.90625,0.96875,0.967741935483871,0.073,0.335,0.443,0.009,1.339,40.733271386606695,1880.9328004179865,0.073,0.337,0.505,0.009,1.362,35.29226931459814,1860.7156580331418,472,1.3985185185185185,0,3,0,0,3,FALSE
432,2022-03-18T23:48:33Z,2022-03-19T00:11:17Z,1364,1,2022-03-19T00:11:18Z,0.8999999761581421,Safari,15.3,Macintosh,1440,900,I had to leave full screen mode once in the childhood part because the screen would not scroll. once I refreshed the page it let me scroll,1.6,502,111,465,69,53,67,-0.36152274250004546,-0.03872576171918871,0.1935182095334613,-0.35966425329489854,-0.16304248743960723,-0.35320416280512285,1,1,1,1,1,1,1,3,1,2,3,1,2,1,3,1,1,1,3,3,1.1697953037312037,0,0,3,3,2,1.6,0,2,2,2,2,3,2,3,2,2,2,1,2,2,2,2,2,1,3,1,1,1,2,1,3,2,0,0,0,0,2,3,4,4,3,2,2,2,4,3,3,2,1,2,2,1,2,1,1,1,3,3,3,1,2,3,2,1,3,1,1,2,2,2,1,1,1,1,2,1,1,1.1598902298689069,1.0600988273786194,1.5,0,1.25,0,2.066666666666667,0,2.888888888888889,0,1.8333333333333333,0,2.3333333333333335,0,1.7142857142857142,0,1,0,2.081081081081081,0,2,0,0,-0.4372658745496692,-0.09601446952555226,-0.2666401720376107,2,2,3,2,2,2,1,1,1,0.9511897312113419,2,0,1,-0.37981704324605103,4,4,4,4,2,2,3,7,7,2,3,0.9511897312113419,7,3.2857142857142856,0,0.18920499890107342,0,0.030788325313879428,1,2,2,2,2,4,4,4,4,3,5,4,4,3,3,3,4,4,3,3,0.8837151016885368,1.8,0,4.2,0,3.4,0,3.4,0,3.6666666666666665,0,2,3,3,4,2,2,2,3,2,2,2,3,2,3,1,3,3,3,2,2,0.5871429486123998,2.45,0,2,3,3,4,2,2,2,3,2,2,2,3,2,3,1,3,3,3,2,2,0.5871429486123998,2.45,0,I lived with my mother and father an equal amount of time (joint custody),0,"White, Caucasian, Anglo, European American",0,21,1,2,NA,1,3,4,student,2,200,67,3,5,2,0,1,0,0,1,I lived with my mother and father an equal amount of time (joint custody),0,TRUE,TRUE,TRUE,TRUE,TRUE,3,0.7143749999999963,0.5685937499999987,0.5740625000000072,0.7728709677419392,0.6267187500000032,0.6267666666666638,1,1,1,0.96875,1,0.967741935483871,0.07,0.409,0.431,0.019,1.568,138.37226629728633,1985.41358145127,0.072,0.407,0.475,0.017,1.731,151.71287944027142,1978.1771299183065,358,1.0607407407407408,0,3,0,0,3,FALSE
433,2022-03-18T23:47:01Z,2022-03-19T00:12:16Z,1514,1,2022-03-19T00:12:18Z,0.8999999761581421,Chrome,99.0.4844.51,Macintosh,1680,1050,NA,1.6,562,175,427,114,88,85,-0.23837449027978405,0.31405317625473256,0.055655318969089276,0.19439856254662236,0.5536954206253788,-0.15101662084600656,2,2,2,1,3,1,2,2,1,1,3,2,2,1,2,3,2,1,3,2,0.8522416262267903,0,1,1,3,2,1.9,0,3,2,3,3,3,3,4,3,2,3,4,3,2,3,3,2,3,2,1,1,2,3,1,4,1,1,0,0,0,2,4,2,2,2,1,1,1,2,2,2,1,1,2,2,1,3,2,2,3,3,2,4,1,1,3,1,1,3,1,1,2,2,1,2,4,1,2,1,1,1,1.416865380869865,0.5936168397046637,1.875,0,1.25,0,2.933333333333333,0,1.8888888888888888,0,2,0,2,0,1.5714285714285714,0,2.3333333333333335,0,1.9189189189189189,0,2,0,0,0.03448198072336553,-0.09601446952555226,-0.030766244401093365,1,2,2,3,2,2,2,3,1,1.2149857925879117,2,0,2,0.0066881592415893995,4,4,4,5,2,2,2,7,7,3,2,1.1338934190276817,7,3.2857142857142856,0,0.05901460416338424,0,-0.048569534426548225,2,2,3,5,3,4,5,3,4,3,5,4,2,3,4,5,4,4,4,5,1.3020130933435712,3,0,4.2,0,3.8,0,3.8,0,3.933333333333333,0,1,1,2,2,2,3,3,2,2,1,3,2,1,3,1,2,3,3,4,3,0.9403246919632545,2.2,0,1,1,2,2,2,3,3,2,2,1,3,2,1,3,1,2,3,3,4,3,0.9403246919632545,2.2,0,"I lived with my mother, but not father, most of the time.",0,Black or African American,0,26,1,2,NA,1,2,7,Volunteer Coordinator,2,260,66,1,5,2,0,0,1,0,0,"I lived with my mother, but not father, most of the time.",0,TRUE,TRUE,TRUE,TRUE,TRUE,4,0.5626354838686605,0.45753749999962745,0.502934374993667,0.6418451612880153,0.5151258064431529,0.6042137931009819,0.96875,1,1,0.96875,0.96875,0.90625,0.063,0.407,0.597,0.009,1.324,45.154326548852076,1925.7763753749148,0.064,0.405,0.698,0.009,1.351,38.646941038009174,1892.6484956093452,434,1.285925925925926,0,3,0,0,3,FALSE
434,2022-03-18T23:53:56Z,2022-03-19T00:14:52Z,1255,1,2022-03-19T00:14:53Z,0.8999999761581421,Firefox,98.0,Windows NT 10.0,1366,768,Nope.,1.7786458333333333,561,81,365,72,44,86,-0.24042696115012174,-0.2040908888944643,-0.16927887089909666,-0.32272673223879716,-0.34734652094203217,-0.13978397962605565,3,3,1,1,2,1,1,3,1,3,4,1,1,1,2,3,1,1,4,3,0.6882472016116853,0,1,1,2,2,2,0,4,3,3,4,2,2,3,3,3,2,1,4,1,3,3,2,3,1,1,2,3,3,2,1,2,0,0,0,0,2,3,1,3,4,3,4,4,4,2,3,2,1,4,4,2,2,2,2,4,4,4,1,1,1,4,4,1,2,3,2,4,3,2,2,3,1,2,1,2,2,1.070348375831741,0.7237468644557459,2.125,0,1.75,0,2.7333333333333334,0,3.111111111111111,0,2.6666666666666665,0,2.5,0,2.4285714285714284,0,2,0,2.6486486486486487,0,1,0,0,0.3752270412189316,-0.14280879051279902,0.11620912535306628,3,3,5,2,2,3,2,3,1,0.7559289460184544,2.857142857142857,0,2,0.5038984217189261,1,2,3,3,1,1,2,4,10,1,1,1.2149857925879117,7,1.8571428571428572,0,-0.7134088621458613,0,-1.2936690501794208,3,2,2,3,2,3,2,3,3,2,2,2,3,2,2,4,3,4,2,2,0.7367883976130072,2.4,0,2.8,0,2.6,0,2.4,0,2.6,0,1,1,1,2,2,1,3,3,1,1,4,3,2,1,1,2,1,1,1,2,0.9233805168766387,1.7,0,1,1,1,2,2,1,3,3,1,1,4,3,2,1,1,2,1,1,1,2,0.9233805168766387,1.7,0,"I lived with my mother and father an equal amount of time (joint custody) & I lived with my extended family on father's side (grandparents, aunts ,uncles, cousins)",1,"Asian or Asian American (e.g., Chinese, Japanese, and others)",0,24,0,1,NA,1,2,6,Unemployed,2,130,66,1,5,2,0,0,0,0,0,"I lived with my mother and father an equal amount of time (joint custody) & I lived with my extended family on father's side (grandparents, aunts ,uncles, cousins)",1,TRUE,TRUE,TRUE,TRUE,TRUE,5,0.6184375,0.4782258064516129,0.5634838709677419,0.71553125,0.5701379310344827,0.5923870967741935,1,0.96875,0.96875,1,0.90625,0.96875,0.069,0.341,0.308,0.04,1.326,176.60883128943198,2083.5351318610815,0.07,0.341,0.319,0.016,1.384,210.25069568313302,2085.4053265267617,384,1.1377777777777778,0,3,0,0,3,FALSE
436,2022-03-18T23:41:46Z,2022-03-19T00:17:36Z,2149,1,2022-03-19T00:17:38Z,0.800000011920929,Chrome,99.0.4844.74,Windows NT 10.0,1536,1024,NA,1.5,1573,61,294,72,31,71,1.8366735596316204,-0.3143343070113147,-0.4268647980062128,-0.32272673223879716,-0.6135634582233127,-0.3082735979253192,3,3,2,2,2,1,1,3,1,2,3,2,2,3,3,3,1,2,3,3,0.6048053188292994,0,1,1,2,3,2.25,0,5,3,3,3,4,3,3,3,4,2,2,3,1,3,4,3,5,5,5,5,4,4,5,3,1,0,0,5,0,3,2,2,2,5,3,4,4,5,2,2,3,3,5,5,3,5,5,5,5,5,5,1,1,2,1,1,4,2,5,5,1,1,5,1,5,2,3,4,5,5,1.624234631492057,0.8997354108424374,4.5,0,4.25,0,3.066666666666667,0,3.3333333333333335,0,4,0,1.8333333333333333,0,3.2857142857142856,0,2.6666666666666665,0,3.2432432432432434,0,2,0,0,1.8186199678993114,0.9381841096989074,1.3784020387991094,4,3,3,5,3,4,4,8,8,0.9759000729485332,3.7142857142857144,0,8,3.3201398991221054,3,3,3,3,2,2,2,3,3,3,2,0.6900655593423543,3,2.5714285714285716,0,-0.6637366525547652,0,-0.8762577463484977,4,4,4,2,4,2,2,2,2,2,5,3,5,4,3,1,2,2,3,2,1.2227992865708155,3.6,0,2.8,0,2.6,0,2.6,0,2.6666666666666665,0,2,4,4,3,4,4,4,3,4,4,4,3,3,4,1,3,3,3,3,3,0.9679060415469871,3.3,0,2,4,4,3,4,4,4,3,4,4,4,3,3,4,1,3,3,3,3,3,0.9679060415469871,3.3,0,I lived with my mother and father an equal amount of time (joint custody),0,"Asian or Asian American (e.g., Chinese, Japanese, and others)",0,24,1,3,NA,1,1,4,Student,1,113,66,1,5,2,0,1,1,0,1,I lived with my mother and father an equal amount of time (joint custody),0,TRUE,TRUE,TRUE,TRUE,TRUE,6,0.41795312499720605,0.40303437499981376,0.4366218750001863,0.5142037037025999,0.45513571428507565,0.4880466666628917,1,1,1,0.84375,0.875,0.9375,0.057,0.35,0.717,0.025,1.784,69.76035483511023,1941.2224488977615,0.055,0.351,0.758,0.025,1.872,74.97766681181282,1923.8062372833872,434,1.285925925925926,0,3,0,3,6,FALSE
437,2022-03-18T23:57:27Z,2022-03-19T00:19:24Z,1316,1,2022-03-19T00:19:24Z,0.8999999761581421,Safari,15.1,Macintosh,1680,1050,NA,1.6,510,234,301,83,52,80,-0.3451029755373439,0.6392712596994412,-0.40146900237593375,-0.18728915503309204,-0.1835207133843211,-0.2071798269457611,3,3,2,3,3,1,2,3,1,3,3,1,1,2,3,3,2,1,4,3,0.5501196042201808,0,0,1,2,1,2.35,0,1,1,1,1,1,1,2,2,1,1,1,2,1,2,2,1,1,1,1,1,1,1,1,0,2,0,0,0,0,2,2,1,1,1,1,1,1,1,1,1,1,1,2,1,1,2,1,1,1,1,1,1,1,1,1,1,1,1,1,1,2,2,1,1,1,1,2,1,1,2,1.8195633571851273,1.7593288763724921,1,0,1.5,0,1.3333333333333333,0,1.2222222222222223,0,1.1666666666666667,0,1,0,1.2857142857142858,0,1,0,1.162162162162162,0,0,0,0,-1.377808854935466,-0.44815275630616064,-0.9129808056208133,1,1,3,1,1,1,1,1,1,1.5735915849388864,1.2857142857142858,0,1,-0.7941589286438315,4,4,3,4,3,3,4,6,6,NA,3,0.7559289460184544,6,3.5714285714285716,0,0.41251961278270693,1,0.32176366763103004,1,1,1,2,1,5,4,4,5,3,5,1,4,4,4,4,4,4,3,4,1.1832159566199232,1.2,0,3.8,0,3.6,0,4.2,0,3.8666666666666667,0,1,3,3,4,3,4,4,3,1,2,3,3,4,4,1,3,3,4,3,3,1.0894228312566052,2.95,0,1,3,3,4,3,4,4,3,1,2,3,3,4,4,1,3,3,4,3,3,1.0894228312566052,2.95,0,NA,NA,"White, Caucasian, Anglo, European American",0,28,1,2,NA,1,3,4,Full-time student,3,121,60,2,5,2,0,0,1,0,0,NA,NA,TRUE,TRUE,TRUE,TRUE,TRUE,5,0.6802903225806456,0.49812903225806265,0.5253749999999981,0.7657666666666653,0.5849199999999977,0.6388620689655192,0.96875,0.96875,1,0.9375,0.8064516129032258,0.9354838709677419,0.07,0.362,0.448,0.014,1.902,84.29332395227085,1975.4731623567054,0.069,0.364,0.432,0.015,1.955,99.67380679604915,1971.8791285727702,420,1.2444444444444445,0,3,0,0,3,FALSE
438,2022-03-18T23:59:40Z,2022-03-19T00:19:51Z,1211,1,2022-03-19T00:19:52Z,0.8999999761581421,Chrome,99.0.4844.74,Windows NT 10.0,1600,900,"Fun game and enjoyable survey, thanks for it",1.7777777777777777,754,44,195,33,36,44,0.15569991682505238,-0.4080412124106375,-0.7860339076344453,-0.8029145059681153,-0.5111723284997433,-0.6115549108639936,1,2,1,1,2,1,1,2,1,2,3,1,1,2,2,2,1,1,2,3,1.025978352085154,0,0,3,5,3,1.6,0,5,2,2,3,1,2,2,2,3,3,2,5,4,5,4,2,3,1,2,4,1,3,2,4,1,1,0,3,0,2,2,3,2,2,1,1,1,2,1,1,3,2,3,3,3,1,1,1,2,2,3,1,3,1,3,2,2,4,4,2,1,1,1,1,3,3,3,3,1,1,1.3710871160797478,1.1126972805283737,2.25,0,2,0,3,0,1.7777777777777777,0,1.9166666666666667,0,2.1666666666666665,0,2.142857142857143,0,2.3333333333333335,0,2,0,2,0,0,0.26292487078986143,0.16253517528056266,0.21273002303521205,1,2,5,2,1,3,1,3,1,1.4638501094227998,2.142857142857143,0,2,0.08955653632114546,5,4,4,3,2,1,4,3,4,3,3,1.4142135623730951,3.5,3.2857142857142856,0,-0.22912466020345523,0,-0.22420549722860333,3,2,3,2,2,5,4,5,5,5,5,3,5,4,4,4,5,5,2,5,1.5946338585572373,2.4,0,4.6,0,4,0,4.6,0,4.4,0,2,2,1,3,3,1,1,4,2,2,2,4,3,2,2,2,1,1,1,2,0.7163503994113789,2.05,0,2,2,1,3,3,1,1,4,2,2,2,4,3,2,2,2,1,1,1,2,0.7163503994113789,2.05,0,"I lived with my mother, but not father, most of the time.",0,Black or African American,0,25,0,1,NA,1,2,4,Tax Preparer,2,158,68,2,5,2,0,0,0,0,0,"I lived with my mother, but not father, most of the time.",0,TRUE,TRUE,TRUE,TRUE,TRUE,6,0.3963531250013039,0.36529687499813734,0.40708749999757854,0.4661960000002384,0.44005333333214125,0.47799285714434725,1,1,1,0.78125,0.9375,0.875,0.052,0.324,0.639,0.024,1.939,56.47856958928726,1927.5616208050044,0.051,0.325,0.67,0.022,2.026,61.406573520927836,1922.3987371079327,320,0.9481481481481481,0,3,0,0,3,FALSE
439,2022-03-19T00:07:28Z,2022-03-19T00:23:18Z,950,1,2022-03-19T00:23:21Z,0.8999999761581421,Chrome,99.0.4844.51,Windows NT 10.0,1536,864,NA,1.7777777777777777,478,75,174,49,33,81,-0.41078204338815,-0.23716391432951942,-0.8622212945252824,-0.6059143936689079,-0.572607006333885,-0.19594718572581019,2,2,1,1,4,1,2,2,1,2,2,1,1,1,2,2,1,1,2,1,1.0760551736979407,0,1,3,3,2,1.6,0,2,1,4,1,3,1,1,3,1,2,3,1,1,3,3,3,2,1,1,1,2,3,1,1,2,0,0,0,0,1,1,2,1,1,1,1,1,1,1,1,1,1,1,2,1,4,3,1,1,1,2,1,1,1,1,1,1,2,1,1,2,3,2,1,1,1,1,1,1,1,1.7929625525132182,1.4735767952260144,1.75,0,1,0,2,0,1.1111111111111112,0,1.5,0,1.1666666666666667,0,1.7142857142857142,0,1,0,1.3513513513513513,0,1,0,0,-0.6760433201771223,-0.4013584353189139,-0.5387008777480181,1,1,1,1,1,1,1,1,1,1.9518001458970664,1,0,1,-0.9598956828029438,5,5,5,5,4,4,5,5,5,5,4,1.4638501094227998,5,4.714285714285714,0,0.8143305273750964,0,1.186102038401866,3,3,4,3,2,2,5,3,4,3,5,4,3,4,5,5,4,4,5,3,1.3345232785352157,3,0,3.8,0,4.2,0,3.8,0,3.933333333333333,0,2,1,1,4,1,2,3,2,1,1,2,1,1,2,1,2,1,1,1,2,0.9233805168766387,1.6,0,2,1,1,4,1,2,3,2,1,1,2,1,1,2,1,2,1,1,1,2,0.9233805168766387,1.6,0,NA,NA,"White, Caucasian, Anglo, European American",0,23,0,1,NA,1,4,6,Student/ Musician,4,145,67,2,5,2,0,0,1,0,0,NA,NA,TRUE,TRUE,TRUE,TRUE,TRUE,5,0.6150677419343302,0.48297187500353905,0.5296593749951571,0.6393750000021288,0.5983862068940853,0.8025888888913172,1,1,1,0.9032258064516129,0.90625,0.84375,0.089,0.291,0.418,0.005,1.578,96.53098623189744,1997.696982527111,0.089,0.296,0.414,0.006,1.667,120.23861808672804,1996.8285931014748,338,1.0014814814814814,0,3,0,0,3,FALSE
440,2022-03-18T23:42:35Z,2022-03-19T00:23:29Z,2453,1,2022-03-19T00:23:30Z,0.8999999761581421,Chrome,99.0.4844.74,Windows NT 10.0,1536,864,NA,1.7777777777777777,1022,207,758,131,42,122,0.7057621100755532,0.4904426452416932,1.2565136552008562,0.40371118186453026,-0.38830297283146,0.26459110429217686,4,4,4,4,4,4,4,4,4,4,4,4,4,4,4,4,4,4,4,4,1.538967528127731,0,0,4,1,1,4,0,5,5,5,5,5,5,5,5,5,5,5,5,1,5,5,5,5,2,3,5,5,5,5,8,1,2,0,6,0,5,5,5,5,5,5,5,5,5,4,5,5,1,5,5,5,5,5,5,5,5,5,1,3,4,3,4,5,4,3,3,4,5,5,5,5,5,1,5,2,2,1.8025674049114637,2.065591117977289,4.375,0,2.5,0,4.733333333333333,0,5,0,4.583333333333333,0,3.3333333333333335,0,4.142857142857143,0,5,0,4.4324324324324325,0,4,0,0,3.0120150743431986,0.7732231068672859,1.8926190906052422,5,5,5,5,3,5,5,8,3,1.9023794624226837,4.714285714285714,0,5.5,2.9339555324598967,2,1,2,1,1,1,1,1,1,1,1,1.4638501094227998,1,1.2857142857142858,0,-1.7975357472230855,0,-2.2642079234884935,1,1,1,1,1,5,5,5,5,1,5,5,3,5,5,5,5,5,5,5,1.98086080374405,1,0,5,0,3.8,0,5,0,4.6,0,4,4,4,4,4,4,4,4,4,4,4,4,4,4,2,4,3,4,4,4,1.2513150976809202,3.85,0,4,4,4,4,4,4,4,4,4,4,4,4,4,4,2,4,3,4,4,4,1.2513150976809202,3.85,0,"I lived with my extended family on father's side (grandparents, aunts ,uncles, cousins) & I was in foster care most of the time.",1,"White, Caucasian, Anglo, European American",0,26,1,2,NA,1,2,6,unemployed,2,98,62,1,5,2,0,0,0,0,0,"I lived with my extended family on father's side (grandparents, aunts ,uncles, cousins) & I was in foster care most of the time.",1,TRUE,TRUE,TRUE,TRUE,TRUE,3,0.6930225806447767,0.49794062500074504,0.589003125000745,0.7498281249972061,0.6110300000011921,0.6848733333344261,1,1,1,1,0.967741935483871,0.9375,0.065,0.414,0.379,0.012,1.501,27.055895190268593,1871.0280033018387,0.065,0.414,0.399,0.012,1.549,28.736315870932117,1869.5289924152041,390,1.1555555555555557,0,3,0,0,3,FALSE
441,2022-03-18T23:59:40Z,2022-03-19T00:23:51Z,1450,1,2022-03-19T00:23:52Z,0.8999999761581421,Chrome,99.0.4844.51,Windows NT 10.0,1500,1000,None,1.5,555,86,417,85,58,88,-0.2527417863721479,-0.1765300343652517,0.019375610925833477,-0.16266414099569113,-0.060651357716037795,-0.11731869718615386,1,1,2,1,2,1,1,2,1,1,1,1,2,1,1,1,1,2,2,1,1.3178930553209385,0,1,1,3,2,1.3,0,3,3,4,4,4,3,4,3,2,2,2,3,1,4,5,2,5,1,3,2,2,3,2,6,1,1,0,3,1,4,5,4,5,4,2,5,5,5,3,4,1,1,4,2,2,4,3,4,1,3,5,1,4,3,5,2,3,5,5,5,3,4,3,2,4,1,3,1,3,3,1.3836236534601505,0.9154754164341269,2.5,0,2.5,0,3.1333333333333333,0,4.333333333333333,0,2.6666666666666665,0,3.3333333333333335,0,4,0,2.3333333333333335,0,3.4054054054054053,0,3,1,0,1.044610968552942,1.2522221884464544,1.1484165784996982,1,1,2,2,2,3,3,5,3,1.3451854182690985,2,0,4,0.7796985642168702,3,4,4,1,1,1,1,2,3,2,1,1.7043362064926932,2.5,2.142857142857143,0,-1.3124263354299273,0,-1.5039481557409573,2,3,3,5,3,2,3,1,4,2,4,4,2,5,4,3,3,2,2,1,1.1254628677422756,3.2,0,3,0,2.4,0,3,0,2.8,0,1,1,1,2,4,2,2,3,1,1,4,1,1,1,1,1,1,2,2,3,1.190974832912761,1.75,0,1,1,1,2,4,2,2,3,1,1,4,1,1,1,1,1,1,2,2,3,1.190974832912761,1.75,0,"I lived with my mother, but not father, most of the time.",0,"White, Caucasian, Anglo, European American",0,29,0,1,NA,1,3,6,IT Technician,5,251,72,3,5,2,0,0,1,0,0,"I lived with my mother, but not father, most of the time.",0,TRUE,TRUE,TRUE,TRUE,TRUE,3,0.604546875,0.5365812500026077,0.5577000000067055,0.6523437500037252,0.6107593750003725,0.6697718750014902,1,1,1,1,1,1,0.133,0.354,0.612,0.008,1.076,146.64094923394146,1964.9879645352707,0.134,0.352,0.667,0.006,1.086,153.1186405758458,1946.2975864600833,450,1.3333333333333335,0,3,0,0,3,FALSE
443,2022-03-18T23:58:06Z,2022-03-19T00:30:21Z,1935,1,2022-03-19T00:30:23Z,0.8999999761581421,Safari,15.2,Macintosh,1440,900,NA,1.6,583,209,353,79,591,65,-0.19527260200269259,0.5014669870533782,-0.2128145205510036,-0.2365391831078939,10.854243070816462,-0.3756694452450246,3,4,3,3,4,3,4,4,1,4,4,1,1,3,4,4,1,4,4,3,1.105012502906165,0,1,2,3,2,3.1,0,2,2,3,2,1,1,5,2,2,2,3,3,5,3,4,1,1,1,1,2,2,1,2,4,2,0,0,0,0,1,3,4,3,5,2,3,1,5,3,2,5,1,4,1,2,1,1,1,3,1,5,1,1,1,1,1,1,4,4,3,2,1,2,1,1,2,2,3,2,3,1.4221541838079732,1.2344267996967353,1.375,0,2.5,0,2.6666666666666665,0,3,0,2.0833333333333335,0,1.6666666666666667,0,2.4285714285714284,0,1.3333333333333333,0,2.2432432432432434,0,2,0,0,-0.15882342043587488,0.3349016051513059,0.08803909235771551,3,4,4,2,1,3,4,6,2,1.1126972805283737,3,0,4,1.359777203773763,5,5,5,5,1,2,4,7,10,2,2,1.8126539343499315,8.5,3.857142857142857,0,0.11596863490883813,0,0.29585372207782706,2,2,2,2,2,4,5,4,5,2,5,4,5,3,5,4,4,5,5,2,1.5675276256394517,2,0,4.4,0,4.2,0,3.8,0,4.133333333333334,0,2,2,4,2,1,4,4,2,1,1,2,3,3,3,1,3,2,3,3,4,1.0513149660756937,2.5,0,2,2,4,2,1,4,4,2,1,1,2,3,3,3,1,3,2,3,3,4,1.0513149660756937,2.5,0,"I lived with my mother, but not father, most of the time.",0,Black or African American,0,21,1,2,NA,1,3,3,student,3,140,66,1,5,2,0,0,1,0,0,"I lived with my mother, but not father, most of the time.",0,TRUE,TRUE,TRUE,TRUE,TRUE,6,0.6069677419354811,0.5408749999999982,0.4999687500000036,0.6387187499999996,0.5702500000000018,0.53209375,1,1,1,1,1,1,0.071,0.369,0.589,0.05,1.892,71.00131417106108,1874.9710322450137,0.074,0.364,0.591,0.043,1.991,108.99231687773903,1900.6442197732226,438,1.2977777777777777,0,3,0,0,3,FALSE
445,2022-03-19T00:12:44Z,2022-03-19T00:31:39Z,1135,1,2022-03-19T00:31:40Z,0.8999999761581421,Chrome,99.0.4844.51,Macintosh,1440,900,NA,1.6,463,67,353,88,64,60,-0.44156910644321534,-0.28126128157625957,-0.2128145205510036,-0.12572661993958972,0.062217997952245516,-0.43183265134477916,3,4,3,3,4,1,2,4,1,4,4,2,2,1,4,4,2,1,4,4,0.6863327411532597,0,1,1,2,2,2.85,0,4,4,3,3,3,3,5,4,2,2,3,2,2,3,3,3,2,1,1,2,2,2,1,0,2,0,0,0,0,1,2,3,4,4,2,4,3,3,4,4,1,2,2,3,3,3,2,4,4,4,2,1,1,1,1,1,1,1,1,1,3,3,3,2,3,2,1,1,1,1,1.1930731006201687,0.816496580927726,1.75,0,1,0,3.066666666666667,0,2.888888888888889,0,3,0,1.1666666666666667,0,1.8571428571428572,0,2.3333333333333335,0,2.4054054054054053,0,0,0,0,0.2507202527940642,-0.6205191861769039,-0.18489946669141988,4,4,3,3,3,5,4,3,1,0.9759000729485332,3.7142857142857144,0,2,1.0011086841962626,4,3,3,4,2,2,4,5,8,5,3,0.8997354108424374,6.5,3.142857142857143,0,0.7410941633828612,0,0.28976695842073497,3,3,3,3,3,4,2,4,4,1,5,3,4,2,3,3,4,4,3,3,0.816496580927726,3,0,4,0,2.6,0,3.2,0,3.2666666666666666,0,2,1,1,4,2,1,2,3,3,3,2,3,1,2,1,3,1,1,2,1,0.6708203932499369,1.95,0,2,1,1,4,2,1,2,3,3,3,2,3,1,2,1,3,1,1,2,1,0.6708203932499369,1.95,0,I lived with my mother and father an equal amount of time (joint custody),0,Filipino,0,20,0,1,NA,1,3,4,student,5,145,65,3,5,2,0,0,3,0,0,I lived with my mother and father an equal amount of time (joint custody),0,TRUE,TRUE,TRUE,TRUE,TRUE,6,0.4237999999998137,0.39223548386750684,0.4215812499998137,0.4890851851845229,0.46551666666766006,0.5105214285722801,1,1,1,0.8709677419354839,0.9375,0.875,0.048,0.348,0.624,0.011,1.387,42.44477953215273,1920.402805925355,0.051,0.349,0.709,0.012,1.42,53.30665854259437,1926.7400665808298,438,1.2977777777777777,0,3,0,3,6,FALSE
446,2022-03-19T00:17:06Z,2022-03-19T00:33:57Z,1011,1,2022-03-19T00:33:58Z,0.8999999761581421,Chrome,99.0.4844.74,Windows NT 10.0,1536,864,No thank you.,1.7777777777777777,534,58,205,49,40,82,-0.2958436746492394,-0.33087081972884225,-0.7497541995911894,-0.6059143936689079,-0.42925942472088774,-0.18471454450585928,4,3,3,3,4,1,2,4,1,4,4,4,4,2,4,4,2,2,4,4,1.019545822516343,0,1,1,2,1,3.15,0,4,4,3,4,3,2,5,2,2,5,5,5,1,4,4,2,3,1,1,1,2,2,1,1,2,0,0,0,0,1,1,1,1,1,1,1,1,1,1,1,1,1,1,2,1,2,1,1,1,3,2,1,1,1,3,1,1,5,5,1,3,3,2,1,1,1,1,1,2,2,1.8224492644025296,1.2344267996967353,1.625,0,1.5,0,3.533333333333333,0,1,0,1.3333333333333333,0,1.5,0,2.857142857142857,0,1,0,1.5405405405405406,0,1,0,0,0.022080514050217243,-0.22899200544817064,-0.1034557456989767,1,1,1,1,1,1,1,1,1,1.9518001458970664,1,0,1,-0.9598956828029438,5,5,5,5,4,4,5,6,7,3,3,1.4638501094227998,6.5,4.714285714285714,0,0.3129387823351568,0,0.8804775270233084,3,3,3,1,3,3,5,5,5,5,1,4,5,4,2,5,3,5,5,4,1.6846647257229665,2.6,0,3.2,0,5,0,4,0,4.066666666666666,0,4,4,4,1,4,4,4,2,2,2,4,3,1,2,3,3,1,3,1,4,1.1652874052533586,2.8,0,4,4,4,1,4,4,4,2,2,2,4,3,1,2,3,3,1,3,1,4,1.1652874052533586,2.8,0,I lived with my mother and father an equal amount of time (joint custody),0,"White, Caucasian, Anglo, European American",0,26,0,1,NA,1,3,5,Question and Answer Analyst,2,216,70,3,5,2,0,0,1,0,0,I lived with my mother and father an equal amount of time (joint custody),0,TRUE,TRUE,TRUE,TRUE,TRUE,1,0.5877968750037253,0.5464406249970197,0.584393750000745,0.7196925925965663,0.6944733333329359,0.8027700000067551,1,1,1,0.8709677419354839,0.9375,0.967741935483871,0.099,0.392,0.504,0.006,1.279,13.795568614032216,1848.167063555979,0.096,0.391,0.486,0.006,1.354,20.456061428860313,1844.2392438144352,385,1.1407407407407408,0,3,0,0,3,FALSE
447,2022-03-19T00:15:38Z,2022-03-19T00:34:04Z,1106,1,2022-03-19T00:34:06Z,0.8999999761581421,Chrome,99.0.4844.51,Macintosh,1440,900,NA,1.6,490,66,293,81,48,76,-0.3861523929440977,-0.2867734524821021,-0.4304927688105384,-0.21191416907049299,-0.26543361716317665,-0.2521103918255647,1,1,1,1,1,1,1,1,1,1,1,1,1,1,1,1,1,1,1,1,1.538967528127731,0,1,1,4,4,1,0,3,2,3,3,3,2,3,3,2,2,3,3,2,3,2,1,2,2,1,1,3,3,2,2,2,0,0,0,0,1,2,3,2,3,2,2,1,3,2,2,2,1,3,2,3,4,4,1,3,3,4,1,3,1,1,1,1,1,1,1,2,3,2,1,1,1,2,2,1,1,1.3254270092150517,0.6399404734221844,1.875,0,1.5,0,2.6,0,2.111111111111111,0,2.5,0,1.8333333333333333,0,1.5714285714285714,0,1,0,2,0,1,0,0,-0.07575327859351295,-0.22899200544817064,-0.1523726420208418,2,3,3,2,2,2,2,3,1,0.7867957924694432,2.2857142857142856,0,2,0.1724249134007015,4,4,4,4,3,2,4,6,4,5,3,0.9511897312113419,5,3.5714285714285716,0,0.4700624421135551,0,0.35683903389215443,3,1,1,4,2,3,5,3,4,2,5,4,3,4,4,4,3,2,2,2,1.0997835284835873,2.2,0,3.4,0,3.2,0,3.4,0,3.3333333333333335,0,2,2,1,1,2,1,1,1,1,1,2,1,2,2,1,1,1,1,2,1,1.145931016569864,1.35,0,2,2,1,1,2,1,1,1,1,1,2,1,2,2,1,1,1,1,2,1,1.145931016569864,1.35,0,"I lived with my mother, but not father, most of the time.",0,"White, Caucasian, Anglo, European American",0,27,1,2,NA,1,2,6,Student,1,111,62,2,5,2,0,0,1,0,0,"I lived with my mother, but not father, most of the time.",0,TRUE,TRUE,TRUE,TRUE,TRUE,5,0.44894062500260773,0.41851874999981376,0.45918750000279396,0.5300821428575686,0.4919142857119441,0.5707838709671651,1,1,1,0.875,0.875,0.96875,0.085,0.328,0.645,0.017,1.856,115.7172347752956,1960.3966267926405,0.084,0.328,0.708,0.016,2.009,127.2506131213098,1961.8118882931165,434,1.285925925925926,0,3,0,0,3,FALSE
448,2022-03-19T00:07:23Z,2022-03-19T00:36:44Z,1760,1,2022-03-19T00:36:44Z,0.8999999761581421,Chrome,99.0.4844.74,Macintosh,1440,900,NA,1.6,608,123,580,156,66,126,-0.14396083024425033,0.027420289150921522,0.6107348520309029,0.7115238573320418,0.10317444984167329,0.30952166917198043,2,2,1,1,2,1,1,3,1,2,3,1,1,1,2,2,1,1,2,3,0.9333020044867296,0,1,1,3,2,1.65,0,2,2,2,2,2,2,3,3,2,3,4,4,2,3,2,1,5,1,1,2,4,2,3,1,1,1,0,1,0,1,2,1,1,2,1,2,1,4,2,1,2,1,2,2,2,2,2,5,5,2,4,1,1,1,3,1,2,2,2,1,1,2,2,3,4,4,2,2,2,2,1.4907119849998598,0.8837151016885368,2.375,0,2,0,2.533333333333333,0,1.6666666666666667,0,2.3333333333333335,0,1.8333333333333333,0,1.7142857142857142,0,3.6666666666666665,0,2.081081081081081,0,1,0,0,0.14904791094197897,-0.05662557557742737,0.0462111676822758,2,2,3,2,2,3,2,3,1,0.7867957924694432,2.2857142857142856,0,2,0.1724249134007015,3,3,3,3,1,1,4,6,6,5,3,0.9511897312113419,6,2.5714285714285716,0,0.6507502562930925,0,-0.07500917533715123,2,5,3,3,4,3,5,3,3,4,3,3,3,5,4,4,4,3,4,2,0.8338093878327919,3.4,0,3.2,0,4,0,3.4,0,3.533333333333333,0,3,2,3,1,3,3,3,2,3,3,3,3,3,3,2,3,3,3,3,3,0.4893604849295929,2.75,0,3,2,3,1,3,3,3,2,3,3,3,3,3,3,2,3,3,3,3,3,0.4893604849295929,2.75,0,I lived with my mother and father an equal amount of time (joint custody),0,"Hispanic of Latino (e.g., Mexican American, Central American, and others) & White, Caucasian, Anglo, European American",1,19,1,2,NA,1,3,4,Cashier,5,107,67,1,5,2,0,0,1,0,0,I lived with my mother and father an equal amount of time (joint custody),0,TRUE,TRUE,TRUE,TRUE,TRUE,2,0.4578312500000066,0.47601562500001093,0.4875218750000004,0.5484379310344771,0.49592758620690136,0.5560419354838725,1,1,1,0.9354838709677419,0.9354838709677419,0.96875,0.061,0.386,0.571,0.026,1.611,30.340886894609678,1860.174543451829,0.061,0.385,0.568,0.026,1.688,40.2579931270761,1862.5618151095507,468,1.3866666666666665,0,3,0,0,3,FALSE
449,2022-03-19T00:18:53Z,2022-03-19T00:37:24Z,1111,1,2022-03-19T00:37:25Z,0.800000011920929,Chrome,99.0.4844.51,Macintosh,1280,800,no,1.6,499,68,297,45,40,73,-0.3676801551110585,-0.2757491106704171,-0.4159808855932361,-0.6551644217437097,-0.42925942472088774,-0.2858083154854174,2,2,1,1,1,1,2,3,1,1,4,1,1,2,1,2,1,1,4,2,1.1697953037312037,0,1,4,4,4,1.7,0,4,3,3,3,3,4,2,4,3,3,4,3,3,4,4,3,4,1,1,3,4,4,3,4,1,0,0,1,0,2,4,3,3,3,3,2,2,3,2,2,3,2,3,3,2,4,4,3,4,4,4,1,1,1,3,2,1,3,3,3,4,5,4,3,5,3,2,2,2,2,1.0540925533894598,0.7037315505489968,2.875,0,2,0,3.3333333333333335,0,2.7777777777777777,0,3,0,2,0,3.2857142857142856,0,3.6666666666666665,0,2.891891891891892,0,2,0,0,1.0714808130114315,0.16253517528056266,0.617007994145997,2,2,3,2,1,2,2,3,2,0.9511897312113419,2,0,2.5,0.1999407604854096,3,3,3,3,1,1,1,4,5,NA,2,1.3801311186847085,4.5,2.142857142857143,0,-0.5104300970135641,1,-1.015089472050588,3,3,3,5,3,4,5,4,4,2,5,5,1,3,4,2,5,4,3,5,1.486446705914413,3.4,0,4.6,0,2.6,0,4,0,3.7333333333333334,0,1,1,1,2,1,2,2,2,2,1,2,1,1,2,1,2,2,2,2,2,0.8522416262267903,1.6,0,1,1,1,2,1,2,2,2,2,1,2,1,1,2,1,2,2,2,2,2,0.8522416262267903,1.6,0,I lived with my mother and father an equal amount of time (joint custody),0,"White, Caucasian, Anglo, European American",0,26,1,2,NA,1,2,4,unemployed,1,280,66,1,5,2,0,0,0,0,0,I lived with my mother and father an equal amount of time (joint custody),0,TRUE,TRUE,TRUE,TRUE,TRUE,1,0.6069562500012107,0.48723124999925493,0.5151625000003259,0.7404656249999534,0.5446968750001397,0.5760125000004191,1,1,1,1,1,1,0.117,0.312,0.578,0.03,1.746,29.922779810917085,1821.7628899119582,0.113,0.315,0.575,0.028,1.896,40.21991791266455,1821.4922742083652,324,0.96,0,3,0,0,3,FALSE
450,2022-03-19T00:24:55Z,2022-03-19T00:37:41Z,765,1,2022-03-19T00:37:41Z,0.8999999761581421,Firefox,98.0,Windows NT 10.0,1536,864,NA,1.7777777777777777,430,39,140,34,25,52,-0.5093006451643591,-0.43560206693985015,-0.9855723018723521,-0.7906019989494147,-0.736432813891596,-0.5216937811043864,3,2,2,2,3,2,2,2,1,2,4,1,1,1,3,3,1,1,3,2,0.7451598203705946,0,1,1,3,3,2.05,0,5,3,3,3,2,3,3,4,3,3,4,5,1,5,4,2,3,1,1,2,3,3,3,1,2,0,0,0,0,3,1,1,2,3,1,1,1,1,2,2,5,1,3,2,3,3,5,5,5,5,3,1,2,2,2,2,2,2,2,1,1,2,2,1,3,2,1,2,2,2,1.4627507100116683,1.0600988273786194,2.25,0,1.75,0,3.4,0,1.5555555555555556,0,3.4166666666666665,0,2,0,1.7142857142857142,0,2,0,2.2972972972972974,0,1,0,0,0.5676466233300906,-0.14280879051279902,0.2124189164086458,2,2,3,1,1,2,4,2,1,1.2724180205607036,2.142857142857143,0,1.5,-0.10369606492267476,3,3,4,4,1,1,3,5,3,3,2,1.2535663410560174,4,2.7142857142857144,0,-0.4830488383752279,0,-0.6886923679804283,3,2,3,3,2,3,2,3,3,2,5,3,4,3,3,1,3,3,2,2,0.9411239481143202,2.6,0,3.4,0,2.2,0,2.8,0,2.8,0,1,1,2,4,2,2,3,4,3,2,2,3,2,3,3,3,1,2,3,2,0.7254762501100116,2.4,0,1,1,2,4,2,2,3,4,3,2,2,3,2,3,3,3,1,2,3,2,0.7254762501100116,2.4,0,I lived with my mother and father an equal amount of time (joint custody),0,"White, Caucasian, Anglo, European American",0,26,1,2,NA,1,1,6,office assistant,2,116,62,2,5,2,0,0,1,0,0,I lived with my mother and father an equal amount of time (joint custody),0,TRUE,TRUE,TRUE,TRUE,TRUE,4,0.4304375,0.39515625,0.43524999999999997,0.5136551724137931,0.4765666666666667,0.49825,1,1,1,0.90625,0.9375,1,0.099,0.308,0.762,0.031,1.843,23.165202547134445,1814.6604745911634,0.098,0.308,0.764,0.031,1.886,33.66346848708619,1818.4546586639153,303,0.8977777777777777,0,3,0,3,6,FALSE
451,2022-03-19T00:02:44Z,2022-03-19T00:37:48Z,2104,1,2022-03-19T00:37:49Z,1,Chrome,96.0.4664.111,CrOS x86_64 14268.67.0,1536,864,no,1.7777777777777777,546,98,661,334,102,190,-0.2712140242051871,-0.11038398349514147,0.904600487181275,2.9031501066607244,0.8403905838513731,1.0284107072488382,1,2,1,1,1,1,1,2,1,1,4,1,1,1,1,1,1,1,1,3,1.3869694338832115,0,1,2,4,5,1.35,0,3,2,1,2,1,2,1,2,1,1,1,3,2,3,4,2,1,2,1,1,1,1,1,4,2,0,0,0,0,1,2,1,3,5,2,4,2,3,2,1,1,1,3,1,1,1,1,1,1,1,3,4,1,1,4,1,1,3,2,1,1,1,1,1,2,2,1,2,2,2,1.513205138039714,1.2909944487358056,1.25,0,1.75,0,1.9333333333333333,0,2.5555555555555554,0,1.25,0,2.3333333333333335,0,1.4285714285714286,0,1.6666666666666667,0,1.8108108108108107,0,2,0,0,-0.7228933053867957,0.07635196034519101,-0.3232706725208024,1,2,4,1,1,2,1,1,1,1.4142135623730951,1.7142857142857142,0,1,-0.5455537974051633,2,4,4,4,1,2,3,3,5,NA,2,1.2149857925879117,4,2.857142857142857,0,-0.6459459576482172,1,-0.7105599897410269,2,4,2,2,1,5,3,4,4,2,5,3,3,3,2,2,4,5,2,3,0.9856107606091623,2.2,0,4.4,0,2.4,0,3.2,0,3.3333333333333335,0,1,1,1,3,1,1,1,3,2,1,2,2,1,1,1,2,1,2,1,1,0.6863327411532597,1.45,0,1,1,1,3,1,1,1,3,2,1,2,2,1,1,1,2,1,2,1,1,0.6863327411532597,1.45,0,"I lived with my mother, but not father, most of the time.",0,"White, Caucasian, Anglo, European American",0,29,1,2,NA,1,1,4,unemployed,1,160,57,1,5,2,0,0,0,0,0,"I lived with my mother, but not father, most of the time.",0,TRUE,TRUE,TRUE,TRUE,TRUE,3,0.7480125000011176,0.5582161290299508,0.6385000000074506,0.7816500000003725,0.6908967741900874,0.7082937500029802,1,1,1,1,0.96875,1,0.097,0.381,0.406,0.017,1.566,71.70382731835375,1874.3046160637507,0.099,0.381,0.411,0.015,1.674,82.32953830744277,1864.3207371009757,338,1.0014814814814814,0,3,0,0,3,FALSE
452,2022-03-19T00:18:58Z,2022-03-19T00:39:57Z,1258,1,2022-03-19T00:39:59Z,0.8999999761581421,Chrome,99.0.4844.74,Windows NT 10.0,1366,768,NA,1.7786458333333333,595,96,275,68,54,92,-0.1706429515586403,-0.1214083253068265,-0.49579624328839883,-0.371976760313599,-0.14256426149489335,-0.07238813230635024,2,2,2,1,2,1,1,2,1,2,2,1,1,1,2,2,1,1,2,3,0.9733285267845752,0,1,3,3,3,1.6,0,1,1,2,1,2,1,1,1,1,1,1,1,2,1,1,1,1,1,1,1,1,1,1,2,2,0,0,0,0,1,1,1,1,1,1,1,1,1,1,1,1,1,2,1,1,1,1,1,1,1,1,1,2,1,2,1,1,2,2,1,1,1,1,1,1,1,1,1,1,1,1.8776382839954893,1.9073791542572855,1,0,1,0,1.2,0,1,0,1.0833333333333333,0,1.3333333333333333,0,1.2857142857142858,0,1,0,1.135135135135135,0,1,0,0,-1.4478869840726245,-0.4013584353189139,-0.9246227096957692,1,1,1,1,1,1,1,1,1,1.9518001458970664,1,0,1,-0.9598956828029438,5,5,5,5,3,4,5,6,7,2,3,1.5275252316519468,6.5,4.571428571428571,0,0.09886109181130473,0,0.6725592714017276,2,2,2,2,2,4,5,4,4,3,4,4,1,5,4,3,5,5,5,4,1.4474937289114918,2,0,4.4,0,3.4,0,4.2,0,4,0,1,1,2,3,2,2,2,4,2,1,4,3,3,2,2,3,1,1,1,1,0.7863975156570492,2.05,0,1,1,2,3,2,2,2,4,2,1,4,3,3,2,2,3,1,1,1,1,0.7863975156570492,2.05,0,I lived with my mother and father an equal amount of time (joint custody),0,Black or African American,0,30,0,1,NA,1,4,6,Finance Admin,4,300,76,2,5,2,0,0,1,0,0,I lived with my mother and father an equal amount of time (joint custody),0,TRUE,TRUE,TRUE,TRUE,TRUE,3,0.5612875000024214,0.4610500000007451,0.4825656249979511,0.7088066666632891,0.5496562500009313,0.5680125000039116,1,1,1,0.9375,1,1,0.078,0.358,0.651,0.014,1.566,39.57795800042247,1852.5208233051112,0.082,0.359,0.69,0.017,1.692,53.06494769366332,1836.176591524184,352,1.0429629629629629,0,3,0,0,3,FALSE
453,2022-03-19T00:03:37Z,2022-03-19T00:42:19Z,2321,1,2022-03-19T00:42:20Z,0.8999999761581421,Chrome,99.0.4844.51,Windows NT 10.0,1366,768,"I am pretty sure I was in the same income bracket as I am now growing up, but I don't know cause my mom didn't tell us our income.",1.7786458333333333,621,158,877,147,123,123,-0.11727870892986036,0.2203462708554097,1.6882421809156,0.6007112941637377,1.2704333286903646,0.27582374551212774,2,3,2,1,2,1,2,2,1,2,2,1,1,2,2,2,2,2,3,2,0.812727700887249,0,1,1,4,3,1.85,0,3,1,2,2,3,5,3,3,2,3,2,3,3,3,2,3,3,4,3,2,3,2,4,0,1,0,0,1,1,1,1,2,2,3,1,3,1,2,1,2,4,2,4,2,1,2,3,5,4,4,5,2,5,2,4,3,2,1,1,1,4,4,2,2,3,3,1,3,2,2,1.3617468025864259,0.9411239481143202,3,0,2,0,2.6666666666666665,0,1.7777777777777777,0,2.8333333333333335,0,3.5,0,2.142857142857143,0,2.6666666666666665,0,2.5405405405405403,0,0,1,0,0.6812283101619454,0.4223735060017412,0.5518009080818433,2,2,4,3,1,2,2,1,1,0.9511897312113419,2.2857142857142856,0,1,-0.2140802890869389,4,5,4,5,2,2,3,4,6,NA,2,1.2724180205607036,5,3.5714285714285716,0,-0.3749142363789111,1,-0.1582184776150709,3,4,3,2,3,3,4,4,4,4,4,4,4,5,5,4,5,4,4,3,1.2227992865708155,3,0,4,0,4,0,4.2,0,4.066666666666666,0,2,1,3,3,2,3,3,3,3,3,2,2,2,3,2,2,2,2,1,2,0.6569466853317864,2.3,0,2,1,3,3,2,3,3,3,3,3,2,2,2,3,2,2,2,2,1,2,0.6569466853317864,2.3,0,"I lived with my mother, but not father, most of the time.",0,"White, Caucasian, Anglo, European American",0,28,1,2,NA,1,1,4,Disabled,1,116,60,2,5,2,0,0,0,0,0,"I lived with my mother, but not father, most of the time.",0,TRUE,TRUE,TRUE,TRUE,TRUE,6,0.7124937499761581,0.6599906250014901,0.6658468749970198,0.7425062500014902,0.71462903226191,0.7399781249910593,1,1,1,1,1,1,0.112,0.48,0.624,0.011,1.214,3.1193141414461896,1790.0218201293546,0.113,0.48,0.626,0.012,1.251,6.22115995498069,1787.7494620774348,344,1.0192592592592593,0,0,0,0,3,FALSE
454,2022-03-19T00:28:05Z,2022-03-19T00:50:34Z,1349,1,2022-03-19T00:50:34Z,0.8999999761581421,Chrome,99.0.4844.74,Windows NT 10.0,1920,1080,None!,1.7777777777777777,540,105,421,81,57,81,-0.28352884942721324,-0.07179878715424383,0.03388749414313579,-0.21191416907049299,-0.08112958366075168,-0.19594718572581019,3,2,2,1,3,1,1,2,1,2,3,1,1,2,3,2,1,1,3,3,0.7677718959499145,0,1,2,2,2,1.9,0,2,2,3,2,2,1,2,3,2,1,2,2,2,2,3,1,3,5,1,2,2,3,1,2,2,0,0,0,0,2,3,4,2,2,3,4,2,2,1,2,1,1,2,2,1,3,1,1,2,2,3,4,1,2,3,1,1,2,1,1,1,2,1,1,1,1,2,2,2,1,1.3378302544754286,1.1254628677422756,2.25,0,1.75,0,2.066666666666667,0,2.6666666666666665,0,1.5833333333333333,0,2.3333333333333335,0,1.2857142857142858,0,1,0,1.864864864864865,0,1,0,0,-0.20400019188805987,-0.14280879051279902,-0.17340449120042944,1,1,2,1,1,1,1,1,1,1.7320508075688772,1.1428571428571428,0,1,-0.8770273057233877,4,4,5,5,3,4,5,8,6,4,3,1.3801311186847085,7,4.285714285714286,0,0.6173603799487777,0,0.8337583288054001,3,3,3,5,4,3,4,4,3,3,5,4,2,4,4,5,4,5,4,3,1.1952286093343936,3.6,0,4.2,0,3.6,0,3.6,0,3.8,0,1,1,1,3,1,1,3,2,1,1,3,1,1,2,2,1,1,1,1,2,1.0563093645728086,1.5,0,1,1,1,3,1,1,3,2,1,1,3,1,1,2,2,1,1,1,1,2,1.0563093645728086,1.5,0,I lived with my mother and father an equal amount of time (joint custody),0,"White, Caucasian, Anglo, European American",0,29,1,2,NA,1,2,6,Homemaker,3,120,61,1,5,2,0,0,0,0,0,I lived with my mother and father an equal amount of time (joint custody),0,TRUE,TRUE,TRUE,TRUE,TRUE,1,0.5713433333307505,0.500159374997951,0.5028937499979511,0.6063612903173893,0.5574258064454601,0.607093333329757,0.967741935483871,1,1,0.96875,0.96875,0.967741935483871,0.099,0.351,0.645,0.012,1.398,110.12533358914669,1944.9840067766954,0.1,0.353,0.661,0.012,1.449,115.74526458777292,1938.357504877839,236,0.6992592592592592,0,3,0,0,3,FALSE
456,2022-03-19T00:38:44Z,2022-03-19T00:57:14Z,1110,1,2022-03-19T00:57:15Z,0.8999999761581421,Chrome,99.0.4844.51,Macintosh,1440,900,The survey was extremely fun and interesting.,1.6,655,50,204,42,42,73,-0.04749469933837891,-0.37496818697558243,-0.753382170395515,-0.6921019427998111,-0.38830297283146,-0.2858083154854174,1,2,2,2,2,1,1,2,1,2,2,1,2,1,2,2,1,1,3,2,0.9880869341680844,0,1,1,4,4,1.65,0,1,1,2,1,1,1,2,2,1,1,1,2,4,2,1,1,1,1,1,1,1,1,1,0,2,0,0,0,0,1,1,4,2,1,1,2,1,2,1,1,1,1,2,4,2,1,1,1,1,1,1,1,1,1,1,1,1,1,1,1,5,1,1,1,1,1,1,1,1,1,1.7264068119885534,1.7320508075688772,1,0,1,0,1.5333333333333334,0,1.6666666666666667,0,1.4166666666666667,0,1,0,1.5714285714285714,0,1,0,1.4054054054054055,0,0,0,0,-1.184109756421522,-0.6205191861769039,-0.9023144712992129,2,1,4,2,1,1,2,1,1,1.0690449676496976,1.8571428571428572,0,1,-0.4626854203256071,3,3,3,3,1,1,5,3,3,1,2,1.0690449676496976,3,2.7142857142857144,0,-1.0918920336024696,0,-1.0598141622426434,1,1,1,2,2,4,4,4,2,4,4,4,5,4,5,5,5,5,4,1,1.52127765851133,1.4,0,4.4,0,4.4,0,3.2,0,4,0,1,1,1,1,1,1,2,1,1,1,1,2,1,1,1,3,1,1,1,1,1,1.2,0,1,1,1,1,1,1,2,1,1,1,1,2,1,1,1,3,1,1,1,1,1,1.2,0,I lived with my mother and father an equal amount of time (joint custody),0,"White, Caucasian, Anglo, European American",0,18,0,1,NA,1,3,3,Team Leader at a fast food establishment,1,170,69,5,5,2,0,0,1,0,0,I lived with my mother and father an equal amount of time (joint custody),0,TRUE,TRUE,TRUE,TRUE,TRUE,6,0.5283062500003726,0.6433933333362143,0.5061096774185857,0.6082838709666845,0.8036250000004657,0.5948433333342273,1,0.967741935483871,1,1,1,0.9375,0.062,0.379,0.46,0.021,1.787,72.86289470343466,1950.9045046029553,0.063,0.383,0.483,0.025,1.87,89.37220140638533,1961.5284437281555,446,1.3214814814814815,0,3,0,3,6,FALSE
458,2022-03-19T00:36:04Z,2022-03-19T01:01:44Z,1539,1,2022-03-19T01:01:45Z,1,Opera,84.0.4316.36,Windows NT 10.0,1920,1080,NA,1.7777777777777777,622,98,388,75,47,73,-0.11522623805952267,-0.11038398349514147,-0.08583554239960833,-0.28578921118269573,-0.28591184310789053,-0.2858083154854174,3,4,4,4,4,3,4,4,4,4,4,3,2,2,4,4,4,4,4,4,1.332784974957958,0,0,1,2,1,3.65,0,5,4,3,4,4,5,5,5,4,3,4,5,1,5,5,5,5,1,1,5,5,5,4,10,2,0,0,0,0,3,1,5,2,5,1,4,1,2,2,2,5,3,1,2,5,2,5,5,5,5,5,1,1,1,5,5,1,5,5,5,3,3,4,3,5,5,5,5,5,5,1.6421622017013717,1.5522640914238175,3.875,0,5,0,4.133333333333334,0,2.6666666666666665,0,3.5,0,3,0,3.7142857142857144,0,4.333333333333333,0,3.324324324324324,0,5,0,0,2.0470628579658072,1.8542160070789921,1.9506394325223997,5,5,5,5,5,5,4,8,1,1.889822365046136,4.857142857142857,0,4.5,2.630318707051812,2,2,2,2,1,1,1,1,2,NA,1,1.3451854182690985,1.5,1.5714285714285714,0,-1.8399273887137941,1,-2.135194450850569,2,2,2,3,3,4,4,4,4,2,5,3,5,4,5,3,3,4,4,4,1.1751393027860062,2.4,0,3.8,0,3.6,0,4.2,0,3.8666666666666667,0,3,4,4,3,3,4,2,4,4,4,4,4,4,4,2,4,4,4,4,4,1.1821033884786185,3.65,0,3,4,4,3,3,4,2,4,4,4,4,4,4,4,2,4,4,4,4,4,1.1821033884786185,3.65,0,"I lived with my mother and father an equal amount of time (joint custody) & I lived with my extended family on mother's side (grandparents, aunts ,uncles, cousins)",1,"Hispanic of Latino (e.g., Mexican American, Central American, and others) & White, Caucasian, Anglo, European American",1,19,1,2,NA,1,2,1,Student,7,112,62,2,5,2,0,0,0,0,0,"I lived with my mother and father an equal amount of time (joint custody) & I lived with my extended family on mother's side (grandparents, aunts ,uncles, cousins)",1,TRUE,TRUE,TRUE,TRUE,TRUE,3,0.4229781249985099,0.40920000000484286,0.41734838709523603,0.5397499999920528,0.4969437499959022,0.5022258064496902,1,1,0.96875,0.9375,1,0.96875,0.052,0.32,0.515,0.018,1.654,119.98598329965968,2027.254759059765,0.056,0.314,0.521,0.021,1.715,142.5304734803329,2014.4011226790255,449,1.3303703703703704,0,3,0,0,3,FALSE
459,2022-03-19T00:42:29Z,2022-03-19T01:02:00Z,1171,1,2022-03-19T01:02:02Z,0.8999999761581421,Chrome,99.0.4844.74,Windows NT 10.0,1920,1080,No.,1.7777777777777777,592,70,257,41,96,59,-0.17680036416965336,-0.26472476885873203,-0.5610997177662592,-0.7044144498185115,0.7175212281830898,-0.44306529256473004,2,2,1,1,2,1,1,3,1,2,2,1,2,1,2,2,1,1,3,3,0.9119095061289915,0,1,1,3,3,1.7,0,4,2,3,3,3,3,3,3,3,3,3,3,3,3,3,4,4,4,2,3,3,3,4,1,2,0,0,0,0,4,4,4,4,4,2,4,4,4,3,4,3,2,4,2,3,3,3,4,3,4,4,4,4,4,3,2,2,2,1,1,2,3,3,2,2,3,2,3,2,3,0.8647240876416868,0.3779644730092272,3.375,0,2.5,0,3,0,3.7777777777777777,0,3.1666666666666665,0,3.5,0,2,0,2.3333333333333335,0,3.081081081081081,0,1,0,0,1.226991268119171,0.11574085429331589,0.6713660612062434,2,2,3,2,1,2,2,3,3,0.9511897312113419,2,0,3,0.3931933617292298,4,4,4,4,3,3,5,4,4,NA,3,1.1126972805283737,4,3.857142857142857,0,-0.12954382975590517,1,0.14620102477518104,3,3,3,3,3,3,3,3,3,2,2,3,3,3,4,3,3,4,2,3,0.5936168397046637,3,0,3,0,2.6,0,3.2,0,2.933333333333333,0,1,1,2,2,2,2,2,3,2,2,2,3,2,2,1,3,1,2,2,2,0.4893604849295929,1.95,0,1,1,2,2,2,2,2,3,2,2,2,3,2,2,1,3,1,2,2,2,0.4893604849295929,1.95,0,"I lived with my mother, but not father, most of the time.",0,"White, Caucasian, Anglo, European American",0,19,0,1,NA,1,3,4,NA,7,185,72,3,5,2,0,0,0,0,0,"I lived with my mother, but not father, most of the time.",0,TRUE,TRUE,TRUE,TRUE,TRUE,1,0.4837968750006985,0.45688750000006983,0.455109375,0.5742103448280229,0.5250533333335072,0.5743586206899891,1,1,1,0.90625,0.967741935483871,0.90625,0.062,0.35,0.57,0.012,1.775,92.8993246060331,1972.2483496476075,0.062,0.35,0.597,0.012,1.753,114.61575878477689,1970.8365676061435,318,0.9422222222222223,0,3,0,0,3,FALSE
460,2022-03-19T00:44:55Z,2022-03-19T01:09:26Z,1470,1,2022-03-19T01:09:27Z,0.8999999761581421,Chrome,99.0.4844.74,Windows NT 10.0,1536,864,NA,1.7777777777777777,537,79,437,197,50,97,-0.2896862620382263,-0.21511523070614935,0.09193502701234507,1.216336645098761,-0.22447716527374886,-0.01622492620659573,2,2,1,2,2,1,1,2,1,2,2,1,1,1,2,2,1,1,2,2,0.998683343734455,0,1,1,3,3,1.55,0,4,2,1,2,1,1,2,2,1,1,2,2,3,2,3,2,3,1,1,1,2,2,1,1,2,0,0,0,0,2,3,2,2,4,2,4,4,3,2,2,4,1,2,1,3,2,2,2,2,2,2,1,1,1,3,1,2,3,3,1,1,1,2,1,1,1,2,1,2,2,1.2099437854561526,1.3020130933435712,1.625,0,1.75,0,1.9333333333333333,0,2.888888888888889,0,2.0833333333333335,0,1.5,0,1.8571428571428572,0,1,0,2.054054054054054,0,1,0,0,-0.45271849572176753,-0.14280879051279902,-0.29776364311728326,2,2,3,2,1,2,2,4,3,0.9511897312113419,2,0,3.5,0.5864459629730501,4,4,4,4,3,3,5,1,1,NA,4,1.1126972805283737,1,3.857142857142857,0,-0.4262368656715114,1,-0.034648909489103485,2,2,3,3,2,4,4,2,4,3,3,4,4,4,4,3,5,4,3,2,0.9611501047232549,2.4,0,4,0,3.4,0,3.2,0,3.533333333333333,0,2,2,2,1,2,2,3,3,2,2,2,3,3,3,2,3,1,2,1,2,0.6708203932499369,2.15,0,2,2,2,1,2,2,3,3,2,2,2,3,3,3,2,3,1,2,1,2,0.6708203932499369,2.15,0,I lived with my mother and father an equal amount of time (joint custody),0,"White, Caucasian, Anglo, European American",0,27,0,1,NA,1,3,6,Tech Support Specialist,2,165,69,2,5,2,0,0,1,0,0,I lived with my mother and father an equal amount of time (joint custody),0,TRUE,TRUE,TRUE,TRUE,TRUE,1,0.5806437499932945,0.4933625000193715,0.5491218750029803,0.641568965533684,0.5723281250149012,0.6260437500029803,1,1,1,0.9354838709677419,1,1,0.086,0.392,0.518,0.019,1.53,60.95273239659481,1862.2588620066447,0.088,0.394,0.553,0.022,1.699,90.47438107150091,1874.5481099507085,320,0.9481481481481481,0,3,0,0,3,FALSE
461,2022-03-19T00:53:14Z,2022-03-19T01:19:22Z,1567,1,2022-03-19T01:19:24Z,0.800000011920929,Firefox,98.0,Windows NT 10.0,2560,1440,NA,1.7777777777777777,581,296,398,88,80,72,-0.19937754374336794,0.9810258558616775,-0.04955583435635254,-0.12572661993958972,0.38986961306766765,-0.2970409567053683,2,2,2,2,2,1,2,2,1,2,3,3,3,3,3,3,2,1,3,3,0.7163503994113789,0,1,2,4,4,2.25,0,4,4,4,3,4,4,4,4,4,4,3,4,1,4,2,2,3,1,1,2,2,4,2,0,2,0,0,0,0,2,4,2,2,3,1,2,1,1,3,3,2,1,2,3,1,5,4,3,3,3,3,2,2,1,1,1,1,1,1,1,2,2,4,1,1,1,2,2,3,2,1.4415540496554675,1.0690449676496976,2.125,0,2.25,0,3.533333333333333,0,2,0,2.75,0,1.6666666666666667,0,1.7142857142857142,0,1,0,2.054054054054054,0,0,0,0,0.4649900380912473,-0.18960311150004575,0.13769346329560078,2,2,4,2,2,2,2,1,2,0.7559289460184544,2.2857142857142856,0,1.5,-0.020827687843118697,5,4,5,3,1,1,3,1,1,1,2,1.6761634196950514,1,3.142857142857143,0,-1.4532676619615443,0,-1.047811426730423,2,2,2,2,2,4,4,4,4,4,4,4,5,4,3,2,4,3,4,3,1.0327955589886444,2,0,3.8,0,3.8,0,3.6,0,3.7333333333333334,0,2,2,2,1,2,3,1,2,1,2,1,2,2,2,1,1,1,3,1,1,0.998683343734455,1.65,0,2,2,2,1,2,3,1,2,1,2,1,2,2,2,1,1,1,3,1,1,0.998683343734455,1.65,0,I lived with my mother and father an equal amount of time (joint custody),0,"White, Caucasian, Anglo, European American",0,25,0,1,NA,1,3,6,broker,5,270,68,1,5,2,0,1,0,0,1,I lived with my mother and father an equal amount of time (joint custody),0,TRUE,TRUE,TRUE,TRUE,TRUE,6,0.6437419354838709,0.60071875,0.65640625,0.7383870967741936,0.7133870967741935,0.924125,1,1,1,0.96875,0.96875,1,0.209,0.213,0.458,0.004,1.29,26.763210089964243,1815.6460876724038,0.202,0.209,0.457,0.004,1.309,26.445402931535664,1808.0844656731363,172,0.5096296296296297,0,3,0,0,3,FALSE
462,2022-03-19T00:51:18Z,2022-03-19T01:19:46Z,1707,1,2022-03-19T01:19:46Z,1,Edge,99.0.1150.39,Windows NT 10.0,1600,900,No. Thanks!,1.7777777777777777,779,128,481,85,53,80,0.2070116885834946,0.05498114368013412,0.25156574240267054,-0.16266414099569113,-0.16304248743960723,-0.2071798269457611,2,2,1,1,1,1,1,2,1,2,1,1,1,1,1,2,1,1,2,2,1.2258187382102494,0,1,2,2,2,1.35,0,3,4,3,3,4,2,4,3,3,3,4,3,1,3,3,3,3,1,2,3,3,4,3,1,1,2,0,0,0,3,3,2,3,3,2,3,3,3,3,2,2,2,4,4,2,4,3,3,4,4,5,1,1,1,1,2,2,1,1,1,3,4,4,2,3,3,2,2,3,2,1.1068989227681203,0.7745966692414834,2.75,0,2.25,0,3.066666666666667,0,2.7777777777777777,0,3.0833333333333335,0,1.8333333333333333,0,2.2857142857142856,0,2.6666666666666665,0,2.6216216216216215,0,1,0,0,0.7822116816433009,0.029557639357944268,0.4058846605006226,4,3,4,3,1,3,3,3,1,0.7867957924694432,3,0,2,0.5867667987984821,2,3,3,2,1,2,3,4,10,2,2,0.7559289460184544,7,2.2857142857142856,0,-0.15506308636046787,0,-0.7210479807461602,2,2,1,2,2,4,4,4,5,3,4,4,4,5,4,4,4,5,3,3,1.2071217242444348,1.8,0,4.2,0,3.6,0,4.2,0,4,0,1,1,2,1,1,2,2,2,1,1,2,1,2,2,1,2,2,2,1,2,0.9445132413883326,1.55,0,1,1,2,1,1,2,2,2,1,1,2,1,2,2,1,2,2,2,1,2,0.9445132413883326,1.55,0,NA,NA,Native American/Alaskan Native/indigenous,0,28,1,2,NA,1,2,6,Office Worker,2,120,64,2,5,2,0,0,1,0,0,NA,NA,TRUE,TRUE,TRUE,TRUE,TRUE,6,0.6143406249992549,0.5523718749843538,0.5395875000096857,0.6981032258041443,0.5969468749985098,0.7192093750014901,1,1,1,1,1,1,0.112,0.309,0.399,0.016,1.844,164.41584720079007,1966.3285730793946,0.11,0.318,0.408,0.018,1.964,178.183068431486,1964.768066481921,364,1.0785185185185184,0,3,0,0,3,FALSE
463,2022-03-19T00:47:46Z,2022-03-19T01:20:48Z,1981,1,2022-03-19T01:20:49Z,0.8999999761581421,Chrome,99.0.4844.74,Windows NT 10.0,1920,1080,NA,1.7777777777777777,880,180,360,36,16,49,0.4143112464876013,0.34161403078394514,-0.18741872492072456,-0.7659769849120138,-0.920736847394021,-0.555391704764239,1,1,1,1,1,1,1,1,1,1,1,1,1,1,1,1,1,1,1,1,1.538967528127731,0,1,2,3,2,1,0,3,2,3,3,3,3,4,4,3,3,2,3,1,3,3,3,1,1,1,3,3,3,3,0,2,0,0,0,0,2,2,2,2,2,2,2,2,2,1,2,5,1,2,3,2,3,4,5,5,5,4,1,1,1,3,1,1,1,1,1,1,1,1,1,1,3,1,1,1,1,1.5725689088154367,0.7432233529572065,2.25,0,1,0,2.8666666666666667,0,2,0,3.1666666666666665,0,1.8333333333333333,0,1,0,1.6666666666666667,0,2.135135135135135,0,0,0,0,0.2637122654992679,-0.6205191861769039,-0.17840346033881802,1,1,1,1,1,1,1,3,1,1.9518001458970664,1,0,2,-0.5733904803153034,5,5,5,5,3,3,5,4,4,2,4,1.5735915849388864,4,4.428571428571429,0,-0.00859035837599742,0,0.5296352900683985,2,2,1,4,3,2,1,2,2,3,4,4,3,4,4,4,4,4,3,3,0.990430401872025,2.4,0,3.6,0,2.8,0,3,0,3.1333333333333333,0,1,1,1,4,1,1,1,2,1,1,1,2,1,1,1,1,1,1,1,1,0.8750939799154206,1.25,0,1,1,1,4,1,1,1,2,1,1,1,2,1,1,1,1,1,1,1,1,0.8750939799154206,1.25,0,I lived with my mother and father an equal amount of time (joint custody),0,"White, Caucasian, Anglo, European American",0,28,0,1,NA,1,2,4,Sales rep,2,225,71,1,5,2,0,0,1,0,0,I lived with my mother and father an equal amount of time (joint custody),0,TRUE,TRUE,TRUE,TRUE,TRUE,6,0.5784799999999504,0.6100250000001397,0.6804718749998138,0.6268624999991153,0.6625448275845627,0.7704241379311887,0.967741935483871,1,1,1,0.9354838709677419,0.9354838709677419,0.075,0.505,0.422,0.016,1.719,204.63208816311854,2136.2774479490404,0.074,0.506,0.398,0.017,1.776,219.95915451961315,2087.754874360332,344,1.0192592592592593,0,3,0,9,12,FALSE
464,2022-03-19T01:04:15Z,2022-03-19T01:22:24Z,1089,1,2022-03-19T01:22:25Z,0.8999999761581421,Chrome,99.0.4844.51,Windows NT 10.0,1280,720,NA,1.7777777777777777,459,73,256,65,52,72,-0.4497789899245661,-0.24818825614120446,-0.5647276885705849,-0.4089142813697004,-0.1835207133843211,-0.2970409567053683,3,1,1,1,3,1,1,4,1,3,4,1,1,1,3,3,1,1,3,4,0.7591546545162482,0,1,2,2,1,2.05,0,5,3,4,3,5,4,4,4,3,4,5,5,1,5,4,3,4,1,1,5,5,4,4,0,2,0,0,0,0,2,4,3,3,4,1,2,2,4,3,1,5,1,3,2,3,4,5,5,5,5,4,1,1,1,2,1,1,1,2,1,4,4,4,1,1,5,2,3,1,2,1.5368350145223337,1.4573295865416045,3.375,0,2,0,3.933333333333333,0,2.7777777777777777,0,3.5,0,1.6666666666666667,0,2.4285714285714284,0,2.3333333333333335,0,2.72972972972973,0,0,0,0,1.4813197592573977,-0.2757863264354174,0.6027667164109901,2,2,5,2,1,3,1,1,1,1.1547005383792515,2.2857142857142856,0,1,-0.2140802890869389,5,5,5,4,3,3,4,6,4,3,2,1.2149857925879117,5,4.142857142857143,0,-0.3023610241956905,0,0.1957132964346883,3,3,3,2,3,3,3,4,4,3,5,3,4,3,4,1,3,4,3,5,1.0465362369445672,2.8,0,3.6,0,2.8,0,4,0,3.466666666666667,0,1,1,2,3,3,2,2,4,3,1,4,3,1,2,3,3,1,2,3,2,0.8583950752789521,2.3,0,1,1,2,3,3,2,2,4,3,1,4,3,1,2,3,3,1,2,3,2,0.8583950752789521,2.3,0,I lived with my mother and father an equal amount of time (joint custody),0,"White, Caucasian, Anglo, European American",0,21,1,2,NA,1,2,4,"student, unemployed",3,186,64,2,5,1,0,0,1,1,0,I lived with my mother and father an equal amount of time (joint custody),0,TRUE,TRUE,TRUE,TRUE,TRUE,4,0.42322333332896234,0.40950967741589395,0.42065806452112814,0.5813227272711017,0.47518333332737284,0.5694681818160143,0.9375,0.96875,0.96875,0.6875,0.75,0.6875,0.056,0.284,0.39,0.009,1.754,97.05867955797596,2068.228869813266,0.055,0.286,0.409,0.01,1.856,128.63779659959576,2072.003139359872,360,1.0666666666666667,0,3,0,0,3,FALSE
466,2022-03-19T01:06:12Z,2022-03-19T01:29:13Z,1381,1,2022-03-19T01:29:14Z,0.8999999761581421,Chrome,99.0.4844.51,Macintosh,1440,900,NA,1.6,857,71,235,36,29,85,0.36710441646983444,-0.2592125979528895,-0.640915075461422,-0.7659769849120138,-0.6545199101127405,-0.15101662084600656,3,3,1,1,4,1,1,3,1,3,4,1,1,2,4,4,1,1,4,4,0.4442616583193193,0,1,1,2,2,2.35,0,3,3,2,3,2,2,3,3,2,3,3,2,3,4,3,2,2,3,3,4,2,3,3,1,1,2,0,2,1,3,2,4,3,3,3,4,2,3,2,3,4,3,3,3,4,3,3,4,3,2,3,2,2,3,3,3,3,2,3,3,2,3,3,3,2,3,4,2,2,3,0.6139029865352317,0.5936168397046637,2.75,0,2.75,0,2.7333333333333334,0,3,0,3.0833333333333335,0,2.6666666666666665,0,2.7142857142857144,0,2.6666666666666665,0,2.891891891891892,0,1,1,0,0.7546528668140811,0.9000839016658461,0.8273683842399635,3,4,3,2,3,3,2,3,2,0.6900655593423543,2.857142857142857,0,2.5,0.6971510229627462,2,2,3,3,2,3,3,6,8,6,3,0.5345224838248488,7,2.5714285714285716,0,1.045515760996482,0,0.16562106175315516,3,2,3,3,2,4,3,3,4,3,3,2,3,4,2,3,3,2,3,3,0.6399404734221844,2.6,0,2.8,0,3,0,3.2,0,3,0,2,3,2,3,3,3,3,4,1,1,1,3,1,1,2,4,2,2,1,1,0.7863975156570492,2.15,0,2,3,2,3,3,3,3,4,1,1,1,3,1,1,2,4,2,2,1,1,0.7863975156570492,2.15,0,I lived with my mother and father an equal amount of time (joint custody),0,"Asian or Asian American (e.g., Chinese, Japanese, and others)",0,22,0,1,NA,1,4,4,nursing,3,170,67,3,5,2,0,0,1,0,0,I lived with my mother and father an equal amount of time (joint custody),0,TRUE,TRUE,TRUE,TRUE,TRUE,6,0.7638538461533877,0.7030965517240352,0.7795774193559923,0.7992583333334575,0.8043722222215599,0.9495880000007153,0.896551724137931,0.9354838709677419,0.96875,0.8,0.5806451612903226,0.8333333333333334,0.093,0.308,0.257,0.006,1.994,149.91490393534804,2115.2763482541086,0.092,0.309,0.228,0.007,2.079,158.07044252939866,2059.035571663966,304,0.9007407407407407,1,3,0,0,3,FALSE
467,2022-03-19T01:15:32Z,2022-03-19T01:33:45Z,1093,1,2022-03-19T01:33:47Z,1,Firefox,98.0,Macintosh,1440,900,NA,1.6,505,63,251,53,45,64,-0.35536532988903236,-0.30330996519962966,-0.5828675425922127,-0.5566643655941059,-0.3268682949973183,-0.38690208646497554,3,2,2,2,3,1,1,2,1,3,4,2,2,2,3,2,2,1,2,3,0.6863327411532597,0,1,2,1,3,2.15,0,3,4,4,3,4,4,3,4,3,2,3,4,1,4,4,3,4,1,1,3,5,4,5,4,2,0,0,0,0,2,4,4,4,5,1,1,1,3,1,3,5,1,3,2,1,5,4,5,5,4,4,1,1,1,4,1,1,3,1,1,5,5,4,1,4,3,3,2,3,1,1.6186785104276018,0.9411239481143202,3.25,0,2.25,0,3.3333333333333335,0,2.7777777777777777,0,3.25,0,2,0,2.857142857142857,0,2.6666666666666665,0,2.810810810810811,0,2,0,0,1.19992457498333,0.24871839021593428,0.7243214825996321,2,1,3,1,1,3,1,1,1,1.2909944487358056,1.7142857142857142,0,1,-0.5455537974051633,3,3,4,3,1,1,3,3,3,NA,2,1.1338934190276817,3,2.5714285714285716,0,-0.9169776789175231,1,-1.0306214065179669,2,3,2,3,2,4,5,4,4,3,5,4,3,3,3,5,5,4,4,2,1.2798809468443688,2.4,0,4.4,0,4,0,3.2,0,3.8666666666666667,0,2,3,3,4,3,3,4,3,3,1,4,3,2,3,1,3,1,3,3,4,1,2.8,0,2,3,3,4,3,3,4,3,3,1,4,3,2,3,1,3,1,3,3,4,1,2.8,0,I lived with my mother and father an equal amount of time (joint custody),0,"White, Caucasian, Anglo, European American",0,24,1,1,NA,1,2,3,Retail,2,175,64,2,5,2,0,0,0,0,0,I lived with my mother and father an equal amount of time (joint custody),0,TRUE,TRUE,TRUE,TRUE,TRUE,6,0.52028125,0.40975,0.44378125,0.5515,0.5079655172413793,0.5654814814814815,1,1,1,0.875,0.90625,0.84375,0.057,0.346,0.52,0.012,1.685,49.12936329030435,1917.9257942511279,0.059,0.345,0.595,0.013,1.789,43.55021302274506,1907.7563156578274,378,1.12,0,3,0,0,3,FALSE
468,2022-03-19T00:56:53Z,2022-03-19T01:37:44Z,2450,1,2022-03-19T01:37:45Z,0.8999999761581421,Chrome,99.0.4844.74,Windows NT 10.0,1536,864,No.,1.7777777777777777,1245,136,710,69,129,90,1.163463114160858,0.09907851092687428,1.0823710565932283,-0.35966425329489854,1.393302684358648,-0.09485341474625206,2,2,2,1,2,1,2,3,1,2,3,1,1,1,2,2,1,2,2,2,0.8870412083230169,0,1,2,2,1,1.75,0,5,3,5,4,5,3,5,5,5,4,5,5,2,5,4,5,5,5,2,5,5,5,5,40,2,0,0,0,0,5,5,4,3,4,5,4,4,5,4,5,5,5,5,2,2,5,5,5,5,5,5,5,5,5,5,5,2,5,5,5,2,2,3,4,5,5,4,5,5,5,1.6598961579735207,1.6903085094570331,4.625,0,4.75,0,4.333333333333333,0,4.333333333333333,0,4.416666666666667,0,5,0,3.4285714285714284,0,4.666666666666667,0,4.324324324324325,0,6,0,0,2.899220782220749,1.9871935430016106,2.4432071626111798,4,4,3,4,2,5,5,8,5,1.2724180205607036,3.857142857142857,0,6.5,2.8232504724702006,2,3,3,1,2,1,2,4,4,2,2,1.1126972805283737,4,2,0,-0.69712652889908,0,-1.2063174174006965,1,4,2,3,3,5,5,5,5,2,5,5,4,5,4,5,5,5,5,3,1.820517979665599,2.6,0,5,0,4.2,0,4.4,0,4.533333333333333,0,3,4,4,4,3,4,4,3,3,4,4,3,4,4,3,4,2,3,1,4,1.1239029738980326,3.4,0,3,4,4,4,3,4,4,3,3,4,4,3,4,4,3,4,2,3,1,4,1.1239029738980326,3.4,0,NA,NA,"White, Caucasian, Anglo, European American",0,28,1,2,NA,1,2,3,Prep Cook,1,170,65,3,5,2,1,0,2,0,1,NA,NA,TRUE,TRUE,TRUE,TRUE,TRUE,6,0.6594749999791384,0.5364468749761582,0.6164290322795991,0.8014499999880791,0.5678406250178814,0.6103875000178814,1,1,1,1,1,1,0.125,0.345,0.595,0.023,1.403,36.99335934548967,1837.8832420505337,0.127,0.346,0.602,0.024,1.481,54.919906980689035,1836.2928239872242,386,1.1437037037037037,0,3,0,3,6,FALSE
469,2022-03-19T00:34:15Z,2022-03-19T01:41:00Z,4004,1,2022-03-19T01:41:01Z,1,Chrome,98.0.4758.109,Macintosh,1440,900,none,1.6,1189,108,714,98,51,87,1.0485247454219475,-0.055262274436716274,1.0968829398105306,-0.002601549752585081,-0.20399893932903498,-0.12855133840610475,3,3,3,2,4,2,3,3,3,3,3,3,3,3,3,4,3,2,3,4,0.6958523739384593,0,0,3,1,1,3,0,3,2,4,4,3,4,2,3,2,3,4,5,3,4,4,2,4,5,1,2,4,3,3,0,2,0,0,0,0,4,5,4,4,3,4,5,5,4,1,3,2,3,3,2,2,4,4,3,5,4,5,4,1,3,3,1,1,1,4,1,2,1,1,1,1,3,1,3,3,4,1.244205790071742,0.9611501047232549,3,0,2.75,0,3.3333333333333335,0,4.222222222222222,0,3,0,2.8333333333333335,0,1.5714285714285714,0,1.6666666666666667,0,2.891891891891892,0,0,0,0,1.1261063209764917,-0.017236681629302503,0.5544348196735945,3,2,3,3,2,2,2,3,2,0.5345224838248488,2.4285714285714284,0,2.5,0.44854589172407777,5,5,5,5,3,4,4,3,3,5,4,1.2149857925879117,3,4.428571428571429,0,0.45295489901602165,0,0.8109712816657271,4,3,3,4,4,4,4,4,3,4,5,3,5,3,4,1,4,5,4,4,1.3020130933435712,3.6,0,4.2,0,3.6,0,3.6,0,3.8,0,4,4,4,4,4,4,1,3,4,4,4,4,2,3,1,4,3,4,2,4,1.3088765773505315,3.35,0,4,4,4,4,4,4,1,3,4,4,4,4,2,3,1,4,3,4,2,4,1.3088765773505315,3.35,0,I lived with my mother and father an equal amount of time (joint custody),0,"White, Caucasian, Anglo, European American",0,23,1,2,NA,1,2,3,Direct Support Professional,2,135,66,2,4,2,0,0,1,1,0,I lived with my mother and father an equal amount of time (joint custody),0,TRUE,TRUE,TRUE,TRUE,TRUE,3,0.6248781250012108,0.48431250000046566,0.5271466666678587,0.6846645161293207,0.5237466666668653,0.5689827586206897,1,1,0.967741935483871,0.96875,0.967741935483871,0.9354838709677419,0.042,0.445,0.482,0.033,1.593,59.875895672592684,1966.1078405754906,0.043,0.447,0.527,0.03,1.663,78.12174289038768,1966.7186551398167,304,0.9007407407407407,1,3,0,0,3,FALSE
470,2022-03-19T00:48:27Z,2022-03-19T01:43:29Z,3301,1,2022-03-19T01:43:31Z,0.8999999761581421,Chrome,99.0.4844.51,Windows NT 6.1,1366,768,NA,1.7786458333333333,2344,126,471,101,69,108,3.419128600661979,0.04395680186844908,0.21528603435941476,0.03433597130351631,0.16460912767581495,0.1073341272128642,2,1,2,1,2,1,1,2,1,1,3,2,2,1,2,2,1,1,2,2,1.0563093645728086,0,1,4,3,2,1.6,0,5,3,3,3,4,1,4,5,5,3,3,4,5,4,3,5,5,5,3,5,5,4,4,2,2,0,0,0,0,1,1,5,3,1,1,5,2,1,1,3,5,5,3,5,1,5,5,5,5,5,5,3,5,5,5,3,3,3,1,1,3,3,2,1,3,4,3,5,4,2,1.5552874071755738,1.3093073414159542,4.5,0,3.5,0,3.6666666666666665,0,2.2222222222222223,0,4,0,4.333333333333333,0,2.2857142857142856,0,2.6666666666666665,0,3.189189189189189,0,1,0,0,2.057200564849413,0.46047371403480236,1.2588371394421076,4,3,5,3,1,3,3,1,1,0.9511897312113419,3.142857142857143,0,1,0.2831299733903977,4,4,4,4,1,1,2,2,3,NA,2,1.4638501094227998,2.5,2.857142857142857,0,-1.0524935395521762,1,-0.9583720195574212,4,4,5,5,5,3,2,2,2,1,5,3,1,4,3,1,5,5,2,3,1.4375905768565218,4.6,0,4.2,0,1.4,0,2.8,0,2.8,0,1,4,1,2,3,2,3,4,1,1,3,4,3,4,4,4,1,3,4,4,1.2732056517228265,2.8,0,1,4,1,2,3,2,3,4,1,1,3,4,3,4,4,4,1,3,4,4,1.2732056517228265,2.8,0,"I lived with my mother, but not father, most of the time.",0,"White, Caucasian, Anglo, European American",0,26,1,2,NA,1,2,3,Bookkeeper,7,132,65,3,5,2,0,0,1,0,0,"I lived with my mother, but not father, most of the time.",0,TRUE,TRUE,TRUE,TRUE,TRUE,4,0.6007124999910594,0.5341906250417232,0.5499812499582768,0.6530500000417233,0.5900343749672174,0.6490258064423838,1,1,1,1,1,1,0.157,0.364,0.833,0.013,1.497,14.153092674869384,1799.448616568442,0.158,0.365,0.852,0.014,1.561,16.418368317593742,1797.29662940167,304,0.9007407407407407,1,3,3,21,24,FALSE
471,2022-03-19T01:45:58Z,2022-03-19T02:05:26Z,1167,1,2022-03-19T02:05:28Z,1,Chrome,98.0.4758.102,Windows NT 10.0,1536,864,NA,1.7777777777777777,484,81,360,83,35,63,-0.39846721816612385,-0.2040908888944643,-0.18741872492072456,-0.18728915503309204,-0.5316505544444572,-0.3981347276849264,1,1,1,1,2,1,1,2,1,1,1,1,1,1,1,1,1,1,2,2,1.3803127029389886,0,1,1,4,5,1.2,0,2,2,2,2,2,1,2,2,2,2,1,2,2,2,2,2,2,1,1,2,1,1,2,0,1,0,0,2,0,2,2,3,2,4,2,4,4,3,2,2,2,1,3,1,2,2,1,2,1,1,1,1,1,1,2,1,1,1,1,1,1,1,1,1,2,1,2,1,2,2,1.3077500564749405,1.2071217242444348,1.5,0,1.75,0,1.8666666666666667,0,2.888888888888889,0,1.6666666666666667,0,1.1666666666666667,0,1,0,1.3333333333333333,0,1.7297297297297298,0,0,0,0,-0.6782086556279895,-0.361969541370789,-0.5200890984993892,1,1,1,2,1,2,2,1,2,1.7182493859684491,1.4285714285714286,0,1.5,-0.5180379503204552,4,4,4,4,2,1,4,3,3,2,2,1.2909944487358056,3,3.2857142857142856,0,-0.8778143430786174,0,-0.6196158112720472,2,2,2,2,2,4,2,4,4,4,5,4,4,4,4,5,4,4,3,3,1.1126972805283737,2,0,4.2,0,3.6,0,3.8,0,3.8666666666666667,0,1,1,1,1,1,1,1,2,1,1,1,2,1,1,1,2,1,1,1,1,0.9445132413883326,1.15,0,1,1,1,1,1,1,1,2,1,1,1,2,1,1,1,2,1,1,1,1,0.9445132413883326,1.15,0,I lived with my mother and father an equal amount of time (joint custody),0,"White, Caucasian, Anglo, European American",0,25,0,1,NA,1,3,6,Police Officer,3,190,72,3,5,2,0,0,0,0,0,I lived with my mother and father an equal amount of time (joint custody),0,TRUE,TRUE,TRUE,TRUE,TRUE,2,0.5394031250029803,0.4524999999925494,0.5136156250312924,0.5860718749985099,0.516356249988079,0.5782625000104308,1,1,1,1,1,1,0.128,0.328,0.714,0.023,1.646,22.38576684125618,1822.7597935303452,0.13,0.326,0.718,0.022,1.662,33.48635496983766,1815.5525731853604,320,0.9481481481481481,0,3,0,0,3,FALSE
472,2022-03-19T01:38:17Z,2022-03-19T02:07:03Z,1726,1,2022-03-19T02:07:05Z,0.8999999761581421,Chrome,98.0.4758.80,Macintosh,1366,768,No feedback,1.7786458333333333,603,67,683,152,71,77,-0.15422318459593878,-0.28126128157625957,0.9844158448764376,0.66227382925724,0.2055655795652427,-0.24087775060561378,2,3,1,1,2,1,1,3,1,2,3,1,1,1,3,3,1,1,3,3,0.7451598203705946,0,1,1,2,2,1.85,0,2,2,2,3,3,2,2,2,2,2,1,2,3,2,3,2,3,3,1,2,1,1,1,3,2,0,0,0,0,2,2,3,3,3,2,2,2,2,2,2,1,1,3,3,2,2,2,1,1,1,3,1,2,1,3,1,1,2,1,1,2,2,2,1,1,1,2,2,2,2,1.2216760996649203,0.990430401872025,1.75,0,2,0,2.2,0,2.3333333333333335,0,1.75,0,1.8333333333333333,0,1.5714285714285714,0,1,0,1.8108108108108107,0,2,0,0,-0.38785685653442536,0.16253517528056266,-0.11266084062693135,2,1,3,1,1,1,1,1,1,1.2535663410560174,1.4285714285714286,0,1,-0.7112905515642753,4,4,4,3,3,3,4,4,4,1,2,0.7559289460184544,4,3.5714285714285716,0,-0.9112042194229322,0,-0.4851152916262145,3,3,3,3,3,3,4,3,3,2,4,3,3,3,2,2,4,3,3,3,0.6546536707079771,3,0,3.4,0,2.8,0,2.8,0,3,0,1,1,2,2,3,2,2,3,2,1,3,2,1,3,1,3,1,1,1,1,0.8335087534664907,1.8,0,1,1,2,2,3,2,2,3,2,1,3,2,1,3,1,3,1,1,1,1,0.8335087534664907,1.8,0,I lived with my mother and father an equal amount of time (joint custody),0,"Hispanic of Latino (e.g., Mexican American, Central American, and others) & White, Caucasian, Anglo, European American",1,23,0,1,NA,1,2,3,Labor,1,140,70,2,5,2,0,0,1,0,0,I lived with my mother and father an equal amount of time (joint custody),0,TRUE,TRUE,TRUE,TRUE,TRUE,1,0.5592000000092291,0.5411199999928474,0.5235419354823327,0.6157399999896686,0.5988266666650772,0.6026586206986986,1,1,1,0.9375,0.9375,0.90625,0.052,0.41,0.419,0.013,1.37,97.25880126929935,2007.6149729581773,0.052,0.41,0.464,0.013,1.419,117.31625994747412,2005.0324177875834,460,1.3629629629629632,0,3,0,0,3,FALSE
473,2022-03-19T01:29:55Z,2022-03-19T02:07:38Z,2262,1,2022-03-19T02:07:38Z,1,Chrome,97.0.4692.102,CrOS aarch64 14324.80.0,1366,768,"No feedback, thank you!",1.7786458333333333,1130,148,568,117,101,102,0.9274289640720237,0.16522456179698453,0.567199202378996,0.23133608360272373,0.8199123579066593,0.03993827989315878,2,2,2,1,3,1,1,3,1,2,4,2,1,4,3,3,1,1,3,3,0.8750939799154206,0,1,1,4,2,2.15,0,5,1,4,2,3,5,5,5,5,4,4,4,3,5,3,1,4,3,1,2,5,5,2,5,2,0,0,0,0,1,1,1,1,2,1,1,1,1,2,2,4,2,1,3,1,3,2,2,3,3,4,1,1,1,2,1,1,5,2,1,2,3,2,1,1,1,1,1,2,1,1.5986105077709065,1.4960264830861913,2.875,0,1.25,0,3.8666666666666667,0,1.1111111111111112,0,2.3333333333333335,0,1.6666666666666667,0,2.2857142857142856,0,1,0,1.8108108108108107,0,3,0,0,0.8321128213519234,0.12314628133243774,0.4776295513421806,1,2,3,1,2,2,2,1,1,1.2724180205607036,1.8571428571428572,0,1,-0.4626854203256071,5,5,5,5,2,3,4,4,4,3,3,1.4638501094227998,4,4.142857142857143,0,-0.1387807531136866,0,0.2954240334286271,1,3,2,3,2,4,5,4,4,2,4,5,4,5,3,4,3,4,5,3,1.3093073414159542,2.2,0,4,0,4,0,3.8,0,3.933333333333333,0,1,2,1,3,2,1,2,3,2,2,1,3,1,1,1,3,1,1,1,2,0.512989176042577,1.7,0,1,2,1,3,2,1,2,3,2,2,1,3,1,1,1,3,1,1,1,2,0.512989176042577,1.7,0,I lived with my mother and father an equal amount of time (joint custody),0,"White, Caucasian, Anglo, European American",0,19,1,2,NA,1,3,3,student,3,106,63,3,5,2,0,0,0,0,0,I lived with my mother and father an equal amount of time (joint custody),0,TRUE,TRUE,TRUE,TRUE,TRUE,6,0.5549249999988825,0.4552468750067055,0.44549062500707803,0.6197548387127538,0.5186593750044703,0.5333566666722298,1,1,1,0.96875,1,0.9375,0.075,0.288,0.474,0.019,1.813,64.84952976860443,1938.5922240845896,0.075,0.296,0.526,0.02,2.043,73.59432217092757,1921.1636577380712,460,1.3629629629629632,0,3,0,0,3,FALSE
474,2022-03-19T01:39:53Z,2022-03-19T02:08:20Z,1706,1,2022-03-19T02:08:21Z,1,Chrome,99.0.4844.74,Windows NT 10.0,1920,1080,I think the study should give you a score for the given game at the end of the test.,1.7777777777777777,578,200,474,112,139,101,-0.20553495635438102,0.45185744890079554,0.22616994677239152,0.1697735485092214,1.598084943805787,0.02870563867320788,2,2,2,1,3,1,2,2,2,3,3,1,1,1,2,2,2,1,3,2,0.7947194142390263,0,1,2,4,4,1.9,0,4,3,4,3,3,3,2,3,2,4,2,4,2,4,3,4,4,1,1,2,3,4,1,2,1,1,0,1,0,2,2,3,3,3,3,3,3,3,2,3,3,1,3,2,1,5,4,3,4,4,4,1,1,1,3,2,1,3,3,1,3,2,3,1,1,4,2,3,3,3,1.151445103261908,0.7745966692414834,2.5,0,2.75,0,3.066666666666667,0,2.7777777777777777,0,2.9166666666666665,0,2,0,2.2857142857142856,0,2,0,2.5405405405405403,0,1,0,0,0.6375279037898972,0.2019240692286875,0.4197259865092924,4,3,4,3,3,3,3,2,3,0.4879500364742666,3.2857142857142856,0,2.5,0.9457561542014143,3,4,4,3,2,1,4,9,10,2,2,1.1126972805283737,9.5,3,0,0.29665644908837546,0,-0.05856778870180679,2,2,3,2,2,4,3,3,4,2,5,3,5,3,4,4,3,5,3,1,1.1254628677422756,2.2,0,4,0,3.4,0,3,0,3.466666666666667,0,1,1,1,1,3,2,4,2,2,2,2,2,3,2,1,3,1,2,1,3,0.9880869341680844,1.95,0,1,1,1,1,3,2,4,2,2,2,2,2,3,2,1,3,1,2,1,3,0.9880869341680844,1.95,0,I lived with my mother and father an equal amount of time (joint custody),0,"Hispanic of Latino (e.g., Mexican American, Central American, and others)",0,20,0,1,NA,1,2,4,Team Memeber,4,205,72,2,5,2,0,0,0,0,0,I lived with my mother and father an equal amount of time (joint custody),0,TRUE,TRUE,TRUE,TRUE,TRUE,5,0.6438718750178813,0.5902656249925494,0.6846000000089407,0.7103718750067055,0.6522387096843412,0.785832258062978,1,1,1,1,1,1,0.242,0.151,0.476,0.01,1.638,48.16984382079945,1852.8423285120393,0.245,0.157,0.477,0.01,1.664,59.51709044953026,1845.2338714609928,355,1.0518518518518518,0,3,0,6,9,FALSE
475,2022-03-19T01:53:46Z,2022-03-19T02:10:53Z,1027,1,2022-03-19T02:10:54Z,0.8999999761581421,Chrome,99.0.4844.74,Windows NT 10.0,1920,1080,NA,1.7777777777777777,450,71,284,63,49,61,-0.4682512277576053,-0.2592125979528895,-0.4631445060494686,-0.43353929540710134,-0.24495539121846277,-0.4206000101248282,3,3,3,3,3,1,1,4,1,3,4,1,1,1,3,3,2,1,4,3,0.6805570473787206,0,1,1,2,1,2.4,0,4,4,5,2,5,3,5,4,5,2,3,4,1,4,4,3,4,1,1,3,4,3,5,4,2,0,0,0,0,3,1,3,3,4,2,5,1,3,3,2,5,1,4,4,2,4,5,5,5,5,3,1,1,1,3,3,1,3,3,2,3,4,3,2,2,1,2,4,2,2,1.3639502778182058,1.4074631010979937,3,0,2.5,0,3.6666666666666665,0,2.7777777777777777,0,3.75,0,2,0,2.7142857142857144,0,1.6666666666666667,0,2.864864864864865,0,2,0,0,1.2599634215755586,0.3349016051513059,0.7974325133634322,1,1,3,1,1,1,1,1,1,1.5735915849388864,1.2857142857142858,0,1,-0.7941589286438315,3,4,4,3,1,1,3,4,4,2,2,1.2535663410560174,4,2.7142857142857144,0,-0.69712652889908,0,-0.8191839251523371,3,4,2,2,2,4,5,4,5,3,4,4,3,2,5,3,3,4,5,5,1.3557637102737474,2.6,0,3.8,0,3.8,0,4.2,0,3.933333333333333,0,2,2,2,4,4,3,4,4,4,4,4,3,1,4,1,4,1,4,4,4,1.348488432516786,3.15,0,2,2,2,4,4,3,4,4,4,4,4,3,1,4,1,4,1,4,4,4,1.348488432516786,3.15,0,I lived with my mother and father an equal amount of time (joint custody),0,"White, Caucasian, Anglo, European American",0,20,0,1,NA,1,2,4,IT worker and student,1,235,69,2,5,2,0,0,0,0,0,I lived with my mother and father an equal amount of time (joint custody),0,TRUE,TRUE,TRUE,TRUE,TRUE,4,0.4530406250096857,0.4514437499977648,0.44884687499701975,0.5619933333277702,0.5167967741873957,0.5473322580591324,1,1,1,0.9375,0.96875,0.96875,0.078,0.315,0.598,0.013,1.572,45.468588225645426,1871.383104195862,0.077,0.318,0.605,0.013,1.625,59.51884095113882,1882.5985725201404,432,1.28,0,3,0,0,3,FALSE
476,2022-03-19T01:43:37Z,2022-03-19T02:11:47Z,1690,1,2022-03-19T02:11:49Z,0.8999999761581421,Chrome,99.0.4844.74,Windows NT 10.0,1920,1080,"If I had to nitpick, maybe change the game up a little bit and add some variety",1.7777777777777777,737,101,336,84,76,96,0.12080791202931165,-0.0938474707776139,-0.2744900242245385,-0.17497664801439158,0.30795670928881214,-0.027457567426546634,3,2,3,3,4,2,4,4,1,3,3,4,3,3,4,4,3,3,4,4,1.0563093645728086,0,1,1,3,3,3.2,0,3,2,4,2,2,2,3,4,2,2,4,2,3,3,1,2,2,1,1,1,2,1,3,1,2,0,0,0,0,1,1,4,2,4,1,4,1,4,2,2,1,2,3,2,1,1,2,2,3,3,2,1,1,1,3,1,1,2,2,1,1,1,2,1,1,1,2,1,2,2,1.4441556652887477,0.9611501047232549,1.625,0,1.75,0,2.6,0,2.4444444444444446,0,2,0,1.5,0,1.4285714285714286,0,1,0,1.837837837837838,0,1,0,0,-0.2558698183701986,-0.14280879051279902,-0.19933930444149883,1,1,2,2,1,2,3,3,2,1.5118578920369088,1.7142857142857142,0,2.5,0.03420400632629733,4,3,4,4,3,3,4,6,6,3,3,0.7559289460184544,6,3.5714285714285716,0,0.22259487524538815,0,0.20599459946673454,3,3,4,3,3,3,4,4,4,3,4,4,3,3,4,4,5,4,4,3,0.9611501047232549,3.2,0,4,0,3.6,0,3.6,0,3.7333333333333334,0,3,4,2,3,3,2,2,2,4,1,2,3,2,2,2,3,1,3,3,3,0.8207826816681233,2.5,0,3,4,2,3,3,2,2,2,4,1,2,3,2,2,2,3,1,3,3,3,0.8207826816681233,2.5,0,I lived with my mother and father an equal amount of time (joint custody),0,"Asian or Asian American (e.g., Chinese, Japanese, and others)",0,21,0,1,NA,1,3,4,Student and part time waiter,3,130,67,1,5,2,0,0,0,0,0,I lived with my mother and father an equal amount of time (joint custody),0,TRUE,TRUE,TRUE,TRUE,TRUE,4,0.4457718750052154,0.4086968750208616,0.4103903225814143,0.5008064516129033,0.47459354839786405,0.4954062499925494,1,1,1,0.96875,1,1,0.102,0.278,0.738,0.028,1.775,26.43630646359265,1816.3556122850302,0.104,0.275,0.741,0.028,1.85,41.33128736725236,1823.716353031487,526,1.5585185185185184,0,3,0,15,18,FALSE
477,2022-03-19T01:55:47Z,2022-03-19T02:22:17Z,1589,1,2022-03-19T02:22:19Z,0.8999999761581421,Chrome,99.0.4844.51,Windows NT 10.0,1366,768,NA,1.7786458333333333,616,234,347,108,64,65,-0.12754106328154882,0.6392712596994412,-0.2345823453769571,0.12052352043441956,0.062217997952245516,-0.3756694452450246,1,2,1,1,2,2,2,2,1,2,2,1,1,2,1,1,2,2,2,1,1.0990426455975697,0,1,1,5,4,1.55,0,3,2,2,2,1,3,3,2,2,2,3,1,2,2,1,1,1,1,1,1,2,1,1,1,2,0,0,0,0,1,1,1,1,1,1,1,1,1,1,2,1,1,2,1,1,1,1,1,1,2,1,1,1,1,1,2,1,2,1,1,2,1,2,2,3,1,2,1,1,1,1.7849891277501346,1.1952286093343936,1.125,0,1.25,0,2.066666666666667,0,1,0,1.25,0,1.1666666666666667,0,1.4285714285714286,0,2,0,1.2702702702702702,0,1,0,0,-0.9554700176776745,-0.3151752203835423,-0.6353226190306084,1,1,4,1,1,2,1,1,1,1.4638501094227998,1.5714285714285714,0,1,-0.6284221744847194,3,3,3,3,1,1,2,7,6,1,1,1.1338934190276817,6.5,2.2857142857142856,0,-0.80375276923563,0,-1.116458294789604,2,2,2,2,3,4,4,3,4,5,3,4,5,4,4,4,4,4,4,2,1.1464230084422218,2.2,0,3.8,0,4.4,0,3.4,0,3.8666666666666667,0,1,1,1,2,1,1,1,1,1,1,1,1,1,1,1,1,1,2,1,1,1.142481141154959,1.1,0,1,1,1,2,1,1,1,1,1,1,1,1,1,1,1,1,1,2,1,1,1.142481141154959,1.1,0,I lived with my mother and father an equal amount of time (joint custody),0,"White, Caucasian, Anglo, European American",0,30,0,1,NA,1,2,6,Mailman,5,180,70,3,5,2,0,0,1,0,0,I lived with my mother and father an equal amount of time (joint custody),0,TRUE,TRUE,TRUE,TRUE,TRUE,2,0.6229612903210424,0.5685129032327283,0.5515843750052154,0.7127656250074506,0.6367466666618983,0.6503218750171363,1,1,1,1,0.967741935483871,1,0.129,0.357,0.647,0.016,1.572,91.46403264765107,1911.575853735831,0.126,0.361,0.659,0.015,1.628,114.69913681316578,1902.054045623759,388,1.1496296296296296,0,3,0,0,0,FALSE
478,2022-03-19T02:04:41Z,2022-03-19T02:25:14Z,1232,1,2022-03-19T02:25:16Z,0.8999999761581421,Firefox,98.0,Windows NT 10.0,3840,1080,NA,3.5555555555555554,464,46,542,35,35,61,-0.4395166355728777,-0.39701687059895246,0.47287196146653093,-0.7782894919307143,-0.5316505544444572,-0.4206000101248282,2,2,2,1,2,2,1,3,1,2,2,2,1,1,2,2,1,1,3,2,0.8870412083230169,0,1,1,3,2,1.75,0,3,1,2,2,3,2,3,2,1,1,1,3,2,3,2,2,3,1,1,1,2,2,3,4,1,0,0,1,0,2,2,4,2,1,1,1,1,2,2,1,1,1,4,1,3,2,3,3,3,4,3,1,1,1,5,1,2,5,1,1,1,1,1,1,1,1,1,1,3,2,1.6168222271214958,1.1832159566199232,1.875,0,1.75,0,2.066666666666667,0,1.7777777777777777,0,2.3333333333333335,0,2,0,1.7142857142857142,0,1,0,1.9189189189189189,0,2,0,0,-0.34425487450105274,0.07635196034519101,-0.13395145707793088,1,2,3,2,1,2,1,2,1,1.3801311186847085,1.7142857142857142,0,1.5,-0.3523011961613431,5,5,5,5,3,3,4,4,3,3,3,1.2909944487358056,3.5,4.285714285714286,0,-0.22912466020345523,0,0.31778139191909993,2,3,3,2,3,5,3,4,3,2,2,3,4,3,5,3,3,4,3,3,0.9411239481143202,2.6,0,3.4,0,3,0,3.6,0,3.3333333333333335,0,2,1,3,3,2,3,1,3,3,1,1,2,2,4,1,1,1,2,1,2,0.998683343734455,1.95,0,2,1,3,3,2,3,1,3,3,1,1,2,2,4,1,1,1,2,1,2,0.998683343734455,1.95,0,I lived with my mother and father an equal amount of time (joint custody),0,"White, Caucasian, Anglo, European American",0,30,0,1,NA,1,3,8,Marketing Manager,4,160,72,3,5,2,0,0,1,0,0,I lived with my mother and father an equal amount of time (joint custody),0,TRUE,TRUE,TRUE,TRUE,TRUE,6,0.5315625,0.44425,0.45221875,0.5625161290322581,0.5123548387096775,0.52859375,1,1,1,0.96875,0.96875,1,NA,NA,NA,NA,NA,NA,NA,NA,NA,NA,NA,NA,NA,NA,400,1.1851851851851851,0,3,0,0,3,FALSE
479,2022-03-19T02:13:43Z,2022-03-19T02:30:17Z,993,1,2022-03-19T02:30:17Z,0.8999999761581421,Chrome,99.0.4844.74,Windows NT 10.0,2560,1440,NA,1.7777777777777777,466,88,248,42,39,67,-0.4354116938322023,-0.16550569255356667,-0.5937514550051894,-0.6921019427998111,-0.4497376506656016,-0.35320416280512285,2,2,1,1,2,1,2,1,1,1,2,1,1,1,2,2,2,1,2,2,1.105012502906165,0,0,2,5,5,1.5,0,1,1,1,1,1,1,1,1,1,1,1,1,1,1,3,1,1,1,1,1,1,1,1,0,2,0,0,0,0,2,1,1,2,1,1,1,1,1,3,1,1,1,1,2,1,4,3,2,2,2,1,1,1,1,1,1,1,1,2,1,1,1,1,1,1,1,1,1,1,1,1.7816212207352533,1.98086080374405,1,0,1,0,1.1333333333333333,0,1.2222222222222223,0,1.9166666666666667,0,1,0,1.1428571428571428,0,1,0,1.3783783783783783,0,0,0,0,-1.3707223025508095,-0.6205191861769039,-0.9956207443638567,1,1,1,1,1,1,1,2,1,1.9518001458970664,1,0,1.5,-0.7666430815591236,5,5,5,5,4,4,5,6,6,6,4,1.4638501094227998,6,4.714285714285714,0,1.2090960320784858,0,1.426732275492172,1,2,2,1,2,5,1,5,5,1,5,1,5,1,1,5,3,4,2,5,0.5936168397046637,1.6,0,3.6,0,2.8,0,3.4,0,3.2666666666666666,0,2,2,1,3,2,1,1,2,2,3,2,1,2,1,1,2,1,1,1,1,0.8944271909999159,1.6,0,2,2,1,3,2,1,1,2,2,3,2,1,2,1,1,2,1,1,1,1,0.8944271909999159,1.6,0,I lived with my mother and father an equal amount of time (joint custody),0,"White, Caucasian, Anglo, European American",0,25,0,1,NA,1,4,4,NA,6,130,65,2,5,2,0,0,1,0,0,I lived with my mother and father an equal amount of time (joint custody),0,TRUE,TRUE,TRUE,TRUE,TRUE,2,0.5276281250000465,0.4630531249999185,0.47982812500017463,0.6024451612902264,0.5307533333335692,0.5820225806451973,1,1,1,1,0.9375,0.96875,NA,NA,NA,NA,NA,NA,NA,NA,NA,NA,NA,NA,NA,NA,370,1.0962962962962963,0,3,0,3,6,FALSE
480,2022-03-19T02:12:23Z,2022-03-19T02:34:14Z,1311,1,2022-03-19T02:34:15Z,1,Firefox,98.0,Windows NT 10.0,1920,1080,NA,1.7777777777777777,526,87,336,147,72,78,-0.31226344161194086,-0.17101786345940917,-0.2744900242245385,0.6007112941637377,0.2260438055099566,-0.22964510938566288,2,3,2,1,2,4,4,4,4,2,3,2,1,2,2,3,3,3,3,4,0.99472291830968,0,1,1,4,3,2.7,0,1,2,3,2,3,2,2,3,2,2,2,3,1,2,4,1,1,1,1,1,1,1,1,2,2,0,0,0,0,1,1,1,1,1,1,1,1,1,2,1,5,2,1,2,1,5,2,5,5,5,2,1,1,1,3,1,1,2,2,2,3,3,4,1,1,3,2,1,1,3,1.65763317647414,1.0997835284835873,1,0,1.75,0,2.2666666666666666,0,1,0,3,0,1.5,0,2.4285714285714284,0,1.6666666666666667,0,2.054054054054054,0,1,0,0,-0.5801780143069083,-0.14280879051279902,-0.36149340240985367,1,1,2,1,1,2,1,1,1,1.6761634196950514,1.2857142857142858,0,1,-0.7941589286438315,4,5,5,4,5,5,4,4,3,4,3,1.1126972805283737,3.5,4.571428571428571,0,-0.015046969679603108,0,0.6031263459903523,1,2,2,2,2,4,5,5,4,5,4,5,5,4,4,1,5,5,3,2,1.624221425205085,1.8,0,4.6,0,3.8,0,3.8,0,4.066666666666666,0,2,1,2,2,3,2,2,2,2,2,3,2,1,4,1,2,1,2,2,3,0.8506963092234007,2.05,0,2,1,2,2,3,2,2,2,2,2,3,2,1,4,1,2,1,2,2,3,0.8506963092234007,2.05,0,I lived with my mother and father an equal amount of time (joint custody),0,"White, Caucasian, Anglo, European American",0,19,0,3,NA,1,4,2,student,1,175,70,2,5,2,0,0,1,0,0,I lived with my mother and father an equal amount of time (joint custody),0,TRUE,TRUE,TRUE,TRUE,TRUE,3,0.4661290322580645,0.4695625,0.4875,0.5796875,0.5190625,0.55990625,1,1,1,1,1,1,NA,NA,NA,NA,NA,NA,NA,NA,NA,NA,NA,NA,NA,NA,278,0.8237037037037037,0,3,0,0,3,FALSE
481,2022-03-19T02:07:36Z,2022-03-19T02:37:59Z,1823,1,2022-03-19T02:38:01Z,0.8999999761581421,Chrome,99.0.4844.74,Macintosh,1280,800,The game was fun I could have kept playing it.,1.6,1032,104,378,80,61,90,0.7262868187789301,-0.07731095806008635,-0.12211525044286413,-0.22422667608919344,7.833201181038607e-4,-0.09485341474625206,3,3,2,3,4,2,2,3,2,3,4,2,2,2,2,3,2,1,3,4,0.5525062514530825,0,1,1,3,3,2.6,0,5,5,2,5,1,2,3,2,2,1,1,4,1,4,3,2,1,1,2,1,2,2,2,3,1,1,0,0,0,2,2,1,2,1,1,3,1,1,2,2,5,1,4,1,2,1,2,5,5,5,2,1,1,1,1,1,1,3,3,4,2,2,2,1,4,4,2,2,2,4,1.5877723454642423,0.7237468644557459,1.625,0,2.5,0,2.7333333333333334,0,1.5555555555555556,0,2.9166666666666665,0,1.1666666666666667,0,2.4285714285714284,0,3,0,2.2162162162162162,0,2,0,0,-0.03224972089881582,0.3349016051513059,0.15132594212624503,5,5,5,2,2,2,2,1,1,1.3451854182690985,3.2857142857142856,0,1,0.36599835046995377,1,1,1,1,1,1,1,7,3,NA,1,1.5118578920369088,5,1,0,-0.891316364271223,1,-1.8666731750776697,2,4,4,1,2,4,4,5,5,1,5,4,5,5,5,1,5,5,2,1,1.8464895909600492,2.6,0,4.6,0,2.6,0,4.2,0,3.8,0,1,3,4,4,1,4,4,4,4,2,1,4,1,1,1,4,1,4,3,2,1.3168942730211068,2.65,0,1,3,4,4,1,4,4,4,4,2,1,4,1,1,1,4,1,4,3,2,1.3168942730211068,2.65,0,I lived with my mother and father an equal amount of time (joint custody),0,"White, Caucasian, Anglo, European American",0,25,0,1,NA,1,1,3,Disabled,7,200,66,3,5,2,1,0,1,0,1,I lived with my mother and father an equal amount of time (joint custody),0,TRUE,TRUE,TRUE,TRUE,TRUE,1,0.527528124993667,0.47254062499664723,0.5258906249888241,0.5666548387062165,0.5207580645180517,0.6063562500011176,1,1,1,0.96875,1,1,NA,NA,NA,NA,NA,NA,NA,NA,NA,NA,NA,NA,NA,NA,368,1.0903703703703704,0,3,0,0,3,FALSE
482,2022-03-19T02:20:35Z,2022-03-19T02:43:20Z,1364,1,2022-03-19T02:43:23Z,1,Chrome,98.0.4758.82,Windows NT 10.0,1536,864,I do not have any feedback.,1.7777777777777777,500,83,372,156,48,110,-0.36562768424072084,-0.19306654708277926,-0.1438830752688176,0.7115238573320418,-0.26543361716317665,0.129799409652766,1,1,1,1,1,1,1,1,1,1,1,1,1,1,1,1,1,1,1,1,1.538967528127731,0,1,1,3,4,1,0,1,1,1,1,1,1,1,1,1,1,1,1,1,1,4,1,1,1,1,1,1,1,1,2,2,0,0,0,0,2,5,5,5,5,1,4,3,1,1,1,1,1,4,1,1,1,1,1,1,1,1,1,1,1,1,1,1,2,1,1,1,1,1,1,1,1,1,1,1,1,1.5304712811230214,1.9880595947760098,1,0,1,0,1.2,0,3.4444444444444446,0,1.25,0,1,0,1.1428571428571428,0,1,0,1.7027027027027026,0,1,0,0,-1.1998576506096474,-0.4013584353189139,-0.8006080429642807,1,1,3,1,1,1,1,1,1,1.5735915849388864,1.2857142857142858,0,1,-0.7941589286438315,5,5,5,5,3,3,5,3,7,2,3,1.5735915849388864,5,4.428571428571429,0,-0.17217062945800132,0,0.42992455307445965,1,1,2,3,2,4,4,4,5,1,5,4,3,3,4,2,4,4,3,3,1.162919151265879,1.8,0,4.2,0,2.6,0,3.8,0,3.533333333333333,0,1,1,1,1,1,1,1,1,1,1,1,1,1,1,1,1,1,1,1,1,1.231174022502185,1,0,1,1,1,1,1,1,1,1,1,1,1,1,1,1,1,1,1,1,1,1,1.231174022502185,1,0,"I lived with my mother, but not father, most of the time.",0,"White, Caucasian, Anglo, European American",0,29,0,1,NA,1,3,5,Unemployed,2,140,68,1,5,2,0,0,0,0,0,"I lived with my mother, but not father, most of the time.",0,TRUE,TRUE,TRUE,TRUE,TRUE,6,0.4317064516159796,0.4149125000089407,0.4546193548171751,0.48521851850439,0.48061612907532725,0.5253225805836339,0.96875,1,0.96875,0.84375,0.96875,0.96875,NA,NA,NA,NA,NA,NA,NA,NA,NA,NA,NA,NA,NA,NA,380,1.125925925925926,0,3,0,0,3,FALSE
483,2022-03-19T02:09:55Z,2022-03-19T02:43:38Z,2023,1,2022-03-19T02:43:39Z,0.8999999761581421,Chrome,99.0.4844.74,Windows NT 10.0,1536,864,N/A,1.7777777777777777,977,49,138,53,50,101,0.6134009209103571,-0.3804803578814249,-0.9928282434810032,-0.5566643655941059,-0.22447716527374886,0.02870563867320788,3,4,1,2,2,2,2,3,2,3,4,2,1,3,3,3,3,2,3,2,0.6488856845230502,0,1,3,3,4,2.5,0,2,3,2,4,3,2,3,2,4,4,3,4,2,3,2,1,2,2,3,4,4,3,3,1,2,0,0,0,0,4,2,1,2,2,1,2,2,1,2,5,1,2,1,4,2,3,3,4,5,4,4,2,3,2,2,3,2,2,2,1,4,3,2,3,4,2,4,4,3,2,1.2357293502329008,0.8338093878327919,2.75,0,3.25,0,2.8666666666666667,0,1.8888888888888888,0,3,0,2.6666666666666665,0,2.2857142857142856,0,3,0,2.5405405405405403,0,1,0,0,0.6593781069759214,0.37429049909943074,0.5168343030376761,3,4,1,4,3,4,4,4,1,0.6900655593423543,3.2857142857142856,0,2.5,0.9457561542014143,4,3,3,4,1,1,3,6,6,2,3,1.2535663410560174,6,2.7142857142857144,0,0.008517184721536036,0,-0.38905714840320554,4,4,3,3,4,3,4,1,2,3,3,4,3,4,3,3,4,1,4,2,0.7037315505489968,3.6,0,3,0,3.4,0,2.4,0,2.933333333333333,0,2,1,3,3,3,2,2,2,4,3,2,3,2,4,2,3,1,4,4,3,0.9445132413883326,2.65,0,2,1,3,3,3,2,2,2,4,3,2,3,2,4,2,3,1,4,4,3,0.9445132413883326,2.65,0,"I lived with my father, but not mother, most of the time.",0,"White, Caucasian, Anglo, European American",0,30,0,1,NA,1,3,6,Anal,2,170,72,3,5,2,0,0,0,0,0,"I lived with my father, but not mother, most of the time.",0,TRUE,TRUE,TRUE,TRUE,TRUE,1,0.7536093750000873,1.1116387096775036,0.9539466666666481,0.8947600000000558,0.9837708333332945,1.0839499999999713,1,1,0.967741935483871,0.9375,0.7741935483870968,0.8666666666666667,NA,NA,NA,NA,NA,NA,NA,NA,NA,NA,NA,NA,NA,NA,304,0.9007407407407407,1,3,3,0,3,FALSE
484,2022-03-19T02:31:20Z,2022-03-19T02:50:51Z,1170,1,2022-03-19T02:50:52Z,0.8999999761581421,Chrome,99.0.4844.51,Macintosh,1440,900,No feedback.,1.6,472,85,306,69,80,109,-0.42309686861017615,-0.18204220527109422,-0.38332914835430587,-0.35966425329489854,0.38986961306766765,0.1185667684328151,2,3,3,3,3,2,3,3,2,3,2,3,3,2,3,3,3,1,2,3,0.5982430416161189,0,1,1,2,2,2.6,0,4,2,3,2,3,2,4,4,3,2,3,3,2,3,3,2,4,1,1,2,3,3,2,1,2,0,0,0,0,2,2,3,3,3,3,3,3,3,2,2,2,2,2,2,1,2,3,3,4,4,2,1,1,1,1,1,1,2,3,2,2,2,2,2,2,3,2,2,1,2,1.0856696913328099,0.7432233529572065,2.25,0,1.75,0,2.8666666666666667,0,2.7777777777777777,0,2.4166666666666665,0,1.1666666666666667,0,2,0,2.3333333333333335,0,2.2162162162162162,0,1,0,0,0.29914502742255056,-0.14280879051279902,0.07816811845487577,2,2,3,2,1,2,2,3,2,0.9511897312113419,2,0,2.5,0.1999407604854096,4,4,5,4,3,3,4,7,5,6,4,0.9759000729485332,6,3.857142857142857,0,1.2090960320784858,0,0.9621720847941407,2,2,2,3,2,4,5,4,4,3,4,4,4,4,5,5,4,4,5,3,1.3345232785352157,2.2,0,4,0,4.4,0,4,0,4.133333333333334,0,1,1,2,2,2,2,1,1,2,2,2,2,1,2,3,2,2,2,1,2,0.8255779474818965,1.75,0,1,1,2,2,2,2,1,1,2,2,2,2,1,2,3,2,2,2,1,2,0.8255779474818965,1.75,0,I lived with my mother and father an equal amount of time (joint custody),0,"White, Caucasian, Anglo, European American",0,24,0,1,NA,1,3,6,Unemployed,3,172,71,4,5,2,0,0,0,0,0,I lived with my mother and father an equal amount of time (joint custody),0,TRUE,TRUE,TRUE,TRUE,TRUE,6,0.46746874998882415,0.43170312499441205,0.43437187499739227,0.5356241379298012,0.487210714291249,0.5109620689688058,1,1,1,0.90625,0.875,0.9354838709677419,NA,NA,NA,NA,NA,NA,NA,NA,NA,NA,NA,NA,NA,NA,436,1.2918518518518518,0,3,0,3,6,FALSE
486,2022-03-19T02:33:42Z,2022-03-19T03:00:13Z,1590,1,2022-03-19T03:00:14Z,0.8999999761581421,Chrome,99.0.4844.74,Windows NT 10.0,1600,900,Great Survey! :),1.7777777777777777,596,112,451,104,72,118,-0.1685904806883026,-0.03321359081334619,0.14272661827290317,0.0712734923596177,0.2260438055099566,0.21966053941237323,1,1,2,1,2,1,1,1,1,1,2,1,2,1,1,1,1,1,2,1,1.3562719801759993,0,1,2,4,4,1.25,0,3,2,3,2,2,2,4,3,2,1,3,2,1,2,3,3,4,5,2,2,3,4,2,2,2,0,0,0,0,1,2,4,2,1,1,3,3,1,2,1,2,2,3,1,2,2,2,3,3,3,4,3,1,1,3,3,1,2,4,4,1,2,2,1,1,1,3,3,2,2,1.3506755066722445,1.0327955589886444,3.125,0,2.5,0,2.3333333333333335,0,2,0,2.1666666666666665,0,2.5,0,2.2857142857142856,0,1,0,2.108108108108108,0,1,0,0,0.40121106662933903,0.11574085429331589,0.2584759604613275,1,1,3,1,1,1,2,2,1,1.5275252316519468,1.4285714285714286,0,1.5,-0.5180379503204552,4,4,5,3,2,3,3,7,4,3,3,0.9759000729485332,5.5,3.4285714285714284,0,0.13225096815561946,0,0.07349856105786363,1,3,3,2,2,4,5,4,5,4,5,5,3,5,5,5,5,5,5,2,1.7511900715418263,2.2,0,4.8,0,4.4,0,4.2,0,4.466666666666667,0,2,1,1,3,3,2,1,2,1,2,1,1,1,1,1,1,1,2,1,2,1.0052493799000692,1.5,0,2,1,1,3,3,2,1,2,1,2,1,1,1,1,1,1,1,2,1,2,1.0052493799000692,1.5,0,"I lived with my mother, but not father, most of the time.",0,"White, Caucasian, Anglo, European American",0,23,0,1,NA,1,3,3,Web Developer,2,125,66,2,5,2,0,0,1,0,0,"I lived with my mother, but not father, most of the time.",0,TRUE,TRUE,TRUE,TRUE,TRUE,5,0.7391161290318254,0.5812718750000931,0.7595406250003726,0.8150031250000466,0.6824843750009313,0.8363312499999301,1,1,1,1,1,1,NA,NA,NA,NA,NA,NA,NA,NA,NA,NA,NA,NA,NA,NA,316,0.9362962962962963,0,3,0,0,3,FALSE
487,2022-03-19T02:58:40Z,2022-03-19T03:19:23Z,1242,1,2022-03-19T03:19:23Z,0.8999999761581421,Chrome,99.0.4844.51,Windows NT 10.0,1920,1080,NA,1.7777777777777777,524,85,343,83,67,86,-0.31636838335261624,-0.18204220527109422,-0.24909422859425942,-0.18728915503309204,0.12365267578638717,-0.13978397962605565,1,1,2,2,2,1,1,1,1,1,3,1,2,1,1,1,1,1,2,2,1.2732056517228265,0,1,1,3,3,1.4,0,2,2,1,2,1,2,1,1,3,1,1,1,2,1,1,1,1,1,1,3,2,2,1,1,2,0,0,0,0,1,2,1,1,1,1,1,1,1,1,1,1,1,1,2,1,1,1,1,1,1,1,1,1,1,3,1,1,2,1,1,1,1,3,1,3,1,2,1,1,1,1.8538977687394032,1.709915063331955,1.5,0,1.25,0,1.4666666666666666,0,1.1111111111111112,0,1.0833333333333333,0,1.3333333333333333,0,1.4285714285714286,0,1.6666666666666667,0,1.2432432432432432,0,1,0,0,-1.0656068526558775,-0.3151752203835423,-0.6903910365197099,2,1,4,2,2,3,3,1,1,0.9759000729485332,2.4285714285714284,0,1,-0.13121191200738283,3,4,3,4,1,1,3,3,3,2,2,1.2535663410560174,3,2.7142857142857144,0,-0.8778143430786174,0,-0.9293226050707346,2,3,3,3,3,4,4,3,4,2,5,4,4,4,3,4,4,4,4,3,1.01418510567422,2.8,0,4.2,0,3.6,0,3.4,0,3.7333333333333334,0,1,1,2,1,1,1,1,2,1,1,2,1,2,1,1,2,1,1,1,1,1.0399898784932577,1.25,0,1,1,2,1,1,1,1,2,1,1,2,1,2,1,1,2,1,1,1,1,1.0399898784932577,1.25,0,I lived with my mother and father an equal amount of time (joint custody),0,"White, Caucasian, Anglo, European American",0,24,0,1,NA,1,3,6,Help Desk Associate / Student,1,155,73,2,5,2,0,0,1,0,0,I lived with my mother and father an equal amount of time (joint custody),0,TRUE,TRUE,TRUE,TRUE,TRUE,2,0.5754875000044704,0.48609354838440494,0.5861064516229014,0.6368531250003725,0.5039193548425551,0.6282129032265755,1,1,0.96875,1,0.96875,0.96875,NA,NA,NA,NA,NA,NA,NA,NA,NA,NA,NA,NA,NA,NA,272,0.8059259259259259,0,3,0,0,3,FALSE
488,2022-03-19T03:02:53Z,2022-03-19T03:29:27Z,1594,1,2022-03-19T03:29:28Z,0.8999999761581421,Chrome,99.0.4844.51,Windows NT 10.0,1536,864,:P,1.7777777777777777,561,115,509,126,82,127,-0.24042696115012174,-0.016677078095818636,0.3531489249237868,0.3421486467710279,0.43082606495709547,0.32075431039193136,1,1,1,1,1,1,2,1,1,1,1,1,1,1,1,1,2,1,1,1,1.465390194130093,0,1,2,4,5,1.1,0,3,2,2,2,2,2,3,3,2,2,2,3,2,3,2,2,3,5,1,2,2,2,2,1,2,0,0,0,0,1,2,2,2,2,3,4,2,3,4,2,2,1,3,2,1,3,3,2,2,3,4,1,5,1,3,1,1,1,1,1,2,1,2,1,1,2,2,3,2,1,1.3445474360571321,0.7988086367179802,2.375,0,2,0,2.3333333333333335,0,2.3333333333333335,0,2.3333333333333335,0,2.5,0,1.2857142857142858,0,1.3333333333333333,0,2.081081081081081,0,1,0,0,0.061647098197882645,-0.05662557557742737,0.002510761310227639,2,3,3,2,3,3,3,1,1,0.5773502691896257,2.7142857142857144,0,1,0.03452484215172952,5,5,5,3,1,1,3,3,3,2,2,1.7994708216848747,3,3.2857142857142856,0,-0.8778143430786174,0,-0.6196158112720472,2,2,2,3,2,4,4,4,4,4,4,4,4,4,4,3,4,4,4,3,0.9611501047232549,2.2,0,4,0,3.8,0,3.8,0,3.8666666666666667,0,1,1,2,1,2,1,1,1,1,1,1,1,1,2,1,1,2,2,1,1,1.1821033884786185,1.25,0,1,1,2,1,2,1,1,1,1,1,1,1,1,2,1,1,2,2,1,1,1.1821033884786185,1.25,0,"I lived with my mother, but not father, most of the time.",0,"Hispanic of Latino (e.g., Mexican American, Central American, and others)",0,21,0,1,NA,1,2,4,Student,2,133,70,3,5,2,1,1,0,0,2,"I lived with my mother, but not father, most of the time.",0,TRUE,TRUE,TRUE,TRUE,TRUE,3,0.5194249999996974,0.5409218750002328,0.5010499999998137,0.5491870967738571,0.5714906250002095,0.5754032258064516,1,1,1,1,1,0.96875,NA,NA,NA,NA,NA,NA,NA,NA,NA,NA,NA,NA,NA,NA,400,1.1851851851851851,0,3,0,0,3,FALSE
489,2022-03-19T03:12:03Z,2022-03-19T03:35:20Z,1396,1,2022-03-19T03:35:22Z,NA,Edge,99.0.1150.39,Windows NT 10.0,1536,864,NA,1.7777777777777777,645,100,360,68,55,89,-0.06801940804175581,-0.09935964168345643,-0.18741872492072456,-0.371976760313599,-0.12208603555017945,-0.10608605596620295,1,1,1,2,1,1,2,2,1,1,3,1,1,2,2,2,1,1,2,2,1.1742858972247996,0,1,1,4,4,1.5,0,2,2,3,2,3,3,2,2,2,2,2,1,3,1,3,2,2,1,1,2,1,1,1,0,1,1,0,1,0,2,2,2,2,2,1,1,1,1,1,1,1,1,2,2,2,2,1,1,1,3,1,1,1,1,3,2,1,1,1,1,1,1,2,1,1,1,1,1,1,2,1.6598961579735207,1.0327955589886444,1.375,0,1.25,0,2.2,0,1.5555555555555556,0,1.5,0,1.5,0,1.1428571428571428,0,1,0,1.4054054054054055,0,0,0,0,-0.7288971900460186,-0.5343359712415323,-0.6316165806437755,1,2,4,1,1,2,2,2,1,1.3451854182690985,1.8571428571428572,0,1.5,-0.2694328190817869,4,4,4,4,2,2,4,3,6,NA,3,1.0690449676496976,4.5,3.4285714285714284,0,0.005972030878747869,1,-0.0034750606350365952,1,1,1,1,1,5,4,4,5,3,3,4,4,3,3,4,5,4,3,3,1.0997835284835873,1,0,4.2,0,3.6,0,3.6,0,3.8,0,1,1,1,2,2,1,2,3,2,1,2,2,2,1,1,2,1,1,1,3,0.8013147091860318,1.6,0,1,1,1,2,2,1,2,3,2,1,2,2,2,1,1,2,1,1,1,3,0.8013147091860318,1.6,0,I lived with my mother and father an equal amount of time (joint custody),0,"White, Caucasian, Anglo, European American",0,23,0,1,NA,1,3,1,N/A,7,160,69,4,5,2,0,0,0,0,0,I lived with my mother and father an equal amount of time (joint custody),0,TRUE,TRUE,TRUE,TRUE,TRUE,5,0.5238645161255714,0.4113968750052154,0.4475093749929219,0.5600843749977649,0.5121451612922453,0.5331968749929219,1,1,1,1,0.96875,1,0.116,0.284,0.705,0.012,1.351,38.209949454048335,1824.503203872032,0.12,0.286,0.779,0.014,1.472,49.975644583935996,1837.1341277211131,424,1.2562962962962962,0,3,0,0,3,FALSE
490,2022-03-19T03:11:12Z,2022-03-19T03:38:02Z,1610,1,2022-03-19T03:38:03Z,0.8999999761581421,Chrome,99.0.4844.74,Windows NT 10.0,1680,1050,I noticed that the first few questions with the scales of 1-5 or so that there was a horizontal scroll bar and if you scrolled to the right there was an unused option that had the default text as its title.,1.6,475,174,442,84,40,72,-0.41693945599916304,0.30854100534889,0.11007488103397296,-0.17497664801439158,-0.42925942472088774,-0.2970409567053683,1,1,1,1,1,1,1,2,1,1,2,1,1,1,1,2,1,1,1,1,1.4244112357114616,0,1,4,5,4,1.15,0,3,2,2,2,1,1,2,3,1,1,2,3,2,3,5,2,4,1,1,1,3,2,1,4,2,0,0,0,0,2,2,3,1,2,1,1,1,1,1,1,1,1,3,1,4,3,1,1,3,3,3,1,1,1,3,1,1,3,1,1,2,1,2,1,1,1,2,1,2,1,1.5562525251134285,1.1751393027860062,1.875,0,1.5,0,2.2,0,1.5555555555555556,0,1.9166666666666667,0,1.6666666666666667,0,1.5714285714285714,0,1,0,1.6486486486486487,0,2,0,0,-0.40409687241592984,-0.009831254590180624,-0.20696406350305524,1,1,2,1,1,1,1,1,1,1.7320508075688772,1.1428571428571428,0,1,-0.8770273057233877,5,5,5,5,4,4,5,5,8,4,4,1.4638501094227998,6.5,4.714285714285714,0,0.8712845581205503,0,1.2208185011075534,2,2,2,1,2,4,3,3,4,3,4,3,4,4,5,2,3,3,3,3,0.8451542547285166,1.8,0,3.4,0,3,0,3.8,0,3.4,0,1,1,1,1,3,1,1,2,1,1,1,1,1,2,1,1,1,1,1,2,1.164157703189193,1.25,0,1,1,1,1,3,1,1,2,1,1,1,1,1,2,1,1,1,1,1,2,1.164157703189193,1.25,0,I lived with my mother and father an equal amount of time (joint custody),0,"White, Caucasian, Anglo, European American",0,30,0,1,NA,1,4,4,Unemployed,6,145,72,2,5,2,0,1,0,0,1,I lived with my mother and father an equal amount of time (joint custody),0,TRUE,TRUE,TRUE,TRUE,TRUE,2,0.49024999999441204,0.4772906250078231,0.4688531250022352,0.5565437499899417,0.5369343750011176,0.547678125004284,1,1,1,1,1,1,0.082,0.345,0.642,0.015,1.447,24.218734184701283,1824.2080033749482,0.083,0.344,0.668,0.016,1.467,34.62654636618576,1816.853419602149,384,1.1377777777777778,0,3,0,0,3,FALSE
491,2022-03-19T03:19:16Z,2022-03-19T03:43:28Z,1451,1,2022-03-19T03:43:29Z,0.8999999761581421,Chrome,99.0.4844.74,Windows NT 10.0,1366,768,"Great survey, more of these would be great, thanks.",1.7786458333333333,610,142,363,62,46,85,-0.13985588850357494,0.1321515363619294,-0.17653481250774783,-0.4458518024258018,-0.3063900690526044,-0.15101662084600656,2,2,3,3,3,2,4,3,2,2,2,2,2,2,2,2,2,2,2,2,0.5982430416161189,0,1,1,3,2,2.3,0,3,2,2,2,2,3,4,3,3,2,3,2,3,4,3,3,5,2,2,3,4,4,4,1,1,1,0,0,0,3,2,2,2,2,2,2,2,2,2,3,3,4,3,4,2,3,5,4,5,3,4,1,2,1,3,2,3,2,2,2,3,2,2,2,2,3,1,1,2,2,1.0404722882338493,0.7432233529572065,3.375,0,1.5,0,2.7333333333333334,0,2.111111111111111,0,3.4166666666666665,0,2.1666666666666665,0,2.2857142857142856,0,2.3333333333333335,0,2.5945945945945947,0,1,0,0,0.8978602795873473,-0.22899200544817064,0.3344341370695883,3,2,3,3,3,2,3,2,1,0.4879500364742666,2.7142857142857144,0,1.5,0.22777744339554973,4,4,4,3,4,4,4,6,5,3,3,0.7867957924694432,5.5,3.857142857142857,0,0.13225096815561946,0,0.30577865640687946,3,2,3,3,2,4,3,4,3,4,2,4,4,3,4,4,2,3,4,2,0.8837151016885368,2.6,0,3,0,3.8,0,3.2,0,3.3333333333333335,0,2,3,3,3,2,3,4,3,2,3,3,2,2,3,2,2,3,3,2,2,0.5982430416161189,2.6,0,2,3,3,3,2,3,4,3,2,3,3,2,2,3,2,2,3,3,2,2,0.5982430416161189,2.6,0,I lived with my mother and father an equal amount of time (joint custody),0,"Hispanic of Latino (e.g., Mexican American, Central American, and others)",0,27,0,1,NA,1,3,6,Clerk,4,151,63,3,5,2,0,0,0,0,0,I lived with my mother and father an equal amount of time (joint custody),0,TRUE,TRUE,TRUE,TRUE,TRUE,1,0.5104300003051758,0.46184333318074544,0.5069968748688698,0.601074999888738,0.5276545456106012,0.5788520000457764,0.9375,0.967741935483871,1,0.75,0.6875,0.78125,0.053,0.367,0.42,0.014,1.733,43.977046904992854,1967.9698075404158,0.053,0.367,0.433,0.013,1.809,71.2347875949128,1993.6490874974702,315,0.9333333333333332,0,3,0,0,3,FALSE
492,2022-03-19T03:39:24Z,2022-03-19T03:59:42Z,1217,1,2022-03-19T03:59:44Z,0.8999999761581421,Chrome,99.0.4844.74,Windows NT 10.0,2560,1440,NA,1.7777777777777777,604,58,314,82,47,71,-0.1521707137256011,-0.33087081972884225,-0.35430538191970123,-0.1996016620517925,-0.28591184310789053,-0.3082735979253192,2,3,1,1,3,1,1,4,1,3,4,1,1,1,2,2,1,1,2,3,0.8207826816681233,0,1,2,1,1,1.9,0,2,2,2,2,2,1,2,2,2,1,3,2,2,2,2,1,3,1,1,1,2,1,1,1,2,0,0,0,0,1,1,1,2,2,1,2,2,2,1,1,1,1,2,3,2,4,2,3,3,2,1,1,1,1,1,1,1,2,2,2,1,1,3,1,1,1,1,1,1,1,1.5882451078226316,1.1872336794093274,1.375,0,1,0,1.9333333333333333,0,1.5555555555555556,0,2.0833333333333335,0,1,0,1.7142857142857142,0,1,0,1.6216216216216217,0,1,0,0,-0.7509442419093942,-0.4013584353189139,-0.5761513386141541,2,2,3,1,2,2,1,2,2,1.0690449676496976,1.8571428571428572,0,2,-0.07618021783796666,5,5,5,5,1,2,5,6,6,3,3,1.9880595947760098,6,4,0,0.22259487524538815,0,0.4382746948157501,3,3,3,4,3,4,3,5,4,2,4,4,3,3,3,2,4,4,3,4,0.8997354108424374,3.2,0,4,0,2.6,0,3.8,0,3.466666666666667,0,2,3,2,3,4,1,4,4,1,1,4,3,2,3,1,3,1,1,1,3,1.0990426455975697,2.35,0,2,3,2,3,4,1,4,4,1,1,4,3,2,3,1,3,1,1,1,3,1.0990426455975697,2.35,0,I lived with my mother and father an equal amount of time (joint custody),0,"White, Caucasian, Anglo, European American",0,27,0,1,NA,1,3,7,Manager of Student Financial Services,5,145,63,2,5,2,0,0,1,0,0,I lived with my mother and father an equal amount of time (joint custody),0,TRUE,TRUE,TRUE,TRUE,TRUE,4,0.4160718749994412,0.41212499999953434,0.4163531250001397,0.5469173913057084,0.5065740740740741,0.5411208333335817,1,1,1,0.71875,0.84375,0.75,0.059,0.322,0.658,0.008,1.455,39.4968212956511,1935.0336115782547,0.056,0.323,0.638,0.009,1.503,44.346169365013004,1936.2536950335566,308,0.9125925925925925,0,3,0,3,6,FALSE
493,2022-03-19T04:10:33Z,2022-03-19T04:35:50Z,1517,1,2022-03-19T04:35:51Z,0.8999999761581421,Safari,14.0.2,Macintosh,1440,900,No.,1.6,687,188,355,85,49,66,0.018184368512427163,0.38571139803068527,-0.20555857894235247,-0.16266414099569113,-0.24495539121846277,-0.3644368040250737,2,3,2,2,2,3,4,3,1,2,4,2,3,3,2,3,2,3,2,3,0.7591546545162482,0,1,3,1,2,2.55,0,4,2,4,3,4,4,5,4,2,3,4,4,4,4,4,3,5,1,1,3,3,4,4,2,1,1,0,0,0,3,2,1,4,5,4,4,4,4,1,2,2,1,4,1,3,2,3,4,5,5,1,1,1,1,5,5,1,5,1,1,2,3,2,1,1,3,2,2,2,1,1.517663764904237,1.0690449676496976,3,0,1.75,0,3.6666666666666665,0,3.4444444444444446,0,2.75,0,2.3333333333333335,0,2.142857142857143,0,1.6666666666666667,0,2.6486486486486487,0,1,0,0,1.1654760564468054,-0.14280879051279902,0.5113336329670032,1,1,4,1,1,1,1,1,1,1.4960264830861913,1.4285714285714286,0,1,-0.7112905515642753,5,5,5,5,3,5,4,1,2,3,3,1.2535663410560174,1.5,4.571428571428571,0,-0.59050028856253,0,0.2523574289816484,4,3,5,5,5,2,5,3,3,3,2,2,1,4,4,5,2,2,5,2,1.1872336794093274,4.4,0,2,0,3.8,0,3.2,0,3,0,4,4,4,3,4,4,3,2,4,4,4,3,4,4,4,3,4,4,4,4,0.7539370349250519,3.7,0,4,4,4,3,4,4,3,2,4,4,4,3,4,4,4,3,4,4,4,4,0.7539370349250519,3.7,0,I lived with my mother and father an equal amount of time (joint custody),0,"White, Caucasian, Anglo, European American",0,21,0,1,NA,1,3,4,Unemployed,3,220,71,2,5,2,0,0,1,0,0,I lived with my mother and father an equal amount of time (joint custody),0,TRUE,TRUE,TRUE,TRUE,TRUE,5,0.5226451612903221,0.47238709677418605,0.4795625,0.5937333333333352,0.5215333333333333,0.5646896551724098,1,0.96875,1,0.9375,0.967741935483871,0.90625,0.057,0.367,0.534,0.015,1.678,49.61538525274151,1915.698907769386,0.06,0.365,0.556,0.015,1.795,62.958043640262,1916.8285751351623,330,0.9777777777777777,0,3,0,0,3,FALSE
494,2022-03-19T04:23:02Z,2022-03-19T04:38:35Z,932,1,2022-03-19T04:38:37Z,0.8999999761581421,Opera,83.0.4254.70,Windows NT 10.0,5120,1440,NA,3.5555555555555554,456,67,224,51,35,60,-0.45593640253557915,-0.28126128157625957,-0.6808227543090034,-0.581289379631507,-0.5316505544444572,-0.43183265134477916,3,3,3,2,3,1,3,3,1,3,4,3,3,3,3,3,3,2,2,3,0.6958523739384593,0,1,1,2,2,2.7,0,2,2,2,3,5,2,2,3,4,2,4,3,1,3,5,2,3,1,1,2,2,3,3,0,2,0,0,0,0,2,3,4,4,4,1,3,2,1,3,1,2,2,3,3,1,2,2,3,5,5,2,1,1,3,2,1,1,1,1,1,1,3,5,1,1,2,1,2,2,2,1.4745081126172803,1.1952286093343936,2.125,0,1.75,0,2.8666666666666667,0,2.6666666666666665,0,2.6666666666666665,0,1.6666666666666667,0,1.8571428571428572,0,1.3333333333333333,0,2.2432432432432434,0,0,0,0,0.25633044009858436,-0.361969541370789,-0.05281955063610233,2,2,2,3,1,2,2,4,5,1.1338934190276817,2,0,4.5,0.9729511654606905,4,5,5,5,3,3,4,1,4,4,4,1.2149857925879117,2.5,4.142857142857143,0,0.14853330140240079,0,0.4705569876352758,3,4,2,3,3,4,5,4,5,4,4,5,3,4,4,4,5,4,4,5,1.4375905768565218,3,0,4.4,0,4,0,4.4,0,4.266666666666667,0,3,4,4,4,4,4,4,4,4,3,4,3,4,4,3,4,3,4,4,4,1.118033988749895,3.75,0,3,4,4,4,4,4,4,4,4,3,4,3,4,4,3,4,3,4,4,4,1.118033988749895,3.75,0,"I lived with my extended family on father's side (grandparents, aunts ,uncles, cousins)",0,"White, Caucasian, Anglo, European American",0,25,0,1,NA,1,3,4,Student,3,230,74,2,5,2,0,0,1,0,0,"I lived with my extended family on father's side (grandparents, aunts ,uncles, cousins)",0,TRUE,TRUE,TRUE,TRUE,TRUE,6,0.4905531250004424,0.41570937500090804,0.4730999999997439,0.5906354838710639,0.5003103448281,0.5910068965519554,1,1,1,0.96875,0.90625,0.90625,0.061,0.345,0.461,0.01,1.425,43.7983942755593,1917.8413586036459,0.06,0.345,0.457,0.01,1.51,56.8334983162788,1912.6905464757485,362,1.0725925925925925,0,3,0,0,3,FALSE
495,2022-03-19T04:29:36Z,2022-03-19T04:48:15Z,1118,1,2022-03-19T04:48:17Z,0.8999999761581421,Chrome,99.0.4844.51,Windows NT 10.0,1536,864,.,1.7777777777777777,488,79,294,69,51,85,-0.3902573346847731,-0.21511523070614935,-0.4268647980062128,-0.35966425329489854,-0.20399893932903498,-0.15101662084600656,2,2,1,4,2,2,3,2,1,3,3,2,3,3,2,2,1,3,3,1,0.8870412083230169,0,1,4,5,3,2.25,0,3,2,1,3,1,1,2,2,3,1,1,1,1,3,3,1,3,2,1,1,1,1,2,2,2,0,0,0,0,2,5,3,1,2,3,5,5,1,1,1,1,1,2,1,2,2,3,1,1,2,2,4,4,1,3,1,1,2,1,1,2,1,2,1,1,1,2,2,3,1,1.4694077579620841,1.3522468075656264,1.5,0,2,0,1.8666666666666667,0,3,0,1.5,0,2.5,0,1.4285714285714286,0,1,0,1.972972972972973,0,1,0,0,-0.5719103698581425,-0.05662557557742737,-0.31426797271778495,3,3,4,4,1,1,1,3,1,1.2149857925879117,2.4285714285714284,0,2,0.2552932904802576,2,3,3,1,2,2,2,6,6,NA,1,0.9759000729485332,6,2.142857142857143,0,-0.6202846430019169,1,-1.082051567602698,3,3,4,1,3,3,4,2,4,2,4,3,2,4,3,3,3,4,3,2,0.7988086367179802,2.8,0,3.4,0,2.8,0,3,0,3.066666666666667,0,1,1,1,2,4,1,2,3,2,1,1,2,1,1,1,1,1,1,2,2,1.019545822516343,1.55,0,1,1,1,2,4,1,2,3,2,1,1,2,1,1,1,1,1,1,2,2,1.019545822516343,1.55,0,"I lived with my mother, but not father, most of the time.",0,"White, Caucasian, Anglo, European American",0,24,0,1,NA,1,2,6,Systems Administrator,3,110,70,2,5,2,0,1,2,0,1,"I lived with my mother, but not father, most of the time.",0,TRUE,TRUE,TRUE,TRUE,TRUE,1,0.6062548387096707,0.48122812500000145,0.504606250000008,0.6562156249999862,0.5599724137930978,0.6383999999999923,1,1,1,1,1,0.9375,0.071,0.324,0.422,0.013,1.826,124.1104491581767,1978.8122285270626,0.073,0.325,0.425,0.013,1.857,138.2787231294459,1986.5796500209563,390,1.1555555555555557,0,3,0,0,3,FALSE
496,2022-03-19T05:11:00Z,2022-03-19T05:30:37Z,1177,1,2022-03-19T05:30:39Z,0.8999999761581421,Chrome,99.0.4844.51,Windows NT 10.0,1280,720,NA,1.7777777777777777,479,85,292,73,56,77,-0.40872957251781233,-0.18204220527109422,-0.43412073961486397,-0.3104142252200967,-0.10160780960546556,-0.24087775060561378,3,3,2,1,3,1,2,4,1,3,3,2,1,2,3,4,2,1,4,4,0.5104177855340404,0,1,1,4,4,2.45,0,2,2,2,2,2,1,1,1,1,1,1,2,1,2,2,2,3,4,1,1,1,1,1,0,2,0,0,0,0,2,1,1,1,1,1,1,1,2,1,1,1,1,1,2,1,2,1,3,2,2,3,1,1,2,2,1,1,1,1,1,2,2,1,1,1,1,2,2,2,2,1.7054056433612528,1.5491933384829668,1.75,0,2,0,1.5333333333333334,0,1.2222222222222223,0,1.5,0,1.6666666666666667,0,1.2857142857142858,0,1,0,1.3783783783783783,0,0,0,0,-0.8681676292722537,-0.2757863264354174,-0.5719769778538355,1,1,2,1,1,1,1,2,1,1.7320508075688772,1.1428571428571428,0,1.5,-0.6837747044795675,5,5,5,5,3,3,5,6,6,3,3,1.5735915849388864,6,4.428571428571429,0,0.22259487524538815,0,0.6705547901647659,2,1,2,2,2,4,5,4,5,2,3,4,4,4,5,4,4,4,5,4,1.3627702877384937,1.8,0,3.8,0,4,0,4.4,0,4.066666666666666,0,2,4,2,3,2,2,1,3,2,1,1,3,2,3,1,3,1,2,1,1,0.7677718959499145,2,0,2,4,2,3,2,2,1,3,2,1,1,3,2,3,1,3,1,2,1,1,0.7677718959499145,2,0,I lived with my mother and father an equal amount of time (joint custody),0,"White, Caucasian, Anglo, European American",0,21,0,1,NA,1,3,4,student,2,200,79,2,5,2,0,0,1,0,0,I lived with my mother and father an equal amount of time (joint custody),0,TRUE,TRUE,TRUE,TRUE,TRUE,3,0.4785281250178814,0.4246531249731779,0.4493968750089407,0.5632387096651139,0.495359375,0.5293096774008966,1,1,1,0.96875,1,0.96875,0.064,0.349,0.707,0.016,1.598,66.43151260793485,1903.3248031359387,0.066,0.346,0.659,0.019,1.674,80.25314746999057,1909.2269895862373,354,1.0488888888888888,0,3,0,0,3,FALSE
497,2022-03-19T05:06:16Z,2022-03-19T05:30:38Z,1461,1,2022-03-19T05:30:40Z,0.800000011920929,Firefox,98.0,Windows NT 10.0,1920,1080,NA,1.7777777777777777,567,110,411,94,83,89,-0.22811213592809562,-0.04423793262503123,-0.002392213900120001,-0.05185157782738694,0.45130429090180935,-0.10608605596620295,1,1,1,2,1,1,1,2,1,1,4,1,1,1,1,1,1,1,1,1,1.460893742308382,0,1,1,4,4,1.25,0,1,1,3,2,4,1,4,3,1,1,1,2,4,2,2,2,3,1,1,1,2,2,1,3,2,0,0,0,0,1,2,2,1,1,1,1,1,1,2,1,3,4,2,4,1,1,4,3,3,1,2,1,5,1,3,1,1,3,1,1,1,1,1,1,1,1,2,2,2,2,1.698789535488692,1.486446705914413,1.625,0,2,0,2.1333333333333333,0,1.2222222222222223,0,2.4166666666666665,0,2.1666666666666665,0,1.2857142857142858,0,1,0,1.7567567567567568,0,2,0,0,-0.4952378100297063,0.16253517528056266,-0.16635131737457182,1,1,2,1,1,1,1,2,3,1.7320508075688772,1.1428571428571428,0,2.5,-0.29726950199192703,5,5,5,5,5,5,5,4,4,6,5,1.5118578920369088,4,5,0,1.1919884889809524,0,1.5711577294670571,2,3,3,3,3,4,5,4,4,1,5,4,4,5,5,1,4,4,1,1,1.6676187756655838,2.8,0,4.2,0,2.4,0,3.8,0,3.466666666666667,0,1,2,1,1,1,1,4,4,1,1,4,3,4,3,2,3,1,2,1,4,1.2523661815266247,2.2,0,1,2,1,1,1,1,4,4,1,1,4,3,4,3,2,3,1,2,1,4,1.2523661815266247,2.2,0,I lived with my mother and father an equal amount of time (joint custody),0,"White, Caucasian, Anglo, European American",0,30,0,1,NA,1,4,4,Consultant,6,275,70,2,5,2,0,0,1,0,0,I lived with my mother and father an equal amount of time (joint custody),0,TRUE,TRUE,TRUE,TRUE,TRUE,1,0.5183125,0.5058125,0.58828125,0.6379666666666667,0.595741935483871,0.61603125,1,1,1,0.9375,0.96875,1,0.222,0.296,0.734,0.048,1.472,73.94721223703243,1871.3576211981024,0.217,0.299,0.734,0.049,1.489,88.99651984824575,1873.9572066425785,320,0.9481481481481481,0,3,0,0,3,FALSE
498,2022-03-19T05:19:11Z,2022-03-19T05:35:25Z,974,1,2022-03-19T05:35:27Z,0.800000011920929,Chrome,99.0.4844.74,Windows NT 10.0,2560,1440,NA,1.7777777777777777,493,52,231,61,24,55,-0.37999498033308465,-0.3639438451638974,-0.6554269586787244,-0.45816430944450226,-0.7569110398363099,-0.48799585744453366,1,1,1,1,1,1,1,1,1,1,1,1,1,1,1,1,1,1,1,1,1.538967528127731,0,1,1,3,4,1,0,4,1,3,3,1,1,1,1,1,1,1,1,2,2,2,1,1,1,1,1,1,1,1,0,2,0,0,0,0,2,3,2,2,1,1,1,1,4,1,1,1,1,2,1,2,4,1,1,1,1,2,1,1,1,2,1,1,1,1,1,2,1,1,1,1,2,1,1,1,1,1.6168222271214958,1.6388149028228556,1,0,1,0,1.6666666666666667,0,1.8888888888888888,0,1.4166666666666667,0,1.3333333333333333,0,1.1428571428571428,0,1.3333333333333333,0,1.4594594594594594,0,0,0,0,-1.1022207066432692,-0.6205191861769039,-0.8613699464100866,5,5,5,4,5,5,4,4,1,1.8126539343499315,4.714285714285714,0,2.5,1.7744399249969756,5,5,5,5,3,3,4,1,6,3,3,1.2909944487358056,3.5,4.285714285714286,0,-0.22912466020345523,0,0.31778139191909993,2,1,1,2,2,5,4,5,5,5,3,5,5,5,5,5,5,3,4,3,1.7265434778633235,1.6,0,4.2,0,4.6,0,4.6,0,4.466666666666667,0,1,1,1,4,1,1,1,3,1,1,1,2,1,1,1,2,1,1,1,1,0.6386663736585051,1.35,0,1,1,1,4,1,1,1,3,1,1,1,2,1,1,1,2,1,1,1,1,0.6386663736585051,1.35,0,I lived with my mother and father an equal amount of time (joint custody),0,"Hispanic of Latino (e.g., Mexican American, Central American, and others) & White, Caucasian, Anglo, European American",1,23,0,1,NA,1,3,5,Student,1,200,72,1,5,2,0,0,1,0,0,I lived with my mother and father an equal amount of time (joint custody),0,TRUE,TRUE,TRUE,TRUE,TRUE,5,0.5602687500268221,0.4461312499977648,0.511225000012666,0.6456937500163913,0.5268656249791384,0.5955218750052154,1,1,1,1,1,1,0.123,0.29,0.533,0.009,1.01,80.08939812066687,1875.1066080460375,0.122,0.294,0.531,0.009,1.06,107.92921614061628,1891.1325798163953,388,1.1496296296296296,0,3,0,3,6,FALSE
499,2022-03-19T05:22:28Z,2022-03-19T05:44:02Z,1293,1,2022-03-19T05:44:03Z,0.8999999761581421,Chrome,99.0.4844.74,Windows NT 10.0,1920,1080,NA,1.7777777777777777,505,81,309,131,52,127,-0.35536532988903236,-0.2040908888944643,-0.3724452359413291,0.40371118186453026,-0.1835207133843211,0.32075431039193136,2,3,2,2,2,1,1,1,1,1,4,1,2,1,2,2,1,1,3,3,1.025978352085154,0,1,1,4,4,1.8,0,4,2,1,2,1,1,1,1,1,1,1,1,2,1,4,1,1,1,1,1,1,1,1,4,2,0,0,0,0,1,1,3,1,1,1,1,1,1,1,2,1,1,3,1,2,1,1,2,2,1,1,1,1,1,3,1,1,3,3,1,2,2,2,1,1,1,1,1,2,2,1.6743068127745593,1.6818357317441643,1,0,1.5,0,1.6,0,1.2222222222222223,0,1.5,0,1.3333333333333333,0,2,0,1,0,1.4594594594594594,0,2,0,0,-1.1313543108913016,-0.009831254590180624,-0.5705927827407411,1,1,3,1,1,1,1,3,2,1.5735915849388864,1.2857142857142858,0,2.5,-0.21440112491237084,5,5,5,5,3,2,4,6,6,5,4,1.4638501094227998,6,4.142857142857143,0,0.9950183415546338,0,0.9865339245215761,2,3,4,4,4,4,2,3,4,2,5,1,4,4,5,5,5,5,3,3,1.3557637102737474,3.4,0,4,0,3.2,0,3.8,0,3.6666666666666665,0,1,2,2,2,1,3,2,3,3,2,2,2,3,3,2,3,1,2,3,3,0.7163503994113789,2.25,0,1,2,2,2,1,3,2,3,3,2,2,2,3,3,2,3,1,2,3,3,0.7163503994113789,2.25,0,I lived with my mother and father an equal amount of time (joint custody),0,"Black or African American & Hispanic of Latino (e.g., Mexican American, Central American, and others) & White, Caucasian, Anglo, European American",1,24,0,1,NA,1,3,4,Student,3,173,74,1,5,2,0,0,1,0,0,I lived with my mother and father an equal amount of time (joint custody),0,TRUE,TRUE,TRUE,TRUE,TRUE,3,0.40434687498956917,0.4991343749910593,0.41893750001117586,0.4553799999952316,0.5233250000029802,0.480890625,1,1,1,1,1,1,0.115,0.244,0.66,0.019,1.506,69.34183309848547,1875.0993109214962,0.117,0.246,0.673,0.021,1.553,94.00312518614696,1876.0092660833825,478,1.4162962962962962,0,3,0,6,9,FALSE
500,2022-03-19T05:35:09Z,2022-03-19T05:55:38Z,1229,1,2022-03-19T05:55:40Z,0.8999999761581421,Chrome,99.0.4844.51,Windows NT 10.0,2560,1440,"None, though on that 2nd screen question; I did have it connected, but nothing was on it!",1.7777777777777777,565,87,255,96,44,78,-0.23221707766877098,-0.17101786345940917,-0.5683556593749104,-0.02722656378998601,-0.34734652094203217,-0.22964510938566288,2,2,2,2,2,1,1,3,1,3,3,1,1,1,3,3,1,1,2,3,0.7677718959499145,0,1,2,3,2,1.9,0,1,1,2,2,1,2,3,1,1,1,1,2,1,2,3,1,1,1,1,1,3,1,1,0,2,0,0,0,0,1,4,1,2,3,2,4,1,4,1,1,2,1,3,2,1,3,2,2,1,2,1,1,1,1,3,2,1,1,1,1,2,2,1,1,1,1,1,1,1,1,1.478575728931794,1.5522640914238175,1.25,0,1,0,1.6,0,2.4444444444444446,0,1.75,0,1.5,0,1.2857142857142858,0,1,0,1.7297297297297298,0,0,0,0,-0.9039940885502392,-0.6205191861769039,-0.7622566373635715,2,1,2,1,1,1,1,1,1,1.4638501094227998,1.2857142857142858,0,1,-0.7941589286438315,5,5,5,5,3,3,5,7,4,4,4,1.5735915849388864,5.5,4.428571428571429,0,0.6905967439410129,0,0.9558264242898122,2,2,2,3,2,4,4,3,5,3,4,5,4,4,3,5,4,4,4,2,1.2227992865708155,2.2,0,4.2,0,4,0,3.4,0,3.8666666666666667,0,2,1,2,2,3,2,2,3,1,1,3,3,3,3,1,3,1,3,3,2,0.7880689256524124,2.2,0,2,1,2,2,3,2,2,3,1,1,3,3,3,3,1,3,1,3,3,2,0.7880689256524124,2.2,0,I lived with my mother and father an equal amount of time (joint custody),0,"White, Caucasian, Anglo, European American",0,24,0,1,NA,1,4,6,Aerospace Engineer,4,180,74,2,5,2,0,0,1,0,0,I lived with my mother and father an equal amount of time (joint custody),0,TRUE,TRUE,TRUE,TRUE,TRUE,6,0.4393499999977648,0.3941687499973923,0.40724687500856815,0.5100531249977648,0.4516312499884516,0.4821656249966472,1,1,1,1,1,1,0.088,0.269,0.622,0.019,1.602,55.22314773642917,1834.3970706617754,0.091,0.272,0.667,0.022,1.729,78.9737429522967,1860.1567250609146,366,1.0844444444444443,0,3,0,0,3,FALSE
501,2022-03-19T05:35:13Z,2022-03-19T05:56:31Z,1277,1,2022-03-19T05:56:31Z,0.8999999761581421,Chrome,99.0.4844.74,Windows NT 10.0,1920,1080,I enjoyed this study!,1.7777777777777777,460,96,257,153,30,123,-0.4477265190542284,-0.1214083253068265,-0.5610997177662592,0.6745863362759404,-0.6340416841680265,0.27582374551212774,1,1,3,3,1,2,4,1,2,1,1,3,3,3,1,1,4,4,1,1,0.6863327411532597,0,1,2,4,4,2.05,0,4,2,3,3,2,3,3,4,3,3,3,3,4,3,3,5,4,4,3,3,3,4,2,5,1,2,0,2,0,2,3,1,3,3,3,3,2,3,1,1,3,3,1,1,1,2,2,2,2,2,3,2,1,1,2,1,1,5,5,5,1,2,2,1,1,1,3,4,4,5,1.4606962838433024,0.5936168397046637,3.5,0,4,0,3.066666666666667,0,2.5555555555555554,0,1.75,0,1.6666666666666667,0,3,0,1,0,2.108108108108108,0,3,0,0,0.8855572372528745,1.0711616456215256,0.9783594414372001,3,3,4,3,3,3,2,3,2,0.4879500364742666,3,0,2.5,0.7800194000423024,5,5,5,3,3,3,4,9,9,3,2,1.2535663410560174,9,4,0,0.42039023252245894,0,0.5588413176586065,3,2,4,3,4,2,3,3,4,2,4,3,4,3,2,4,4,4,2,3,0.7367883976130072,3.2,0,3.4,0,3,0,3,0,3.1333333333333333,0,3,2,2,3,2,1,2,2,2,1,4,2,2,2,1,3,1,1,1,1,0.8522416262267903,1.9,0,3,2,2,3,2,1,2,2,2,1,4,2,2,2,1,3,1,1,1,1,0.8522416262267903,1.9,0,I lived with my mother and father an equal amount of time (joint custody),0,"Hispanic of Latino (e.g., Mexican American, Central American, and others)",0,18,0,1,NA,1,3,3,student,4,200,67,3,5,2,0,0,0,0,0,I lived with my mother and father an equal amount of time (joint custody),0,TRUE,TRUE,TRUE,TRUE,TRUE,5,0.5514062500004656,0.48095806451622514,0.5482374999999301,0.6257419354838709,0.5556064516130474,0.637363333333532,1,1,1,1,0.96875,0.967741935483871,0.082,0.313,0.34,0.079,1.772,150.83165957684864,2023.516545897736,0.078,0.33,0.363,0.029,1.838,148.16663944806078,1975.362897333808,304,0.9007407407407407,1,3,0,6,9,FALSE
502,2022-03-19T05:14:34Z,2022-03-19T06:13:06Z,3512,1,2022-03-19T06:13:08Z,0.8999999761581421,Chrome,99.0.4844.51,Windows NT 10.0,1536,864,This was a creative survey,1.7777777777777777,833,610,1113,298,71,113,0.31784511558172984,2.7118475202962284,2.544443290736437,2.459899853987508,0.2055655795652427,0.1634973333126187,3,2,3,3,3,1,2,2,2,3,2,1,2,2,3,3,2,2,2,3,0.6155870112510925,0,1,1,2,2,2.3,0,5,2,2,3,2,2,3,2,1,2,3,2,1,3,2,1,2,1,1,2,2,3,1,0,2,0,0,0,0,1,2,2,4,3,3,2,1,2,3,3,4,2,2,2,1,1,1,2,2,2,1,1,1,1,1,1,1,1,1,1,1,1,1,1,1,1,2,3,2,2,1.517663764904237,1.0600988273786194,1.625,0,2.25,0,2.3333333333333335,0,2.2222222222222223,0,2.0833333333333335,0,1,0,1,0,1,0,1.6486486486486487,0,0,0,0,-0.45508067984998607,-0.18960311150004575,-0.3223418956750159,1,1,3,2,2,1,2,5,4,1.3801311186847085,1.7142857142857142,0,4.5,0.8072144113015782,5,5,5,5,4,4,5,8,8,4,4,1.4638501094227998,8,4.714285714285714,0,1.1423162793898562,0,1.38602652098515,3,2,2,3,2,4,4,4,4,3,4,4,3,4,3,4,5,4,4,4,1.0327955589886444,2.4,0,4.2,0,3.6,0,3.8,0,3.8666666666666667,0,2,3,2,2,1,4,2,3,3,1,4,3,1,3,2,3,1,3,4,2,0.9880869341680844,2.45,0,2,3,2,2,1,4,2,3,3,1,4,3,1,3,2,3,1,3,4,2,0.9880869341680844,2.45,0,I lived with my mother and father an equal amount of time (joint custody),0,"White, Caucasian, Anglo, European American",0,19,0,1,NA,1,4,4,Student,5,166,69,3,5,2,0,0,2,0,0,I lived with my mother and father an equal amount of time (joint custody),0,TRUE,TRUE,TRUE,TRUE,TRUE,4,0.5766593750016764,0.6662625000001863,0.5103624999970198,0.6073374999985098,0.6669875000016764,0.6033387096783808,1,1,1,1,1,0.96875,0.078,0.387,0.593,0.015,1.543,61.95412277083808,1900.2088655607458,0.076,0.388,0.651,0.014,1.635,64.64418200453817,1893.2862794187242,374,1.108148148148148,0,3,3,6,9,FALSE
503,2022-03-19T05:51:11Z,2022-03-19T06:13:18Z,1327,1,2022-03-19T06:13:19Z,0.8999999761581421,Chrome,99.0.4844.51,Windows NT 10.0,1920,1080,NA,1.7777777777777777,539,95,328,121,54,67,-0.2855813202975509,-0.12692049621266902,-0.30351379065914313,0.2805861116775256,-0.14256426149489335,-0.35320416280512285,3,3,3,4,3,2,3,4,2,4,4,3,1,2,4,4,3,1,3,4,0.9119095061289915,0,1,2,3,3,3,0,2,3,3,3,4,2,2,3,2,3,3,3,2,3,3,2,2,1,1,1,1,1,1,3,1,0,0,1,1,2,3,2,3,3,3,4,4,4,3,2,2,2,4,1,3,2,2,3,3,3,3,2,1,1,3,3,1,3,1,1,3,4,3,3,2,1,1,1,2,2,0.930788035143537,0.6546536707079771,1.25,0,1.5,0,2.7333333333333334,0,3.111111111111111,0,2.5,0,2.1666666666666665,0,2.2857142857142856,0,2,0,2.5135135135135136,0,2,1,0,-0.06620611774196164,0.688328577846978,0.3110612300525082,3,2,5,1,1,3,2,2,1,0.8997354108424374,2.4285714285714284,0,1.5,0.06204068923643738,2,3,2,4,1,1,2,9,10,1,1,1.2724180205607036,9.5,2.142857142857143,0,-0.26168932669701794,0,-0.8634689534840833,3,4,3,2,3,3,2,3,2,2,5,4,3,2,3,3,4,4,3,3,0.8618916073713346,3,0,4,0,2.6,0,2.6,0,3.066666666666667,0,3,1,4,2,3,4,3,3,3,2,2,2,2,3,1,3,1,3,2,3,0.8885233166386386,2.5,0,3,1,4,2,3,4,3,3,3,2,2,2,2,3,1,3,1,3,2,3,0.8885233166386386,2.5,0,"I lived with my mother, but not father, most of the time.",0,"Asian or Asian American (e.g., Chinese, Japanese, and others)",0,27,0,1,NA,1,2,6,Freelance,2,171,71,2,5,2,0,1,0,0,1,"I lived with my mother, but not father, most of the time.",0,TRUE,TRUE,TRUE,TRUE,TRUE,5,0.5769312499994412,0.47995806451694617,0.5387468749997206,0.5862718749998603,0.5794899999996026,0.6479999999997672,1,1,1,1,0.9375,1,0.073,0.405,0.492,0.017,1.6,87.24311415510662,1900.2373102652207,0.078,0.4,0.548,0.018,1.762,98.80589464717922,1884.6345243881963,348,1.031111111111111,0,3,0,6,9,FALSE
504,2022-03-19T06:53:53Z,2022-03-19T07:16:08Z,1335,1,2022-03-19T07:16:10Z,0.800000011920929,Chrome,99.0.4844.51,Macintosh,1440,900,None,1.6,489,135,419,86,58,85,-0.3882048638144354,0.09356634002103176,0.026631552534484636,-0.15035163397699064,-0.060651357716037795,-0.15101662084600656,1,1,1,1,1,1,1,1,1,1,1,1,1,1,1,1,1,1,1,1,1.538967528127731,0,1,1,4,4,1,0,1,1,1,1,1,1,1,1,1,1,1,1,1,1,1,2,2,3,1,1,1,1,1,1,2,0,0,0,0,1,2,1,1,1,1,1,1,1,1,1,1,1,1,1,1,1,1,1,1,1,2,1,1,1,3,1,1,2,1,1,1,1,1,1,1,1,1,1,1,1,1.879636409796595,2.065591117977289,1.5,0,1,0,1,0,1.1111111111111112,0,1,0,1.5,0,1.1428571428571428,0,1,0,1.135135135135135,0,1,0,0,-1.3167857649564794,-0.4013584353189139,-0.8590721001376966,1,1,2,1,1,1,1,1,1,1.7320508075688772,1.1428571428571428,0,1,-0.8770273057233877,5,5,5,5,3,3,5,7,5,6,4,1.5735915849388864,6,4.428571428571429,0,1.2090960320784858,0,1.2718788785928283,2,2,2,3,2,4,5,4,4,5,5,5,5,5,5,5,5,4,5,5,1.8464895909600492,2.2,0,4.6,0,5,0,4.6,0,4.733333333333333,0,1,1,1,1,2,2,2,1,1,1,3,1,1,2,1,1,1,2,1,1,1.190974832912761,1.35,0,1,1,1,1,2,2,2,1,1,1,3,1,1,2,1,1,1,2,1,1,1.190974832912761,1.35,0,I lived with my mother and father an equal amount of time (joint custody),0,"White, Caucasian, Anglo, European American",0,25,0,1,NA,1,3,4,Electrician,5,160,72,5,5,2,0,0,1,0,0,I lived with my mother and father an equal amount of time (joint custody),0,TRUE,TRUE,TRUE,TRUE,TRUE,5,0.5616093749997672,0.4920032258061392,0.5041718750002329,0.617038709677155,0.5460249999995577,0.5667741935486275,1,1,1,0.96875,1,0.96875,0.073,0.375,0.629,0.018,1.689,39.35210083918841,1880.7447829892008,0.074,0.376,0.635,0.02,1.776,50.82281890747301,1873.2406840289248,388,1.1496296296296296,0,3,0,0,3,FALSE
505,2022-03-19T06:55:52Z,2022-03-19T07:21:40Z,1548,1,2022-03-19T07:21:42Z,0.8999999761581421,Chrome,99.0.4844.74,Windows NT 10.0,1920,1200,NA,1.6,959,46,234,114,30,122,0.5764564452442787,-0.39701687059895246,-0.6445430462657475,0.19439856254662236,-0.6340416841680265,0.26459110429217686,1,1,1,1,1,1,1,2,1,2,3,1,1,1,1,1,1,1,1,2,1.3717065820970682,0,1,2,3,4,1.25,0,4,3,1,4,2,1,4,2,1,1,1,4,2,3,5,3,4,1,1,2,2,3,2,0,2,0,0,0,0,2,3,4,2,4,2,2,2,2,2,1,1,1,3,2,1,4,3,3,1,2,2,2,1,1,3,4,1,1,1,1,3,2,2,1,1,1,2,2,2,2,1.3254270092150517,0.7037315505489968,2.25,0,2,0,2.533333333333333,0,2.5555555555555554,0,2,0,2.1666666666666665,0,1.5714285714285714,0,1,0,2,0,0,0,0,0.058989641053636126,-0.2757863264354174,-0.10839834269089063,2,2,3,2,1,3,3,1,2,0.9759000729485332,2.2857142857142856,0,1.5,-0.020827687843118697,4,4,4,4,2,2,3,1,4,1,2,0.9511897312113419,2.5,3.2857142857142856,0,-1.1822359406922383,0,-0.8051767084031548,1,3,3,4,3,3,3,4,3,1,2,4,4,3,2,3,4,4,4,4,0.9411239481143202,2.8,0,3.4,0,3,0,3.2,0,3.2,0,2,1,1,1,1,1,1,2,2,1,1,2,1,1,1,3,1,1,1,1,0.8885233166386386,1.3,0,2,1,1,1,1,1,1,2,2,1,1,2,1,1,1,3,1,1,1,1,0.8885233166386386,1.3,0,I lived with my mother and father an equal amount of time (joint custody),0,"White, Caucasian, Anglo, European American",0,24,0,1,NA,1,2,5,free lancer,1,300,69,1,5,2,0,0,0,0,0,I lived with my mother and father an equal amount of time (joint custody),0,TRUE,TRUE,TRUE,TRUE,TRUE,6,0.5034437499996275,0.5141562499981374,0.5336156249986962,0.5812999999979511,0.6647064516159796,0.6725999999991779,1,1,1,1,0.96875,0.9354838709677419,0.091,0.312,0.409,0.014,1.692,102.27079799777569,1952.9450243642393,0.087,0.318,0.408,0.014,1.817,109.19387543395403,1959.9384391107656,303,0.8977777777777777,0,3,0,9,12,FALSE
506,2022-03-19T07:31:38Z,2022-03-19T07:58:33Z,1615,1,2022-03-19T07:58:36Z,0.8999999761581421,Chrome,99.0.4844.51,Windows NT 10.0,1920,1080,"Nope, was fun to do and I was very honest. I didn't have a good life growing up and I'm still poor, give me a bonus haha :) Enjoy the rest of your week",1.7777777777777777,514,72,563,167,60,145,-0.33689309205599316,-0.253700427047047,0.5490593483573681,0.846961434537747,-0.019694905826610026,0.5229418523510476,3,3,1,1,3,2,2,4,1,3,3,2,1,1,3,3,2,1,3,3,0.4893604849295929,0,1,1,3,3,2.25,0,5,3,4,4,3,1,2,5,3,2,5,4,3,4,5,4,4,5,2,2,5,4,4,0,2,0,0,0,0,2,4,4,4,1,1,3,2,3,3,2,5,1,5,3,2,5,5,5,5,5,5,2,4,4,3,1,1,1,1,1,3,4,5,2,4,5,2,2,1,1,1.5245734893157248,1.3345232785352157,3.75,0,1.5,0,3.533333333333333,0,2.6666666666666665,0,3.8333333333333335,0,3.1666666666666665,0,2.2857142857142856,0,3.6666666666666665,0,3.135135135135135,0,0,0,0,1.6475584672807977,-0.44815275630616064,0.5997028554873185,1,1,4,1,1,1,1,2,2,1.4960264830861913,1.4285714285714286,0,2,-0.324785349076635,4,4,4,5,1,2,1,6,3,2,1,1.5118578920369088,4.5,3,0,-0.9510507070708526,0,-0.819110605206131,5,5,4,4,4,2,4,2,2,2,3,2,3,3,3,1,3,4,2,4,0.9611501047232549,4.4,0,2.8,0,2.4,0,2.8,0,2.6666666666666665,0,2,1,2,4,4,2,3,3,4,2,1,2,1,1,2,2,1,3,4,4,1.1285761872936695,2.4,0,2,1,2,4,4,2,3,3,4,2,1,2,1,1,2,2,1,3,4,4,1.1285761872936695,2.4,0,"I lived with my mother, but not father, most of the time.",0,"White, Caucasian, Anglo, European American",0,28,0,1,NA,1,1,4,unemployed,1,192,67,1,5,2,0,0,0,0,0,"I lived with my mother, but not father, most of the time.",0,TRUE,TRUE,TRUE,TRUE,TRUE,5,0.5570874999947846,0.5656562499981374,0.5286749999988825,0.6131906250007451,0.699393750006333,0.7028935483867123,1,1,1,1,1,0.96875,0.095,0.322,0.424,0.011,1.8,44.01672387680019,1883.6776246165728,0.099,0.324,0.46,0.011,1.876,56.50826265589593,1883.0882443689738,304,0.9007407407407407,1,3,0,3,6,FALSE
507,2022-03-19T07:43:25Z,2022-03-19T08:10:52Z,1646,1,2022-03-19T08:10:52Z,1,Edge,99.0.1150.39,Windows NT 10.0,1536,864,NA,1.7777777777777777,716,94,484,98,63,96,0.07770602375222016,-0.13243266711851154,0.2624496548156473,-0.002601549752585081,0.04173977200753163,-0.027457567426546634,2,2,1,2,2,1,1,1,1,2,2,1,1,1,2,2,1,1,2,2,1.0711528467275955,0,1,3,3,2,1.5,0,2,2,3,3,3,2,2,3,3,2,3,2,2,2,2,1,1,2,1,2,1,1,2,1,2,0,0,0,0,1,2,2,1,1,1,1,1,2,1,2,1,1,2,2,1,3,2,1,1,2,2,1,1,1,2,2,1,2,2,1,2,3,3,1,3,1,2,1,1,2,1.5572170448993052,0.7745966692414834,1.375,0,1.5,0,2.4,0,1.3333333333333333,0,1.5833333333333333,0,1.5,0,2,0,1.6666666666666667,0,1.5945945945945945,0,1,0,0,-0.5588199328142632,-0.22899200544817064,-0.39390596913121695,1,2,3,2,1,1,2,2,1,1.3801311186847085,1.7142857142857142,0,1.5,-0.3523011961613431,3,3,5,3,1,1,2,3,3,2,2,1.4638501094227998,3,2.5714285714285716,0,-0.8778143430786174,0,-1.0067493035204065,3,4,4,2,3,3,4,4,3,2,3,3,5,4,2,4,3,4,3,3,0.816496580927726,3.2,0,3.2,0,3.6,0,3.2,0,3.3333333333333335,0,1,1,2,3,2,1,2,4,2,1,1,2,2,2,1,2,1,1,1,2,0.6805570473787206,1.7,0,1,1,2,3,2,1,2,4,2,1,1,2,2,2,1,2,1,1,1,2,0.6805570473787206,1.7,0,"I lived with my mother, but not father, most of the time.",0,"Hispanic of Latino (e.g., Mexican American, Central American, and others) & White, Caucasian, Anglo, European American",1,27,0,1,NA,1,3,3,Waiter,3,170,69,1,5,2,0,0,1,0,0,"I lived with my mother, but not father, most of the time.",0,TRUE,TRUE,TRUE,TRUE,TRUE,1,0.49504687501862643,0.4622718750089407,0.5181838709731256,0.5997599999944369,0.5829366666674614,0.6093156250044703,1,1,1,0.9375,1,1,0.112,0.337,0.64,0.018,1.754,40.93164134496338,1822.2895645450646,0.113,0.335,0.641,0.018,1.832,53.67986396749323,1839.468838916589,368,1.0903703703703704,0,3,0,0,3,FALSE
508,2022-03-19T07:03:49Z,2022-03-19T08:26:44Z,4974,1,2022-03-19T08:26:45Z,0.8999999761581421,Chrome,99.0.4844.51,Windows NT 10.0,1707,1067,No problems.,1.5998125585754452,687,112,390,170,32,87,0.018184368512427163,-0.03321359081334619,-0.07857960079095717,0.8838989555938483,-0.5930852322785988,-0.12855133840610475,1,1,1,1,1,1,1,2,1,1,2,1,1,1,1,2,1,1,2,1,1.3803127029389886,0,1,1,5,5,1.2,0,2,1,2,1,2,1,1,2,2,1,2,2,1,2,1,2,2,1,1,1,2,2,1,1,2,0,0,0,0,1,1,2,1,1,1,1,1,1,1,1,2,1,2,1,1,2,1,2,1,1,1,1,1,1,1,1,1,2,2,1,1,1,2,1,1,1,2,1,1,1,1.8158461656476568,1.6035674514745464,1.5,0,1.25,0,1.5333333333333334,0,1.1111111111111112,0,1.3333333333333333,0,1,0,1.4285714285714286,0,1,0,1.2162162162162162,0,1,0,0,-1.0482841690489393,-0.3151752203835423,-0.6817296947162408,1,1,2,1,1,1,1,1,1,1.7320508075688772,1.1428571428571428,0,1,-0.8770273057233877,5,5,5,5,3,3,5,6,4,4,3,1.5735915849388864,5,4.428571428571429,0,0.2559847515897029,0,0.6909076674182771,2,2,2,2,2,5,2,2,4,4,5,4,3,4,4,3,4,5,3,2,1.2227992865708155,2,0,4.6,0,3,0,3.2,0,3.6,0,1,1,1,1,1,1,1,2,1,1,1,2,1,1,1,2,1,1,1,1,0.9445132413883326,1.15,0,1,1,1,1,1,1,1,2,1,1,1,2,1,1,1,2,1,1,1,1,0.9445132413883326,1.15,0,I lived with my mother and father an equal amount of time (joint custody),0,"White, Caucasian, Anglo, European American",0,30,0,1,NA,1,3,4,Restaurant manager,5,160,73,3,5,2,0,0,1,0,0,I lived with my mother and father an equal amount of time (joint custody),0,TRUE,TRUE,TRUE,TRUE,TRUE,4,0.44046875000093133,0.38463225806504486,0.4490031250009779,0.4999677419362049,0.4432375000007451,0.4754833333333333,1,0.96875,1,0.96875,1,0.967741935483871,0.052,0.35,0.573,0.038,1.654,71.19807079535839,1909.4595738058256,0.051,0.35,0.572,0.039,1.741,93.58058794950126,1922.8075452061712,422,1.2503703703703704,0,3,0,3,6,FALSE
509,2022-03-19T09:21:05Z,2022-03-19T09:44:42Z,1416,1,2022-03-19T09:44:44Z,1,Edge,99.0.1150.39,Windows NT 10.0,1536,864,"I enjoyed the Flanker game, and answering the questions.  I hadn't thought about my life before I was 13 as in-depth as this before, so it was interesting.",1.7777777777777777,657,78,293,66,60,84,-0.04338975759770353,-0.22062740161199185,-0.4304927688105384,-0.3966017743509999,-0.019694905826610026,-0.16224926206595747,1,2,2,1,2,1,2,2,1,2,2,3,3,1,3,2,2,1,2,2,0.9333020044867296,0,1,1,3,3,1.85,0,3,2,3,2,2,3,4,3,2,3,4,3,3,3,1,2,4,1,1,2,3,3,2,0,2,0,0,0,0,1,1,1,1,1,1,1,1,3,2,2,3,1,2,2,1,5,5,3,4,4,3,1,1,1,4,3,1,1,1,1,3,5,3,1,1,1,2,2,1,1,1.6526437097061275,0.8338093878327919,2.25,0,1.5,0,2.7333333333333334,0,1.2222222222222223,0,2.8333333333333335,0,2.1666666666666665,0,2.142857142857143,0,1,0,2.054054054054054,0,0,0,0,0.17001229507992105,-0.44815275630616064,-0.1390702306131198,1,1,2,1,1,2,1,1,1,1.6761634196950514,1.2857142857142858,0,1,-0.7941589286438315,5,5,5,5,3,3,4,6,3,6,5,1.2909944487358056,4.5,4.285714285714286,0,1.282332396070721,0,1.2390935771778964,1,1,1,1,1,4,5,3,5,5,5,4,5,3,4,1,5,4,2,3,1.533747356112131,1,0,4.4,0,3.6,0,3.6,0,3.8666666666666667,0,1,1,2,2,3,2,2,2,1,1,2,2,3,3,1,3,1,1,1,2,0.8522416262267903,1.8,0,1,1,2,2,3,2,2,2,1,1,2,2,3,3,1,3,1,1,1,2,0.8522416262267903,1.8,0,I lived with my mother and father an equal amount of time (joint custody),0,"White, Caucasian, Anglo, European American",0,27,0,1,NA,1,2,7,"PhD Candidate, Finance",2,147,68,5,5,2,0,0,1,0,0,I lived with my mother and father an equal amount of time (joint custody),0,TRUE,TRUE,TRUE,TRUE,TRUE,2,0.5094812499918043,0.40185624999552966,0.4897677419262548,0.5406218749955296,0.4841533333381017,0.5466161290407181,1,1,1,1,0.9375,0.96875,0.065,0.377,0.582,0.019,1.494,51.79283128429188,1888.699569064207,0.066,0.376,0.619,0.02,1.552,74.19076121008813,1899.5571598602592,386,1.1437037037037037,0,3,0,0,3,FALSE
510,2022-03-19T09:58:23Z,2022-03-19T10:21:00Z,1357,1,2022-03-19T10:21:02Z,1,Edge,99.0.1150.39,Windows NT 10.0,1920,1080,No.,1.7777777777777777,551,145,387,96,45,75,-0.26095166985349866,0.14868804907945696,-0.0894635132039339,-0.02722656378998601,-0.3268682949973183,-0.2633430330455156,2,2,2,2,1,1,2,2,3,1,2,3,1,1,1,1,1,1,2,2,1.0990426455975697,0,1,1,2,2,1.65,0,3,2,3,3,3,3,2,2,3,1,1,2,1,2,5,1,2,1,1,1,2,2,2,1,2,0,0,0,0,2,2,3,2,5,2,5,4,5,3,2,1,1,3,2,2,1,1,1,2,1,2,1,1,1,3,1,1,2,2,1,2,2,1,3,3,1,3,1,2,2,1.2284172780488758,1.1751393027860062,1.5,0,2,0,2.4,0,3.3333333333333335,0,1.6666666666666667,0,1.5,0,1.5714285714285714,0,2.3333333333333335,0,2.081081081081081,0,1,0,0,-0.2915978533095081,-0.05662557557742737,-0.17411171444346774,2,1,2,1,1,1,1,3,2,1.4638501094227998,1.2857142857142858,0,2.5,-0.21440112491237084,2,4,4,4,4,3,3,7,6,6,4,0.7867957924694432,6.5,3.4285714285714284,0,1.2994399391682545,0,0.7849613294043237,4,2,3,3,4,2,4,5,5,4,5,4,4,5,5,2,3,4,4,2,1.424279266355945,3.2,0,3.6,0,3.6,0,4.4,0,3.8666666666666667,0,1,2,1,2,3,4,4,3,2,1,3,3,1,1,1,4,1,3,1,1,1.0711528467275955,2.1,0,1,2,1,2,3,4,4,3,2,1,3,3,1,1,1,4,1,3,1,1,1.0711528467275955,2.1,0,I lived with my mother and father an equal amount of time (joint custody),0,Filipino,0,19,0,1,NA,1,3,3,Student,6,150,64,1,5,2,0,0,1,0,0,I lived with my mother and father an equal amount of time (joint custody),0,TRUE,TRUE,TRUE,TRUE,TRUE,6,0.4858000000100583,0.4248031250089407,0.5172562499959021,0.5712531250100583,0.5036562500018626,0.6029032258083743,1,1,1,1,1,0.96875,0.064,0.328,0.322,0.018,1.504,116.1725711674313,1960.2173875287729,0.066,0.33,0.321,0.016,1.612,137.15313859899885,1962.8211211634264,294,0.8711111111111112,0,3,0,0,3,FALSE
511,2022-03-19T10:57:13Z,2022-03-19T11:20:45Z,1411,1,2022-03-19T11:20:47Z,1,Firefox,98.0,Windows NT 10.0,1920,1080,Study worked perfectly fine,1.7777777777777777,583,117,307,95,132,114,-0.19527260200269259,-0.0056527362841335945,-0.3797011775499803,-0.039539070808686475,1.4547373621927897,0.1747299745325696,2,2,2,2,2,1,3,2,1,1,3,1,1,1,1,2,1,1,2,2,1.0699237552766379,0,1,1,2,2,1.65,0,2,1,2,2,1,3,2,2,1,1,1,1,2,2,1,1,3,1,1,1,2,2,3,0,2,0,0,0,0,1,2,3,1,1,1,4,2,1,1,2,5,1,2,2,1,3,5,5,5,2,1,5,1,1,3,3,1,1,1,1,2,2,2,1,1,1,2,2,1,1,1.6823585617609376,1.5796322658258457,1.75,0,1.5,0,1.6,0,1.7777777777777777,0,2.8333333333333335,0,2.3333333333333335,0,1.4285714285714286,0,1,0,2.081081081081081,0,0,0,0,-0.5319500883557738,-0.44815275630616064,-0.4900514223309672,1,2,3,1,1,1,1,3,1,1.5275252316519468,1.4285714285714286,0,2,-0.324785349076635,5,5,5,5,2,3,5,4,3,5,3,1.7043362064926932,3.5,4.285714285714286,0,0.19903072084424905,0,0.5787645062629174,2,3,3,1,2,4,4,3,4,3,5,1,4,3,3,5,4,4,4,4,1.0600988273786194,2.2,0,3.6,0,4,0,3.4,0,3.6666666666666665,0,2,1,1,3,1,2,2,4,3,1,2,3,3,4,2,4,1,3,4,2,0.9733285267845752,2.4,0,2,1,1,3,1,2,2,4,3,1,2,3,3,4,2,4,1,3,4,2,0.9733285267845752,2.4,0,NA,NA,"White, Caucasian, Anglo, European American",0,28,0,1,NA,1,1,3,Unemployed looking for work,1,264,76,1,5,2,0,0,1,0,0,NA,NA,TRUE,TRUE,TRUE,TRUE,TRUE,5,0.49290625,0.46209375,0.50278125,0.582103448275862,0.5973846153846154,0.6607931034482759,1,1,1,0.90625,0.8125,0.90625,0.067,0.358,0.425,0.011,1.88,107.27934954763577,1987.3521428830054,0.075,0.351,0.498,0.01,1.886,102.30913354400258,1960.688021762655,304,0.9007407407407407,1,3,0,6,9,FALSE
513,2022-03-19T11:51:27Z,2022-03-19T12:24:07Z,1959,1,2022-03-19T12:24:10Z,0.5,Chrome,99.0.4844.74,Windows NT 10.0,1536,864,NA,1.7777777777777777,986,117,411,82,55,125,0.6318731587433964,-0.0056527362841335945,-0.002392213900120001,-0.1996016620517925,-0.12208603555017945,0.29828902795202955,1,1,1,1,1,1,1,1,1,1,1,1,1,1,1,1,1,1,1,1,1.538967528127731,1,0,2,2,1,1,0,5,5,1,3,2,5,4,5,3,3,4,4,3,5,5,2,4,1,5,5,4,4,3,3,1,3,0,4,0,2,2,3,3,3,2,4,2,3,2,4,2,2,3,3,3,3,2,2,3,3,3,1,1,1,4,2,5,1,1,1,4,4,5,2,3,1,2,2,1,1,1.138989594902999,1.4074631010979937,3.5,0,1.5,0,3.8,0,2.6666666666666665,0,2.6666666666666665,0,2,0,3,0,2,0,2.5675675675675675,0,2,0,0,1.406812534879829,-0.009831254590180624,0.6984906401448242,1,1,5,1,1,1,1,8,1,1.5118578920369088,1.5714285714285714,0,4.5,0.7243460342220222,3,3,3,4,1,1,1,1,1,2,1,1.4638501094227998,1,2.2857142857142856,0,-1.5834580566992333,0,-1.591729477168882,2,2,4,3,4,5,3,5,5,2,5,1,5,5,5,5,4,4,3,1,1.6388149028228556,3,0,3.8,0,3.6,0,4.2,0,3.8666666666666667,0,1,3,1,4,4,2,1,1,1,1,2,1,2,1,1,1,2,2,1,1,1.190974832912761,1.65,0,1,3,1,4,4,2,1,1,1,1,2,1,2,1,1,1,2,2,1,1,1.190974832912761,1.65,0,I lived with my mother and father an equal amount of time (joint custody),0,"White, Caucasian, Anglo, European American",0,30,0,1,NA,1,2,4,Assistant Manager,2,195,70,3,5,2,1,0,1,0,1,I lived with my mother and father an equal amount of time (joint custody),0,TRUE,TRUE,TRUE,TRUE,TRUE,4,0.6027249999903143,0.6216562499850988,0.6180156250111759,0.7090800000111261,0.6422100000063579,0.6724896551699474,1,1,1,0.9375,0.967741935483871,0.90625,0.08,0.326,0.255,0.019,1.819,81.75435191782674,2012.3922241046957,0.076,0.324,0.26,0.016,1.959,90.42274726867015,1997.6227863900133,434,1.285925925925926,0,3,0,0,3,FALSE
514,2022-03-19T13:06:09Z,2022-03-19T13:33:36Z,1647,1,2022-03-19T13:33:37Z,0.800000011920929,Chrome,99.0.4844.74,Windows NT 10.0,1920,1080,N/A,1.7777777777777777,547,122,603,142,48,87,-0.2691615533348494,0.021908118245079003,0.6941781805303913,0.5391487590702353,-0.26543361716317665,-0.12855133840610475,1,1,1,1,1,1,1,1,1,1,1,1,1,1,1,1,1,1,1,1,1.538967528127731,0,1,1,5,5,1,0,4,3,2,3,3,3,2,3,3,3,2,3,2,3,3,3,4,1,1,3,3,3,2,2,2,0,0,0,0,1,4,4,4,5,4,4,4,4,2,3,2,3,3,3,2,5,4,4,5,5,4,4,1,1,3,1,1,2,2,1,4,3,2,2,3,3,3,2,2,1,1.2124231810593074,0.560611910581388,2.5,0,2,0,2.8,0,3.7777777777777777,0,3.4166666666666665,0,2.3333333333333335,0,2.142857142857143,0,2.6666666666666665,0,3.027027027027027,0,1,0,0,0.7335900583374629,-0.05662557557742737,0.3384822413800178,4,3,5,3,3,3,3,3,1,0.7867957924694432,3.4285714285714284,0,2,0.8353719300371503,3,4,4,4,2,2,3,4,1,2,2,0.8997354108424374,2.5,3.142857142857143,0,-0.9681582501683861,0,-0.7521118496809179,3,2,4,4,4,3,4,4,3,3,5,3,3,4,4,5,4,3,4,4,1.0327955589886444,3.4,0,3.6,0,3.8,0,3.8,0,3.7333333333333334,0,1,1,1,1,1,1,1,1,1,1,1,1,1,1,1,1,1,1,1,1,1.231174022502185,1,0,1,1,1,1,1,1,1,1,1,1,1,1,1,1,1,1,1,1,1,1,1.231174022502185,1,0,I lived with my mother and father an equal amount of time (joint custody),0,"White, Caucasian, Anglo, European American",0,30,0,1,NA,1,3,6,Social Worker,4,195,70,2,5,2,0,0,1,0,0,I lived with my mother and father an equal amount of time (joint custody),0,TRUE,TRUE,TRUE,TRUE,TRUE,6,0.6385624999962747,0.5292774193498396,0.5676125000081956,0.6973874999973924,0.62003125,0.6912967741950866,1,1,1,1,1,0.96875,0.081,0.379,0.449,0.015,1.981,83.71120639890779,1921.1289675093208,0.088,0.383,0.517,0.017,2.239,82.98118562622078,1911.0349864381826,304,0.9007407407407407,1,3,0,3,6,FALSE
515,2022-03-19T13:34:26Z,2022-03-19T13:50:31Z,964,1,2022-03-19T13:50:33Z,0.8999999761581421,Chrome,99.0.4844.51,Windows NT 10.0,1920,1080,NA,1.7777777777777777,486,75,206,61,40,53,-0.39436227642544847,-0.23716391432951942,-0.7461262287868639,-0.45816430944450226,-0.42925942472088774,-0.5104611398844354,1,2,1,1,1,1,2,1,1,2,1,2,3,1,1,2,1,1,2,1,1.2773327473170102,0,1,3,4,4,1.4,0,2,1,2,2,1,1,2,2,2,1,1,1,3,2,1,2,1,1,1,1,2,1,1,0,2,0,0,0,0,1,1,1,2,1,1,2,1,1,1,1,1,1,2,1,1,1,1,1,1,1,1,1,1,1,3,1,1,1,1,1,1,1,1,1,1,1,1,1,1,2,1.8652021281831572,1.5796322658258457,1.25,0,1.25,0,1.6,0,1.2222222222222223,0,1.0833333333333333,0,1.3333333333333333,0,1,0,1,0,1.135135135135135,0,0,0,0,-1.1638343426543103,-0.5343359712415323,-0.8490851569479213,1,1,2,1,1,1,1,1,1,1.7320508075688772,1.1428571428571428,0,1,-0.8770273057233877,5,4,5,5,4,3,5,6,6,4,4,1.4638501094227998,6,4.428571428571429,0,0.7809406510307816,0,1.010895764249011,2,1,3,1,1,4,4,4,5,5,4,5,5,2,4,5,5,5,4,2,1.5976172734359604,1.6,0,4.6,0,4.6,0,3.4,0,4.2,0,1,3,1,4,1,2,1,1,1,1,2,1,1,2,2,1,1,2,1,2,1.0894228312566052,1.55,0,1,3,1,4,1,2,1,1,1,1,2,1,1,2,2,1,1,2,1,2,1.0894228312566052,1.55,0,NA,NA,"White, Caucasian, Anglo, European American",0,28,0,1,NA,1,4,6,Hospital Technician,2,140,67,4,5,2,0,0,1,0,0,NA,NA,TRUE,TRUE,TRUE,TRUE,TRUE,2,0.46018709677265535,0.3999935483932495,0.42157419355069436,0.5916071428358555,0.47192666666110356,0.5257599999904633,0.96875,1,0.96875,0.875,0.9375,0.9375,0.056,0.329,0.55,0.017,1.909,105.19843333127875,2048.7119083436423,0.057,0.33,0.578,0.02,1.974,140.4162248729556,2023.2396494611055,307,0.9096296296296296,0,0,0,0,3,FALSE
516,2022-03-19T13:18:52Z,2022-03-19T13:56:10Z,2237,1,2022-03-19T13:56:11Z,0.8999999761581421,Firefox,98.0,Windows NT 10.0,1920,1080,NA,1.7777777777777777,815,150,513,159,128,90,0.28090063991565145,0.17624890360866954,0.36766080814108915,0.7484613783881432,1.3728244584139342,-0.09485341474625206,3,1,2,1,3,1,1,3,1,2,2,2,2,1,3,3,2,1,3,3,0.7880689256524124,0,0,4,3,3,2,0,2,2,3,2,2,3,2,2,1,2,3,2,2,2,1,2,2,1,1,1,2,2,2,1,2,0,0,0,0,1,2,2,1,1,2,1,2,3,1,2,2,1,3,2,1,1,2,2,2,2,2,1,1,1,2,1,1,2,2,1,2,2,1,1,1,1,1,1,1,1,1.4836445670042409,1.1254628677422756,1.625,0,1,0,2.066666666666667,0,1.6666666666666667,0,1.75,0,1.3333333333333333,0,1.5714285714285714,0,1,0,1.5675675675675675,0,1,0,0,-0.6070478587653975,-0.4013584353189139,-0.5042031470421557,1,1,2,2,1,1,2,1,3,1.6035674514745464,1.4285714285714286,0,2,-0.324785349076635,5,5,5,5,4,4,5,6,6,5,4,1.4638501094227998,6,4.714285714285714,0,0.9950183415546338,0,1.2962407183202633,3,3,3,3,3,3,3,3,3,3,2,3,2,3,3,3,4,4,3,2,0.560611910581388,3,0,3.2,0,2.8,0,2.8,0,2.933333333333333,0,1,2,1,2,2,1,1,3,1,2,2,2,3,2,2,2,1,2,2,2,0.7181848464596079,1.8,0,1,2,1,2,2,1,1,3,1,2,2,2,3,2,2,2,1,2,2,2,0.7181848464596079,1.8,0,I lived with my mother and father an equal amount of time (joint custody),0,"White, Caucasian, Anglo, European American",0,19,0,1,NA,1,4,4,landscaping,5,180,71,2,5,2,0,0,1,0,0,I lived with my mother and father an equal amount of time (joint custody),0,TRUE,TRUE,TRUE,TRUE,TRUE,2,0.5694827586206896,0.584125,0.57,0.6169677419354839,0.6043793103448276,0.6252413793103448,0.90625,1,1,0.96875,0.9666666666666667,0.9666666666666667,0.058,0.434,0.417,0.022,1.477,40.050068795610606,1878.931475911903,0.058,0.433,0.433,0.022,1.558,58.712381164101345,1885.5886683194099,506,1.4992592592592593,0,3,0,3,6,FALSE
517,2022-03-19T13:54:08Z,2022-03-19T14:12:50Z,1122,1,2022-03-19T14:12:52Z,1,Firefox,98.0,Windows NT 10.0,1920,1080,NA,1.7777777777777777,440,72,308,113,52,86,-0.4887759364609822,-0.253700427047047,-0.3760732067456547,0.18208605552792187,-0.1835207133843211,-0.13978397962605565,2,2,2,1,2,1,3,4,1,1,4,1,1,1,3,4,1,1,2,4,1.019545822516343,0,1,1,3,2,2.05,0,1,1,1,1,1,1,1,1,3,1,1,1,1,1,5,3,1,1,3,1,2,2,1,7,1,1,0,1,0,1,5,5,5,5,5,5,5,5,2,1,1,1,2,1,5,1,1,1,5,1,1,1,2,1,4,5,3,5,5,5,1,1,1,1,1,1,3,1,5,5,1.7544452337072474,1.98086080374405,1.75,0,3.5,0,1.4,0,4.555555555555555,0,1.8333333333333333,0,2.3333333333333335,0,3,0,1,0,2.72972972972973,0,4,0,0,-0.3358888057136111,1.1179559666087724,0.39103358044758063,5,5,5,5,5,5,5,4,3,1.9518001458970664,5,0,3.5,2.3266818816437285,3,2,5,3,1,1,1,6,1,2,2,1.6761634196950514,3.5,2.2857142857142856,0,-0.7874704359888487,0,-1.1065333604605516,1,5,1,5,1,5,5,5,5,1,5,5,5,5,5,5,3,1,5,1,2,2.6,0,3.8,0,4.2,0,4.2,0,4.066666666666666,0,4,1,4,1,4,3,4,4,4,2,2,3,4,4,1,4,1,2,2,4,1.3018205875255096,2.9,0,4,1,4,1,4,3,4,4,4,2,2,3,4,4,1,4,1,2,2,4,1.3018205875255096,2.9,0,I lived with my mother and father an equal amount of time (joint custody),0,"Hispanic of Latino (e.g., Mexican American, Central American, and others) & Native American/Alaskan Native/indigenous",1,27,0,2,NA,1,1,4,Unemployed,2,360,74,3,5,2,0,0,0,0,0,I lived with my mother and father an equal amount of time (joint custody),0,TRUE,TRUE,TRUE,TRUE,TRUE,5,0.431625,0.40403125,0.4376451612903226,0.5053793103448276,0.4962857142857143,0.5155666666666667,1,1,1,0.90625,0.9032258064516129,0.9375,0.066,0.33,0.523,0.014,1.347,160.2362058048521,2047.9848772905436,0.065,0.331,0.642,0.011,1.357,130.88010724936777,1997.4039498560555,410,1.2148148148148148,0,3,3,0,3,FALSE
518,2022-03-19T14:31:22Z,2022-03-19T14:47:19Z,957,1,2022-03-19T14:47:21Z,0.8999999761581421,Chrome,99.0.4844.74,Macintosh,2048,1152,N/A,1.7777777777777777,499,70,231,45,28,47,-0.3676801551110585,-0.26472476885873203,-0.6554269586787244,-0.6551644217437097,-0.6749981360574544,-0.5778569872041409,2,2,2,2,3,1,3,2,2,3,3,2,1,2,3,2,3,1,3,3,0.6708203932499369,0,0,2,4,3,2.25,0,3,2,4,2,3,1,3,3,2,1,2,3,1,2,2,2,3,1,1,2,3,1,2,1,1,0,0,1,0,2,2,2,2,2,2,2,2,2,2,2,3,2,3,4,3,3,2,3,3,2,3,1,1,1,2,2,1,3,1,1,2,1,1,1,1,1,2,3,1,1,1.2369438265459067,1.1464230084422218,1.875,0,1.75,0,2.2666666666666666,0,2,0,2.6666666666666665,0,1.6666666666666667,0,1.4285714285714286,0,1,0,1.972972972972973,0,1,0,0,-0.23323222047476808,-0.14280879051279902,-0.18802050549378355,2,1,3,1,1,1,1,2,1,1.2535663410560174,1.4285714285714286,0,1.5,-0.5180379503204552,4,4,5,4,3,3,5,8,7,5,3,1.2724180205607036,7.5,4,0,0.9217819775623984,0,0.8644658290371638,3,3,4,3,2,3,4,4,4,4,5,4,4,3,3,5,4,4,4,5,1.1751393027860062,3,0,4,0,4.2,0,3.8,0,4,0,2,1,1,2,2,1,3,3,1,2,1,3,1,2,1,2,1,2,1,3,0.7863975156570492,1.75,0,2,1,1,2,2,1,3,3,1,2,1,3,1,2,1,2,1,2,1,3,0.7863975156570492,1.75,0,I lived with my mother and father an equal amount of time (joint custody),0,"Asian or Asian American (e.g., Chinese, Japanese, and others)",0,24,0,1,NA,1,4,6,Student,6,155,72,2,5,2,0,0,1,0,0,I lived with my mother and father an equal amount of time (joint custody),0,TRUE,TRUE,TRUE,TRUE,TRUE,3,0.5162593750000014,0.47419062499999565,0.5468343749999949,0.5624884615384732,0.5226259259259225,0.6201781249999876,1,1,1,0.8666666666666667,0.8709677419354839,1,0.088,0.373,0.529,0.016,1.372,30.57083326224213,1813.6685827191884,0.09,0.368,0.513,0.016,1.453,46.046864421756034,1827.3130045346193,372,1.1022222222222222,0,3,0,0,3,FALSE
519,2022-03-19T14:31:27Z,2022-03-19T14:50:00Z,1112,1,2022-03-19T14:50:00Z,0.8999999761581421,Chrome,99.0.4844.51,Windows NT 10.0,1536,864,NA,1.7777777777777777,528,77,238,71,47,84,-0.30815849987126553,-0.22613957251783437,-0.6300311630484453,-0.3350392392574976,-0.28591184310789053,-0.16224926206595747,3,2,3,2,3,1,1,2,1,3,2,2,3,3,3,3,1,1,3,3,0.7591546545162482,0,1,1,3,3,2.25,0,1,1,1,1,1,1,1,1,1,1,1,1,1,1,1,1,1,1,1,1,1,1,1,0,2,0,0,0,0,1,1,3,1,1,1,1,1,1,1,1,1,1,1,1,1,1,1,1,2,2,1,1,1,1,2,1,1,1,1,1,1,1,1,1,1,1,1,1,1,1,1.879636409796595,2.065591117977289,1,0,1,0,1,0,1.2222222222222223,0,1.1666666666666667,0,1.1666666666666667,0,1,0,1,0,1.135135135135135,0,0,0,0,-1.5352877968167211,-0.6205191861769039,-1.0779034914968126,1,1,1,1,1,1,1,1,1,1.9518001458970664,1,0,1,-0.9598956828029438,5,5,5,5,3,3,5,7,3,6,4,1.5735915849388864,5,4.428571428571429,0,1.0284082178989484,0,1.161740198674431,2,2,2,3,2,4,3,4,5,1,5,4,3,3,4,3,5,4,3,3,1.1751393027860062,2.2,0,4.4,0,2.6,0,3.8,0,3.6,0,1,1,1,2,1,1,1,1,1,1,2,1,2,1,1,1,1,1,1,1,1.1367080817685316,1.15,0,1,1,1,2,1,1,1,1,1,1,2,1,2,1,1,1,1,1,1,1,1.1367080817685316,1.15,0,I lived with my mother and father an equal amount of time (joint custody),0,"White, Caucasian, Anglo, European American",0,28,0,1,NA,1,3,7,Teacher of the deaf,3,155,69,2,5,2,0,0,1,0,0,I lived with my mother and father an equal amount of time (joint custody),0,TRUE,TRUE,TRUE,TRUE,TRUE,4,0.4516906249932945,0.4144218750111759,0.447609375,0.5402566666722298,0.480658620694588,0.5267781249880791,1,1,1,0.9375,0.90625,1,0.069,0.328,0.57,0.012,1.223,60.63661192249641,1857.1590632749114,0.071,0.328,0.597,0.013,1.282,71.30530267541258,1858.4801513029786,386,1.1437037037037037,0,3,0,0,3,FALSE
520,2022-03-19T14:40:57Z,2022-03-19T14:59:27Z,1109,1,2022-03-19T14:59:29Z,1,Firefox,98.0,Windows NT 10.0,1920,1080,NA,1.7777777777777777,459,133,302,44,48,63,-0.4497789899245661,0.08254199820934673,-0.39784103157160816,-0.6674769287624102,-0.26543361716317665,-0.3981347276849264,2,3,1,1,3,1,3,3,1,3,3,1,1,1,2,2,2,1,2,3,0.812727700887249,0,0,2,3,4,1.95,0,4,2,2,2,3,4,4,5,3,4,5,3,2,4,3,3,5,5,1,3,5,4,5,5,2,0,0,0,0,1,1,1,1,1,2,3,1,3,2,2,5,4,4,4,4,5,5,5,5,5,5,1,1,3,1,1,1,3,3,2,3,3,2,1,2,3,1,1,1,1,1.5299806668193037,1.082325538564332,3.875,0,1,0,3.3333333333333335,0,1.5555555555555556,0,4.166666666666667,0,2,0,2.4285714285714284,0,2,0,2.675675675675676,0,3,0,0,1.4139975116031613,0.03696306639706612,0.7254802890001137,1,1,2,1,1,1,1,3,4,1.7320508075688772,1.1428571428571428,0,3.5,0.08923570049571344,5,5,5,5,5,5,4,6,5,6,4,1.1338934190276817,5.5,4.857142857142857,0,1.1187521249887171,0,1.449089633982645,4,4,5,5,5,1,2,5,1,1,1,2,2,4,4,2,3,1,2,2,1.4540583599999397,4.6,0,1.6,0,1.8,0,3.2,0,2.2,0,1,1,4,3,3,4,2,3,3,4,3,3,1,4,1,4,1,4,2,3,1.187655806953123,2.7,0,1,1,4,3,3,4,2,3,3,4,3,3,1,4,1,4,1,4,2,3,1.187655806953123,2.7,0,NA,NA,"White, Caucasian, Anglo, European American",0,24,0,1,NA,1,2,6,Freelance Writer,2,150,73,1,5,2,0,0,1,0,0,NA,NA,TRUE,TRUE,TRUE,TRUE,TRUE,1,0.4638125,0.40596875,0.43409375,0.6246,0.508,0.5319285714285714,1,1,1,0.9375,0.90625,0.9032258064516129,0.056,0.333,0.531,0.011,1.417,26.725350027126616,1924.0807083403702,0.056,0.334,0.538,0.012,1.464,40.588760980899806,1928.389807237611,294,0.8711111111111112,0,3,0,3,6,FALSE
521,2022-03-19T14:52:06Z,2022-03-19T15:13:13Z,1266,1,2022-03-19T15:13:13Z,0.8999999761581421,Chrome,99.0.4844.51,Macintosh,1440,900,NA,1.6,580,84,315,93,73,72,-0.20143001461370563,-0.18755437617693674,-0.35067741111537565,-0.0641640848460874,0.24652203145467047,-0.2970409567053683,3,3,2,3,3,1,2,2,1,3,3,2,4,3,3,3,2,1,3,3,0.7181848464596079,0,0,4,4,4,2.5,0,4,4,4,4,3,2,3,3,2,3,3,4,2,4,5,3,2,1,1,1,3,3,2,2,1,1,0,1,0,2,3,3,4,5,4,4,4,4,3,3,3,1,4,4,3,4,4,3,3,3,4,3,2,1,3,1,3,2,2,2,5,4,2,2,3,2,2,2,2,2,0.9012837024557319,0.7367883976130072,2,0,2,0,3.3333333333333335,0,3.6666666666666665,0,3.1666666666666665,0,2.3333333333333335,0,2.857142857142857,0,2.3333333333333335,0,3.027027027027027,0,1,0,0,0.7481568604614796,-0.05662557557742737,0.3457656424420261,4,3,4,4,3,4,3,3,1,0.816496580927726,3.5714285714285716,0,2,0.9182403071167066,3,3,3,3,1,1,2,4,4,2,2,1.1338934190276817,4,2.2857142857142856,0,-0.69712652889908,0,-1.0514640205013528,4,5,4,4,4,2,4,3,2,3,3,3,3,3,2,4,3,4,4,3,0.7037315505489968,4.2,0,3,0,3.6,0,2.6,0,3.066666666666667,0,3,2,3,4,2,3,3,3,2,1,2,3,3,3,3,4,2,3,4,3,0.8207826816681233,2.8,0,3,2,3,4,2,3,3,3,2,1,2,3,3,3,3,4,2,3,4,3,0.8207826816681233,2.8,0,I lived with my mother and father an equal amount of time (joint custody),0,"White, Caucasian, Anglo, European American",0,28,0,1,NA,1,3,7,Financial Analyst,3,165,70,3,5,2,0,0,1,0,0,I lived with my mother and father an equal amount of time (joint custody),0,TRUE,TRUE,TRUE,TRUE,TRUE,4,0.49186250000074505,0.4746870967745781,0.4925000000028841,0.5842806451599444,0.5589599999984105,0.5536766666650772,1,1,1,0.96875,0.9375,0.9375,0.061,0.374,0.563,0.019,1.691,36.228105923553734,1887.844020771329,0.06,0.375,0.562,0.02,1.73,52.903660898227436,1897.664112725901,416,1.2325925925925925,0,3,0,3,6,FALSE
522,2022-03-19T15:15:24Z,2022-03-19T15:38:32Z,1387,1,2022-03-19T15:38:34Z,1,Chrome,99.0.4844.51,Windows NT 10.0,1920,1080,NA,1.7777777777777777,540,120,441,95,65,70,-0.28352884942721324,0.010883776433393964,0.10644691022964739,-0.039539070808686475,0.0826962238969594,-0.3195062391452701,3,2,3,3,4,2,1,4,1,3,4,3,3,2,3,3,2,1,3,4,0.7880689256524124,0,1,1,4,2,2.7,0,3,3,4,3,3,2,2,3,2,3,3,3,1,3,2,3,3,4,1,2,3,3,2,1,2,0,0,0,0,2,3,4,3,4,2,4,4,3,3,3,2,1,3,2,4,4,2,2,4,4,4,4,1,3,3,3,1,2,1,1,3,5,4,3,4,1,2,2,1,1,1.0856696913328099,0.7988086367179802,2.625,0,1.5,0,2.6666666666666665,0,3.2222222222222223,0,2.8333333333333335,0,3,0,2.4285714285714284,0,2.6666666666666665,0,2.864864864864865,0,1,0,0,0.6590828339598942,-0.22899200544817064,0.21504541425586177,2,1,3,2,1,2,1,1,2,1.1547005383792515,1.7142857142857142,0,1.5,-0.3523011961613431,2,2,2,2,1,1,2,3,3,3,1,1,3,1.7142857142857142,0,-1.0080047378163064,0,-1.5506673539588656,2,3,2,2,2,4,4,5,5,3,5,4,3,4,2,5,4,4,4,4,1.245945806357946,2.2,0,4.2,0,3.8,0,4,0,4,0,1,1,3,4,2,3,3,4,2,1,3,3,2,2,2,3,1,3,2,3,0.7947194142390263,2.4,0,1,1,3,4,2,3,3,4,2,1,3,3,2,2,2,3,1,3,2,3,0.7947194142390263,2.4,0,I lived with my mother and father an equal amount of time (joint custody),0,"White, Caucasian, Anglo, European American",0,25,0,1,NA,1,2,4,Instacart Shopper,1,245,71,2,5,2,0,0,0,0,0,I lived with my mother and father an equal amount of time (joint custody),0,TRUE,TRUE,TRUE,TRUE,TRUE,3,0.4286000000089407,0.4116312500089407,0.43966249999776486,0.5706071428656578,0.5293000000139763,0.5736142856989588,1,1,1,0.875,0.90625,0.875,0.067,0.317,0.515,0.01,1.611,20.91044849241696,1889.5518745382767,0.068,0.317,0.556,0.011,1.641,25.54408802336867,1887.4580377004588,328,0.9718518518518519,0,3,0,3,6,FALSE
523,2022-03-19T15:15:17Z,2022-03-19T15:42:55Z,1657,1,2022-03-19T15:42:56Z,0.8999999761581421,Chrome,99.0.4844.74,Windows NT 10.0,1536,864,No feedback to report.,1.7777777777777777,751,73,386,73,52,268,0.1495425042140393,-0.24818825614120446,-0.09309148400825949,-0.3104142252200967,-0.1835207133843211,1.9045567224050086,1,2,1,2,1,1,2,2,1,1,2,2,1,2,1,1,1,1,2,1,1.2354415362426845,0,0,4,4,3,1.4,0,2,3,1,3,2,1,2,1,2,1,2,3,1,2,4,2,1,1,1,2,1,2,2,1,1,0,0,2,0,3,2,3,4,4,1,3,3,2,2,3,1,1,3,2,1,1,1,2,1,3,2,1,1,1,1,2,1,2,1,1,3,3,4,1,2,1,2,1,1,1,1.2339053944782488,1.162919151265879,1.5,0,1.25,0,2,0,2.7777777777777777,0,1.75,0,1.3333333333333333,0,2.142857142857143,0,1.3333333333333333,0,1.972972972972973,0,1,0,0,-0.513643161362078,-0.3151752203835423,-0.41440919087281014,1,1,4,1,1,3,2,3,1,1.4638501094227998,1.8571428571428572,0,2,-0.07618021783796666,3,4,5,4,2,2,3,4,3,1,3,1.1126972805283737,3.5,3.2857142857142856,0,-0.6572800412511595,0,-0.48518861157242077,1,1,2,2,1,4,4,4,5,1,5,4,4,3,5,4,5,5,3,3,1.4040757000349275,1.4,0,4.6,0,3.2,0,4,0,3.933333333333333,0,1,1,1,2,2,1,2,1,1,1,3,1,1,1,1,1,1,1,1,1,1.164157703189193,1.25,0,1,1,1,2,2,1,2,1,1,1,3,1,1,1,1,1,1,1,1,1,1.164157703189193,1.25,0,I lived with my mother and father an equal amount of time (joint custody),0,"White, Caucasian, Anglo, European American",0,22,0,1,NA,1,3,4,Unemployed,1,102.4,63,2,5,2,0,0,0,0,0,I lived with my mother and father an equal amount of time (joint custody),0,TRUE,TRUE,TRUE,TRUE,TRUE,4,0.6789322580649487,0.5497187500002328,0.5183656250000931,0.7533843750001397,0.6092499999988359,0.5826562500004656,1,1,1,1,1,1,0.159,0.298,0.723,0.013,1.14,90.49783750951863,1900.3356623974823,0.144,0.308,0.723,0.012,1.23,96.39564161740509,1882.915726173448,384,1.1377777777777778,0,3,0,0,3,FALSE
524,2022-03-19T15:30:47Z,2022-03-19T15:50:58Z,1211,1,2022-03-19T15:50:59Z,0.8999999761581421,Chrome,99.0.4844.74,Windows NT 10.0,2048,1152,NA,1.7777777777777777,481,62,398,82,44,80,-0.40462463077713695,-0.30882213610547216,-0.04955583435635254,-0.1996016620517925,-0.34734652094203217,-0.2071798269457611,2,1,2,1,2,2,3,2,1,2,1,2,1,3,2,2,1,2,2,2,0.9459053029269173,0,0,3,3,3,1.8,0,2,2,2,3,2,1,3,1,2,1,1,2,1,2,3,3,2,2,1,3,3,1,1,0,1,1,0,0,0,2,2,2,3,4,3,3,3,4,2,4,3,1,2,1,2,1,2,1,1,2,3,1,1,1,3,2,1,1,1,1,3,4,2,1,1,1,2,2,1,2,1.1343662489631763,1.2421180068162376,2,0,1.75,0,1.8666666666666667,0,2.888888888888889,0,1.8333333333333333,0,1.8333333333333333,0,1.8571428571428572,0,1,0,2.027027027027027,0,0,0,0,-0.3297864967157125,-0.361969541370789,-0.3458780190432508,2,1,3,1,1,2,3,1,1,1.2149857925879117,1.8571428571428572,0,1,-0.4626854203256071,5,5,5,5,4,4,4,6,6,4,3,1.1126972805283737,6,4.571428571428571,0,0.4366725657692403,0,0.8784730457863462,2,1,2,2,2,4,3,4,5,4,5,3,4,4,4,1,3,4,2,2,1.2071217242444348,1.8,0,3.8,0,2.8,0,3.8,0,3.466666666666667,0,1,1,1,4,1,1,1,2,1,1,2,1,1,2,1,1,1,1,1,1,1,1.3,0,1,1,1,4,1,1,1,2,1,1,2,1,1,2,1,1,1,1,1,1,1,1.3,0,I lived with my mother and father an equal amount of time (joint custody),0,"White, Caucasian, Anglo, European American",0,26,0,1,NA,1,2,4,Online freelancing,3,145,70,3,5,2,0,0,1,0,0,I lived with my mother and father an equal amount of time (joint custody),0,TRUE,TRUE,TRUE,TRUE,TRUE,1,0.44601290326733745,0.4263903225391142,0.4058580644976708,0.4999645161551814,0.505596874974668,0.5036064516190559,0.96875,1,0.96875,1,1,0.96875,0.061,0.302,0.512,0.012,1.36,147.1707495363231,2050.980369060357,0.062,0.302,0.538,0.013,1.431,166.17545047157594,2049.20907267152,304,0.9007407407407407,1,3,0,3,6,FALSE
525,2022-03-19T15:43:01Z,2022-03-19T16:03:28Z,1226,1,2022-03-19T16:03:30Z,0.8999999761581421,Chrome,99.0.4844.74,Windows NT 10.0,1920,1080,No comments,1.7777777777777777,476,66,407,80,68,74,-0.4148869851288254,-0.2867734524821021,-0.01690409711742232,-0.22422667608919344,0.14413090173110105,-0.2745756742654665,1,1,1,1,1,1,1,1,1,1,1,1,1,1,1,1,1,1,1,1,1.538967528127731,0,1,1,5,5,1,0,1,2,1,1,1,1,1,1,2,1,1,1,1,1,2,1,1,1,1,1,1,1,1,1,2,0,0,0,0,1,2,3,2,3,1,3,2,1,1,1,1,1,1,1,2,2,1,1,1,1,1,1,1,1,1,1,1,2,2,1,3,4,3,1,1,1,1,1,2,2,1.5891902106184537,1.8973665961010275,1,0,1.5,0,1.2,0,2,0,1.1666666666666667,0,1,0,2.2857142857142856,0,1,0,1.5405405405405406,0,1,0,0,-1.2707231744562124,-0.22899200544817064,-0.7498575899521915,1,1,3,1,1,2,2,1,1,1.4638501094227998,1.5714285714285714,0,1,-0.6284221744847194,5,5,5,5,4,4,4,3,3,2,3,1.1126972805283737,3,4.571428571428571,0,-0.5335462578170761,0,0.28707389168733605,2,2,2,2,2,4,5,4,4,3,4,5,4,3,3,4,3,3,3,4,1.01418510567422,2,0,3.8,0,3.8,0,3.6,0,3.7333333333333334,0,1,1,1,2,1,1,1,2,1,1,1,2,1,1,1,2,1,1,2,1,0.8255779474818965,1.25,0,1,1,1,2,1,1,1,2,1,1,1,2,1,1,1,2,1,1,2,1,0.8255779474818965,1.25,0,I lived with my mother and father an equal amount of time (joint custody),0,"Hispanic of Latino (e.g., Mexican American, Central American, and others) & White, Caucasian, Anglo, European American",1,25,0,2,NA,1,3,6,Inspector,3,130,64,1,5,2,0,0,1,0,0,I lived with my mother and father an equal amount of time (joint custody),0,TRUE,TRUE,TRUE,TRUE,TRUE,6,0.4484838709678621,0.4200687500000349,0.4503812499999185,0.5199666666667908,0.4942960000000894,0.5506230769230482,0.96875,1,1,0.84375,0.78125,0.8125,0.056,0.348,0.499,0.012,1.632,33.41270289545375,1941.0840738118802,0.055,0.348,0.553,0.012,1.677,35.79861351611889,1940.1796547987567,311,0.9214814814814816,0,3,0,3,6,FALSE
527,2022-03-19T15:50:39Z,2022-03-19T16:11:13Z,1233,1,2022-03-19T16:11:14Z,1,Firefox,98.0,Windows NT 10.0,1920,1080,NA,1.7777777777777777,462,61,499,60,43,59,-0.443621577313553,-0.3143343070113147,0.316869216880531,-0.4704768164632027,-0.36782474688674605,-0.44306529256473004,2,3,3,1,3,2,1,2,1,1,3,1,1,1,2,3,1,1,2,3,0.9445132413883326,0,0,2,2,4,1.85,0,3,2,1,2,1,1,3,2,2,1,2,2,1,3,3,3,2,1,1,2,1,3,2,5,2,0,0,0,0,2,3,2,1,2,3,4,2,1,1,1,2,1,2,4,1,2,1,3,2,4,3,1,1,1,1,1,3,4,1,1,1,2,1,1,1,2,1,2,2,3,1.4972447167185936,1.1751393027860062,1.875,0,2,0,1.9333333333333333,0,2.2222222222222223,0,2,0,1.3333333333333333,0,1.8571428571428572,0,1.3333333333333333,0,1.864864864864865,0,3,0,0,-0.4261439242793056,0.38169592613855263,-0.022223999070376477,1,1,2,1,1,1,1,3,1,1.7320508075688772,1.1428571428571428,0,2,-0.49052210323574724,4,5,5,3,2,3,5,7,6,4,4,1.4960264830861913,6.5,3.857142857142857,0,0.8712845581205503,0,0.7562583104095221,4,2,3,3,2,3,5,4,5,3,5,5,3,3,3,5,5,3,5,4,1.4638501094227998,2.8,0,4.2,0,4.2,0,3.8,0,4.066666666666666,0,1,1,1,3,3,2,3,3,3,1,2,3,1,1,1,3,1,3,1,2,0.7863975156570492,1.95,0,1,1,1,3,3,2,3,3,3,1,2,3,1,1,1,3,1,3,1,2,0.7863975156570492,1.95,0,"I lived with my extended family on father's side (grandparents, aunts ,uncles, cousins)",0,"Hispanic of Latino (e.g., Mexican American, Central American, and others) & White, Caucasian, Anglo, European American",1,22,0,1,NA,1,2,2,Unemployed,2,195,69,3,5,2,0,0,1,0,0,"I lived with my extended family on father's side (grandparents, aunts ,uncles, cousins)",0,TRUE,TRUE,TRUE,TRUE,TRUE,2,0.5269032258064517,0.49315625,0.51109375,0.6089677419354839,0.5435483870967742,0.627,1,1,1,1,1,1,0.177,0.226,0.622,0.01,1.186,63.89878034389911,1864.7088245389205,0.181,0.224,0.622,0.011,1.283,78.04370465620599,1863.9130652179863,420,1.2444444444444445,0,3,0,0,3,FALSE
528,2022-03-19T16:01:32Z,2022-03-19T16:21:13Z,1181,1,2022-03-19T16:21:14Z,0.8999999761581421,Chrome,99.0.4844.51,Windows NT 10.0,1920,1080,none,1.7777777777777777,646,90,238,36,38,62,-0.06596693717141812,-0.15448135074188163,-0.6300311630484453,-0.7659769849120138,-0.4702158766103155,-0.40936736890487735,3,2,3,3,3,2,2,3,3,2,3,2,3,3,2,2,3,3,2,2,0.4893604849295929,0,1,4,5,5,2.55,0,3,3,3,3,3,2,4,3,4,4,3,3,3,3,3,3,4,4,3,3,2,4,3,0,2,0,0,0,0,3,4,2,2,3,3,3,4,4,3,3,3,3,3,3,2,4,4,3,3,3,3,3,3,3,3,3,3,3,2,2,2,4,3,3,3,3,3,3,3,3,0.5747437083869038,0.5345224838248488,3.25,0,3,0,3.1333333333333333,0,3.111111111111111,0,3.0833333333333335,0,3,0,2.7142857142857144,0,3,0,3,0,0,0,0,1.1952002067268923,0.06894653330606912,0.6320733700164807,3,3,2,4,2,3,5,1,1,0.9759000729485332,3.142857142857143,0,1,0.2831299733903977,3,3,4,4,2,2,2,7,7,3,3,0.8997354108424374,7,2.857142857142857,0,0.4032826894249255,0,-0.07100021286322747,3,3,3,3,3,3,3,4,4,4,2,3,3,3,2,4,3,3,3,3,0.6399404734221844,3,0,2.8,0,3.4,0,3.2,0,3.1333333333333333,0,2,2,3,2,3,2,1,3,2,2,2,3,2,2,3,2,3,2,2,2,0.5501196042201808,2.25,0,2,2,3,2,3,2,1,3,2,2,2,3,2,2,3,2,3,2,2,2,0.5501196042201808,2.25,0,I lived with my mother and father an equal amount of time (joint custody),0,"White, Caucasian, Anglo, European American",0,21,0,1,NA,1,3,5,Retail,3,180,72,3,5,2,0,1,2,0,1,I lived with my mother and father an equal amount of time (joint custody),0,TRUE,TRUE,TRUE,TRUE,TRUE,4,0.7100031250044704,0.5177580645122836,0.7916218750067056,0.8316500000119209,0.5835068965574791,0.8465166666666667,1,1,1,0.967741935483871,0.9354838709677419,0.967741935483871,0.09,0.417,0.244,0.037,1.286,139.92141161386573,1978.9358790219628,0.092,0.388,0.251,0.009,1.545,97.27821005177773,1923.5347013216426,304,0.9007407407407407,1,3,0,0,3,FALSE
529,2022-03-19T16:06:05Z,2022-03-19T16:22:43Z,997,1,2022-03-19T16:22:44Z,0.8999999761581421,Chrome,99.0.4844.74,Windows NT 10.0,1536,864,NA,1.7777777777777777,586,35,151,66,50,55,-0.1891151893916795,-0.4576507505632202,-0.9456646230247707,-0.3966017743509999,-0.22447716527374886,-0.48799585744453366,2,2,1,1,2,1,1,2,1,2,2,1,1,1,2,2,1,1,2,2,1.025978352085154,0,1,2,4,4,1.5,0,2,2,1,2,1,1,2,1,1,1,1,2,1,2,2,1,1,1,1,1,1,1,1,0,2,0,0,0,0,3,3,3,3,3,3,3,3,3,1,2,1,1,2,1,2,1,1,1,1,1,2,1,1,1,1,1,1,1,1,1,2,1,1,1,1,1,1,1,1,1,1.196842693269434,1.5491933384829668,1,0,1,0,1.4666666666666666,0,3,0,1.25,0,1.1666666666666667,0,1.1428571428571428,0,1,0,1.6216216216216217,0,0,0,0,-1.118755995540801,-0.6205191861769039,-0.8696375908588525,2,2,3,1,1,1,1,1,1,1.2149857925879117,1.5714285714285714,0,1,-0.6284221744847194,4,4,4,4,2,2,5,3,3,2,3,1.2909944487358056,3,3.5714285714285716,0,-0.5335462578170761,0,-0.25491299746036694,1,1,1,1,1,5,4,5,5,4,5,4,5,4,4,5,4,5,4,5,1.5491933384829668,1,0,4.6,0,4.4,0,4.6,0,4.533333333333333,0,1,1,1,2,1,1,1,1,1,1,1,1,1,1,1,1,1,1,1,1,1.145931016569864,1.05,0,1,1,1,2,1,1,1,1,1,1,1,1,1,1,1,1,1,1,1,1,1.145931016569864,1.05,0,I lived with my mother and father an equal amount of time (joint custody),0,"White, Caucasian, Anglo, European American",0,28,0,1,NA,1,3,5,sales,1,132,66,3,5,2,0,0,1,0,0,I lived with my mother and father an equal amount of time (joint custody),0,TRUE,TRUE,TRUE,TRUE,TRUE,1,0.502322580647084,0.5005843750089407,0.5273218750040978,0.6021187499910593,0.5569714285752603,0.5870551724166706,0.96875,1,1,1,0.9032258064516129,0.9354838709677419,0.06,0.379,0.464,0.018,1.691,66.17528112642063,1937.036856588302,0.06,0.381,0.486,0.018,1.766,80.07327165022764,1929.2618429925546,372,1.1022222222222222,0,3,0,0,3,FALSE
530,2022-03-19T16:15:20Z,2022-03-19T16:42:12Z,1612,1,2022-03-19T16:42:14Z,0.8999999761581421,Chrome,99.0.4844.74,Windows NT 10.0,1920,1080,Thank you for this interesting study!,1.7777777777777777,539,90,658,83,40,52,-0.2855813202975509,-0.15448135074188163,0.8937165747682981,-0.18728915503309204,-0.42925942472088774,-0.5216937811043864,2,2,2,1,3,1,2,2,1,3,3,2,1,1,2,3,2,1,3,2,0.7591546545162482,0,0,2,3,4,1.95,0,3,2,3,2,2,2,2,2,2,2,2,2,2,2,2,2,2,1,1,1,2,2,2,0,2,0,0,0,0,2,2,4,2,4,2,2,2,2,2,2,3,2,2,2,2,2,2,3,4,4,2,1,1,1,1,2,1,1,1,1,2,2,2,1,1,1,2,2,1,1,1.282827208023608,0.9611501047232549,1.625,0,1.5,0,2.1333333333333333,0,2.4444444444444446,0,2.5,0,1.3333333333333333,0,1.4285714285714286,0,1,0,1.972972972972973,0,0,0,0,-0.4007504449009533,-0.44815275630616064,-0.42445160060355697,2,2,2,2,1,2,2,2,1,1.1338934190276817,1.8571428571428572,0,1.5,-0.2694328190817869,2,2,4,3,1,1,3,6,6,2,3,1.1126972805283737,6,2.2857142857142856,0,0.008517184721536036,0,-0.6213372437522214,1,2,2,3,2,4,3,4,4,2,5,3,4,2,3,3,4,5,3,3,0.828078671210825,2,0,4.2,0,3,0,3.2,0,3.466666666666667,0,1,1,1,1,1,1,1,2,1,1,1,1,1,1,1,1,1,1,1,1,1.145931016569864,1.05,0,1,1,1,1,1,1,1,2,1,1,1,1,1,1,1,1,1,1,1,1,1.145931016569864,1.05,0,I lived with my mother and father an equal amount of time (joint custody),0,"Asian or Asian American (e.g., Chinese, Japanese, and others)",0,21,0,1,NA,1,2,4,Student,2,140,68,2,5,2,0,0,2,0,0,I lived with my mother and father an equal amount of time (joint custody),0,TRUE,TRUE,TRUE,TRUE,TRUE,5,0.45939687502384186,0.40065937499329446,0.44202500000968575,0.5239516129147622,0.4741999999900018,0.5937900000135103,1,1,1,0.96875,0.96875,0.9375,0.06,0.344,0.473,0.009,1.409,184.84031439593255,2044.875923962502,0.06,0.344,0.545,0.009,1.464,206.15266174919867,2054.942610961813,306,0.9066666666666667,0,3,0,6,9,FALSE
531,2022-03-19T16:18:56Z,2022-03-19T16:42:44Z,1427,1,2022-03-19T16:42:44Z,0.8999999761581421,Chrome,99.0.4844.74,Windows NT 10.0,1536,864,NA,1.7777777777777777,516,53,421,109,63,71,-0.3327881503153178,-0.35843167425805483,0.03388749414313579,0.13283602745312004,0.04173977200753163,-0.3082735979253192,1,1,1,1,1,1,1,1,1,1,1,1,1,1,1,1,1,1,1,1,1.538967528127731,0,1,1,5,5,1,0,1,1,1,1,1,1,1,1,1,1,2,2,1,1,2,1,1,2,1,1,1,1,1,1,2,0,0,0,0,1,1,1,1,2,4,4,1,2,1,1,1,1,2,1,1,5,5,3,3,3,1,5,1,3,4,1,1,2,1,1,1,1,1,1,1,1,1,1,1,1,1.75401726803831,1.8973665961010275,1.125,0,1,0,1.2,0,1.8888888888888888,0,2.25,0,2.5,0,1.1428571428571428,0,1,0,1.8918918918918919,0,1,0,0,-1.0625556981569282,-0.4013584353189139,-0.731957066737921,1,2,1,1,1,1,1,1,1,1.889822365046136,1.1428571428571428,0,1,-0.8770273057233877,5,5,5,5,4,4,5,6,3,3,4,1.4638501094227998,4.5,4.714285714285714,0,0.2958312392376234,0,0.8700495840988496,3,2,3,1,1,5,5,5,5,5,5,5,5,4,5,5,5,5,3,3,1.8593393604027366,2,0,5,0,4.6,0,4.4,0,4.666666666666667,0,2,1,1,1,1,2,1,1,1,1,1,2,2,3,1,2,1,2,1,1,1.0563093645728086,1.4,0,2,1,1,1,1,2,1,1,1,1,1,2,2,3,1,2,1,2,1,1,1.0563093645728086,1.4,0,I lived with my mother and father an equal amount of time (joint custody),0,"White, Caucasian, Anglo, European American",0,30,0,1,NA,1,3,7,Speech Therapist,2,145,64,3,5,2,0,0,1,0,0,I lived with my mother and father an equal amount of time (joint custody),0,TRUE,TRUE,TRUE,TRUE,TRUE,3,0.48652187500707805,0.4307967741931638,0.4975562500022352,0.5972099999984105,0.4895483870986969,0.6297387096804957,1,1,1,0.9375,0.96875,0.96875,0.077,0.345,0.472,0.016,1.98,80.68073402820887,1923.198624415476,0.082,0.341,0.526,0.019,2.41,83.44588859164773,1910.617539403955,460,1.3629629629629632,0,3,3,6,9,FALSE
532,2022-03-19T16:19:42Z,2022-03-19T16:46:45Z,1622,1,2022-03-19T16:46:46Z,0.800000011920929,Chrome,99.0.4844.51,Windows NT 6.3,1440,960,Very interesting and active study,1.5,1127,65,165,29,23,102,0.9212715514610107,-0.2922856233879446,-0.8948730317642126,-0.8521645340429171,-0.7773892657810237,0.03993827989315878,2,3,1,1,3,1,1,2,2,2,2,4,3,3,1,2,2,2,2,1,1,0,1,1,5,4,2,0,3,2,4,3,3,1,3,3,2,1,2,2,3,2,1,4,3,3,3,2,3,4,5,1,1,2,1,0,0,2,3,2,3,4,3,2,3,4,3,2,4,3,3,4,3,3,3,4,4,3,3,2,3,2,2,3,3,4,4,3,1,4,3,3,2,1,2,1,2,3,0.8219949365267865,1.1338934190276817,3.375,0,2,0,2.3333333333333335,0,2.888888888888889,0,3.25,0,2.5,0,3.142857142857143,0,2,0,2.918918918918919,0,1,0,1,0.8647897017922841,0.8479035383463732,0.8563466200693286,3,2,2,3,4,4,3,1,2,0.7559289460184544,3,0,1.5,0.39351419755466194,3,4,4,3,2,3,2,6,6,1,3,0.7559289460184544,6,3,0,-0.2055605058023161,0,-0.3646953086757706,3,4,4,3,3,3,2,4,3,3,2,3,4,3,3,2,3,4,3,2,0.7037315505489968,3.4,0,3,0,2.8,0,3,0,2.933333333333333,0,2,3,3,3,2,3,3,2,2,2,3,2,2,3,3,3,2,1,1,1,0.7326950970650465,2.3,0,2,3,3,3,2,3,3,2,2,2,3,2,2,3,3,3,2,1,1,1,0.7326950970650465,2.3,0,"I lived with my mother, but not father, most of the time. & I lived with my father, but not mother, most of the time.",1,"Asian or Asian American (e.g., Chinese, Japanese, and others)",0,28,0,1,NA,1,3,6,IT,3,135,63,4,5,2,0,0,4,0,0,"I lived with my mother, but not father, most of the time. & I lived with my father, but not mother, most of the time.",1,TRUE,TRUE,TRUE,TRUE,TRUE,2,0.8895625,0.8384193548387097,0.92596875,0.9649354838709677,0.8919375,0.9641935483870968,1,1,1,1,1,1,0.574,0.344,0.993,0.021,1.141,39.94931120549052,1842.766842779498,0.569,0.352,0.993,0.026,1.203,60.892803346246104,1841.0667189935755,304,0.9007407407407407,1,3,0,0,3,FALSE
533,2022-03-19T16:23:39Z,2022-03-19T17:02:28Z,2329,1,2022-03-19T17:02:30Z,0.8999999761581421,Chrome,99.0.4844.51,Windows NT 10.0,1366,768,I do not have any feedback for this survey.,1.7786458333333333,581,164,713,300,193,193,-0.19937754374336794,0.25341929629046483,1.093254969006205,2.484524868024909,2.7039091448203365,1.062108630908691,1,1,1,1,2,1,1,2,1,2,3,1,1,3,2,3,1,1,3,2,1.0990426455975697,0,0,2,3,3,1.65,0,3,2,5,3,4,2,5,2,3,2,1,3,1,3,2,2,4,2,1,1,1,1,1,1,2,0,0,0,0,1,2,3,1,1,1,1,2,1,3,1,3,2,3,4,3,5,5,5,2,5,3,2,1,1,5,4,3,1,1,1,2,2,3,1,1,1,2,1,1,1,1.5528719880954165,1.2227992865708155,1.625,0,1.25,0,2.7333333333333334,0,1.4444444444444444,0,3.4166666666666665,0,2.6666666666666665,0,1.8571428571428572,0,1,0,2.324324324324324,0,1,0,0,0.014993961665560251,-0.3151752203835423,-0.150090629358991,2,1,3,1,1,2,1,2,1,1.2149857925879117,1.5714285714285714,0,1.5,-0.4351695732408991,5,4,5,5,4,4,3,4,3,5,4,0.7559289460184544,3.5,4.285714285714286,0,0.5432988061057903,0,0.7886139231752537,3,2,3,2,3,4,5,5,5,2,5,4,4,5,3,2,5,4,1,2,1.5675276256394517,2.6,0,4.4,0,2.8,0,4,0,3.7333333333333334,0,2,1,1,2,3,2,3,2,2,1,4,2,1,2,1,2,1,2,1,2,0.9445132413883326,1.85,0,2,1,1,2,3,2,3,2,2,1,4,2,1,2,1,2,1,2,1,2,0.9445132413883326,1.85,0,I lived with my mother and father an equal amount of time (joint custody),0,"White, Caucasian, Anglo, European American",0,27,0,1,NA,1,3,4,Unable to work,2,75,54,1,5,2,0,0,1,0,0,I lived with my mother and father an equal amount of time (joint custody),0,TRUE,TRUE,TRUE,TRUE,TRUE,5,0.6073548387096774,0.5807562500536442,0.6599718750268221,0.6282374999970197,0.599183870976971,0.7089999999671147,0.96875,1,1,1,1,0.90625,0.064,0.451,0.266,0.025,1.31,83.48211736053655,1982.794519133311,0.063,0.459,0.265,0.034,1.379,92.6315313423686,1978.7692566026512,232,0.6874074074074075,0,3,0,0,3,FALSE
534,2022-03-19T16:49:02Z,2022-03-19T17:11:14Z,1332,1,2022-03-19T17:11:19Z,0.8999999761581421,Chrome,99.0.4844.51,Windows NT 10.0,1707,960,NA,1.778125,523,116,395,88,66,82,-0.31842085422295396,-0.011164907189976115,-0.060439746769329276,-0.12572661993958972,0.10317444984167329,-0.18471454450585928,3,4,2,2,4,1,3,4,1,3,4,3,1,4,4,3,2,2,4,4,0.8645047258706176,0,0,2,3,2,2.9,0,2,1,2,1,2,2,2,2,2,1,3,2,3,2,2,2,3,4,2,1,2,2,2,1,2,0,0,0,0,1,2,1,1,1,1,2,1,1,1,1,2,1,2,1,2,1,2,1,1,2,3,1,1,2,3,1,1,3,2,1,1,2,2,1,1,1,1,2,2,2,1.653552005300781,1.245945806357946,2.25,0,1.75,0,1.9333333333333333,0,1.2222222222222223,0,1.4166666666666667,0,1.8333333333333333,0,1.7142857142857142,0,1,0,1.4594594594594594,0,1,0,0,-0.4394312100005364,-0.14280879051279902,-0.29112000025666773,1,2,3,2,1,2,2,3,1,1.2724180205607036,1.8571428571428572,0,2,-0.07618021783796666,5,5,5,5,3,3,5,8,6,6,3,1.5735915849388864,7,4.428571428571429,0,1.045515760996482,0,1.1721681415988898,2,3,3,2,2,4,4,4,5,3,4,4,5,4,4,5,5,4,4,4,1.3345232785352157,2.4,0,4.2,0,4.2,0,4.2,0,4.2,0,1,3,4,4,4,4,3,4,3,3,2,3,2,4,2,3,3,4,3,3,1.0310954828418375,3.1,0,1,3,4,4,4,4,3,4,3,3,2,3,2,4,2,3,3,4,3,3,1.0310954828418375,3.1,0,I lived with my mother and father an equal amount of time (joint custody),0,"White, Caucasian, Anglo, European American",0,29,0,1,NA,1,2,7,Graduate Student Researcher,2,150,72,2,5,2,0,0,1,0,0,I lived with my mother and father an equal amount of time (joint custody),0,TRUE,TRUE,TRUE,TRUE,TRUE,3,0.5020874999910593,0.4592874999977648,0.4796218750067055,0.587190000017484,0.5172193548371715,0.5440937499962747,1,1,1,0.967741935483871,0.96875,1,0.118,0.3,0.696,0.016,1.422,57.960592211104704,1868.1510626522067,0.126,0.301,0.771,0.018,1.626,77.87070636564268,1861.2638045082265,426,1.2622222222222224,0,3,0,0,3,FALSE
535,2022-03-19T16:56:22Z,2022-03-19T17:15:19Z,1136,1,2022-03-19T17:15:22Z,0.8999999761581421,Chrome,99.0.4844.74,Windows NT 10.0,1920,1080,N/A,1.7777777777777777,571,84,265,69,42,52,-0.21990225244674486,-0.18755437617693674,-0.5320759513316546,-0.35966425329489854,-0.38830297283146,-0.5216937811043864,2,3,2,2,4,1,2,4,2,3,4,2,2,2,3,4,2,1,2,4,0.6386663736585051,0,1,1,3,3,2.55,0,4,4,3,4,3,3,4,3,3,3,3,4,2,4,4,5,4,3,2,5,5,4,4,5,2,0,0,0,0,3,4,4,4,4,3,4,4,4,3,4,4,3,4,3,4,4,4,4,5,5,4,4,1,3,5,1,3,4,3,1,3,3,3,3,2,3,3,2,3,2,1.067539057664702,0.5163977794943222,4,0,2.5,0,3.4,0,3.7777777777777777,0,3.9166666666666665,0,3,0,2.857142857142857,0,2.6666666666666665,0,3.4324324324324325,0,3,0,0,1.8284624017668898,0.5540623560092959,1.191262378888093,3,2,5,2,1,2,2,4,3,0.6900655593423543,2.4285714285714284,0,3.5,0.8350510942117183,3,3,3,2,1,1,2,3,1,2,2,1.1338934190276817,2,2.142857142857143,0,-1.0585021572581548,0,-1.34916807878782,2,2,2,2,2,4,4,4,4,3,3,4,4,4,4,4,4,4,4,4,0.9611501047232549,2,0,3.8,0,3.8,0,4,0,3.8666666666666667,0,1,3,4,4,4,4,4,4,4,3,3,4,3,3,2,4,1,4,2,4,1.268027892769755,3.25,0,1,3,4,4,4,4,4,4,4,3,3,4,3,3,2,4,1,4,2,4,1.268027892769755,3.25,0,"I lived with my mother, but not father, most of the time.",0,"White, Caucasian, Anglo, European American",0,24,0,1,NA,1,2,4,Unemployed,1,300,72,1,5,2,0,0,1,0,0,"I lived with my mother, but not father, most of the time.",0,TRUE,TRUE,TRUE,TRUE,TRUE,1,0.5555781250074506,0.49754516127032616,0.5704093749783933,0.6139935484086313,0.49705937498807906,0.6471032257810716,1,1,1,1,1,1,0.162,0.221,0.44,0.101,1.836,110.02601654261744,1938.309610073531,0.162,0.218,0.448,0.028,2.005,106.41290864544314,1892.2003473216691,281,0.8325925925925926,0,3,0,0,3,FALSE
536,2022-03-19T17:07:43Z,2022-03-19T17:40:55Z,1991,1,2022-03-19T17:40:57Z,0.8999999761581421,Chrome,99.0.4844.74,Windows NT 6.1,1280,720,Thank you and goodluck in your research!! :),1.7777777777777777,929,117,534,103,69,92,0.5148823191341481,-0.0056527362841335945,0.4438481950319263,0.05896098534091724,0.16460912767581495,-0.07238813230635024,2,3,2,2,3,2,2,3,1,3,2,2,2,2,2,3,2,1,2,3,0.5525062514530825,0,0,3,3,3,2.2,0,4,3,3,3,4,3,3,4,2,3,2,4,2,4,4,4,4,1,1,4,4,4,3,20,2,0,0,0,0,2,2,4,2,3,1,2,1,2,2,1,1,1,3,2,1,5,3,2,3,3,3,1,1,1,3,1,1,5,5,5,3,3,2,1,4,1,3,2,3,3,1.4811123163668898,0.7237468644557459,3.125,0,2.75,0,3.2,0,2.111111111111111,0,2.25,0,1.6666666666666667,0,3.4285714285714284,0,2,0,2.324324324324324,0,6,0,0,0.8744352869825108,1.2977278235186376,1.0860815552505743,3,3,4,2,2,3,3,3,3,0.5345224838248488,2.857142857142857,0,3,0.8904036242065665,3,3,3,2,1,1,2,6,3,2,2,1.1338934190276817,4.5,2.142857142857143,0,-0.6067826218093113,0,-1.073821378991826,2,2,2,2,2,4,5,4,4,5,4,4,5,5,5,4,4,3,5,3,1.4474937289114918,2,0,3.8,0,4.8,0,4.2,0,4.266666666666667,0,1,1,1,1,1,2,2,1,1,2,3,3,1,1,2,3,1,3,2,2,0.9679060415469871,1.7,0,1,1,1,1,1,2,2,1,1,2,3,3,1,1,2,3,1,3,2,2,0.9679060415469871,1.7,0,I lived with my mother and father an equal amount of time (joint custody),0,"White, Caucasian, Anglo, European American",0,27,0,1,NA,1,3,3,Business Owner,4,225,71,4,5,2,0,0,1,0,0,I lived with my mother and father an equal amount of time (joint custody),0,TRUE,TRUE,TRUE,TRUE,TRUE,6,0.5951250000000146,0.4881968749999796,0.5482343750000291,0.6487399999999751,0.587106249999968,0.7064966666667412,1,1,1,0.9375,1,0.967741935483871,0.094,0.339,0.478,0.005,1.242,95.44244235689008,1924.6374601151244,0.097,0.342,0.51,0.005,1.283,113.83531453360062,1941.8168887097163,212,0.6281481481481481,0,3,0,0,3,FALSE
537,2022-03-19T18:17:09Z,2022-03-19T18:34:44Z,1055,1,2022-03-19T18:34:46Z,1,Firefox,98.0,Windows NT 10.0,1920,1080,N/A,1.7777777777777777,495,64,232,117,41,63,-0.37589003859240927,-0.2977977942937871,-0.6517989878743987,0.23133608360272373,-0.40878119877617386,-0.3981347276849264,3,2,2,2,2,1,1,3,1,3,4,1,1,1,3,2,1,1,3,3,0.7326950970650465,0,0,2,2,2,2,0,2,1,1,2,1,1,1,1,1,1,1,2,2,3,2,3,2,1,1,1,1,1,1,0,2,0,0,0,0,1,2,1,1,2,1,1,2,2,1,2,1,1,2,2,2,1,1,1,1,4,1,1,1,1,3,3,1,1,1,1,2,1,3,1,1,1,3,2,1,1,1.6589913357978252,1.6417180315870614,1.375,0,1.75,0,1.4666666666666666,0,1.4444444444444444,0,1.5833333333333333,0,1.6666666666666667,0,1.4285714285714286,0,1,0,1.4864864864864864,0,0,0,0,-1.0139340748510905,-0.361969541370789,-0.6879518081109398,1,1,2,1,1,1,1,1,2,1.7320508075688772,1.1428571428571428,0,1.5,-0.6837747044795675,5,5,5,4,1,1,4,6,6,2,2,1.889822365046136,6,3.5714285714285716,0,-0.3357509005400053,0,-0.1343463746175106,3,2,2,3,2,3,3,4,5,2,1,4,4,3,5,5,4,5,4,5,1.4375905768565218,2.4,0,3.4,0,3.6,0,4.4,0,3.8,0,2,1,1,2,2,2,4,4,1,1,1,3,1,1,1,3,1,2,3,1,0.8750939799154206,1.85,0,2,1,1,2,2,2,4,4,1,1,1,3,1,1,1,3,1,2,3,1,0.8750939799154206,1.85,0,I lived with my mother and father an equal amount of time (joint custody),0,"Asian or Asian American (e.g., Chinese, Japanese, and others)",0,19,0,1,NA,1,2,4,Student,2,220,68,2,5,2,0,0,1,0,0,I lived with my mother and father an equal amount of time (joint custody),0,TRUE,TRUE,TRUE,TRUE,TRUE,3,0.43884375,0.4131290322580645,0.43240625,0.5497333333333333,0.47103125,0.49789655172413794,1,0.96875,1,0.9375,1,0.9354838709677419,0.059,0.326,0.579,0.019,1.806,109.52464349491733,1989.795624977473,0.06,0.325,0.617,0.022,1.909,138.59177454261834,1991.5407696619222,272,0.8059259259259259,0,3,0,0,3,FALSE
538,2022-03-19T18:12:03Z,2022-03-19T18:38:39Z,1596,1,2022-03-19T18:38:41Z,1,Firefox,98.0,Windows NT 10.0,1536,864,NA,1.7777777777777777,572,108,520,171,56,97,-0.21784978157640716,-0.055262274436716274,0.3930566037713682,0.8962114626125488,-0.10160780960546556,-0.01622492620659573,1,2,1,1,1,1,1,2,1,2,1,1,1,2,2,2,1,1,2,2,1.1964860832322377,0,1,1,4,4,1.4,0,2,2,2,1,2,1,2,1,2,1,1,2,1,2,3,2,2,1,1,1,1,1,1,0,1,0,0,1,0,1,5,4,3,5,3,4,3,4,1,3,4,2,3,1,3,2,2,1,1,1,3,1,5,1,4,2,2,1,1,1,3,4,2,1,1,1,1,1,1,1,1.20559257357262,1.4540583599999397,1.25,0,1,0,1.6666666666666667,0,3.5555555555555554,0,2,0,2.6666666666666665,0,2,0,1,0,2.4054054054054053,0,0,0,0,-0.5795874682748537,-0.6205191861769039,-0.6000533272258788,1,1,4,2,1,1,1,2,2,1.4638501094227998,1.5714285714285714,0,2,-0.24191697199707893,5,5,4,4,1,1,4,4,5,3,2,1.7728105208558367,4.5,3.4285714285714284,0,-0.3927049312854592,0,-0.2464895357728703,2,2,3,2,3,3,3,3,4,4,2,2,5,4,2,2,2,3,3,1,1.0690449676496976,2.4,0,2.4,0,3.4,0,2.8,0,2.8666666666666667,0,1,2,3,2,2,3,2,3,1,1,4,2,1,2,1,3,1,2,1,2,0.8870412083230169,1.95,0,1,2,3,2,2,3,2,3,1,1,4,2,1,2,1,3,1,2,1,2,0.8870412083230169,1.95,0,"I lived with my mother, but not father, most of the time.",0,"White, Caucasian, Anglo, European American",0,29,0,1,NA,1,2,7,Staff Accountant,2,205,69,2,5,2,0,0,0,0,0,"I lived with my mother, but not father, most of the time.",0,TRUE,TRUE,TRUE,TRUE,TRUE,1,0.5475,0.478375,0.5166875,0.6165333333333334,0.50375,0.5646,1,1,1,0.967741935483871,1,0.967741935483871,0.061,0.381,0.461,0.024,1.763,19.05163569199302,1856.153367094403,0.064,0.378,0.49,0.031,2.01,32.292929045512246,1859.0655945617405,390,1.1555555555555557,0,3,0,0,3,FALSE
539,2022-03-19T18:22:00Z,2022-03-19T18:52:46Z,1845,1,2022-03-19T18:52:47Z,1,Edge,99.0.1150.46,Windows NT 10.0,1366,768,NA,1.7786458333333333,603,147,742,133,59,92,-0.15422318459593878,0.159712390891142,1.1984661223316468,0.42833619590193117,-0.04017313177132391,-0.07238813230635024,2,3,1,1,3,1,2,3,1,3,3,2,1,1,2,3,2,1,3,3,0.6386663736585051,0,0,2,3,3,2.05,0,4,2,3,3,5,1,4,1,3,1,1,2,2,3,5,2,1,1,1,1,1,1,1,0,2,0,0,0,0,2,5,4,3,5,2,4,4,3,1,3,1,1,4,3,4,4,3,2,2,3,3,1,1,1,4,1,1,1,1,1,2,1,1,1,1,1,1,1,1,1,1.1176981923798792,1.2983506020002016,1.125,0,1,0,2.6666666666666665,0,3.5555555555555554,0,2.5833333333333335,0,1.8333333333333333,0,1.1428571428571428,0,1,0,2.2972972972972974,0,0,0,0,-0.24445259508380726,-0.6205191861769039,-0.4324858906303556,1,1,4,1,1,1,1,1,1,1.4960264830861913,1.4285714285714286,0,1,-0.7112905515642753,4,4,4,3,2,2,4,3,3,2,2,1,3,3.2857142857142856,0,-0.8778143430786174,0,-0.6196158112720472,2,1,1,1,1,5,3,2,5,1,5,4,5,3,4,5,4,5,2,3,1.3345232785352157,1.2,0,4.6,0,3.2,0,3.4,0,3.7333333333333334,0,1,2,1,2,2,2,1,2,2,2,2,2,2,1,1,2,1,2,1,1,0.7677718959499145,1.6,0,1,2,1,2,2,2,1,2,2,2,2,2,2,1,1,2,1,2,1,1,0.7677718959499145,1.6,0,"I lived with my mother, but not father, most of the time.",0,"White, Caucasian, Anglo, European American",0,23,0,1,NA,1,1,2,unemployed,1,150,68,3,5,2,0,0,1,0,0,"I lived with my mother, but not father, most of the time.",0,TRUE,TRUE,TRUE,TRUE,TRUE,6,0.566203125,0.6702843750026077,0.6046062500011176,0.6333064516071351,0.7598645161255714,0.7103419354769491,1,1,1,1,0.96875,1,0.077,0.43,0.465,0.023,1.776,102.32627294982076,1902.8336835309972,0.072,0.428,0.437,0.019,1.88,103.82253847223575,1888.0215389841355,344,1.0192592592592593,0,3,0,0,3,FALSE
540,2022-03-19T18:48:48Z,2022-03-19T19:12:55Z,1446,1,2022-03-19T19:13:01Z,0.8999999761581421,Chrome,99.0.4844.51,Windows NT 10.0,1440,900,"Interesting study, enjoyed it!",1.6,559,106,438,94,75,94,-0.24453190289079713,-0.0662866162484013,0.09556299781667064,-0.05185157782738694,0.28747848334409826,-0.04992284986644844,2,3,1,1,2,1,1,3,1,2,3,1,2,2,2,1,1,1,3,3,0.9119095061289915,0,0,4,4,3,1.8,0,3,3,4,2,3,3,4,4,3,3,3,3,2,3,2,2,2,1,1,2,2,3,3,0,2,0,0,0,0,2,4,1,3,4,2,4,3,3,2,1,2,1,3,2,1,2,2,2,1,3,1,1,1,1,3,1,2,1,1,1,3,2,3,1,1,1,2,2,2,1,1.292156983369153,0.6399404734221844,2,0,1.75,0,3,0,2.888888888888889,0,1.8333333333333333,0,1.3333333333333333,0,1.8571428571428572,0,1,0,1.945945945945946,0,0,0,0,0.13005201357755244,-0.361969541370789,-0.11595876389661829,1,2,3,2,1,2,2,3,4,1.2724180205607036,1.8571428571428572,0,3.5,0.503577585893494,4,4,5,3,3,2,4,3,4,5,3,1.1126972805283737,3.5,3.5714285714285716,0,0.19903072084424905,0,0.19163101401455812,3,2,2,3,3,3,4,3,4,2,4,3,1,3,3,4,3,4,3,2,0.8837151016885368,2.6,0,3.4,0,2.8,0,3,0,3.066666666666667,0,1,2,2,2,2,2,3,3,3,2,2,4,3,3,2,4,1,3,2,3,0.7451598203705946,2.45,0,1,2,2,2,2,2,3,3,3,2,2,4,3,3,2,4,1,3,2,3,0.7451598203705946,2.45,0,I lived with my mother and father an equal amount of time (joint custody),0,"White, Caucasian, Anglo, European American",0,27,0,1,NA,1,2,4,Winemaker,5,187,74,2,5,2,0,0,1,0,0,I lived with my mother and father an equal amount of time (joint custody),0,TRUE,TRUE,TRUE,TRUE,TRUE,1,0.8797225806463149,0.4768468749970198,0.5865093749985099,0.8305870967718862,0.5515620689659283,0.6936838709731256,1,1,1,0.96875,0.9354838709677419,1,0.139,0.359,0.607,0.013,1.459,45.671552799221054,1859.427397682743,0.136,0.362,0.605,0.013,1.543,62.08982199075193,1845.7443319896493,312,0.9244444444444444,0,3,0,0,3,FALSE
541,2022-03-19T19:15:22Z,2022-03-19T19:38:53Z,1411,1,2022-03-19T19:38:55Z,0.8999999761581421,Chrome,99.0.4844.74,Windows NT 10.0,1920,1080,Interesting study. The game was kind of fun.,1.7777777777777777,573,112,310,81,62,100,-0.21579731070606947,-0.03321359081334619,-0.3688172651370035,-0.21191416907049299,0.021261546062817747,0.017472997453256978,2,2,3,2,3,1,1,2,1,3,3,1,3,1,3,2,1,1,3,3,0.8255779474818965,0,1,4,3,2,2.05,0,2,1,2,1,2,2,1,2,1,1,2,1,1,1,2,2,2,1,1,2,2,2,1,1,2,0,0,0,0,1,1,3,1,2,1,1,1,1,2,1,1,1,1,2,1,2,1,1,2,2,1,5,1,1,1,1,1,5,5,1,1,2,2,2,1,1,1,1,2,2,1.8025674049114637,1.6676187756655838,1.625,0,1.5,0,1.4666666666666666,0,1.3333333333333333,0,1.4166666666666667,0,1.6666666666666667,0,2.4285714285714284,0,1.3333333333333333,0,1.6216216216216217,0,1,0,0,-0.8456284557154992,-0.22899200544817064,-0.5373102305818349,3,2,3,3,2,2,2,3,2,0.5345224838248488,2.4285714285714284,0,2.5,0.44854589172407777,5,5,5,5,3,3,5,6,6,5,3,1.5735915849388864,6,4.428571428571429,0,0.6507502562930925,0,0.9315379045085834,2,2,3,3,2,3,5,3,4,3,4,4,3,4,4,4,4,4,2,3,0.9611501047232549,2.4,0,3.8,0,3.4,0,3.6,0,3.6,0,1,2,1,2,1,1,2,2,1,1,2,1,1,1,1,2,1,2,2,1,0.9233805168766387,1.4,0,1,2,1,2,1,1,2,2,1,1,2,1,1,1,1,2,1,2,2,1,0.9233805168766387,1.4,0,I lived with my mother and father an equal amount of time (joint custody),0,"Asian or Asian American (e.g., Chinese, Japanese, and others)",0,20,0,1,NA,1,3,4,Student,6,134,67,3,5,2,0,0,1,0,0,I lived with my mother and father an equal amount of time (joint custody),0,TRUE,TRUE,TRUE,TRUE,TRUE,3,0.6043187499986962,0.5949781249994412,0.5823781249988824,0.6891218749997206,0.6611290322578242,0.6601531250001863,1,1,1,1,1,1,0.172,0.323,0.716,0.008,1.135,8.514977354426124,1792.088584543778,0.176,0.328,0.738,0.009,1.227,15.10961272647832,1797.4966219037155,280,0.8296296296296296,0,3,0,3,6,FALSE
543,2022-03-19T20:09:04Z,2022-03-19T20:31:54Z,1370,1,2022-03-19T20:31:56Z,0.8999999761581421,Chrome,99.0.4844.74,Windows NT 10.0,1536,864,NA,1.7777777777777777,549,74,405,94,38,66,-0.26505661159417404,-0.24267608523536194,-0.024160038726073477,-0.05185157782738694,-0.4702158766103155,-0.3644368040250737,2,2,2,2,3,1,2,3,1,3,4,4,3,2,3,3,4,1,4,3,0.9119095061289915,0,1,1,3,3,2.6,0,4,1,2,3,4,2,4,3,2,2,2,4,2,4,3,2,5,1,1,3,5,3,1,1,2,0,0,0,0,1,1,3,2,2,1,1,1,1,3,1,1,2,3,1,1,3,1,1,1,3,5,1,1,1,1,1,1,1,1,1,4,5,3,1,1,1,1,1,1,1,1.6934780387911346,0.9154754164341269,2.625,0,1,0,2.8,0,1.4444444444444444,0,1.75,0,1.6666666666666667,0,2.2857142857142856,0,1,0,1.7027027027027026,0,1,0,0,0.20948045488891037,-0.4013584353189139,-0.09593899021500177,1,1,1,1,1,1,1,3,1,1.9518001458970664,1,0,2,-0.5733904803153034,5,5,5,5,2,2,5,6,3,4,3,1.8126539343499315,4.5,4.142857142857143,0,0.16564084449993424,0,0.48098493055973457,2,2,2,2,2,4,4,4,4,3,5,3,5,4,4,4,4,5,3,5,1.1872336794093274,2,0,4.2,0,3.8,0,4.2,0,4.066666666666666,0,1,1,1,2,3,1,2,3,1,1,2,2,2,1,1,3,1,1,1,2,0.7539370349250519,1.6,0,1,1,1,2,3,1,2,3,1,1,2,2,2,1,1,3,1,1,1,2,0.7539370349250519,1.6,0,I lived with my mother and father an equal amount of time (joint custody),0,"White, Caucasian, Anglo, European American",0,30,0,1,NA,1,2,6,Self Employed,3,225,73,1,5,2,0,0,1,0,0,I lived with my mother and father an equal amount of time (joint custody),0,TRUE,TRUE,TRUE,TRUE,TRUE,6,0.6236967741866265,0.5891562499925495,0.573337500013411,0.6052281250022352,0.617318750012666,0.7242366666754086,1,1,1,1,1,0.967741935483871,0.084,0.364,0.428,0.011,1.85,37.88065473750742,1872.7198380444509,0.084,0.364,0.428,0.012,1.934,47.75323788288868,1875.5214629381992,342,1.0133333333333332,0,3,0,0,3,FALSE
544,2022-03-19T20:24:25Z,2022-03-19T20:39:22Z,896,1,2022-03-19T20:39:22Z,1,Opera,84.0.4316.31,Windows NT 10.0,1920,1080,n/a,1.7777777777777777,476,48,215,39,22,57,-0.4148869851288254,-0.3859925287872675,-0.7134744915479336,-0.7290394638559125,-0.7978674917257377,-0.46553057500463185,2,2,1,1,1,1,1,2,1,2,2,1,1,1,1,1,1,1,2,1,1.2814465510343749,0,1,2,3,3,1.3,0,1,1,1,1,1,1,1,1,1,1,1,1,1,1,1,1,1,1,1,1,1,1,1,4,1,2,0,2,0,1,1,3,1,1,1,4,1,1,1,1,1,1,3,3,1,1,1,1,1,1,1,1,1,1,3,1,2,2,3,1,1,1,1,1,1,1,2,1,1,1,1.757438075321173,2.065591117977289,1,0,1.25,0,1,0,1.5555555555555556,0,1.3333333333333333,0,1.3333333333333333,0,1.5714285714285714,0,1,0,1.4054054054054055,0,2,0,0,-1.4171785904057796,-0.09601446952555226,-0.756596529965666,1,1,3,1,1,1,2,3,3,1.5275252316519468,1.4285714285714286,0,3,0.06171985341100544,4,4,4,4,2,2,3,7,4,5,3,0.9511897312113419,5.5,3.2857142857142856,0,0.5604063492033238,0,0.2570549769520093,1,1,1,1,1,5,5,5,5,5,5,5,5,5,4,5,5,5,5,3,1.9444671200491874,1,0,5,0,5,0,4.4,0,4.8,0,1,1,1,1,1,1,1,1,1,1,1,1,1,1,1,1,1,1,1,1,1.231174022502185,1,0,1,1,1,1,1,1,1,1,1,1,1,1,1,1,1,1,1,1,1,1,1.231174022502185,1,0,I lived with my mother and father an equal amount of time (joint custody),0,"Asian or Asian American (e.g., Chinese, Japanese, and others)",0,26,0,1,NA,1,3,6,speech language pathologist assistant,3,160,69,3,5,2,0,0,1,0,0,I lived with my mother and father an equal amount of time (joint custody),0,TRUE,TRUE,TRUE,TRUE,TRUE,6,0.5102093750001514,0.45293124999979045,0.490971875000163,0.5979437499998022,0.5315833333333333,0.610209375000326,1,1,1,1,0.9375,1,0.193,0.262,0.831,0.005,0.953,29.544433008990165,1824.0398602179491,0.197,0.262,0.852,0.005,1.003,38.81379538326164,1822.5859200960113,304,0.9007407407407407,1,3,0,3,6,FALSE
545,2022-03-19T20:15:43Z,2022-03-19T20:40:38Z,1495,1,2022-03-19T20:40:40Z,0.8999999761581421,Chrome,99.0.4844.74,Windows NT 10.0,1920,1080,NA,1.7777777777777777,606,125,468,84,58,99,-0.1480657719849257,0.038444630962606564,0.20440212194643803,-0.17497664801439158,-0.060651357716037795,0.006240356233306075,2,1,3,1,1,1,1,1,1,1,1,1,2,1,2,1,1,1,1,1,1.394538218230416,0,1,1,5,4,1.25,0,2,3,2,2,1,4,4,1,3,2,1,4,1,3,5,3,1,1,1,2,1,2,1,2,2,0,0,0,0,1,5,5,1,1,1,1,1,2,1,3,5,1,4,3,1,4,2,5,5,4,1,1,1,1,3,2,3,2,2,2,2,3,3,2,2,1,1,2,2,3,1.5625112612206804,1.162919151265879,1.5,0,2,0,2.533333333333333,0,2,0,3.1666666666666665,0,1.5,0,2.4285714285714284,0,1.6666666666666667,0,2.3513513513513513,0,1,0,0,-0.11522143840250225,-0.05662557557742737,-0.08592350698996482,1,1,5,1,1,1,1,3,6,1.5118578920369088,1.5714285714285714,0,4.5,0.7243460342220222,1,2,2,2,1,1,1,1,1,2,2,1.4142135623730951,1,1.4285714285714286,0,-1.2391899714376922,0,-1.846440250954577,1,1,1,1,2,5,5,5,5,5,5,5,5,5,5,5,5,5,5,3,2,1.2,0,5,0,5,0,4.6,0,4.866666666666666,0,1,1,1,1,3,1,1,1,2,1,4,1,1,1,1,1,1,1,1,1,1.3337718577107003,1.3,0,1,1,1,1,3,1,1,1,2,1,4,1,1,1,1,1,1,1,1,1,1.3337718577107003,1.3,0,"I lived with my extended family on mother's side (grandparents, aunts ,uncles, cousins)",0,Black or African American,0,22,0,1,NA,1,3,4,Data Analyst,3,192,72,4,5,2,0,0,1,0,0,"I lived with my extended family on mother's side (grandparents, aunts ,uncles, cousins)",0,TRUE,TRUE,TRUE,TRUE,TRUE,5,0.5916312500014901,0.4726843749955296,0.5759593749959022,0.6163843750022352,0.5287290322588336,0.5966967741962402,1,1,1,1,1,1,0.113,0.389,0.601,0.032,1.242,17.8086655421204,1809.3944554706975,0.112,0.392,0.603,0.035,1.284,36.13299847241323,1818.8045627586366,320,0.9481481481481481,0,3,0,0,3,FALSE
546,2022-03-19T20:15:11Z,2022-03-19T20:46:29Z,1877,1,2022-03-19T20:46:31Z,0.8999999761581421,Firefox,98.0,Macintosh,1920,1080,I do not.,1.7777777777777777,562,160,763,100,89,85,-0.23837449027978405,0.23137061266709474,1.274653509222484,0.022023464284815848,0.5741736465700926,-0.15101662084600656,2,3,2,1,3,1,2,3,1,3,4,1,1,3,2,3,2,1,3,4,0.7163503994113789,0,0,2,3,3,2.25,0,2,1,2,2,2,2,1,3,5,1,3,3,2,2,1,2,5,3,1,2,3,2,2,2,2,0,0,0,0,1,3,5,2,2,2,3,3,3,2,1,4,1,4,3,1,5,5,4,5,5,5,1,4,1,4,3,1,5,1,1,2,3,1,2,4,2,2,2,2,1,1.4977460543240444,1.3451854182690985,2.5,0,1.75,0,2.1333333333333333,0,2.6666666666666665,0,3.3333333333333335,0,3,0,2,0,2.6666666666666665,0,2.810810810810811,0,1,0,0,0.3477666507283879,-0.14280879051279902,0.10247893010779445,1,1,1,1,1,1,1,1,2,1.9518001458970664,1,0,1.5,-0.7666430815591236,3,5,5,5,2,2,1,5,4,3,2,1.4638501094227998,4.5,3.2857142857142856,0,-0.3927049312854592,0,-0.3239162342225421,2,2,1,1,2,5,5,4,5,3,5,5,4,4,4,5,5,5,3,3,1.5796322658258457,1.6,0,5,0,4,0,4,0,4.333333333333333,0,2,4,1,4,1,3,2,4,3,2,1,4,2,3,1,4,1,2,2,2,0.8944271909999159,2.4,0,2,4,1,4,1,3,2,4,3,2,1,4,2,3,1,4,1,2,2,2,0.8944271909999159,2.4,0,I lived with my mother and father an equal amount of time (joint custody),0,"White, Caucasian, Anglo, European American",0,27,0,2,NA,1,2,3,Unemployed,2,125,68,1,5,2,0,1,2,0,1,I lived with my mother and father an equal amount of time (joint custody),0,TRUE,TRUE,TRUE,TRUE,TRUE,1,0.46175,0.45440625,0.47190625,0.5356129032258065,0.5091875,0.5207666666666667,1,1,1,1,1,0.9375,0.04,0.405,0.586,0.028,1.727,115.18679733715267,2008.0448448323084,0.04,0.408,0.652,0.029,1.806,127.93400291820198,1982.4767315823683,354,1.0488888888888888,0,3,0,0,3,FALSE
548,2022-03-19T20:58:31Z,2022-03-19T21:46:46Z,2894,1,2022-03-19T21:46:47Z,1,Chrome,98.0.4758.80,Macintosh,1280,800,no,1.6,517,87,1939,93,76,106,-0.3307356794449801,-0.17101786345940917,5.541147175109366,-0.0641640848460874,0.30795670928881214,0.0848688447729624,2,2,1,1,2,1,1,3,1,2,2,1,1,1,2,2,1,1,3,2,0.9679060415469871,0,1,4,4,4,1.6,0,3,2,3,3,2,2,4,2,3,2,2,3,2,3,3,2,3,1,1,2,2,2,2,0,1,1,0,1,0,2,3,3,2,3,3,3,3,3,2,2,3,1,3,1,3,3,3,3,3,4,4,1,1,1,4,2,1,1,1,1,2,2,2,2,2,2,2,1,2,2,1.0433544884595018,0.6324555320336759,1.875,0,1.75,0,2.6,0,2.7777777777777777,0,2.5833333333333335,0,2.1666666666666665,0,1.4285714285714286,0,2,0,2.2972972972972974,0,0,0,0,0.054166848458523,-0.361969541370789,-0.15390134645613301,2,2,4,3,1,2,2,3,4,0.9511897312113419,2.2857142857142856,0,3.5,0.7521827171321622,3,4,4,3,2,2,3,6,6,3,2,0.816496580927726,6,3,0,-0.12167321001615315,0,-0.3135616112442895,2,3,3,3,3,4,4,4,4,3,3,4,3,3,3,3,3,4,3,3,0.6399404734221844,2.8,0,3.6,0,3.2,0,3.4,0,3.4,0,1,2,3,2,2,3,2,2,2,2,3,2,1,3,2,2,3,3,3,2,0.6863327411532597,2.25,0,1,2,3,2,2,3,2,2,2,2,3,2,1,3,2,2,3,3,3,2,0.6863327411532597,2.25,0,I lived with my mother and father an equal amount of time (joint custody),0,"White, Caucasian, Anglo, European American",0,26,0,1,NA,1,2,4,mental health tech,2,210,70,4,5,2,1,1,0,0,2,I lived with my mother and father an equal amount of time (joint custody),0,TRUE,TRUE,TRUE,TRUE,TRUE,6,0.6786166666676601,0.5907499999962748,0.5786875000018626,0.7101843750001863,0.6521281249988824,0.6729500000011176,0.967741935483871,1,1,1,1,1,0.313,0.195,0.823,0.013,1.54,119.07835238967479,1923.8277021146514,0.314,0.197,0.836,0.013,1.601,138.998087622668,1925.9652936673692,334,0.9896296296296296,0,3,0,0,3,FALSE
550,2022-03-19T21:56:41Z,2022-03-19T22:20:32Z,1430,1,2022-03-19T22:20:34Z,1,Firefox,98.0,Windows NT 10.0,1920,1080,NA,1.7777777777777777,498,138,471,88,78,61,-0.3697326259813962,0.11010285273855931,0.21528603435941476,-0.12572661993958972,0.3489131611782399,-0.4206000101248282,3,3,2,1,3,1,2,3,1,3,4,2,2,4,3,3,2,1,2,3,0.7181848464596079,0,1,2,2,2,2.4,0,1,2,2,1,2,1,1,2,1,1,2,1,3,1,1,1,2,1,1,1,3,1,1,1,2,0,0,0,0,1,1,4,1,1,1,2,1,1,1,1,1,1,2,2,1,4,2,1,2,4,2,2,1,1,2,2,1,2,1,1,2,2,2,1,1,1,2,1,2,1,1.643989873053573,1.6987390281365427,1.375,0,1.5,0,1.4666666666666666,0,1.4444444444444444,0,1.8333333333333333,0,1.6666666666666667,0,1.5714285714285714,0,1,0,1.5945945945945945,0,1,0,0,-0.9666903922867142,-0.22899200544817064,-0.5978411988674424,1,1,3,1,1,1,1,1,2,1.5735915849388864,1.2857142857142858,0,1.5,-0.6009063274000113,5,5,5,4,2,3,4,4,3,2,3,1.3801311186847085,3.5,4,0,-0.44320235072730735,0,0.0324364378478475,2,1,3,4,2,4,4,4,5,3,4,3,3,4,4,5,4,4,4,3,1.082325538564332,2.4,0,3.8,0,3.8,0,4,0,3.8666666666666667,0,2,2,1,4,4,3,4,4,4,3,4,3,1,1,2,3,2,2,2,4,1.1367080817685316,2.75,0,2,2,1,4,4,3,4,4,4,3,4,3,1,1,2,3,2,2,2,4,1.1367080817685316,2.75,0,I lived with my mother and father an equal amount of time (joint custody),0,"White, Caucasian, Anglo, European American",0,22,0,1,NA,1,3,4,Student,2,160,63,1,5,2,0,0,1,0,0,I lived with my mother and father an equal amount of time (joint custody),0,TRUE,TRUE,TRUE,TRUE,TRUE,6,0.39728125000000003,0.36478125,0.39825,0.46462068965517245,0.44064285714285717,0.4979642857142857,1,1,1,0.90625,0.875,0.9032258064516129,0.055,0.308,0.573,0.009,1.247,65.10118521159684,1940.9522266283846,0.055,0.307,0.617,0.009,1.302,81.03537387704131,1943.104611628686,312,0.9244444444444444,0,3,0,0,3,FALSE
551,2022-03-19T23:54:47Z,2022-03-20T00:22:50Z,1683,1,2022-03-20T00:22:52Z,1,Opera,84.0.4316.36,Windows NT 10.0,1920,1080,"I had a difficult family dynamic growing up so at times I was not sure what to answer. Like what house I was referring to, since I did a week with one and a week with the other.",1.7777777777777777,787,71,405,72,83,88,0.22343145554619614,-0.2592125979528895,-0.024160038726073477,-0.32272673223879716,0.45130429090180935,-0.11731869718615386,2,2,2,1,2,1,1,2,1,1,2,2,1,1,2,2,1,1,2,2,1.0399898784932577,0,1,2,3,3,1.55,0,3,3,3,3,3,3,4,2,2,2,2,4,1,4,4,4,2,3,1,1,4,4,3,5,2,0,0,0,0,2,4,2,3,3,2,4,3,3,2,1,5,1,3,2,1,5,5,5,5,5,3,1,4,4,3,1,2,3,2,2,3,3,3,2,2,4,2,3,1,4,1.2657417201396586,0.6172133998483676,2.75,0,2.5,0,2.8666666666666667,0,2.888888888888889,0,3.3333333333333335,0,2.6666666666666665,0,2.5714285714285716,0,2.6666666666666665,0,2.918918918918919,0,3,0,0,0.8247309959512393,0.5540623560092959,0.6893966759802677,2,1,4,1,1,1,1,8,8,1.1338934190276817,1.5714285714285714,0,8,2.0771142429287637,5,5,5,5,2,3,5,9,9,3,3,1.7043362064926932,9,4.285714285714286,0,0.7646583177840003,0,0.9235441314702866,2,4,3,4,3,4,5,4,5,3,5,4,3,3,4,4,5,4,4,4,1.3020130933435712,3.2,0,4.4,0,3.8,0,4,0,4.066666666666666,0,1,2,2,2,2,1,3,2,2,1,3,2,3,3,1,2,1,2,1,4,0.9514531821875089,2,0,1,2,2,2,2,1,3,2,2,1,3,2,3,3,1,2,1,2,1,4,0.9514531821875089,2,0,I lived with my mother and father an equal amount of time (joint custody),0,"White, Caucasian, Anglo, European American",0,25,0,1,NA,1,1,3,Unemployed/Disabled,1,370,73,3,5,2,0,0,1,0,0,I lived with my mother and father an equal amount of time (joint custody),0,TRUE,TRUE,TRUE,TRUE,TRUE,3,0.5713249999769032,0.5600218750201166,0.60222666665713,0.6814999999701977,0.6487666666944821,0.6500218749940395,1,1,0.967741935483871,1,0.9375,1,0.082,0.385,0.388,0.046,1.824,96.80534674008658,1921.5013092568213,0.081,0.386,0.386,0.04,1.993,120.49968841160552,1949.192953193606,326,0.965925925925926,0,3,0,0,3,FALSE
552,2022-03-20T00:06:23Z,2022-03-20T00:29:53Z,1409,1,2022-03-20T00:29:55Z,0.8999999761581421,Chrome,99.0.4844.74,Windows NT 10.0,1920,1080,N/A,1.7777777777777777,516,180,365,108,59,89,-0.3327881503153178,0.34161403078394514,-0.16927887089909666,0.12052352043441956,-0.04017313177132391,-0.10608605596620295,3,3,2,2,3,3,3,3,1,3,3,3,1,2,3,3,3,2,3,3,0.5525062514530825,0,1,1,2,3,2.6,0,3,2,4,2,2,2,3,2,4,2,1,2,2,2,4,3,2,1,1,3,3,4,2,0,2,0,0,0,0,2,5,4,5,5,2,5,5,5,2,2,1,1,4,1,2,4,1,1,3,3,2,1,1,1,1,1,1,1,1,1,4,4,3,1,1,1,1,1,1,1,1.2136609794225788,1.0600988273786194,2.375,0,1,0,2.466666666666667,0,4.222222222222222,0,2.0833333333333335,0,1.1666666666666667,0,2.142857142857143,0,1,0,2.3783783783783785,0,0,0,0,0.24983443374598222,-0.6205191861769039,-0.18534237621546085,1,2,2,1,1,1,1,1,1,1.6761634196950514,1.2857142857142858,0,1,-0.7941589286438315,4,4,4,4,2,2,3,2,4,2,2,0.9511897312113419,3,3.2857142857142856,0,-0.8778143430786174,0,-0.6196158112720472,3,4,3,2,3,2,4,2,3,4,2,2,3,4,4,4,3,2,4,3,0.7432233529572065,3,0,2.2,0,3.8,0,3.2,0,3.066666666666667,0,3,2,4,4,4,4,1,3,4,2,4,3,1,3,1,3,1,4,1,3,1.234376040972246,2.75,0,3,2,4,4,4,4,1,3,4,2,4,3,1,3,1,3,1,4,1,3,1.234376040972246,2.75,0,I lived with my mother and father an equal amount of time (joint custody),0,"White, Caucasian, Anglo, European American",0,22,0,1,NA,1,2,5,Freelancer,2,180,70,2,5,2,0,0,0,0,0,I lived with my mother and father an equal amount of time (joint custody),0,TRUE,TRUE,TRUE,TRUE,TRUE,1,0.6276593749979511,0.5402562499982305,0.5847562500010245,0.7441531250011176,0.6533187499996275,0.734265625001397,1,1,1,1,1,1,0.099,0.407,0.552,0.007,1.278,71.47961647629919,1870.588298581481,0.102,0.407,0.634,0.007,1.352,69.59098990825025,1855.7170001950642,304,0.9007407407407407,1,0,0,0,3,FALSE
553,2022-03-20T03:27:08Z,2022-03-20T03:51:01Z,1433,1,2022-03-20T03:51:03Z,0.800000011920929,Chrome,99.0.4844.74,Windows NT 6.3,1366,768,NA,1.7786458333333333,547,107,381,91,60,96,-0.2691615533348494,-0.06077444534255879,-0.11123133802988738,-0.08878909888348833,-0.019694905826610026,-0.027457567426546634,3,4,2,2,3,2,3,4,2,3,3,3,2,3,3,4,2,4,3,3,0.7181848464596079,0,1,1,3,2,2.9,0,1,2,3,3,4,2,3,3,2,2,2,3,3,3,3,1,1,1,1,1,2,1,2,1,2,0,0,0,0,2,2,1,2,2,3,3,2,3,3,2,2,1,3,2,2,2,2,3,3,3,1,1,1,1,2,1,2,2,1,1,2,2,2,1,1,1,2,2,2,2,1.2603922360077393,0.8451542547285166,1.25,0,2,0,2.6,0,2.2222222222222223,0,2.3333333333333335,0,1.1666666666666667,0,1.7142857142857142,0,1,0,1.8918918918918919,0,1,0,0,-0.3961245009831912,-0.05662557557742737,-0.22637503828030928,2,2,4,2,1,2,2,4,1,0.8997354108424374,2.142857142857143,0,2.5,0.2828091375649657,4,5,5,4,3,3,4,7,3,NA,3,1.1126972805283737,5,4,0,0.1414878915134009,1,0.3888357431024493,3,3,3,2,3,3,5,3,3,3,3,3,4,3,3,4,3,3,4,3,0.7037315505489968,2.8,0,3,0,4,0,3,0,3.3333333333333335,0,2,3,2,3,3,3,2,3,4,2,2,3,2,2,1,4,1,2,1,2,0.7591546545162482,2.35,0,2,3,2,3,3,3,2,3,4,2,2,3,2,2,1,4,1,2,1,2,0.7591546545162482,2.35,0,I lived with my mother and father an equal amount of time (joint custody),0,"White, Caucasian, Anglo, European American",0,25,0,1,NA,1,3,3,unemployed,7,175,74,1,5,2,0,0,0,0,0,I lived with my mother and father an equal amount of time (joint custody),0,TRUE,TRUE,TRUE,TRUE,TRUE,2,0.5335593750000699,0.4828687500000233,0.5736218749999534,0.5700290322581366,0.5327633333332836,0.6275781249996507,1,1,1,0.96875,0.9375,1,0.295,0.2,0.788,0.017,1.349,94.28497007842162,1897.972646183191,0.296,0.194,0.787,0.019,1.444,109.94851073824054,1892.931934600898,352,1.0429629629629629,0,3,0,3,6,FALSE
554,2022-03-20T05:33:33Z,2022-03-20T05:53:25Z,1192,1,2022-03-20T05:53:27Z,0.8999999761581421,Chrome,99.0.4844.74,Macintosh,1440,900,NA,1.6,502,71,282,58,41,190,-0.36152274250004546,-0.2592125979528895,-0.4704004476581198,-0.49510183050060363,-0.40878119877617386,1.0284107072488382,4,4,3,4,4,2,2,3,1,4,2,2,2,2,4,2,1,1,4,4,0.910465468000326,0,1,1,3,2,2.75,0,4,3,4,3,4,4,4,4,3,3,4,4,2,4,3,2,1,1,1,3,3,3,2,1,2,0,0,0,0,2,2,1,2,2,2,2,2,2,3,2,3,1,3,2,1,3,3,3,2,3,2,1,1,1,2,1,2,2,2,1,3,4,4,1,1,1,2,2,1,3,1.2938988268694636,0.8451542547285166,2,0,2,0,3.533333333333333,0,1.8888888888888888,0,2.4166666666666665,0,1.3333333333333333,0,2.5714285714285716,0,1,0,2.027027027027027,0,1,0,0,0.3985536094850925,-0.05662557557742737,0.17096401695383256,2,1,3,2,1,1,1,2,2,1.2149857925879117,1.5714285714285714,0,2,-0.24191697199707893,3,4,4,4,1,3,4,6,6,3,3,1.1547005383792515,6,3.2857142857142856,0,0.22259487524538815,0,0.051141202567390576,4,4,4,3,4,2,5,3,2,5,4,2,5,4,3,4,5,4,4,4,1.3201731488169053,3.8,0,3.4,0,4.6,0,3.2,0,3.7333333333333334,0,1,1,1,2,4,2,4,2,2,1,1,2,2,2,1,3,1,2,1,4,1.0990426455975697,1.95,0,1,1,1,2,4,2,4,2,2,1,1,2,2,2,1,3,1,2,1,4,1.0990426455975697,1.95,0,I lived with my mother and father an equal amount of time (joint custody),0,"White, Caucasian, Anglo, European American",0,20,0,1,NA,1,4,5,Aquatics supervisor,4,170,74,2,5,2,0,0,1,0,0,I lived with my mother and father an equal amount of time (joint custody),0,TRUE,TRUE,TRUE,TRUE,TRUE,1,0.5156375000001281,0.53015625,0.5978156249997555,0.6478687500000233,0.5778741935484352,0.7114903225807413,1,1,1,1,0.96875,1,0.196,0.264,0.56,0.013,1.382,49.15294562985206,1839.4031484590746,0.195,0.264,0.56,0.012,1.446,74.09813622702853,1859.9792064717496,632,1.8725925925925926,0,3,0,0,3,FALSE
555,2022-03-20T06:08:02Z,2022-03-20T06:37:24Z,1762,1,2022-03-20T06:37:26Z,0.8999999761581421,Chrome,99.0.4844.74,Windows NT 10.0,1920,1080,No,1.7777777777777777,586,180,549,167,70,129,-0.1891151893916795,0.34161403078394514,0.49826775709681,0.846961434537747,0.18508735362052883,0.3432195928318332,2,3,1,1,2,1,1,4,1,3,4,2,1,3,3,3,1,1,4,3,0.7539370349250519,0,1,1,2,2,2.2,0,3,2,2,2,2,1,2,2,2,1,1,2,2,2,3,1,3,5,1,1,3,2,2,2,1,2,0,1,0,2,1,2,2,2,1,3,3,3,2,2,1,1,2,2,2,1,2,3,1,2,3,4,1,2,4,1,1,2,2,2,2,2,2,1,1,1,2,3,2,2,1.3025731060852963,1.1832159566199232,2.25,0,2.25,0,1.9333333333333333,0,2.111111111111111,0,1.75,0,2.5,0,1.8571428571428572,0,1,0,1.9189189189189189,0,1,0,0,-0.23864555910193605,0.029557639357944268,-0.10454395987199588,1,2,3,1,1,2,1,1,1,1.4638501094227998,1.5714285714285714,0,1,-0.6284221744847194,5,4,4,4,3,3,4,6,3,NA,3,0.9759000729485332,4.5,3.857142857142857,0,0.005972030878747869,1,0.22880503471397923,2,1,2,2,2,4,4,4,5,2,3,4,3,5,5,3,5,4,3,3,1.245945806357946,1.8,0,4,0,3,0,4.4,0,3.8,0,1,2,4,4,3,4,3,4,4,3,2,3,3,3,1,4,1,4,2,2,1.1367080817685316,2.85,0,1,2,4,4,3,4,3,4,4,3,2,3,3,3,1,4,1,4,2,2,1.1367080817685316,2.85,0,"I lived with my mother, but not father, most of the time.",0,"White, Caucasian, Anglo, European American",0,23,0,1,NA,1,4,6,Unemployed,3,230,70,1,5,2,0,0,1,0,0,"I lived with my mother, but not father, most of the time.",0,TRUE,TRUE,TRUE,TRUE,TRUE,3,0.430131250007078,0.3999562499914318,0.4198843750022352,0.4867800000031789,0.43208666666746137,0.4703774193525314,1,1,1,0.9375,0.9375,0.96875,0.052,0.345,0.676,0.02,1.395,41.98140178438638,1878.6064026974957,0.055,0.346,0.74,0.024,1.497,44.36682279745223,1873.5203829767506,315,0.9333333333333332,0,3,0,0,3,FALSE
556,2022-03-20T07:09:58Z,2022-03-20T07:27:42Z,1063,1,2022-03-20T07:27:44Z,0.800000011920929,Firefox,98.0,Windows NT 10.0,1920,1080,Interesting survey! Thank you!,1.7777777777777777,498,83,244,53,30,74,-0.3697326259813962,-0.19306654708277926,-0.6082633382224918,-0.5566643655941059,-0.6340416841680265,-0.2745756742654665,2,1,2,2,4,1,1,2,1,2,3,1,2,1,3,2,1,2,2,2,0.9445132413883326,0,1,2,3,4,1.85,0,4,5,1,5,4,5,5,3,3,1,4,5,4,5,4,4,5,1,1,5,5,4,5,2,1,1,0,1,0,1,4,5,4,5,1,5,4,4,2,1,5,1,3,2,5,5,5,5,5,5,5,1,1,1,5,5,3,2,3,2,5,5,5,4,5,5,2,1,2,3,1.7381084606609052,1.4375905768565218,3.75,0,2,0,3.8666666666666667,0,3.6666666666666665,0,3.6666666666666665,0,3,0,3.5714285714285716,0,4.666666666666667,0,3.6216216216216215,0,1,0,0,2.0058230600606533,-0.05662557557742737,0.9745987422416129,3,3,5,3,2,2,3,1,1,0.7867957924694432,3,0,1,0.20026159631084173,3,3,2,2,1,1,1,6,1,3,2,1.3972762620115438,3.5,1.8571428571428572,0,-0.5733927454649965,0,-1.2083218986376585,5,5,5,5,4,1,3,1,1,1,5,2,2,1,4,2,5,5,1,3,1.6903085094570331,4.8,0,3.6,0,1.8,0,2,0,2.466666666666667,0,1,1,1,1,4,1,2,2,1,1,1,1,1,1,1,1,1,2,1,3,1.2523661815266247,1.4,0,1,1,1,1,4,1,2,2,1,1,1,1,1,1,1,1,1,2,1,3,1.2523661815266247,1.4,0,I lived with my mother and father an equal amount of time (joint custody),0,"Hispanic of Latino (e.g., Mexican American, Central American, and others)",0,24,1,3,NA,1,3,4,Retail cashier,2,210,63,2,5,2,0,0,1,0,0,I lived with my mother and father an equal amount of time (joint custody),0,TRUE,TRUE,TRUE,TRUE,TRUE,2,0.4174375,0.36378125,0.41103125,0.5334,0.45675862068965517,0.5044074074074074,1,1,1,0.9375,0.90625,0.84375,NA,NA,NA,NA,NA,NA,NA,NA,NA,NA,NA,NA,NA,NA,279,0.8266666666666667,0,3,0,0,3,FALSE
557,2022-03-20T07:15:16Z,2022-03-20T07:57:42Z,2545,1,2022-03-20T07:57:44Z,0.8999999761581421,Chrome,99.0.4844.74,Windows NT 6.1,1920,1080,Nope,1.7777777777777777,681,169,1033,221,125,141,0.005869543290401025,0.2809801508196774,2.2542056263903905,1.511836813547572,1.3113897805797925,0.478011287471244,3,2,3,3,3,3,4,3,2,3,3,3,3,2,3,3,4,1,3,3,0.7591546545162482,0,1,1,2,2,2.85,0,4,3,4,3,4,3,4,4,3,2,2,3,2,3,3,3,4,2,1,4,4,4,2,5,2,0,0,0,0,2,3,2,1,4,3,4,4,4,3,2,3,2,4,2,2,5,4,4,5,5,4,3,3,1,5,1,1,5,5,3,2,2,3,1,2,3,2,4,4,4,1.2991103446927392,0.7432233529572065,3,0,3.5,0,3.1333333333333333,0,3,0,3.4166666666666665,0,2.8333333333333335,0,3,0,2,0,3.027027027027027,0,3,0,0,1.097760111437866,0.8987952157507824,0.9982776635943241,2,2,4,2,1,3,1,3,2,1.0690449676496976,2.142857142857143,0,2.5,0.2828091375649657,4,3,4,1,2,2,2,2,1,2,2,1.2149857925879117,1.5,2.5714285714285716,0,-1.1488460643479235,0,-1.171957323398003,3,2,3,4,3,4,2,4,4,3,1,2,3,4,5,1,2,2,3,3,1.1872336794093274,3,0,2.2,0,2.4,0,4,0,2.8666666666666667,0,2,1,3,4,2,3,1,3,1,2,3,2,1,1,2,3,1,3,2,2,0.7880689256524124,2.1,0,2,1,3,4,2,3,1,3,1,2,3,2,1,1,2,3,1,3,2,2,0.7880689256524124,2.1,0,I lived with my mother and father an equal amount of time (joint custody),0,"Hispanic of Latino (e.g., Mexican American, Central American, and others)",0,30,0,1,NA,1,1,3,unemployed,1,297,71,3,5,2,0,0,1,0,0,I lived with my mother and father an equal amount of time (joint custody),0,TRUE,TRUE,TRUE,TRUE,TRUE,5,0.50984375,0.4993870967741936,0.5378125,0.58332,0.5718666666666666,0.6623333333333333,1,0.96875,1,0.8064516129032258,0.9375,0.84375,NA,NA,NA,NA,NA,NA,NA,NA,NA,NA,NA,NA,NA,NA,276,0.8177777777777777,0,3,0,0,3,FALSE
558,2022-03-20T10:46:07Z,2022-03-20T11:05:03Z,1135,1,2022-03-20T11:05:05Z,1,Chrome,99.0.4844.51,Windows NT 10.0,1366,768,NA,1.7786458333333333,710,64,194,26,23,78,0.06539119853019403,-0.2977977942937871,-0.7896618784387708,-0.8891020550990185,-0.7773892657810237,-0.22964510938566288,4,4,2,1,4,2,1,3,1,4,4,1,1,3,3,3,1,1,4,4,0.5871429486123998,0,1,1,4,3,2.55,0,4,2,4,3,2,2,4,2,1,1,3,3,3,2,2,2,3,1,1,1,3,2,2,1,2,0,0,0,0,3,4,3,3,5,4,3,3,3,2,3,3,2,3,3,4,2,3,3,2,2,3,2,2,1,4,1,1,1,3,1,4,3,3,2,2,2,2,1,1,1,0.7836543333090898,1.0465362369445672,1.875,0,1.25,0,2.533333333333333,0,3.4444444444444446,0,2.6666666666666665,0,2.1666666666666665,0,2.2857142857142856,0,2,0,2.6486486486486487,0,1,0,0,0.1785752125447143,-0.3151752203835423,-0.06830000391941399,2,4,2,4,4,3,3,2,1,0.4879500364742666,3.142857142857143,0,1.5,0.4763825746342179,5,5,5,5,4,4,4,6,7,5,3,1.1126972805283737,6.5,4.571428571428571,0,0.7410941633828612,0,1.0640339429174537,3,4,3,2,3,3,3,5,3,3,3,3,4,1,3,3,3,4,2,3,0.7432233529572065,3,0,3.2,0,3,0,3,0,3.066666666666667,0,2,2,2,3,2,1,1,4,2,2,1,3,2,2,1,4,2,2,1,2,0.4893604849295929,2.05,0,2,2,2,3,2,1,1,4,2,2,1,3,2,2,1,4,2,2,1,2,0.4893604849295929,2.05,0,I lived with my mother and father an equal amount of time (joint custody),0,"White, Caucasian, Anglo, European American",0,30,0,1,NA,1,3,4,Freelancer,4,200,69,3,5,2,0,0,1,0,0,I lived with my mother and father an equal amount of time (joint custody),0,TRUE,TRUE,TRUE,TRUE,TRUE,1,0.5851774193509932,0.6097656249962747,0.633680645158214,0.6519464285756861,0.6838580645092072,0.6984269230847175,0.96875,1,1,0.875,0.96875,0.8387096774193549,NA,NA,NA,NA,NA,NA,NA,NA,NA,NA,NA,NA,NA,NA,388,1.1496296296296296,0,3,0,0,3,FALSE
559,2022-03-20T10:51:08Z,2022-03-20T11:10:00Z,1131,1,2022-03-20T11:10:02Z,1,Edge,99.0.1150.46,Windows NT 10.0,2048,1152,NA,1.7777777777777777,496,79,303,75,58,78,-0.3738375677220716,-0.21511523070614935,-0.3942130607672826,-0.28578921118269573,-0.060651357716037795,-0.22964510938566288,3,2,2,1,2,1,2,3,1,2,3,1,1,3,3,2,2,1,4,3,0.7880689256524124,0,1,2,3,2,2.1,0,4,2,1,2,2,1,1,1,1,1,1,1,1,1,2,2,2,1,1,1,1,1,1,1,2,0,0,0,0,1,2,1,1,5,2,4,1,2,1,1,1,1,3,1,1,2,1,1,2,2,2,1,1,2,1,1,1,1,1,1,1,1,1,1,1,1,1,1,1,1,1.643989873053573,1.7265434778633235,1.25,0,1,0,1.4666666666666666,0,2.111111111111111,0,1.4166666666666667,0,1.3333333333333333,0,1,0,1,0,1.4594594594594594,0,1,0,0,-1.080370503457245,-0.4013584353189139,-0.7408644693880795,3,2,4,3,2,3,3,5,3,0.5345224838248488,2.857142857142857,0,4,1.2769088266942068,4,4,4,4,2,2,5,4,3,3,3,1.2909944487358056,3.5,3.5714285714285716,0,-0.22912466020345523,0,-0.06935210032925938,2,2,3,3,2,4,4,5,4,2,2,2,5,4,5,3,4,4,2,1,1.3557637102737474,2.4,0,3.2,0,3.2,0,3.8,0,3.4,0,2,4,3,3,3,4,4,4,3,2,3,4,2,2,1,3,1,2,1,2,1.019545822516343,2.65,0,2,4,3,3,3,4,4,4,3,2,3,4,2,2,1,3,1,2,1,2,1.019545822516343,2.65,0,"I lived with my mother, but not father, most of the time. & I lived with my extended family on mother's side (grandparents, aunts ,uncles, cousins)",1,"Black or African American & Hispanic of Latino (e.g., Mexican American, Central American, and others)",1,28,0,1,NA,1,2,4,Closed Captioner,1,135,68,2,5,2,0,0,1,0,0,"I lived with my mother, but not father, most of the time. & I lived with my extended family on mother's side (grandparents, aunts ,uncles, cousins)",1,TRUE,TRUE,TRUE,TRUE,TRUE,2,0.45934687500167637,0.4549125000005588,0.4784468749985099,0.549420689658872,0.5194531250018627,0.5677241379330898,1,1,1,0.90625,1,0.90625,NA,NA,NA,NA,NA,NA,NA,NA,NA,NA,NA,NA,NA,NA,266,0.788148148148148,0,3,0,3,6,FALSE
560,2022-03-20T11:46:10Z,2022-03-20T12:21:54Z,2143,1,2022-03-20T12:21:56Z,0.8999999761581421,Chrome,99.0.4844.74,Windows NT 10.0,1920,1080,-,1.7777777777777777,691,372,462,335,53,67,0.02639425199377792,1.399950844705709,0.18263429712048457,2.915462613679425,-0.16304248743960723,-0.35320416280512285,3,3,2,1,3,1,1,2,1,2,3,2,1,2,3,3,3,3,3,3,0.6863327411532597,0,0,3,3,4,2.25,0,4,2,2,3,3,2,4,3,2,4,2,5,1,5,4,2,1,1,1,2,4,2,2,2,2,0,0,0,0,4,4,5,5,5,1,3,2,3,2,2,2,1,4,2,5,4,3,2,2,2,5,1,1,1,4,4,1,2,3,1,2,1,2,1,1,2,2,1,1,2,1.1823273226555742,0.9611501047232549,1.875,0,1.5,0,3.066666666666667,0,3.5555555555555554,0,2.5833333333333335,0,2.6666666666666665,0,1.7142857142857142,0,1.3333333333333333,0,2.5675675675675675,0,1,0,0,0.3762112846056897,-0.22899200544817064,0.07360963957875953,1,1,3,1,1,1,1,1,1,1.5735915849388864,1.2857142857142858,0,1,-0.7941589286438315,4,4,4,4,1,1,4,8,6,NA,3,1.4638501094227998,7,3.142857142857143,0,0.6835513340520131,1,0.25469159215961057,1,1,2,2,2,5,3,4,4,2,5,4,5,4,4,1,5,4,3,2,1.4074631010979937,1.6,0,4.6,0,2.8,0,3.6,0,3.6666666666666665,0,3,1,3,4,1,2,1,4,1,1,2,2,3,1,1,3,1,1,3,3,0.910465468000326,2.05,0,3,1,3,4,1,2,1,4,1,1,2,2,3,1,1,3,1,1,3,3,0.910465468000326,2.05,0,I lived with my mother and father an equal amount of time (joint custody),0,Black or African American,0,30,0,1,NA,1,2,6,Unemployed,3,236,71,2,5,2,0,0,1,0,0,I lived with my mother and father an equal amount of time (joint custody),0,TRUE,TRUE,TRUE,TRUE,TRUE,2,0.4966968750003725,0.428499999998603,0.4691625000005588,0.5608218750008382,0.4960750000020489,0.522448387096005,1,1,1,1,1,0.96875,NA,NA,NA,NA,NA,NA,NA,NA,NA,NA,NA,NA,NA,NA,306,0.9066666666666667,0,3,0,3,6,FALSE
561,2022-03-20T13:15:27Z,2022-03-20T13:37:54Z,1347,1,2022-03-20T13:37:55Z,1,Chrome,98.0.4758.80,Linux aarch64,1920,1080,NA,1.7777777777777777,531,58,526,62,35,72,-0.30200108726025243,-0.33087081972884225,0.41482442859732166,-0.4458518024258018,-0.5316505544444572,-0.2970409567053683,2,3,1,1,2,1,1,1,1,3,2,1,1,1,2,3,1,1,3,3,0.9514531821875089,0,0,4,3,2,1.7,0,4,3,2,3,3,1,3,3,3,3,2,3,1,4,3,1,3,1,1,2,4,3,1,2,2,0,0,0,0,1,3,5,5,5,5,5,5,5,4,4,1,1,5,1,1,4,1,2,4,3,4,1,1,1,3,3,1,2,2,1,2,1,1,1,2,2,2,1,1,3,1.2681120250624975,0.7432233529572065,2,0,1.75,0,2.7333333333333334,0,4.333333333333333,0,2.5833333333333335,0,2.1666666666666665,0,1.4285714285714286,0,1.6666666666666667,0,2.6486486486486487,0,1,0,0,0.3206015332538714,-0.14280879051279902,0.0888963713705362,5,4,5,1,4,5,3,1,1,1.7043362064926932,3.857142857142857,0,1,0.6974718587881783,2,3,3,1,1,1,3,6,6,1,2,1,6,2,0,-0.5498285910638574,0,-1.1165316147358102,1,1,1,1,1,5,4,5,5,5,5,5,5,5,5,5,5,5,5,5,2.007130147392398,1,0,5,0,4.8,0,5,0,4.933333333333334,0,1,1,1,2,2,1,1,1,1,1,1,4,1,2,1,4,1,1,1,1,0.812727700887249,1.45,0,1,1,1,2,2,1,1,1,1,1,1,4,1,2,1,4,1,1,1,1,0.812727700887249,1.45,0,I lived with my mother and father an equal amount of time (joint custody),0,"White, Caucasian, Anglo, European American",0,22,0,1,NA,1,2,6,Software Developer,2,130,67,1,5,2,0,0,1,0,0,I lived with my mother and father an equal amount of time (joint custody),0,TRUE,TRUE,TRUE,TRUE,TRUE,1,0.5781625000005588,0.508268750000745,0.5254156249994412,0.6679499999955296,0.5590387096741507,0.6141999999996155,1,1,1,1,0.96875,0.96875,NA,NA,NA,NA,NA,NA,NA,NA,NA,NA,NA,NA,NA,NA,530,1.5703703703703704,0,3,0,0,3,FALSE
562,2022-03-20T14:16:18Z,2022-03-20T14:54:57Z,2319,1,2022-03-20T14:54:58Z,1,Edge,99.0.1150.46,Windows NT 10.0,1536,864,NA,1.7777777777777777,602,893,445,103,119,76,-0.15627565546627648,4.271791886649662,0.12095879344694971,0.05896098534091724,1.188520424911509,-0.2521103918255647,3,3,1,1,3,1,1,3,1,3,4,1,1,1,3,3,1,1,3,3,0.5104177855340404,0,0,2,3,2,2.05,0,2,2,2,2,2,1,2,2,2,2,1,2,2,2,3,2,2,1,1,1,1,1,1,1,2,0,0,0,0,1,2,2,2,4,2,2,2,2,1,2,1,1,3,2,5,4,1,3,1,1,1,1,1,1,2,2,1,2,2,1,1,1,1,1,1,1,1,1,1,2,1.4729798605784363,1.162919151265879,1.25,0,1.25,0,1.9333333333333333,0,2.111111111111111,0,2.0833333333333335,0,1.3333333333333333,0,1.2857142857142858,0,1,0,1.7297297297297298,0,1,0,0,-0.7583260673100781,-0.3151752203835423,-0.5367506438468101,5,5,5,4,4,5,4,5,2,1.7182493859684491,4.571428571428571,0,3.5,2.0780767504050597,3,3,3,3,1,1,4,3,3,2,2,0.9511897312113419,3,2.5714285714285716,0,-0.8778143430786174,0,-1.0067493035204065,2,2,2,3,2,4,4,4,4,1,2,5,5,4,4,4,5,4,3,3,1.3345232785352157,2.2,0,4,0,3.4,0,3.8,0,3.7333333333333334,0,1,1,1,2,3,2,1,2,1,1,2,3,1,2,1,3,1,2,1,1,0.7539370349250519,1.6,0,1,1,1,2,3,2,1,2,1,1,2,3,1,2,1,3,1,2,1,1,0.7539370349250519,1.6,0,I lived with my mother and father an equal amount of time (joint custody),0,"Asian or Asian American (e.g., Chinese, Japanese, and others)",0,18,0,1,NA,1,2,4,Student,2,208,71,2,5,2,1,1,1,0,2,I lived with my mother and father an equal amount of time (joint custody),0,TRUE,TRUE,TRUE,TRUE,TRUE,6,0.5155387096635757,0.43882812501117585,0.45480937499180435,0.582666666674614,0.5124806451566758,0.5132466666618983,0.96875,1,1,0.9375,0.96875,0.9375,NA,NA,NA,NA,NA,NA,NA,NA,NA,NA,NA,NA,NA,NA,366,1.0844444444444443,0,3,0,3,6,FALSE
563,2022-03-20T15:36:57Z,2022-03-20T16:07:34Z,1836,1,2022-03-20T16:07:36Z,0.8999999761581421,Chrome,99.0.4844.74,Windows NT 10.0,1500,1000,No comments.,1.5,1076,82,377,116,54,84,0.8165955370737885,-0.19857871798862178,-0.1257432212471897,0.21902357658402327,-0.14256426149489335,-0.16224926206595747,1,2,1,1,2,1,1,2,1,2,2,1,1,1,2,2,1,1,1,2,1.1652874052533586,0,0,2,3,2,1.4,0,4,2,3,2,3,3,3,3,2,2,4,4,2,5,4,2,4,1,1,2,3,3,2,0,2,0,0,0,0,3,4,4,3,3,1,4,2,3,1,2,1,1,4,2,3,1,1,1,3,3,3,1,1,1,3,1,1,1,1,1,2,2,2,1,1,2,2,1,1,1,1.1290592432528839,0.8997354108424374,2.25,0,1.25,0,3.066666666666667,0,3,0,1.9166666666666667,0,1.6666666666666667,0,1.4285714285714286,0,1.3333333333333333,0,2,0,0,0,0,0.2920584750378941,-0.5343359712415323,-0.1211387481018191,2,2,2,2,2,2,1,2,1,1.1338934190276817,1.8571428571428572,0,1.5,-0.2694328190817869,3,4,4,4,2,2,4,6,6,3,3,1,6,3.2857142857142856,0,0.22259487524538815,0,0.051141202567390576,1,1,1,1,1,5,5,5,5,3,4,5,5,4,4,5,5,5,4,5,1.7237832147426693,1,0,4.8,0,4.4,0,4.6,0,4.6,0,1,1,1,1,1,2,2,2,2,1,2,3,1,1,1,3,2,2,1,2,0.8013147091860318,1.6,0,1,1,1,1,1,2,2,2,2,1,2,3,1,1,1,3,2,2,1,2,0.8013147091860318,1.6,0,I lived with my mother and father an equal amount of time (joint custody),0,"White, Caucasian, Anglo, European American",0,24,0,1,NA,1,3,7,Graphic Designer,3,130,69,3,5,2,0,0,1,0,0,I lived with my mother and father an equal amount of time (joint custody),0,TRUE,TRUE,TRUE,TRUE,TRUE,2,0.5154093750026076,0.45743437499925493,0.4805906250011176,0.5757066666662694,0.5172290322578722,0.5672299999982119,1,1,1,0.9375,0.96875,0.9375,NA,NA,NA,NA,NA,NA,NA,NA,NA,NA,NA,NA,NA,NA,436,1.2918518518518518,0,3,0,0,3,FALSE
564,2022-03-20T15:43:40Z,2022-03-20T16:12:36Z,1736,1,2022-03-20T16:12:39Z,0.8999999761581421,Safari,15.3,Macintosh,1440,900,I enjoyed the survey and found the questions interesting. Thanks!,1.6,843,139,372,92,53,111,0.33836982428510676,0.11561502364440183,-0.1438830752688176,-0.07647659186478786,-0.16304248743960723,0.14103205087271692,2,2,1,1,3,1,2,2,1,1,4,1,1,2,2,2,2,1,1,2,1.0711528467275955,0,0,2,4,4,1.7,0,3,1,2,2,2,2,1,2,2,1,3,3,1,3,2,2,2,1,1,1,3,3,2,1,1,1,1,0,0,1,2,4,1,1,1,1,1,1,1,1,1,1,3,2,1,4,2,3,4,4,3,2,1,1,3,1,1,2,2,1,1,1,1,1,1,1,2,2,2,2,1.6689173991798651,1.2649110640673518,1.875,0,2,0,2,0,1.4444444444444444,0,2.25,0,1.8333333333333333,0,1.2857142857142858,0,1,0,1.7027027027027026,0,1,0,1,-0.46787584387783815,0.8479035383463732,0.19001384723426754,1,1,1,1,1,1,1,1,1,1.9518001458970664,1,0,1,-0.9598956828029438,5,5,5,5,3,1,5,3,3,5,4,1.9023794624226837,3,4.142857142857143,0,0.45295489901602165,0,0.6561178847663833,2,3,2,2,2,5,4,4,5,4,5,5,5,4,4,5,5,4,5,3,1.6417180315870614,2.2,0,4.8,0,4.6,0,4,0,4.466666666666667,0,1,2,3,1,2,3,2,4,1,1,1,2,1,4,2,4,1,3,2,3,1.050062654772261,2.15,0,1,2,3,1,2,3,2,4,1,1,1,2,1,4,2,4,1,3,2,3,1.050062654772261,2.15,0,I lived with my mother and father an equal amount of time (joint custody),0,"White, Caucasian, Anglo, European American",0,23,0,1,NA,1,2,4,Administrator,3,130,70,2,5,2,0,0,1,0,0,I lived with my mother and father an equal amount of time (joint custody),0,TRUE,TRUE,TRUE,TRUE,TRUE,1,0.8435624999999891,0.8716875000000073,0.7934375000000055,0.9800666666666705,0.9798064516129033,0.8969687500000091,1,1,1,0.967741935483871,1,1,NA,NA,NA,NA,NA,NA,NA,NA,NA,NA,NA,NA,NA,NA,392,1.1614814814814816,0,3,0,3,6,FALSE
565,2022-03-20T15:51:28Z,2022-03-20T16:30:09Z,2321,1,2022-03-20T16:30:11Z,0.8999999761581421,Chrome,99.0.4844.74,Windows NT 10.0,1920,1080,NA,1.7777777777777777,637,215,782,101,331,104,-0.08443917500445733,0.5345400124884333,1.34358495450467,0.03433597130351631,5.529904325190853,0.06240356233306059,3,3,3,3,3,1,3,3,1,3,3,1,1,2,3,3,2,1,3,3,0.6407232755171874,1,0,2,3,3,2.4,0,1,2,2,2,3,1,2,1,2,1,1,2,2,2,2,2,1,1,1,2,2,1,2,0,1,0,0,1,0,1,3,1,1,2,1,1,1,2,2,1,1,1,2,2,1,3,2,2,3,3,1,1,1,1,2,2,1,1,1,1,2,2,2,1,1,1,1,1,1,1,1.6098421014470927,1.424279266355945,1.5,0,1,0,1.7333333333333334,0,1.4444444444444444,0,1.9166666666666667,0,1.3333333333333333,0,1.4285714285714286,0,1,0,1.5405405405405406,0,0,0,0,-0.8191523086117131,-0.6205191861769039,-0.7198357473943084,1,2,4,2,2,2,2,1,1,1.1338934190276817,2.142857142857143,0,1,-0.29694866616649496,4,4,5,5,1,1,4,1,6,2,2,1.7728105208558367,3.5,3.4285714285714284,0,-0.7874704359888487,0,-0.4871197728631766,2,2,2,3,3,4,4,4,4,3,4,4,3,3,4,4,4,4,4,3,0.8837151016885368,2.4,0,4,0,3.6,0,3.6,0,3.7333333333333334,0,2,2,3,3,2,3,2,3,2,2,2,3,3,3,1,3,1,2,2,3,0.5871429486123998,2.35,0,2,2,3,3,2,3,2,3,2,2,2,3,3,3,1,3,1,2,2,3,0.5871429486123998,2.35,0,"I lived with my extended family on mother's side (grandparents, aunts ,uncles, cousins)",0,Native American/Alaskan Native/indigenous,0,25,0,1,NA,1,2,5,Computer Lab Teacher/Technology Assistant,2,215,70,3,5,2,0,1,1,0,1,"I lived with my extended family on mother's side (grandparents, aunts ,uncles, cousins)",0,TRUE,TRUE,TRUE,TRUE,TRUE,5,0.521,0.43724062500055877,0.4885562499957159,0.5433774193539734,0.5105312499990686,0.5477312499978579,1,1,1,0.96875,1,1,NA,NA,NA,NA,NA,NA,NA,NA,NA,NA,NA,NA,NA,NA,342,1.0133333333333332,0,3,3,6,9,FALSE
