id,meta_start,meta_end,meta_duration,meta_finished,meta_recorded,meta_captcha,meta_browser,meta_version,meta_operating system,meta_resolution_width,meta_resolution_height,meta_feedback,meta_resolution_ratio,meta_task_duration,meta_state_duration,meta_ace_duration,meta_temp_orient_duration,meta_psychopath_duration,meta_dems_duration,meta_task_duration_z,meta_state_duration_z,meta_ace_duration_z,meta_temp_orient_duration_z,meta_psychopath_duration_z,meta_dems_duration_z,stai_s01,stai_s02,stai_s03,stai_s04,stai_s05,stai_s06,stai_s07,stai_s08,stai_s09,stai_s10,stai_s11,stai_s12,stai_s13,stai_s14,stai_s15,stai_s16,stai_s17,stai_s18,stai_s19,stai_s20,sd_stai,sick,meal,hungry,sleep,rested,stai_s_mean,stai_s_missing,chaos01,chaos02,chaos03,chaos04,chaos05,chaos06,chaos07,chaos08,chaos09,chaos10,chaos11,chaos12,chaos13,chaos14,chaos15,unp01,unp02,unp03,unp04,unp05,unp06,unp07,unp08,unp_moving,unp_household_size,unp_partners_mother,unp_partners_father,quic01,quic02,quic03,quic04,quic05,quic06,quic07,quic08,quic09,quic10,quic11,quic12,quic13,quic14,quic15,quic16,quic17,quic18,quic19,quic20,quic21,quic22,quic23,quic24,quic25,quic26,quic27,quic28,quic29,quic30,quic31,quic32,quic33,quic34,quic35,quic36,quic37,change_env01,change_env02,change_env03,change_env04,sd_quic,sd_chaos,unp_mean,unp_missing,change_env_mean,change_env_missing,chaos_mean,chaos_missing,quic_monitoring_mean,quic_monitoring_missing,quic_par_predict_mean,quic_par_predict_missing,quic_par_env_mean,quic_par_env_missing,quic_phys_env_mean,quic_phys_env_missing,quic_safety_mean,quic_safety_missing,quic_total_mean,quic_total_missing,unp_moving_binned,unp_partners_mother_binned,unp_partners_father_binned,unp_quic_punp,unpredictability_subj,unpredictability_obj,unpredictability_composite,violence01,violence02,violence03,violence04,violence05,violence06,violence07,aces_fighting1,aces_fighting2,sd_violence,violence_mean,violence_missing,fighting_mean,violence_composite,ses01,ses02,ses03,ses04,ses05,ses06,ses07,dems_edu_mother,dems_edu_father,dems_income_past,dems_class_past,sd_ses,ses_subj_mean,ses_subj_missing,ses_subj_mean_recoded,edu_parents_recoded,income_past_recoded,class_past_recoded,ses_obj_mean,ses_obj_missing,poverty_composite,impuls01,impuls02,impuls03,impuls04,impuls05,fos01,fos02,fos03,fos04,fos05,fos06,fos07,fos08,fos09,fos10,fos11,fos12,fos13,fos14,fos15,sd_fos,impuls_mean,impuls_missing,fos_pa_mean,fos_pa_missing,fos_tp_mean,fos_tp_missing,fos_fc_mean,fos_fc_missing,fos_fo_mean,fos_fo_missing,depression01,depression02,depression03,depression04,depression05,depression06,depression07,depression08,depression09,depression10,depression11,depression12,depression13,depression14,depression15,depression16,depression17,depression18,depression19,depression20,sd_depression,depression_mean,depression_missing,dems_ethnicity,dems_ethnicity_mixed,dems_age,dems_sex,dems_gender,dems_gender_4_text,dems_born_us,dems_class_current,dems_edu,dems_occupation,dems_income,dems_colorblind,weight,height,activity,att_check01,att_check02,att_getup,att_interrupted,att_noise,attention_check_sum,attention_interrupt_sum,ex_narb_NA_selfreport_pass,ex_narb_attention_checks_pass,ex_narb_suspect_responses_pass,ex_narb_resolution_ratio,ex_narb_resolution_height,counterbalance.x,rt_change,acc_change,rt_var_change,counterbalance.y,rt_cueing_cued,rt_cueing_neutral,acc_cueing_cued,acc_cueing_neutral,rt_var_cueing_cued,rt_var_cueing_neutral,counterbalance,rt_flanker_congruent,rt_flanker_incongruent,acc_flanker_congruent,acc_flanker_incongruent,rt_var_flanker_congruent,rt_var_flanker_incongruent,change_ml_a,change_ml_v,change_ml_t0,change_ks_a,change_ks_v,change_ks_t0,change_ks_st0,change_hddm_a,change_hddm_v,change_hddm_t,cueing_ml_a,cueing_cued_ml_v,cueing_cued_ml_t0,cueing_neutral_ml_v,cueing_neutral_ml_t0,cueing_ml_fit,cueing_ks_a,cueing_cued_ks_v,cueing_cued_ks_t0,cueing_neutral_ks_v,cueing_neutral_ks_t0,cueing_ks_fit,cueing_fixed_hddm_a,cueing_neutral_hddm_v,cueing_cued_hddm_v,cueing_neutral_hddm_t,cueing_cued_hddm_t,flanker_ks_a,flanker_con_ks_v,flanker_con_ks_t0,flanker_incon_ks_v,flanker_incon_ks_t0,flanker_ks_fit,flanker_ssp_a,flanker_ssp_t0,flanker_ssp_p,flanker_ssp_rd,flanker_ssp_sda,flanker_ssp_interference,flanker_fixed_hddm_a,flanker_con_hddm_v,flanker_incon_hddm_v,flanker_con_hddm_t,flanker_incon_hddm_t,final_width_px,scale_factor,fullscreenenter,fullscreenexit,blur_event,focus_event,event_during_cueing,event_during_change,event_during_flanker
1,2021-11-12T18:09:54Z,2021-11-12T18:40:56Z,1861,1,2021-11-12T18:40:57Z,1,Chrome,95.0.4638.69,Windows NT 10.0,1280,720,NA,1.7777777777777777,735,96,625,121,79,107,-0.13925781347288652,0.05628551762956986,0.9507902260980237,0.2000843091083093,0.09744193443982496,0.02742145097557139,3,4,2,2,3,1,1,4,1,4,3,1,2,1,4,4,1,1,2,3,1.2258187382102494,0,1,2,5,5,1.45,0,4,5,2,2,2,1,5,4,2,1,1,5,2,4,4,2,4,4,1,2,2,1,3,5,1,2,3,4,4,5,5,4,5,4,5,5,2,4,2,1,5,1,5,3,3,3,3,3,1,1,5,4,3,1,3,3,3,3,5,2,1,1,1,3,2,2,2,2,1.456063226690421,1.533747356112131,2.375,0,2,0,1.8666666666666667,0,1.4444444444444444,0,2.0833333333333335,0,3,0,2.142857142857143,0,1.6666666666666667,0,2.108108108108108,0,3,2,3,0.144539757260731,-0.1288122820061409,1.1282568208640904,0.49972226942897474,4,2,2,3,2,4,4,4,1,1,3,0,2.5,0.8469035402869574,5,5,5,5,2,2,1,4,7,NA,3,1.8126539343499315,4.142857142857143,0,1.8571428571428572,3.5,3.8333333333333335,3.2559414990859232,-0.4571894270818581,0,-0.563033266702152,3,4,4,2,2,2,3,2,2,2,1,4,1,3,3,3,4,1,3,4,1.0600988273786194,3,0,4.4,0,3.2,0,3.2,0,3.6,0,2,1,1,4,2,1,1,3,1,1,2,4,2,2,2,4,1,2,1,2,1.050062654772261,1.45,0,"White, Caucasian, Anglo, European American",0,26,1,2,NA,1,3,6,Teacher,1,0,109,69,2,5,2,0,0,1,0,0,TRUE,TRUE,TRUE,TRUE,TRUE,1,0.9689083333317604,0.72,0.18178143326077806,1,0.43045312499953436,0.5180600000013907,1,0.9375,0.0018699774092332136,0.006123577973863204,1,0.5644843749981373,0.6408548387096774,1,0.96875,0.007203311683837731,0.0076763203127120155,1.4271,0.6613,0.5237,1.1783,0.5677,0.5853,0.0534,NA,NA,NA,1.3424,5.9454,0.3176,2.986,0.3113,-74.7244,0.6985,6.7674,0.3824,4.4588,0.4471,0.9727,NA,NA,NA,NA,NA,0.8137,3.2552,0.4736,4.9955,0.5567,0.9961,0.081,0.383,0.502,0.016,1.812,113.25,NA,NA,NA,NA,NA,357,1.0577777777777777,1,0,0,1,FALSE,FALSE,FALSE
2,2021-11-12T18:29:39Z,2021-11-12T18:57:30Z,1671,1,2021-11-12T18:57:34Z,1,Chrome,95.0.4638.69,Windows NT 10.0,1536,864,NA,1.7777777777777777,778,79,399,105,93,140,-0.028775031717708392,-0.09815503369452862,-0.13722781824789776,0.0051018045636124325,0.2908107693556527,0.5848365540837228,2,3,4,3,2,1,1,3,2,2,3,2,3,3,1,2,2,3,2,2,0.8013147091860318,0,1,2,3,4,2.6,0,4,5,3,4,4,2,4,1,1,2,1,5,3,4,3,2,1,1,1,1,1,3,1,0,2,0,0,4,3,4,4,4,5,4,4,5,3,5,3,1,5,1,5,2,1,2,3,3,5,1,1,1,1,1,1,1,1,1,5,1,2,1,1,1,1,1,2,1,1.6237723475403307,1.3870146083619754,1.375,0,1.25,0,2,0,1.8888888888888888,0,1.8333333333333333,0,0.8333333333333334,0,1,0,1,0,1.5135135135135136,0,0,0,0,-0.8473115880114084,-0.756787244710855,-0.6588395645607719,-0.7078134046358134,4,1,5,2,1,2,1,1,1,1.6035674514745464,1.4285714285714286,0,1,-0.6467170085812028,5,4,5,5,4,4,2,6,4,4,4,1.0690449676496976,4.428571428571429,0,1.5714285714285714,4,3.8333333333333335,3.2559414990859232,-0.1748077221195339,0,-0.5811844090638635,2,2,3,1,2,1,4,3,2,3,1,5,2,4,4,2,5,2,4,5,1.4074631010979937,2,0,4.8,0,3.8,0,3.2,0,3.933333333333333,0,1,2,1,3,2,1,2,3,1,2,1,4,1,2,1,4,1,2,1,1,1.0052493799000692,1.4,0,"White, Caucasian, Anglo, European American",0,18,1,2,NA,1,4,4,Full time student,5,0,150,71,2,5,2,0,0,0,0,0,TRUE,TRUE,TRUE,TRUE,TRUE,5,0.7139536585342593,0.82,0.04087522292360682,5,0.429609677416663,0.4857483870925442,0.96875,0.96875,0.001390286360862519,0.0026939386187109986,5,0.5176093749981373,0.565940625006333,1,1,0.006477084103693077,0.003834502489063209,1.4835,1.1292,0.3229,0.8639,1.7583,0.5841,0.2938,1.4789781606666668,1.0492792888666667,0.3200236789,0.9093,6.0256,0.3585,3.7334,0.3726,-99.9974,0.7418,7.4161,0.3773,7.7264,0.4389,0.9936,0.9924019337666666,3.8748345646666666,5.694360025666667,0.3667654368666667,0.3517926919666667,0.8492,4.6747,0.435,6.2013,0.4971,0.9625,0.206,0.263,0.828,0.022,1.452,66,1.924471455,4.905503073,5.485785591333333,0.32550241803333335,0.40009415626666667,388,1.1496296296296296,1,0,0,1,FALSE,FALSE,FALSE
3,2021-11-12T20:05:45Z,2021-11-12T20:37:26Z,1901,1,2021-11-12T20:37:28Z,1,Chrome,95.0.4638.69,Macintosh,1920,1200,N/A,1.6,763,94,472,256,135,119,-0.06731553698114262,0.038116041003205335,0.2142116385541034,1.845249191204189,0.870917274103136,0.2301178521058083,3,3,2,2,2,1,3,2,1,2,1,1,1,2,2,3,3,1,2,2,0.7591546545162482,0,1,1,2,1,2.25,0,4,5,1,5,1,1,4,2,1,1,2,5,2,4,5,1,2,1,1,1,2,2,1,0,2,0,0,5,2,1,4,4,5,4,5,5,1,5,3,1,4,1,5,1,2,3,3,2,5,1,1,1,1,1,1,1,1,1,5,1,1,1,1,1,1,1,1,1,1.692147559571376,1.7265434778633235,1.375,0,1,0,1.4,0,2.111111111111111,0,1.75,0,0.8333333333333334,0,0.8571428571428571,0,1,0,1.5135135135135136,0,0,0,0,-0.8473115880114084,-1.014636397091459,-0.7372407672780129,-0.8759385821847359,5,1,5,1,1,1,3,3,1,1.9023794624226837,1.2857142857142858,0,2,-0.3631965189619651,5,5,5,5,4,4,1,6,4,4,4,1.4638501094227998,4.714285714285714,0,1.2857142857142858,4,3.8333333333333335,3.2559414990859232,-0.1748077221195339,0,-0.740526403906737,1,3,2,4,2,2,5,2,3,3,1,1,3,4,4,1,5,1,5,3,1.505545305418162,2.4,0,4,0,4.2,0,3.6,0,3.933333333333333,0,2,1,3,3,1,3,3,4,3,3,2,3,3,3,1,2,1,3,2,3,0.8870412083230169,2.25,0,"White, Caucasian, Anglo, European American",0,30,1,2,NA,1,2,4,phlebotomist,2,0,190,67,1,5,2,0,0,1,0,0,TRUE,TRUE,TRUE,TRUE,TRUE,2,0.9792903225792031,0.62,0.06825520449297964,2,0.5632875000005588,0.6372724137927951,1,0.90625,0.0069835624193429514,0.013751682540539246,2,0.884878125003539,1.4514379310376686,1,1,0.03535617789282836,0.25000669243792767,1.5002,0.3439,0.463,1.037,0.4521,0.7204,0.6062,1.5164334806666666,0.5094928609473334,0.4560987154,1.1888,3.4956,0.3932,2.4509,0.4279,-49.7157,1.1192,5.8441,0.4687,2.5863,0.4423,0.9819,1.3920670978,2.704693149666667,3.8951973676666665,0.4060598241,0.3801149564,2.115,3.175,0.5479,1.5316,0.8255,0.9907,0.149,0.381,0.273,0.004,1.873,468.25,3.5965427936666665,3.8487970086666667,1.9296920329,0.4152991676,0.4983295293,104,0.3081481481481481,1,0,0,1,FALSE,FALSE,FALSE
4,2021-11-12T20:10:50Z,2021-11-12T20:47:03Z,2172,1,2021-11-12T20:47:05Z,1,Chrome,95.0.4638.69,Windows NT 10.0,1920,1080,NA,1.7777777777777777,997,71,574,143,88,187,0.5339163451284313,-0.1708329401999867,0.7052640302500502,0.4681852528572675,0.22175047117142851,1.3787307918438174,4,4,1,1,2,1,1,4,3,4,2,1,1,2,4,2,2,3,1,2,1.2085223687584246,0,1,3,2,2,1.85,0,3,4,4,5,2,1,5,3,2,2,3,4,2,3,3,3,4,1,3,2,1,2,5,2,4,0,0,4,5,3,4,5,5,4,5,5,2,4,2,4,4,4,5,2,2,1,3,3,5,1,1,1,2,1,3,4,5,5,5,3,1,1,1,1,3,3,3,5,1.5663503610155212,1.162919151265879,2.625,0,3.5,0,2.2666666666666666,0,1.5555555555555556,0,2.3333333333333335,0,1,0,3,0,1,0,2,0,1,0,0,0.2327977159502012,0.10406499300426954,0.24986373369091455,0.17696436334759205,5,3,2,1,1,2,3,1,4,1.3972762620115438,2.142857142857143,0,2.5,0.33410042935609163,5,4,5,4,3,4,5,6,7,3,3,0.7559289460184544,3.7142857142857144,0,2.2857142857142856,2.5,3.8333333333333335,3.2559414990859232,-1.0219528370065065,0,-0.6064019794001662,4,3,4,5,4,4,4,3,5,5,5,3,3,4,3,5,3,2,4,5,0.990430401872025,4,0,2.6,0,3.4,0,2.4,0,2.8,0,2,3,1,2,3,2,4,2,1,1,3,1,2,1,1,3,1,2,1,1,0.9333020044867296,2.05,0,"White, Caucasian, Anglo, European American",0,23,0,1,NA,1,4,6,executive officer,4,0,176.37,67,4,5,2,0,0,0,0,0,TRUE,TRUE,TRUE,TRUE,TRUE,2,0.7565170731733485,0.82,0.020608396146742692,2,0.47689666666686537,0.582609374997206,0.967741935483871,1,0.007027707225293465,0.020265348619957296,2,0.6721593750026077,0.7561483870965819,1,1,0.01767298700535223,0.026144731913724486,1.2143,1.3358,0.4566,0.8996,1.8156,0.594,0.3668,1.2619114250666668,1.1714831358,0.44826973893333333,1.6462,3.4146,0.2454,4.0791,0.3808,-54.2693,1.1542,4.7016,0.3509,4.6782,0.4429,0.9983,1.6872982153333334,4.0323779313333334,3.6076531966666665,0.3741524173,0.24529113393333332,1.0601,4.7451,0.5595,2.8434,0.5787,0.9895,0.127,0.404,0.481,0.013,1.259,96.84615384615384,2.4722058983333333,4.403956277,3.6288408333333333,0.3932085811666667,0.4177870945,104,0.3081481481481481,1,1,11,12,FALSE,FALSE,FALSE
5,2021-11-12T19:50:08Z,2021-11-12T21:01:17Z,4269,1,2021-11-12T21:01:18Z,0.8999999761581421,Chrome,95.0.4638.69,Windows NT 10.0,1920,1080,-,1.7777777777777777,2663,50,424,56,38,165,4.814481796387192,-0.36161244477681426,-0.01687183989104805,-0.5920321156045217,-0.46885251067081346,1.0071207231050496,3,3,2,2,3,1,1,3,2,3,4,1,1,2,1,3,1,2,2,2,0.9119095061289915,0,1,2,4,3,1.9,0,5,5,2,5,2,1,5,1,1,1,1,5,1,5,3,1,1,1,1,1,1,1,1,4,2,0,0,4,5,5,5,5,5,5,5,5,1,5,1,1,5,1,5,1,1,1,1,1,5,1,1,1,5,1,1,5,5,1,5,1,1,1,1,1,1,1,3,3,1.9977464781575742,1.88477610139267,1,0,2,0,1.2666666666666666,0,1.1111111111111112,0,1,0,1.5,0,2,0,1,0,1.3513513513513513,0,2,0,0,-1.1814310030501165,-1.3027808890723365,-0.01745100881601569,-0.6601159489441761,4,3,4,2,3,3,3,8,8,0.6900655593423543,2.5714285714285716,0,8,2.619934196080626,4,4,4,4,2,2,1,4,4,3,3,1.2909944487358056,3.5714285714285716,0,2.4285714285714284,5,3.8333333333333335,3.2559414990859232,0.38995568780511447,0,0.17922328042708108,4,5,2,3,3,4,3,4,4,4,3,4,1,5,4,4,2,5,4,4,1.0465362369445672,3.4,0,2.4,0,3.6,0,3,0,3,0,1,1,1,4,1,1,4,4,1,1,1,3,1,1,1,4,1,1,1,1,1.260743306232687,1.2,0,"White, Caucasian, Anglo, European American",0,23,0,1,NA,1,4,6,Teacher / tutor,2,0,185,71,2,5,2,0,0,0,0,0,TRUE,TRUE,TRUE,TRUE,TRUE,NA,NA,NA,NA,6,0.4833451612918608,0.5990677419367336,1,0.96875,0.008427499892490739,0.023712034989482954,6,0.8268968750010245,0.8990187499998137,1,1,0.10725188031256856,0.12237486866959332,NA,NA,NA,NA,NA,NA,NA,NA,NA,NA,1.4176,4.1763,0.3136,3.0074,0.3742,-56.1129,0.8965,4.2604,0.3801,3.6162,0.4588,0.9118,1.545656197,3.1858415376666667,4.379011525,0.36282781686666665,0.3053561465333333,1.9852,1.4598,0.3176,1.4976,0.3745,0.4614,0.19,0.059,0.234,0.225,1.541,6.848888888888888,2.336816941,2.115877562,1.8929836250333334,0.2526546310066667,0.26412095696666665,104,0.3081481481481481,1,1,6,7,FALSE,FALSE,FALSE
6,2021-11-12T20:40:27Z,2021-11-12T21:11:50Z,1882,1,2021-11-12T21:11:51Z,1,Chrome,95.0.4638.69,Macintosh,1440,900,no,1.6,735,64,862,66,50,70,-0.13925781347288652,-0.23442610839226255,2.091764900920959,-0.47016805026408615,-0.3031077950286754,-0.5975591191759924,3,3,1,1,3,1,2,3,1,4,3,1,1,2,3,4,1,1,3,4,1.164157703189193,0,1,3,4,4,1.45,0,5,4,3,4,3,1,4,2,3,1,3,5,3,4,4,1,3,1,1,2,3,2,2,1,2,0,0,5,5,5,5,5,5,4,5,5,2,4,1,1,4,3,5,2,1,1,1,1,5,1,1,1,3,2,1,5,1,1,3,3,2,1,3,1,2,2,2,2,1.7133112488498508,1.2227992865708155,1.875,0,2,0,2.066666666666667,0,1.1111111111111112,0,1.5,0,1.3333333333333333,0,2.142857142857143,0,1.6666666666666667,0,1.5675675675675675,0,1,0,0,-0.5026852731287158,-0.4900333918726625,-0.22054348261253207,-0.3552884372425973,4,2,5,2,1,2,1,2,1,1.5118578920369088,1.5714285714285714,0,1.5,-0.3767559860388676,5,4,5,4,1,1,3,6,7,2,3,1.7043362064926932,3.2857142857142856,0,2.7142857142857144,2.5,3.8333333333333335,3.2559414990859232,-1.0219528370065065,0,-0.3673889871358558,1,3,2,3,2,1,5,1,1,3,1,5,2,4,5,1,3,2,4,2,1.5886502207249789,2.2,0,4.4,0,4.2,0,4.6,0,4.4,0,2,1,2,3,3,2,3,3,2,3,1,3,1,2,1,3,3,3,2,2,0.7863975156570492,2.05,0,"White, Caucasian, Anglo, European American",0,20,1,2,NA,1,2,4,student and content creator for Buzzfeed,1,0,110,63,2,5,2,0,1,1,0,1,TRUE,TRUE,TRUE,TRUE,TRUE,2,1.02324999998297,0.84,0.07472284746013637,NA,NA,NA,NA,NA,NA,NA,2,1.1711187499687077,1.3209483870767778,1,1,0.15261331963155408,0.20588094791120307,1.4705,1.2037,0.6199,1.2593,1.1734,0.6881,0.109,1.4919677456666667,1.0980741158,0.6079472056666667,NA,NA,NA,NA,NA,NA,NA,NA,NA,NA,NA,NA,NA,NA,NA,NA,NA,2.5548,1.452,0.4268,1.3698,0.522,0.7343,0.226,0.237,0.243,0.02,1.909,95.45,3.184423256666667,2.1280640566666666,1.8605256265666668,0.4000997950333333,0.4445530695666667,104,0.3081481481481481,1,0,0,1,FALSE,FALSE,FALSE
7,2021-11-12T20:50:28Z,2021-11-12T21:15:48Z,1520,1,2021-11-12T21:15:48Z,0.8999999761581421,Chrome,95.0.4638.54,Macintosh,1440,900,/,1.6,722,86,361,86,79,91,-0.1726595847011962,-0.03456186550225277,-0.32016890535030934,-0.2264399195832151,0.09744193443982496,-0.2428404171980778,3,2,2,2,1,2,4,2,2,2,1,2,3,2,3,1,4,3,3,2,0.8645047258706176,0,1,3,3,1,2.8,0,4,3,2,4,1,3,4,2,1,1,3,5,1,5,4,3,1,1,1,3,1,1,1,5,2,0,0,3,5,5,5,5,5,4,5,4,1,5,2,1,5,1,5,4,3,2,2,3,4,1,1,1,3,1,1,4,4,1,4,3,2,1,1,1,2,1,3,3,1.622384705343382,1.4573295865416045,1.5,0,2.25,0,1.8,0,1.4444444444444444,0,1.8333333333333333,0,1.3333333333333333,0,2.2857142857142856,0,1,0,1.7297297297297298,0,3,0,0,-0.6350722111629208,-0.6960997752879425,0.2640426676977418,-0.21602855379510036,5,2,4,1,1,1,1,2,2,1.6761634196950514,1.2857142857142858,0,2,-0.3631965189619651,5,5,5,5,2,1,3,7,7,2,3,1.7043362064926932,3.7142857142857144,0,2.2857142857142856,2,3.8333333333333335,3.2559414990859232,-1.3043345419688306,0,-0.7475928318813282,2,3,3,4,3,2,5,1,1,4,1,5,3,5,4,1,3,2,4,3,1.533747356112131,3,0,4.2,0,4.2,0,4.4,0,4.266666666666667,0,3,2,4,2,4,4,4,2,4,4,1,3,3,2,2,2,3,3,4,4,0.9733285267845752,3.1,0,"Asian or Asian American (e.g., Chinese, Japanese, and others)",0,19,1,2,NA,1,3,4,Student,3,0,99,63,1,5,2,0,0,0,0,0,TRUE,TRUE,TRUE,TRUE,TRUE,5,1.127168750008568,0.64,0.2276926481612541,5,0.5036870967707326,0.6003551724183148,1,0.90625,0.003578048495075049,0.009642999353870502,5,0.8239687500018626,1.0438566666662692,1,0.9375,0.0553570086672784,0.10097657611776177,1.5852,0.3632,0.5607,1.4393,0.267,0.65,0.2025,1.5955349943333332,0.5037630515784,0.5502328639666667,1.2016,4.3195,0.3646,2.5193,0.3964,-58.3806,0.9005,7.2879,0.4423,3.5221,0.4736,0.9994,1.3549108840666666,2.7737258926666666,4.56956678,0.3828080023666667,0.3551249874,1.4245,3.1041,0.5678,1.3602,0.7003,0.9658,0.081,0.535,0.21,0.017,2.001,117.70588235294116,2.235117865,3.1841113266666667,1.8161826922,0.4654758076,0.5189319164,104,0.3081481481481481,1,0,1,2,FALSE,FALSE,FALSE
8,2021-11-12T21:14:28Z,2021-11-12T21:32:10Z,1062,1,2021-11-12T21:32:12Z,0.8999999761581421,Chrome,95.0.4638.69,Macintosh,1440,900,NA,1.6,543,46,251,61,46,67,-0.6325762808448446,-0.39795139802954327,-0.8497352101204481,-0.5311000829343039,-0.3583560335760547,-0.6482332194585516,2,3,2,1,3,1,2,3,2,3,3,2,1,1,3,3,2,1,2,3,0.812727700887249,0,1,1,4,3,1.85,0,4,4,2,3,1,1,5,1,1,1,2,3,2,4,5,1,2,1,1,1,2,2,2,0,2,0,0,5,5,4,5,5,4,5,5,5,1,3,1,1,3,1,4,2,2,3,3,4,3,1,1,1,3,3,3,1,4,1,2,4,2,1,3,1,2,1,2,4,1.5002502293786697,1.5023790657297036,1.5,0,2.25,0,1.6666666666666667,0,1.2222222222222223,0,2.1666666666666665,0,1.8333333333333333,0,2.5714285714285716,0,1.6666666666666667,0,1.972972972972973,0,0,0,0,-0.4837728534095438,-0.6488661467737779,-0.34523475369180734,-0.4970504502327926,2,4,2,5,5,5,4,3,1,1.3451854182690985,4.428571428571429,0,2,1.5170815544512093,5,5,5,4,2,3,3,7,4,1,2,1.2149857925879117,3.857142857142857,0,2.142857142857143,3.5,3.8333333333333335,3.2559414990859232,-0.4571894270818581,0,-0.40369127185927867,1,2,2,1,1,1,5,2,1,2,3,4,2,5,4,2,4,1,4,1,1.486446705914413,1.4,0,4.2,0,3.8,0,4.6,0,4.2,0,2,3,3,4,3,4,4,2,1,2,3,1,4,2,1,1,3,3,2,4,1.0954451150103321,2.8,0,"White, Caucasian, Anglo, European American",0,19,1,2,NA,1,2,4,Student,1,0,140,67,1,5,2,0,0,1,0,0,TRUE,TRUE,TRUE,TRUE,TRUE,NA,NA,NA,NA,6,0.45028275861822326,0.5163833333333333,0.9666666666666667,0.9375,0.0035171796437376236,0.0038664351534692556,6,0.6012903225806452,0.6385310344901578,0.96875,0.90625,0.00784758103946578,0.008346833830926773,NA,NA,NA,NA,NA,NA,NA,NA,NA,NA,1.0609,3.9948,0.3228,3.2571,0.3704,-68.9227,0.8802,5.8345,0.3715,5.4189,0.4295,0.9871,1.1692283212333334,3.4850564876666668,4.2624058326666665,0.3635040560666667,0.3168622956,0.6433,3.5035,0.5414,3.0738,0.576,0.956,0.056,0.419,0.308,0.03,2.024,67.46666666666667,1.4923303496666667,3.087581128666667,2.4924725125,0.36626674633333334,0.3796833163,368,1.0903703703703704,1,0,0,1,FALSE,FALSE,FALSE
9,2021-11-12T21:05:27Z,2021-11-12T21:32:25Z,1618,1,2021-11-12T21:32:27Z,1,Chrome,95.0.4638.69,Windows NT 10.0,1280,720,Have a beautiful day! :),1.7777777777777777,687,72,471,124,89,105,-0.26258743031587606,-0.16174820188680444,0.2093973994198294,0.23664352871043995,0.23556253080827336,-0.006361282546134758,4,4,1,1,4,1,2,3,1,2,2,1,2,2,4,4,1,1,2,3,1.2085223687584246,0,0,2,4,3,1.55,0,3,4,4,3,3,2,3,4,3,2,5,3,2,3,4,4,5,1,1,3,4,2,3,0,2,0,0,5,4,5,4,4,5,4,4,5,2,5,5,2,4,3,5,2,5,5,5,3,1,1,1,1,1,1,1,1,1,1,5,1,2,1,1,2,1,1,1,1,1.7220526895148898,0.8618916073713346,2.875,0,1,0,2.933333333333333,0,1.5555555555555556,0,3,0,1.5,0,1,0,1.3333333333333333,0,1.945945945945946,0,0,0,0,0.3546777541404215,0.4747715446625703,-0.7372407672780129,-0.1312346113077213,5,2,2,1,1,1,1,1,1,1.4638501094227998,1.5714285714285714,0,1,-0.5612498234260587,5,5,5,4,2,2,3,5,3,2,3,1.3801311186847085,3.7142857142857144,0,2.2857142857142856,5,3.8333333333333335,3.2559414990859232,0.38995568780511447,0,0.09955228300564435,3,3,3,5,4,4,3,3,2,2,1,3,4,4,4,4,3,4,3,3,0.9154754164341269,3.6,0,3,0,2.4,0,3.6,0,3,0,2,2,3,2,3,3,4,2,2,2,1,2,1,3,1,2,2,3,1,3,0.8335087534664907,2.4,0,"White, Caucasian, Anglo, European American",0,20,1,2,NA,1,3,3,full time student,2,0,104,62,1,5,2,0,0,1,0,0,TRUE,TRUE,TRUE,TRUE,TRUE,1,0.9724891891898335,0.74,0.11390051086141297,1,0.4799218749997672,0.6022833333328367,1,0.9375,0.0026409495061828735,0.009795786088605736,1,0.6559374999993015,0.8810516129030336,1,0.96875,0.009115615967729272,0.04722352861881764,1.5403,0.7126,0.5142,1.227,0.6206,0.666,0.3375,NA,NA,NA,1.2955,4.9896,0.3501,2.9381,0.4013,-68.0203,0.7528,5.1167,0.413,3.8821,0.5053,0.7128,NA,NA,NA,NA,NA,1.3233,5.4061,0.533,1.8519,0.6127,0.9771,0.101,0.416,0.372,0.008,1.548,193.5,NA,NA,NA,NA,NA,345,1.0222222222222224,1,0,0,1,FALSE,FALSE,FALSE
10,2021-11-12T21:02:28Z,2021-11-12T21:33:39Z,1870,1,2021-11-12T21:33:40Z,1,Chrome,95.0.4638.69,Windows NT 10.0,1366,768,No comments,1.7786458333333333,836,108,524,111,75,136,0.12024825530090397,0.16530237738775702,0.4645520735363508,0.07822024376787376,0.04219369589244561,0.5172710870403106,1,4,1,1,3,1,1,4,1,4,4,2,1,1,3,3,1,1,3,3,1.268027892769755,0,1,2,3,3,1.45,0,5,5,2,4,1,1,5,1,2,5,2,5,1,4,5,1,1,1,1,1,1,1,1,1,2,0,0,4,5,5,5,4,5,5,4,5,1,5,1,1,5,2,5,1,1,2,2,3,5,1,3,1,3,1,1,1,2,1,5,1,2,1,1,1,2,2,1,2,1.7424224619867699,1.780850519113991,1,0,1.75,0,1.6,0,1.3333333333333333,0,1.4166666666666667,0,1.5,0,1.1428571428571428,0,1,0,1.3783783783783783,0,1,0,0,-1.1646199632997414,-1.14791653328819,-0.2989446853297732,-0.7234306093089816,4,2,2,2,1,2,2,3,2,0.8997354108424374,2.142857142857143,0,2.5,0.33410042935609163,4,5,5,3,3,3,1,1,3,NA,2,1.3972762620115438,4,0,2,7,3.8333333333333335,3.2559414990859232,1.5194825076544112,0,0.5049736980874192,1,1,3,2,3,2,3,1,1,1,1,3,3,4,3,5,2,1,1,5,1.4540583599999397,2,0,3.8,0,1.8,0,3.6,0,3.066666666666667,0,1,1,1,3,2,1,1,2,1,1,2,3,2,1,1,4,1,1,1,1,0.8870412083230169,1.35,0,"Hispanic of Latino (e.g., Mexican American, Central American, and others)",0,27,0,1,NA,1,2,6,Software Developer,1,0,139,64,3,5,2,0,0,0,0,0,TRUE,TRUE,TRUE,TRUE,TRUE,2,0.9162511627906283,0.86,0.06616325993461322,2,0.4577937499994878,0.5143593749995343,1,1,0.0017245935081051178,0.00221258507058204,2,0.5518562500001862,0.7028266666675608,1,0.967741935483871,0.00456476124987975,0.01368023516125704,1.4727,1.3009,0.5414,0.9296,2.1107,0.7424,0.4902,1.4804672133333334,1.1574178041,0.5324356164666667,4.6728,11.3467,0.2519,9.9384,0.2793,-110.735,0.7188,6.5751,0.4033,6.0437,0.4617,0.8125,1.4686289967666666,5.362445069666666,6.367224491,0.3842038378666667,0.3489370508,1.0691,5.8403,0.4704,3.1159,0.5523,0.7885,0.098,0.365,0.545,0.012,1.912,159.33333333333331,2.231555799666667,5.240987246,2.957480235,0.3438835421,0.3369812457,342,1.0133333333333332,1,0,0,1,FALSE,FALSE,FALSE
11,2021-11-12T21:07:52Z,2021-11-12T21:34:07Z,1575,1,2021-11-12T21:34:08Z,1,Chrome,95.0.4638.69,Windows NT 10.0,1366,768,no,1.7786458333333333,681,76,464,107,65,114,-0.27800363242124976,-0.1254092486340754,0.1756977254799115,0.02947461763169954,-0.09592690047600279,0.1456610183015429,3,3,2,2,3,1,1,1,1,2,2,1,3,1,2,2,1,1,1,3,0.8335087534664907,0,1,1,4,3,2.1,0,2,5,2,3,4,2,2,2,3,2,3,5,1,4,4,3,4,1,1,2,3,3,1,1,2,0,0,5,2,4,3,5,5,2,4,4,4,5,2,1,3,2,5,1,3,3,4,1,3,1,1,1,3,2,1,1,1,1,4,2,1,1,3,1,2,1,1,1,1.4632638658632766,1.2227992865708155,2.25,0,1.25,0,2.4,0,2.2222222222222223,0,2.1666666666666665,0,1.6666666666666667,0,1.1428571428571428,0,1.6666666666666667,0,1.9189189189189189,0,1,0,0,-0.05088857983738084,-0.034635395644906565,-0.4557470907642554,-0.245191243204581,5,1,2,1,1,1,1,2,1,1.4960264830861913,1.4285714285714286,0,1.5,-0.4622231711940119,2,2,2,4,1,2,3,4,4,2,1,0.9511897312113419,2.2857142857142856,0,3.7142857142857144,5,3.8333333333333335,3.2559414990859232,0.38995568780511447,0,0.8962622572200118,4,4,2,2,2,1,3,3,2,1,1,5,1,4,3,1,4,2,2,3,1.2983506020002016,2.8,0,4.6,0,3.2,0,3.4,0,3.7333333333333334,0,1,1,1,4,1,1,2,3,1,1,1,3,1,1,1,4,1,1,1,2,1.0462967275611939,1.2,0,"White, Caucasian, Anglo, European American",0,23,1,2,NA,1,2,6,Unemployed,4,0,105,61,1,5,2,0,0,1,0,0,TRUE,TRUE,TRUE,TRUE,TRUE,4,0.8690575000286103,0.8,0.06632701064763906,4,0.4583500000834465,0.5489225806574668,1,0.96875,0.007580701290978461,0.006242672249080944,4,0.6149718751311303,0.6701531249880791,1,1,0.017071703400719167,0.02549168775148461,1.3768,1.0197,0.4977,1.0492,1.1916,0.6554,0.4853,NA,NA,NA,1.6831,4.1467,0.2554,3.9605,0.3498,-60.6926,0.9147,3.6585,0.3472,3.7415,0.4452,0.9831,NA,NA,NA,NA,NA,1.2708,5.2041,0.4929,2.6713,0.4798,0.661,0.201,0.157,0.417,0.06,1.61,26.833333333333336,NA,NA,NA,NA,NA,360,1.0666666666666667,1,0,0,1,FALSE,FALSE,FALSE
12,2021-11-12T21:02:45Z,2021-11-12T21:36:48Z,2043,1,2021-11-12T21:36:51Z,1,Chrome,95.0.4638.69,Macintosh,1440,900,N/A,1.6,760,123,628,134,136,141,-0.07502363803382947,0.30157345208549097,0.9652329435008457,0.3585075940508755,0.8847293337399809,0.6017279208445759,2,2,3,3,2,3,3,1,2,2,2,2,1,2,2,1,2,2,2,1,0.6488856845230502,0,1,1,4,4,2.8,0,2,4,2,4,2,2,3,4,3,2,5,3,2,3,2,4,4,1,1,4,4,4,4,7,2,0,3,4,4,4,3,3,3,3,3,3,2,4,4,3,4,2,4,2,4,4,4,4,2,4,1,1,3,1,1,4,4,4,5,1,1,1,1,1,3,2,4,4,1.2728393929008168,0.990430401872025,3.25,0,3.25,0,2.8666666666666667,0,2.6666666666666665,0,2.9166666666666665,0,2.1666666666666665,0,2.142857142857143,0,1,0,2.4864864864864864,0,4,0,3,0.9241517256843829,0.8395738927566005,1.3100888930607648,1.0748313929086826,4,2,3,2,2,2,2,4,1,0.7867957924694432,2.142857142857143,0,2.5,0.33410042935609163,4,4,4,4,3,3,2,3,3,3,3,0.7867957924694432,3.7142857142857144,0,2.2857142857142856,6,3.8333333333333335,3.2559414990859232,0.9547190977297628,0,0.3819339879679685,2,3,3,3,2,3,3,3,2,2,2,3,3,3,3,2,3,2,3,4,0.5936168397046637,2.6,0,3.4,0,3,0,3,0,3.1333333333333333,0,3,1,2,4,2,2,3,3,2,1,2,3,3,3,2,3,2,2,1,2,0.8013147091860318,2,0,"White, Caucasian, Anglo, European American",0,26,1,2,NA,1,3,6,Regulatory Affairs Associate,3,0,196,64,2,5,2,0,0,1,0,0,TRUE,TRUE,TRUE,TRUE,TRUE,3,1.0447829268292819,0.8367346938775511,0.05851560933677633,3,0.5256750000001048,0.5831290322580345,1,1,0.0025811567741905205,0.0027844161290262806,3,0.7734468750000233,0.8307375000000174,1,1,0.005957691602836485,0.006307882419359183,1.5352,1.1668,0.6009,1.1589,1.5982,0.7577,0.4842,1.538659079,1.0711033653333333,0.5906626724666667,10,12.1844,0.1153,12.3001,0.1766,-97.759,0.7324,6.4728,0.4755,6.6698,0.529,0.872,2.0109909503333334,5.766272808,5.548674024333334,0.4163842657333333,0.3483162818,1.6872,9.2675,0.6889,10.6639,0.7482,0.9491,0.396,0.329,0.887,0.018,1.271,70.61111111111111,3.307127721666667,5.113245089,5.282196858333333,0.4542316027,0.5257818606,378,1.12,1,0,0,1,FALSE,FALSE,FALSE
13,2021-11-12T21:12:43Z,2021-11-12T21:53:24Z,2441,1,2021-11-12T21:53:26Z,0.8999999761581421,Chrome,95.0.4638.69,Windows NT 10.0,1920,1080,no,1.7777777777777777,1409,84,525,122,87,131,1.5924955563640915,-0.0527313421286173,0.4693663126706248,0.21227071564235284,0.20793841153458367,0.43281425323604517,2,2,3,3,2,1,3,1,1,1,1,2,1,2,1,1,2,1,1,1,0.7539370349250519,0,1,3,2,2,2.8,0,5,5,2,5,1,1,5,1,1,1,1,5,3,5,4,2,1,1,1,2,2,1,2,3,1,0,0,5,4,4,5,3,5,4,4,3,1,5,1,1,5,1,5,1,1,1,1,2,3,1,1,3,3,1,1,2,1,1,5,1,1,1,1,1,1,1,1,2,1.6407901121691928,1.889822365046136,1.5,0,1.25,0,1.2666666666666666,0,1.8888888888888888,0,1.0833333333333333,0,1.8333333333333333,0,1,0,1,0,1.4324324324324325,0,2,0,0,-0.8199936484170486,-1.0530621153704003,-0.25265461696773905,-0.6528583661690697,5,1,3,1,1,2,1,3,1,1.5275252316519468,1.4285714285714286,0,2,-0.2777293338068208,5,5,5,5,2,2,2,5,8,4,4,1.6035674514745464,4,0,2,2.5,3.8333333333333335,3.2559414990859232,-1.0219528370065065,0,-0.7657439742430396,3,2,3,3,3,2,4,2,2,3,2,4,1,3,4,2,4,3,3,3,0.9411239481143202,2.8,0,3.8,0,3.8,0,3.6,0,3.7333333333333334,0,2,2,2,2,3,3,3,1,2,2,2,2,2,3,2,2,1,2,4,2,0.6958523739384593,2.5,0,"Hispanic of Latino (e.g., Mexican American, Central American, and others) & White, Caucasian, Anglo, European American",1,30,0,1,NA,1,2,3,janitor,2,0,132,67,2,5,2,0,1,0,0,1,TRUE,TRUE,TRUE,TRUE,TRUE,5,1.4878534883718157,0.8775510204081632,0.5048131320833759,5,0.5844812500001862,0.6618354838709197,1,1,0.010016456411251838,0.01750726169897229,5,0.8221406249997671,0.9486687499999534,1,1,0.032586169586893095,0.06833836092750596,2.2116,0.8548,0.5262,2.6327,0.881,0.2997,0.0376,1.9875347253333333,0.813355944,0.5494041478333334,1.7962,4.4165,0.3811,3.8131,0.4263,-58.7509,1.0895,5.0299,0.4592,3.756,0.5149,0.8315,1.9816788246666666,3.877147132,4.486278092666667,0.4066711050333333,0.36274930046666665,1.763,2.58,0.5152,2.1078,0.5427,0.9264,0.172,0.345,0.337,0.014,1.391,99.35714285714286,2.8208617356666665,3.4274242223333333,2.838610114,0.4056488135333333,0.44753931006666664,326,0.965925925925926,1,0,1,2,FALSE,FALSE,FALSE
14,2021-11-12T21:23:40Z,2021-11-12T21:57:52Z,2051,1,2021-11-12T21:57:54Z,0.8999999761581421,Chrome,95.0.4638.69,Windows NT 10.0,1366,768,N/A; thank you!!,1.7786458333333333,704,88,941,81,67,102,-0.21890819101731726,-0.016392388875888245,2.472089792528604,-0.28737195225343287,-0.06830278120231312,-0.057035382828693984,4,4,1,2,4,1,3,4,1,4,3,1,1,1,4,4,2,1,4,4,1.3869694338832115,0,1,1,2,2,1.25,0,2,5,3,5,2,3,4,4,3,1,3,3,2,3,4,2,3,4,1,1,4,3,1,7,2,1,2,5,4,3,5,4,5,5,5,3,1,4,1,1,3,1,5,2,2,2,1,3,2,2,1,1,1,1,1,2,1,1,4,2,1,1,1,1,1,2,1,1,1.5339011874475008,1.1254628677422756,2.375,0,1.25,0,2.466666666666667,0,1.6666666666666667,0,1.6666666666666667,0,1.5,0,1.2857142857142858,0,1,0,1.5675675675675675,0,4,1,2,-0.19168103774677378,-0.1032596633017564,0.713062832016679,0.3049015843574613,5,1,5,1,1,1,1,1,1,1.9518001458970664,1,0,1,-0.9031185640466358,5,5,5,5,4,3,1,6,8,6,4,1.5275252316519468,4.571428571428571,0,1.4285714285714286,2,3.8333333333333335,3.2559414990859232,-1.3043345419688306,0,-1.2256188164099486,2,2,2,2,2,2,5,2,2,3,1,4,1,4,4,2,4,2,5,3,1.3345232785352157,2,0,4.2,0,4.4,0,3.8,0,4.133333333333334,0,1,1,1,3,1,2,1,3,2,3,2,4,2,2,2,4,1,3,2,1,0.998683343734455,1.65,0,"White, Caucasian, Anglo, European American",0,30,1,2,NA,1,1,6,Currently unemployed,1,0,125,67,4,5,2,1,1,0,0,2,TRUE,TRUE,TRUE,TRUE,TRUE,4,0.7646774193856024,0.62,0.07912295564796706,4,0.42638064509053386,0.510173333311081,0.96875,0.9375,0.0034786586987303352,0.005321731837819333,4,0.5285187499672175,0.6206499999682108,1,0.9375,0.00918655577071163,0.00943996587942089,1.4592,0.3443,0.2709,1.3004,0.2824,0.3976,0.358,1.4673794383333334,0.516508001749,0.2699163099333333,0.8426,3.9829,0.3273,3.1483,0.3878,-79.205,0.8839,5.0985,0.3402,4.2651,0.4051,0.9122,0.9391080990333334,3.3813635676666665,4.276861799333333,0.38000825786666664,0.3215254616,1.737,6.6263,0.3868,7.8489,0.5068,0.9358,0.074,0.363,0.475,0.016,1.987,124.1875,1.8673452576666667,4.2284177886666665,2.5703714643333333,0.30804692473333334,0.2792452780333333,326,0.965925925925926,1,0,0,1,FALSE,FALSE,FALSE
15,2021-11-12T21:44:46Z,2021-11-12T22:07:49Z,1383,1,2021-11-12T22:07:50Z,1,Chrome,91.0.4472.114,Macintosh,1440,900,NA,1.6,705,56,339,73,62,94,-0.216338823999755,-0.30710401489772066,-0.4260821663043371,-0.38486320452578127,-0.1373630793865373,-0.19216631691551858,3,3,2,1,3,1,1,3,1,3,3,2,2,1,3,3,1,1,3,3,0.9333020044867296,0,1,1,4,4,1.65,0,4,4,2,4,3,2,4,2,2,2,3,5,2,4,5,2,3,1,1,1,3,2,3,0,2,0,0,5,3,5,4,4,5,5,5,5,2,4,1,1,5,2,5,2,3,3,3,1,5,1,1,1,1,1,1,1,2,1,4,3,2,1,1,1,1,1,1,2,1.6476391336438676,1.1464230084422218,2,0,1.25,0,2,0,1.4444444444444444,0,1.8333333333333333,0,0.8333333333333334,0,1.5714285714285714,0,1,0,1.5135135135135136,0,0,0,0,-0.4585562937839808,-0.4881943776477256,-0.6588395645607719,-0.5735169711042487,4,2,4,1,2,2,1,2,1,1.2535663410560174,1.7142857142857142,0,1.5,-0.2912888008837234,5,5,5,5,3,2,1,8,8,5,4,1.7043362064926932,4.285714285714286,0,1.7142857142857142,1,3.8333333333333335,3.2559414990859232,-1.869097951893479,0,-1.3486585265293993,2,2,3,3,3,2,4,2,2,3,1,2,2,4,5,2,5,1,4,3,1.3201731488169053,2.6,0,4.2,0,3.8,0,4,0,4,0,2,1,1,3,2,2,2,2,1,3,2,4,2,1,2,4,2,2,2,1,0.8870412083230169,1.75,0,"White, Caucasian, Anglo, European American",0,29,1,2,NA,1,3,7,Teacher,5,0,155,63,3,5,2,0,0,1,0,0,TRUE,TRUE,TRUE,TRUE,TRUE,1,0.9518543478302334,0.92,0.016351335685178818,1,0.4511933332125346,0.5524129032627229,0.9375,1,0.0022516503220970396,0.003915803825280631,1,0.5787593750059604,0.7037499999701977,1,1,0.004875701847163053,0.003494584518905762,1.3887,2.0299,0.6733,0.6149,3.0987,0.895,0.2812,1.3659095233333334,1.5059587846,0.6633145384666667,1.5231,3.8554,0.2746,4.4238,0.3803,-65.4942,0.6136,5.9534,0.4023,4.5013,0.5017,0.9557,1.5688292746666668,4.342116771,3.9845552943333336,0.3743530095,0.27144437773333335,0.9633,4.2348,0.4729,5.7973,0.617,0.9984,0.151,0.363,0.731,0.011,1.584,144.00000000000003,1.9304919765,5.172574398666667,5.770498058333334,0.3977073108333333,0.5466638847333334,437,1.2948148148148149,1,0,0,1,FALSE,FALSE,FALSE
16,2021-11-12T21:58:52Z,2021-11-12T22:23:46Z,1493,1,2021-11-12T22:23:52Z,0.8999999761581421,Chrome,95.0.4638.69,Windows NT 10.0,1360,768,None,1.7708333333333333,720,53,333,90,66,95,-0.17779831873632074,-0.33435822983726743,-0.454967601109981,-0.17769429344704088,-0.08211484083915795,-0.1752749501546655,2,2,3,3,2,2,1,2,1,2,2,3,3,3,2,3,1,2,2,2,0.6708203932499369,0,1,1,4,4,2.55,0,4,4,2,4,3,1,4,2,3,1,2,4,2,4,3,1,1,1,1,1,1,1,1,2,4,0,0,4,4,5,3,2,4,4,5,4,3,4,1,1,4,4,1,1,1,1,1,2,5,1,1,1,1,1,1,2,1,1,4,1,2,1,1,1,1,1,2,1,1.502750231494994,1.1254628677422756,1,0,1.25,0,2.066666666666667,0,2.111111111111111,0,2,0,0.8333333333333334,0,1.2857142857142858,0,1,0,1.6756756756756757,0,1,0,0,-0.9796985260456136,-0.8196040990257993,-0.4557470907642554,-0.6376755948950273,2,3,1,3,1,4,3,5,1,1.1338934190276817,3.2857142857142856,0,3,1.202331747984437,3,3,4,3,1,1,3,1,6,3,3,1.1338934190276817,2.5714285714285716,0,3.4285714285714284,5.5,3.8333333333333335,3.2559414990859232,0.6723373927674386,0,0.8781111148583004,2,3,3,2,3,3,4,2,3,2,4,3,3,4,3,4,3,1,4,3,0.8837151016885368,2.6,0,3.2,0,3,0,3.4,0,3.2,0,2,2,3,2,3,3,3,2,2,1,2,2,3,3,2,2,1,1,1,2,0.7181848464596079,2.3,0,"Hispanic of Latino (e.g., Mexican American, Central American, and others)",0,26,0,1,NA,1,2,4,Part time employed and student,2,0,168,70,4,5,2,0,0,1,0,0,TRUE,TRUE,TRUE,TRUE,TRUE,6,0.7918545454545793,0.8979591836734694,0.07293664807853319,6,0.5004677419358444,0.5766033333331346,0.96875,0.9375,0.010441729032231615,0.008766817247975399,6,0.6216586206890643,0.6261599999999007,0.9354838709677419,0.9375,0.01728918262363172,0.007168919314474632,1.4399,1.6201,0.4391,1.3961,2.2032,0.4615,0.1222,1.42531103,1.3297590968666666,0.4327328073,0.9605,3.8327,0.3833,2.8924,0.4277,-68.7786,1.082,5.8115,0.3945,5.5441,0.465,0.8642,1.0879182298,3.1467102086666667,4.121965151333334,0.4166865519333333,0.3742084011,0.853,2.6042,0.4905,3.9717,0.5251,0.9078,0.057,0.428,0.303,0.018,1.405,78.05555555555556,1.3588857616333334,2.76863204,2.90420391,0.38807504443333335,0.41834949543333333,104,0.3081481481481481,1,0,0,1,FALSE,FALSE,FALSE
17,2021-11-12T22:07:46Z,2021-11-12T22:32:17Z,1470,1,2021-11-12T22:32:18Z,0.4000000059604645,Safari,13.0.5,Macintosh,1280,800,no,1.6,633,142,363,144,52,93,-0.4013332492642393,0.47418348003595395,-0.3105404270817614,0.48037165939131105,-0.2754836757549857,-0.20905768367637165,3,3,2,1,3,2,3,4,3,3,3,2,2,3,3,2,2,1,2,3,0.7608859102526822,0,1,2,4,4,2.1,0,4,4,2,4,2,1,3,3,2,1,2,4,3,2,4,4,3,5,1,1,2,2,2,0,1,0,1,5,4,4,5,5,4,4,5,5,2,3,1,1,4,3,4,5,3,3,2,2,1,2,5,1,5,2,1,1,1,1,5,2,3,1,3,2,3,2,1,1,1.536346432403955,1.0997835284835873,2.5,0,1.75,0,2.2,0,1.4444444444444444,0,2.4166666666666665,0,3.1666666666666665,0,1.2857142857142858,0,2,0,2.108108108108108,0,0,0,1,0.22229081610621654,0.06815582050682095,-0.32558751222710886,-0.12871584586014395,5,1,5,1,1,2,1,1,2,1.889822365046136,1.1428571428571428,0,1.5,-0.6331575415043005,4,3,4,4,4,3,2,1,3,4,3,0.7867957924694432,3.7142857142857144,0,2.2857142857142856,7,3.8333333333333335,3.2559414990859232,1.5194825076544112,0,0.6643156929302927,3,2,2,3,3,4,5,4,3,3,1,4,4,4,3,2,5,1,4,5,1.3020130933435712,2.6,0,4.2,0,3.6,0,2.6,0,3.466666666666667,0,3,2,1,2,3,1,2,3,2,3,2,3,2,2,1,2,1,1,1,2,0.7591546545162482,1.95,0,"Hispanic of Latino (e.g., Mexican American, Central American, and others) & White, Caucasian, Anglo, European American",1,21,0,1,NA,0,3,4,student,3,0,119.05,67,3,5,2,0,0,2,0,0,TRUE,TRUE,TRUE,TRUE,TRUE,4,0.8236190476190379,0.84,0.050091154693875005,4,0.40571875,0.4669333333333333,1,0.967741935483871,0.0013853054435491604,0.006540703225807003,4,0.6704062500000013,0.7580666666666701,1,0.9375,0.010106700604839033,0.016929661290322546,1.3998,1.3136,0.4848,1.0047,1.8901,0.6313,0.2325,1.4171727596666666,1.1635584524,0.4771533035,1.2845,5.838,0.2957,3.9241,0.3105,-85.7524,0.8128,7.4949,0.3573,3.8441,0.3734,0.8983,1.2869485166333334,3.908943244,5.504727215333333,0.3100444754666667,0.29259838413333333,1.1276,3.4761,0.5166,2.5737,0.5723,0.9745,0.07,0.497,0.386,0.017,1.813,106.6470588235294,1.6930241513333333,4.210642059666666,2.5790102973333333,0.4698316986,0.4517876783,418,1.2385185185185186,1,0,0,1,FALSE,FALSE,FALSE
19,2021-11-12T22:02:26Z,2021-11-12T22:40:35Z,2288,1,2021-11-12T22:40:36Z,1,Chrome,95.0.4638.69,Windows NT 10.0,1280,720,N/A,1.7777777777777777,1371,40,435,142,113,82,1.4948596096967248,-0.45245982790863687,0.03608479058596582,0.4559988463232239,0.5670519620925495,-0.39486271804575546,2,2,3,3,2,2,2,2,2,2,2,2,2,2,2,2,2,2,2,2,0.30779350562554625,0,1,1,3,3,2.6,0,4,5,4,5,4,1,4,2,2,2,1,4,3,5,4,2,2,1,2,2,2,2,2,1,2,1,1,4,5,4,4,4,4,4,4,4,1,5,3,1,4,4,3,2,3,3,4,4,3,3,1,1,1,1,1,2,1,1,4,2,2,1,1,1,2,2,1,1,1.3917388177876397,1.3972762620115438,1.875,0,1.5,0,2,0,1.8888888888888888,0,2.5833333333333335,0,1.5,0,1.4285714285714286,0,1,0,1.945945945945946,0,1,1,1,-0.2673307166234623,-0.35607572411937555,0.005736966445190152,-0.1751693788370927,4,2,3,1,1,1,2,1,1,1.1547005383792515,1.7142857142857142,0,1,-0.4757826382709144,4,4,4,4,2,3,2,1,8,3,3,0.9511897312113419,3.5714285714285716,0,2.4285714285714284,4.5,3.8333333333333335,3.2559414990859232,0.10757398284279028,0,0.038032427945918976,2,4,3,3,3,2,4,2,2,4,1,5,2,2,3,2,4,2,5,4,1.2798809468443688,3,0,4.4,0,4.2,0,3,0,3.8666666666666667,0,2,2,3,1,3,2,2,1,1,1,3,3,3,3,2,3,1,3,3,3,0.8506963092234007,2.45,0,"Asian or Asian American (e.g., Chinese, Japanese, and others)",0,21,1,2,NA,0,3,3,Student,2,0,104,63,1,5,2,1,0,1,0,1,TRUE,TRUE,TRUE,TRUE,TRUE,5,1.0950250000001862,0.8163265306122449,0.24057081266145336,5,0.4422857142859804,0.5767035714286779,0.9333333333333333,0.9655172413793104,0.020525805471291198,0.054881940049376333,5,0.546512499999837,0.6515218749999767,1,1,0.0068864514516115615,0.011847543054418225,1.9876,0.8302,0.3872,1.4828,0.7166,0.6353,0.1875,1.8481301883333334,0.8094496753,0.3937291681,1.0708,3.1339,0.3278,2.189,0.3433,-39.0535,0.9303,4.3556,0.3427,3.4232,0.4021,0.9901,1.1632896875666667,2.4521247473,3.425414994,0.3355721401333333,0.31989534976666667,1.0188,4.8132,0.4398,3.3851,0.5118,0.9047,0.118,0.333,0.549,0.013,1.544,118.76923076923077,2.04519669,5.058010682,3.957192371666667,0.3489730555666667,0.3972813994,368,1.0903703703703704,1,0,3,4,FALSE,FALSE,FALSE
20,2021-11-12T22:09:08Z,2021-11-12T22:41:14Z,1926,1,2021-11-12T22:41:16Z,1,Chrome,95.0.4638.69,Windows NT 10.0,1536,864,NA,1.7777777777777777,763,103,500,119,131,142,-0.06731553698114262,0.1198786858218457,0.3490103343137751,0.17571149604022218,0.8156690355557566,0.618619287605429,2,3,1,1,2,1,1,2,1,3,2,1,1,2,2,3,1,1,2,2,0.7326950970650465,0,1,4,3,3,1.9,0,5,4,3,4,5,2,3,2,2,2,2,4,2,4,4,2,2,1,2,1,1,1,1,3,2,0,0,4,5,5,4,4,5,3,5,5,3,4,1,2,5,2,3,4,1,1,1,1,5,1,1,1,3,1,1,2,1,1,5,2,2,1,2,1,2,1,1,1,1.619605854250695,1.1464230084422218,1.375,0,1.25,0,2.2666666666666666,0,1.5555555555555556,0,1.8333333333333333,0,1.1666666666666667,0,1.2857142857142858,0,1.3333333333333333,0,1.5675675675675675,0,2,0,0,-0.8136895085106579,-0.6189579680629647,-0.25265461696773905,-0.43580629251535186,3,4,3,2,3,3,2,1,1,0.6900655593423543,2.857142857142857,0,1,0.20795484297024003,4,5,5,3,3,3,2,6,1,2,3,1.1338934190276817,3.857142857142857,0,2.142857142857143,5.5,3.8333333333333335,3.2559414990859232,0.6723373927674386,0,0.16107213806536974,1,2,2,1,1,2,4,2,2,3,1,4,3,4,4,2,4,2,3,3,0.990430401872025,1.4,0,4.2,0,3.4,0,3.8,0,3.8,0,2,1,1,3,1,1,2,2,2,1,1,3,1,1,1,3,1,1,1,2,0.7591546545162482,1.45,0,"Hispanic of Latino (e.g., Mexican American, Central American, and others)",0,22,1,2,NA,1,3,7,Engineer,3,0,115,63,1,5,2,1,1,0,0,2,TRUE,TRUE,TRUE,TRUE,TRUE,3,0.9916636363737511,0.673469387755102,0.05409282938603563,3,0.5515612903218116,0.62767666665713,1,1,0.012858842452420286,0.007681085985795044,3,0.608018750000745,0.6681312499940395,1,1,0.017231462857402804,0.016045314477288568,1.4585,0.5385,0.5524,0.9642,0.4736,0.8028,0.4451,1.489888395,0.65706362033,0.5429833489666667,2.2189,4.8548,0.323,5.129,0.4114,-65.0592,0.9636,4.6404,0.4365,4.5499,0.5245,0.9481,1.9568639083333332,4.496177681,4.507465592333333,0.4134337762,0.33393049886666665,1.03,3.6458,0.479,2.4983,0.5246,0.9783,0.131,0.271,0.388,0.017,1.509,88.76470588235293,2.3750824953333334,3.942739749,3.5821898963333334,0.3061237525666667,0.3388133935,330,0.9777777777777777,1,0,0,1,FALSE,FALSE,FALSE
21,2021-11-12T22:19:45Z,2021-11-12T22:47:30Z,1664,1,2021-11-12T22:47:31Z,0.8999999761581421,Chrome,95.0.4638.69,Windows NT 10.0,1366,768,no,1.7786458333333333,755,97,434,104,78,111,-0.08787047312164088,0.06537025594275213,0.03127055145169184,-0.007084601970431121,0.08362987480298012,0.0949869180189837,3,3,2,2,3,1,2,3,1,4,3,4,4,1,3,4,4,2,3,3,1.019545822516343,0,1,1,4,2,2.05,0,3,3,5,1,5,5,2,5,3,5,4,2,2,1,1,5,5,2,1,5,5,5,5,1,4,0,0,5,1,1,1,2,5,1,2,3,1,1,5,2,2,3,4,5,5,5,5,4,2,1,5,1,3,1,1,1,1,1,1,5,5,2,5,3,2,1,1,1,1.710241189108988,1.5976172734359604,4.125,0,1.25,0,4.2,0,3.6666666666666665,0,3.8333333333333335,0,2.3333333333333335,0,2.5714285714285716,0,3.3333333333333335,0,3.324324324324324,0,1,0,0,1.9895513698644145,2.1486616502444646,-0.4557470907642554,0.8464572797401047,5,1,5,1,1,2,4,1,1,1.889822365046136,1.5714285714285714,0,1,-0.5612498234260587,3,3,3,3,1,1,5,4,6,3,1,1.3801311186847085,2.142857142857143,0,3.857142857142857,4,3.8333333333333335,3.2559414990859232,-0.1748077221195339,0,0.6935515496791245,2,3,3,3,3,1,5,1,1,1,1,5,2,4,5,3,5,3,4,4,1.6903085094570331,2.8,0,4.6,0,3.4,0,4.2,0,4.066666666666666,0,3,4,4,2,3,4,4,3,2,2,3,2,1,4,2,2,4,4,1,4,1.0711528467275955,3,0,"White, Caucasian, Anglo, European American",0,26,1,2,NA,1,2,4,Caregiver,1,0,165,65,3,5,2,0,0,1,0,0,TRUE,TRUE,TRUE,TRUE,TRUE,5,1.1427500000012418,0.72,0.24515518605829242,5,0.4589624999994412,0.5209666666651765,1,0.9375,0.0020326069354378363,0.005592460877136473,5,0.6563312499998137,0.766737500000745,1,1,0.011822138347119836,0.017611547580263502,1.9952,0.4515,0.5583,1.3498000000000001,0.4959,0.7151,0.1831,1.7779799533333334,0.6134961469233333,0.4821627171,1.3961,6.2593,0.3474,3.0351,0.3142,-76.0975,0.7879,6.3617,0.3983,4.6098,0.4415,0.988,1.4181237293333333,3.1487055733333333,5.798762178333333,0.31298909766666666,0.3411888265333333,1.1538,4.983,0.5439,2.7445,0.5924,0.9651,0.169,0.34,0.536,0.011,1.419,129,2.8370579636666666,4.15037111,4.123431294,0.31514661516666664,0.4269359299666667,104,0.3081481481481481,1,1,0,1,FALSE,FALSE,FALSE
22,2021-11-12T22:29:16Z,2021-11-12T22:54:24Z,1508,1,2021-11-12T22:54:26Z,1,Chrome,95.0.4638.69,Windows NT 10.0,1536,864,NA,1.7777777777777777,753,81,394,100,63,72,-0.09300920715676544,-0.07998555706816408,-0.1612990139192677,-0.05583022810660534,-0.12355101974969247,-0.5637763856542862,2,1,2,1,1,4,4,1,3,2,3,3,1,1,1,1,3,2,3,2,1.050062654772261,0,1,1,4,4,2.85,0,3,4,2,4,4,2,1,2,2,2,1,4,2,4,4,2,3,1,1,1,2,2,3,6,2,0,0,4,4,4,3,2,4,3,4,3,4,4,2,1,3,2,4,1,1,3,4,2,4,1,1,1,4,4,1,3,3,1,5,1,2,1,2,1,3,1,2,1,1.2985323200391226,1.162919151265879,1.875,0,1.75,0,2.3333333333333335,0,2.5555555555555554,0,2.25,0,2,0,1.5714285714285714,0,1.3333333333333333,0,2.135135135135135,0,3,0,0,-0.1496534383708357,-0.13152240823236297,0.10724026226325957,-0.0121410729845517,4,2,3,1,1,2,1,1,3,1.1547005383792515,1.7142857142857142,0,2,-0.10679496349653231,4,3,3,3,2,2,3,7,7,3,2,0.6900655593423543,2.857142857142857,0,3.142857142857143,2,3.8333333333333335,3.2559414990859232,-1.3043345419688306,0,-0.2695668473527077,2,3,3,4,3,2,4,4,3,2,1,4,2,4,4,2,4,2,3,4,1.0690449676496976,3,0,4.2,0,3.4,0,3,0,3.533333333333333,0,1,3,3,3,3,4,3,3,1,2,4,3,4,4,2,3,3,3,1,2,0.9665456669582609,2.55,0,"Hispanic of Latino (e.g., Mexican American, Central American, and others) & White, Caucasian, Anglo, European American",1,27,1,2,NA,1,3,8,Lawyer,5,0,215,67,1,5,2,0,1,1,0,1,TRUE,TRUE,TRUE,TRUE,TRUE,3,1.0055894736843674,0.7916666666666666,0.04085619283241332,3,0.46871875,0.5428906249997671,1,1,0.004450998991880109,0.0038870002317387873,3,0.6698687499994412,0.7561312499991618,1,1,0.006790331249905847,0.004374800927467103,1.3402,1.0797,0.6616,1.0989,1.1212,0.7565,0.047,1.3905466313333332,1.0221949506333334,0.6491941465666666,2.8381,7.1611,0.2706,7.1381,0.3441,-91.3813,0.8492,5.8153,0.3918,5.5857,0.4673,0.9511,1.7960481363333334,5.271145700333333,5.430111160333333,0.3787635941,0.3067830532,0.8754,4.6208,0.5899,4.5618,0.6691,0.9703,0.19,0.38,0.648,0.014,1.447,103.35714285714286,2.8145161863333334,4.747503852,5.659077151666667,0.3767012912666667,0.5167791941,392,1.1614814814814816,1,0,0,1,FALSE,FALSE,FALSE
23,2021-11-12T22:27:46Z,2021-11-12T22:55:17Z,1650,1,2021-11-12T22:55:18Z,1,Chrome,95.0.4638.69,Windows NT 10.0,1536,864,N/A,1.7777777777777777,670,92,505,120,82,119,-0.30626666961443483,0.01994656437684081,0.37308152998514504,0.18789790257426575,0.1388781133503595,0.2301178521058083,3,3,2,2,2,1,1,3,1,3,3,1,2,2,3,3,1,1,2,2,0.8255779474818965,0,1,4,3,3,1.85,0,5,5,2,5,2,1,5,2,1,2,1,4,1,5,4,1,2,1,1,1,1,1,1,0,2,0,0,4,5,3,5,5,5,3,5,4,1,5,1,2,3,2,3,2,1,1,2,2,4,1,1,1,2,1,1,1,1,1,5,1,2,1,1,1,2,1,2,2,1.5716138106958624,1.7320508075688772,1.125,0,1.75,0,1.4,0,1.6666666666666667,0,1.75,0,1.1666666666666667,0,1,0,1,0,1.4864864864864864,0,0,0,0,-1.0196247454527547,-1.1336883706005216,-0.5020371591262895,-0.8178627648634056,3,2,3,1,1,2,2,1,1,0.816496580927726,2,0,1,-0.3048482679606258,5,5,5,4,3,3,1,3,3,2,2,1.4960264830861913,4.285714285714286,0,1.7142857142857142,6,3.8333333333333335,3.2559414990859232,0.9547190977297628,0,0.06324999828222155,2,2,2,3,2,2,3,2,2,1,1,4,3,3,5,2,5,2,3,3,1.2227992865708155,2.2,0,4.4,0,2.8,0,3.8,0,3.6666666666666665,0,1,1,1,3,3,1,1,2,1,1,1,3,1,2,1,3,1,2,1,2,0.8207826816681233,1.5,0,"Asian or Asian American (e.g., Chinese, Japanese, and others)",0,20,0,1,NA,1,2,3,full time student,1,0,133,68,2,5,2,0,0,1,0,0,TRUE,TRUE,TRUE,TRUE,TRUE,4,0.8770547619047742,0.8571428571428571,0.25828227500001,4,0.47334193548386644,0.5223062500000014,1,1,0.0043476191827964365,0.0026575025403204875,4,0.5698718749999753,0.6431812500000087,1,1,0.011832676925406781,0.01860986415322154,1.6873,1.1125,0.361,1.2901,1.6094,0.4675,0.1425,1.6355462143333332,1.0312997100666668,0.3606332891333333,1.98,6.2353,0.3146,7.2168,0.3851,-97.5608,0.9244,4.8654,0.3799,6.3665,0.4479,0.973,1.5585846312666667,5.681095809,5.255442062666667,0.3926486998666667,0.32799235513333336,0.869,3.5149,0.4702,3.5004,0.5321,0.973,0.241,0.143,0.563,0.023,1.745,75.86956521739131,2.468843033,4.2269883293333335,3.5624639393333335,0.27854462403333335,0.298519721,386,1.1437037037037037,1,0,0,1,FALSE,FALSE,FALSE
24,2021-11-12T22:39:01Z,2021-11-12T23:03:05Z,1443,1,2021-11-12T23:03:08Z,1,Chrome,95.0.4638.69,Macintosh,1440,900,NA,1.6,716,68,369,88,52,98,-0.1880757868065699,-0.1980871551395335,-0.28165499227611746,-0.202067106515128,-0.2754836757549857,-0.12460084987210628,2,2,1,1,2,1,2,1,1,3,1,2,2,2,2,2,2,1,2,2,0.5712405705774795,0,1,1,3,3,2.3,0,1,4,2,4,3,3,4,3,2,3,3,4,2,3,3,2,5,5,2,2,2,4,2,1,3,2,6,3,4,4,4,4,4,4,4,4,1,5,2,1,4,2,5,3,3,2,2,2,1,4,5,5,5,1,1,2,2,2,4,2,3,1,1,1,2,2,2,2,1.4099602788688723,0.8837151016885368,3,0,2,0,2.6666666666666665,0,2.111111111111111,0,1.8333333333333333,0,4,0,1.8571428571428572,0,1,0,2.2432432432432434,0,1,2,6,0.6173502502400353,0.5416535883168487,1.2514208139685998,0.8965372011427243,4,2,3,2,2,2,2,8,5,0.7867957924694432,2.142857142857143,0,6.5,1.8100511284536203,3,4,4,4,1,1,3,6,6,2,2,1.3451854182690985,2.857142857142857,0,3.142857142857143,3,3.8333333333333335,3.2559414990859232,-0.7395711320441822,0,0.012814857609616537,3,3,3,3,3,3,5,3,2,5,2,3,3,2,4,1,4,1,5,2,1.3627702877384937,3,0,3.8,0,4.6,0,3.4,0,3.933333333333333,0,2,3,3,3,3,4,3,1,3,3,4,2,3,3,2,2,3,3,3,3,0.6958523739384593,3,0,"Hispanic of Latino (e.g., Mexican American, Central American, and others)",0,20,1,3,NA,1,2,4,Teacher Assistant,1,0,160,62,3,5,2,0,0,1,0,0,TRUE,TRUE,TRUE,TRUE,TRUE,4,1.5061000000019558,0.6666666666666666,0.43405604040769585,4,0.5911406250018626,0.6670516129025529,1,0.96875,0.008561564425707708,0.011679715444033909,4,0.8263406249987892,1.0022516129021684,1,1,0.027641856683509092,0.01588851991351925,2.2482,0.333,0.3583,1.9247,0.3343,0.6276,0.5547,2.035172991,0.4096286704825333,0.3755262131666667,1.486,4.1433,0.4118,2.931,0.4343,-53.2203,1.0492,4.2395,0.4686,3.5994,0.5429,0.8224,1.7988905493333334,3.2178248926666666,4.432440664666666,0.4055958908,0.38699001763333335,1.2243,2.8338,0.6219,3.5723,0.8537,0.9278,0.264,0.336,0.552,0.004,1.084,271,3.613234527,4.047133411333333,3.6781307363333333,0.37901805693333335,0.5127453049333334,104,0.3081481481481481,1,0,0,1,FALSE,FALSE,FALSE
25,2021-11-12T22:39:18Z,2021-11-12T23:08:47Z,1769,1,2021-11-12T23:08:48Z,1,Chrome,95.0.4638.69,Windows NT 10.0,1280,720,NA,1.7777777777777777,789,99,491,83,101,89,-5.119945245232906e-4,0.08353973256911665,0.3056821821053092,-0.26299913918534573,0.40130724645041144,-0.27662315071978394,3,3,2,3,3,3,4,2,1,3,3,2,1,3,3,4,3,1,2,4,0.9333020044867296,1,1,1,3,2,2.15,0,5,4,2,4,4,1,2,1,3,3,1,4,2,5,4,1,2,1,1,1,1,1,2,1,2,0,0,3,5,4,1,3,2,1,4,4,3,4,1,1,4,1,4,5,1,3,4,4,3,1,1,1,3,1,1,3,3,1,5,1,1,1,1,1,4,4,2,3,1.4632638658632766,1.4142135623730951,1.25,0,3.25,0,2.066666666666667,0,3,0,2.4166666666666665,0,1.5,0,1.4285714285714286,0,1,0,2.1621621621621623,0,1,0,0,-0.5215976928478879,-0.5031000718919498,0.1714625309736735,-0.16581877045913818,5,1,3,1,1,1,1,1,2,1.5735915849388864,1.2857142857142858,0,1.5,-0.5476903563491562,5,5,5,3,3,2,1,8,6,NA,3,1.618347187425374,4,0,2,2,3.8333333333333335,3.2559414990859232,-1.3043345419688306,0,-0.9069348267242017,1,2,2,4,2,1,3,1,2,1,2,3,3,4,3,4,1,1,4,2,1.1751393027860062,2.2,0,3.6,0,2.6,0,4,0,3.4,0,1,3,1,1,1,2,1,3,3,2,1,4,3,2,1,3,2,2,2,1,0.9445132413883326,1.85,0,Middle Eastern,0,20,1,2,NA,1,3,3,student,3,0,125,62,3,5,2,0,0,1,0,0,TRUE,TRUE,TRUE,TRUE,TRUE,3,1.6458677419354357,0.6326530612244898,0.4137756466670948,NA,NA,NA,NA,NA,NA,NA,NA,NA,NA,NA,NA,NA,NA,2.3779,0.2444,0.4333,2.0769,0.155,0.7467,0.6156,2.128262506,0.3248373958981333,0.45100546873333336,NA,NA,NA,NA,NA,NA,NA,NA,NA,NA,NA,NA,NA,NA,NA,NA,NA,NA,NA,NA,NA,NA,NA,NA,NA,NA,NA,NA,NA,NA,NA,NA,NA,NA,104,0.3081481481481481,1,0,0,1,FALSE,FALSE,FALSE
26,2021-11-12T22:38:41Z,2021-11-12T23:13:35Z,2093,1,2021-11-12T23:13:36Z,1,Chrome,92.0.4515.159,Windows NT 10.0,1366,768,"You didn't ask about if we had 1 parent or not growing up. I have only ever had a mother, never a father in the picture. I tried to convey this in answers, but it was all clicking buttons. I may have answered the divorce question wrong, but they were never married so I didn't think of it initially. If you ever do this study again, I suggest setting up the answers first asking if the participant has a single parent household or not, which parent it is, and then continuing from there, so the data can include whether or not its 2 parent, single father, or single mother. These environmental factors play into whether or not for instance someone would get in a fight or not, even if they lived in a more dangerous or more safe neighborhood. The format of the ""'at least one parent"" sort of includes this but negligence from 2 whole parents vs 1 parent/1 not negligent vs only 1 parent vs only 1 negligent parent are differnt dynamics.",1.7786458333333333,690,100,659,88,147,100,-0.2548793292631892,0.09262447088229891,1.1144743566633393,-0.202067106515128,1.036661989745274,-0.09081811635040013,2,2,3,3,1,2,3,1,1,2,2,3,4,4,1,1,4,2,1,1,1.0894228312566052,0,1,1,3,2,3.25,0,2,2,5,2,5,3,1,5,4,3,4,2,3,2,1,3,3,1,2,2,4,5,3,5,2,0,0,4,5,1,4,5,5,5,5,4,3,4,3,1,1,3,5,5,3,3,5,5,1,2,5,1,5,3,1,3,1,2,2,5,4,1,2,1,2,2,2,1,1.5957902576925787,1.3870146083619754,2.875,0,1.75,0,4.133333333333334,0,1.7777777777777777,0,3.25,0,3.3333333333333335,0,2.7142857142857144,0,1.3333333333333333,0,2.7027027027027026,0,3,0,0,0.8253868671509286,1.3156849965704867,0.10724026226325957,0.7114626294168731,3,3,2,3,3,5,2,1,1,1,3.2857142857142856,0,1,0.4643563984356728,4,4,2,2,1,1,5,6,1,1,1,1.6035674514745464,2.142857142857143,0,3.857142857142857,5.5,3.8333333333333335,3.2559414990859232,0.6723373927674386,0,1.1171241071226108,3,2,3,3,2,1,5,2,1,4,1,5,1,5,5,1,5,1,5,2,1.9073791542572855,2.6,0,5,0,4.8,0,4.6,0,4.8,0,2,1,4,2,3,4,4,2,4,2,4,2,3,4,2,2,1,4,4,4,1.1192102478745307,3.1,0,"White, Caucasian, Anglo, European American",0,22,1,2,NA,1,1,5,student,1,0,200,64,2,5,2,0,0,0,0,0,TRUE,TRUE,TRUE,TRUE,TRUE,5,1.0152051282052237,0.78,0.22102502866935056,5,0.5971156249998603,0.6701093750001164,1,1,0.010192976844729376,0.014367682167323486,5,0.6564875000002212,0.7219812500000699,1,1,0.018941939838805093,0.014262549314493351,1.6257,0.7875,0.4517,1.3177,0.9978,0.5902,0.3763,1.6077848353333333,0.8127108587666667,0.4486670809,1.5575,3.7298,0.3883,3.9964,0.4752,-60.1127,1.3932,5.0524,0.4549,3.5551,0.474,0.9768,1.994992906,4.176753957333333,4.199679116333333,0.43301447033333335,0.35736221,1.211,4.0162,0.5062,3.7204,0.5857,0.8781,0.228,0.246,0.561,0.018,1.519,84.38888888888889,2.7481351933333333,4.047935523666666,3.7645417313333334,0.3168893342333333,0.35971988046666664,365,1.0814814814814815,1,0,0,1,FALSE,FALSE,FALSE
27,2021-11-12T22:43:50Z,2021-11-12T23:13:49Z,1798,1,2021-11-12T23:13:51Z,1,Chrome,95.0.4638.69,Windows NT 10.0,1536,864,NA,1.7777777777777777,861,89,458,77,68,131,0.184482430739961,-0.0073076505627059805,0.14681229067426757,-0.3361175783896071,-0.054490721565468275,0.43281425323604517,2,2,2,3,2,2,2,2,1,2,2,2,3,3,2,2,2,1,2,2,0.5104177855340404,0,1,2,5,4,2.55,0,2,3,4,3,5,3,3,3,2,3,3,3,2,3,2,1,3,1,1,2,2,3,2,2,2,0,0,5,4,3,4,5,5,3,3,4,3,4,2,2,3,2,5,4,3,3,4,4,3,1,1,1,2,1,2,2,3,2,3,3,3,1,1,1,2,1,2,2,1.2586040219561052,0.7988086367179802,1.875,0,1.75,0,3.2,0,2,0,2.75,0,1.3333333333333333,0,2.4285714285714284,0,1,0,2.189189189189189,0,1,0,0,-0.11603135887008498,0.2641560207961311,-0.2989446853297732,-0.01739433226682105,4,1,3,1,1,2,2,1,1,1.1547005383792515,1.7142857142857142,0,1,-0.4757826382709144,5,4,5,4,3,1,2,6,6,4,3,1.5118578920369088,3.7142857142857144,0,2.2857142857142856,3,3.8333333333333335,3.2559414990859232,-0.7395711320441822,0,-0.465211126919004,4,3,3,4,4,3,5,3,3,3,3,3,5,2,4,3,3,2,3,3,0.8618916073713346,3.6,0,3.2,0,3,0,3,0,3.066666666666667,0,2,4,4,3,4,3,4,1,1,1,3,2,2,3,1,3,3,3,2,4,1.0894228312566052,2.75,0,"White, Caucasian, Anglo, European American",0,18,1,2,NA,1,3,4,student,5,0,165,63,3,5,2,0,0,1,0,0,TRUE,TRUE,TRUE,TRUE,TRUE,1,0.8565363636369054,0.66,0.08779950628873678,1,0.42161562500102445,0.4971866666674614,1,0.9375,0.002205771038216012,0.006072185876910743,1,0.6324281249986962,0.8615032258072207,1,0.96875,0.017245356280493392,0.036395634152822834,1.4818,0.4723,0.3723,1.0814,0.5057,0.5759,0.4117,1.494397423,0.6050344143793334,0.36859135633333334,1.3822,5.3412,0.2922,3.2562,0.3131,-72.5264,0.6733,6.5006,0.374,4.0644,0.4251,0.9735,1.41077537,3.3625965526666666,5.202300336666666,0.3115712664333333,0.28842825246666665,1.395,4.2868,0.4688,2.3166,0.5874,0.9807,0.108,0.385,0.429,0.005,1.364,272.8,2.176864463,3.8547528103333333,2.6951519536666666,0.3485482119,0.4706833347666667,382,1.1318518518518519,1,0,0,1,FALSE,FALSE,FALSE
28,2021-11-12T22:54:46Z,2021-11-12T23:19:32Z,1486,1,2021-11-12T23:19:33Z,1,Chrome,94.0.4606.114,CrOS x86_64 14150.74.0,1536,864,This was a fun study!,1.7777777777777777,667,66,418,86,57,126,-0.3139747706671217,-0.21625663176589804,-0.04575727469669198,-0.2264399195832151,-0.2064233775707615,0.3483574194317798,4,4,1,1,4,1,1,4,1,4,4,1,1,1,4,4,1,1,4,4,1.538967528127731,0,0,1,3,2,1,0,1,2,4,1,4,4,1,2,1,4,2,3,2,1,1,3,4,5,1,3,2,4,5,0,2,0,8,1,1,3,2,3,1,1,1,3,4,2,1,1,3,1,5,3,5,5,5,5,1,1,5,4,2,1,1,1,1,1,5,1,1,3,5,1,1,1,1,1,1.6421622017013717,1.2649110640673518,3.375,0,1,0,3.6666666666666665,0,4.222222222222222,0,3.1666666666666665,0,2.8333333333333335,0,0.8571428571428571,0,3,0,2.972972972972973,0,0,0,6,1.3045015000366231,1.4461582163186295,0.32145711411707156,0.8838076652178506,3,3,2,3,3,3,2,1,1,0.4879500364742666,3,0,1,0.2934220281253842,2,2,2,2,1,1,5,4,3,1,1,1.3451854182690985,1.5714285714285714,0,4.428571428571429,5.5,3.8333333333333335,3.2559414990859232,0.6723373927674386,0,1.435808096808358,4,4,4,4,4,2,4,3,1,4,1,4,1,3,4,5,4,2,2,4,1.3345232785352157,4,0,4.2,0,3.2,0,3.4,0,3.6,0,2,4,4,4,4,4,4,1,2,3,3,1,4,4,2,1,3,3,3,3,1.0990426455975697,3.25,0,"Black or African American & Hispanic of Latino (e.g., Mexican American, Central American, and others) & White, Caucasian, Anglo, European American",1,21,1,2,NA,1,3,4,Case Aid,1,0,106,62,1,5,2,0,0,1,0,0,TRUE,TRUE,TRUE,TRUE,TRUE,NA,NA,NA,NA,6,0.5425266666667226,0.5799481481482378,0.9375,0.8709677419354839,0.014538096088717579,0.008632234903221856,6,0.7395406249999069,0.750846666666648,1,0.967741935483871,0.022694410876999707,0.022931051569929493,NA,NA,NA,NA,NA,NA,NA,NA,NA,NA,1.1772,2.1826,0.2967,2.0986,0.3556,-25.354,0.9176,3.2793,0.4088,3.3707,0.4522,0.9548,1.2689473086666667,2.3486425017333334,2.5005686881333333,0.3477959110666667,0.2911805448,1.2848,2.9379,0.5389,3.568,0.5638,0.9948,0.071,0.52,0.374,0.035,1.77,50.57142857142857,2.263459447,3.4387696623333333,3.107582428,0.4055383491,0.39965916526666667,104,0.3081481481481481,1,1,1,2,FALSE,FALSE,FALSE
29,2021-11-12T22:16:03Z,2021-11-12T23:19:42Z,3818,1,2021-11-12T23:19:44Z,0.8999999761581421,Edge,95.0.1020.40,Windows NT 10.0,1366,768,-,1.7786458333333333,2298,62,525,632,81,91,3.87666283497696,-0.2525955850186271,0.4693663126706248,6.427338048004565,0.12506605371351465,-0.2428404171980778,4,2,4,3,2,2,4,2,1,3,1,4,3,4,2,3,3,3,2,2,0.9787209698591858,0,1,2,2,2,2.9,0,2,4,2,4,3,1,4,3,3,1,4,3,1,3,4,4,4,1,1,3,4,3,3,7,2,0,0,5,4,4,5,4,5,5,5,5,1,4,4,1,4,2,5,5,4,4,5,5,4,1,1,1,5,3,2,4,4,4,3,3,2,1,3,1,4,2,4,4,1.4831384627537982,1.1464230084422218,2.875,0,3.5,0,2.4,0,1.3333333333333333,0,3,0,2,0,3,0,1.6666666666666667,0,2.3783783783783785,0,4,0,0,0.623654390146426,0.4314095250430094,0.8591411550804637,0.6452753400617366,4,1,1,1,1,1,2,1,1,1.1338934190276817,1.8571428571428572,0,1,-0.39031545311577004,3,5,4,4,1,1,4,3,3,2,2,1.5735915849388864,2.857142857142857,0,3.142857142857143,6,3.8333333333333335,3.2559414990859232,0.9547190977297628,0,0.8599599724965891,3,3,3,2,3,2,4,5,2,2,1,4,1,4,5,2,4,1,4,3,1.4375905768565218,2.8,0,4.4,0,3.8,0,3.4,0,3.8666666666666667,0,3,3,3,1,4,4,2,2,3,3,3,2,3,3,4,2,3,3,3,4,0.7880689256524124,3.2,0,"Hispanic of Latino (e.g., Mexican American, Central American, and others) & White, Caucasian, Anglo, European American",1,23,1,2,NA,1,2,4,Caregiver,3,0,205,66,1,5,2,0,0,1,0,0,TRUE,TRUE,TRUE,TRUE,TRUE,NA,NA,NA,NA,3,0.4888931034484814,0.6664266666630904,0.9666666666666667,0.967741935483871,0.003378235172406928,0.018910169848988308,3,0.65516451612884,0.9473133333355188,1,0.967741935483871,0.006084081699383791,0.23955729724643765,NA,NA,NA,NA,NA,NA,NA,NA,NA,NA,1.4773,4.1214,0.3202,2.6803,0.4058,-46.6632,1.1059,5.075,0.3821,2.932,0.4866,0.9314,1.606776703,2.8665819066666667,4.316119561333333,0.3930983261666667,0.3118897871,1.4186,4.328,0.5051,2.0015,0.5297,0.7893,0.08,0.463,0.324,0.014,1.684,120.28571428571428,2.0325030226666665,4.734538801666667,1.9615264757,0.44317615973333335,0.43284961603333333,104,0.3081481481481481,1,0,0,1,FALSE,FALSE,FALSE
30,2021-11-12T22:44:26Z,2021-11-12T23:21:56Z,2249,1,2021-11-12T23:21:58Z,0.8999999761581421,Chrome,89.0.4389.114,Windows NT 6.3,1536,864,"During the Arrow Detection game, the frame in which the arrows appeared was a bit too small, requiring me to scroll left/right to find some arrows. Zooming out did not work. This is why there were some long pauses in my Arrow Detection game.",1.7777777777777777,899,80,587,102,76,186,0.2821183774073277,-0.08907029538134635,0.7678491389956121,-0.03145741503851823,0.05600575552929045,1.3618394250829642,2,2,2,2,2,1,3,2,1,2,1,1,1,2,2,2,2,1,2,2,0.5501196042201808,0,1,3,3,2,2.35,0,5,4,3,3,3,2,4,2,3,2,2,4,3,3,4,2,2,1,1,2,2,2,2,0,2,0,0,5,4,4,3,4,5,4,4,5,1,5,1,2,4,3,5,4,3,3,3,3,5,1,1,1,1,1,1,1,1,1,3,3,2,1,2,1,1,2,1,2,1.5211225505572565,0.9154754164341269,1.75,0,1.5,0,2.3333333333333335,0,1.7777777777777777,0,2.25,0,0.8333333333333334,0,1.5714285714285714,0,1.3333333333333333,0,1.7567567567567568,0,0,0,0,-0.46275905372157444,-0.34784855521834285,-0.5804383618435307,-0.46414345853093675,5,2,3,1,1,3,2,1,2,1.3972762620115438,1.8571428571428572,0,1.5,-0.20582161572857902,4,4,4,4,1,1,2,6,6,NA,3,1.4638501094227998,3.142857142857143,0,2.857142857142857,3,3.8333333333333335,3.2559414990859232,-0.7395711320441822,0,-0.14652713723325692,2,2,2,1,1,2,5,2,2,3,2,5,2,4,5,1,4,2,4,3,1.3345232785352157,1.6,0,4.2,0,4.2,0,4,0,4.133333333333334,0,2,1,3,1,3,3,2,2,3,2,4,3,2,1,1,2,1,2,2,3,0.8750939799154206,2.35,0,"White, Caucasian, Anglo, European American",0,29,1,3,NA,1,3,6,freelance online work (various),3,0,90,61,2,5,2,0,0,1,0,0,TRUE,TRUE,TRUE,TRUE,TRUE,3,0.7434126923109989,0.78,0.015627711677323703,NA,NA,NA,NA,NA,NA,NA,3,0.605275483869557,0.6260481249992154,0.96875,1,0.013686476220208469,0.005812443415646874,0.9661,1.3667,0.5495,0.909,1.1489,0.5661,0.006,1.0298857299,1.1541172736,0.5408432694,NA,NA,NA,NA,NA,NA,NA,NA,NA,NA,NA,NA,NA,NA,NA,NA,NA,1.2005,4.2506,0.4576,5.7373,0.5256,0.9658,0.069,0.415,0.335,0.049,1.743,35.57142857142857,1.7774123686666667,3.6084322246666667,4.139459083,0.3745946909333333,0.41601128816666666,376,1.114074074074074,1,1,6,7,TRUE,FALSE,FALSE
31,2021-11-12T23:07:24Z,2021-11-12T23:25:37Z,1093,1,2021-11-12T23:25:38Z,0.8999999761581421,Chrome,95.0.4638.69,Macintosh,1440,900,NA,1.6,574,51,257,59,48,67,-0.5529259033004139,-0.35252770646363196,-0.8208497753148042,-0.555472896002391,-0.3307319143023651,-0.6482332194585516,2,3,2,4,2,1,3,2,1,2,3,1,1,1,3,3,1,1,2,2,0.9176629354822471,0,1,1,3,2,2.1,0,4,3,2,4,2,2,4,2,3,2,3,3,2,4,2,2,3,1,1,2,3,2,1,0,2,0,0,4,2,1,3,3,4,3,4,4,2,5,1,1,3,3,4,3,2,2,4,4,4,2,1,1,1,1,1,1,1,1,4,2,4,1,3,1,2,1,1,1,1.3037253160461753,0.8618916073713346,1.875,0,1.25,0,2.4,0,2.888888888888889,0,2.3333333333333335,0,1.1666666666666667,0,1.5714285714285714,0,1.6666666666666667,0,2.135135135135135,0,0,0,0,-0.1496534383708357,-0.10287250241229595,-0.6588395645607719,-0.3808560334865339,4,2,3,1,2,2,2,3,1,0.9511897312113419,2,0,2,0.06413940681375631,5,5,5,5,3,2,3,6,2,5,3,1.2909944487358056,4,0,2,5,3.8333333333333335,3.2559414990859232,0.38995568780511447,0,-0.05978971183722909,3,2,2,5,2,2,3,2,2,4,1,5,3,4,4,3,4,1,2,4,1.2227992865708155,2.8,0,4.6,0,3,0,3.6,0,3.7333333333333334,0,2,2,3,2,3,3,3,1,2,2,3,2,4,2,1,2,2,3,1,3,0.8013147091860318,2.6,0,"White, Caucasian, Anglo, European American & Filipino",1,23,1,2,NA,1,3,6,CNA,2,0,105,64,1,5,2,0,0,0,0,0,TRUE,TRUE,TRUE,TRUE,TRUE,3,0.6859794871797547,0.78,0.02386811592235382,3,0.4522709677418874,0.49578965517313317,1,0.90625,0.007105520129125845,0.003944887086769305,3,0.6004093750005122,0.7348749999992017,1,0.875,0.007444306038311978,0.013341118991725107,1.2004,1.1332,0.3955,0.8889,1.2934,0.5169,0.2175,1.2499906581,1.0561016090666666,0.3885675326,1.1037,3.7868,0.3066,2.8899,0.3304,-61.9999,0.8492,4.4607,0.3528,5.1368,0.4101,0.8504,1.2101690815666666,3.136662534666667,4.073911648666667,0.32359442446666664,0.3006412441,1.0414,4.9275,0.489,2.1848,0.5608,0.915,0.071,0.445,0.454,0.007,1.369,195.57142857142856,1.4196408180333333,4.196382348,2.0991149203666666,0.43143452423333334,0.4495020718,104,0.3081481481481481,1,0,0,1,FALSE,FALSE,FALSE
32,2021-11-12T23:04:49Z,2021-11-12T23:26:28Z,1299,1,2021-11-12T23:26:29Z,1,Firefox,94.0,Macintosh,1440,900,NA,1.6,651,57,347,66,43,80,-0.3550846429481182,-0.2980192765845384,-0.38756825323014515,-0.47016805026408615,-0.39979221248658925,-0.4286454515674616,3,2,2,3,1,3,2,1,1,2,1,2,1,1,2,1,2,2,1,1,0.7326950970650465,0,1,2,5,4,2.7,0,1,1,2,1,2,5,1,5,3,5,5,1,1,1,1,2,5,1,1,4,5,4,4,0,2,0,0,1,1,4,1,1,3,2,2,1,1,5,5,3,2,2,5,5,5,5,5,5,1,1,1,1,3,1,1,1,4,3,1,5,4,3,4,5,2,1,3,3,1.6854794097943888,1.7593288763724921,3.25,0,2.25,0,4.2,0,4.222222222222222,0,3.5,0,1.8333333333333333,0,3.142857142857143,0,4,0,3.4324324324324325,0,0,0,0,1.512538116947517,1.8190909430913276,-0.34523475369180734,0.7369280946997601,2,5,2,5,5,5,5,5,4,1.4638501094227998,4.714285714285714,0,4.5,2.6104851116974532,2,2,3,3,1,1,5,4,3,2,1,1.3972762620115438,1.8571428571428572,0,4.142857142857143,5.5,3.8333333333333335,3.2559414990859232,0.6723373927674386,0,1.2764661019654844,1,1,2,2,1,1,1,2,1,3,3,4,4,5,5,4,4,5,4,3,1.4375905768565218,1.4,0,3.4,0,2.4,0,4.4,0,3.4,0,3,3,4,1,4,4,4,1,3,2,4,1,3,4,4,1,4,4,4,4,1.2096106376585989,3.7,0,"White, Caucasian, Anglo, European American",0,22,1,2,NA,1,2,3,Student,1,0,104,64,3,5,2,0,0,1,0,0,TRUE,TRUE,TRUE,TRUE,TRUE,1,0.8895833333333333,0.72,0.08669979591836734,1,0.50303125,0.5674516129032258,1,1,0.0018409989919354844,0.003644855913978494,1,0.641258064516129,0.6873333333333334,0.96875,0.9375,0.021554822580645158,0.014142887096774196,1.545,0.6579,0.3925,1.141,0.7515,0.5982,0.245,1.547795581,0.7316522225,0.3881790002666667,9.9976,14.1673,0.1502,11.0406,0.1147,-99.6639,0.7596,6.3007,0.4466,5.8432,0.5036,0.9176,1.8350433143333333,5.006879973,6.430700529666667,0.3897166473,0.3667956543,1.2591,4.4271,0.4772,4.4954,0.5456,0.8205,0.065,0.446,0.349,0.02,1.885,94.25,1.8410069476666666,2.7231432563333335,2.561192071333333,0.30997567526666664,0.3503577695,400,1.1851851851851851,1,0,0,1,FALSE,FALSE,FALSE
33,2021-11-12T23:08:17Z,2021-11-12T23:26:30Z,1092,1,2021-11-12T23:26:31Z,1,Chrome,95.0.4638.69,Windows NT 10.0,1920,1080,NA,1.7777777777777777,571,45,288,57,36,58,-0.5606340043531007,-0.40703613634272556,-0.6716083621523106,-0.5798457090704782,-0.49647662994450314,-0.8002555203062293,3,3,1,1,2,1,3,2,1,2,2,2,2,1,2,2,2,1,3,2,0.7181848464596079,0,0,2,4,3,2.1,0,2,4,3,3,4,4,3,4,4,2,2,2,4,3,1,5,5,5,4,5,5,5,4,7,2,4,0,2,1,2,2,2,4,2,2,2,3,2,4,5,2,3,4,4,5,5,5,5,1,5,5,1,5,4,1,5,3,3,3,4,2,5,5,4,4,4,3,2,1.4311002927985332,1,4.75,0,3.25,0,3.4,0,3.888888888888889,0,4.083333333333333,0,4,0,2.857142857142857,0,4.666666666666667,0,3.891891891891892,0,4,4,0,2.7313384988497216,2.3173670078268196,1.6072727827353175,1.9623198952810685,4,3,2,1,1,2,3,4,1,1.1126972805283737,2.2857142857142856,0,2.5,0.41956761451123586,2,2,2,2,1,1,5,4,2,1,1,1.3451854182690985,1.5714285714285714,0,4.428571428571429,6,3.8333333333333335,3.2559414990859232,0.9547190977297628,0,1.57699894928952,4,4,4,4,4,3,3,4,3,2,3,4,2,3,5,4,4,3,3,3,0.7988086367179802,4,0,3.4,0,2.8,0,3.2,0,3.1333333333333333,0,3,2,3,2,4,4,4,2,3,3,3,2,3,2,2,2,3,3,2,4,0.7677718959499145,3,0,"White, Caucasian, Anglo, European American",0,24,1,2,NA,1,2,4,Remote Clerk,3,0,210,60,3,5,2,0,0,0,0,0,TRUE,TRUE,TRUE,TRUE,TRUE,6,0.646543902439088,0.8367346938775511,0.020018925646219512,6,0.45315483870940104,0.47112499999976715,0.96875,1,0.0030073049092729986,0.002993490322596182,6,0.5437249999999767,0.586859375,1,1,0.004248900645133172,0.004076435393120124,1.0601,1.6079,0.4428,0.9425,1.5434,0.4666,0.1424,1.1668320954333333,1.2685439087666666,0.4088838083,1.149,4.5364,0.3324,5.1451,0.3595,-92.0296,0.8359,5.4025,0.377,6.0048,0.4046,0.8651,1.2397739956333333,4.980026603,4.650062223,0.3518816562666667,0.3261799674,0.8024,4.8112,0.4644,6.6493,0.5272,0.9742,0.126,0.363,0.732,0.014,1.085,77.5,2.0591273936666665,5.805062702333333,5.016049685666666,0.37323741476666666,0.38966610743333335,276,0.8177777777777777,1,1,0,1,FALSE,FALSE,FALSE
34,2021-11-12T23:09:09Z,2021-11-12T23:28:55Z,1186,1,2021-11-12T23:28:56Z,1,Chrome,93.0.4577.82,Macintosh,1440,900,N/A,1.6,670,51,227,56,41,89,-0.30626666961443483,-0.35252770646363196,-0.9652769493430238,-0.5920321156045217,-0.42741633176027893,-0.27662315071978394,2,3,3,3,2,1,3,2,1,2,2,2,2,2,2,2,2,2,2,2,0.5525062514530825,0,1,3,4,4,2.5,0,5,5,1,5,1,1,5,1,1,1,1,5,1,5,5,5,1,1,1,1,1,1,1,4,2,0,0,5,5,5,5,5,5,5,5,5,1,5,1,1,5,1,5,1,1,1,1,1,5,1,1,1,1,1,1,4,1,1,5,1,1,1,1,1,1,1,1,1,1.9643978361978662,2.065591117977289,1.5,0,1,0,1,0,1,0,1,0,0.8333333333333334,0,1.2857142857142858,0,1,0,1.0810810810810811,0,2,0,0,-1.0385371651719268,-1.3186544855402116,-0.33105581968498016,-0.8248551526125959,5,1,5,1,1,1,1,1,1,1.9518001458970664,1,0,1,-0.9031185640466358,5,5,5,5,5,5,1,4,4,6,4,1.5118578920369088,5,0,1,5,3.8333333333333335,3.2559414990859232,0.38995568780511447,0,-0.6174866937872863,1,3,1,3,1,1,5,3,1,4,1,3,3,5,4,1,4,3,5,3,1.486446705914413,1.8,0,4,0,4.4,0,4,0,4.133333333333334,0,1,1,1,4,3,2,2,4,1,1,1,4,1,2,1,4,1,2,2,2,1.1697953037312037,1.4,0,"White, Caucasian, Anglo, European American",0,23,1,2,NA,1,4,6,unemployed,4,0,130,65,3,5,2,0,0,1,0,0,TRUE,TRUE,TRUE,TRUE,TRUE,4,0.9663125000223517,0.64,0.1380754632886694,4,0.6313656249940396,0.683050000011921,1,1,0.007505101037733517,0.004980950320489636,4,0.818090624988079,0.9828125,1,1,0.02123556991022056,0.048311502414092704,1.414,0.4166,0.5477,1.3022,0.3021,0.5929,0.0803,1.4516594713333333,0.570429876887,0.5370657741333333,10,9.279,0.0925,9.4878,0.1561,-73.8739,0.7929,4.4276,0.5382,6.3477,0.6332,0.6503,2.474057337666667,4.518341452333333,5.126684414333333,0.4123622695333333,0.39211990863333335,0.9183,3.7988,0.7129,2.4731,0.8332,0.6437,0.326,0.257,0.587,0.007,1.371,195.85714285714286,3.3648967903333333,4.099690224,3.104749372,0.40710644456666667,0.4386219846666667,104,0.3081481481481481,1,0,0,1,FALSE,FALSE,FALSE
35,2021-11-12T23:07:21Z,2021-11-12T23:33:54Z,1592,1,2021-11-12T23:33:55Z,0.8999999761581421,Safari,14.1.2,Macintosh,1440,900,great survey!,1.6,891,67,307,67,53,80,0.26156344126682946,-0.20717189345271578,-0.5801378186011047,-0.45798164373004263,-0.2616716161181409,-0.4286454515674616,3,3,1,2,2,1,1,2,1,2,1,1,2,2,2,3,1,1,2,3,0.7677718959499145,0,1,2,3,3,2,0,4,5,3,4,2,2,3,2,2,2,2,4,3,3,3,1,2,1,1,1,2,2,1,0,2,2,2,4,4,3,3,4,5,4,4,3,2,4,2,1,3,2,4,1,1,2,2,3,4,2,1,1,1,1,1,1,1,1,5,2,2,1,1,1,1,1,1,1,1.3378302544754286,0.9611501047232549,1.375,0,1,0,2.2666666666666666,0,2.2222222222222223,0,1.9166666666666667,0,1.1666666666666667,0,1.1428571428571428,0,1,0,1.7027027027027026,0,0,2,2,-0.7296343097587817,-0.5608838346439097,0.028924941706396007,-0.2659794464687568,5,2,4,1,1,1,1,1,1,1.6761634196950514,1.2857142857142858,0,1,-0.7321841937363471,5,5,5,5,3,2,2,6,4,4,3,1.4638501094227998,4.142857142857143,0,1.8571428571428572,4,3.8333333333333335,3.2559414990859232,-0.1748077221195339,0,-0.42184241422098995,3,3,3,3,3,3,4,2,2,2,1,3,1,4,3,2,4,2,3,3,0.9856107606091623,3,0,3.8,0,3.6,0,3.6,0,3.6666666666666665,0,1,1,1,1,1,2,3,3,2,1,1,3,1,2,1,3,1,2,1,2,0.812727700887249,1.65,0,"White, Caucasian, Anglo, European American",0,24,1,2,NA,1,3,6,social service specialist,4,0,150,65,2,5,2,0,0,0,0,0,TRUE,TRUE,TRUE,TRUE,TRUE,6,0.6942499999999935,0.7346938775510204,0.023051395408162794,NA,NA,NA,NA,NA,NA,NA,6,0.7298125000000073,0.9487187499999873,1,1,0.028278608870965928,0.05329298286290684,1.1106,0.9749,0.4238,1.0546,1.0696,0.4597,0.2278,1.1709147908,0.9628097531833333,0.4161867755,NA,NA,NA,NA,NA,NA,NA,NA,NA,NA,NA,NA,NA,NA,NA,NA,NA,1.3312,2.8778,0.51,2.0003,0.6842,0.9988,0.192,0.271,0.406,0.009,1.79,198.88888888888891,2.8459089006666667,3.8963274576666667,2.7957570106666667,0.3629685921,0.43479997896666667,104,0.3081481481481481,1,1,0,1,FALSE,FALSE,FALSE
36,2021-11-12T23:11:33Z,2021-11-12T23:38:13Z,1599,1,2021-11-12T23:38:14Z,1,Chrome,94.0.4606.81,Windows NT 10.0,1600,900,NA,1.7777777777777777,820,72,412,66,65,92,0.07913838301990746,-0.16174820188680444,-0.07464270950233591,-0.47016805026408615,-0.09592690047600279,-0.2259490504372247,3,3,1,1,3,1,3,3,1,3,3,1,2,2,3,3,1,1,2,3,0.9333020044867296,0,1,4,2,3,1.75,0,4,4,2,4,1,2,4,2,1,1,1,4,1,4,4,1,1,1,1,1,1,1,1,2,2,0,0,5,3,4,4,3,4,4,4,4,2,5,4,1,4,1,2,1,1,1,1,1,5,1,1,1,1,1,1,1,1,1,5,1,1,1,1,1,2,1,2,1,1.5706581317928376,1.4040757000349275,1,0,1.5,0,1.6666666666666667,0,2.111111111111111,0,1.6666666666666667,0,0.8333333333333334,0,0.8571428571428571,0,1,0,1.4864864864864864,0,1,0,0,-1.0973758042982402,-1.072807320732879,-0.3773458880470143,-0.7250766043899466,3,3,2,3,1,2,1,1,1,0.8997354108424374,2.4285714285714284,0,1,-0.048446712495193056,5,5,5,3,2,2,2,3,4,2,1,1.5118578920369088,3.7142857142857144,0,2.2857142857142856,5.5,3.8333333333333335,3.2559414990859232,0.6723373927674386,0,0.24074313548680643,1,1,1,4,1,1,4,1,1,1,1,4,3,2,4,2,5,1,3,2,1.3972762620115438,1.6,0,4.8,0,3,0,4,0,3.933333333333333,0,1,1,2,3,3,2,2,2,1,2,3,3,2,3,1,3,2,3,1,1,0.8255779474818965,1.95,0,"White, Caucasian, Anglo, European American",0,20,1,2,NA,1,2,5,student,3,0,150,66,1,5,2,0,0,0,0,0,TRUE,TRUE,TRUE,TRUE,TRUE,1,0.8493604651051898,0.86,0.03093137900661594,1,0.5197903225806452,0.5434064516405905,1,1,0.0027705922350472474,0.005921758621036756,1,0.6670750000476837,0.7022812499552965,1,1,0.019004117400558847,0.008531419632610315,1.3947,1.4183,0.4807,0.935,1.8931,0.6853,0.2775,1.4084825543333332,1.2220847594,0.4728004831666667,2.924,8.1853,0.3412,6.3728,0.314,-88.3561,0.6796,6.9419,0.4702,5.3854,0.4873,0.7493,1.7397296769666666,4.688300444,5.935912825666667,0.3623737073,0.3785203918,1.1515,2.9465,0.5057,4.6154,0.5916,0.9397,0.289,0.197,0.629,0.023,1.383,60.130434782608695,2.812599605,4.074948637333334,4.290728479,0.3214734569666667,0.3800961227333333,446,1.3214814814814815,1,0,0,1,FALSE,FALSE,FALSE
38,2021-11-12T23:13:03Z,2021-11-12T23:46:26Z,2002,1,2021-11-12T23:46:29Z,1,Edge,95.0.1020.44,Windows NT 10.0,1536,864,I enjoyed talking.,1.7777777777777777,884,97,475,120,89,136,0.2435778721438935,0.06537025594275213,0.22865435595692538,0.18789790257426575,0.23556253080827336,0.5172710870403106,2,2,2,2,2,1,3,2,1,3,4,1,2,1,1,1,1,2,1,1,0.8506963092234007,0,1,3,2,2,2.35,0,4,5,3,4,3,3,4,1,1,1,1,4,1,4,5,1,1,1,2,1,1,2,2,1,2,1,0,3,5,5,5,5,4,4,4,4,1,5,2,1,5,1,5,2,1,3,2,3,5,1,1,1,1,1,1,2,1,1,5,1,1,1,1,1,1,3,2,3,1.7084843923544981,1.533747356112131,1.375,0,2.25,0,1.7333333333333334,0,1.6666666666666667,0,1.5833333333333333,0,0.8333333333333334,0,1,0,1,0,1.3783783783783783,0,1,1,0,-0.9313667867632848,-0.9294610014101783,0.06449092769773276,-0.43248503685622275,5,1,5,1,1,2,1,1,1,1.889822365046136,1.1428571428571428,0,1,-0.8176513788914915,5,5,5,5,4,3,2,6,6,5,3,1.2149857925879117,4.428571428571429,0,1.5714285714285714,3,3.8333333333333335,3.2559414990859232,-0.7395711320441822,0,-0.8635661140261877,5,5,4,2,3,4,4,2,3,3,1,2,5,1,1,4,4,4,3,5,1.3870146083619754,3.8,0,3,0,2.6,0,2,0,2.533333333333333,0,3,1,1,4,3,2,4,3,1,1,4,3,1,2,2,3,1,3,3,1,1.1285761872936695,2,0,"Asian or Asian American (e.g., Chinese, Japanese, and others) & White, Caucasian, Anglo, European American",1,22,1,2,NA,1,3,4,Parttime Student,7,0,102,64,1,5,2,0,0,2,0,0,TRUE,TRUE,TRUE,TRUE,TRUE,5,1.0165937500004656,0.64,0.10158691102023713,5,0.5401967741928755,0.5967379310336607,0.96875,0.90625,0.018697195957340523,0.00956741286301729,5,0.7532156249987892,0.8521225806445845,1,1,0.017307860716193682,0.024564331140271966,1.3644,0.435,0.5869,1.3414,0.3847,0.6016,0.2207,1.4122096746666666,0.5946015838393334,0.5752073650666667,1.1055,2.7526,0.348,2.3465,0.3898,-40.7095,1.2006,3.0954,0.3414,3.4273,0.4215,0.8967,1.2261412878666667,2.60775194,3.0744721316666666,0.3789116961,0.337756827,1.3994,4.2426,0.583,2.8206,0.6182,0.9073,0.153,0.417,0.466,0.012,1.383,115.25,2.7914802746666667,4.127303228666666,3.799369103,0.41501953146666665,0.4872688731,374,1.108148148148148,1,0,0,1,FALSE,FALSE,FALSE
39,2021-11-12T23:21:40Z,2021-11-12T23:46:50Z,1510,1,2021-11-12T23:46:51Z,1,Chrome,94.0.4606.81,Windows NT 10.0,1504,1003,NA,1.4995014955134596,760,62,403,97,73,80,-0.07502363803382947,-0.2525955850186271,-0.11797086171080182,-0.092389447708736,0.014569576618755927,-0.4286454515674616,2,1,3,2,1,1,3,2,1,2,1,1,4,3,1,1,1,2,1,1,0.9233805168766387,1,1,2,4,4,2.9,0,4,5,2,4,1,1,5,1,1,1,3,4,1,4,4,1,4,5,2,1,4,1,1,0,2,0,1,5,3,1,5,5,5,3,2,1,2,5,3,2,1,1,3,1,4,4,5,2,1,5,4,1,2,1,1,1,1,1,5,2,2,2,3,3,2,3,1,1,1.5494840757171082,1.624221425205085,2.375,0,1.75,0,1.5333333333333334,0,2.6666666666666665,0,2.75,0,2.8333333333333335,0,1.1428571428571428,0,2.6666666666666665,0,2.4864864864864864,0,0,0,1,0.37989431376598426,-0.10945423753312258,-0.32558751222710886,-0.21752087488011573,4,3,2,1,2,4,5,1,1,1.4142135623730951,3,0,1,0.2934220281253842,5,3,4,5,2,2,1,1,1,2,2,1.5735915849388864,3.7142857142857144,0,2.2857142857142856,8,3.8333333333333335,3.2559414990859232,2.0842459175790595,0,0.946697397892617,5,3,5,5,5,4,5,5,4,2,1,5,4,4,3,5,5,2,5,3,1.3201731488169053,4.6,0,4.2,0,3,0,2.6,0,3.2666666666666666,0,1,1,2,1,2,2,3,2,1,3,1,2,3,4,1,2,3,3,2,1,0.9176629354822471,2.3,0,"Asian or Asian American (e.g., Chinese, Japanese, and others)",0,20,1,2,NA,1,2,3,barista,1,0,105,59,2,5,2,0,0,1,0,0,TRUE,TRUE,TRUE,TRUE,TRUE,2,0.8322604651340219,0.86,0.09776715347690806,2,0.49092187501490114,0.5950064516067505,1,1,0.001163773379426099,0.006293711960180323,2,0.6675437500327825,0.7097343749850988,1,1,0.007554708350978476,0.0063789145869093365,1.3344,1.3602,0.5636,1.088,1.1384,0.6088,0.0828,1.373289676,1.1923225048666666,0.5513237305,3.7502,11.4157,0.3267,7.054,0.3292,-101.358,0.6473,7.1724,0.4511,5.0705,0.5264,0.5147,1.7981057523333333,4.660076116666667,6.970940395,0.40618711246666667,0.3694318294,1.0295,3.8687,0.54,4.0126,0.5879,0.9757,0.131,0.439,0.593,0.013,0.985,75.76923076923077,2.2172614555333334,4.937720913666666,5.113379483666667,0.4476053217,0.5016048844333333,104,0.3081481481481481,1,1,0,1,FALSE,FALSE,FALSE
40,2021-11-12T23:26:24Z,2021-11-12T23:47:40Z,1276,1,2021-11-12T23:47:41Z,1,Chrome,95.0.4638.54,Macintosh,1440,900,n/a,1.6,598,47,374,70,41,93,-0.49126109487891917,-0.38886665971636103,-0.2575837966047475,-0.421422424127912,-0.42741633176027893,-0.20905768367637165,4,4,1,1,4,1,1,3,1,4,3,1,1,1,4,4,1,1,3,3,1.3803127029389886,0,1,1,4,4,1.2,0,4,4,1,4,1,1,5,1,1,1,1,5,3,4,4,1,3,3,1,1,1,1,1,5,2,0,3,5,3,3,4,4,5,5,5,5,1,5,1,1,3,1,4,1,1,1,1,1,3,1,1,3,4,1,1,3,1,1,5,1,1,1,1,1,2,1,1,1,1.65763317647414,1.6761634196950514,1.5,0,1.25,0,1.4666666666666666,0,1.6666666666666667,0,1.25,0,2,0,1.1428571428571428,0,1,0,1.4864864864864864,0,3,0,3,-0.7863715689162981,-0.9438827445425771,0.4797867975263196,-0.23204797350812878,5,1,3,1,1,1,1,1,1,1.5735915849388864,1.2857142857142858,0,1,-0.7321841937363471,5,5,5,5,2,2,2,6,7,3,3,1.6035674514745464,4,0,2,2.5,3.8333333333333335,3.2559414990859232,-1.0219528370065065,0,-0.7657439742430396,2,2,2,3,2,1,4,2,1,2,1,4,2,4,5,2,4,2,4,3,1.3345232785352157,2.2,0,4.4,0,3.6,0,4.2,0,4.066666666666666,0,1,1,1,4,1,1,1,4,1,1,1,4,1,1,1,4,2,1,2,2,1.2085223687584246,1.15,0,"White, Caucasian, Anglo, European American",0,24,1,2,NA,1,4,6,Registered Nurse,5,0,150,69,3,5,2,0,0,1,0,0,TRUE,TRUE,TRUE,TRUE,TRUE,4,0.6423829268304313,0.82,0.02645736661655393,4,0.4011093750009313,0.46980344827627313,1,0.90625,0.0012374447479533007,0.0044235359576019284,4,0.49753124999860304,0.6050166666681568,1,0.9375,0.0053823912499923595,0.006363234475789165,1.1473,1.3669,0.3496,0.9988,1.9228,0.4315,0.2658,1.1944128572333332,1.1800156141666667,0.3422804306,0.953,5.5705,0.3156,3.022,0.3362,-88.2518,0.67,7.7854,0.3614,4.4002,0.3949,0.9664,1.026985352,3.230200181333333,5.456146258,0.33082780563333336,0.3105097849,0.6292,4.2657,0.4423,3.5658,0.5441,0.9891,0.065,0.349,0.422,0.014,1.806,129,1.5355448193333334,4.093976355,3.212621782,0.3097297198,0.3877823863666667,398,1.1792592592592592,1,0,0,1,FALSE,FALSE,FALSE
41,2021-11-12T23:21:04Z,2021-11-12T23:49:29Z,1704,1,2021-11-12T23:49:30Z,1,Chrome,87.0.4280.88,Macintosh,1440,900,NA,1.6,720,68,434,78,61,108,-0.17779831873632074,-0.1980871551395335,0.03127055145169184,-0.3239311718555635,-0.15117513902338214,0.04431281773642447,4,4,1,1,4,1,1,4,1,4,3,1,1,1,4,4,1,1,4,4,1.5035046776746235,0,1,1,5,5,1.05,0,1,3,4,3,4,3,2,4,5,4,4,2,3,2,2,4,4,4,2,2,4,4,4,9,1,5,2,4,2,1,2,1,2,2,2,2,3,2,4,2,1,4,2,3,4,5,5,1,1,5,5,4,5,5,5,5,5,5,4,1,2,2,4,1,4,4,4,4,1.5446313106647445,1.0997835284835873,3.5,0,4,0,3.8666666666666667,0,4,0,3.6666666666666665,0,4.666666666666667,0,3.4285714285714284,0,2.3333333333333335,0,3.810810810810811,0,5,5,2,1.9033947911437412,1.945886134389598,2.6051013660749422,2.27549375023227,3,4,2,4,2,2,3,7,3,0.8997354108424374,3.142857142857143,0,5,1.854839912378057,1,2,4,2,1,1,4,3,1,1,2,1.3451854182690985,1.8571428571428572,0,4.142857142857143,7,3.8333333333333335,3.2559414990859232,1.5194825076544112,0,1.7000386594089707,1,1,1,3,1,2,5,1,1,3,1,4,2,4,4,3,4,1,4,1,1.4474937289114918,1.4,0,4.4,0,3.8,0,4.6,0,4.266666666666667,0,2,2,2,1,2,2,3,2,3,3,3,2,3,3,1,2,1,2,3,3,0.7163503994113789,2.55,0,"Hispanic of Latino (e.g., Mexican American, Central American, and others)",0,25,1,2,NA,1,2,4,assistant,2,0,170,61,2,5,2,0,0,0,0,0,TRUE,TRUE,TRUE,TRUE,TRUE,3,0.7259413513505982,0.74,0.03746064051581908,3,0.5253724193110341,0.5636268749949522,1,1,0.0036234140064492736,0.003470739015349525,3,0.6374042187671876,0.71544953128614,1,1,0.014577951601736052,0.010868396690462441,1.252,0.8977,0.4043,1.035,0.8504,0.4895,0.0402,1.3000912943333334,0.9149561890333333,0.39709537326666666,6.0433,10.1066,0.2264,9.1767,0.2344,-91.338,0.7681,6.3014,0.462,6.2519,0.5093,0.9618,1.931763261,5.020757968,5.894849711333333,0.3765112795,0.3664255771666667,1.094,3.9609,0.5035,3.7609,0.5765,0.95,0.25,0.268,0.697,0.016,1.58,98.75,2.7749075183333334,4.616858779666667,4.152905215,0.3394540705,0.3861675278,432,1.28,1,0,0,1,FALSE,FALSE,FALSE
42,2021-11-12T23:18:18Z,2021-11-12T23:50:28Z,1929,1,2021-11-12T23:50:30Z,1,Chrome,94.0.4606.81,Windows NT 10.0,1600,900,"My back arrow currently does not work on my keyboard, so I was only able to click the right arrow on the first attention game, then I remembered, that I can use my on-screen keyboard application, so I was able to complete the final two attention games successfully. Sorry that I didn't think of the solution sooner.",1.7777777777777777,768,78,532,113,97,153,-0.05446870189333121,-0.10723977200771087,0.5030659866105427,0.10259305683596086,0.34605900790303207,0.8044243219748128,2,2,3,3,2,2,3,2,1,2,2,3,3,2,2,2,2,3,2,2,0.5501196042201808,0,1,1,4,4,2.75,0,1,4,4,3,2,4,3,4,2,3,2,3,3,3,3,3,4,5,1,2,5,5,4,4,1,0,5,3,2,3,4,3,3,2,2,3,2,4,2,1,4,2,4,2,3,3,2,3,2,3,3,2,3,1,2,2,5,5,3,2,1,1,1,2,2,3,2,2,1.0419143849595252,0.8837151016885368,3.625,0,2.25,0,3.066666666666667,0,3.2222222222222223,0,2.1666666666666665,0,2.5,0,2.7142857142857144,0,1.3333333333333333,0,2.5675675675675675,0,2,0,5,1.2078380214719655,1.121523810506113,0.9431984283971292,1.0323611194516211,4,1,3,2,1,2,2,1,1,1.0690449676496976,1.8571428571428572,0,1,-0.39031545311577004,3,4,5,5,3,2,2,5,6,2,2,1.2724180205607036,3.7142857142857144,0,2.2857142857142856,3.5,3.8333333333333335,3.2559414990859232,-0.4571894270818581,0,-0.3240202744378419,3,4,4,5,3,3,5,2,3,3,2,4,2,4,5,5,4,2,3,2,1.162919151265879,3.8,0,3.8,0,3.2,0,4,0,3.6666666666666665,0,2,3,3,2,3,3,3,3,2,3,2,3,3,4,3,3,1,3,3,3,0.6386663736585051,2.65,0,"White, Caucasian, Anglo, European American",0,19,1,2,NA,1,3,3,currently unemployed,1,0,147,65,2,5,2,0,0,1,0,0,TRUE,TRUE,TRUE,TRUE,TRUE,4,1.1108970588235294,0.68,0.08561965962297319,NA,NA,NA,NA,NA,NA,NA,NA,NA,NA,NA,NA,NA,NA,1.5462,0.5081,0.5665,1.2067,0.6659,0.7764,0.64,1.5642448123333332,0.619498393272,0.5557975616333334,NA,NA,NA,NA,NA,NA,NA,NA,NA,NA,NA,NA,NA,NA,NA,NA,NA,NA,NA,NA,NA,NA,NA,NA,NA,NA,NA,NA,NA,NA,NA,NA,NA,NA,104,0.3081481481481481,1,1,7,8,TRUE,FALSE,FALSE
43,2021-11-12T23:18:00Z,2021-11-12T23:53:17Z,2117,1,2021-11-12T23:53:18Z,1,Firefox,94.0,Windows NT 10.0,2560,1440,"Feeling a little bit sick today, probably a cold.

",1.7777777777777777,1117,78,582,101,74,86,0.8422403872359052,-0.10723977200771087,0.7437779433242422,-0.04364382157256178,0.028381636255600768,-0.3272972510023432,2,4,3,2,2,1,1,2,1,3,3,2,3,1,2,2,1,1,2,3,0.8870412083230169,1,1,1,5,5,2.05,0,4,4,2,4,3,2,4,2,1,1,1,4,3,5,4,1,2,1,1,1,2,1,2,0,2,0,0,5,3,4,3,3,5,2,5,5,1,5,2,1,4,1,5,1,3,3,3,1,5,1,1,1,1,1,1,1,1,1,5,2,2,1,1,1,1,1,1,1,1.626082453058314,1.3345232785352157,1.375,0,1,0,1.8666666666666667,0,2.111111111111111,0,1.6666666666666667,0,0.8333333333333334,0,1.1428571428571428,0,1,0,1.5405405405405406,0,0,0,0,-0.8305005482610333,-0.8024722296671781,-0.7372407672780129,-0.7698564984725955,5,1,5,1,1,1,1,1,1,1.9518001458970664,1,0,1,-0.9031185640466358,5,5,5,5,3,2,1,5,6,4,4,1.7043362064926932,4.285714285714286,0,1.7142857142857142,3.5,3.8333333333333335,3.2559414990859232,-0.4571894270818581,0,-0.6427042641235889,1,2,2,3,2,1,5,1,1,1,2,5,3,4,5,2,5,2,2,2,1.624221425205085,2,0,4.6,0,3,0,4.6,0,4.066666666666666,0,1,1,1,2,2,2,2,3,4,1,1,3,1,3,1,3,1,1,1,2,0.9514531821875089,1.7,0,"White, Caucasian, Anglo, European American",0,29,0,1,NA,1,3,6,Currently unemployed,3,0,178,69,2,5,2,0,1,0,0,1,TRUE,TRUE,TRUE,TRUE,TRUE,5,0.9184565217391304,0.92,0.10328742897959187,5,0.41225,0.46950000000000003,1,0.9375,0.002253741935483871,0.00402154435483871,5,0.52515625,0.6189655172413793,1,0.90625,0.0017918135080645153,0.003957353830645161,1.5497,1.5595,0.5538,1.3379,1.7432,0.6026,0.269,1.5215813186666667,1.3056393439,0.5460393696333333,1.1248,5.0354,0.3006,3.4236,0.3273,-80.6277,0.8589,6.7692,0.3494,7.0712,0.4091,0.8113,1.2075666450666667,3.580562355666667,5.083125233333333,0.3218396689,0.29543249466666666,0.5289,4.6279,0.4812,5.9069,0.576,0.8982,0.05,0.449,0.671,0.02,1.936,96.8,1.3192125124333334,5.858254681,2.6010319629,0.4194136153333333,0.3914216783666667,380,1.125925925925926,1,0,0,1,FALSE,FALSE,FALSE
44,2021-11-12T23:37:12Z,2021-11-12T23:57:13Z,1200,1,2021-11-12T23:57:15Z,1,Chrome,95.0.4638.69,Windows NT 10.0,1280,720,no,1.7777777777777777,632,41,258,54,51,93,-0.4039026162818016,-0.44337508959545463,-0.8160355361805302,-0.6164049286726088,-0.28929573539183057,-0.20905768367637165,4,3,2,2,3,1,1,2,1,3,3,1,1,2,3,3,1,2,3,3,0.9514531821875089,0,1,2,4,4,1.7,0,2,4,2,4,1,1,3,1,1,1,2,5,3,4,4,1,1,2,1,1,1,1,1,0,2,0,1,5,5,5,5,5,5,4,4,5,1,5,1,1,4,1,5,2,2,2,2,3,4,2,1,1,4,2,1,1,2,2,5,1,1,1,1,1,2,2,2,3,1.6899277664609975,1.4074631010979937,1.125,0,2.25,0,1.8666666666666667,0,1.2222222222222223,0,1.5833333333333333,0,1.8333333333333333,0,1.1428571428571428,0,1,0,1.4594594594594594,0,0,0,1,-1.0364357852031298,-0.9447538565438629,-0.1687851067926266,-0.5567694816682447,5,1,4,1,1,2,1,1,1,1.6761634196950514,1.2857142857142858,0,1,-0.7321841937363471,5,5,5,5,3,3,2,5,7,4,4,1.2909944487358056,4.285714285714286,0,1.7142857142857142,3,3.8333333333333335,3.2559414990859232,-0.7395711320441822,0,-0.783895116604751,2,2,2,2,2,2,5,3,2,4,1,5,2,4,4,1,4,2,3,2,1.3345232785352157,2,0,4.4,0,4.2,0,3.8,0,4.133333333333334,0,1,1,1,3,2,1,1,4,1,1,2,3,2,1,2,4,2,2,1,1,1.0052493799000692,1.4,0,"White, Caucasian, Anglo, European American",0,19,1,2,NA,1,3,4,n/a,3,0,160,65,2,5,2,0,0,0,0,0,TRUE,TRUE,TRUE,TRUE,TRUE,3,0.8148774999979883,0.8,0.05646608637102879,3,0.535746874999255,0.6370800000001987,1,1,0.014206722570445878,0.014461858896272889,3,0.6561906249979511,0.7123566666687529,1,0.9375,0.009228459586622216,0.006435049102890453,1.4441,1.0405,0.3927,1.2117,1.3771,0.4988,0.3536,1.4577455636666667,0.9970171186666666,0.38732250516666666,1.8895,4.0465,0.3023,4.3483,0.4198,-57.5599,0.9811,4.1227,0.4128,3.8289,0.5046,0.9632,1.8959344693333333,4.150012009,4.088215295666667,0.410347157,0.3010389687666667,1.2194,3.9189,0.5044,4.8158,0.5871,0.9107,0.058,0.496,0.382,0.012,1.362,113.5,1.8683866453333333,4.352609035333334,2.811912257,0.4424146914666667,0.4090524406,360,1.0666666666666667,1,0,0,1,FALSE,FALSE,FALSE
45,2021-11-12T23:38:20Z,2021-11-13T00:02:44Z,1463,1,2021-11-13T00:02:46Z,1,Chrome,95.0.4638.69,Windows NT 10.0,1707,960,"A very thorough and interesting study, thank you for the opportunity to participate!",1.778125,631,72,344,115,66,112,-0.40647198329936385,-0.16174820188680444,-0.40201097063296715,0.12696586990404798,-0.08211484083915795,0.11187828477983676,3,3,1,1,3,1,2,3,1,4,3,1,1,2,3,3,2,1,3,4,1.0699237552766379,0,1,1,2,1,1.55,0,3,2,4,2,5,4,3,2,4,2,3,3,2,3,2,2,3,3,1,1,3,3,3,1,2,0,0,3,2,4,5,5,5,4,5,3,3,4,4,1,3,2,5,5,4,4,5,4,2,1,1,1,3,3,1,3,1,1,3,2,3,1,3,1,2,1,2,2,1.4431155818514962,0.9611501047232549,2.375,0,1.75,0,3.3333333333333335,0,2,0,3.1666666666666665,0,2,0,1.8571428571428572,0,1.6666666666666667,0,2.3783783783783785,0,1,0,0,0.312650154764484,0.617633912873446,-0.2989446853297732,0.15934461377183642,5,1,3,1,1,1,1,1,1,1.5735915849388864,1.2857142857142858,0,1,-0.7321841937363471,2,3,4,2,1,2,4,4,3,2,2,1.1338934190276817,2.2857142857142856,0,3.7142857142857144,5.5,3.8333333333333335,3.2559414990859232,0.6723373927674386,0,1.037453109701174,1,1,2,4,2,1,5,2,2,4,1,5,4,4,5,2,5,4,2,4,1.4960264830861913,2,0,4.4,0,3.4,0,3.8,0,3.8666666666666667,0,2,1,2,3,4,1,2,4,1,1,2,4,1,1,1,3,1,1,1,4,1.2139539573337679,1.6,0,"Black or African American & White, Caucasian, Anglo, European American",1,26,1,2,NA,1,3,7,Reporting Analyst,3,0,145,66,1,5,2,0,0,1,0,0,TRUE,TRUE,TRUE,TRUE,TRUE,6,0.9000581395347971,0.86,0.08658228000001983,6,0.36774062500020954,0.4189310344826302,1,0.90625,8.736231350623663e-4,0.0015720185483967765,6,0.48892812500009314,0.5640222222222774,1,0.84375,0.005251881441572614,0.0057332961190106335,1.6094,1.2509,0.4772,1.1803,1.1792,0.6165,0.1832,1.5767776493333334,1.1189779482,0.47225045116666664,0.8446,6.6764,0.3045,3.4221,0.3129,-106.2503,0.5593,8.8874,0.3363,6.3522,0.3744,0.9618,0.8854368259,3.5543377786666666,6.068471366333333,0.3099972511333333,0.3002007413,0.6587,3.8484,0.4111,4.1509,0.4978,0.6032,0.06,0.368,0.576,0.011,1.55,140.90909090909093,1.0819758225,4.595912657666666,2.0381679322333333,0.37340065786666665,0.34043630113333334,419,1.2414814814814816,1,0,0,1,FALSE,FALSE,FALSE
47,2021-11-12T23:43:35Z,2021-11-13T00:07:04Z,1409,1,2021-11-13T00:07:07Z,1,Firefox,94.0,Windows NT 10.0,1366,768,NA,1.7786458333333333,680,82,353,99,76,72,-0.28057299943881203,-0.07090081875498182,-0.3586828184245012,-0.06801663464064889,0.05600575552929045,-0.5637763856542862,2,2,2,1,2,1,2,2,1,2,1,3,1,1,2,2,3,1,2,2,0.6386663736585051,0,1,3,2,2,2.35,0,5,5,1,5,1,1,5,1,1,1,1,5,1,5,5,1,1,1,1,1,1,1,1,0,2,0,0,5,5,5,5,5,5,5,5,5,1,5,1,1,4,1,5,1,1,1,1,1,5,1,1,1,2,1,1,1,3,1,5,1,1,1,1,1,1,1,1,1,1.9081774396373994,2.065591117977289,1,0,1,0,1,0,1,0,1.0833333333333333,0,1,0,1.1428571428571428,0,1,0,1.1081081081081081,0,0,0,0,-1.3327303608034937,-1.5219139525069039,-0.7372407672780129,-1.1295773598924583,4,1,2,2,1,3,2,1,1,1.0690449676496976,2.142857142857143,0,1,-0.21938108280548152,5,5,5,5,1,1,3,3,3,2,2,1.9023794624226837,3.5714285714285716,0,2.4285714285714284,6,3.8333333333333335,3.2559414990859232,0.9547190977297628,0,0.46160498538940525,2,2,3,3,3,2,3,2,2,1,1,3,2,3,4,3,4,2,2,3,0.9154754164341269,2.6,0,4,0,2.6,0,3.6,0,3.4,0,2,2,4,1,2,4,4,1,1,1,1,2,1,2,1,3,2,4,2,4,1.1964860832322377,2.5,0,"White, Caucasian, Anglo, European American",0,22,1,2,NA,1,2,3,none,2,0,100,62,1,5,2,0,0,1,0,0,TRUE,TRUE,TRUE,TRUE,TRUE,2,1.0122142857142857,0.84,0.05238965551020408,2,0.5271875,0.59071875,1,1,0.004263318548387096,0.01204278931451613,2,0.66196875,0.84553125,1,1,0.008293966733870964,0.03458774092741935,1.3595,1.2398,0.6605,1.1276,1.2653,0.7592,0.3079,1.4104341853333333,1.1217188785666667,0.6451191062666667,1.7136,4.9163,0.3675,3.9752,0.3787,-73.277,1.0975,5.6585,0.4357,3.99,0.4481,0.9646,2.0914886486666666,4.364720334,4.832946766,0.3537092235,0.3117592977,1.2321,3.4975,0.506,2.6391,0.6155,0.8824,0.318,0.151,0.605,0.007,1.385,197.85714285714286,2.645102913,4.805279040333334,3.427039515,0.39029775406666667,0.4601499418666667,268,0.794074074074074,1,0,0,1,FALSE,FALSE,FALSE
48,2021-11-12T23:48:28Z,2021-11-13T00:09:40Z,1272,1,2021-11-13T00:09:41Z,1,Chrome,95.0.4638.69,Macintosh,1440,900,NA,1.6,665,54,303,75,53,72,-0.31911350470224625,-0.3252734915240852,-0.5993947751382007,-0.3604903914576942,-0.2616716161181409,-0.5637763856542862,3,2,3,3,2,1,2,2,1,2,2,1,1,1,2,2,2,1,2,2,0.6708203932499369,0,1,1,4,2,2.25,0,2,3,5,3,5,3,3,3,4,2,2,3,3,3,2,3,3,1,1,2,2,4,3,0,2,0,0,2,3,3,2,2,4,3,5,4,5,3,2,1,4,3,4,5,4,2,2,3,4,1,1,1,1,1,1,1,1,1,2,5,4,1,3,2,2,2,2,2,1.3836236534601505,0.9611501047232549,2.375,0,2,0,3.3333333333333335,0,2.888888888888889,0,2.8333333333333335,0,1,0,2.2857142857142856,0,2,0,2.4324324324324325,0,0,0,0,0.3462722342652341,0.6408635662410679,-0.4236359564090485,0.10861380491600969,5,2,3,1,1,1,1,3,1,1.5275252316519468,1.4285714285714286,0,2,-0.2777293338068208,3,3,3,3,2,2,3,7,7,NA,3,0.4879500364742666,2.7142857142857144,0,3.2857142857142856,2,3.8333333333333335,3.2559414990859232,-1.3043345419688306,0,-0.189895849931271,3,3,3,3,3,2,5,3,2,3,1,4,2,3,4,2,4,2,4,3,1.0997835284835873,3,0,4.2,0,4,0,3.4,0,3.8666666666666667,0,2,3,3,3,3,4,4,3,1,4,2,3,2,3,2,4,3,3,1,3,0.8944271909999159,2.5,0,"White, Caucasian, Anglo, European American",0,22,1,2,NA,1,3,6,Teacher,1,0,125,66,2,5,2,0,0,1,0,0,TRUE,TRUE,TRUE,TRUE,TRUE,2,0.7427257142858846,0.7,0.03616631617969496,2,0.5646625000010245,0.6679161290338924,1,0.96875,0.020994414032177812,0.0100915641831699,2,0.7430906249992549,0.8749531249990686,1,1,0.011883863457845893,0.013261038054329743,1.0788,0.801,0.5039,0.9232,0.722,0.559,0.1219,1.1482628163,0.8645094875066667,0.494082989,1.4247,3.1145,0.336,3.2894,0.4611,-47.466,1.171,3.5133,0.4002,3.7022,0.5184,0.9982,1.6835847956666667,3.4857950753333333,3.5182490916666667,0.43518766653333335,0.3181241867,0.9819,4.0656,0.6254,2.465,0.7347,0.9247,0.182,0.407,0.549,0.009,1.473,163.66666666666669,3.1893485863333333,4.6764161086666665,4.250700514,0.4047306846666667,0.5040274516333333,104,0.3081481481481481,1,0,0,1,FALSE,FALSE,FALSE
49,2021-11-12T23:24:53Z,2021-11-13T00:11:42Z,2809,1,2021-11-13T00:11:42Z,1,Safari,13.1.3,Macintosh,1680,1050,These types of surveys that ask about the past always make me feel a little sad.,1.6,784,86,461,95,59,127,-0.013358829612334701,-0.03456186550225277,0.16125500807708953,-0.11676226077682311,-0.17879925829707183,0.3652487861926329,1,2,3,1,2,2,4,2,2,2,2,3,3,2,1,1,3,1,1,1,0.8870412083230169,0,1,1,3,3,2.95,0,3,2,3,3,2,3,3,3,5,2,1,2,1,2,3,5,5,3,4,3,4,4,4,6,2,0,0,2,2,1,1,1,2,1,3,2,1,2,3,3,4,5,3,5,5,4,3,3,1,2,3,1,2,3,1,4,3,2,1,4,3,3,3,1,5,4,4,4,1.238763308519644,0.990430401872025,4,0,4.25,0,2.933333333333333,0,4.333333333333333,0,3.4166666666666665,0,2.5,0,3,0,2.3333333333333335,0,3.3783783783783785,0,3,0,0,1.9454223905196797,1.5738245196181855,0.8912522894356707,1.232538404526928,3,1,2,2,1,1,1,1,1,0.7867957924694432,1.8571428571428572,0,1,-0.39031545311577004,1,2,3,2,1,2,3,1,1,NA,2,0.816496580927726,2,0,4,8,3.8333333333333335,3.2559414990859232,2.0842459175790595,0,1.902749366949858,2,2,3,4,5,2,5,4,3,2,1,5,4,3,5,3,2,2,3,2,1.2798809468443688,3.2,0,4,0,3,0,3.4,0,3.466666666666667,0,4,4,4,2,2,2,3,2,1,2,2,2,4,4,2,2,2,4,4,3,1.019545822516343,2.95,0,"Hispanic of Latino (e.g., Mexican American, Central American, and others)",0,24,1,2,NA,1,3,4,English teacher,1,0,110,57,1,5,2,0,0,1,0,0,TRUE,TRUE,TRUE,TRUE,TRUE,NA,NA,NA,NA,3,0.48237500000000366,0.5238709677419392,1,0.96875,0.006835983870966455,0.003540378024193993,3,0.6565312500000055,0.7787187499999991,1,1,0.006970773185484743,0.014036466733870535,NA,NA,NA,NA,NA,NA,NA,NA,NA,NA,1.2232,4.1897,0.3364,4.3791,0.3947,-78.8819,0.8608,5.4514,0.3995,6.2714,0.4518,0.9881,NA,NA,NA,NA,NA,0.9649,5.8671,0.581,3.1954,0.6543,0.9922,0.248,0.305,0.699,0.005,0.926,185.20000000000002,NA,NA,NA,NA,NA,438,1.2977777777777777,1,0,0,1,FALSE,FALSE,FALSE
50,2021-11-12T23:38:41Z,2021-11-13T00:11:50Z,1989,1,2021-11-13T00:11:53Z,1,Firefox,94.0,Windows NT 10.0,1920,1080,n/a,1.7777777777777777,731,56,615,331,76,89,-0.14953528154313564,-0.30710401489772066,0.9026478347552838,2.7592296812574557,0.05600575552929045,-0.27662315071978394,2,1,1,2,1,1,1,1,1,2,2,1,1,1,2,1,1,1,1,2,0.47016234598162726,0,1,2,3,2,2.3,0,1,1,3,1,5,3,1,3,1,1,2,1,1,1,1,3,4,5,1,2,1,3,2,10,2,3,0,2,1,2,2,1,2,2,2,2,3,2,2,2,3,2,3,3,2,2,2,2,1,2,2,3,3,2,1,5,4,4,3,3,2,1,4,1,1,1,1,3,0.9388191419977446,1.2227992865708155,2.625,0,1.5,0,3.6,0,4.222222222222222,0,2.5,0,2.6666666666666665,0,3,0,2,0,3.054054054054054,0,5,3,0,0.8884282662148361,1.1300413500742408,1.0549236299181224,1.0924824899961816,2,3,1,2,2,3,3,4,2,0.7559289460184544,3.142857142857143,0,3,1.1168645628292926,3,3,3,3,1,1,3,2,1,1,2,0.9759000729485332,2.4285714285714284,0,3.5714285714285716,7.5,3.8333333333333335,3.2559414990859232,1.8018642126167355,0,1.5225455222043855,2,2,2,3,3,3,2,2,3,2,1,3,3,3,2,2,1,2,3,1,0.7745966692414834,2.4,0,3.2,0,2.8,0,3.4,0,3.1333333333333333,0,1,2,2,1,2,3,1,1,2,1,1,3,2,2,1,2,1,1,2,3,0.7326950970650465,2,0,"Hispanic of Latino (e.g., Mexican American, Central American, and others) & White, Caucasian, Anglo, European American",1,23,1,2,NA,1,2,3,Currently unemployed,1,0,259,61,1,5,2,0,0,0,0,0,TRUE,TRUE,TRUE,TRUE,TRUE,6,1.03671875,0.64,0.17094897306122447,6,0.5362903225806451,0.659125,0.96875,1,0.005041813508064517,0.006188822580645162,6,0.66471875,0.6750625,1,1,0.005526724798387099,0.007426383064516128,1.5745,0.38,0.5213,1.3228,0.1868,0.6308,0.2269,1.5820529626666666,0.519218816912,0.5129951859666667,1.5384,4.1291,0.3612,4.066,0.4699,-65.1987,0.9399,4.7731,0.4405,4.1562,0.5565,0.9939,1.739532547,4.161720290333333,4.312423713666667,0.4517791214,0.34489122386666665,0.894,4.5054,0.5602,3.7552,0.5688,0.5637,0.224,0.327,0.665,0.123,1.489,12.10569105691057,2.334601526666667,5.500124591666666,4.491366253,0.4584606229666667,0.4220092606,317,0.9392592592592592,1,0,0,1,FALSE,FALSE,FALSE
52,2021-11-12T23:55:11Z,2021-11-13T00:13:41Z,1109,1,2021-11-13T00:13:42Z,1,Chrome,95.0.4638.69,Windows NT 10.0,1920,1080,NA,1.7777777777777777,581,77,244,50,65,58,-0.534940334177478,-0.11632451032089314,-0.883434884060366,-0.665150554808783,-0.09592690047600279,-0.8002555203062293,3,3,1,1,3,1,1,1,1,1,3,1,1,1,3,3,1,1,3,3,1.0052493799000692,0,0,4,3,2,1.7,0,5,5,2,5,2,2,5,2,2,2,2,5,2,5,2,2,3,1,1,1,2,2,1,0,2,0,0,5,1,1,1,1,5,4,4,4,1,5,1,1,4,2,4,3,2,2,2,2,4,1,1,1,2,2,1,1,1,1,3,4,1,1,1,1,2,1,1,1,1.4305755997312923,1.52127765851133,1.625,0,1.25,0,1.7333333333333334,0,3.111111111111111,0,1.75,0,1.3333333333333333,0,1.5714285714285714,0,1,0,1.972972972972973,0,0,0,0,-0.4060217945640583,-0.5664976675410849,-0.6588395645607719,-0.6126686160509284,5,2,2,3,2,2,2,2,1,1.1338934190276817,2.2857142857142856,0,1.5,0.050579939736853735,4,5,5,5,2,2,3,6,4,3,3,1.3801311186847085,3.7142857142857144,0,2.2857142857142856,4,3.8333333333333335,3.2559414990859232,-0.1748077221195339,0,-0.18282942195667984,1,1,1,1,1,1,5,2,1,4,2,5,1,5,4,1,5,3,3,3,1.6035674514745464,1,0,4.4,0,4.4,0,4.2,0,4.333333333333333,0,1,3,1,4,4,1,1,3,1,1,3,3,1,1,2,4,1,1,3,1,1.2139539573337679,1.6,0,"White, Caucasian, Anglo, European American",0,21,0,1,NA,1,3,4,student,3,0,130,70,1,5,2,0,0,0,0,0,TRUE,TRUE,TRUE,TRUE,TRUE,4,0.7399743589774156,0.78,0.071688108265939507,4,0.3601225806436231,0.4448538461510952,0.96875,0.8125,0.0017063835380264872,0.0036642185377830914,4,0.5061093750018626,0.5713129032331128,1,0.96875,0.0071996924897162785,0.007354714668189193,1.2552,1.0023,0.4094,1.1742,1.1805,0.4338,0.3733,1.3015656852,0.9770888986333334,0.40122328463333334,0.9077,3.9323,0.2502,2.0793,0.296,-66.2381,0.5458,5.3994,0.32,3.5897,0.3753,0.9971,0.9692230790666667,2.4129795832,4.189675281333333,0.2927339117,0.24761177213333332,1.1914,4.0325,0.368,4.4442,0.4378,0.9946,0.066,0.362,0.454,0.025,1.945,77.8,1.8233488893333334,4.464830056666667,3.517671072,0.303776398,0.3236125138,310,0.9185185185185185,1,0,1,2,FALSE,FALSE,FALSE
53,2021-11-12T23:47:17Z,2021-11-13T00:15:12Z,1674,1,2021-11-13T00:15:13Z,1,Chrome,95.0.4638.54,Windows NT 10.0,1536,864,NA,1.7777777777777777,813,128,399,102,59,131,0.06115281389697148,0.3469971436514023,-0.13722781824789776,-0.03145741503851823,-0.17879925829707183,0.43281425323604517,3,3,1,2,3,1,1,3,1,3,2,1,1,3,3,3,2,1,3,3,0.9333020044867296,0,1,3,3,2,1.75,0,4,4,5,3,4,3,3,3,3,2,1,4,3,4,3,3,4,2,3,2,2,2,3,0,4,0,0,4,4,4,4,4,4,4,4,4,1,4,1,3,4,4,4,4,3,1,1,1,4,1,1,1,4,4,2,1,1,1,4,2,1,1,1,1,3,2,1,1,1.4405120877920723,0.9611501047232549,2.625,0,1.75,0,2.7333333333333334,0,2,0,2.0833333333333335,0,2,0,1.2857142857142858,0,1,0,1.864864864864865,0,0,0,0,0.14874251719832501,0.24654020032568483,-0.5020371591262895,-0.12774847940030237,4,1,1,1,1,1,1,1,1,1.1338934190276817,1.7142857142857142,0,1,-0.4757826382709144,3,2,3,2,1,1,4,1,3,2,1,1.1126972805283737,2,0,4,7,3.8333333333333335,3.2559414990859232,1.5194825076544112,0,1.6203676619875336,2,4,3,4,4,3,4,4,2,3,2,4,3,4,3,2,3,2,4,2,0.8451542547285166,3.4,0,3.6,0,3.6,0,3.4,0,3.533333333333333,0,2,2,1,2,2,1,2,3,2,1,1,3,1,2,1,3,1,2,1,2,0.7163503994113789,1.65,0,"White, Caucasian, Anglo, European American",0,30,1,2,NA,1,2,6,veterinary tech,2,0,190,62,2,5,2,0,0,1,0,0,TRUE,TRUE,TRUE,TRUE,TRUE,3,0.9018787878715631,0.66,0.09536663714670683,3,0.6519781250059604,0.7917937499955296,1,1,0.016587829505509594,0.0270801702829205,3,0.8165062499959022,0.9725870967718863,1,0.96875,0.017733615443774633,0.043840710232521715,1.4164,0.4854,0.4408,1.1544,0.4843,0.5773,0.4703,1.4470121523333332,0.6219154309255,0.4335407009666667,3.4348,5.3722,0.3323,3.6455,0.3207,-40.6326,1.1282,3.6118,0.4838,2.4366,0.6044,0.8839,2.3960122173333334,2.930242551666667,4.482232355666667,0.3756425857333333,0.3835651245666667,1.347,4.0208,0.634,2.3009,0.7099,0.9593,0.103,0.557,0.406,0.008,1.43,178.75,2.764435241666667,4.189949429666667,2.459758776,0.4863384635333333,0.4232488335333333,104,0.3081481481481481,1,0,0,1,FALSE,FALSE,FALSE
54,2021-11-12T23:51:15Z,2021-11-13T00:16:00Z,1484,1,2021-11-13T00:16:01Z,1,Chrome,95.0.4638.69,Windows NT 10.0,1920,1080,NA,1.7777777777777777,626,58,324,77,71,75,-0.4193188183871753,-0.2889345382713561,-0.49829575331844694,-0.3361175783896071,-0.013054542654933752,-0.513102285371727,2,1,4,3,2,4,3,2,1,2,2,3,1,1,2,2,4,1,2,2,1.0052493799000692,0,0,2,4,4,2.8,0,2,2,4,3,2,3,1,4,2,1,5,2,3,3,5,2,1,1,1,1,4,4,3,0,2,0,0,5,4,5,5,5,5,5,5,5,1,5,5,2,5,1,5,5,5,5,5,5,4,1,1,1,2,1,1,1,1,1,3,5,4,1,3,3,1,2,2,2,1.7866707005467437,1.2649110640673518,2.125,0,1.75,0,3.2,0,1.1111111111111112,0,3.0833333333333335,0,1.1666666666666667,0,2.142857142857143,0,2.3333333333333335,0,2.108108108108108,0,0,0,0,-0.010962360430240004,0.33674868756994975,-0.5020371591262895,-0.0826442357781699,3,3,2,4,1,3,2,2,1,0.9759000729485332,2.857142857142857,0,1.5,0.3924486803574311,5,4,4,3,2,4,5,6,6,1,2,1.0690449676496976,3.2857142857142856,0,2.7142857142857144,3,3.8333333333333335,3.2559414990859232,-0.7395711320441822,0,-0.22619813465469363,2,2,2,3,2,2,5,2,2,4,1,4,2,5,5,2,5,2,5,2,1.52127765851133,2.2,0,4.4,0,4.4,0,4.4,0,4.4,0,2,2,4,1,3,4,4,2,3,4,3,2,2,4,4,3,3,4,4,3,0.9445132413883326,3.25,0,"White, Caucasian, Anglo, European American",0,27,1,2,NA,1,3,7,Teacher,4,0,230,65,1,5,2,0,0,0,0,0,TRUE,TRUE,TRUE,TRUE,TRUE,1,0.8644117647128947,0.68,0.07607939877499204,1,0.4668374999947846,0.5523099999944369,1,0.967741935483871,0.002843435966943177,0.004561914644226802,1,0.5748718750048428,0.6955677419343302,1,0.96875,0.00944902724620155,0.009736782568988267,1.4437,0.5469,0.4202,1.0969,0.5088,0.6016,0.4735,1.4674700743333333,0.661757144873,0.41425132396666664,1.7733,5.4729,0.3048,4.4087,0.3596,-74.245,0.7585,5.8954,0.4089,5.1638,0.4827,0.8936,1.6967503543333333,4.178637973666667,5.125911353666667,0.3595971162,0.3035138365,1.0435,4.7673,0.4549,3.0205,0.5556,0.8313,0.095,0.393,0.552,0.014,1.946,139,1.6090253335,4.738979498666667,3.2628302546666665,0.40837400986666667,0.45873684536666665,349,1.0340740740740741,1,0,0,1,FALSE,FALSE,FALSE
57,2021-11-12T23:53:14Z,2021-11-13T00:19:36Z,1581,1,2021-11-13T00:19:37Z,0.699999988079071,Safari,14.0.3,Macintosh,1440,900,NA,1.6,714,241,345,85,57,74,-0.19321452084169444,1.3735725730409982,-0.39719673149869317,-0.23862632611725865,-0.2064233775707615,-0.5299936521325801,1,2,3,3,1,2,3,2,1,4,1,3,3,2,2,1,2,1,2,1,0.9176629354822471,0,1,1,3,3,2.8,0,2,3,2,5,2,3,3,3,1,4,3,2,2,2,3,2,4,1,1,1,2,3,2,1,2,0,0,4,4,4,5,5,5,5,5,3,3,5,3,1,3,2,5,3,2,3,3,5,2,1,1,1,3,1,2,2,2,1,3,2,4,1,1,2,2,1,2,2,1.4488268009320848,0.9759000729485332,2,0,1.75,0,2.8,0,1.5555555555555556,0,2.5,0,1.6666666666666667,0,2.142857142857143,0,1.3333333333333333,0,2.027027027027027,0,1,0,0,-0.13914653852685102,0.07628619918548828,-0.2989446853297732,-0.11132924307214245,4,2,3,1,1,2,2,2,1,1.0690449676496976,1.8571428571428572,0,1.5,-0.20582161572857902,4,4,4,4,2,2,1,7,8,NA,3,1.2909944487358056,3.5714285714285716,0,2.4285714285714284,1.5,3.8333333333333335,3.2559414990859232,-1.5867162469311549,0,-0.8091126869410536,3,3,4,3,4,3,5,2,3,2,2,3,2,3,4,2,5,2,4,3,1.0690449676496976,3.4,0,3.8,0,3.8,0,3.4,0,3.6666666666666665,0,2,3,4,4,4,4,4,2,3,2,1,1,2,4,1,1,2,4,2,3,1.1821033884786185,2.85,0,"White, Caucasian, Anglo, European American",0,21,1,2,NA,1,3,4,student,1,0,95,59,2,5,2,0,1,1,0,1,TRUE,TRUE,TRUE,TRUE,TRUE,NA,NA,NA,NA,4,0.51865625,0.6203793103448236,1,0.9354838709677419,0.004310232862903826,0.00863549462365673,4,0.8501874999999995,0.907321428571426,1,0.9032258064516129,0.016765770161290088,0.028239090322580408,NA,NA,NA,NA,NA,NA,NA,NA,NA,NA,1.58,4.0968,0.3258,3.0244,0.3857,-51.353,0.87,5.4501,0.4457,3.5706,0.5075,0.9973,1.6879332976666668,3.155749364666667,4.2683469296666665,0.37507278066666666,0.3191684671,1.1309,3.0442,0.6725,2.6164,0.6895,0.9631,0.059,0.653,0.298,0.016,1.476,92.25,1.9785413606666666,3.6357436963333334,2.1004758701,0.5743013522666667,0.4867792529666667,422,1.2503703703703704,1,0,0,1,FALSE,FALSE,FALSE
58,2021-11-12T23:56:06Z,2021-11-13T00:20:40Z,1474,1,2021-11-13T00:20:41Z,1,Chrome,94.0.4606.71,Windows NT 10.0,1536,864,n/a (fun!),1.7777777777777777,609,87,403,128,84,68,-0.46299805768573404,-0.025477127189070508,-0.11797086171080182,0.28538915484661415,0.16650223262404917,-0.6313418526976985,2,3,3,3,1,2,4,1,3,2,1,4,2,2,2,1,4,1,1,1,1.0894228312566052,0,1,2,5,5,3.15,0,4,5,5,4,5,1,4,2,3,1,1,5,3,5,4,1,3,1,1,1,2,2,1,1,2,0,0,5,5,3,5,2,5,3,3,3,2,5,2,1,5,2,5,2,1,1,1,2,5,1,1,1,3,2,1,2,2,2,5,1,1,1,1,1,2,2,2,2,1.5744773669313188,1.5522640914238175,1.5,0,2,0,2.1333333333333333,0,2.2222222222222223,0,1.4166666666666667,0,1.3333333333333333,0,1.2857142857142858,0,1,0,1.5945945945945945,0,1,0,0,-0.7191274099147971,-0.6109243796066618,-0.22054348261253207,-0.41573393110959694,4,1,3,1,1,1,1,1,1,1.2535663410560174,1.4285714285714286,0,1,-0.6467170085812028,5,5,5,5,2,2,1,3,6,3,3,1.8126539343499315,4.142857142857143,0,1.8571428571428572,4.5,3.8333333333333335,3.2559414990859232,0.10757398284279028,0,-0.28065156173982786,2,2,3,4,3,2,5,3,2,2,2,4,2,4,4,1,5,1,4,5,1.4375905768565218,2.8,0,4.4,0,4,0,3.2,0,3.8666666666666667,0,1,1,3,1,3,3,2,2,3,3,1,2,4,3,2,2,2,4,4,3,0.998683343734455,2.75,0,"Hispanic of Latino (e.g., Mexican American, Central American, and others)",0,20,1,2,NA,1,3,4,Student,4,0,135,61,1,5,2,0,0,1,0,0,TRUE,TRUE,TRUE,TRUE,TRUE,6,0.7234405406230204,0.74,0.038229965715789786,6,0.3831225806820777,0.4575192307875707,1,0.8125,0.0020888138069012955,0.006254063186612552,6,0.49268387097697103,0.5421586206699239,0.96875,0.90625,0.011973963835913594,0.014282000223766625,1.3113,0.8549,0.3407,0.9866,1.372,0.5135,0.3959,1.3486189436666667,0.8858188657333333,0.3354082091,0.8855,5.1492000000000004,0.2971,1.8615,0.2925,-72.3285,0.6744,6.0852,0.3278,2.9745,0.3646,0.9937,0.9381643925666666,2.1838503922666668,5.113516572333333,0.2889988765,0.293482172,0.6735,13.2443,0.4544,3.1607,0.4693,0.769,0.066,0.27,0.275,0.032,2.061,64.40625,1.2401739116666666,2.946543619333333,2.2374949746,0.2853940972,0.29337516886666665,386,1.1437037037037037,1,0,0,1,FALSE,FALSE,FALSE
59,2021-11-13T00:07:49Z,2021-11-13T00:30:23Z,1354,1,2021-11-13T00:30:26Z,1,Chrome,95.0.4638.69,Windows NT 10.0,1368,912,NA,1.5,812,63,263,60,44,75,0.058583446879409196,-0.24351084670544482,-0.7919643405091602,-0.5432864894683475,-0.3859801528497444,-0.513102285371727,3,2,1,1,3,1,2,3,1,4,2,2,1,1,3,3,2,1,3,4,1.0399898784932577,0,1,2,3,4,1.65,0,5,5,2,4,1,1,3,1,1,1,1,5,2,4,3,1,1,1,1,1,1,1,1,0,2,0,0,5,3,5,5,4,4,4,5,5,2,4,1,1,4,1,5,1,1,1,1,2,5,1,1,1,1,1,1,1,1,1,5,1,1,1,1,1,1,1,1,1,1.7376764714754929,1.6388149028228556,1,0,1,0,1.5333333333333334,0,1.5555555555555556,0,1.3333333333333333,0,0.8333333333333334,0,0.8571428571428571,0,1,0,1.2432432432432432,0,0,0,0,-1.2486751620516177,-1.234640572527312,-0.7372407672780129,-0.9859406699026625,5,1,4,1,1,2,1,1,1,1.6761634196950514,1.2857142857142858,0,1,-0.7321841937363471,5,5,5,5,2,2,1,5,7,NA,3,1.8126539343499315,4.142857142857143,0,1.8571428571428572,3,3.8333333333333335,3.2559414990859232,-0.7395711320441822,0,-0.7042241191833141,1,1,1,1,1,1,5,1,1,1,1,4,1,4,4,3,5,2,4,1,1.6417180315870614,1,0,4.6,0,3.6,0,4.6,0,4.266666666666667,0,1,1,2,3,1,1,2,1,2,1,1,3,2,3,1,2,1,2,2,2,0.7326950970650465,1.8,0,"White, Caucasian, Anglo, European American",0,22,1,2,NA,1,3,6,Unemployed,5,0,190,66,2,5,2,0,0,1,0,0,TRUE,TRUE,TRUE,TRUE,TRUE,5,0.9045418604652635,0.8775510204081632,0.10710586593541711,5,0.4151437500001048,0.47052580645151676,1,1,0.0011058180241830453,0.0018090986451667391,5,0.577603124999965,0.6363129032259026,1,0.96875,0.009194512570612766,0.0077204099898932205,1.3572,1.3967,0.5849,1.2185,1.4821,0.5932,0.0375,NA,NA,NA,9.9987,16.5437,0.113,14.27,0.1202,-118.8504,0.7247,8.011,0.3718,6.6076,0.4188,0.9592,NA,NA,NA,NA,NA,1.0679,3.9373,0.4493,5.0999,0.5307,0.9995,0.068,0.395,0.392,0.016,1.6,100,NA,NA,NA,NA,NA,430,1.2740740740740741,1,0,0,1,FALSE,FALSE,FALSE
60,2021-11-12T23:58:37Z,2021-11-13T00:33:40Z,2103,1,2021-11-13T00:33:42Z,1,Edge,95.0.1020.44,Windows NT 10.0,1366,768,dd,1.7786458333333333,636,86,1061,76,52,110,-0.3936251482115524,-0.03456186550225277,3.0497984886414824,-0.3483039849236506,-0.2754836757549857,0.07809555125813061,2,2,2,2,2,2,4,1,2,4,1,2,1,1,3,3,2,2,2,2,0.8522416262267903,0,1,1,1,1,2.4,0,2,1,3,1,4,4,3,3,2,4,1,1,2,1,2,5,5,1,2,3,5,4,5,9,2,6,10,2,2,3,1,2,4,4,4,4,1,1,3,1,1,2,1,4,3,1,5,4,2,5,5,3,5,1,4,5,5,4,4,1,4,1,3,3,1,2,5,5,1.479083394433082,1.162919151265879,3.75,0,3.25,0,3.6,0,3.111111111111111,0,3.25,0,3.6666666666666665,0,3.4285714285714284,0,2.3333333333333335,0,3.2972972972972974,0,5,6,6,1.7394871535775827,1.7180419509421723,3.282329553112966,2.500185752027569,4,2,2,1,1,2,3,3,2,1.0690449676496976,2.142857142857143,0,2.5,0.33410042935609163,3,3,3,3,4,4,3,4,3,1,2,0.4879500364742666,3.2857142857142856,0,2.7142857142857144,5.5,3.8333333333333335,3.2559414990859232,0.6723373927674386,0,0.4797561277511168,4,4,4,5,4,2,3,4,2,3,2,2,3,2,4,3,1,2,2,2,0.8338093878327919,4.2,0,3,0,2.8,0,3.2,0,3,0,1,1,1,2,1,2,2,2,3,3,2,3,3,3,1,2,2,3,3,3,0.812727700887249,2.25,0,"Hispanic of Latino (e.g., Mexican American, Central American, and others) & White, Caucasian, Anglo, European American",1,19,1,2,NA,1,3,3,cashier,2,0,160,64,2,5,2,0,1,0,0,1,TRUE,TRUE,TRUE,TRUE,TRUE,5,1.107406666658322,0.6122448979591837,0.1857327301522096,NA,NA,NA,NA,NA,NA,NA,5,0.7611517241391642,0.857779166671137,0.90625,0.75,0.031319036843246835,0.04890713189926922,1.8164,0.2659,0.45,1.495,0.1378,0.7006,0.4956,1.7591840106666667,0.4039461461511633,0.44870698913333334,NA,NA,NA,NA,NA,NA,NA,NA,NA,NA,NA,NA,NA,NA,NA,NA,NA,0.9648,2.2648,0.5933,1.2793,0.6451,0.9559,0.066,0.497,0.212,0.002,0.913,456.5,1.6072134516666667,1.9119738446,0.8952170485676667,0.3689930306,0.3155674666666667,308,0.9125925925925925,1,0,0,1,FALSE,FALSE,FALSE
61,2021-11-13T00:08:35Z,2021-11-13T00:37:06Z,1710,1,2021-11-13T00:37:08Z,1,Chrome,95.0.4638.69,Macintosh,1440,900,NA,1.6,822,113,442,114,71,89,0.08427711705503202,0.21072606895366833,0.06978446452588374,0.11477946337000441,-0.013054542654933752,-0.27662315071978394,1,2,3,3,1,1,1,2,1,2,2,1,2,2,1,2,1,1,4,2,0.8506963092234007,0,1,2,4,5,2.35,0,5,5,2,5,2,1,5,2,1,1,1,4,2,4,4,1,1,1,1,1,1,1,1,0,2,0,0,5,5,5,5,5,5,5,5,5,1,5,1,1,5,1,5,1,1,1,1,1,5,1,1,1,2,1,1,1,1,1,5,1,1,1,1,1,1,1,1,1,1.9521298140264163,1.6676187756655838,1,0,1,0,1.4666666666666666,0,1,0,1,0,1,0,0.8571428571428571,0,1,0,1.027027027027027,0,0,0,0,-1.3831634800546193,-1.356209091817867,-0.7372407672780129,-1.04672492954794,5,1,4,2,1,1,1,1,1,1.6761634196950514,1.2857142857142858,0,1,-0.7321841937363471,5,5,5,5,3,3,1,6,7,6,4,1.5735915849388864,4.428571428571429,0,1.5714285714285714,2.5,3.8333333333333335,3.2559414990859232,-1.0219528370065065,0,-1.00475696650735,1,1,1,1,1,1,5,1,1,3,1,5,1,4,5,1,5,1,5,1,1.9148542155126762,1,0,5,0,4.6,0,4.8,0,4.8,0,1,1,1,2,2,1,1,4,1,1,2,2,1,3,1,3,1,2,1,2,0.8750939799154206,1.55,0,"White, Caucasian, Anglo, European American",0,28,1,2,NA,1,3,7,Analyst,3,0,140,65,3,5,2,0,0,0,0,0,TRUE,TRUE,TRUE,TRUE,TRUE,4,0.7025911764677834,0.68,0.027831511628053814,4,0.4604875000193715,0.5499593750163912,1,1,0.0017961830646547581,0.004696828942004317,4,0.6242406250052154,0.6744500000067055,1,1,0.005499767006397732,0.0040986735496946316,1.0696,0.7263,0.4542,0.8846,0.6535,0.5211,0.1314,1.1350546596666666,0.82286835507,0.4457217379333333,2.9433,9.1967,0.3005,6.7355,0.3315,-98.8617,0.8117,6.8922,0.4037,4.8644,0.4695,0.9727,1.5850687698,4.748598695,6.297285899666667,0.3875813645333333,0.34077740916666666,0.8934,4.7707,0.5318,4.9873,0.5842,0.8597,0.079,0.496,0.602,0.029,1.546,53.310344827586206,2.2348551706666666,5.149429342333334,5.6482741763333335,0.4122981706,0.48635364123333336,382,1.1318518518518519,1,0,0,1,FALSE,FALSE,FALSE
62,2021-11-13T00:12:53Z,2021-11-13T00:37:07Z,1453,1,2021-11-13T00:37:08Z,0.8999999761581421,Chrome,94.0.4606.71,Windows NT 10.0,1366,768,NA,1.7786458333333333,768,57,320,58,80,83,-0.05446870189333121,-0.2980192765845384,-0.5175527098555429,-0.5676593025364346,0.1112539940766698,-0.3779713512849024,3,2,3,3,2,2,1,2,1,2,2,2,1,2,2,1,2,1,2,2,0.6407232755171874,0,1,4,2,3,2.4,0,3,4,2,4,2,2,5,2,2,2,4,4,1,4,5,2,4,1,1,1,2,2,1,2,2,0,0,5,3,5,5,5,4,5,5,4,3,4,2,1,5,5,5,2,2,2,4,3,3,1,1,1,2,2,2,3,1,1,4,4,3,3,4,1,2,2,2,2,1.4678741957860881,1.2798809468443688,1.75,0,2,0,2,0,1.4444444444444444,0,2.3333333333333335,0,1.5,0,2.142857142857143,0,2.6666666666666665,0,2.027027027027027,0,1,0,0,-0.29464865621782205,-0.3749498174805686,-0.22054348261253207,-0.2977466500465503,3,2,4,2,1,2,1,1,1,1.0690449676496976,1.8571428571428572,0,1,-0.39031545311577004,4,5,4,5,3,2,2,6,6,NA,3,1.2724180205607036,3.857142857142857,0,2.142857142857143,3,3.8333333333333335,3.2559414990859232,-0.7395711320441822,0,-0.5448821243404407,3,2,4,4,3,3,4,2,2,3,1,3,4,2,3,5,3,2,2,3,1.01418510567422,3.2,0,3.6,0,2.4,0,3.2,0,3.066666666666667,0,3,4,3,2,3,4,3,1,2,2,4,3,4,3,1,2,1,2,1,4,1.0954451150103321,2.8,0,"Asian or Asian American (e.g., Chinese, Japanese, and others) & Filipino",1,24,1,2,NA,1,2,6,NA,1,0,181,67,1,5,2,0,0,2,0,0,TRUE,TRUE,TRUE,TRUE,TRUE,6,0.7254444444444444,0.7346938775510204,0.050971701238056916,6,0.4236433333158493,0.5012566666682561,0.967741935483871,0.9375,0.00329592761208767,0.003791499962449304,6,0.5211093749925494,0.5926892857381276,1,0.9032258064516129,0.005877547329066022,0.008462406793369712,1.1715,0.9127,0.4431,0.8131,1.0601,0.5672,0.211,1.2305777317666666,0.9278675861233333,0.4347632684666667,1.0594,4.9103,0.3201,3.002,0.3433,-75.0577,0.6579,7.9202,0.3744,6.6113,0.4476,0.8649,1.1461112169666667,3.2366249186666667,4.948672354666667,0.33831835926666665,0.3140558125,0.8492,4.5969,0.4384,3.5664,0.4808,0.9751,0.07,0.344,0.41,0.016,1.834,114.625,1.3218406943333334,3.844704858666667,2.7380243933333333,0.3475884351333333,0.3839759093,348,1.031111111111111,1,0,0,1,FALSE,FALSE,FALSE
63,2021-11-13T00:10:34Z,2021-11-13T00:38:28Z,1673,1,2021-11-13T00:38:30Z,1,Chrome,95.0.4638.69,Windows NT 10.0,1280,720,all its ok,1.7777777777777777,786,83,373,98,51,140,-0.008220095577210136,-0.06181608044179956,-0.2623980357390215,-0.08020304117469244,-0.28929573539183057,0.5848365540837228,3,4,2,2,4,1,1,3,1,4,4,1,1,1,4,4,1,1,4,4,1.3954814298487213,0,1,1,5,5,1.2,0,3,4,2,4,3,2,4,2,1,1,4,4,1,4,3,1,2,3,1,1,2,3,3,0,2,0,0,5,4,4,5,4,5,3,3,3,2,5,1,1,4,2,5,3,2,1,4,2,4,1,1,1,3,1,1,1,3,1,4,2,2,1,1,1,3,2,2,2,1.4806053465364064,1.2071217242444348,2,0,2.25,0,2.1333333333333333,0,2,0,1.8333333333333333,0,1.3333333333333333,0,1.5714285714285714,0,1,0,1.7297297297297298,0,0,0,0,-0.3240679757809788,-0.33797595253710344,-0.34523475369180734,-0.3416053531144554,5,2,3,1,1,1,1,2,2,1.5275252316519468,1.4285714285714286,0,2,-0.2777293338068208,3,4,4,5,2,2,3,3,1,1,2,1.1126972805283737,3.2857142857142856,0,2.7142857142857144,7,3.8333333333333335,3.2559414990859232,1.5194825076544112,0,0.903328685194603,2,2,2,2,2,2,3,2,2,3,4,4,2,4,4,2,3,2,4,2,0.9154754164341269,2,0,3.4,0,3.6,0,4,0,3.6666666666666665,0,1,1,1,3,3,1,3,1,1,1,1,4,2,2,1,4,1,2,1,2,1.0563093645728086,1.6,0,Native American/Alaskan Native/indigenous,0,21,0,1,NA,1,3,4,Student,2,0,183,70,4,5,2,0,0,1,0,0,TRUE,TRUE,TRUE,TRUE,TRUE,6,0.9433666666646798,0.72,0.09967656491554432,6,0.5061156249940395,0.566456666670243,1,0.967741935483871,0.0020398194252397557,0.002177332258386548,6,0.6687033333321413,0.7254281250108033,0.9375,1,0.006163326521906345,0.00808563434556498,1.6254,0.599,0.3008,1.2618,0.9284,0.5713,0.649,1.5967511896666666,0.6787329795966667,0.30394347893333334,1.4681,5.9282,0.3823,5.1053,0.4317,-91.4442,0.7835,5.4832,0.4397,5.7304,0.4992,0.9471,1.5161020967,4.768178470666666,5.601754931,0.4218913301,0.374768393,1.0821,3.3487,0.521,3.4441,0.586,0.9826,0.063,0.53,0.432,0.026,1.522,58.53846153846154,1.5595633789666667,3.804584574666667,3.4951339723333334,0.4873414677333333,0.5030925427,350,1.0370370370370372,1,0,1,2,FALSE,FALSE,FALSE
64,2021-11-13T00:21:15Z,2021-11-13T00:40:13Z,1138,1,2021-11-13T00:40:13Z,1,Chrome,95.0.4638.69,Macintosh,1440,900,NA,1.6,598,53,301,57,35,62,-0.49126109487891917,-0.33435822983726743,-0.6090232534067487,-0.5798457090704782,-0.510288689581348,-0.732690053262817,3,3,2,1,3,1,1,2,2,3,2,3,3,1,3,3,2,1,2,2,0.812727700887249,0,1,2,3,3,2.05,0,4,5,2,5,2,1,4,1,1,1,1,5,1,5,4,2,3,1,1,1,2,1,1,1,2,0,0,5,5,5,5,5,5,5,5,5,1,4,1,1,5,1,5,1,1,2,3,1,4,1,1,1,3,2,1,2,2,1,5,1,1,1,1,1,1,1,1,1,1.8112925718339323,1.780850519113991,1.5,0,1,0,1.3333333333333333,0,1,0,1.3333333333333333,0,1.5,0,1.1428571428571428,0,1,0,1.2702702702702702,0,1,0,0,-0.9208598869193001,-1.0941011696531993,-0.5341482934814965,-0.8141247315673479,5,1,5,1,1,1,1,1,1,1.9518001458970664,1,0,1,-0.9031185640466358,5,5,5,5,3,2,1,6,7,5,4,1.7043362064926932,4.285714285714286,0,1.7142857142857142,2.5,3.8333333333333335,3.2559414990859232,-1.0219528370065065,0,-0.9250859690859132,2,2,2,3,2,2,4,2,2,2,1,4,3,4,3,2,5,3,4,3,1.0997835284835873,2.2,0,4.2,0,3.4,0,3.6,0,3.7333333333333334,0,2,1,1,3,2,1,1,2,1,2,2,4,2,2,1,4,2,2,2,2,0.8870412083230169,1.65,0,Prefer not to say,0,22,1,2,NA,1,4,6,Model,1,0,140,64,3,5,2,0,0,0,0,0,TRUE,TRUE,TRUE,TRUE,TRUE,NA,NA,NA,NA,6,0.4675906249999534,0.5547099999999627,1,0.9375,0.004580473780235238,0.00668766611897372,6,0.6511516129032618,0.727343333333296,1,0.967741935483871,0.011695599247325588,0.014382498494638409,NA,NA,NA,NA,NA,NA,NA,NA,NA,NA,1.2691,4.6755,0.3319,3.251,0.3795,-70.345,0.8729,5.5231,0.3887,5.1504,0.4596,0.9942,1.3866703943666667,3.434109658666667,4.802566503666666,0.37090195756666666,0.32389155496666666,1.0167,2.6215,0.5036,3.4565,0.5786,0.9611,0.064,0.497,0.422,0.02,1.689,84.45,1.8242913783333334,3.915623623666667,3.6226299433333335,0.41707886006666667,0.48944749833333334,104,0.3081481481481481,1,1,5,6,FALSE,FALSE,FALSE
65,2021-11-13T00:08:00Z,2021-11-13T00:41:26Z,2005,1,2021-11-13T00:41:27Z,1,Chrome,95.0.4638.69,Windows NT 10.0,1920,1080,NA,1.7777777777777777,738,83,559,171,79,130,-0.13154971242019967,-0.06181608044179956,0.6330504432359404,0.8094046358104869,0.09744193443982496,0.4159228864751921,3,2,1,2,1,1,2,2,1,2,3,1,1,1,2,1,2,2,1,2,0.6708203932499369,1,1,2,3,2,2.25,0,2,3,3,3,2,2,4,2,2,1,1,5,1,4,3,2,2,5,1,2,2,2,3,1,4,0,0,4,3,4,4,4,3,3,5,3,2,3,1,1,4,4,5,3,5,1,5,2,3,1,3,1,2,1,2,2,1,1,5,1,2,1,1,1,3,3,2,2,1.4405120877920723,1.1872336794093274,2.375,0,2.5,0,2.1333333333333333,0,2.3333333333333335,0,2.5,0,1.6666666666666667,0,1.2857142857142858,0,1,0,2.027027027027027,0,1,0,0,0.09410663800960553,-0.0490571387773049,-0.06374107717804986,-0.05639910797767738,5,1,1,1,1,1,1,1,2,1.5118578920369088,1.5714285714285714,0,1.5,-0.3767559860388676,4,4,5,4,1,1,2,8,8,3,4,1.632993161855452,3.2857142857142856,0,2.7142857142857144,1,3.8333333333333335,3.2559414990859232,-1.869097951893479,0,-0.7909615445793421,2,2,3,3,3,3,4,2,3,3,4,3,2,4,4,1,3,3,3,4,0.8837151016885368,2.6,0,2.8,0,3.8,0,3.4,0,3.3333333333333335,0,1,3,2,2,3,2,3,1,1,1,2,2,1,1,1,2,1,3,1,3,0.8335087534664907,2.1,0,"White, Caucasian, Anglo, European American",0,22,0,1,NA,1,3,7,unemployed,2,0,190,73,3,5,2,0,0,1,0,0,TRUE,TRUE,TRUE,TRUE,TRUE,2,0.9394512195143758,0.82,0.08001829381210249,2,0.4517593750022352,0.5119838709715874,1,0.96875,0.004085450231647294,0.010013242862749764,2,0.8318733333359162,1.220229032259795,0.9375,0.96875,0.028881059355110043,0.20017350692142483,1.5389,1.0872,0.5196,1.3529,1.1142,0.5586,0.0975,1.5783165576666667,0.9896350470333334,0.4639081681,1.5009,5.1353,0.3056,3.4739,0.3043,-69.7033,1.1433,5.3753,0.3465,3.4984,0.3548,0.9479,1.5175000789333333,3.5370487323333335,5.014262556333334,0.3038661752,0.30209214533333334,1.9496,2.8038,0.48,1.1906,0.6079,0.9963,0.096,0.471,0.163,0.015,2.004,133.6,2.26628077,2.5610826103333335,1.4585885649,0.42437153046666665,0.45110615416666666,310,0.9185185185185185,1,1,0,1,FALSE,FALSE,FALSE
66,2021-11-12T23:57:52Z,2021-11-13T00:48:39Z,3047,1,2021-11-13T00:48:40Z,1,Chrome,95.0.4638.69,Windows NT 10.0,1366,768,No I do not have any other feedback.,1.7786458333333333,1193,129,844,539,85,138,1.0375122805706387,0.35608188196458457,2.0051085965040274,5.294002240338515,0.18031429226089402,0.5510538205620167,2,2,3,1,2,3,3,2,1,3,2,1,1,3,2,2,2,1,2,2,0.7254762501100116,0,0,3,2,2,2.4,0,2,3,4,4,3,4,2,4,3,4,4,2,3,2,4,5,5,5,2,5,5,5,4,7,2,20,15,4,3,3,4,4,4,4,5,2,2,2,5,3,2,4,4,2,5,5,5,5,1,4,5,4,4,2,4,3,4,4,4,2,2,2,2,5,3,5,5,4,1.1930731006201687,0.8618916073713346,4.5,0,4.25,0,3.466666666666667,0,2.3333333333333335,0,3.8333333333333335,0,3.8333333333333335,0,2.857142857142857,0,3,0,3.27027027027027,0,4,6,6,2.1891824669001205,1.9714387530939819,3.3928418901854136,2.6821403216396975,4,2,4,2,1,1,1,8,3,1.3451854182690985,1.5714285714285714,0,5.5,1.099194713058661,3,3,3,3,1,2,3,3,2,2,3,0.7867957924694432,2.5714285714285716,0,3.4285714285714284,6.5,3.8333333333333335,3.2559414990859232,1.237100802692087,0,1.1604928198206246,4,4,3,2,3,3,4,2,1,2,1,3,4,4,4,4,2,2,4,2,1.1464230084422218,3.2,0,3.4,0,2.8,0,4.2,0,3.466666666666667,0,2,4,3,1,3,4,3,2,3,3,4,2,3,4,3,1,4,4,4,3,0.9733285267845752,3.4,0,"White, Caucasian, Anglo, European American",0,30,1,2,NA,1,1,4,Stay at home mom,2,0,130,68,1,5,2,0,1,2,0,1,TRUE,TRUE,TRUE,TRUE,TRUE,NA,NA,NA,NA,5,0.5874343750011176,0.6548000000012107,1,1,0.029133753941519586,0.013628842580329661,5,0.6054531250009313,0.7220218749996274,1,1,0.0043332574092732265,0.013088323054601796,NA,NA,NA,NA,NA,NA,NA,NA,NA,NA,1.7764,3.3006,0.3183,3.7479,0.4178,-46.6979,1.2832,2.7459,0.3612,4.0165,0.4911,0.9604,1.902029969,3.7734292083333334,3.5111018143333332,0.40246747726666665,0.3092899017333333,1.1308,5.9938,0.5116,3.0843,0.5544,0.9819,0.096,0.421,0.498,0.015,1.608,107.20000000000002,2.2774638273333334,5.631743218666666,4.159134555666666,0.4099250724,0.4530533675333333,392,1.1614814814814816,1,0,0,1,FALSE,FALSE,FALSE
68,2021-11-13T00:28:58Z,2021-11-13T00:50:22Z,1283,1,2021-11-13T00:50:23Z,1,Chrome,95.0.4638.69,Macintosh,1440,900,NA,1.6,661,62,268,91,56,70,-0.3293909727724954,-0.2525955850186271,-0.7678931448377903,-0.1655078869129973,-0.22023543720760635,-0.5975591191759924,2,3,3,2,2,3,3,2,1,3,3,3,3,2,2,2,2,1,3,3,0.6805570473787206,0,0,3,4,3,2.4,0,4,5,2,5,1,1,5,1,1,1,1,5,2,4,5,1,1,1,1,1,1,1,1,0,2,0,0,5,5,5,5,5,5,5,5,5,1,5,1,1,4,1,5,1,1,1,1,1,5,1,1,1,1,1,1,1,1,1,5,1,1,1,1,1,1,1,1,1,1.9382354750537296,1.8464895909600492,1,0,1,0,1.2666666666666666,0,1,0,1.0833333333333333,0,0.8333333333333334,0,0.8571428571428571,0,1,0,1.027027027027027,0,0,0,0,-1.3831634800546193,-1.4421588092780684,-0.7372407672780129,-1.0896997882780406,5,1,3,1,1,2,1,1,1,1.5275252316519468,1.4285714285714286,0,1,-0.6467170085812028,5,5,5,5,3,3,1,7,7,NA,3,1.5735915849388864,4.428571428571429,0,1.5714285714285714,2,3.8333333333333335,3.2559414990859232,-1.3043345419688306,0,-1.145947818988512,2,2,2,3,2,3,4,3,2,2,2,4,3,3,3,4,4,3,3,3,0.7037315505489968,2.2,0,3.6,0,2.8,0,3.2,0,3.2,0,1,1,2,4,1,2,1,3,1,1,2,3,2,1,2,4,1,2,2,1,0.9880869341680844,1.45,0,"White, Caucasian, Anglo, European American",0,21,1,3,NA,1,3,4,student,7,0,115,60,2,5,2,0,0,1,0,0,TRUE,TRUE,TRUE,TRUE,TRUE,3,0.7934558823529412,0.6938775510204082,0.03729466588285492,3,0.4442000000106877,0.5149935483874813,1,0.96875,0.003646572857310007,0.005945992569507244,3,0.6106656250059604,0.6949419354834864,1,0.96875,0.0176954500718404,0.017014306088015182,1.3174,0.6663,0.4004,0.9489,0.9616,0.58,0.3656,1.360222081,0.7625895826366667,0.3939045688,1.5204,4.522,0.2761,4.1712,0.3414,-67.4062,0.898,6.5087,0.377,4.3569,0.4157,0.97,1.5458171114,4.113253315,4.544266859333334,0.33770158,0.27374305353333334,1.142,2.3799,0.4218,3.97,0.5513,0.903,0.079,0.361,0.303,0.014,1.775,126.78571428571428,2.0040283943333335,3.283813400666667,3.1484828363333333,0.2995189379666667,0.3904784212333333,434,1.285925925925926,1,0,0,1,FALSE,FALSE,FALSE
69,2021-11-13T00:17:39Z,2021-11-13T00:51:23Z,2023,1,2021-11-13T00:51:23Z,1,Chrome,95.0.4638.69,Windows NT 10.0,1536,864,"No, it was great.",1.7777777777777777,831,112,608,105,95,149,0.10740142021309255,0.20164133064048606,0.8689481608153659,0.0051018045636124325,0.3184348886293424,0.7368588549314005,4,4,1,2,4,1,2,3,1,3,3,1,1,1,4,3,2,1,4,4,1.2763022245616642,0,1,1,5,4,1.35,0,4,4,3,3,4,3,3,2,2,3,2,3,3,3,2,3,4,5,1,2,3,3,3,7,2,1,1,3,1,3,3,2,2,1,1,3,3,4,2,1,3,2,4,5,5,4,3,3,1,1,1,2,3,3,1,5,5,5,5,1,4,1,3,1,3,4,4,4,1.4311002927985332,0.7037315505489968,3,0,3.75,0,2.8,0,3.888888888888889,0,2.9166666666666665,0,2.3333333333333335,0,3,0,1.6666666666666667,0,3.027027027027027,0,4,1,1,1.1048704030009173,0.9357833737875021,1.3206252122899094,1.1282042930387057,4,2,4,1,1,1,1,1,1,1.4142135623730951,1.4285714285714286,0,1,-0.6467170085812028,4,3,5,5,1,1,3,3,7,3,2,1.6761634196950514,3.142857142857143,0,2.857142857142857,4,3.8333333333333335,3.2559414990859232,-0.1748077221195339,0,0.13585456772906723,3,2,2,3,2,3,4,4,2,4,2,2,1,3,4,1,5,1,5,2,1.4074631010979937,2.4,0,3.8,0,4.6,0,3.4,0,3.933333333333333,0,3,4,2,3,2,2,3,3,3,1,2,3,3,3,2,3,1,2,2,3,0.7608859102526822,2.3,0,"White, Caucasian, Anglo, European American",0,27,1,2,NA,1,3,6,"Student, English teacher",2,0,112,62,2,5,2,0,0,1,0,0,TRUE,TRUE,TRUE,TRUE,TRUE,2,1.3508108695797298,0.92,0.17821716056586864,2,0.5335499999523163,0.5685718750208616,1,1,0.0036574477425243006,0.0018312330512520382,2,0.6140031250566244,0.7716599999427796,1,0.9375,0.008059516428429022,0.015498375708348363,2.0297,1.2538,0.6662,1.8789,1.4815,0.7732,0.7412,1.856993329,1.0926252782333334,0.665679868,5.5767,9.1896,0.2301,11.5037,0.3262,-101.7411,0.7836,4.4555,0.4575,5.9672,0.5077,0.9977,1.8102768030666667,6.125712767,5.382519492666667,0.42937186466666666,0.36879380463333333,1.3204,5.9832,0.5015,3.4127,0.5838,0.9617,0.086,0.452,0.551,0.01,1.742,174.2,1.851849675,4.5468497076666665,2.6238919156666665,0.4122708102666667,0.4412958153,376,1.114074074074074,1,0,0,1,FALSE,FALSE,FALSE
70,2021-11-13T00:27:47Z,2021-11-13T00:53:43Z,1555,1,2021-11-13T00:53:44Z,0.8999999761581421,Chrome,85.0.4183.102,Macintosh,1440,900,n/a,1.6,768,73,319,41,148,129,-0.05446870189333121,-0.15266346357362218,-0.5223669489898168,-0.7748282136151751,1.050474049382119,0.39903151971433903,2,2,3,3,2,1,3,2,2,2,2,2,3,1,2,2,3,1,2,2,0.6407232755171874,0,0,4,3,2,2.6,0,3,3,3,3,3,1,3,2,2,2,3,5,4,4,4,2,2,1,1,1,1,1,1,2,2,0,0,4,4,4,4,4,5,5,4,4,2,4,3,3,3,3,3,3,2,4,4,4,5,5,1,1,1,1,1,1,1,1,5,1,1,1,1,1,1,1,1,1,1.5245734893157248,1,1.25,0,1,0,2.466666666666667,0,1.7777777777777777,0,3,0,1.5,0,0.8571428571428571,0,1,0,1.945945945945946,0,1,0,0,-0.6560860108508899,-0.42411925044203497,-0.5341482934814965,-0.47913377196176576,5,1,3,2,1,3,3,4,1,1.3972762620115438,2,0,2.5,0.24863324420094737,5,5,5,5,3,3,1,5,5,6,4,1.5735915849388864,4.428571428571429,0,1.5714285714285714,4,3.8333333333333335,3.2559414990859232,-0.1748077221195339,0,-0.5811844090638635,1,2,2,4,4,2,4,3,3,3,3,3,3,3,3,4,3,4,4,3,0.560611910581388,2.6,0,3,0,3.2,0,3,0,3.066666666666667,0,3,1,1,3,2,1,2,3,1,2,2,3,1,2,1,3,1,2,2,2,0.7880689256524124,1.7,0,"White, Caucasian, Anglo, European American",0,18,0,1,NA,1,4,3,Unemployed,7,0,165,72,3,5,3,0,0,2,1,0,TRUE,TRUE,TRUE,TRUE,TRUE,2,1.045731818179995,0.7333333333333333,0.1981721780430064,2,0.4263118749968271,0.5225154838671217,1,0.96875,0.0019436104355094708,0.010823585382358232,2,0.7554538709678567,0.8769028124934266,1,1,0.17193776667564417,0.11310529960628485,1.487,0.6885,0.517,1.4278,0.807,0.5314,0.5031,1.512084584,0.7599727505666667,0.5068274609333333,1.3412,7.2563,0.3339,3.0878,0.3136,-84.3361,1.3169,8.2652,0.3422,4.6202,0.3726,0.9039,1.3483892565666666,3.170030488,6.405729660333333,0.3131732969666667,0.3272337236333333,1.5349,3.0983,0.4213,2.2364,0.5149,0.6491,0.125,0.311,0.329,0.004,1.027,256.75,2.460773845333333,2.6104175376666667,2.218167975,0.2696555834666667,0.31011679733333336,440,1.3037037037037038,1,0,0,1,FALSE,FALSE,FALSE
71,2021-11-13T00:34:17Z,2021-11-13T00:54:03Z,1185,1,2021-11-13T00:54:05Z,1,Chrome,95.0.4638.69,Windows NT 10.0,1280,720,I was a little confused if when it asked me about the number of romantic partners my mom or dad had before I was 13 if this referred to their total number of romantic partners in their life before I hit 13 or the number of romantic partners when I was aged 0-13,1.7777777777777777,612,39,250,89,39,55,-0.4552899566330472,-0.46154456622181916,-0.8545494492547221,-0.18988069998108442,-0.4550404510339686,-0.8509296205887885,2,3,2,2,2,1,2,2,1,3,2,1,1,2,2,2,1,2,2,3,0.6407232755171874,0,1,1,4,4,2.1,0,2,5,3,5,3,3,4,3,2,2,2,4,2,3,3,2,2,1,3,2,1,4,2,1,2,0,0,4,4,5,4,4,5,5,5,5,2,4,1,1,5,2,5,1,2,2,2,2,4,1,1,1,3,1,1,3,1,1,5,1,1,1,3,1,2,2,1,1,1.633912381270694,1.0327955589886444,2.125,0,1.5,0,2.4,0,1.4444444444444444,0,1.5833333333333333,0,1.3333333333333333,0,1.1428571428571428,0,1.6666666666666667,0,1.4864864864864864,0,1,0,0,-0.39761627468887056,-0.2741911959985085,-0.3773458880470143,-0.3257685420227614,5,2,4,1,1,1,1,1,1,1.6761634196950514,1.2857142857142858,0,1,-0.7321841937363471,4,5,5,5,2,3,3,7,7,5,3,1.2149857925879117,3.857142857142857,0,2.142857142857143,2,3.8333333333333335,3.2559414990859232,-1.3043345419688306,0,-0.827263829302765,2,2,2,3,3,2,4,2,2,3,1,4,4,4,5,2,4,2,4,3,1.162919151265879,2.4,0,4.2,0,3.4,0,4,0,3.8666666666666667,0,2,1,2,4,2,2,2,3,1,1,3,3,2,2,1,3,2,2,1,2,0.8255779474818965,1.75,0,"White, Caucasian, Anglo, European American",0,22,1,2,NA,1,3,4,Student,1,0,138,70,3,5,2,0,0,0,0,0,TRUE,TRUE,TRUE,TRUE,TRUE,6,0.8102540540542151,0.74,0.03912425387767074,6,0.47694193548252506,0.5965655172415848,0.96875,0.9666666666666667,0.006830527701881968,0.009846476091575747,6,0.6439812499973923,0.6538419354856014,1,1,0.013102251895646604,0.004608145849591081,1.4163,0.7853,0.3954,0.9921,0.9406,0.6167,0.2976,1.442460425,0.8320913116266667,0.38966907716666666,1.309,3.6414,0.3045,3.2409,0.4027,-55.8512,1.2005,4.8957,0.3569,4.4647,0.455,0.9292,1.4420209459666666,3.441821695,3.921445942666667,0.3925472864,0.29659306116666667,1.0249,4.3379,0.5167,5.1363,0.5622,0.9823,0.123,0.439,0.638,0.036,1.476,41,2.471778666666667,4.804885075333333,4.906114142,0.3901729993,0.40969906316666665,362,1.0725925925925925,1,0,0,1,FALSE,FALSE,FALSE
72,2021-11-13T00:27:03Z,2021-11-13T00:55:43Z,1720,1,2021-11-13T00:55:48Z,1,Chrome,95.0.4638.69,Windows NT 10.0,1536,1024,NA,1.5,833,69,449,168,51,82,0.11254015424821712,-0.18900241682635124,0.10348413846580166,0.7728454162083563,-0.28929573539183057,-0.39486271804575546,2,3,1,3,2,1,1,2,1,3,3,1,2,1,3,3,1,1,2,3,0.8870412083230169,1,1,5,4,3,1.85,0,3,5,3,4,4,1,2,1,1,1,1,4,1,4,4,1,2,1,1,1,1,1,2,2,2,1,4,4,3,5,5,5,5,5,5,5,2,5,1,1,5,1,1,1,2,2,3,3,5,4,1,1,2,1,1,3,3,1,5,1,1,1,1,1,1,1,2,2,1.7264068119885534,1.5023790657297036,1.25,0,1.5,0,1.9333333333333333,0,1.3333333333333333,0,1.9166666666666667,0,1.5,0,1.4285714285714286,0,1,0,1.5945945945945945,0,1,1,4,-0.8746295276057681,-0.8043112438921151,0.5350859071427324,-0.13461266837469132,5,1,4,1,1,1,1,2,2,1.7320508075688772,1.1428571428571428,0,2,-0.44866370411710943,5,5,5,5,4,4,2,3,4,3,3,1.1126972805283737,4.571428571428571,0,1.4285714285714286,5.5,3.8333333333333335,3.2559414990859232,0.6723373927674386,0,-0.23728284904181396,2,2,2,2,2,2,5,2,2,3,1,4,3,4,5,3,4,2,4,2,1.2227992865708155,2,0,4.2,0,3.6,0,4.2,0,4,0,2,2,3,2,1,3,3,2,3,2,3,2,2,2,1,2,3,3,1,3,0.7163503994113789,2.45,0,"White, Caucasian, Anglo, European American",0,30,1,2,NA,1,2,3,Housewife,2,0,187,62,1,5,2,0,1,2,0,1,TRUE,TRUE,TRUE,TRUE,TRUE,5,0.8898217391301271,0.9387755102040817,0.037532288418429,5,0.5991531250004191,0.6713968750002095,1,1,0.0072620032157143044,0.004783530635104136,5,0.7343781250003958,0.7715968750001629,1,1,0.009577992086679952,0.014504240957706823,1.4895,2.0421,0.5712,1.4934,5.5131,0.7295,0.3776,1.4251551096666666,1.5152222567666667,0.5642508045333333,1.6727,5.1875,0.4379,5.5042,0.5195,-85.5806,0.9505,4.5687,0.49370000000000003,6.0663,0.587,0.9193,2.0096515713333334,5.234395170333333,5.19100698,0.4852337945333333,0.4081062555666667,1.0116,4.0091,0.6248,3.3718,0.6324,0.8271,0.276,0.273,0.586,0.039,1.349,34.58974358974359,3.107424512,4.535729018666666,4.1420968763333335,0.39325327243333336,0.4008068213,519,1.5377777777777777,1,0,0,1,FALSE,FALSE,FALSE
73,2021-11-13T00:37:31Z,2021-11-13T00:57:16Z,1184,1,2021-11-13T00:57:16Z,1,Chrome,95.0.4638.69,Windows NT 10.0,1920,1080,N/A,1.7777777777777777,656,37,275,67,45,62,-0.3422378078603068,-0.47971404284818364,-0.7341934708978723,-0.45798164373004263,-0.37216809321289956,-0.732690053262817,3,3,2,1,3,1,1,3,1,2,2,1,1,1,3,3,1,1,2,2,0.8750939799154206,0,1,3,3,3,1.75,0,4,5,3,4,1,1,4,1,1,1,2,3,1,4,3,2,1,1,1,1,1,1,2,0,2,0,0,5,1,2,4,4,5,5,5,5,2,5,1,1,4,2,5,1,1,2,3,3,4,1,1,1,1,1,1,1,1,1,4,2,2,1,1,1,1,1,1,1,1.6251588048991217,1.4573295865416045,1.25,0,1,0,1.7333333333333334,0,2,0,1.6666666666666667,0,1,0,1.2857142857142858,0,1,0,1.5675675675675675,0,0,0,0,-0.8914405673561434,-0.9018757880361272,-0.7372407672780129,-0.81955827765707,5,1,5,1,1,1,1,1,1,1.9518001458970664,1,0,1,-0.9031185640466358,5,5,5,5,3,2,1,7,6,6,4,1.7043362064926932,4.285714285714286,0,1.7142857142857142,2.5,3.8333333333333335,3.2559414990859232,-1.0219528370065065,0,-0.9250859690859132,2,2,2,1,2,1,4,3,1,5,1,4,1,4,4,1,4,2,3,4,1.4735767952260144,1.8,0,4.4,0,4.4,0,3.6,0,4.133333333333334,0,1,2,1,4,1,1,2,1,1,1,1,3,1,2,2,2,1,1,1,1,0.8271701918685112,1.5,0,"White, Caucasian, Anglo, European American",0,24,0,1,NA,1,4,6,Software Engineer,6,0,125,69,1,5,2,0,0,0,0,0,TRUE,TRUE,TRUE,TRUE,TRUE,6,0.9425463414642868,0.8367346938775511,0.042435825349207784,6,0.38460937500000003,0.4423766666680574,1,1,0.001639010554375649,0.0035681721958764076,6,0.5709624999975785,0.6194387096791498,1,0.96875,0.016095947580796605,0.00418458031282337,1.3903,1.2792,0.5811,1.0089,1.8289,0.725,0.273,1.4201449143333333,1.1422516252333332,0.5705617534333334,2.0656,8.7521,0.2666,6.7902,0.2903,-106.9036,0.8829,7.8693,0.3283,6.1465,0.3716,0.9412,1.3063622945,5.047443453,6.268069494,0.318856705,0.2865568788,1.1667,3.4653,0.4041,6.0989,0.5198,0.985,0.074,0.38,0.411,0.028,2.111,75.39285714285715,1.5233891858,3.516322131,4.448271259333334,0.3501686224666667,0.463277828,320,0.9481481481481481,1,0,2,3,FALSE,FALSE,FALSE
74,2021-11-13T00:31:43Z,2021-11-13T00:57:50Z,1567,1,2021-11-13T00:57:53Z,0.8999999761581421,Chrome,95.0.4638.69,Windows NT 10.0,1536,864,N/A,1.7777777777777777,724,67,415,101,89,91,-0.1675208506660716,-0.20717189345271578,-0.060199992099513946,-0.04364382157256178,0.23556253080827336,-0.2428404171980778,2,2,1,1,2,1,1,2,1,2,2,1,1,1,2,2,1,1,2,2,0.512989176042577,0,0,1,3,2,2,0,2,5,2,5,2,2,4,2,2,2,2,5,3,4,4,1,1,1,1,1,1,1,1,0,2,0,0,4,3,4,4,4,5,5,5,5,2,5,1,1,4,2,5,3,2,2,2,2,5,1,1,1,1,1,1,1,1,1,5,2,2,1,1,1,1,1,1,1,1.6237723475403307,1.2798809468443688,1,0,1,0,2,0,1.6666666666666667,0,1.75,0,0.8333333333333334,0,1.1428571428571428,0,1,0,1.4594594594594594,0,0,0,0,-1.1141868440486153,-0.9411726183163546,-0.7372407672780129,-0.8392066927971837,5,1,4,1,1,1,1,3,1,1.7320508075688772,1.1428571428571428,0,2,-0.44866370411710943,5,5,5,5,3,3,1,4,3,NA,4,1.5735915849388864,4.428571428571429,0,1.5714285714285714,5.5,3.8333333333333335,3.2559414990859232,0.6723373927674386,0,-0.15761185162037722,3,3,2,2,2,2,4,2,2,3,2,3,2,3,3,3,3,2,3,3,0.6172133998483676,2.4,0,3.6,0,3.4,0,3.4,0,3.466666666666667,0,2,2,2,3,2,1,2,2,2,1,3,3,2,2,1,3,1,2,1,2,0.6863327411532597,1.85,0,"White, Caucasian, Anglo, European American",0,20,1,2,NA,1,4,4,N/A,7,0,127,63,1,5,2,0,0,0,0,0,TRUE,TRUE,TRUE,TRUE,TRUE,NA,NA,NA,NA,5,0.5752468750011176,0.7099258064521897,1,1,0.009828738699806744,0.015339177978505106,5,0.7413125000009313,0.9027677419344263,1,1,0.016946477903233413,0.013334888924898697,NA,NA,NA,NA,NA,NA,NA,NA,NA,NA,1.7368,4.4456,0.3799,4.0901,0.4976,-63.5463,0.9128,4.1566,0.4626,2.7335,0.5727,0.9809,2.0510595266666667,4.104363320666667,4.678693991,0.46109520396666664,0.35610470736666666,1.1371,4.1874,0.5958,2.8339,0.7355,0.9458,0.187,0.385,0.546,0.005,1.189,237.8,3.0825547116666665,4.581623826,4.044832828,0.40735178440000003,0.5253192835666667,104,0.3081481481481481,1,1,2,3,FALSE,TRUE,FALSE
76,2021-11-13T00:39:07Z,2021-11-13T00:59:22Z,1215,1,2021-11-13T00:59:23Z,0.8999999761581421,Chrome,95.0.4638.69,Windows NT 10.0,1920,1080,NA,1.7777777777777777,606,64,303,76,47,68,-0.4707061587384209,-0.23442610839226255,-0.5993947751382007,-0.3483039849236506,-0.34454397393920994,-0.6313418526976985,3,3,1,2,3,1,1,2,1,2,2,1,1,1,2,2,1,1,2,2,0.7326950970650465,0,1,1,3,2,1.9,0,4,4,3,4,3,2,4,2,3,2,2,3,2,4,4,1,1,1,1,2,1,2,1,0,2,0,0,5,4,5,4,3,4,3,5,4,2,4,1,1,3,2,5,2,3,1,2,2,5,1,1,1,2,1,2,1,1,1,5,2,2,1,1,1,1,1,2,2,1.5022505639062869,0.8837151016885368,1.25,0,1.5,0,2.2666666666666666,0,1.8888888888888888,0,1.8333333333333333,0,1,0,1.2857142857142858,0,1,0,1.5945945945945945,0,0,0,0,-0.8746295276057681,-0.6610617147917793,-0.5804383618435307,-0.620750038317655,4,2,3,2,2,3,2,3,1,0.7867957924694432,2.2857142857142856,0,2,0.2350737771240448,4,4,5,2,4,4,2,2,2,3,3,1.1338934190276817,3.857142857142857,0,2.142857142857143,7,3.8333333333333335,3.2559414990859232,1.5194825076544112,0,0.584644695508856,2,2,3,2,2,3,2,2,2,3,2,3,2,3,3,4,3,2,2,3,0.6324555320336759,2.2,0,3.4,0,2.6,0,3.4,0,3.1333333333333333,0,2,2,3,2,2,4,2,2,1,3,2,3,3,4,1,2,2,3,1,3,0.8750939799154206,2.45,0,"White, Caucasian, Anglo, European American",0,21,1,2,NA,1,2,5,Unemployed,4,0,170,63,2,5,2,0,0,1,0,0,TRUE,TRUE,TRUE,TRUE,TRUE,3,0.882141463407656,0.82,0.07336217814352806,3,0.38114374996721745,0.4675612903333479,1,0.96875,0.0014788651201080886,0.0038309250696132555,3,0.5500906249955296,0.6184899999856949,1,0.967741935483871,0.004377387973885603,0.006386075292158874,1.3388,1.1551,0.5838,1.0744,0.9598,0.6644,0.1497,1.3863192556666666,1.070821495,0.5711930317666667,1.3864,6.9063,0.2808,3.9247,0.3015,-90.6182,0.8439,6.6264,0.3202,4.6767,0.3876,0.9354,1.3170191285333332,3.7868230156666667,6.118860812333334,0.30402501293333334,0.27901381416666665,1.0593,6.4396,0.4668,4.5459,0.5081,0.9942,0.073,0.41,0.554,0.015,1.585,105.66666666666667,1.933080773,5.315391887333333,3.406815796666667,0.37340603903333336,0.3464449041666667,284,0.8414814814814815,1,0,0,1,FALSE,FALSE,FALSE
77,2021-11-13T00:39:37Z,2021-11-13T00:59:51Z,1214,1,2021-11-13T00:59:52Z,1,Chrome,95.0.4638.69,Macintosh,1440,900,NA,1.6,583,56,302,103,46,87,-0.5298016001423533,-0.30710401489772066,-0.6042090142724746,-0.019271008504474677,-0.3583560335760547,-0.31040588424149007,3,3,3,3,3,1,1,3,1,3,1,2,1,2,3,3,2,2,3,3,0.8645047258706176,0,1,1,2,1,2,0,2,2,4,2,3,3,3,3,2,3,2,2,2,2,3,2,2,1,3,2,2,3,3,1,3,0,0,4,2,3,4,3,4,4,4,4,2,3,2,1,3,2,4,5,3,3,4,4,4,1,1,1,4,4,2,1,2,1,2,4,4,1,5,2,3,2,1,1,1.2645549015756885,0.6399404734221844,2.25,0,1.75,0,3.2,0,2.4444444444444446,0,2.8333333333333335,0,2,0,2.4285714285714284,0,2.6666666666666665,0,2.5675675675675675,0,1,0,0,0.3525763741716248,0.5879193146073626,-0.2989446853297732,0.1444873146387947,3,5,3,5,3,3,3,4,2,0.9759000729485332,3.5714285714285716,0,3,1.3732661182947257,3,3,4,2,1,1,5,7,7,3,2,1.4960264830861913,2.142857142857143,0,3.857142857142857,2,3.8333333333333335,3.2559414990859232,-1.3043345419688306,0,0.12878813975447612,3,2,3,3,3,3,3,4,2,3,4,4,2,3,3,3,4,2,4,4,0.7745966692414834,2.8,0,3.4,0,3.4,0,2.8,0,3.2,0,2,1,2,2,3,3,3,2,3,3,3,3,3,3,1,2,1,2,2,3,0.7451598203705946,2.45,0,"White, Caucasian, Anglo, European American",0,25,1,2,NA,1,3,7,teacher,2,0,180,65,2,5,2,0,0,0,0,0,TRUE,TRUE,TRUE,TRUE,TRUE,5,0.6829249999978476,0.72,0.0561116908735381,5,0.44126666666617,0.5145406250003726,0.9375,1,0.002672198054442193,0.003440372167123275,5,0.6484312499999069,0.7319448275848709,1,0.90625,0.008678188669534695,0.006696637812609755,1.3099,0.7432,0.2991,1.2537,0.6878,0.3463,0.2262,1.3447119026666667,0.81019951066,0.2943658097,1.0495,4.127,0.3251,4.4792,0.3974,-86.3234,0.8107,5.8731,0.367,5.7088,0.4428,0.9624,1.1531641125666667,4.530888362,4.341174600333333,0.3904536509666667,0.3183727584,0.9046,3.2972,0.5329,4.2128,0.6203,0.9267,0.059,0.505,0.44,0.014,1.73,123.57142857142857,1.6995260376666668,4.264282162,2.4745225576666665,0.4495680307666667,0.43053707416666664,406,1.202962962962963,1,0,0,1,FALSE,FALSE,FALSE
78,2021-11-13T00:28:17Z,2021-11-13T01:01:34Z,1996,1,2021-11-13T01:01:35Z,1,Chrome,95.0.4638.69,Windows NT 10.0,1280,720,n/a,1.7777777777777777,843,88,656,105,105,128,0.13823382442383994,-0.016392388875888245,1.1000316392605174,0.0051018045636124325,0.4565554849977908,0.38214015295348597,2,3,3,3,2,1,3,2,1,2,3,3,1,2,2,2,3,1,2,1,0.7880689256524124,0,0,1,3,4,2.5,0,3,3,4,2,4,3,3,4,4,3,3,2,4,2,3,3,5,1,3,4,3,4,4,5,4,0,0,4,2,3,3,2,4,4,5,2,3,3,2,1,3,3,5,4,3,3,3,5,4,1,1,1,3,3,2,4,3,3,3,4,3,2,3,1,2,1,3,3,1.115008180796555,0.7432233529572065,3.375,0,2.25,0,3.533333333333333,0,2.7777777777777777,0,2.8333333333333335,0,1.6666666666666667,0,3,0,2,0,2.6486486486486487,0,3,0,0,1.1027690230321205,1.2494804844727638,0.2640426676977418,0.7567615760852529,4,3,4,1,2,3,2,2,1,1.1126972805283737,2.142857142857143,0,1.5,-0.03488724541829051,3,2,4,3,2,1,4,4,4,4,2,1.1126972805283737,2.4285714285714284,0,3.5714285714285716,5,3.8333333333333335,3.2559414990859232,0.38995568780511447,0,0.8165912597985752,1,2,1,1,1,1,5,2,1,3,1,5,2,5,5,2,5,2,4,2,1.647508942095828,1.2,0,4.8,0,4,0,4.6,0,4.466666666666667,0,3,4,1,4,3,2,3,3,1,1,3,3,2,2,1,3,1,2,1,2,1.019545822516343,1.95,0,"White, Caucasian, Anglo, European American",0,23,1,4,Genderqueer,1,2,4,Unemployed - disabled student,5,0,220,67,2,5,2,0,1,1,0,1,TRUE,TRUE,TRUE,TRUE,TRUE,5,0.8013880952341216,0.8571428571428571,0.11003504041828142,5,0.5652281249966472,0.6403200000007947,1,1,0.007929395634900412,0.0032616451027136666,5,0.6990593750011176,0.7426161290330272,1,1,0.008016668942586931,0.0069288173970388925,1.4617,1.2865,0.4484,0.9931,1.4159,0.5795,0.0105,1.464182776,1.1473440699333333,0.4417698367333333,2.419,5.8255,0.3576,6.7392,0.4608,-82.4171,0.9434,4.5715,0.4627,6.0176,0.5651,0.9997,1.9873540096666666,5.3657016513333335,5.039662329666666,0.46184212923333334,0.36984697536666666,1.0513,3.4246,0.5593,4.6038,0.6379,0.9646,0.202,0.364,0.603,0.03,1.589,52.96666666666667,2.741049756333333,4.97793127,4.893562298333333,0.42790746073333336,0.47007291863333334,348,1.031111111111111,1,0,0,1,FALSE,FALSE,FALSE
79,2021-11-13T00:43:12Z,2021-11-13T01:02:43Z,1171,1,2021-11-13T01:02:44Z,1,Chrome,95.0.4638.69,Macintosh,1280,800,The survey went well!,1.6,582,38,302,56,41,74,-0.5323709671599156,-0.4706293045350014,-0.6042090142724746,-0.5920321156045217,-0.42741633176027893,-0.5299936521325801,3,3,2,2,2,1,2,2,1,2,2,2,2,1,2,2,2,2,2,2,0.5104177855340404,0,1,1,3,3,2.25,0,2,2,3,3,4,3,2,4,3,3,5,2,2,3,2,3,3,1,3,3,4,4,5,2,4,2,5,4,1,1,3,1,1,2,2,1,5,2,5,4,3,5,2,5,5,5,5,5,2,5,1,1,1,1,3,3,1,1,4,3,3,2,2,3,2,2,3,3,1.5658709882847794,0.9154754164341269,3.25,0,2.5,0,3.533333333333333,0,4.222222222222222,0,4.583333333333333,0,2,0,2.142857142857143,0,2.3333333333333335,0,3.4864864864864864,0,1,2,5,1.546160196448267,1.5558215382582787,1.2317735725039012,1.39379755538109,4,2,4,1,1,2,2,1,1,1.2535663410560174,1.7142857142857142,0,1,-0.4757826382709144,3,2,3,3,2,2,3,3,4,NA,3,0.5345224838248488,2.5714285714285716,0,3.4285714285714284,5.5,3.8333333333333335,3.2559414990859232,0.6723373927674386,0,0.8781111148583004,5,3,4,4,4,4,3,3,3,4,2,4,4,4,4,5,3,2,2,5,0.990430401872025,4,0,3.4,0,2.4,0,3,0,2.933333333333333,0,2,3,2,2,2,4,2,2,2,2,4,2,3,3,1,2,1,3,2,2,0.8013147091860318,2.5,0,"Asian or Asian American (e.g., Chinese, Japanese, and others)",0,23,1,2,NA,1,1,6,Unemployed,7,0,190,63,2,5,2,0,0,1,0,0,TRUE,TRUE,TRUE,TRUE,TRUE,6,0.7758952380943867,0.84,0.03575496816214319,6,0.4068375000059605,0.4757793103374284,1,0.90625,0.001060592096865408,0.0040188977321996555,6,0.6730343750044704,0.7356656249966472,1,1,0.008704773941302828,0.007771834587381108,1.1331,1.4622,0.5107,1.0826,1.394,0.5233,0.1125,NA,NA,NA,1.1093,7.3825,0.3317,2.5874,0.2884,-87.3855,0.615,7.0373,0.3646,4.6294,0.4138,0.9957,NA,NA,NA,NA,NA,0.829,2.9815,0.569,3.8612,0.6355,0.9213,0.143,0.432,0.615,0.02,1.583,79.14999999999999,NA,NA,NA,NA,NA,292,0.8651851851851852,1,0,0,1,FALSE,FALSE,FALSE
80,2021-11-13T00:21:16Z,2021-11-13T01:03:58Z,2561,1,2021-11-13T01:04:00Z,1,Chrome,95.0.4638.69,Windows NT 10.0,1536,864,NA,1.7777777777777777,1352,67,841,105,38,90,1.4460416363630415,-0.20717189345271578,1.9906658791012053,0.0051018045636124325,-0.46885251067081346,-0.2597317839589309,1,2,3,2,1,1,1,1,1,2,2,2,2,2,2,2,2,1,2,2,0.5712405705774795,1,1,2,2,2,2.5,0,1,2,5,2,5,5,1,5,3,2,5,1,1,1,1,5,5,3,1,3,5,5,5,0,2,3,2,3,3,2,3,1,5,2,3,2,3,5,5,3,2,3,5,3,5,5,5,5,1,5,1,1,3,3,1,2,1,1,3,3,3,2,5,5,1,1,1,1,1.470939721288287,1.7994708216848747,4,0,1,0,4.266666666666667,0,3.3333333333333335,0,3.5833333333333335,0,2.8333333333333335,0,1.8571428571428572,0,4,0,3.1621621621621623,0,0,3,2,1.8109340725166776,2.0539040225490397,0.2355581492994198,1.1447310859242297,1,5,1,1,3,5,5,1,3,2,4.142857142857143,0,2,1.3461471841409207,1,2,4,2,1,1,5,2,3,1,1,1.6035674514745464,1.7142857142857142,0,4.285714285714286,6.5,3.8333333333333335,3.2559414990859232,1.237100802692087,0,1.6385188043492451,3,3,3,3,3,3,3,3,3,3,3,3,3,3,3,3,3,3,3,3,0,3,0,3,0,3,0,3,0,3,0,2,2,2,2,2,2,3,2,2,2,3,2,2,3,2,3,1,2,2,3,0.5231483637805969,2.3,0,"Hispanic of Latino (e.g., Mexican American, Central American, and others) & White, Caucasian, Anglo, European American",1,20,1,2,NA,1,2,4,no occupation,2,0,104,57,1,5,2,0,0,1,0,0,TRUE,TRUE,TRUE,TRUE,TRUE,6,1.2711225806451703,0.62,0.2941272780612195,6,0.6917709677419175,0.7986965517241363,1,1,0.02081915279569645,0.025331151059107656,6,0.8192562499999912,0.8898533333333054,1,1,0.019885488346772656,0.0281661018850461,1.8146,0.2854,0.5847,1.5578,0.1686,0.7371,0.0525,1.771851436,0.41522131706523335,0.5751475091666667,2.2318,3.8585,0.4026,3.5278,0.4824,-38.9585,1.092,2.5105,0.5115,3.3204,0.6362,0.9255,2.4033105593333333,3.439792778666667,3.8826284483333335,0.44576694953333335,0.3773837241,1.2343,2.8954,0.6199,1.9416,0.6569,0.7549,0.085,0.591,0.372,0.017,1.091,64.17647058823529,3.005657583666667,4.228960145,3.6446772476666665,0.4641831184,0.4793908608333333,386,1.1437037037037037,1,0,0,1,FALSE,FALSE,FALSE
81,2021-11-13T00:33:51Z,2021-11-13T01:03:59Z,1807,1,2021-11-13T01:04:00Z,1,Chrome,95.0.4638.69,Windows NT 10.0,1920,1080,No feedback.,1.7777777777777777,773,108,571,100,69,98,-0.041621866805519804,0.16530237738775702,0.6908213128472283,-0.05583022810660534,-0.04067866192862343,-0.12460084987210628,4,3,1,1,3,1,1,3,1,4,3,1,1,1,4,4,1,1,3,3,1.2814465510343749,0,0,2,4,4,1.3,0,2,2,4,2,4,3,3,3,2,3,3,3,3,3,1,3,4,5,3,2,3,3,4,4,2,3,1,1,2,2,2,1,4,3,2,3,1,3,2,3,3,2,5,4,4,3,4,5,2,4,1,3,4,1,3,3,1,1,4,2,3,1,4,2,3,3,1,2,1.2068373778005288,0.7988086367179802,3.375,0,2.25,0,3.4,0,3.7777777777777777,0,2.9166666666666665,0,2.6666666666666665,0,2,0,2.3333333333333335,0,2.918918918918919,0,2,3,1,1.2708794205358729,1.3083289396707392,0.8572994635794774,1.0828142016251083,4,2,3,1,2,2,3,3,1,0.9759000729485332,2.142857142857143,0,2,0.14960659196890055,3,3,3,2,1,1,4,4,5,1,2,1.1338934190276817,2.142857142857143,0,3.857142857142857,4.5,3.8333333333333335,3.2559414990859232,0.10757398284279028,0,0.8347424021602866,4,4,3,4,3,3,4,3,2,4,1,3,2,3,4,1,3,1,3,2,1.0555973258234952,3.6,0,3.8,0,4,0,3.6,0,3.8,0,2,3,1,2,4,1,4,2,4,3,3,3,2,2,1,2,1,1,2,4,1.0894228312566052,2.45,0,"White, Caucasian, Anglo, European American",0,27,1,2,NA,1,2,6,Unemployed,1,0,145,61,1,5,2,0,0,0,0,0,TRUE,TRUE,TRUE,TRUE,TRUE,3,0.7321384615370861,0.78,0.029901084592617436,3,0.4524714285710028,0.5535766666581233,0.875,0.9375,0.0035127882254439324,0.004683449678121574,3,0.63171875,0.6678906250018627,1,1,0.008398788024459999,0.004026260877816713,1.1026,1.1814,0.489,0.9358,1.2692,0.5543,0.1575,1.1653351695666667,1.0780682232333334,0.4798121054,1.0641,2.2147,0.2659,3.0342,0.396,-46.6699,0.5586,3.533,0.3954,5.0163,0.5044,0.9818,1.1567913193,3.243544853,2.6051797415333335,0.38885938566666667,0.2619109884,0.7842,5.1207,0.558,4.9292,0.5943,0.9864,0.161,0.4,0.721,0.03,1.67,55.666666666666664,2.5550760156666668,4.6584633,5.684124597,0.3605567344,0.4526161388666667,430,1.2740740740740741,1,0,0,1,FALSE,FALSE,FALSE
82,2021-11-13T00:28:35Z,2021-11-13T01:04:36Z,2161,1,2021-11-13T01:04:39Z,1,Chrome,94.0.4606.81,Macintosh,1440,900,n/a,1.6,884,118,626,135,135,141,0.2435778721438935,0.25614976051957966,0.9556044652322977,0.370694000584919,0.870917274103136,0.6017279208445759,2,2,3,3,2,2,2,2,1,3,1,2,3,3,2,2,2,3,1,1,0.7181848464596079,1,1,1,1,1,2.8,0,2,4,4,3,3,2,2,3,4,2,3,2,4,3,3,3,4,2,2,3,4,3,4,4,2,0,0,4,3,2,3,2,3,2,3,2,3,4,2,2,2,3,1,2,4,4,4,5,3,2,3,1,3,1,1,3,2,1,4,5,3,1,1,2,2,2,2,1,1.1416231003721427,0.7988086367179802,3.125,0,1.75,0,3.2,0,3.3333333333333335,0,3.3333333333333335,0,2,0,2.2857142857142856,0,1.3333333333333333,0,2.810810810810811,0,2,0,0,1.0481331438434005,1.0684827686500429,-0.0958522115332568,0.486315278558393,3,3,2,2,2,4,3,5,1,0.7559289460184544,3,0,3,1.0313973776741485,4,4,4,4,2,2,3,6,6,3,3,0.9511897312113419,3.2857142857142856,0,2.7142857142857144,3,3.8333333333333335,3.2559414990859232,-0.7395711320441822,0,-0.22619813465469363,2,3,3,3,2,2,3,2,3,2,2,2,2,3,4,5,3,3,2,3,0.8837151016885368,2.6,0,3.2,0,2.4,0,3.4,0,3,0,2,1,3,2,4,4,4,2,4,4,3,3,2,3,2,3,3,4,3,4,0.9176629354822471,3,0,Filipino,0,27,1,2,NA,1,3,6,unemployed,3,0,128,61,1,5,2,0,0,0,0,0,TRUE,TRUE,TRUE,TRUE,TRUE,4,0.914159459463648,0.74,0.06918372237053995,4,0.42484062500298025,0.49160645161328775,1,0.96875,0.0019410902322693603,0.0015234198279785345,4,0.5854218749944121,0.6331781250014901,1,1,0.009701985633831891,0.0066710617628430455,1.2961,0.8417,0.5704,1.123,0.7258,0.6379,0.1139,1.3497097686666666,0.8757219315333333,0.5592678030333333,1.2686,5.6293,0.3122,5.4641,0.3846,-99.2851,0.6504,6.0361,0.3789,7.2281,0.4468,0.7424,1.2819117736666668,5.0289712453333335,5.357812606666666,0.37920103526666665,0.30852882113333335,1.0858,3.979,0.4693,5.6893,0.5479,0.9896,0.258,0.193,0.671,0.013,1.161,89.30769230769232,2.530035659666667,4.52692397,4.554438798666666,0.3084815284,0.36177258516666666,440,1.3037037037037038,1,0,0,1,FALSE,FALSE,FALSE
83,2021-11-13T00:45:41Z,2021-11-13T01:07:54Z,1333,1,2021-11-13T01:07:55Z,1,Chrome,95.0.4638.69,Macintosh,1440,900,NA,1.6,677,55,338,82,48,88,-0.28828110049149885,-0.31618875321090295,-0.4308964054386111,-0.2751855457193893,-0.3307319143023651,-0.293514517480637,3,2,1,1,2,1,1,1,2,2,2,1,1,1,2,1,1,1,2,1,0.6048053188292994,0,0,3,2,2,2.15,0,5,5,1,5,1,1,5,1,1,1,1,5,4,4,5,2,2,1,1,1,1,1,1,1,2,0,0,5,5,5,5,5,5,3,4,5,2,5,1,1,4,1,5,1,1,1,3,3,3,1,1,1,2,2,1,1,2,1,4,1,1,1,2,1,2,1,1,2,1.6756514577345158,1.9639610121239315,1.25,0,1.5,0,1.2666666666666666,0,1.3333333333333333,0,1.5,0,1.5,0,1.1428571428571428,0,1.3333333333333333,0,1.4324324324324325,0,1,0,0,-0.9754957661080196,-1.160499262195652,-0.3773458880470143,-0.7689225751213331,5,1,3,1,1,2,1,1,1,1.5275252316519468,1.4285714285714286,0,1,-0.6467170085812028,5,5,5,5,2,1,1,7,6,3,4,1.9880595947760098,4,0,2,2.5,3.8333333333333335,3.2559414990859232,-1.0219528370065065,0,-0.7657439742430396,1,1,2,1,2,1,4,1,1,1,1,4,1,4,4,3,5,1,1,5,1.6846647257229665,1.4,0,4.8,0,2.8,0,3.8,0,3.8,0,1,3,4,3,4,4,4,1,2,2,4,1,2,4,1,1,1,4,3,4,1.3088765773505315,3.05,0,"White, Caucasian, Anglo, European American",0,20,1,2,NA,1,3,4,Waitress,2,0,100,62,2,5,2,0,0,1,0,0,TRUE,TRUE,TRUE,TRUE,TRUE,5,1.018165853658691,0.82,0.1311688012898051,5,0.41051935483875773,0.4869593750000931,0.96875,1,0.0017756645161407549,0.0032720411996115797,5,0.5918781250000466,0.7022031250000582,1,1,0.008946688215764437,0.007280659022170328,1.6405,0.9842,0.482,1.4838,1.0541,0.5258,0.0644,1.6174819533333333,0.9487446526,0.476581862,1.4049,5.8786,0.2962,4.4164,0.3279,-87.2364,0.6187,5.3607,0.3568,4.7979,0.4382,0.9673,1.3937536995333333,4.268876249,5.5050699136666665,0.32618493623333333,0.29308314916666667,1.0748,4.1029,0.4631,4.0395,0.5771,0.9952,0.245,0.232,0.686,0.006,1.083,180.5,2.503253243666667,4.728344004333334,4.751976151666667,0.33029817786666665,0.4458205641333333,426,1.2622222222222224,1,0,0,1,FALSE,FALSE,FALSE
84,2021-11-13T00:46:18Z,2021-11-13T01:09:04Z,1365,1,2021-11-13T01:09:05Z,1,Chrome,95.0.4638.69,Windows NT 10.0,1366,768,"The games were fun, minus the color dot one where u have to say if it changed or not, that one was kind of hard. I liked the arrow games tho",1.7786458333333333,640,59,368,65,68,93,-0.3833476801413033,-0.2798497999581739,-0.28646923141039143,-0.4823544567981297,-0.054490721565468275,-0.20905768367637165,4,4,2,2,3,2,3,3,1,4,3,2,1,2,4,2,2,2,3,3,0.9403246919632545,0,1,1,5,5,1.8,0,1,4,4,4,1,3,3,3,1,2,5,2,3,2,2,3,3,1,1,4,3,3,5,2,2,0,0,3,1,5,2,1,5,3,3,1,3,5,5,1,2,5,2,2,5,5,5,5,4,1,1,1,1,1,1,1,3,3,3,2,2,1,1,4,2,4,1,1,1.5995494861236894,1.2344267996967353,2.875,0,2,0,3.066666666666667,0,3.3333333333333335,0,3.75,0,1,0,2,0,2,0,2.7837837837837838,0,1,0,0,0.8758199864020546,0.8921309835008454,-0.22054348261253207,0.33579375044415666,5,1,4,1,1,2,1,8,2,1.6761634196950514,1.2857142857142858,0,5,0.7437665053611813,5,5,5,5,5,5,1,6,7,6,3,1.5118578920369088,5,0,1,2.5,3.8333333333333335,3.2559414990859232,-1.0219528370065065,0,-1.3234409561930969,4,4,4,5,4,3,5,3,3,2,1,4,4,2,3,1,4,1,5,2,1.3557637102737474,4.2,0,4.2,0,3.8,0,3,0,3.6666666666666665,0,3,1,2,2,2,2,2,3,1,2,1,4,3,4,3,3,2,3,3,3,0.8870412083230169,2.25,0,"Asian or Asian American (e.g., Chinese, Japanese, and others)",0,24,1,2,NA,1,3,6,Student in nursing school.,3,0,125,61,2,5,2,0,0,1,0,0,TRUE,TRUE,TRUE,TRUE,TRUE,3,0.7676315789473194,0.76,0.01621852981224349,3,0.42627666666659836,0.4924322580645582,0.967741935483871,0.96875,0.0022679959784980305,0.003975354798366624,3,0.5740625000000582,0.6222,1,0.9375,0.0019518533870954318,0.0045699219354752895,1.1455,1.1076,0.4912,0.8873,1.5875,0.594,0.2475,1.2059938471666667,1.0385344768,0.48296956933333335,1.9589,5.2101,0.2513,4.6948,0.2966,-67.2575,0.8491,5.9347,0.3646,4.9535,0.4111,0.8235,1.5932498243333333,4.243167161666666,3.658001252,0.31426432126666665,0.2146777903,0.7677,6.6253,0.5178,4.1647,0.54,0.9882,0.048,0.495,0.59,0.029,1.648,56.82758620689655,1.5795552169666667,5.855170637666666,3.064313836,0.44589569706666665,0.3832441712333333,326,0.965925925925926,1,0,0,1,FALSE,FALSE,FALSE
85,2021-11-13T00:40:18Z,2021-11-13T01:10:03Z,1784,1,2021-11-13T01:10:04Z,1,Edge,95.0.1020.44,Windows NT 10.0,1536,864,NA,1.7777777777777777,814,118,502,117,66,120,0.06372218091453376,0.25614976051957966,0.35863881258232305,0.15133868297213507,-0.08211484083915795,0.24700921886666136,3,4,1,1,2,2,2,3,1,4,3,2,1,1,3,3,2,1,3,3,1.019545822516343,0,1,2,3,2,1.65,0,5,5,2,5,1,1,5,1,1,1,1,5,1,4,5,2,2,5,1,1,1,2,1,5,1,1,1,5,4,4,5,4,5,5,5,5,1,4,1,1,5,1,5,1,1,1,1,2,4,2,1,1,2,1,1,3,1,1,5,1,1,1,1,1,1,2,2,1,1.7578652081687294,1.9591057240729093,1.875,0,1.5,0,1.1333333333333333,0,1.3333333333333333,0,1.1666666666666667,0,1.3333333333333333,0,1.1428571428571428,0,1,0,1.2702702702702702,0,3,1,1,-0.6876067103828436,-1.018895166875523,0.4119219140382229,-0.3034866264186501,5,1,5,1,1,1,1,1,1,1.9518001458970664,1,0,1,-0.9031185640466358,5,5,5,5,4,3,1,7,3,6,4,1.5275252316519468,4.571428571428571,0,1.4285714285714286,4,3.8333333333333335,3.2559414990859232,-0.1748077221195339,0,-0.6608554064853003,1,2,2,3,3,2,3,2,1,2,1,5,2,4,5,2,5,2,4,2,1.424279266355945,2.2,0,4.6,0,3.4,0,4.4,0,4.133333333333334,0,1,1,2,3,2,2,4,4,1,2,3,4,1,1,1,4,2,2,1,1,1.1652874052533586,1.6,0,"White, Caucasian, Anglo, European American",0,23,1,2,NA,1,3,4,stay at home mom mostly/ part time assistant,3,0,160,62,1,5,2,0,0,0,0,0,TRUE,TRUE,TRUE,TRUE,TRUE,2,0.7888125000953674,0.8,0.03355692983891913,2,0.4828612901626095,0.5108103446960449,1,0.90625,0.012638407126005523,0.00646423990310446,2,0.6602322580891271,0.7833857142584665,1,0.875,0.07767181216858281,0.07056614947280854,1.2604,1.1786,0.4897,0.9483,1.2213,0.6041,0.216,1.3080142892666666,1.0833999906333334,0.48040595783333334,1.0243,3.791,0.3478,2.8105,0.3586,-64.059,0.9187,4.4742,0.3707,4.1273,0.3981,0.9536,1.136547928,3.081973693666667,4.061768216,0.35123084216666667,0.33951910216666664,1.1697,4.4258,0.4644,2.134,0.5052,0.9134,0.064,0.441,0.383,0.01,1.525,152.5,1.435131294,3.2501240323333334,1.6721605527333334,0.4320866022,0.4032070852,357,1.0577777777777777,1,0,0,1,FALSE,FALSE,FALSE
86,2021-11-13T00:52:57Z,2021-11-13T01:12:05Z,1148,1,2021-11-13T01:12:07Z,1,Chrome,95.0.4638.69,Windows NT 10.0,1536,864,N/A,1.7777777777777777,617,49,250,63,42,80,-0.4424431215452358,-0.3706971830899965,-0.8545494492547221,-0.5067272698662169,-0.4136042721234341,-0.4286454515674616,3,2,4,4,2,4,4,2,4,3,1,4,4,4,1,2,4,3,2,2,1.0990426455975697,0,0,1,2,3,3.45,0,4,2,5,2,4,4,4,4,4,5,5,2,1,1,2,1,1,1,1,1,4,4,3,1,2,0,0,2,1,1,2,4,5,2,2,1,2,5,5,1,1,5,5,5,5,5,5,5,5,1,1,1,1,1,1,2,1,1,2,5,5,1,1,1,1,3,1,1,1.8265640794498113,1.4375905768565218,2,0,1.5,0,3.8,0,3.7777777777777777,0,3.75,0,0.8333333333333334,0,2.5714285714285716,0,1,0,2.891891891891892,0,1,0,0,0.3988067334851569,0.8777092403684471,-0.3773458880470143,0.2501816761607164,5,1,5,1,1,1,1,6,8,1.9518001458970664,1,0,7,1.310807484599657,5,5,5,5,5,5,1,6,6,5,4,1.5118578920369088,5,0,1,3,3.8333333333333335,3.2559414990859232,-0.7395711320441822,0,-1.1822501037119346,2,2,1,1,1,1,4,3,1,5,1,4,1,5,5,1,4,4,5,2,1.709915063331955,1.4,0,4,0,4.8,0,4.4,0,4.4,0,3,3,3,1,3,4,3,2,4,4,3,3,3,4,2,3,2,3,4,2,0.8255779474818965,3.05,0,"White, Caucasian, Anglo, European American",0,23,1,2,NA,1,4,7,Accountant,3,0,175,70,3,5,2,0,0,1,0,0,TRUE,TRUE,TRUE,TRUE,TRUE,2,0.9638187500052154,0.64,0.13837517877656724,2,0.46085862068883304,0.5190199999928474,0.9666666666666667,0.9375,0.004104750861544034,0.0014743634576560513,2,0.5676781250033528,0.679087096773809,1,0.96875,0.007492773376877459,0.014747736773361619,1.5462,0.3857,0.3998,1.3416,0.4619,0.5213,0.4576,1.5488808796666667,0.5307810281694,0.3962455948,0.9942,3.4612,0.3242,4.3842,0.4199,-77.9371,0.732,4.989,0.3902,5.6678,0.4586,0.9065,1.1037464928333334,4.392337591666666,3.8095732773333335,0.41179636123333335,0.3177329668,1.0215,3.7593,0.4513,2.3669,0.521,0.9417,0.096,0.341,0.427,0.012,1.714,142.83333333333331,1.908442451,4.203707162666666,3.19016905,0.34136314116666666,0.39170657913333334,104,0.3081481481481481,1,1,0,1,FALSE,FALSE,FALSE
87,2021-11-13T00:48:10Z,2021-11-13T01:12:46Z,1475,1,2021-11-13T01:12:46Z,0.8999999761581421,Chrome,94.0.4606.114,CrOS x86_64 14150.74.0,1200,800,no,1.5,712,64,418,66,71,85,-0.198353254876819,-0.23442610839226255,-0.04575727469669198,-0.47016805026408615,-0.013054542654933752,-0.34418861776319626,2,2,2,2,2,3,3,1,2,2,1,2,1,3,2,1,2,2,1,1,0.6708203932499369,0,0,3,2,1,2.85,0,2,2,5,2,4,5,2,5,5,5,5,1,2,1,1,5,5,5,2,5,5,5,5,11,2,7,0,2,1,3,1,2,3,2,3,2,5,2,4,4,1,2,3,5,4,4,5,5,1,5,5,4,5,3,1,5,5,5,1,5,4,4,3,5,3,3,5,5,1.4947355064472891,1.7265434778633235,4.625,0,4,0,4.466666666666667,0,3.888888888888889,0,4.166666666666667,0,4.333333333333333,0,4.142857142857143,0,4,0,4.162162162162162,0,6,6,0,2.8216978375079886,2.8381951943733776,2.661927753666121,2.7500614740197493,2,4,2,4,4,4,3,8,2,0.9511897312113419,3.857142857142857,0,5,2.2821758381537784,3,3,3,3,2,1,4,7,6,NA,1,0.9511897312113419,2.4285714285714284,0,3.5714285714285716,2.5,3.8333333333333335,3.2559414990859232,-1.0219528370065065,0,0.11063699739276467,5,5,5,5,5,5,5,5,5,2,2,3,5,3,3,1,3,2,3,2,1.3870146083619754,5,0,3,0,3.2,0,2.4,0,2.8666666666666667,0,3,4,4,1,3,4,4,1,4,4,4,1,2,4,3,1,3,4,4,3,1.190974832912761,3.65,0,"White, Caucasian, Anglo, European American",0,22,1,2,NA,1,1,4,disability (was a barista),1,0,110,64,2,5,2,0,0,2,0,0,TRUE,TRUE,TRUE,TRUE,TRUE,4,0.9541705882338917,0.68,0.08232556949001775,4,0.5980906249992549,0.7088774193539735,1,0.96875,0.013612221522250601,0.03255648447570016,4,0.7804281250007916,0.8010482758625314,1,0.9666666666666667,0.017278173699364723,0.01380585178146131,1.4425,0.5557,0.5061,1.1694,0.6155,0.6477,0.2133,1.472104412,0.6701704824966667,0.49798344023333335,1.5047,3.7174,0.3957,2.6079,0.4379,-43.4203,1.2823,3.8218,0.4263,3.0938,0.4842,0.9347,1.777094189,2.857153261,4.023726624,0.4086083341,0.37363264993333334,1.0554,3.352,0.6476,2.8214,0.6411,0.9797,0.072,0.575,0.358,0.041,1.754,42.78048780487805,2.5854935363333333,3.3307614096666667,3.5010109706666666,0.3864156237333333,0.4550658860333333,370,1.0962962962962963,1,0,0,1,FALSE,FALSE,FALSE
88,2021-11-13T00:41:28Z,2021-11-13T01:14:44Z,1995,1,2021-11-13T01:14:45Z,1,Chrome,95.0.4638.69,Windows NT 10.0,1536,864,N/A,1.7777777777777777,991,67,565,110,84,102,0.5185001430230577,-0.20717189345271578,0.6619358780415844,0.0660338372338302,0.16650223262404917,-0.057035382828693984,3,3,2,2,3,2,2,3,3,3,3,2,2,3,3,3,2,1,3,3,0.6048053188292994,0,1,2,4,5,2.05,0,4,4,3,4,3,3,4,2,2,2,3,5,4,4,4,2,2,1,1,2,2,2,2,1,2,0,0,5,5,5,5,5,5,5,5,5,2,5,3,1,5,1,5,1,1,2,2,3,5,1,1,1,2,1,2,2,2,1,5,3,2,1,2,2,2,1,2,2,1.7150631013001945,0.9102589898327995,1.75,0,1.75,0,2.3333333333333335,0,1,0,1.5833333333333333,0,1,0,1.7142857142857142,0,1.6666666666666667,0,1.4324324324324325,0,1,0,0,-0.6644915307260776,-0.48722647542407477,-0.2989446853297732,-0.393085580376924,5,1,3,1,1,3,2,1,1,1.4960264830861913,1.7142857142857142,0,1,-0.4757826382709144,5,5,5,5,3,3,2,6,4,3,3,1.2909944487358056,4.285714285714286,0,1.7142857142857142,4,3.8333333333333335,3.2559414990859232,-0.1748077221195339,0,-0.5015134116424268,2,3,2,2,2,2,4,3,3,3,1,3,2,3,4,1,4,2,4,2,1.0327955589886444,2.2,0,4,0,4,0,3.4,0,3.8,0,2,1,3,3,3,2,1,2,1,2,2,1,2,2,1,2,2,2,1,2,0.6708203932499369,2.05,0,"White, Caucasian, Anglo, European American",0,29,1,2,NA,1,3,7,Natural Resources,3,0,130,64,2,5,2,0,0,0,0,0,TRUE,TRUE,TRUE,TRUE,TRUE,3,0.9186418604649776,0.86,0.03857472459185775,3,0.5025225806451372,0.5489906249999185,1,1,0.01447804313977957,0.010187011844743145,3,0.7125374999999186,0.8725031249999884,1,1,0.013716223709653733,0.02507247063505934,1.4142,1.407,0.5732,1.0975,1.448,0.6876,0.1372,1.430032763,1.2154053036666668,0.5635319279,2.2954,4.4363,0.2438,4.8057,0.3102,-59.1243,1.0834,3.8105,0.3522,4.197,0.4196,0.9244,1.792234473,4.139478145,4.023507541,0.3343512061,0.2763525132,1.1429,4.1804,0.5721,2.9436,0.6929,0.9242,0.163,0.379,0.473,0.008,1.409,176.125,2.906692609333333,4.344262256666667,3.6721455666666665,0.3792939563,0.4787704914,382,1.1318518518518519,1,0,0,1,FALSE,FALSE,FALSE
89,2021-11-13T00:10:54Z,2021-11-13T01:14:49Z,3834,1,2021-11-13T01:14:50Z,0.8999999761581421,Chrome,95.0.4638.69,Windows NT 6.3,1366,768,Thansk,1.7786458333333333,2535,104,445,89,47,154,4.4856028181392205,0.12896342413502795,0.08422718192870571,-0.18988069998108442,-0.34454397393920994,0.8213156887356658,4,4,2,2,4,1,1,4,1,4,4,1,1,1,3,4,1,1,4,4,1.4317821063276353,0,1,1,3,3,1.15,0,5,5,1,5,1,1,5,1,1,1,1,5,1,5,5,1,1,3,1,1,1,1,1,0,1,3,4,5,3,5,5,3,5,5,5,5,1,5,1,1,5,1,5,1,1,1,1,1,5,3,3,1,2,1,1,1,1,1,5,1,1,1,1,1,1,1,1,1,1.834766024965136,2.065591117977289,1.25,0,1,0,1,0,1.4444444444444444,0,1,0,1.6666666666666667,0,0.8571428571428571,0,1,0,1.2432432432432432,0,0,3,4,-1.0931730443606464,-1.3564026722625975,0.5884574430977813,-0.3839726145824081,5,1,3,1,1,1,1,2,2,1.5735915849388864,1.2857142857142858,0,2,-0.3631965189619651,5,5,5,5,2,2,2,6,6,4,3,1.6035674514745464,4,0,2,3,3.8333333333333335,3.2559414990859232,-0.7395711320441822,0,-0.6245531217618774,1,1,1,1,1,1,1,1,1,3,1,5,1,5,5,1,4,1,3,3,1.6818357317441643,1,0,4.8,0,3.4,0,4.6,0,4.266666666666667,0,2,1,1,1,2,1,1,4,1,1,1,4,1,1,1,4,1,1,1,1,1.0990426455975697,1.25,0,"White, Caucasian, Anglo, European American",0,26,1,2,NA,1,3,6,physiotherapist,4,0,120,60,1,5,2,0,0,1,0,0,TRUE,TRUE,TRUE,TRUE,TRUE,1,0.8879972222232156,0.72,0.07573795887741991,1,0.5925321428594845,0.6511370370376993,0.9655172413793104,1,0.03224542290683175,0.015275852420379817,1,0.6261625000014901,0.6844193548377483,1,1,0.012074341128689823,0.009126016279815345,1.4385,0.6863,0.4612,1.1049,0.7556,0.6267,0.0979,1.4667745886666668,0.7592441810033334,0.4532262901333333,2.012,2.4584,0.2005,4.2925,0.4168,-29.7955,1.2416,2.9805,0.3748,5.925,0.5293,0.9796,1.9349509246666667,4.018807532,2.588312271,0.41091847913333335,0.2137798139,0.9157,3.2471,0.5026,3.7052,0.5868,0.9055,0.114,0.399,0.497,0.032,1.856,58,2.743984199333333,4.475295062,4.356028220333333,0.3216218622,0.3749840091,292,0.8651851851851852,1,0,0,1,FALSE,FALSE,FALSE
90,2021-11-13T00:46:08Z,2021-11-13T01:15:06Z,1737,1,2021-11-13T01:15:07Z,1,Chrome,95.0.4638.69,Macintosh,1440,900,No comments.,1.6,931,44,452,77,40,128,0.36433812196932075,-0.4161208746559078,0.11792685586862363,-0.3361175783896071,-0.4412283913971238,0.38214015295348597,4,4,1,1,4,1,1,4,1,4,4,1,1,1,4,4,1,1,4,4,1.538967528127731,0,1,1,3,3,1,0,4,5,2,5,1,1,4,2,1,1,2,5,1,5,3,2,2,1,1,1,2,2,2,5,2,3,2,3,2,4,5,5,4,5,5,5,1,5,2,1,5,2,4,1,2,1,2,2,5,1,1,1,1,1,1,5,5,2,5,1,1,1,1,1,2,1,1,1,1.7488735113090823,1.6987390281365427,1.625,0,1.25,0,1.4666666666666666,0,1.7777777777777777,0,1.5,0,0.8333333333333334,0,2.142857142857143,0,1,0,1.5945945945945945,0,3,3,2,-0.6413763510693116,-0.8437048643947072,0.92323677340621,0.03976595450575143,5,1,3,1,1,1,1,1,1,1.5735915849388864,1.2857142857142858,0,1,-0.7321841937363471,3,4,5,3,2,1,1,6,7,2,3,1.4960264830861913,3.2857142857142856,0,2.7142857142857144,2.5,3.8333333333333335,3.2559414990859232,-1.0219528370065065,0,-0.3673889871358558,1,1,1,1,1,1,3,1,1,3,1,5,2,5,5,1,5,3,3,2,1.624221425205085,1,0,4.6,0,3.6,0,4.8,0,4.333333333333333,0,1,1,1,4,1,1,1,4,1,1,1,4,1,1,1,4,1,1,1,1,1.231174022502185,1,0,"White, Caucasian, Anglo, European American",0,23,0,1,NA,1,3,4,Finance Manager,2,0,156,68,3,5,2,0,0,0,0,0,TRUE,TRUE,TRUE,TRUE,TRUE,3,1.046291666669978,0.72,0.14369522075104382,3,0.5025741935545398,0.5571999999973923,1,1,0.0023034499790864685,0.004975488386465964,3,0.8018093750122934,0.9262937499955296,1,1,0.019954940231629872,0.03276245867034475,1.6318,0.5965,0.5605,1.3737,0.4353,0.6916,0.2776,1.6303498606666667,0.67442208205,0.5516713618333333,6.3193,11.2548,0.2218,8.5922,0.1895,-91.6834,0.8365,6.2562,0.4361,4.7162,0.4748,0.9373,1.846000419,4.748251712,6.1280193506666665,0.36731754856666665,0.3576264818,1.5064,3.3936,0.5882,2.847,0.6732,0.9891,0.239,0.323,0.495,0.015,1.658,110.53333333333333,3.125253663,4.070362991666666,3.4317456533333335,0.4172596096,0.47109435353333334,104,0.3081481481481481,1,0,3,4,FALSE,FALSE,FALSE
91,2021-11-13T00:54:06Z,2021-11-13T01:16:36Z,1349,1,2021-11-13T01:16:37Z,0.8999999761581421,Chrome,95.0.4638.54,Macintosh,1280,800,NA,1.6,720,47,287,115,42,71,-0.17779831873632074,-0.38886665971636103,-0.6764226012865845,0.12696586990404798,-0.4136042721234341,-0.5806677524151392,3,2,3,3,2,1,2,2,1,3,2,3,3,3,3,3,3,1,1,2,0.8013147091860318,0,1,1,3,3,2.5,0,1,3,4,2,5,3,1,4,4,3,1,1,3,2,2,4,4,4,1,1,5,5,5,1,2,0,NA,3,1,1,1,1,4,3,4,2,5,3,5,3,4,3,4,5,5,5,5,5,1,1,4,1,4,5,1,1,1,1,3,3,1,3,4,4,3,3,1,1,1.572091432287407,1.2983506020002016,3.625,0,2,0,3.8,0,3.7777777777777777,0,4,0,3.1666666666666665,0,1.4285714285714286,0,3.6666666666666665,0,3.3513513513513513,0,1,0,NA,1.6953581742328474,1.7735027483573693,-0.13158132221341223,0.8209607130719785,4,1,4,1,1,1,1,1,1,1.4638501094227998,1.2857142857142858,0,1,-0.7321841937363471,3,3,3,3,1,1,3,7,7,NA,3,0.9759000729485332,2.4285714285714284,0,3.5714285714285716,2,3.8333333333333335,3.2559414990859232,-1.3043345419688306,0,-0.030553855088397364,3,3,4,4,4,4,4,3,3,3,3,4,4,3,4,1,4,2,5,1,1.1464230084422218,3.6,0,3.4,0,3.8,0,3.6,0,3.6,0,2,3,3,2,4,4,3,2,3,3,3,2,1,3,1,2,1,3,3,4,0.9403246919632545,2.8,0,"White, Caucasian, Anglo, European American",0,29,1,2,NA,1,3,7,graduate student,1,0,130,63,3,5,2,0,0,0,0,0,TRUE,TRUE,TRUE,TRUE,TRUE,3,0.8579323529408258,0.6938775510204082,0.056785637253419584,3,0.5379258064512283,0.649220689664627,1,0.90625,0.007133421978164435,0.0084466657960672,3,0.8198218749985099,1.0118074074100565,1,0.84375,0.02678248305584184,0.026830280715044966,1.5044,0.6159,0.442,1.0101,0.7285,0.6522,0.2378,1.5299107103333334,0.6925777914566666,0.3907758908333333,1.3185,3.4945,0.3493,2.5119,0.4223,-45.0752,0.6989,4.5574,0.4725,3.6016,0.569,0.9973,1.5112672841333334,2.7515292486666665,3.8800503263333335,0.40255772936666667,0.33868607566666664,1.0075,2.4411,0.6499,2.1211,0.8201,0.9742,0.105,0.532,0.389,0.007,1.869,267,1.946601458,3.359627362,1.5000684810666667,0.5242657036666667,0.5097162831666666,104,0.3081481481481481,1,0,0,1,FALSE,FALSE,FALSE
93,2021-11-13T00:48:54Z,2021-11-13T01:18:08Z,1753,1,2021-11-13T01:18:09Z,1,Chrome,95.0.4638.54,Macintosh,1440,900,n/a,1.6,678,105,483,112,78,111,-0.2857117334739366,0.13804816244821022,0.2671682690311173,0.09040665030191732,0.08362987480298012,0.0949869180189837,2,2,3,3,2,3,2,3,1,2,2,1,2,2,2,2,1,1,2,2,0.6488856845230502,0,1,2,4,4,2.4,0,2,4,3,4,4,3,2,5,3,3,4,2,3,2,4,4,5,5,1,4,5,5,5,3,2,0,2,5,3,3,3,2,4,2,4,1,4,2,4,4,1,3,5,3,5,5,5,5,1,4,3,2,3,2,2,5,1,1,3,2,3,2,2,3,3,4,2,1,1.322591867980916,0.9411239481143202,4.25,0,2.5,0,3.3333333333333335,0,3,0,4,0,3,0,2.2857142857142856,0,2.3333333333333335,0,3.189189189189189,0,2,0,2,1.983247229958024,1.7718573145771632,0.49225069041682806,1.1320540024969956,5,1,4,2,1,3,2,2,1,1.5118578920369088,1.7142857142857142,0,1.5,-0.2912888008837234,5,5,5,5,3,3,2,4,3,NA,3,1.2909944487358056,4.285714285714286,0,1.7142857142857142,5.5,3.8333333333333335,3.2559414990859232,0.6723373927674386,0,-0.07794085419894053,3,4,4,2,5,2,4,2,2,3,4,4,2,4,5,2,4,3,5,3,1.0997835284835873,3.6,0,3.4,0,4,0,4,0,3.8,0,2,2,3,3,3,3,3,1,1,1,1,2,2,3,2,2,2,3,3,3,0.7863975156570492,2.45,0,"White, Caucasian, Anglo, European American",0,20,1,2,NA,1,2,4,barista,2,0,115,67,1,5,2,0,0,2,0,0,TRUE,TRUE,TRUE,TRUE,TRUE,5,0.6303258064533434,0.6326530612244898,0.10004827158928349,5,0.4697593750013038,0.5258741935491562,1,0.96875,0.003993187006143249,0.009107462580131063,5,0.5987156250020489,0.7325193548423629,1,1,0.006497912329145065,0.007232902945438902,1.2297,0.4359,0.2974,0.9407,0.5736,0.4393,0.5302,1.2718870297,0.6169118912212667,0.29196687276666666,1.2462,4.6212,0.3349,3.2259,0.3404,-69.3404,0.9923,5.7187,0.3874,3.9117,0.4055,0.9918,1.3912873953,3.4588286146666665,4.781581026666666,0.3308507625,0.3249890757666667,1.0021,4.2412,0.4915,3.5067,0.6047,0.9794,0.152,0.364,0.66,0.011,1.678,152.54545454545456,2.572997504,5.031989111666666,4.908821371,0.3476985469,0.4780980593,447,1.3244444444444445,1,0,1,2,FALSE,FALSE,FALSE
94,2021-11-13T00:49:46Z,2021-11-13T01:18:31Z,1724,1,2021-11-13T01:18:32Z,1,Chrome,93.0.4577.63,Macintosh,1440,900,NA,1.6,610,498,356,75,53,85,-0.46042869066817177,3.7083503195288396,-0.3442401010216793,-0.3604903914576942,-0.2616716161181409,-0.34418861776319626,2,1,3,3,2,1,4,3,3,2,2,3,3,4,2,2,4,4,1,2,0.998683343734455,0,1,2,3,2,3.15,0,3,4,3,3,3,2,1,2,1,5,3,4,4,3,3,3,2,1,1,1,3,3,2,2,2,0,0,2,2,3,3,3,5,5,5,5,2,5,1,1,3,1,5,2,2,1,2,3,5,1,1,1,3,2,1,2,2,1,4,2,2,1,2,1,2,1,1,1,1.4457143874535143,1.0997835284835873,2,0,1.25,0,2.933333333333333,0,2.3333333333333335,0,1.6666666666666667,0,1.3333333333333333,0,1.5714285714285714,0,1.3333333333333333,0,1.7837837837837838,0,1,0,0,-0.2904458962802283,0.029052570671323868,-0.4557470907642554,-0.21334726004646576,5,1,4,1,1,1,1,1,1,1.7320508075688772,1.1428571428571428,0,1,-0.8176513788914915,5,5,5,4,3,3,1,3,3,5,4,1.4960264830861913,4.285714285714286,0,1.7142857142857142,6,3.8333333333333335,3.2559414990859232,0.9547190977297628,0,0.06324999828222155,3,5,4,4,4,4,5,3,1,2,2,4,3,3,3,1,3,3,3,2,1.082325538564332,4,0,3.2,0,3.6,0,3.6,0,3.466666666666667,0,3,3,3,2,4,4,4,4,4,3,3,2,2,2,1,2,2,2,3,4,0.9333020044867296,2.85,0,"White, Caucasian, Anglo, European American",0,21,1,2,NA,1,4,4,receptionist/cashier,6,0,165,69,1,5,2,1,1,1,0,2,TRUE,TRUE,TRUE,TRUE,TRUE,2,0.9447189189485602,0.74,0.12163573724501794,2,0.4679374999925494,0.5491406250074505,1,1,0.013338999833208477,0.015804134749682324,2,0.637549999974668,0.6974290322411445,1,0.96875,0.015241419355823915,0.01820794974336264,1.8512,0.6183,0.209,1.56,0.7781,0.4264,0.2925,1.759843305,0.66946303998,0.21718376122333333,2.1583,4.5021,0.2282,3.9643,0.2769,-54.5344,1.0241,4.2894,0.3425,4.1699,0.4265,0.977,1.7034133191666667,3.5134896243333333,4.136113682666666,0.3049137503,0.25947199913333335,1.1495,4.4838,0.5148,3.7646,0.5408,0.9995,0.077,0.411,0.346,0.013,1.373,105.61538461538461,2.0161405753333335,3.4725911303333334,3.349673891,0.3432266379666667,0.4106071011333333,336,0.9955555555555555,1,0,0,1,FALSE,FALSE,FALSE
95,2021-11-13T00:55:13Z,2021-11-13T01:18:43Z,1410,1,2021-11-13T01:18:44Z,1,Chrome,95.0.4638.69,Macintosh,1440,900,NA,1.6,696,54,323,67,47,113,-0.2394631271578155,-0.3252734915240852,-0.5031099924527209,-0.45798164373004263,-0.34454397393920994,0.12876965154068984,3,2,3,1,2,1,2,2,1,3,3,3,1,2,2,2,2,1,2,3,0.7591546545162482,0,1,3,4,3,2.15,0,2,2,4,3,4,4,3,4,2,3,5,2,2,2,2,3,4,5,2,3,2,4,2,2,2,2,1,3,3,2,3,3,5,5,5,3,1,5,2,1,4,3,5,5,2,3,2,3,1,2,5,1,3,3,1,2,2,2,1,4,3,1,3,1,1,2,1,1,1.3770970904029955,1.0327955589886444,3.125,0,1.25,0,3.6,0,2.4444444444444446,0,2.1666666666666665,0,3,0,2.5714285714285716,0,1.6666666666666667,0,2.4594594594594597,0,1,2,1,0.8295896270885226,1.0893894566809024,0.13396897132097274,0.6116792140009375,4,2,2,2,1,2,2,1,3,0.8997354108424374,2.142857142857143,0,2,0.14960659196890055,2,4,3,3,1,1,3,4,5,2,1,1.1338934190276817,2.4285714285714284,0,3.5714285714285716,4.5,3.8333333333333335,3.2559414990859232,0.10757398284279028,0,0.6754004073174131,4,5,4,4,3,3,4,3,3,5,2,2,4,3,3,2,3,3,2,2,0.8837151016885368,4,0,3,0,3.4,0,3.2,0,3.2,0,2,2,2,3,2,2,3,4,1,2,3,3,2,2,1,3,2,2,2,3,0.7326950970650465,2,0,"White, Caucasian, Anglo, European American",0,18,1,2,NA,1,2,4,Student,2,0,155,65,2,5,2,0,0,0,0,0,TRUE,TRUE,TRUE,TRUE,TRUE,3,0.7798595237958998,0.84,0.009895812874816988,3,0.46983437505364417,0.5182862068866861,1,0.90625,0.004962372012351137,0.0057345045037441485,3,0.6323843750208616,0.6461322580614397,1,0.96875,0.01159675555351448,0.016696792731441607,1.0764,1.6592,0.5737,0.6329,2.0837,0.713,0.2272,1.1323383849,1.3076649081666667,0.5639007596333333,1.1112,3.831,0.3248,3.0659,0.3634,-65.6416,0.7315,6.0296,0.4095,3.1983,0.4249,0.9918,1.2340251594333334,3.2936318316666666,4.136122172,0.35448658013333334,0.31805922923333335,1.0848,5.6321,0.5452,4.2294,0.5069,0.9397,0.081,0.382,0.328,0.038,1.49,39.21052631578947,1.9222881823333333,3.5853429533333334,3.113271868,0.36083624836666667,0.34812995416666664,426,1.2622222222222224,1,0,0,1,FALSE,FALSE,FALSE
97,2021-11-13T00:59:08Z,2021-11-13T01:21:37Z,1348,1,2021-11-13T01:21:37Z,1,Firefox,94.0,Windows NT 10.0,1920,1080,NA,1.7777777777777777,653,56,286,63,46,124,-0.34994590891299365,-0.30710401489772066,-0.6812368404208585,-0.5067272698662169,-0.3583560335760547,0.31457468591007365,2,3,3,3,2,1,1,1,1,2,1,2,3,3,2,2,1,1,2,3,0.8255779474818965,0,0,5,4,3,2.45,0,2,2,4,3,4,5,2,5,5,5,5,2,2,2,1,4,5,1,1,5,5,5,5,5,2,0,1,3,4,4,4,2,5,4,4,2,3,3,5,1,4,5,5,5,5,5,5,5,2,2,1,1,2,1,1,3,3,2,4,2,4,1,1,2,1,4,2,2,1.4866775743954068,1.486446705914413,3.875,0,2.25,0,4.2,0,2.4444444444444446,0,3.75,0,1.6666666666666667,0,2.2857142857142856,0,1.3333333333333333,0,2.675675675675676,0,3,0,1,1.4305842981644374,1.762468663007749,0.44049231459692256,1.1014804888023357,5,1,4,1,1,1,1,2,1,1.7320508075688772,1.1428571428571428,0,1.5,-0.6331575415043005,5,5,5,5,3,2,1,3,6,6,4,1.7043362064926932,4.285714285714286,0,1.7142857142857142,4.5,3.8333333333333335,3.2559414990859232,0.10757398284279028,0,-0.3603225591612647,3,5,4,4,4,4,4,3,4,3,2,3,4,3,5,5,3,1,3,2,1.0997835284835873,4,0,3.4,0,2.6,0,3.4,0,3.1333333333333333,0,2,4,2,3,4,3,3,2,1,1,3,3,2,3,2,3,3,3,3,3,0.812727700887249,2.55,0,"White, Caucasian, Anglo, European American",0,27,3,3,NA,1,2,4,homemaker/stay at home parent,2,0,140,62,3,5,2,0,0,0,0,0,TRUE,TRUE,TRUE,TRUE,TRUE,3,0.7203170731707317,0.8367346938775511,0.012774693027210885,3,0.44106451612903225,0.48848387096774193,1,0.96875,0.0031887956989247314,0.002119403225806452,3,0.60340625,0.6724375,1,1,0.008576313508064513,0.00815677016129032,1.0865,1.6855,0.4928,0.8113,2.2786,0.5843,0.0646,1.1303090645666667,1.3137929180333334,0.4852903935,1.682,5.6586,0.2924,5.1711,0.3352,-84.3987,0.6115,4.7288,0.3861,6.3182,0.4425,0.999,1.5851048426,4.732825577,5.226413069666667,0.33480448543333335,0.29219816153333333,0.9074,5.2348,0.518,4.889,0.5949,0.6756,0.202,0.293,0.658,0.013,1.262,97.07692307692308,2.5509431786666665,4.8722774226666665,4.643486094333333,0.34538755903333335,0.4044714555,326,0.965925925925926,1,0,0,1,FALSE,FALSE,FALSE
98,2021-11-13T00:53:30Z,2021-11-13T01:22:49Z,1758,1,2021-11-13T01:22:50Z,1,Chrome,95.0.4638.69,Windows NT 10.0,2560,1440,nope,1.7777777777777777,613,45,277,63,42,83,-0.45272058961548495,-0.40703613634272556,-0.7245649926293244,-0.5067272698662169,-0.4136042721234341,-0.3779713512849024,3,3,2,1,3,1,1,3,1,3,2,1,1,1,4,3,1,2,3,3,1.0208355710680808,1,1,1,4,4,1.6,0,4,5,2,4,2,2,4,2,2,2,2,4,2,4,3,2,3,1,1,1,2,2,2,3,2,0,0,4,2,4,3,4,5,3,4,5,2,4,1,1,4,2,4,2,2,2,3,3,5,1,1,1,1,1,1,2,2,2,4,3,2,1,1,1,1,2,2,2,1.346221494521727,1.0997835284835873,1.75,0,1.75,0,2,0,2.2222222222222223,0,2,0,0.8333333333333334,0,1.8571428571428572,0,1,0,1.8108108108108107,0,2,0,0,-0.4291369742208243,-0.4678684309510564,-0.0958522115332568,-0.2818603212421566,5,1,3,1,1,1,1,1,1,1.5735915849388864,1.2857142857142858,0,1,-0.7321841937363471,5,5,5,5,3,3,1,4,8,6,4,1.5735915849388864,4.428571428571429,0,1.5714285714285714,3,3.8333333333333335,3.2559414990859232,-0.7395711320441822,0,-0.8635661140261877,3,2,2,4,2,3,4,2,2,3,1,3,2,3,4,2,3,4,3,3,0.8618916073713346,2.6,0,3.2,0,3.6,0,3.6,0,3.466666666666667,0,1,1,1,2,2,2,2,2,1,1,1,3,2,2,1,3,1,2,1,2,0.6708203932499369,1.65,0,"Asian or Asian American (e.g., Chinese, Japanese, and others) & White, Caucasian, Anglo, European American",1,25,1,2,NA,1,3,6,Veterinary Student,7,0,169,72,4,5,2,0,0,1,0,0,TRUE,TRUE,TRUE,TRUE,TRUE,5,0.6840428571454116,0.7142857142857143,0.025407884192731607,5,0.32774193548098685,0.41630312499683353,0.96875,1,6.822083871490341e-4,0.00422933902237129,5,0.45360000000242146,0.5027645161324932,1,0.96875,0.00263126387134102,0.0018074289918236458,1.1402,0.8559,0.4178,0.6118,1.398,0.6027,0.364,1.2020905726333333,0.8952368075183667,0.40986252926666666,1.1652,7.3351,0.252,4.0555,0.2726,-100.3722,0.8562,8.0052,0.2782,6.5192,0.3501,0.609,1.1425219305666667,3.9538740256666665,6.357287728666667,0.2723513795,0.24838482783333332,0.5776,4.4468,0.4102,7.4848,0.4661,0.9852,0.073,0.328,0.638,0.023,1.775,77.17391304347827,1.6059808508333333,5.01556423,4.605211088,0.29780951613333334,0.34225050793333334,362,1.0725925925925925,1,0,0,1,FALSE,FALSE,FALSE
99,2021-11-13T00:49:10Z,2021-11-13T01:24:24Z,2114,1,2021-11-13T01:24:25Z,1,Chrome,95.0.4638.69,Windows NT 10.0,1536,864,NA,1.7777777777777777,903,77,568,189,108,139,0.29239584547757685,-0.11632451032089314,0.6763785954444064,1.028759953423271,0.49799166390832533,0.5679451873228698,3,2,4,3,2,1,1,3,1,2,2,3,3,3,3,4,1,1,3,2,0.9880869341680844,0,1,1,3,2,2.25,0,4,4,5,3,3,1,4,3,1,1,3,4,2,4,2,2,4,1,1,1,2,2,3,1,2,0,0,3,4,4,4,4,4,2,3,4,3,4,2,2,4,2,4,3,2,2,2,3,4,1,1,1,2,1,1,2,2,1,5,1,1,1,2,1,2,1,2,2,1.238763308519644,1.2798809468443688,2,0,1.75,0,2.4,0,2.4444444444444446,0,2.25,0,1.1666666666666667,0,1.1428571428571428,0,1.3333333333333333,0,1.8918918918918919,0,1,0,0,-0.22320173727872722,-0.1536873691539693,-0.2989446853297732,-0.22631602724187125,5,1,5,1,1,1,1,3,1,1.9518001458970664,1,0,2,-0.5341308892722537,3,4,4,4,2,2,3,7,6,3,3,0.8997354108424374,3.142857142857143,0,2.857142857142857,2.5,3.8333333333333335,3.2559414990859232,-1.0219528370065065,0,-0.2877179897144191,2,3,3,3,2,2,4,2,3,2,1,2,3,3,4,1,3,2,4,2,0.990430401872025,2.6,0,3.6,0,3.6,0,3.6,0,3.6,0,2,3,1,2,3,1,2,3,1,1,2,3,2,1,2,3,2,1,1,1,0.812727700887249,1.75,0,"White, Caucasian, Anglo, European American",0,18,1,2,NA,1,4,3,Student studying biomedical engineering,5,0,200,65,3,5,2,0,0,1,0,0,TRUE,TRUE,TRUE,TRUE,TRUE,1,0.8529151515151854,0.66,0.12116349830219614,1,0.4428379310346369,0.49851333333334574,0.9354838709677419,0.967741935483871,0.04151703529041307,0.008712086924753263,1,0.9383406249998371,1.4270038461536885,1,0.9629629629629629,0.2918079528124654,0.4009418419944996,1.4986,0.4534,0.415,1.4625,0.2278,0.4472,0.1355,1.5126585253333333,0.5855104310095667,0.4097257573,1.2414,2.176,0.2252,3.2563,0.3168,-37.599,1.2455,3.6252,0.2478,4.0135,0.3419,0.8493,1.2962835338666667,3.3967987243333333,2.4703929013,0.3135638254,0.22419308886666667,2.4212,1.9469,0.2643,0.8229,0.5015,0.9322,0.134,0.225,0.156,0.005,1.707,341.40000000000003,2.4777085123333333,2.051251913,1.2330530232,0.3103632324666667,0.4329192481,376,1.114074074074074,1,0,1,2,FALSE,FALSE,FALSE
100,2021-11-13T00:45:09Z,2021-11-13T01:25:25Z,2416,1,2021-11-13T01:25:26Z,1,Edge,95.0.1020.44,Windows NT 10.0,1920,1080,"No, everything was fine.",1.7777777777777777,1246,46,647,141,44,113,1.1736887325014396,-0.39795139802954327,1.0567034870520515,0.4438124397891804,-0.3859801528497444,0.12876965154068984,3,2,3,2,3,2,3,2,3,3,2,3,2,2,3,3,2,3,2,3,0.5104177855340404,0,1,1,4,3,2.45,0,1,4,1,4,2,2,4,2,2,4,2,5,1,5,3,2,2,3,3,1,1,3,1,1,2,0,3,2,2,5,5,5,3,3,4,3,4,3,2,3,4,3,2,4,4,3,2,4,3,1,2,2,3,1,3,2,4,3,2,3,4,1,1,1,1,1,1,1,1.1585949863271212,1.424279266355945,2,0,1,0,2.1333333333333333,0,2.4444444444444446,0,3.1666666666666665,0,1.8333333333333333,0,3.142857142857143,0,1,0,2.6486486486486487,0,1,0,3,0.24750737573177983,0.05692815471246996,-0.00479935278395429,0.026064400964257835,5,1,3,2,1,1,2,1,1,1.4638501094227998,1.5714285714285714,0,1,-0.5612498234260587,4,4,5,3,3,4,2,3,3,3,3,0.9759000729485332,3.857142857142857,0,2.142857142857143,6,3.8333333333333335,3.2559414990859232,0.9547190977297628,0,0.30226299054653183,2,2,3,3,4,4,2,3,1,3,3,2,2,3,3,3,2,2,3,4,0.816496580927726,2.8,0,2.6,0,3,0,3.2,0,2.933333333333333,0,3,2,3,3,2,3,3,3,1,2,2,3,3,2,2,2,3,2,3,3,0.6069769786668839,2.4,0,"White, Caucasian, Anglo, European American & Native American/Alaskan Native/indigenous",1,21,0,1,NA,1,3,3,Social Manager,3,0,160.9,68,3,5,2,0,0,1,0,0,TRUE,TRUE,TRUE,TRUE,TRUE,3,0.9439594594614731,0.7708333333333334,0.21366242737606375,3,0.428880000000447,0.5564593750000931,0.967741935483871,1,0.002559224924714439,0.009215067651291355,3,0.6348687500003726,0.7349250000009779,1,1,0.01256044737912635,0.03836104709663325,1.5151,0.8192,0.4368,1.3949,1.0088,0.4571,0.0376,1.5232088563333332,0.8472682160966667,0.4308869476,1.155,5.1763,0.3223,3.3591,0.3845,-76.5325,0.8223,5.7291,0.3544,4.4954,0.4618,0.9885,1.2901330988333333,3.587124007,5.168041593666667,0.37539604883333333,0.31217648253333335,1.4824,5.2235,0.4917,2.2368,0.441,0.8484,0.111,0.361,0.366,0.047,1.991,42.361702127659576,2.3173681893333336,4.226472331666667,3.2604335053333333,0.3614571692,0.37863116543333336,314,0.9303703703703704,1,1,5,6,FALSE,FALSE,FALSE
101,2021-11-13T01:07:39Z,2021-11-13T01:26:31Z,1132,1,2021-11-13T01:26:32Z,0.8999999761581421,Edge,94.0.992.50,Windows NT 10.0,1536,864,no,1.7777777777777777,603,57,264,30,24,89,-0.47841425979110774,-0.2980192765845384,-0.7871501013748863,-0.9088786854896541,-0.6622213455866413,-0.27662315071978394,3,2,2,1,3,1,2,2,1,4,2,2,1,1,3,3,1,1,2,2,0.8870412083230169,0,1,1,4,4,1.85,0,3,4,2,4,1,1,4,2,2,1,1,3,4,3,5,3,4,1,1,1,1,1,2,3,2,0,2,4,2,3,3,4,4,4,4,4,1,4,2,1,1,2,5,5,5,4,2,3,2,4,3,2,3,2,4,3,2,2,2,3,2,2,3,2,3,2,2,2,1.1396485417876858,1.3451854182690985,1.75,0,2.25,0,2,0,2.4444444444444446,0,2.75,0,2.8333333333333335,0,2.7142857142857144,0,2.3333333333333335,0,2.7027027027027026,0,2,0,2,0.12562733754155897,-0.08457915038529361,0.41384948769958696,0.16463516865714667,4,1,3,1,1,1,1,1,1,1.2535663410560174,1.4285714285714286,0,1,-0.6467170085812028,3,4,4,3,1,1,2,5,4,2,2,1.2724180205607036,2.857142857142857,0,3.142857142857143,4.5,3.8333333333333335,3.2559414990859232,0.10757398284279028,0,0.4363874150531028,3,3,2,4,3,2,4,2,4,4,2,2,3,2,4,3,2,3,3,4,0.8837151016885368,3,0,3,0,3.4,0,2.8,0,3.066666666666667,0,3,2,3,2,2,3,2,2,2,2,2,3,2,2,1,2,3,2,1,1,0.6407232755171874,2.2,0,"White, Caucasian, Anglo, European American",0,22,1,2,NA,1,3,3,internet provider,3,0,130,64,2,5,2,0,0,0,0,0,TRUE,TRUE,TRUE,TRUE,TRUE,NA,NA,NA,NA,NA,NA,NA,NA,NA,NA,NA,3,0.6463531250357628,0.7085548387650521,1,1,0.005418067732207775,0.0045102158826363665,NA,NA,NA,NA,NA,NA,NA,NA,NA,NA,NA,NA,NA,NA,NA,NA,NA,NA,NA,NA,NA,NA,NA,NA,NA,NA,NA,0.8786,4.8088,0.5711,5.8832,0.6454,0.8795,0.179,0.393,0.723,0.013,1.327,102.07692307692308,3.113900007333333,5.381327048,4.843867222666667,0.3622298699,0.3944380968333333,104,0.3081481481481481,1,0,0,1,FALSE,FALSE,FALSE
102,2021-11-13T01:00:48Z,2021-11-13T01:26:33Z,1545,1,2021-11-13T01:26:35Z,1,Edge,95.0.1020.40,Windows NT 10.0,1366,768,no,1.7786458333333333,666,53,484,95,85,90,-0.316544137684684,-0.33435822983726743,0.27198250816539127,-0.11676226077682311,0.18031429226089402,-0.2597317839589309,4,4,1,1,4,1,1,2,1,4,4,1,1,1,4,4,1,1,4,4,1.500876936643164,0,1,1,2,2,1.1,0,1,4,5,2,5,5,2,5,5,5,5,1,1,3,4,5,5,5,5,3,5,5,5,25,4,7,10,4,1,1,5,1,3,2,4,2,5,1,5,3,2,3,1,5,5,5,5,5,2,3,5,1,5,3,3,5,5,1,5,1,1,3,5,3,1,3,4,4,1.635290241570032,1.6846647257229665,4.75,0,3,0,4.066666666666666,0,3.4444444444444446,0,4.583333333333333,0,3.3333333333333335,0,2.2857142857142856,0,3.6666666666666665,0,3.6486486486486487,0,6,6,6,2.5800391410963455,2.4993326258731914,3.407020824192241,2.953176725032716,2,5,1,5,5,5,5,8,3,1.7320508075688772,4.857142857142857,0,5.5,3.0649399716269796,2,2,2,1,1,1,5,6,3,1,1,1.4142135623730951,1.4285714285714286,0,4.571428571428571,4.5,3.8333333333333335,3.2559414990859232,0.10757398284279028,0,1.2330973892674701,3,2,5,5,3,3,4,1,1,5,1,5,2,5,5,1,5,1,5,2,1.8309508328682538,3.6,0,4.6,0,4.6,0,4.8,0,4.666666666666667,0,2,3,1,4,2,1,1,3,1,2,3,1,1,1,1,2,1,2,2,1,0.910465468000326,1.75,0,"White, Caucasian, Anglo, European American",0,22,1,2,NA,1,3,6,Marketing,2,0,140,62,2,5,2,0,0,0,0,0,TRUE,TRUE,TRUE,TRUE,TRUE,1,1.0384195122137303,0.82,0.09270006183882341,1,0.46728666671117147,0.5874593750238418,1,1,0.0014253660126571656,0.005181423787446328,1,0.6104281250238418,0.6573333333015442,1,0.967741935483871,0.012136122734656644,0.013115483240477734,1.5024,1.0808,0.6133,1.2114,1.054,0.7116,0.1081,1.518693141,1.0188314913333334,0.6019615933333333,10,15.2689,0.1398,9.9169,0.0833,-95.8931,0.7733,7.4937,0.4199,5.3275,0.5169,0.9513,1.9837784216666667,4.422503818,6.93216424,0.3664139237333333,0.33202552853333334,1.0894,4.2678,0.4994,5.2816,0.5412,0.8775,0.088,0.342,0.338,0.021,1.915,91.19047619047619,2.086552139,3.4335307206666665,3.296903569,0.30222408916666665,0.35376860343333333,362,1.0725925925925925,1,0,0,1,FALSE,FALSE,FALSE
103,2021-11-13T00:53:40Z,2021-11-13T01:26:37Z,1976,1,2021-11-13T01:26:38Z,1,Chrome,95.0.4638.69,Macintosh,1280,800,N/A,1.6,801,106,674,105,115,128,0.030320409686224094,0.1471329007613925,1.1866879436774491,0.0051018045636124325,0.5946760813662392,0.38214015295348597,2,3,3,3,2,3,2,2,1,2,2,2,1,3,2,1,2,2,1,1,0.7254762501100116,0,1,1,3,3,2.7,0,3,5,2,5,1,1,3,2,1,2,4,4,1,4,3,3,3,1,1,2,3,2,3,1,2,0,0,3,3,5,5,5,5,5,5,4,1,5,3,1,4,2,5,1,3,4,5,5,4,1,1,1,2,1,1,2,1,1,5,1,1,1,1,2,1,3,1,2,1.7242311251607114,1.4375905768565218,2.25,0,1.75,0,1.9333333333333333,0,1.5555555555555556,0,2.4166666666666665,0,1.1666666666666667,0,1,0,1.3333333333333333,0,1.7027027027027026,0,1,0,0,-0.1853768978403831,-0.32810334985586437,-0.2989446853297732,-0.3135240175928188,5,1,5,1,1,1,1,2,2,1.9518001458970664,1,0,2,-0.5341308892722537,5,5,5,4,4,4,1,4,6,5,4,1.4142135623730951,4.571428571428571,0,1.4285714285714286,4,3.8333333333333335,3.2559414990859232,-0.1748077221195339,0,-0.6608554064853003,3,2,2,3,3,2,5,1,2,3,1,5,3,3,4,1,5,3,5,1,1.5796322658258457,2.6,0,4.4,0,4.2,0,4.2,0,4.266666666666667,0,4,3,2,3,2,1,2,2,1,2,3,3,2,2,3,4,1,2,1,2,0.910465468000326,2.05,0,"White, Caucasian, Anglo, European American",0,20,1,2,NA,1,4,3,Orientation Leader,6,0,140,63,1,5,2,0,1,4,0,1,TRUE,TRUE,TRUE,TRUE,TRUE,1,0.8391162790725397,0.8775510204081632,0.10474905783811077,1,0.3886437500081956,0.468629999991258,1,0.967741935483871,0.001582991572878159,0.002486410902875531,1,0.6070499999970198,0.632522580642854,1,0.96875,0.007751764514473946,0.012574257247234481,1.5909,1.3166,0.4178,1.084,1.7249,0.5749,0.4057,1.5545397576666666,1.1613218114,0.4148372973,1.0024,5.8646,0.3032,4.8483,0.3697,-104.6912,0.8232,7.6415,0.3362,6.4928,0.4025,0.918,1.0650460173333334,4.659913127666667,5.620143079,0.3635891368333333,0.2979354753333333,1.2006,4.314,0.4761,3.2416,0.4563,0.9655,0.078,0.401,0.36,0.095,1.764,18.568421052631578,1.8054664273333334,4.085764116,3.41605298,0.3859814711333333,0.3820880858333333,388,1.1496296296296296,1,0,0,1,FALSE,FALSE,FALSE
104,2021-11-13T01:08:23Z,2021-11-13T01:28:44Z,1220,1,2021-11-13T01:28:45Z,0.800000011920929,Safari,14.1.1,Macintosh,1440,900,NA,1.6,621,114,259,55,39,81,-0.43216565347498664,0.2198108072668506,-0.8112212970462562,-0.6042185221385653,-0.4550404510339686,-0.4117540848066085,2,3,4,4,3,3,3,2,3,2,2,4,3,2,2,3,4,3,2,2,0.7677718959499145,0,1,1,2,3,3,0,2,3,4,3,5,4,1,5,5,4,3,1,2,2,1,3,5,2,1,4,5,5,5,7,3,0,0,5,2,2,1,3,2,1,3,1,4,2,5,1,3,5,4,5,5,5,5,5,2,1,1,1,5,3,1,5,5,2,3,5,4,2,3,5,3,4,4,3,1.6075086575456083,1.4638501094227998,3.75,0,3.5,0,4.066666666666666,0,3.7777777777777777,0,4.083333333333333,0,2.3333333333333335,0,3.4285714285714284,0,3.3333333333333335,0,3.5945945945945947,0,4,0,0,1.9244085908317106,2.0463543852045625,0.8591411550804637,1.452747770142513,3,2,3,1,1,3,2,3,1,0.8997354108424374,2.142857142857143,0,2,0.14960659196890055,4,3,3,2,3,2,2,7,7,NA,2,0.7559289460184544,3,0,3,2,3.8333333333333335,3.2559414990859232,-1.3043345419688306,0,-0.34923784477414443,3,2,2,4,3,2,5,3,2,1,4,3,4,2,3,5,3,2,4,3,1.162919151265879,2.8,0,3.2,0,2.6,0,3,0,2.933333333333333,0,3,4,3,2,3,3,4,3,3,4,4,3,2,3,2,3,1,3,3,2,0.7880689256524124,2.8,0,"White, Caucasian, Anglo, European American",0,19,1,3,NA,1,3,3,telemetry technician,3,0,130,67,2,5,2,0,1,0,0,1,TRUE,TRUE,TRUE,TRUE,TRUE,3,0.6881388888888873,0.7346938775510204,0.055719308673470976,3,0.48166666666665586,0.5349374999999964,1,1,0.016019769230767946,0.004486383064517314,3,0.6424374999999991,0.6807419354838743,1,1,0.013384705645161605,0.01690273118279549,1.1745,0.8811,0.3722,0.8957,0.9813,0.4896,0.3159,1.2311250287333333,0.90790753126,0.36414633776666666,5.3543,6.0142,0.0365,8.4395,0.2177,-64.5885,0.8184,4.3551,0.3858,5.6734,0.4674,0.8644,2.0875653463333332,5.222898146333334,3.757129218333333,0.34109480633333333,0.19743714683333333,2.0792,13.5448,0.5629,8.6471,0.5581,0.9615,0.168,0.268,0.435,0.039,1.495,38.333333333333336,2.574577731,4.159094706333334,3.5508964756666668,0.3335272126,0.32005327733333333,424,1.2562962962962962,1,0,0,1,FALSE,FALSE,FALSE
105,2021-11-13T00:40:01Z,2021-11-13T01:28:48Z,2926,1,2021-11-13T01:28:50Z,0.8999999761581421,Chrome,95.0.4638.69,Macintosh,1440,900,Thank you!,1.6,690,1127,564,86,284,120,-0.2548793292631892,9.422650718520483,0.6571216389073103,-0.2264399195832151,2.928914159993017,0.24700921886666136,1,1,3,3,1,1,2,2,1,1,2,3,3,2,1,1,3,3,1,1,0.8944271909999159,0,1,3,2,2,3.1,0,3,1,2,1,3,4,2,3,3,2,4,3,4,2,1,4,2,2,3,3,5,3,5,4,5,2,1,2,1,1,1,1,3,3,3,3,2,5,5,2,1,2,3,5,5,5,5,5,3,5,3,4,3,1,3,4,3,1,1,5,5,4,5,3,3,3,3,2,1.5122125468289127,1.0600988273786194,3.375,0,2.75,0,3.6,0,4,0,3.75,0,3,0,3.5714285714285716,0,4,0,3.72972972972973,0,2,2,1,1.7752106130471301,1.7427234576452704,0.8074686614209358,1.2750960595331031,4,1,4,3,1,1,3,3,3,1.3972762620115438,1.8571428571428572,0,3,0.34765989643299416,3,4,3,3,1,1,5,4,4,1,1,1.4638501094227998,2.2857142857142856,0,3.7142857142857144,5,3.8333333333333335,3.2559414990859232,0.38995568780511447,0,0.8962622572200118,4,4,4,4,4,3,5,4,3,5,1,3,3,3,5,1,5,3,5,5,1.4040757000349275,4,0,3.8,0,4.6,0,2.8,0,3.7333333333333334,0,2,2,2,2,3,1,4,4,2,3,3,3,1,3,2,4,2,1,3,3,0.9459053029269173,2.2,0,"White, Caucasian, Anglo, European American",0,22,1,2,NA,1,2,6,Research Assistant,2,0,148,66,2,5,2,1,1,1,0,2,TRUE,TRUE,TRUE,TRUE,TRUE,2,0.73394102564072,0.78,0.03822378496400457,2,0.47863750000763683,0.5571600000013908,1,0.9375,0.004779921128823358,0.00718250963761583,2,0.6682656249990687,0.7785620689690113,1,0.90625,0.010267068780060977,0.029481759959736724,1.5666,0.9201,0.2623,0.8809,1.4573,0.5715,0.3521,1.5503968853333334,0.9113141197,0.26100198246666667,0.9975,3.9751,0.3532,3.247,0.4178,-73.1052,0.8891,5.5971,0.399,3.7278,0.4439,0.9918,1.1712848817666666,3.4972099433333335,4.346747275666667,0.40316013166666664,0.3426740704333333,0.9794,3.7729,0.5463,2.5583,0.6077,0.9341,0.06,0.521,0.389,0.014,1.568,112,1.9112619066666667,4.00382065,2.0459540841333332,0.42879679713333335,0.37419216943333333,104,0.3081481481481481,1,0,0,1,FALSE,FALSE,FALSE
106,2021-11-13T01:01:52Z,2021-11-13T01:29:55Z,1683,1,2021-11-13T01:29:56Z,1,Edge,95.0.1020.44,Windows NT 10.0,1280,720,no,1.7777777777777777,899,52,418,91,64,99,0.2821183774073277,-0.3434429681504497,-0.04575727469669198,-0.1655078869129973,-0.10973896011284763,-0.10770948311125321,3,3,2,1,2,1,1,2,1,2,2,1,1,1,3,3,1,1,2,2,0.7863975156570492,0,1,2,4,3,1.85,0,3,3,2,4,1,2,4,3,2,1,1,3,4,4,3,2,2,1,1,1,3,1,3,1,2,2,3,5,2,2,3,3,4,3,2,2,2,4,2,1,1,1,1,1,2,4,4,4,4,2,1,1,2,1,1,2,2,2,5,1,2,1,1,1,3,2,2,3,1.2502252049383196,1.1126972805283737,1.75,0,2.5,0,2.2666666666666666,0,3.111111111111111,0,2.75,0,1.3333333333333333,0,1.4285714285714286,0,1,0,2.27027027027027,0,1,2,3,-0.143349298464445,-0.15581675404600126,0.8788742787055398,0.36152876232976927,4,2,2,4,2,3,3,3,1,0.8997354108424374,2.857142857142857,0,2,0.5769425177446221,5,5,5,5,2,2,2,1,1,1,2,1.6035674514745464,4,0,2,8,3.8333333333333335,3.2559414990859232,2.0842459175790595,0,0.7873554030497435,3,2,3,2,2,2,5,2,2,3,2,4,2,3,4,1,4,3,3,2,1.082325538564332,2.4,0,3.8,0,4,0,3.8,0,3.8666666666666667,0,3,2,4,2,2,4,2,2,2,2,1,2,1,3,2,2,3,4,1,2,0.9233805168766387,2.5,0,"Hispanic of Latino (e.g., Mexican American, Central American, and others)",0,19,1,2,NA,1,2,4,Student,2,0,110,63,3,5,2,0,0,0,0,0,TRUE,TRUE,TRUE,TRUE,TRUE,2,1.1501857142857144,0.7142857142857143,0.27543416791707126,NA,NA,NA,NA,NA,NA,NA,2,0.740590624999255,0.8235741935487717,1,1,0.01509942023182017,0.0337829706450145,1.6472,0.5456,0.6684,1.6069,0.2836,0.6801,5e-4,1.6605702766666666,0.6306652490133333,0.6504871801,NA,NA,NA,NA,NA,NA,NA,NA,NA,NA,NA,NA,NA,NA,NA,NA,NA,1.216,3.2792,0.5653,2.8225,0.6104,0.989,0.184,0.352,0.479,0.011,1.169,106.27272727272728,2.7050563396666667,4.134798890666667,3.5773757563333333,0.4136003591333333,0.44709283823333335,366,1.0844444444444443,1,0,0,1,FALSE,FALSE,FALSE
107,2021-11-13T00:54:55Z,2021-11-13T01:29:56Z,2101,1,2021-11-13T01:29:57Z,0.8999999761581421,Chrome,95.0.4638.69,Windows NT 10.0,1368,912,Everything went well and I had no problems with the tasks.,1.5,686,94,499,147,85,122,-0.26515679733343833,0.038116041003205335,0.3441960951795011,0.5169308789934417,0.18031429226089402,0.2807919523883675,2,3,3,4,2,3,3,2,1,2,2,3,3,4,2,1,2,3,1,1,0.9333020044867296,0,1,1,4,5,3.05,0,4,4,2,5,2,1,4,1,2,2,2,5,1,5,5,1,3,1,1,1,1,1,1,0,2,0,0,5,5,4,4,5,5,5,5,5,1,5,1,2,5,3,5,2,2,2,4,4,5,1,1,1,5,2,1,1,1,1,5,2,1,1,3,1,1,1,1,1,1.7480147469502525,1.6035674514745464,1.25,0,1,0,1.5333333333333334,0,1.2222222222222223,0,2,0,1.6666666666666667,0,1,0,1.6666666666666667,0,1.5945945945945945,0,0,0,0,-0.8746295276057681,-0.9762106788125177,-0.7372407672780129,-0.8567257230452653,5,2,3,1,1,1,1,1,1,1.5275252316519468,1.4285714285714286,0,1,-0.6467170085812028,4,4,5,4,5,4,3,6,5,2,2,0.6900655593423543,4.142857142857143,0,1.8571428571428572,3.5,3.8333333333333335,3.2559414990859232,-0.4571894270818581,0,-0.563033266702152,5,5,5,3,4,5,4,3,4,3,4,3,3,4,5,4,3,2,5,4,0.8837151016885368,4.4,0,2.6,0,3.4,0,3.2,0,3.066666666666667,0,3,1,2,3,4,1,4,4,1,2,1,4,2,3,1,4,3,3,1,2,1.190974832912761,1.95,0,"Asian or Asian American (e.g., Chinese, Japanese, and others)",0,26,1,3,NA,1,2,6,student,1,0,99,62,2,5,2,0,0,0,0,0,TRUE,TRUE,TRUE,TRUE,TRUE,6,0.7072242424226168,0.66,0.17060721959289915,6,0.36121199999928477,0.39425925925815547,0.8620689655172413,0.84375,0.0024627716749243468,0.005273612097032463,6,0.550375,0.6158600000023842,1,0.9375,0.010059782580729914,0.006058048225350566,1.2979,0.5019,0.4265,1.1592,0.2511,0.4463,0.0781,1.3416028136666667,0.6452435196456666,0.41784752576666667,0.805,2.9153,0.2549,1.9898,0.2472,-54.3419,0.6679,4.0509,0.2825,2.4708,0.3075,0.9421,0.8512591914666666,2.306818396666667,3.324980314,0.2444399595,0.25249449343333336,0.9058,3.0006,0.4303,4.5168,0.5148,0.9978,0.073,0.376,0.475,0.013,1.602,123.23076923076924,1.6571418723333333,4.118036149,2.9514443486666666,0.3492976154333333,0.3556360241666667,476,1.4103703703703703,1,0,0,1,FALSE,FALSE,FALSE
108,2021-11-13T01:06:32Z,2021-11-13T01:30:05Z,1413,1,2021-11-13T01:30:06Z,1,Chrome,93.0.4577.82,Macintosh,1440,900,no,1.6,791,54,311,66,41,84,0.0046267395106012734,-0.3252734915240852,-0.5608808620640088,-0.47016805026408615,-0.42741633176027893,-0.3610799845240493,1,1,2,2,1,1,2,1,1,2,2,2,2,2,1,1,2,2,1,2,0.5104177855340404,0,1,2,3,3,2.75,0,1,4,3,3,2,1,3,3,2,2,3,3,2,4,4,2,2,1,1,1,1,1,1,3,2,0,0,4,3,4,4,4,4,4,4,4,2,4,2,1,4,1,5,2,2,3,3,3,4,1,1,1,3,1,1,3,3,1,4,1,1,1,1,1,2,1,2,1,1.3445474360571321,0.9759000729485332,1.25,0,1.5,0,2.533333333333333,0,2.111111111111111,0,2,0,1.3333333333333333,0,1.5714285714285714,0,1,0,1.8108108108108107,0,2,0,0,-0.7401412096027664,-0.4535434780410229,-0.17425341425049792,-0.3138984461457604,4,2,4,1,1,1,1,1,1,1.4142135623730951,1.4285714285714286,0,1,-0.6467170085812028,4,4,4,4,4,4,1,6,3,3,2,1.1338934190276817,4.142857142857143,0,1.8571428571428572,4.5,3.8333333333333335,3.2559414990859232,0.10757398284279028,0,-0.28065156173982786,2,3,3,3,2,3,3,3,2,2,2,4,4,4,3,2,4,3,3,3,0.7559289460184544,2.6,0,3.6,0,2.8,0,3.4,0,3.2666666666666666,0,3,3,3,2,2,3,3,2,3,3,2,2,3,3,3,2,2,3,3,2,0.5026246899500346,2.8,0,"Hispanic of Latino (e.g., Mexican American, Central American, and others)",0,21,1,2,NA,1,3,5,student,7,0,145,64,1,5,2,0,0,1,0,0,TRUE,TRUE,TRUE,TRUE,TRUE,NA,NA,NA,NA,2,0.561916129031489,0.7156499999985099,1,1,0.004185088064388799,0.009190049677267111,2,0.679961290324888,0.8969299999992053,0.96875,0.967741935483871,0.00693418064508193,0.07116477982895782,NA,NA,NA,NA,NA,NA,NA,NA,NA,NA,8.4143,9.7871,0.1321,7.9751,0.1881,-72.3481,0.8932,5.3899,0.486,3.0811,0.599,0.9979,2.2812309453333333,4.424335276333333,5.266048733,0.4604002204666667,0.3480228413,1.5726,5.3379,0.528,2.9436,0.5903,0.9418,0.079,0.496,0.352,0.013,1.727,132.84615384615387,1.826291084,4.316281206,2.1288811426666667,0.4807840888,0.46986408216666664,268,0.794074074074074,1,0,0,1,FALSE,FALSE,FALSE
109,2021-11-13T00:54:00Z,2021-11-13T01:32:50Z,2329,1,2021-11-13T01:32:51Z,0.800000011920929,Chrome,88.0.4324.190,Windows NT 10.0,1366,768,"My Parents were never married, broke up before I was born. I grew up with my dad only.",1.7786458333333333,874,86,689,143,134,165,0.21788420196827069,-0.03456186550225277,1.258901530691559,0.4681852528572675,0.8571052144662912,1.0071207231050496,2,2,3,3,3,1,1,1,1,2,1,1,1,1,3,2,1,1,2,3,0.8506963092234007,0,1,2,5,1,2.15,0,4,4,1,4,1,1,5,1,2,1,1,5,1,4,2,1,1,1,1,1,2,1,1,3,2,0,2,5,5,5,5,5,5,2,4,3,2,4,1,1,2,1,4,1,1,1,2,1,1,2,5,1,4,4,1,2,3,2,5,1,2,1,1,1,1,1,1,2,1.6237723475403307,1.6417180315870614,1.125,0,1.25,0,1.5333333333333334,0,1.6666666666666667,0,1.5833333333333333,0,3.3333333333333335,0,1.5714285714285714,0,1,0,1.8918918918918919,0,2,0,2,-0.7674591491971259,-0.9021661587032226,0.10024467683062248,-0.4009607409363001,5,1,2,1,1,2,1,1,1,1.4638501094227998,1.5714285714285714,0,1,-0.5612498234260587,1,3,4,2,1,1,2,3,4,3,3,1.1547005383792515,2.2857142857142856,0,3.7142857142857144,5.5,3.8333333333333335,3.2559414990859232,0.6723373927674386,0,1.037453109701174,4,4,4,2,2,2,2,3,4,2,2,2,3,4,4,3,3,2,1,4,0.9611501047232549,3.2,0,3.4,0,2.2,0,3,0,2.8666666666666667,0,2,2,3,1,2,3,3,1,2,1,2,1,2,3,1,2,2,3,1,2,0.7591546545162482,2.45,0,"Asian or Asian American (e.g., Chinese, Japanese, and others) & Hispanic of Latino (e.g., Mexican American, Central American, and others)",1,20,1,2,NA,1,1,3,self employed,1,0,145,64,1,5,2,0,0,0,0,0,TRUE,TRUE,TRUE,TRUE,TRUE,2,1.1390314515559905,0.6458333333333334,0.1939662576902275,2,0.580947580416837,0.6437465000897646,0.96875,0.967741935483871,0.03863139058503473,0.012774767661201475,2,0.7058076667909821,0.8714398441952653,1,1,0.02285706692575302,0.023676719128934248,1.6695,0.3789,0.5657,1.4271,0.3566,0.6959,0.2251,1.6603314213333333,0.5109889884093334,0.5564286386333334,1.6041,2.2641,0.2425,3.1578,0.4017,-26.6295,1.2327,2.4292,0.3382,3.1279,0.4607,0.9038,1.6875914383333332,3.2481663153333336,2.5134849386666667,0.39151917106666667,0.24099519866666666,1.3177,3.7135,0.5353,2.7477,0.6599,0.938,0.332,0.126,0.596,0.005,1.258,251.6,2.852628694,4.033113836333333,3.6432381896666666,0.35181567036666667,0.48125075846666665,344,1.0192592592592593,1,0,0,1,FALSE,FALSE,FALSE
110,2021-11-13T01:06:57Z,2021-11-13T01:33:19Z,1581,1,2021-11-13T01:33:20Z,1,Chrome,95.0.4638.69,Macintosh,1440,900,NA,1.6,714,60,448,120,68,84,-0.19321452084169444,-0.2707650616449916,0.09866989933152767,0.18789790257426575,-0.054490721565468275,-0.3610799845240493,2,4,3,2,2,1,1,2,1,3,3,1,1,2,2,4,1,1,3,2,0.998683343734455,0,1,4,3,3,1.85,0,4,4,2,5,1,1,4,3,1,1,1,4,2,4,5,2,3,5,1,1,1,2,1,2,2,1,2,5,4,4,3,3,5,5,4,4,2,4,1,1,3,1,5,2,2,1,1,1,3,1,2,3,2,1,1,2,1,1,5,1,1,1,1,1,1,2,1,1,1.4972447167185936,1.5675276256394517,2,0,1.25,0,1.6,0,1.8888888888888888,0,1.5,0,1.8333333333333333,0,1,0,1,0,1.5675675675675675,0,1,1,2,-0.4249342142832303,-0.6368641592005065,0.10378541062712981,-0.2665393742866884,5,1,5,1,1,2,1,1,1,1.889822365046136,1.1428571428571428,0,1,-0.8176513788914915,5,5,5,5,2,2,1,4,6,NA,3,1.8126539343499315,4.142857142857143,0,1.8571428571428572,4,3.8333333333333335,3.2559414990859232,-0.1748077221195339,0,-0.42184241422098995,2,2,3,3,2,2,4,2,2,1,2,3,2,3,5,1,3,2,4,3,1.121223821162776,2.4,0,3.6,0,3.6,0,3.8,0,3.6666666666666665,0,1,1,1,4,2,1,1,4,1,1,1,3,2,1,1,3,1,1,1,1,1.0462967275611939,1.2,0,"White, Caucasian, Anglo, European American",0,21,1,2,NA,1,4,4,Student,7,0,215,64,2,5,2,0,0,1,0,0,TRUE,TRUE,TRUE,TRUE,TRUE,3,0.7896675675753001,0.74,0.03064934041421359,3,0.43976249999552963,0.5793096774162785,1,0.96875,0.003950130160861132,0.003289109508710302,3,0.6575093749985099,0.7409593750163913,1,1,0.020675486681151878,0.025717867637156663,1.4261,0.8222,0.3768,0.8661,1.2223,0.6285,0.3276,1.450332636,0.8562880522333334,0.37095647573333335,1.8143,4.861,0.2531,4.6009,0.3942,-70.7086,0.6409,5.5542,0.394,4.7344,0.523,0.9818,1.7430893086666666,4.303780243666667,4.705687179666667,0.3912476316333333,0.2551497085666667,1.2591,3.3068,0.4767,4.7326,0.5953,0.9826,0.21,0.25,0.529,0.018,1.723,95.72222222222223,2.550829999,3.6441670686666665,3.741023447,0.3048285094666667,0.4026476095,448,1.3274074074074074,1,0,1,2,FALSE,FALSE,FALSE
111,2021-11-13T01:09:48Z,2021-11-13T01:33:49Z,1440,1,2021-11-13T01:33:50Z,0.8999999761581421,Chrome,95.0.4638.69,Windows NT 10.0,1536,864,N/A,1.7777777777777777,710,61,335,69,57,135,-0.20349198891194356,-0.26168032333180935,-0.44533912284143307,-0.4336088306619555,-0.2064233775707615,0.5003797202794574,4,3,1,1,3,1,2,3,1,4,2,1,1,1,4,3,1,1,3,3,1.1821033884786185,1,0,2,3,2,1.45,0,4,5,2,4,3,1,5,1,1,1,1,4,2,5,5,1,1,1,1,1,1,1,2,3,2,0,0,5,4,5,4,5,5,2,5,3,1,4,1,1,3,1,4,4,1,1,2,1,5,1,1,1,3,1,1,2,1,1,4,3,1,1,1,1,1,1,2,1,1.60797561722359,1.709915063331955,1.125,0,1.25,0,1.4666666666666666,0,1.7777777777777777,0,1.6666666666666667,0,1.1666666666666667,0,1.4285714285714286,0,1,0,1.5675675675675675,0,2,0,0,-0.9691916262016289,-1.0701939847290214,-0.25265461696773905,-0.6614243008483802,5,1,5,1,1,1,1,1,1,1.9518001458970664,1,0,1,-0.9031185640466358,5,5,5,5,4,3,1,6,7,5,4,1.5275252316519468,4.571428571428571,0,1.4285714285714286,2.5,3.8333333333333335,3.2559414990859232,-1.0219528370065065,0,-1.0844279639287866,2,3,3,2,2,3,4,1,1,1,1,3,1,4,2,1,4,1,4,3,1.3345232785352157,2.4,0,4,0,3.8,0,3.8,0,3.8666666666666667,0,1,3,1,4,2,1,1,4,1,1,1,4,1,1,1,4,1,1,1,1,1.2513150976809202,1.15,0,"White, Caucasian, Anglo, European American",0,19,1,2,NA,1,4,3,vet anesthesia assistant,1,0,112,61,2,5,2,0,1,0,0,1,TRUE,TRUE,TRUE,TRUE,TRUE,NA,NA,NA,NA,NA,NA,NA,NA,NA,NA,NA,6,0.8094250000001048,0.8933333333332713,1,0.967741935483871,0.020396151612911907,0.02283140397853056,NA,NA,NA,NA,NA,NA,NA,NA,NA,NA,NA,NA,NA,NA,NA,NA,NA,NA,NA,NA,NA,NA,NA,NA,NA,NA,NA,1.2975,4.0523,0.6334,2.6448,0.6785,0.9611,0.075,0.592,0.342,0.018,1.724,95.77777777777779,2.384505659333333,3.9859169303333335,2.9763810553333334,0.5090784011,0.5099563808,104,0.3081481481481481,1,1,1,2,TRUE,FALSE,FALSE
112,2021-11-13T01:14:19Z,2021-11-13T01:33:52Z,1172,1,2021-11-13T01:33:53Z,1,Chrome,95.0.4638.69,Windows NT 10.0,2066,1162,N/A,1.7779690189328743,592,48,287,79,59,65,-0.5066772969842929,-0.3797819214031788,-0.6764226012865845,-0.31174476532151996,-0.17879925829707183,-0.6820159529802577,4,4,1,1,4,1,1,4,1,4,4,1,3,1,4,4,1,1,4,4,1.500876936643164,0,1,2,3,4,1.1,0,2,4,2,3,3,4,3,2,2,1,1,4,1,3,2,2,3,5,1,2,2,2,1,5,2,1,2,4,3,4,4,3,2,3,2,3,1,3,3,1,2,1,5,3,3,1,1,1,3,1,1,3,2,1,1,3,3,1,3,2,1,1,1,1,2,2,2,2,1.150792911137501,1.0600988273786194,2.25,0,2,0,2.466666666666667,0,2.888888888888889,0,1.9166666666666667,0,1.6666666666666667,0,1.8571428571428572,0,1,0,2.081081081081081,0,3,1,2,0.04997765866487016,0.06370347027802684,0.7451739663718859,0.40443871832495637,4,1,2,1,1,2,2,1,2,1.0690449676496976,1.8571428571428572,0,1.5,-0.20582161572857902,5,5,5,5,2,2,2,6,3,2,3,1.6035674514745464,4,0,2,4.5,3.8333333333333335,3.2559414990859232,0.10757398284279028,0,-0.20098056431839117,2,2,2,2,2,1,4,1,1,1,1,4,1,4,1,2,1,1,3,4,1.3627702877384937,2,0,4,0,3.4,0,3.4,0,3.6,0,1,1,1,1,1,2,2,3,1,1,1,3,1,2,1,3,1,2,1,1,0.7608859102526822,1.5,0,"White, Caucasian, Anglo, European American",0,26,0,1,NA,1,3,7,Unemployed,1,0,215,70,3,5,2,0,0,1,0,0,TRUE,TRUE,TRUE,TRUE,TRUE,2,0.6655787878795103,0.66,0.0648259567714906,NA,NA,NA,NA,NA,NA,NA,2,0.5247218749993481,0.603261290322869,1,0.96875,0.002169203699700842,0.0035008670565580577,1.2655,0.5412,0.3144,1.0918,0.4356,0.3848,0.0736,1.3080292303333334,0.68255669737,0.30886693183333336,NA,NA,NA,NA,NA,NA,NA,NA,NA,NA,NA,NA,NA,NA,NA,NA,NA,0.6043,6.1318,0.4793,5.5948,0.5609,0.9546,0.073,0.419,0.704,0.025,2.152,86.08,1.7269806608666667,6.091720348333333,3.674029624666667,0.3904342081,0.3800059925666667,105,0.3111111111111111,1,1,3,4,FALSE,FALSE,FALSE
113,2021-11-13T01:05:07Z,2021-11-13T01:34:09Z,1742,1,2021-11-13T01:34:11Z,1,Chrome,95.0.4638.69,Macintosh,1440,900,nope :),1.6,756,107,470,92,68,102,-0.0853011061040786,0.15621763907457475,0.20458316028555543,-0.15332148037895377,-0.054490721565468275,-0.057035382828693984,3,2,1,2,2,3,3,1,1,2,1,1,1,2,2,1,2,1,2,1,0.7326950970650465,0,1,1,2,1,2.5,0,5,4,2,4,2,1,5,2,2,1,1,4,3,4,4,2,2,1,1,2,1,1,3,0,2,0,0,5,2,3,4,4,5,2,3,4,1,4,1,2,4,2,5,2,1,2,2,1,5,1,1,1,2,1,1,1,1,1,5,1,1,1,3,2,1,1,1,1,1.4760347823404023,1.4375905768565218,1.625,0,1,0,1.7333333333333334,0,2.4444444444444446,0,1.5833333333333333,0,1,0,0.8571428571428571,0,2,0,1.6486486486486487,0,0,0,0,-0.6077542715685611,-0.7058755877468168,-0.7372407672780129,-0.7215581775124149,4,2,3,1,1,3,2,1,1,1.1126972805283737,2,0,1,-0.3048482679606258,5,5,5,5,3,2,1,6,6,5,3,1.7043362064926932,4.285714285714286,0,1.7142857142857142,3,3.8333333333333335,3.2559414990859232,-0.7395711320441822,0,-0.783895116604751,1,3,1,1,1,1,4,1,1,3,2,5,2,4,3,3,5,1,5,1,1.5796322658258457,1.4,0,4.8,0,3.8,0,4.4,0,4.333333333333333,0,2,3,4,1,3,4,4,1,2,3,4,1,2,1,1,1,2,4,4,3,1.2354415362426845,3.1,0,"White, Caucasian, Anglo, European American",0,20,1,2,NA,1,3,4,unemployed,5,0,200,64,1,5,2,0,0,0,0,0,TRUE,TRUE,TRUE,TRUE,TRUE,2,1.1700358974322294,0.7959183673469388,0.24580718831063444,2,0.48373749999329446,0.5667062500081956,1,1,0.00292126822640917,0.007214141250998484,2,0.6506656250059605,0.709806451628285,1,0.96875,0.008036759101702436,0.015484387893903122,1.6273,0.8086,0.6093,1.6014,0.8086,0.5687,0.038,1.6340154426666667,0.8301442714333334,0.5965181477333333,6.3161,9.9439,0.1662,7.9642,0.1702,-83.9407,0.9028,7.0608,0.4222,5.3319,0.4784,0.9984,1.902865326,4.7004183526666665,5.448354252333333,0.3684749256,0.3126801961333333,0.9167,6.0806,0.5839,2.5123,0.5782,0.9474,0.079,0.438,0.367,0.02,1.606,80.3,2.0107471246666666,4.080593811666667,3.2385646876666665,0.4043414869333333,0.4135324256,378,1.12,1,0,0,1,FALSE,FALSE,FALSE
115,2021-11-13T01:05:17Z,2021-11-13T01:35:10Z,1793,1,2021-11-13T01:35:13Z,0.8999999761581421,Safari,14.0.1,Macintosh,1440,900,NA,1.6,678,119,662,134,80,85,-0.2857117334739366,0.2652344988327619,1.1289170740661612,0.3585075940508755,0.1112539940766698,-0.34418861776319626,4,3,2,3,2,1,2,3,1,3,3,1,1,2,2,2,1,1,2,2,0.8870412083230169,0,1,2,2,2,1.95,0,4,5,2,5,2,2,4,2,2,1,1,4,2,4,3,2,4,5,1,1,3,2,2,3,3,1,6,4,5,3,4,4,4,3,3,3,3,5,2,1,3,4,4,5,4,4,4,1,2,4,5,2,1,1,1,4,4,2,4,2,2,1,1,1,1,2,1,2,1.3639502778182058,1.3557637102737474,2.5,0,1.5,0,1.8,0,2.3333333333333335,0,2.8333333333333335,0,2.6666666666666665,0,2.2857142857142856,0,1,0,2.4864864864864864,0,2,1,6,0.4576453726114698,0.058863959159771675,1.0910776747376103,0.574970816948691,5,1,3,1,2,2,1,1,1,1.4638501094227998,1.5714285714285714,0,1,-0.5612498234260587,5,5,5,5,4,4,1,5,8,5,4,1.4638501094227998,4.714285714285714,0,1.2857142857142858,2.5,3.8333333333333335,3.2559414990859232,-1.0219528370065065,0,-1.1640989613502233,1,1,3,3,1,2,5,1,1,4,1,5,2,5,5,1,5,1,5,3,1.8309508328682538,1.8,0,4.8,0,4.6,0,4.6,0,4.666666666666667,0,2,4,2,2,1,2,2,3,1,1,4,3,2,3,2,3,2,3,2,4,0.9403246919632545,2.3,0,"White, Caucasian, Anglo, European American",0,21,1,2,NA,1,3,6,student,3,0,139,66,4,5,2,0,0,1,0,0,TRUE,TRUE,TRUE,TRUE,TRUE,6,1.3234999999999948,0.7083333333333334,0.22919291489361468,6,0.44387499999999724,0.5529062499999982,1,1,0.0025310806451611994,0.006360732862903239,6,0.6250624999999964,0.71453125,1,1,0.004109415322581272,0.0037916118951618425,2.0524,0.4656,0.4902,1.6723,0.3669,0.8042,0.6126,1.921022604,0.530654736476,0.4922573014666667,1.5802,6.3099,0.3187,5.5132,0.4096,-96.657,0.7863,6.4345,0.3815,3.6606,0.4577,0.8999,1.5192728257333334,4.966163032333333,5.7296889166666665,0.40528835123333334,0.31577306510000003,0.9077,5.3587,0.5393,5.7263,0.6383,0.9699,0.189,0.383,0.801,0.014,1.552,110.85714285714286,2.1600153192,5.673739395666667,5.488252241,0.4417096990666667,0.5274055973666667,408,1.208888888888889,1,0,0,1,FALSE,FALSE,FALSE
116,2021-11-13T01:10:06Z,2021-11-13T01:35:14Z,1507,1,2021-11-13T01:35:18Z,1,Chrome,95.0.4638.69,Windows NT 10.0,2560,1080,No feedback,2.3703703703703702,626,66,468,110,68,115,-0.4193188183871753,-0.21625663176589804,0.19495468201700744,0.0660338372338302,-0.054490721565468275,0.16255238506239597,4,4,1,2,3,1,1,3,1,3,2,1,1,1,4,4,1,1,3,3,1.2396943596157715,0,1,3,3,3,1.4,0,4,4,2,4,2,1,4,2,2,1,2,4,2,4,5,2,3,1,1,2,1,1,1,1,2,0,0,5,4,5,5,5,5,4,4,4,1,5,2,1,3,3,5,4,3,3,3,3,4,1,1,1,2,1,1,2,1,1,5,2,2,1,1,1,1,1,1,1,1.578287360080854,1.3020130933435712,1.5,0,1,0,1.8,0,1.4444444444444444,0,2.3333333333333335,0,1.1666666666666667,0,1.2857142857142858,0,1,0,1.6756756756756757,0,1,0,0,-0.6686942906636716,-0.7193294286555646,-0.5341482934814965,-0.6267388610685305,5,1,4,1,1,1,2,1,1,1.6761634196950514,1.2857142857142858,0,1,-0.7321841937363471,5,5,5,4,2,2,1,3,4,5,3,1.7182493859684491,4,0,2,5.5,3.8333333333333335,3.2559414990859232,0.6723373927674386,0,0.081401140643933,2,2,2,1,1,2,5,1,1,3,2,5,2,3,4,1,5,3,4,5,1.533747356112131,1.6,0,4.2,0,4.2,0,3.6,0,4,0,1,2,1,4,1,1,1,3,1,1,1,3,1,1,2,3,1,1,1,2,0.9403246919632545,1.3,0,"White, Caucasian, Anglo, European American",0,20,0,1,NA,1,3,3,Student,4,0,160,68,3,5,2,0,0,1,0,0,TRUE,TRUE,TRUE,TRUE,TRUE,3,0.7945051282046315,0.78,0.05198038041231931,3,0.42882187499979046,0.4853166666665425,1,0.9375,0.0012905714415548503,0.004074016411291552,3,0.5623000000005047,0.6002718750002095,1,1,0.004169228000011489,0.004400536925421816,1.376,0.9659,0.3933,1.0707,1.1677,0.5342,0.2949,1.4050709276666666,0.9521459551666667,0.3869964034,0.9719,6.2848,0.3515,3.4252,0.3605,-96.7403,0.6923,5.8465,0.3735,5.2694,0.4189,0.9908,1.0464130459,3.566909367,5.917266552333333,0.3547603184,0.3452659800333333,0.8593,5.3521,0.4857,5.7916,0.526,0.9253,0.271,0.276,0.943,0.015,0.921,61.400000000000006,2.4336485286666667,5.1769204853333335,5.607710032666667,0.33214170156666667,0.3926598746666667,328,0.9718518518518519,1,0,0,1,FALSE,FALSE,FALSE
118,2021-11-13T01:09:46Z,2021-11-13T01:37:05Z,1639,1,2021-11-13T01:37:06Z,0.8999999761581421,Safari,14.1.2,Macintosh,1440,900,none,1.6,628,145,409,61,46,82,-0.41418008435205067,0.5014376949755007,-0.08908542690515787,-0.5311000829343039,-0.3583560335760547,-0.39486271804575546,2,2,4,4,4,1,1,2,1,1,2,1,1,2,1,1,2,1,1,2,1.0563093645728086,0,1,2,2,2,2.5,0,2,2,2,4,4,4,4,4,4,4,2,4,2,4,4,2,2,1,1,2,3,3,2,2,2,0,0,4,4,2,4,4,4,4,4,4,1,5,1,1,4,2,4,4,4,4,4,4,2,1,4,1,1,1,1,1,1,1,5,1,1,1,1,2,1,1,1,1,1.5156837721956706,0.9759000729485332,2,0,1,0,2.933333333333333,0,2.2222222222222223,0,2.5,0,1.8333333333333333,0,0.8571428571428571,0,1.3333333333333333,0,1.972972972972973,0,1,0,0,-0.1727686180276017,0.11035635745800056,-0.5341482934814965,-0.21189596801174798,2,4,1,3,3,4,4,3,1,1.1547005383792515,3.857142857142857,0,2,1.175212813830632,2,4,4,3,1,1,4,5,3,1,2,1.3801311186847085,2.4285714285714284,0,3.5714285714285716,5,3.8333333333333335,3.2559414990859232,0.38995568780511447,0,0.8165912597985752,4,4,4,5,4,4,4,4,4,2,4,4,2,4,4,2,4,2,5,4,0.990430401872025,4.2,0,3.2,0,3.8,0,2.8,0,3.2666666666666666,0,3,1,1,3,3,1,2,3,2,1,3,3,1,1,3,3,1,2,1,1,0.9445132413883326,1.75,0,"Hispanic of Latino (e.g., Mexican American, Central American, and others)",0,28,1,1,NA,1,2,6,Paralegal,2,0,152,62,1,5,2,1,1,3,0,2,TRUE,TRUE,TRUE,TRUE,TRUE,4,0.8241142857142807,0.7142857142857143,0.0675774396258514,4,0.4462258064516185,0.5480625000000082,1,1,0.0023791139784948715,0.005282512096774333,4,0.5738750000000027,0.6566666666666662,1,0.9375,0.005319983870967932,0.012520129032257535,1.3933,0.6709,0.3565,1.1452,0.942,0.5041,0.475,1.4183385823333334,0.75317973607,0.35198902883333333,9.6286,12.6128,0.0645,10.0042,0.0668,-90.3873,0.8372,7.3392,0.3915,5.6058,0.4749,0.9706,1.9716811923333333,4.996218318333334,5.733612438333333,0.3560118679666667,0.2788082763333333,1.004,6.0178,0.4948,3.0155,0.4975,0.9624,0.063,0.438,0.397,0.029,1.787,61.620689655172406,1.5032339803333334,4.343044958666667,2.9713331603333333,0.4020019388,0.43210305206666666,442,1.3096296296296297,1,0,0,1,FALSE,FALSE,FALSE
119,2021-11-13T01:16:49Z,2021-11-13T01:37:25Z,1235,1,2021-11-13T01:37:26Z,1,Firefox,94.0,Windows NT 10.0,1504,1003,NA,1.4995014955134596,696,47,244,46,99,66,-0.2394631271578155,-0.38886665971636103,-0.883434884060366,-0.7138961809449572,0.37368312717672175,-0.6651245862194046,3,3,2,1,2,1,2,3,1,2,2,2,2,1,2,3,2,1,2,3,0.7254762501100116,0,1,2,4,5,2,0,2,4,3,3,4,2,3,4,4,2,3,2,4,2,2,3,5,1,1,4,4,3,4,0,3,0,0,4,3,4,4,4,5,4,4,3,2,2,3,1,4,3,4,4,5,4,4,4,2,2,3,1,3,3,2,1,1,1,4,2,2,1,1,4,2,4,1,3,1.2556180058348068,0.8837151016885368,3.125,0,2.5,0,3.3333333333333335,0,2.111111111111111,0,3.1666666666666665,0,2.5,0,1.4285714285714286,0,2,0,2.4324324324324325,0,0,0,0,0.8127785873381472,0.9631750067168229,-0.26683355097456624,0.34817072787112835,5,2,5,1,1,2,3,3,4,1.7043362064926932,1.5714285714285714,0,3.5,0.3612193635098966,5,5,5,5,4,3,1,6,7,NA,4,1.5275252316519468,4.571428571428571,0,1.4285714285714286,2.5,3.8333333333333335,3.2559414990859232,-1.0219528370065065,0,-1.0844279639287866,2,3,3,2,2,2,4,3,2,4,1,4,3,3,3,2,5,2,3,4,1.0690449676496976,2.4,0,4.4,0,3.6,0,3,0,3.6666666666666665,0,2,2,2,3,3,3,3,3,2,2,4,3,2,3,2,3,1,3,2,2,0.6882472016116853,2.3,0,"White, Caucasian, Anglo, European American",0,20,1,1,NA,1,4,5,Student,7,0,150,67,2,5,2,0,0,2,0,0,TRUE,TRUE,TRUE,TRUE,TRUE,6,1.1638809523809523,0.84,0.13362795469387753,6,0.4783125,0.538625,1,1,0.0032206088709677413,0.003394435483870967,6,0.59053125,0.66596875,1,1,0.005114450604838711,0.0062408054435483876,1.7339,0.9989,0.6005,1.6824,1.0566,0.6278,0.416,1.695921713,0.9510220355333333,0.5920407557,4.9653,9.3059,0.2115,8.9781,0.2621,-94.5763,0.8534,5.962,0.4095,6.2766,0.471,0.8904,1.8269197973333333,5.324049773666666,5.626992807333333,0.3734037358333333,0.32006436753333334,0.6489,4.6759,0.5382,3.9815,0.606,0.9652,0.303,0.203,0.783,0.019,1.62,85.26315789473685,2.341531287,5.180760064666667,4.903200432333334,0.36983957813333335,0.4347736186,456,1.3511111111111112,1,0,0,1,FALSE,FALSE,FALSE
120,2021-11-13T01:09:40Z,2021-11-13T01:37:34Z,1674,1,2021-11-13T01:37:35Z,1,Chrome,95.0.4638.69,Windows NT 10.0,1536,864,no,1.7777777777777777,965,75,339,75,61,92,0.45169660056643834,-0.13449398694725767,-0.4260821663043371,-0.3604903914576942,-0.15117513902338214,-0.2259490504372247,1,2,3,4,1,2,4,2,1,1,2,2,2,3,1,1,2,2,1,1,0.9679060415469871,1,1,2,3,1,3.1,0,2,3,3,3,3,3,3,3,3,3,4,3,4,2,3,3,3,3,2,2,2,3,3,7,2,0,0,4,4,4,4,4,5,5,5,5,1,5,1,1,4,4,5,5,4,4,3,4,3,1,2,1,4,5,1,5,4,1,5,1,2,1,2,1,3,2,3,3,1.6056394607999884,0.5345224838248488,2.625,0,2.75,0,3.2666666666666666,0,1.5555555555555556,0,2.5833333333333335,0,2.5,0,2,0,1.3333333333333333,0,2.1621621621621623,0,4,0,0,0.3336639544524528,0.6035025404081422,0.6239375469287404,0.6137200436684414,5,1,3,1,1,2,1,1,1,1.5275252316519468,1.4285714285714286,0,1,-0.6467170085812028,3,3,3,3,1,1,3,4,1,3,2,0.9759000729485332,2.4285714285714284,0,3.5714285714285716,6.5,3.8333333333333335,3.2559414990859232,1.237100802692087,0,1.2401638172420615,1,1,1,1,1,2,5,1,1,3,3,4,3,5,5,1,3,3,5,1,1.5583874449479591,1,0,3.4,0,4.2,0,5,0,4.2,0,3,1,3,2,4,4,4,3,2,1,2,2,2,3,2,2,2,2,2,4,0.9459053029269173,2.6,0,"White, Caucasian, Anglo, European American",0,22,1,2,NA,1,2,5,student,2,0,190,62,2,5,2,0,0,0,0,0,TRUE,TRUE,TRUE,TRUE,TRUE,4,0.6154060606089505,0.66,0.026868070677941884,4,0.4510093750040978,0.5202535714230367,1,0.9032258064516129,0.00488994345809344,0.005861238581555424,4,0.6249124999959021,0.7357499999981374,1,1,0.01313320951519023,0.01425917741831791,1.1725,0.6233,0.3431,0.8055,0.6574,0.4783,0.0693,1.2268569099,0.75720594184,0.3377200861333333,1.2442,3.8341,0.2888,2.6291,0.3236,-53.9246,0.6735,6.0299,0.3996,4.2824,0.4468,0.9498,1.3449537596666667,2.8793708746333335,4.088022177333333,0.3180768421,0.28335991223333334,1.0314,3.8174,0.5045,3.5929,0.5944,0.9922,0.26,0.214,0.636,0.017,1.769,104.05882352941175,2.509559546,4.270925229333334,4.1856846013333335,0.3321756828,0.44070614303333333,298,0.882962962962963,1,0,0,1,FALSE,FALSE,FALSE
121,2021-11-13T01:08:41Z,2021-11-13T01:38:48Z,1807,1,2021-11-13T01:38:51Z,1,Chrome,94.0.4606.81,Macintosh,1440,900,NA,1.6,735,68,621,170,78,86,-0.13925781347288652,-0.1980871551395335,0.9315332695609277,0.7972182292764435,0.08362987480298012,-0.3272972510023432,2,1,3,3,2,1,1,2,1,2,1,1,1,1,2,1,2,3,2,1,0.7451598203705946,0,1,1,3,3,2.55,0,3,4,2,4,2,1,2,2,3,1,2,4,1,3,4,2,2,1,1,1,1,1,1,0,2,0,0,5,4,4,3,2,5,4,5,5,5,4,2,2,4,3,3,3,5,2,4,3,2,1,1,1,2,1,2,1,1,1,5,1,1,1,3,2,2,1,1,1,1.4932279563850022,1.1254628677422756,1.25,0,1.25,0,2.1333333333333333,0,1.8888888888888888,0,3,0,1.5,0,1,0,2,0,2.081081081081081,0,0,0,0,-0.5720308120990136,-0.5092946461233157,-0.6588395645607719,-0.5840671053420438,4,2,3,1,1,2,2,3,1,1.0690449676496976,1.8571428571428572,0,2,-0.021327778341387937,5,4,4,4,2,2,2,4,7,4,3,1.2535663410560174,3.5714285714285716,0,2.4285714285714284,3.5,3.8333333333333335,3.2559414990859232,-0.4571894270818581,0,-0.24434927701640521,1,2,1,2,1,1,4,1,1,4,2,5,2,4,5,1,4,1,3,2,1.5430334996209192,1.4,0,4.6,0,4,0,4.6,0,4.4,0,2,4,1,3,2,2,1,4,1,1,1,4,4,2,2,4,1,2,1,1,1.2258187382102494,1.65,0,Black or African American,0,23,1,2,NA,1,3,6,Account Management,5,0,200,64,2,5,2,0,0,0,0,0,TRUE,TRUE,TRUE,TRUE,TRUE,2,0.9075682926832176,0.82,0.029051874860606782,2,0.5484031250048429,0.6258600000023842,1,0.9375,0.015251782894425822,0.026975135485103444,2,0.7225968750026077,0.9010612903275798,1,0.96875,0.019513166117059506,0.054803381253901565,1.3797,1.2092,0.5591,0.8124,1.6153,0.7761,0.2932,1.4108765273333332,1.1015631443,0.5497820559666666,1.4173,3.2603,0.331,2.3035,0.3523,-35.522,1.2579,3.6817,0.3752,2.59,0.396,0.9974,1.5414675046666666,2.525841703333333,3.51802265,0.34251258696666664,0.3221578211666667,1.4025,3.8301,0.5296,2.2017,0.601,0.9327,0.088,0.462,0.303,0.008,1.362,170.25,2.190384405666667,3.901199316,2.4547664473333333,0.4402457807,0.46598807783333335,104,0.3081481481481481,1,0,0,1,FALSE,FALSE,FALSE
122,2021-11-13T01:17:20Z,2021-11-13T01:39:29Z,1329,1,2021-11-13T01:39:30Z,1,Chrome,95.0.4638.69,Macintosh,1440,900,NA,1.6,620,68,270,171,89,75,-0.434735020492549,-0.1980871551395335,-0.7582646665692423,0.8094046358104869,0.23556253080827336,-0.513102285371727,3,3,1,2,3,1,1,3,1,3,3,1,1,1,3,4,1,1,2,2,1.025978352085154,0,1,2,4,3,1.6,0,5,5,1,5,1,1,5,1,1,1,1,5,1,5,5,1,1,1,1,1,1,1,1,0,2,0,0,5,5,5,5,5,5,5,5,5,1,5,1,1,5,1,5,1,1,1,1,1,5,1,1,1,1,1,1,1,1,1,5,1,1,1,1,1,1,1,1,1,1.9666895707934864,2.065591117977289,1,0,1,0,1,0,1,0,1,0,0.8333333333333334,0,0.8571428571428571,0,1,0,1,0,0,0,0,-1.3999745198049947,-1.568373259242148,-0.7372407672780129,-1.1528070132600805,5,1,5,1,1,1,1,1,1,1.9518001458970664,1,0,1,-0.9031185640466358,5,5,5,5,5,5,1,4,6,4,3,1.5118578920369088,5,0,1,4,3.8333333333333335,3.2559414990859232,-0.1748077221195339,0,-0.8998683987496106,1,1,1,1,1,1,5,2,1,1,1,4,1,3,4,1,4,1,4,3,1.5023790657297036,1,0,4.6,0,4,0,3.8,0,4.133333333333334,0,1,2,2,3,4,1,2,4,1,1,1,4,2,1,1,4,2,2,1,3,1.1652874052533586,1.6,0,"White, Caucasian, Anglo, European American",0,20,1,2,NA,1,3,4,Full time student,5,0,120,67,2,5,2,0,1,2,0,1,TRUE,TRUE,TRUE,TRUE,TRUE,3,1.0880162790715695,0.8775510204081632,0.07076196093425587,3,0.46643225806374705,0.5150933333337306,1,0.9375,0.0041754389245313595,0.002691952096944322,3,0.7378250000020489,0.7389419354834864,1,0.96875,0.027193083225284173,0.012482081128477204,1.7981,1.2144,0.5348,1.0508,1.8026,0.8805,0.5865,1.7052744523333334,1.0829301025666667,0.5321940959333333,1.0943,3.8823,0.3255,4.2164,0.3986,-77.4267,0.7151,5.1928,0.4024,5.8086,0.4514,0.9087,1.2330225938666666,4.265758965666667,4.228222233333334,0.38755277513333336,0.3183664862666667,1.158,2.9387,0.5418,3.3537,0.5844,0.9401,0.069,0.511,0.353,0.025,1.645,65.8,2.3340159933333333,3.442199453,3.168616098333333,0.39417734293333334,0.3841538897333333,422,1.2503703703703704,1,0,0,1,FALSE,FALSE,FALSE
123,2021-11-13T01:04:40Z,2021-11-13T01:39:45Z,2105,1,2021-11-13T01:39:46Z,1,Chrome,95.0.4638.69,Windows NT 10.0,1920,1080,My dad was/is a narcissist and abusive to our family. Mom was/is wonderful.  Good luck on your study!,1.7777777777777777,1026,77,393,124,65,110,0.6084279886377375,-0.11632451032089314,-0.1661132530535417,0.23664352871043995,-0.09592690047600279,0.07809555125813061,2,2,2,2,2,1,4,1,1,2,1,3,3,2,2,2,3,1,2,2,0.7947194142390263,0,1,1,2,3,2.7,0,3,4,3,3,4,3,2,3,2,3,2,3,2,2,2,4,5,4,1,2,2,3,2,5,2,0,0,4,2,4,2,3,5,4,4,4,2,5,5,1,4,1,4,3,4,5,5,5,2,1,1,1,3,1,1,4,3,1,3,3,1,2,3,3,2,2,3,1,1.4326732190393427,0.7037315505489968,2.875,0,2,0,3,0,2.4444444444444446,0,3,0,1.6666666666666667,0,2.142857142857143,0,2.6666666666666665,0,2.5135135135135136,0,3,0,0,0.7077095888983023,0.7473328108426686,0.1856414649805007,0.46648713791158464,5,2,3,2,1,1,1,4,1,1.4638501094227998,1.5714285714285714,0,2.5,-0.007768311264485517,3,3,3,3,1,1,3,6,6,2,3,0.9759000729485332,2.4285714285714284,0,3.5714285714285716,3,3.8333333333333335,3.2559414990859232,-0.7395711320441822,0,0.25182784987392687,2,2,2,5,3,2,2,2,1,2,1,4,3,3,5,4,4,3,3,3,1.1464230084422218,2.8,0,4,0,2.4,0,4,0,3.466666666666667,0,3,1,4,2,3,4,4,1,4,2,3,2,3,3,2,2,2,4,2,4,1.019545822516343,3.05,0,"White, Caucasian, Anglo, European American",0,29,1,3,NA,1,2,6,artist,2,0,195,68,1,5,2,0,1,0,0,1,TRUE,TRUE,TRUE,TRUE,TRUE,6,0.8229190476190332,0.84,0.056290972346935496,6,0.44769999999997673,0.4697928571428638,0.967741935483871,0.9032258064516129,0.0024327874623629037,0.006673919698921166,6,0.5708687500000306,0.6307366666667008,1,0.9375,0.007286731250001905,0.003705720796373577,1.4104,1.2828,0.4535,1.1158,1.2409,0.5585,0.1295,1.4244448373333334,1.1474120145666666,0.44687481836666665,0.9507,4.2896,0.3419,2.4778,0.3072,-66.4232,0.8954,5.8274,0.372,4.3627,0.3678,0.7922,1.0377031601,2.7709000657666665,4.471857071666666,0.3016811859,0.33618999516666664,1.0214,3.6776,0.4423,6.2503,0.548,0.9881,0.065,0.428,0.517,0.015,1.657,110.46666666666667,1.5859391724,4.376521246333334,3.1965088616666666,0.39091461926666665,0.4020984659333333,316,0.9362962962962963,1,0,0,1,FALSE,FALSE,FALSE
124,2021-11-13T01:02:41Z,2021-11-13T01:40:13Z,2252,1,2021-11-13T01:40:14Z,1,Chrome,95.0.4638.69,Windows NT 10.0,1280,720,NA,1.7777777777777777,676,52,939,72,105,336,-0.29085046750906113,-0.3434429681504497,2.462461314260056,-0.39704961105982484,0.4565554849977908,3.8955444392109255,4,4,1,1,4,2,3,3,1,4,2,1,1,1,4,4,1,2,3,3,1.2763022245616642,0,1,1,3,2,1.45,0,3,4,1,4,3,2,1,3,1,2,1,4,1,4,3,3,3,5,1,1,1,1,1,7,3,0,5,3,4,3,1,1,5,5,5,5,1,3,1,3,3,3,4,2,4,3,5,5,2,4,1,1,5,3,4,5,5,1,4,3,2,1,2,1,5,5,5,5,1.5082356496167217,1.245945806357946,2,0,5,0,2.2,0,2.4444444444444446,0,2.9166666666666665,0,2.8333333333333335,0,3,0,1.3333333333333333,0,2.72972972972973,0,4,0,5,0.29794049498290537,0.12042254058397016,2.211796605879814,1.166109573231892,4,1,2,1,1,1,1,1,1,1.1338934190276817,1.5714285714285714,0,1,-0.5612498234260587,3,3,4,4,2,2,3,4,3,5,4,0.816496580927726,3,0,3,5.5,3.8333333333333335,3.2559414990859232,0.6723373927674386,0,0.6390981225939902,2,3,3,2,1,2,5,2,3,5,2,4,1,3,4,1,3,2,5,1,1.4573295865416045,2.2,0,3.8,0,5,0,3.8,0,4.2,0,2,2,1,3,1,1,4,3,1,2,2,4,1,1,2,4,2,2,3,1,1.0711528467275955,1.7,0,"White, Caucasian, Anglo, European American",0,21,1,2,NA,1,2,6,Actuary,4,0,156,62,3,5,2,0,1,3,0,1,TRUE,TRUE,TRUE,TRUE,TRUE,1,1.0632261904705138,0.84,0.33394923551327743,1,0.4938687500059605,0.5983387096697285,1,0.96875,0.003307913182982244,0.011498738059272536,1,0.65224062500149,0.7955499999895692,1,1,0.003946805715123329,0.007421165159963945,1.7181,0.9532,0.4743,1.3035,1.3241,0.6107,0.4876,1.6705397476666666,0.9239836944666666,0.4736742518666667,2.1659,5.2702,0.2884,3.6854,0.3211,-58.036,1.0571,6.74,0.4206,3.7382,0.4659,0.9115,1.9389302586666666,3.485354142,4.817218079666667,0.3334850512,0.2935266226,0.8323,5.7036,0.5835,3.1473,0.6932,0.9523,0.119,0.474,0.682,0.013,1.791,137.76923076923077,2.467873304,6.118788257666667,4.835979423,0.4585786045333333,0.5478582919666667,104,0.3081481481481481,1,1,0,1,FALSE,FALSE,FALSE
125,2021-11-13T01:11:57Z,2021-11-13T01:41:31Z,1773,1,2021-11-13T01:41:32Z,1,Chrome,94.0.4606.71,Macintosh,1280,800,NA,1.6,863,77,465,112,58,113,0.1896211647750856,-0.11632451032089314,0.18051196461418548,0.09040665030191732,-0.19261131793391667,0.12876965154068984,4,4,1,1,4,1,1,3,1,4,3,1,1,1,4,4,1,1,3,4,1.4244112357114616,0,1,2,4,3,1.15,0,4,5,2,5,2,1,4,2,1,1,3,4,3,4,5,2,4,1,1,1,3,2,1,0,2,0,0,5,5,5,5,5,5,5,5,5,2,5,2,1,5,1,5,3,3,3,3,4,3,1,1,1,3,1,1,1,1,1,4,2,1,1,1,1,1,2,1,1,1.7346495349231237,1.486446705914413,1.875,0,1.25,0,1.7333333333333334,0,1,0,2.0833333333333335,0,1.5,0,1.1428571428571428,0,1,0,1.5135135135135136,0,0,0,0,-0.5363073526294663,-0.6565125743406198,-0.6588395645607719,-0.6576760694506958,5,2,4,2,1,1,2,1,3,1.5118578920369088,1.5714285714285714,0,2,-0.19226214865167657,5,5,5,5,3,3,1,6,6,6,4,1.5735915849388864,4.428571428571429,0,1.5714285714285714,3,3.8333333333333335,3.2559414990859232,-0.7395711320441822,0,-0.8635661140261877,2,3,3,2,2,3,4,3,2,2,1,4,2,4,4,2,4,1,4,3,1.1254628677422756,2.4,0,4.2,0,3.6,0,3.6,0,3.8,0,1,1,1,4,2,2,1,4,1,1,2,4,2,1,1,4,1,1,1,1,1.1964860832322377,1.2,0,"White, Caucasian, Anglo, European American",0,23,1,2,NA,1,3,6,Clinical Lab Assistant,2,0,150,69,3,5,2,0,0,2,0,0,TRUE,TRUE,TRUE,TRUE,TRUE,3,0.7717184210576509,0.76,0.04075718171782819,3,0.41561875003576276,0.4985699999888738,1,0.9375,0.0015135699591259809,0.007214683184410372,3,0.6394687500223517,0.7216343750581146,1,1,0.005274575767736031,0.007153998463449968,1.2277,0.9992,0.4869,0.8075,1.1714,0.6211,0.0975,1.2812992649333332,0.9767992430333333,0.4781107607333333,1.2729,7.1338,0.3264,2.8875,0.303,-83.7894,0.556,5.6812,0.3729,5.6643,0.443,0.9831,1.2770225017333334,2.9947914296666664,6.3397887116666665,0.3025962348,0.3209312173666667,0.8502,4.5867000000000004,0.5513,4.7381,0.6322,0.8655,0.095,0.462,0.543,0.007,1.047,149.57142857142856,2.395696896,5.334677697333333,4.878351998,0.42047832123333334,0.4837981678666667,104,0.3081481481481481,1,1,0,1,FALSE,FALSE,FALSE
126,2021-11-13T01:17:49Z,2021-11-13T01:42:12Z,1463,1,2021-11-13T01:42:14Z,0.8999999761581421,Chrome,95.0.4638.69,Windows NT 10.0,1920,1080,NA,1.7777777777777777,656,63,466,88,49,85,-0.3422378078603068,-0.24351084670544482,0.18532620374845948,-0.202067106515128,-0.31691985466552025,-0.34418861776319626,2,3,4,4,2,2,2,2,1,2,1,2,3,3,2,2,3,1,2,2,0.8506963092234007,0,1,1,3,2,2.75,0,5,5,3,4,1,2,1,1,1,1,1,4,2,4,4,1,1,1,1,1,1,1,1,1,2,0,0,5,3,1,5,5,5,5,5,5,1,5,2,1,4,1,5,3,1,1,1,2,5,1,1,1,2,3,1,2,2,1,5,2,1,1,1,1,2,1,2,2,1.7394037844978736,1.5946338585572373,1,0,1.75,0,1.8,0,1.6666666666666667,0,1.4166666666666667,0,1.3333333333333333,0,1.2857142857142858,0,1,0,1.4594594594594594,0,1,0,0,-1.1141868440486153,-1.0271223357765558,-0.2989446853297732,-0.6630335105531645,5,1,4,1,1,1,1,1,1,1.7320508075688772,1.1428571428571428,0,1,-0.8176513788914915,5,5,5,5,3,3,1,6,5,4,3,1.5735915849388864,4.428571428571429,0,1.5714285714285714,3.5,3.8333333333333335,3.2559414990859232,-0.4571894270818581,0,-0.7223752615450256,3,2,3,2,2,2,5,4,1,2,2,4,1,3,4,4,4,3,3,2,1.2227992865708155,2.4,0,3.8,0,3.4,0,3.6,0,3.6,0,3,1,2,3,4,2,4,2,1,1,1,3,3,3,1,1,2,3,1,4,1.118033988749895,2.35,0,"White, Caucasian, Anglo, European American",0,22,1,2,NA,1,3,6,lab technician,2,0,162,66,1,5,2,0,1,1,0,1,TRUE,TRUE,TRUE,TRUE,TRUE,6,0.8815081081084303,0.74,0.10898544367344591,6,0.47759333333174386,0.5299500000001862,1,1,0.0011451937472487064,0.0054588361283562465,6,0.5764062500009314,0.6820354838707755,1,1,0.0022950328629937748,0.008099651032522644,1.3494,0.7706,0.5105,1.2361,0.6952,0.5128,0.0412,1.3949246346666666,0.8243820048033333,0.4998594752,9.9807,16.3409,0.1722,9.4167,0,-96.4634,0.7788,7.026,0.4252,5.6293,0.47,0.9647,2.001994474,4.127657850666667,7.059014112,0.2891899897,0.3440806203333333,0.6471,8.6292,0.5408,3.9503,0.6248,0.9923,0.123,0.403,0.691,0.013,1.498,115.23076923076924,2.1971465803333334,6.324693613666667,4.405587999,0.41096164533333335,0.439038852,396,1.1733333333333333,1,0,0,1,FALSE,FALSE,FALSE
127,2021-11-13T01:11:06Z,2021-11-13T01:42:22Z,1876,1,2021-11-13T01:42:23Z,1,Chrome,95.0.4638.69,Windows NT 10.0,1536,864,NA,1.7777777777777777,814,76,595,158,61,103,0.06372218091453376,-0.1254092486340754,0.806363052069804,0.6509813508679207,-0.15117513902338214,-0.040144016067840904,3,3,1,1,3,1,2,3,1,4,2,1,1,2,3,3,1,1,3,3,1.0208355710680808,0,1,1,3,3,1.6,0,4,4,3,4,2,2,4,2,2,2,1,4,1,4,3,2,2,1,1,1,1,2,3,4,4,0,0,5,4,5,3,1,3,3,2,2,2,4,1,1,2,1,5,2,2,1,3,1,5,1,1,1,1,1,1,5,3,1,3,2,3,2,3,1,2,2,2,1,1.3987338762096442,1.1464230084422218,1.625,0,1.75,0,2,0,2.888888888888889,0,1.75,0,0.8333333333333334,0,2.4285714285714284,0,2,0,2.081081081081081,0,2,0,0,-0.33877763556255713,-0.40543873752557247,-0.0958522115332568,-0.25064547452941466,3,2,3,1,2,2,2,1,1,0.6900655593423543,2.142857142857143,0,1,-0.21938108280548152,4,3,3,3,1,1,2,1,1,2,2,1.1338934190276817,2.7142857142857144,0,3.2857142857142856,8,3.8333333333333335,3.2559414990859232,2.0842459175790595,0,1.5043943798426742,1,1,2,3,2,2,4,2,1,1,3,3,3,4,5,1,4,2,4,3,1.2649110640673518,1.8,0,3.6,0,3.4,0,4.2,0,3.7333333333333334,0,2,2,2,2,3,3,3,2,3,1,3,3,2,1,2,3,2,3,1,3,0.7326950970650465,2.3,0,"Hispanic of Latino (e.g., Mexican American, Central American, and others)",0,24,1,2,NA,1,2,6,Unemployed,2,0,97,58,1,5,2,0,0,1,0,0,TRUE,TRUE,TRUE,TRUE,TRUE,NA,NA,NA,NA,3,0.5402812499995343,0.5855935483848856,1,0.96875,0.007850403507915238,0.005326355121117399,3,0.7294718750002794,0.8157656249976717,1,1,0.006746998215658644,0.021228156522241914,NA,NA,NA,NA,NA,NA,NA,NA,NA,NA,1.5001,3.9229,0.3491,4.2222,0.4194,-65.8104,0.9201,3.4983,0.4262,5.0908,0.4947,0.9939,1.6611313156666667,4.232167348666667,4.170977775666667,0.40380938303333336,0.3386068145,1.0837,5.1623,0.6279,2.3295,0.6457,0.9161,0.244,0.305,0.56,0.019,1.356,71.36842105263159,3.0785219176666665,5.034140934333333,3.8481856016666667,0.42776070083333334,0.41889277206666664,104,0.3081481481481481,1,1,5,6,FALSE,FALSE,FALSE
128,2021-11-13T01:19:06Z,2021-11-13T01:42:29Z,1402,1,2021-11-13T01:42:30Z,1,Chrome,95.0.4638.69,Windows NT 10.0,1366,768,NA,1.7786458333333333,624,66,352,66,79,91,-0.4244575524222998,-0.21625663176589804,-0.36349705755877526,-0.47016805026408615,0.09744193443982496,-0.2428404171980778,2,2,4,4,2,2,2,1,1,1,2,3,3,4,2,2,3,4,2,1,1.0399898784932577,0,1,2,2,3,3.15,0,3,2,4,2,5,3,2,4,5,3,2,3,1,3,3,3,5,1,1,2,3,4,4,2,2,0,0,5,3,5,4,5,4,3,4,2,3,4,5,1,2,3,3,5,4,5,4,5,3,1,1,1,3,1,1,3,3,3,2,5,4,1,4,3,2,2,2,2,1.3911992795553898,1.1338934190276817,2.875,0,2,0,3.4,0,2.111111111111111,0,3.6666666666666665,0,1.5,0,3.142857142857143,0,2.6666666666666665,0,2.810810810810811,0,1,0,0,0.8926310261524294,1.046995339284992,-0.22054348261253207,0.41322592833622995,5,1,3,1,1,2,1,4,3,1.5275252316519468,1.4285714285714286,0,3.5,0.27575217835475235,2,3,4,2,1,1,5,5,6,2,2,1.5118578920369088,2,0,4,3.5,3.8333333333333335,3.2559414990859232,-0.4571894270818581,0,0.6320316946193991,2,2,2,3,3,2,5,1,1,2,1,5,1,4,5,3,3,2,3,3,1.486446705914413,2.4,0,4.2,0,3.6,0,4.4,0,4.066666666666666,0,1,1,2,3,4,2,2,3,1,3,3,3,1,4,1,3,1,2,2,3,1.019545822516343,2.05,0,"White, Caucasian, Anglo, European American",0,21,1,2,NA,1,2,5,Waitress,1,0,115,64,2,5,2,0,0,1,0,0,TRUE,TRUE,TRUE,TRUE,TRUE,4,0.8102488371937774,0.86,0.015462355617607858,4,0.4374125000536442,0.4924034483021703,1,0.90625,0.0020680366139170427,0.006341246123387835,4,0.5677531250715255,0.6189137931034483,1,0.90625,0.005830396768437816,0.00954001119540626,1.1015,1.6772,0.5836,0.5564,2.5246,0.7607,0.3382,1.1613215739,1.3303406122333334,0.5715832963666667,1.2154,4.529,0.3032,2.8875,0.3128,-66.9589,0.6741,6.0743,0.3889,3.6598,0.4184,0.994,1.2934715082666666,3.09309675,4.669733825333333,0.3080485354333333,0.29913896786666666,0.8845,6.0721,0.5096,4.0067,0.5028,0.8221,0.061,0.4,0.353,0.019,1.585,83.42105263157895,1.4057745259,3.502170253,2.8252645553333333,0.3629312525,0.40046613903333333,324,0.96,1,0,0,1,FALSE,FALSE,FALSE
129,2021-11-13T00:57:02Z,2021-11-13T01:43:00Z,2758,1,2021-11-13T01:43:01Z,1,Edge,95.0.1020.40,Windows NT 10.0,1366,768,NA,1.7786458333333333,1068,130,720,168,121,204,0.7163414033753533,0.3651666202777668,1.4081429438540527,0.7728454162083563,0.6775484391873082,1.6658840267783195,2,1,3,3,2,1,1,2,1,2,2,1,3,2,1,2,1,1,2,1,0.7326950970650465,0,1,4,3,1,2.5,0,5,4,3,4,4,4,4,2,2,3,1,3,2,3,2,3,2,1,1,2,1,4,3,0,2,0,0,4,4,4,5,5,5,4,4,4,2,4,2,1,4,2,5,2,2,2,3,3,4,1,1,1,1,1,1,1,1,1,4,2,2,1,2,1,2,2,3,3,1.4617238578598342,1.0997835284835873,2.125,0,2.5,0,2.533333333333333,0,1.6666666666666667,0,2,0,1,0,1.2857142857142858,0,1.3333333333333333,0,1.6216216216216217,0,0,0,0,-0.3135610759369941,-0.15881725093931895,-0.26683355097456624,-0.21282540095694258,4,2,4,1,1,1,3,1,1,1.3801311186847085,1.7142857142857142,0,1,-0.4757826382709144,4,4,4,4,3,3,2,3,4,NA,4,0.7867957924694432,3.7142857142857144,0,2.2857142857142856,5.5,3.8333333333333335,3.2559414990859232,0.6723373927674386,0,0.24074313548680643,3,3,3,3,4,2,5,2,2,1,2,4,4,3,4,2,3,2,4,2,1.1464230084422218,3.2,0,3.8,0,3.2,0,3.8,0,3.6,0,3,1,3,2,4,3,4,1,1,1,3,2,3,4,2,2,2,3,3,3,1,2.8,0,"Hispanic of Latino (e.g., Mexican American, Central American, and others) & White, Caucasian, Anglo, European American",1,19,1,2,NA,1,3,3,n/a,6,0,260,67,2,5,2,0,0,0,0,0,TRUE,TRUE,TRUE,TRUE,TRUE,4,1.0617880952273095,0.84,0.13354148019133322,4,0.503966666650772,0.6105031249970198,1,1,0.00972373816186949,0.015755524829769923,4,0.6414781249836087,0.7188612903279643,1,0.96875,0.026740332080950144,0.05489218673486908,1.7354,1.0304,0.4717,1.5896,1.3029,0.5667,0.1668,1.6798238533333334,0.9730128064,0.46940748763333334,1.5635,4.6388,0.3354,4.0237,0.4162,-67.4714,1.0828,4.5519,0.3845,4.0997,0.4773,0.9908,1.7222222246666667,4.078802820333333,4.740475131,0.4006934705,0.32288219556666664,1.6105,3.5871,0.4101,2.9273,0.4138,0.8915,0.081,0.365,0.263,0.039,1.806,46.30769230769231,1.7176997576,3.117656228,2.554040388,0.35829668923333335,0.38959980656666665,338,1.0014814814814814,1,0,0,1,FALSE,FALSE,FALSE
130,2021-11-13T01:10:03Z,2021-11-13T01:43:07Z,1983,1,2021-11-13T01:43:08Z,NA,Chrome,95.0.4638.69,Windows NT 10.0,1280,720,N/A,1.7777777777777777,883,79,508,98,84,152,0.2410085051263312,-0.09815503369452862,0.387524247387967,-0.08020304117469244,0.16650223262404917,0.7875329552139597,2,3,3,3,2,1,2,2,1,2,2,1,3,2,2,2,2,1,2,2,0.6488856845230502,0,1,2,3,3,2.4,0,4,4,3,3,4,2,3,3,2,3,2,3,2,3,3,2,3,1,1,1,2,2,2,4,2,0,0,4,3,3,4,2,4,2,2,2,2,4,3,2,3,3,3,3,2,3,2,3,4,1,1,1,3,3,3,4,2,1,4,2,2,2,3,1,2,2,2,2,0.9562501840075193,0.7037315505489968,1.75,0,2,0,2.6666666666666665,0,3.111111111111111,0,2.5833333333333335,0,1.6666666666666667,0,2.142857142857143,0,2,0,2.4864864864864864,0,2,0,0,-0.008860980461443293,0.10900129434488952,-0.01745100881601569,0.045775142764436914,3,3,2,2,2,3,3,1,1,0.5345224838248488,2.857142857142857,0,1,0.20795484297024003,1,3,4,3,1,1,4,6,3,2,2,1.3972762620115438,2.142857142857143,0,3.857142857142857,4.5,3.8333333333333335,3.2559414990859232,0.10757398284279028,0,0.8347424021602866,2,2,3,3,3,3,5,3,2,4,1,4,2,4,4,2,3,2,3,3,1.0690449676496976,2.6,0,3.8,0,4,0,3.6,0,3.8,0,2,1,2,2,2,2,3,1,2,2,1,2,2,3,1,2,1,3,2,3,0.6863327411532597,2.25,0,"Asian or Asian American (e.g., Chinese, Japanese, and others)",0,25,1,2,NA,1,3,6,Account Manager,4,0,120,64,1,5,2,0,0,3,0,0,TRUE,TRUE,TRUE,TRUE,TRUE,4,1.1225285714297069,0.84,0.18788050681119772,4,0.5303129032249412,0.5762374999998138,1,1,0.007684635161259829,0.00791157661296242,4,0.6309000000013039,0.7038687500003725,1,1,0.0046819987097615964,0.005084182217834904,1.5588,1.0387,0.6285,1.5085,1.0904,0.6142,0,1.5736022986666667,0.9905233794333334,0.6147335965,1.1003,5.0941,0.4223,4.2987,0.4483,-90.1069,0.9857,5.9998,0.4323,4.9682,0.4709,0.7734,1.3902503048666666,4.584861397333333,5.224118609666666,0.42857045553333334,0.39999847666666666,0.9663,4.4119,0.5322,6.5788,0.6315,0.9692,0.233,0.332,0.761,0.01,1.083,108.3,2.512365359,5.4812815913333335,5.150053569,0.40775887576666664,0.46855395493333335,409,1.211851851851852,1,0,0,1,FALSE,FALSE,FALSE
131,2021-11-13T01:23:24Z,2021-11-13T01:43:11Z,1186,1,2021-11-13T01:43:12Z,1,Chrome,95.0.4638.69,Macintosh,1440,900,N/A,1.6,599,59,281,65,49,78,-0.4886917278613569,-0.2798497999581739,-0.7053080360922285,-0.4823544567981297,-0.31691985466552025,-0.4624281850891678,2,3,2,1,3,1,2,2,1,3,3,2,1,1,3,3,2,1,2,2,0.7947194142390263,0,1,1,4,2,1.9,0,5,5,2,4,2,1,4,3,2,1,1,4,1,4,5,1,1,1,1,1,3,3,3,1,2,0,0,5,4,4,5,5,4,5,5,5,1,4,3,1,5,1,5,1,2,2,3,3,5,1,4,1,2,1,1,2,2,1,5,1,1,1,1,1,2,1,1,2,1.7018802532482702,1.5796322658258457,1.75,0,1.5,0,1.6,0,1.3333333333333333,0,1.75,0,1.5,0,1.1428571428571428,0,1,0,1.4864864864864864,0,1,0,0,-0.6308694512253271,-0.779145786077191,-0.3773458880470143,-0.5782458370621026,5,1,5,1,1,1,1,1,1,1.9518001458970664,1,0,1,-0.9031185640466358,5,5,5,5,3,2,1,7,8,6,4,1.7043362064926932,4.285714285714286,0,1.7142857142857142,1.5,3.8333333333333335,3.2559414990859232,-1.5867162469311549,0,-1.2074676740482373,2,3,2,2,2,1,5,2,2,3,1,4,1,5,5,1,4,1,4,3,1.61245154965971,2.2,0,4.6,0,4.4,0,4.2,0,4.4,0,1,2,1,4,2,1,2,4,1,2,2,3,1,2,1,3,1,2,2,2,0.9445132413883326,1.55,0,"White, Caucasian, Anglo, European American",0,22,1,2,NA,1,4,6,News Reporter,2,0,135,63,3,5,2,0,0,1,0,0,TRUE,TRUE,TRUE,TRUE,TRUE,3,0.7540449999991804,0.8,0.016082268852969497,3,0.46019687499967404,0.5025741935482909,1,0.96875,9.49164828636135e-4,0.0023237295867105223,3,0.5864499999999534,0.6647399999993543,1,0.9375,0.006579915483808292,0.006743255312561892,1.0488,1.3904,0.5472,0.8678,1.2367,0.6096,0.126,1.1140146563666666,1.1790348253333334,0.5373902366333333,1.0654,6.4546,0.3777,5.282,0.4099,-111.5742,0.7237,7.7708,0.4158,5.9347,0.4396,0.9379,1.1170266732666667,4.9264227683333335,5.963662604333333,0.4030179983666667,0.3717050336,0.8954,4.6041,0.4909,4.0583,0.562,0.9673,0.066,0.429,0.407,0.015,1.574,104.93333333333334,1.5624224485333333,4.065065097333333,3.2018967456666667,0.3940990974333333,0.44437314516666665,412,1.2207407407407407,1,0,0,1,FALSE,FALSE,FALSE
132,2021-11-13T01:05:20Z,2021-11-13T01:43:18Z,2277,1,2021-11-13T01:43:19Z,1,Chrome,95.0.4638.69,Windows NT 10.0,1536,864,NA,1.7777777777777777,712,55,427,859,64,93,-0.198353254876819,-0.31618875321090295,-0.0024291224882260847,9.193652331232453,-0.10973896011284763,-0.20905768367637165,2,2,3,3,1,2,3,1,2,1,1,3,1,1,2,1,2,3,1,2,0.812727700887249,0,1,1,2,2,2.95,0,1,5,4,2,2,3,2,4,3,2,5,2,2,3,3,4,5,3,2,4,5,5,5,4,2,0,2,4,3,3,4,3,4,3,5,3,2,4,5,2,3,3,4,1,5,5,5,5,2,2,2,1,2,1,2,3,3,1,5,2,1,1,1,3,2,3,2,2,1.3819949022734888,1.1872336794093274,4.125,0,2.25,0,3.2666666666666666,0,2.4444444444444446,0,3.3333333333333335,0,1.8333333333333333,0,1.7142857142857142,0,1.6666666666666667,0,2.4864864864864864,0,2,0,2,1.4684091376027815,1.3875033415653846,0.41384948769958696,0.9006764146324857,5,2,5,2,1,2,1,3,1,1.7182493859684491,1.4285714285714286,0,2,-0.2777293338068208,5,5,5,5,4,4,1,7,7,6,5,1.4638501094227998,4.714285714285714,0,1.2857142857142858,2,3.8333333333333335,3.2559414990859232,-1.3043345419688306,0,-1.3052898138313853,4,4,5,5,5,5,4,4,4,2,2,5,4,2,3,4,2,3,3,4,1.0555973258234952,4.6,0,3,0,2.6,0,2.2,0,2.6,0,3,2,4,2,4,4,4,2,4,3,4,2,3,4,2,2,3,3,4,4,0.8750939799154206,3.35,0,"White, Caucasian, Anglo, European American",0,23,1,2,NA,1,5,6,research assistant,6,0,125,63,3,5,2,0,0,1,0,0,TRUE,TRUE,TRUE,TRUE,TRUE,4,0.9979216216230714,0.74,0.12763910019889385,4,0.4416124999993481,0.5532967741941252,1,0.96875,0.002215337257961956,0.005811617893067038,4,0.6269968750001863,0.6671925925949106,1,0.84375,0.010868273860214276,0.010118938992167793,1.5049,0.7161,0.5329,1.3333,0.6571,0.6072,0.2444,1.5255216686666666,0.7745926320666666,0.5235156506666667,1.8076,5.8459,0.287,3.9888,0.3366,-73.151,1.0832,7.4595,0.3733,5.2691,0.4527,0.7062,1.6733820383333333,3.801244490333333,5.341261539,0.34229612206666665,0.2879034981333333,0.8559,3.9098,0.5243,2.8473,0.5435,0.9609,0.05,0.493,0.42,0.023,1.946,84.6086956521739,1.4953482056666667,3.505650969,1.9326801361,0.4095494838666667,0.35375732936666665,104,0.3081481481481481,1,1,1,2,FALSE,FALSE,FALSE
133,2021-11-13T01:18:27Z,2021-11-13T01:44:25Z,1558,1,2021-11-13T01:44:26Z,1,Chrome,95.0.4638.69,Windows NT 10.0,1536,864,None,1.7777777777777777,657,72,461,100,112,87,-0.3396684408427445,-0.16174820188680444,0.16125500807708953,-0.05583022810660534,0.5532399024557046,-0.31040588424149007,1,2,3,3,1,1,3,2,2,1,1,3,3,2,1,2,4,2,1,1,0.9445132413883326,0,1,1,3,2,3.15,0,1,4,3,3,2,1,2,3,3,1,4,2,1,1,2,5,5,1,1,4,5,4,5,0,2,3,4,4,2,4,3,2,4,4,4,3,3,3,4,2,2,5,4,5,5,5,4,4,2,1,1,1,3,2,3,1,1,1,3,3,1,1,1,3,2,4,1,1,1.3506755066722445,1.082325538564332,3.75,0,2,0,3,0,2.6666666666666665,0,3.8333333333333335,0,1.8333333333333333,0,1.7142857142857142,0,1.6666666666666667,0,2.7027027027027026,0,0,3,4,1.3696442790693273,1.2046666115177265,0.9020622539667457,1.053364432742236,4,1,4,1,1,1,1,1,1,1.4638501094227998,1.2857142857142858,0,1,-0.7321841937363471,2,1,2,3,3,3,1,6,3,5,4,0.8997354108424374,2.7142857142857144,0,3.2857142857142856,4.5,3.8333333333333335,3.2559414990859232,0.10757398284279028,0,0.5160584124745394,2,2,2,3,2,4,4,2,2,3,2,3,2,3,4,2,3,1,4,3,0.9411239481143202,2.2,0,3.4,0,3.8,0,3.6,0,3.6,0,3,3,3,2,2,3,1,2,2,3,2,2,2,3,2,1,1,3,3,2,0.7163503994113789,2.55,0,"White, Caucasian, Anglo, European American",0,21,1,2,NA,1,4,3,Student,4,0,250,68,1,5,2,0,1,2,0,1,TRUE,TRUE,TRUE,TRUE,TRUE,6,0.6915390243902803,0.82,0.026789197636824948,6,0.41517931034493033,0.4777548387098697,0.9354838709677419,0.96875,0.002305113957000395,0.003280991249911918,6,0.5150124999994877,0.6113919999998808,1,0.78125,0.0057007333869603105,0.009652127378937437,1.1628,1.3472,0.4102,0.9598,1.7509,0.5016,0.2244,1.2136824221333333,1.1734858651,0.4017769495,1.0311,3.9451,0.2957,3.5451,0.3377,-73.9408,0.716,4.9437,0.3452,5.6269,0.4151,0.9482,1.1255992116666667,3.7411582543333335,4.20326214,0.3323750148333333,0.2902785051,0.7445,6.4183,0.4514,2.6081,0.4958,0.8692,0.061,0.379,0.481,0.011,1.781,161.9090909090909,1.1513262642666666,4.241361326,1.5592652913333334,0.3796541461333333,0.3372500181,338,1.0014814814814814,1,0,0,1,FALSE,FALSE,FALSE
134,2021-11-13T01:21:55Z,2021-11-13T01:45:24Z,1409,1,2021-11-13T01:45:26Z,0.8999999761581421,Edge,95.0.1020.44,Windows NT 10.0,1920,1080,None,1.7777777777777777,668,63,395,71,64,104,-0.31140540364955943,-0.24351084670544482,-0.15648477478499373,-0.4092360175938684,-0.10973896011284763,-0.02325264930698783,3,3,2,1,2,1,2,3,1,2,2,1,3,1,2,2,2,1,2,2,0.7181848464596079,0,1,2,4,5,2.1,0,3,3,2,4,2,1,4,3,2,1,2,3,3,3,3,2,3,5,2,2,2,2,2,3,3,2,1,5,2,2,3,5,2,2,3,3,1,4,3,3,3,2,4,2,2,3,5,3,2,3,4,3,4,1,2,4,4,3,4,2,1,1,1,1,2,3,3,3,1.18802837146737,0.9102589898327995,2.5,0,2.75,0,2.3333333333333335,0,3,0,2.5833333333333335,0,3,0,2.4285714285714284,0,1,0,2.6486486486486487,0,2,2,1,0.5585116111137219,0.3577521658231747,0.8074686614209358,0.5826104136220552,3,2,1,2,2,2,1,1,1,0.6900655593423543,2.4285714285714284,0,1,-0.048446712495193056,2,3,3,4,2,2,2,6,6,NA,2,0.7867957924694432,2.857142857142857,0,3.142857142857143,3,3.8333333333333335,3.2559414990859232,-0.7395711320441822,0,0.012814857609616537,2,3,2,2,2,2,5,2,1,2,3,4,2,3,4,1,4,2,3,3,1.162919151265879,2.2,0,3.8,0,3.8,0,3.8,0,3.8,0,2,1,2,3,2,3,2,3,2,1,1,2,3,2,1,2,2,2,1,1,0.7181848464596079,1.9,0,Filipino,0,23,0,1,NA,0,3,6,Unemployed,3,0,195,69,2,5,2,0,0,1,0,0,TRUE,TRUE,TRUE,TRUE,TRUE,5,0.9251049999998883,0.8,0.08471427443262812,5,0.4701419354837027,0.5435379310344057,0.96875,0.9666666666666667,0.0020605283870883968,0.006737599816136939,5,0.5146281249998137,0.6098531249999068,1,1,0.008844542086662046,0.007977699344728506,1.4227,1.0163,0.5158,1.2796,1.2457,0.5721,0.2502,1.4526744263333333,0.9789580342666667,0.5060802757,1.1919,4.9353,0.3541,3.3325,0.3746,-73.4568,0.7,6.3886,0.4195,3.1555,0.4617,0.9368,1.3076743556,3.5351801903333335,4.982753095333333,0.36653171636666665,0.3457052362333333,0.9954,3.4891,0.3933,6.9616,0.5463,0.5179,0.147,0.21,0.477,0.017,1.803,106.05882352941175,2.190759502666667,4.613266478333333,3.9763937796666666,0.2803093851,0.33854488866666665,104,0.3081481481481481,1,0,0,1,FALSE,FALSE,FALSE
135,2021-11-13T01:27:15Z,2021-11-13T01:46:35Z,1160,1,2021-11-13T01:46:36Z,1,Chrome,94.0.4606.81,Macintosh,1440,900,NA,1.6,620,56,281,58,46,64,-0.434735020492549,-0.30710401489772066,-0.7053080360922285,-0.5676593025364346,-0.3583560335760547,-0.6989073197411108,2,1,3,3,1,1,3,1,1,1,1,2,3,3,1,1,2,2,1,1,0.8645047258706176,0,1,2,4,3,3.1,0,4,4,4,3,4,3,3,3,2,3,3,3,2,3,2,2,3,1,1,1,3,3,2,0,2,0,0,3,4,4,5,5,5,5,5,4,5,4,4,1,4,2,3,2,3,4,3,4,2,1,1,1,2,1,1,1,1,1,3,3,2,1,1,1,1,2,1,1,1.5166740916559167,0.7037315505489968,2,0,1.25,0,2.933333333333333,0,1.5555555555555556,0,2.9166666666666665,0,1.5,0,1.5714285714285714,0,1,0,2,0,0,0,0,-0.15595757827722637,0.12197118414181142,-0.6588395645607719,-0.26843419020948023,5,1,5,1,1,1,1,1,1,1.9518001458970664,1,0,1,-0.9031185640466358,5,5,5,5,4,3,1,6,7,6,4,1.5275252316519468,4.571428571428571,0,1.4285714285714286,2.5,3.8333333333333335,3.2559414990859232,-1.0219528370065065,0,-1.0844279639287866,1,1,1,1,1,1,5,2,1,2,1,2,3,4,5,2,5,1,4,2,1.5430334996209192,1,0,4.4,0,3.6,0,4.4,0,4.133333333333334,0,2,3,3,2,4,3,2,2,2,1,3,2,1,3,1,2,3,4,2,2,0.8750939799154206,2.55,0,"White, Caucasian, Anglo, European American",0,25,1,2,NA,1,2,6,Painter,1,0,135,65,3,5,2,0,0,1,0,0,TRUE,TRUE,TRUE,TRUE,TRUE,4,0.852991304350936,0.9387755102040817,0.05064196837226682,4,0.6611937500238418,0.6643000000044703,1,1,0.003341834153460225,0.0019004535491863367,4,0.7127562500163913,0.7519249999672174,1,1,0.0062721076976840155,0.006466056129853493,1.6539,1.8605,0.4617,1.4606,2.0311,0.5287,0.2228,1.5352471856666667,1.4350770364,0.4607413957,9.6691,11.5032,0.2409,13.6514,0.3102,-102.2623,0.8367,5.3046,0.5893,7.1573,0.6096,0.9375,2.234400046333333,6.147853354666666,5.7388017903333335,0.49093966976666664,0.4705326032,1.1166,4.1613,0.5812,4.4654,0.6342,0.9669,0.072,0.557,0.474,0.03,1.638,54.6,2.844554169,5.484585521666666,4.912727590333334,0.45892585976666667,0.47001544863333333,434,1.285925925925926,1,0,0,1,FALSE,FALSE,FALSE
136,2021-11-13T01:13:55Z,2021-11-13T01:46:43Z,1968,1,2021-11-13T01:46:44Z,1,Chrome,95.0.4638.69,Windows NT 10.0,1366,768,"I wasn't sure on my parent's education levels. or financial situation; it would've been better for quality control if there was an unsure button in my opinion. However, it was overall a good study! (:",1.7786458333333333,850,59,323,195,216,156,0.15621939354677591,-0.2798497999581739,-0.5031099924527209,1.1018783926275322,1.9896941046875678,0.855098422257372,2,1,4,4,1,3,4,1,3,1,2,4,4,3,1,1,4,2,1,1,1.3088765773505315,0,0,1,3,1,3.65,0,1,1,5,1,5,5,1,5,5,5,5,1,3,1,1,5,5,5,5,5,5,5,5,20,5,50,2,1,1,1,1,1,3,1,1,1,5,1,5,5,1,5,3,5,5,5,5,5,1,5,5,5,5,5,5,5,5,5,3,5,5,5,5,5,5,5,5,5,1.829028525022326,2,5,0,5,0,4.866666666666666,0,4.777777777777778,0,4.833333333333333,0,4.833333333333333,0,4.571428571428571,0,5,0,4.837837837837838,0,6,6,2,3.475227007803827,3.461621016626932,3.3284318583334467,3.3950264374801895,1,5,1,5,5,5,5,8,3,1.9518001458970664,5,0,5.5,3.1504071567821237,1,1,1,1,1,1,5,2,5,1,1,1.5118578920369088,1,0,5,5.5,3.8333333333333335,3.2559414990859232,0.6723373927674386,0,1.7544920864941047,4,5,5,5,5,4,5,4,3,5,2,4,3,5,5,1,4,2,5,4,1.2798809468443688,4.8,0,3.6,0,4.6,0,3.4,0,3.8666666666666667,0,2,4,4,1,3,4,4,3,2,4,4,2,4,4,2,1,4,4,4,4,1.105012502906165,3.5,0,"White, Caucasian, Anglo, European American",0,22,1,2,NA,1,1,4,Homemaker/Stay At Home Parent/Self Employed,2,0,190,63,3,5,2,1,0,0,0,1,TRUE,TRUE,TRUE,TRUE,TRUE,6,0.744245945946993,0.74,0.03629902719981122,6,0.42874687499832365,0.47093548387096773,1,0.96875,0.0022864832158404663,0.0036387191935252374,6,0.5362749999994412,0.6120964285720671,1,0.9333333333333333,0.005339475484094955,0.004058551310399796,1.3084,0.8506,0.3689,1.0619,1.0563,0.4917,0.3075,1.3497830806666666,0.8822588235333333,0.36225024263333333,1.4853,5.2767,0.288,4.7898,0.3238,-84.5183,0.7895,5.9994,0.3644,4.7576,0.3974,0.793,1.4468309906666668,4.550332959666667,5.037809334666667,0.3236008564,0.28691751623333334,0.7651,3.1774,0.4503,5.3162,0.5422,0.7698,0.064,0.409,0.585,0.016,1.873,117.0625,1.3839981150666667,4.368379182666667,3.488407351333333,0.37906132853333335,0.4339818327666667,339,1.0044444444444445,1,0,0,1,FALSE,FALSE,FALSE
137,2021-11-13T01:17:39Z,2021-11-13T01:47:23Z,1783,1,2021-11-13T01:47:24Z,0.8999999761581421,Chrome,95.0.4638.69,Macintosh,1366,768,no,1.7786458333333333,685,620,240,31,30,140,-0.2677261643510006,4.816688393737076,-0.902691840597462,-0.8966922789556105,-0.5793489877655722,0.5848365540837228,2,2,3,3,1,1,2,2,2,2,2,3,3,3,1,1,3,3,1,1,0.8255779474818965,0,1,2,3,2,3.05,0,1,1,4,1,4,4,4,4,4,4,4,2,2,2,2,5,5,1,1,4,4,4,5,2,3,0,0,3,4,4,4,4,2,2,2,2,5,3,5,4,1,3,3,4,4,4,4,4,1,1,3,2,2,3,4,2,3,1,1,5,5,4,4,4,3,3,3,3,1.2508255532105843,1.3020130933435712,3.625,0,3,0,3.933333333333333,0,3,0,4,0,2.5,0,3.4285714285714284,0,4,0,3.4594594594594597,0,1,0,0,1.7626023332343488,1.877261866732748,0.0930613282564324,0.9851615974945902,1,4,2,4,4,3,3,8,4,1.1547005383792515,3.857142857142857,0,6,2.6511635129281608,3,3,3,3,1,1,5,5,3,2,1,1.3801311186847085,2.142857142857143,0,3.857142857142857,5,3.8333333333333335,3.2559414990859232,0.38995568780511447,0,0.9759332546414488,5,5,5,5,5,4,4,3,4,4,3,4,4,3,3,4,3,4,4,4,0.4879500364742666,5,0,2.8,0,3.2,0,2.6,0,2.8666666666666667,0,4,4,3,2,3,4,4,3,3,3,3,3,4,4,4,2,4,4,4,4,0.6863327411532597,3.45,0,"Hispanic of Latino (e.g., Mexican American, Central American, and others)",0,25,1,2,NA,1,2,6,IT Tech,3,0,100,65,2,4,2,0,0,2,1,0,TRUE,TRUE,TRUE,TRUE,TRUE,2,0.9473945945944838,0.7551020408163265,0.13541700397958553,2,0.5792999999999627,0.665729629629671,0.9259259259259259,0.8709677419354839,0.047703710284895916,0.03086394146233623,NA,NA,NA,NA,NA,NA,NA,1.3243,0.8499,0.5655,0.9785,1.1338,0.6768,0.4198,1.3794171766666667,0.87828314603,0.5525607291,1.2737,1.8641,0.2898,1.6315,0.397,-4.7218,1.0117,2.4875,0.386,1.5591,0.4711,0.9973,1.3649274223333334,1.833252203,2.1780859561333332,0.3839603334,0.2834647873,NA,NA,NA,NA,NA,NA,NA,NA,NA,NA,NA,NA,NA,NA,NA,NA,NA,446,1.3214814814814815,1,0,0,1,FALSE,FALSE,FALSE
138,2021-11-13T01:23:22Z,2021-11-13T01:47:34Z,1451,1,2021-11-13T01:47:34Z,1,Chrome,95.0.4638.54,Windows NT 10.0,1366,768,NA,1.7786458333333333,749,68,352,65,46,106,-0.10328667522701457,-0.1980871551395335,-0.36349705755877526,-0.4823544567981297,-0.3583560335760547,0.010530084214718316,3,2,2,2,3,1,1,3,1,3,4,2,1,2,4,4,2,2,3,3,0.99472291830968,0,1,4,2,3,1.7,0,5,4,2,4,2,1,5,2,2,1,2,4,2,5,4,2,1,1,1,3,1,1,3,4,2,0,0,4,3,4,4,4,4,4,3,4,1,3,4,3,5,3,5,1,4,5,5,3,5,1,2,1,1,1,4,3,5,4,4,3,3,2,2,1,3,4,4,5,1.3506755066722445,1.4638501094227998,1.625,0,4,0,1.6666666666666667,0,2.2222222222222223,0,2.8333333333333335,0,1,0,3.2857142857142856,0,1.6666666666666667,0,2.4324324324324325,0,2,0,0,-0.12023411880767895,-0.397695519736365,0.6097586129219131,0.10603154659277406,4,2,3,2,1,2,2,5,2,0.9511897312113419,2,0,3.5,0.6176209189753294,3,4,4,3,2,1,2,7,7,2,3,1.1126972805283737,3,0,3,2,3.8333333333333335,3.2559414990859232,-1.3043345419688306,0,-0.34923784477414443,2,2,3,3,3,2,3,2,1,1,2,4,2,4,2,2,4,3,4,3,1.0555973258234952,2.6,0,3.8,0,3.2,0,3.6,0,3.533333333333333,0,2,2,2,3,2,1,3,3,1,2,3,3,4,4,1,3,2,2,1,2,0.9233805168766387,2.1,0,"White, Caucasian, Anglo, European American",0,30,0,1,NA,1,3,7,Teacher,3,0,123,64,3,5,2,0,0,1,0,0,TRUE,TRUE,TRUE,TRUE,TRUE,2,0.8575315789486233,0.76,0.04937483514230103,NA,NA,NA,NA,NA,NA,NA,2,0.6404531250037253,0.6661875000037253,1,1,0.003205453538440327,0.006260782419372316,1.1725,0.9767,0.5548,1.1568,0.9368,0.565,0.0376,1.2394314472,0.9641986639,0.5427059266,NA,NA,NA,NA,NA,NA,NA,NA,NA,NA,NA,NA,NA,NA,NA,NA,NA,0.9077,6.2037,0.5659,3.5612,0.5553,0.8898,0.078,0.511,0.607,0.116,1.695,14.612068965517242,2.0269828875,5.975177618,4.870474407333333,0.478475387,0.4658572078,496,1.4696296296296296,1,0,5,6,TRUE,FALSE,FALSE
139,2021-11-13T01:13:49Z,2021-11-13T01:47:55Z,2045,1,2021-11-13T01:47:56Z,1,Opera,80.0.4170.91,Windows NT 10.0,1536,864,Was good :),1.7777777777777777,920,104,573,140,80,164,0.3360750847761356,0.12896342413502795,0.7004497911157763,0.4316260332551368,0.1112539940766698,0.9902293563441966,4,3,3,2,2,2,2,4,2,3,4,2,3,2,4,3,3,2,2,3,0.7863975156570492,0,1,1,4,5,2.05,0,1,3,2,3,1,1,4,3,1,1,1,3,2,4,3,3,1,1,3,1,1,1,1,4,3,0,2,4,1,1,2,4,2,1,1,2,5,3,1,1,1,2,3,4,4,1,3,4,2,4,1,1,3,1,1,4,2,1,4,1,1,1,3,2,4,3,2,4,1.2938988268694636,1.1464230084422218,1.5,0,3.25,0,2.2,0,4,0,3,0,2.1666666666666665,0,1.5714285714285714,0,2,0,2.810810810810811,0,2,0,2,0.03736937885208878,-0.0596072730150998,0.7274542985685514,0.3339235127767258,3,3,2,1,1,2,3,3,2,0.8997354108424374,2.4285714285714284,0,2.5,0.5050347996663801,3,3,5,3,2,2,3,1,3,1,2,1,3,0,3,7,3.8333333333333335,3.2559414990859232,1.5194825076544112,0,1.0626706800374763,2,2,2,3,3,1,4,1,1,2,1,4,2,3,5,3,4,2,3,3,1.2983506020002016,2.4,0,4.4,0,3.2,0,4.2,0,3.933333333333333,0,1,1,1,3,2,2,2,4,1,1,3,4,2,2,1,4,3,2,1,1,1.0990426455975697,1.55,0,"Hispanic of Latino (e.g., Mexican American, Central American, and others) & White, Caucasian, Anglo, European American",1,21,0,1,NA,1,2,3,Student,2,0,154,69,2,5,2,0,0,3,0,0,TRUE,TRUE,TRUE,TRUE,TRUE,4,0.902473684209546,0.76,0.09439784365724617,4,0.4806161290332675,0.6007218750000466,1,1,0.005817080731145739,0.007545368860846275,4,0.680425000000745,0.6302870967743859,1,0.96875,0.007923347096802225,0.010960435766086227,1.3262,0.8626,0.4888,1.3914,0.848,0.4556,0.0811,1.3726458670666666,0.8880785667,0.47851767666666667,2.8996,6.9937,0.2733,5.2462,0.3244,-73.9973,0.833,4.8786,0.3886,3.5294,0.5009,0.921,1.8765517416666666,4.020374441333334,5.554533193666667,0.36845148423333335,0.31568741953333335,0.9635,5.1317,0.5812,2.715,0.5035,0.983,0.271,0.201,0.594,0.32,1.309,4.090624999999999,1.7981398343333332,4.3817581966666665,3.3800023973333335,0.47670450733333336,0.3783025057666667,104,0.3081481481481481,1,0,4,5,FALSE,FALSE,FALSE
140,2021-11-13T01:23:15Z,2021-11-13T01:48:01Z,1485,1,2021-11-13T01:48:02Z,1,Chrome,95.0.4638.69,Macintosh,1440,900,NA,1.6,784,59,349,74,62,91,-0.013358829612334701,-0.2798497999581739,-0.3779397749615972,-0.37267679799173775,-0.1373630793865373,-0.2428404171980778,3,3,2,1,2,1,1,3,1,2,2,1,1,2,2,2,1,2,3,2,0.7451598203705946,0,1,3,4,4,1.95,0,2,4,3,3,4,2,4,3,2,2,4,3,2,3,2,2,3,4,1,2,3,2,2,2,2,0,0,4,4,2,4,2,3,2,2,3,3,4,2,2,3,3,4,3,2,2,3,1,2,1,3,2,3,2,2,2,2,1,4,2,2,1,1,2,2,2,1,2,0.9291734839971293,0.8338093878327919,2.375,0,1.75,0,2.8666666666666667,0,3.111111111111111,0,2.3333333333333335,0,2.3333333333333335,0,1.7142857142857142,0,1.3333333333333333,0,2.3783783783783785,0,1,0,0,0.312650154764484,0.41708457213297584,-0.2989446853297732,0.05906994340160132,4,1,2,1,1,2,1,1,1,1.1126972805283737,1.7142857142857142,0,1,-0.4757826382709144,4,5,5,5,2,3,1,6,6,3,3,1.618347187425374,4.142857142857143,0,1.8571428571428572,3,3.8333333333333335,3.2559414990859232,-0.7395711320441822,0,-0.7042241191833141,3,4,3,3,2,2,4,2,3,3,2,4,4,4,3,4,4,2,2,4,0.9154754164341269,3,0,4,0,2.6,0,3.2,0,3.2666666666666666,0,2,2,3,4,3,3,2,2,1,2,2,3,4,2,1,2,1,2,2,4,0.9333020044867296,2.25,0,"Black or African American & White, Caucasian, Anglo, European American",1,20,1,2,NA,1,4,4,student,5,0,120,66,2,5,2,0,0,1,0,0,TRUE,TRUE,TRUE,TRUE,TRUE,2,1.2602605263143778,0.76,0.2849639336140553,2,0.6909199999988079,0.7417799999992053,1,1,0.030024365102553675,0.014744062344499976,2,0.9227709677440504,0.9961968750022352,1,1,0.13937109479518783,0.06946798160268683,1.8548,0.67,0.5623,1.3779,0.7049,0.805,0.2926,1.7893968076666666,0.7035764904666667,0.5566953432,1.7513,3.7864,0.4597,3.5432,0.4947,-47.7068,1.1786,3.4736,0.5116,3.5123,0.5749,0.9598,2.272949502,3.8197666636666665,4.035786098333333,0.443583973,0.4049516987333333,1.4934,3.8228,0.6294,2.1167,0.661,0.5361,0.083,0.61,0.271,0.109,1.836,16.844036697247706,2.622513469,2.943057579,2.773737279,0.4670952001,0.5182763244333334,104,0.3081481481481481,1,0,0,1,FALSE,FALSE,FALSE
141,2021-11-13T01:25:24Z,2021-11-13T01:48:16Z,1371,1,2021-11-13T01:48:17Z,1,Firefox,94.0,Windows NT 10.0,1920,1080,NA,1.7777777777777777,649,49,341,106,66,100,-0.36022337698324275,-0.3706971830899965,-0.41645368803578914,0.017288211097655985,-0.08211484083915795,-0.09081811635040013,3,3,2,2,1,1,1,2,1,2,2,1,1,2,3,3,1,1,2,2,0.7677718959499145,0,1,2,2,4,2,0,4,5,2,5,1,1,4,1,3,1,1,4,1,4,2,1,1,5,1,1,1,1,2,2,2,1,0,5,1,2,3,2,4,5,5,4,1,5,1,1,2,3,4,5,2,1,2,2,2,1,1,1,1,1,1,4,1,1,2,2,4,1,1,1,1,2,2,1,1.4881917600614225,1.5946338585572373,1.625,0,1.5,0,1.6666666666666667,0,2.5555555555555554,0,2.0833333333333335,0,1.3333333333333333,0,2.2857142857142856,0,1,0,2.081081081081081,0,1,1,0,-0.33877763556255713,-0.5486882666259079,-0.1707126804539906,-0.3597004735399492,3,2,4,1,1,2,2,1,1,1.0690449676496976,1.8571428571428572,0,1,-0.39031545311577004,5,5,5,5,2,2,1,6,6,5,4,1.8126539343499315,4.142857142857143,0,1.8571428571428572,3,3.8333333333333335,3.2559414990859232,-0.7395711320441822,0,-0.7042241191833141,2,1,1,3,1,3,5,1,2,5,3,2,1,4,5,1,3,5,4,3,1.505545305418162,1.6,0,2.4,0,4.8,0,4.2,0,3.8,0,1,1,2,2,3,4,4,2,3,1,3,1,1,2,3,1,2,4,4,2,1.1285761872936695,2.7,0,"White, Caucasian, Anglo, European American",0,23,0,2,NA,1,3,5,IT Manager,2,0,189,69,2,5,2,0,0,1,0,0,TRUE,TRUE,TRUE,TRUE,TRUE,4,0.7515263157894737,0.76,0.08799991673469389,4,0.404625,0.5230967741935484,1,0.96875,0.006039919354838712,0.009251447580645163,4,0.6358709677419355,0.7259310344827586,0.96875,0.9354838709677419,0.01768317641129032,0.022318490322580643,1.2491,0.9488,0.4226,1.0834,1.1365,0.4528,0.1883,1.2968406883333334,0.9448201701,0.4145413662333333,1.4508,4.5631,0.2457,3.5478,0.3266,-66.7672,1.0904,6.5137,0.3156,3.9656,0.3834,0.9776,1.4807363667333333,3.599479682,4.614016177666667,0.32400724573333334,0.24414596043333334,1.0868,4.1727,0.5041,2.0331,0.5246,0.9827,0.063,0.436,0.29,0.022,1.768,80.36363636363637,1.6866895486666666,2.7094158366666665,2.5926739496666666,0.3235411276333333,0.4358471096,272,0.8059259259259259,1,1,7,9,FALSE,FALSE,FALSE
143,2021-11-13T01:32:07Z,2021-11-13T01:50:36Z,1109,1,2021-11-13T01:50:37Z,0.8999999761581421,Chrome,95.0.4638.69,Windows NT 10.0,1280,720,NA,1.7777777777777777,616,55,213,100,41,56,-0.44501248856279807,-0.31618875321090295,-1.0326762972228596,-0.05583022810660534,-0.42741633176027893,-0.8340382538279354,4,3,4,4,3,3,4,3,4,3,2,4,3,4,2,2,4,3,2,2,0.812727700887249,0,1,1,4,3,3.05,0,5,5,2,4,2,1,4,2,1,1,3,4,5,5,3,1,2,1,1,1,1,1,1,2,2,0,0,4,5,2,5,5,5,2,3,5,1,5,1,1,4,1,5,3,1,1,3,3,5,1,1,1,1,1,1,1,1,1,4,3,4,1,3,1,2,1,2,1,1.6589913357978252,1.5522640914238175,1.125,0,1.5,0,1.9333333333333333,0,2,0,1.5833333333333333,0,0.8333333333333334,0,1.7142857142857142,0,1.6666666666666667,0,1.6486486486486487,0,1,0,0,-0.9187585069505032,-0.8348001639371186,-0.3773458880470143,-0.6060730259920665,4,2,3,1,1,2,1,1,1,1.1547005383792515,1.7142857142857142,0,1,-0.4757826382709144,2,3,4,4,3,3,2,6,3,3,2,0.816496580927726,3.2857142857142856,0,2.7142857142857144,4.5,3.8333333333333335,3.2559414990859232,0.10757398284279028,0,0.19737442278879264,1,1,1,3,4,1,4,3,2,3,1,4,3,3,3,1,4,4,4,1,1.2227992865708155,2,0,4,0,3.8,0,3.6,0,3.8,0,1,2,1,3,2,1,2,2,1,3,2,4,1,2,1,3,1,1,1,2,0.8944271909999159,1.6,0,"Asian or Asian American (e.g., Chinese, Japanese, and others)",0,21,1,2,NA,1,3,4,Student,3,0,116,65,1,5,2,0,0,0,0,0,TRUE,TRUE,TRUE,TRUE,TRUE,5,0.6224722222222222,0.72,0.022480585408164878,5,0.44078124999953433,0.5147612903238304,1,0.96875,0.003676951895116223,0.008745112096642752,5,0.6011258064522859,0.6537483870978317,1,0.96875,0.025562091978523455,0.006809769516540815,0.9975,0.9371,0.4128,0.9692,0.778,0.4403,0.1576,1.0653905825666667,0.9418190648133333,0.40393078536666666,1.6792,4.9869,0.2724,3.8067,0.3033,-67.2682,0.9314,5.7964,0.3656,4.9573,0.4139,0.9951,1.6132386493333333,3.726627495,4.794687668,0.30655647146666665,0.2735194240666667,1.329,3.0281,0.3853,4.927,0.5167,0.9927,0.073,0.395,0.418,0.017,1.853,108.99999999999999,1.959991122,3.7396256286666665,3.378995684,0.33644709576666665,0.3751289704333333,104,0.3081481481481481,1,1,1,2,FALSE,FALSE,FALSE
144,2021-11-13T01:24:09Z,2021-11-13T01:51:23Z,1633,1,2021-11-13T01:51:24Z,1,Chrome,95.0.4638.69,Windows NT 10.0,1536,864,NA,1.7777777777777777,638,80,487,96,69,178,-0.3884864141764279,-0.08907029538134635,0.28642522556821326,-0.10457585424277956,-0.04067866192862343,1.2267084909961397,4,4,1,1,4,1,2,3,1,4,4,1,1,1,4,3,1,1,4,4,1.4317821063276353,0,1,1,2,1,1.15,0,2,3,4,3,4,3,3,2,4,2,3,5,2,4,4,2,2,1,2,2,3,3,3,4,2,0,0,5,5,2,5,5,5,4,5,5,1,4,2,1,4,2,5,3,2,2,3,3,4,1,1,1,2,1,1,4,4,1,4,2,2,1,1,1,1,1,3,3,1.578287360080854,0.9411239481143202,2.25,0,2,0,2.8,0,1.4444444444444444,0,2,0,1.1666666666666667,0,2.142857142857143,0,1,0,1.7297297297297298,0,2,0,0,-0.16856585809000774,0.05596025248881939,-0.01745100881601569,0.01925462183640185,3,2,3,2,1,3,3,5,4,0.7867957924694432,2.4285714285714284,0,4.5,1.2430101492151444,5,5,5,5,3,3,2,8,1,3,3,1.2909944487358056,4.285714285714286,0,1.7142857142857142,4.5,3.8333333333333335,3.2559414990859232,0.10757398284279028,0,-0.3603225591612647,2,3,3,4,3,2,3,2,3,3,2,4,3,4,4,3,4,2,2,4,0.8451542547285166,3,0,4,0,2.8,0,3.4,0,3.4,0,1,2,2,4,2,1,2,4,1,1,3,4,1,2,1,4,1,2,1,1,1.1697953037312037,1.4,0,"White, Caucasian, Anglo, European American & Other & Greek",1,22,1,2,NA,1,2,6,"Post Graduate Student, Project Engineer",2,0,120,64,3,5,2,0,0,0,0,0,TRUE,TRUE,TRUE,TRUE,TRUE,1,0.6682780487788159,0.82,0.02447871905684279,1,0.4077406249996275,0.5171258064527665,1,0.96875,0.0018966270060264995,0.008406948669113873,1,0.5344031250006519,0.636744827583946,1,0.90625,0.014573673215545221,0.01035451861878529,1.2376,1.3617,0.4061,0.9558,1.1463,0.4988,0.0825,1.2737863028,1.1844578462333333,0.3994883600333333,2.0317,5.7871,0.2322,4.0202,0.2763,-68.5355,0.8192,6.168,0.3532,3.8653,0.4174,0.9177,1.7310443706666667,3.7559483416666666,5.070096785666666,0.296674867,0.2389788629,1.0336,4.3919,0.4089,3.0459,0.494,0.9245,0.068,0.365,0.441,0.011,1.678,152.54545454545456,1.5498534466666667,3.262850992,2.5678293906666667,0.2905929615,0.36887664136666665,354,1.0488888888888888,1,0,0,1,FALSE,FALSE,FALSE
145,2021-11-13T01:28:59Z,2021-11-13T01:52:09Z,1390,1,2021-11-13T01:52:13Z,1,Edge,95.0.1020.44,Windows NT 10.0,1280,800,"For the one question about my parents' marriage, I accidently selected an answer and could not figure out how to deselect. The answer is best left blank for me because I did not grow up in a two-parent household.",1.6,643,44,371,82,52,85,-0.37563957908861645,-0.4161208746559078,-0.27202651400756944,-0.2751855457193893,-0.2754836757549857,-0.34418861776319626,2,3,2,2,3,1,1,3,1,2,2,1,2,1,2,2,1,1,2,1,0.7163503994113789,0,1,1,5,5,2.05,0,1,4,4,2,5,4,5,5,4,5,2,1,1,1,1,5,5,NA,4,5,5,5,5,0,1,0,NA,4,2,1,1,1,3,1,1,4,5,2,1,5,2,2,5,4,4,1,1,4,5,1,2,1,2,2,2,1,1,1,4,5,3,1,2,5,1,2,1,2,1.5387877916944455,1.7320508075688772,4.857142857142857,1,1.5,0,3.8,0,4,0,3,0,1.3333333333333333,0,2,0,2.6666666666666665,0,2.810810810810811,0,0,0,NA,2.1255406735594145,2.0707178668913184,-0.6114411611880771,0.7296383528516206,5,1,5,1,1,2,2,8,3,1.8126539343499315,1.2857142857142858,0,5.5,0.9282603427483724,5,5,5,4,2,3,3,7,NA,3,3,1.2149857925879117,3.857142857142857,0,2.142857142857143,2,3.8333333333333335,3.2559414990859232,-1.3043345419688306,0,-0.827263829302765,4,2,2,1,2,2,4,3,1,4,2,3,1,4,5,2,3,2,4,2,1.2071217242444348,2.2,0,3.6,0,4.2,0,4.2,0,4,0,1,1,2,3,3,1,2,2,2,1,3,3,1,3,2,2,1,1,4,3,0.9445132413883326,2.05,0,"Asian or Asian American (e.g., Chinese, Japanese, and others)",0,19,1,3,NA,1,2,4,Student,2,0,80,58,2,5,2,0,0,1,0,0,TRUE,TRUE,TRUE,TRUE,TRUE,1,0.7894499999992549,0.8163265306122449,0.07043677458127207,1,0.4067000000002208,0.48059032258006834,0.8709677419354839,0.96875,0.006868205247530776,0.0042980341937549444,1,0.6144812500011176,0.6729124999968334,1,1,0.009277068669380877,0.010695655322463903,1.1983,1.2523,0.4863,1.0834,1.5252,0.5095,0.2788,1.2537564193666666,1.1225695575666668,0.47590952706666667,0.9548,2.0694,0.23,4.028,0.3676,-59.2296,0.8019,3.1043,0.2977,4.3655,0.3947,0.9894,1.0228176642666666,4.070672354,2.4675680265333333,0.3620203750666667,0.22652994903333334,0.9077,3.2467,0.5052,3.7123,0.5566,0.9393,0.164,0.299,0.521,0.02,1.461,73.05,2.246416223333333,4.392634223666667,4.5028979866666665,0.36082731716666666,0.43004486426666666,375,1.1111111111111112,1,0,0,1,FALSE,FALSE,FALSE
146,2021-11-13T01:29:41Z,2021-11-13T01:52:22Z,1360,1,2021-11-13T01:52:24Z,0.800000011920929,Safari,14.1.2,Macintosh,1440,900,NA,1.6,697,118,305,70,52,78,-0.23689376014025323,0.25614976051957966,-0.5897662968696528,-0.421422424127912,-0.2754836757549857,-0.4624281850891678,2,2,2,3,2,1,2,2,1,3,2,1,1,3,2,3,1,1,2,3,0.7591546545162482,0,0,2,3,4,2.15,0,5,4,2,3,3,2,4,2,2,2,1,4,2,3,4,2,2,1,1,1,1,2,1,5,2,0,0,4,3,4,3,4,5,4,3,5,3,5,1,1,5,1,5,2,1,2,2,2,5,1,1,1,4,1,2,2,2,1,4,3,2,2,2,1,2,1,2,2,1.4539993514833884,1.1254628677422756,1.375,0,1.75,0,2.066666666666667,0,2.111111111111111,0,1.5,0,1.3333333333333333,0,1.8571428571428572,0,1.6666666666666667,0,1.7567567567567568,0,3,0,0,-0.696012230258031,-0.6236038987364887,0.10724026226325957,-0.25818181823661457,3,3,2,1,2,2,2,2,1,0.6900655593423543,2.4285714285714284,0,1.5,0.13604712489199797,3,3,4,4,2,2,4,3,3,2,2,0.8997354108424374,2.857142857142857,0,3.142857142857143,6,3.8333333333333335,3.2559414990859232,0.9547190977297628,0,0.8599599724965891,2,4,2,3,3,3,4,2,2,3,1,4,3,4,4,4,4,1,3,2,1.0997835284835873,2.8,0,4.2,0,3,0,4,0,3.7333333333333334,0,1,1,2,2,4,2,3,3,1,3,2,4,1,2,2,3,3,3,1,2,0.9665456669582609,2.05,0,"White, Caucasian, Anglo, European American",0,18,1,2,NA,1,2,4,full-time student and part-time retail worker,2,0,125,63,3,5,2,0,0,0,0,0,TRUE,TRUE,TRUE,TRUE,TRUE,4,0.8310000000000013,0.8775510204081632,0.03064388520408205,4,0.50396875,0.526300000000002,1,0.9375,0.006450482862902757,0.0034916129032252475,4,0.6494687499999959,0.7832333333333323,1,0.9375,0.00963206350806465,0.020946564516129154,1.4788,1.5488,0.4775,1.142,2.2869,0.6026,0.3439,1.4594446413333333,1.287424936,0.4712034059333333,1.3264,4.3981,0.3532,3.378,0.3492,-67.2609,0.7988,4.4415,0.4145,5.6148,0.4562,0.9351,1.4406484637333334,3.5629834563333334,4.536891228333333,0.3421388217333333,0.34473020183333336,1.1746,5.7014,0.5369,3.6818,0.6127,0.9903,0.077,0.458,0.425,0.01,1.597,159.7,1.8512586486666667,4.274975818333333,2.521764147,0.43353032243333334,0.4386258842333333,336,0.9955555555555555,1,0,0,1,FALSE,FALSE,FALSE
147,2021-11-13T01:27:40Z,2021-11-13T01:52:46Z,1505,1,2021-11-13T01:52:46Z,1,Chrome,95.0.4638.69,Windows NT 10.0,1366,768,NA,1.7786458333333333,695,60,355,160,103,77,-0.2420324941753778,-0.2707650616449916,-0.34905434015595327,0.6753541639360079,0.4289313657241011,-0.47931955185002084,2,2,3,3,1,3,2,2,1,2,1,2,2,3,1,2,2,2,2,2,0.6488856845230502,0,1,2,3,3,2.8,0,2,4,3,2,4,3,2,2,4,2,3,5,2,4,3,1,3,1,1,1,1,1,2,0,2,0,0,5,3,5,5,5,5,5,5,5,3,4,1,1,2,2,4,2,1,3,3,3,5,1,1,1,3,1,1,1,1,1,4,2,2,1,1,1,2,1,1,1,1.633912381270694,1,1.375,0,1.25,0,2.8666666666666667,0,1.2222222222222223,0,2.25,0,1.1666666666666667,0,1.2857142857142858,0,1,0,1.5945945945945945,0,0,0,0,-0.7968784687602826,-0.3494939889985495,-0.6588395645607719,-0.5041667767796607,5,1,2,1,1,1,1,1,1,1.4960264830861913,1.4285714285714286,0,1,-0.6467170085812028,5,5,5,5,2,2,2,7,4,4,3,1.6035674514745464,4,0,2,3.5,3.8333333333333335,3.2559414990859232,-0.4571894270818581,0,-0.48336226928071535,1,3,1,1,1,1,5,1,2,3,2,4,1,2,5,1,4,5,5,2,1.6417180315870614,1.4,0,3.6,0,4.6,0,4,0,4.066666666666666,0,2,1,2,2,3,3,2,2,3,3,3,2,3,4,2,2,2,3,3,3,0.6882472016116853,2.7,0,"White, Caucasian, Anglo, European American",0,21,1,2,NA,1,2,4,Nanny,6,0,300,67,1,5,2,0,0,2,0,0,TRUE,TRUE,TRUE,TRUE,TRUE,4,0.6948352941175758,0.68,0.019724662648976193,4,0.4900718750000233,0.5987678571429902,1,0.875,0.0014567240221762,0.006116559314520564,4,0.6890500000000175,0.838386206896526,1,0.9666666666666667,0.009201423225806775,0.016298797747120918,1.0318,0.7783,0.4581,0.8615,0.8395,0.5173,0.07,1.0972922476333333,0.85845699184,0.4505855986,1.1463,5.5019,0.3859,2.2821,0.3974,-69.7326,0.8005,8.3423,0.4447,3.3333,0.4903,0.9745,1.2609312723,2.534741207266667,5.440524161666667,0.3869214096333333,0.37757052286666665,0.9876,4.0178,0.5797,2.4366,0.7034,0.9807,0.087,0.481,0.392,0.012,1.737,144.75,2.466935100666667,4.180071163333333,3.1187090263333332,0.39414643693333334,0.4590915069,104,0.3081481481481481,1,0,0,1,FALSE,FALSE,FALSE
148,2021-11-13T01:22:38Z,2021-11-13T01:53:19Z,1840,1,2021-11-13T01:53:20Z,1,Chrome,93.0.4577.63,Macintosh,1440,900,No feedback,1.6,1073,62,400,86,65,88,0.7291882384631648,-0.2525955850186271,-0.13241357911362378,-0.2264399195832151,-0.09592690047600279,-0.293514517480637,2,3,3,2,2,3,3,2,2,3,3,3,2,1,2,2,3,1,2,2,0.6569466853317864,0,1,1,5,4,2.5,0,4,4,3,4,2,3,3,2,2,3,3,3,2,3,3,2,3,1,1,1,1,2,2,1,2,0,0,5,4,3,4,3,4,4,4,5,2,4,3,1,4,2,5,3,3,2,3,3,5,1,1,1,3,1,1,5,5,5,3,3,4,1,1,1,2,1,2,2,1.4431155818514962,0.7037315505489968,1.625,0,1.75,0,2.533333333333333,0,2,0,2.25,0,1.1666666666666667,0,3.5714285714285716,0,1,0,2.2162162162162162,0,1,0,0,-0.25472243681068096,-0.11816535754598059,-0.2989446853297732,-0.2085550214378769,5,2,5,2,2,3,3,1,1,1.3451854182690985,2,0,1,-0.3048482679606258,5,5,5,5,4,4,2,7,8,NA,5,1.1126972805283737,4.571428571428571,0,1.4285714285714286,1.5,3.8333333333333335,3.2559414990859232,-1.5867162469311549,0,-1.3668096688911109,1,1,2,1,3,2,4,1,3,4,2,4,1,4,4,2,3,2,3,2,1.0997835284835873,1.6,0,3.8,0,4,0,4,0,3.933333333333333,0,2,1,1,2,3,1,2,2,2,3,1,2,4,3,1,2,1,2,1,2,0.8522416262267903,2.1,0,"White, Caucasian, Anglo, European American & Middle Eastern",1,22,0,1,NA,1,4,6,Research Assistant,2,0,150,71,3,5,2,1,1,1,0,2,TRUE,TRUE,TRUE,TRUE,TRUE,5,1.169850000038743,0.64,0.14804557706067978,5,0.6059161290199526,0.6974281249791384,1,1,0.012842339390691591,0.021103617574197077,5,0.5860093750655652,0.620462962909981,1,0.84375,0.007593833780311423,0.013565826678269699,1.4442,0.4103,0.7123,1.306,0.2745,0.733,0.0375,1.4926583213333333,0.5590517421093333,0.6946049263333334,2.1701,4.7457,0.3773,3.7641,0.4092,-53.5124,1.1298,4.2403,0.4689,3.3703,0.5368,0.9643,2.1207274823333333,3.6238183196666665,4.516288499333333,0.4036093781,0.3704614972333333,0.721,3.7447,0.5169,2.5869,0.5068,0.9972,0.055,0.42,0.342,0.026,2.058,79.15384615384615,1.3560287159,3.4034716973333334,2.0785228803,0.38127530903333334,0.36520508853333333,466,1.3807407407407408,1,0,2,3,FALSE,FALSE,FALSE
149,2021-11-13T01:31:37Z,2021-11-13T01:53:32Z,1315,1,2021-11-13T01:53:33Z,1,Chrome,95.0.4638.69,Macintosh,1280,800,NA,1.6,775,45,284,60,35,65,-0.036483132770395235,-0.40703613634272556,-0.6908653186894065,-0.5432864894683475,-0.510288689581348,-0.6820159529802577,3,3,3,2,3,1,2,2,1,3,2,2,1,2,3,3,2,1,2,2,0.7451598203705946,0,1,1,3,3,2.05,0,4,5,1,4,1,1,3,2,2,3,2,3,3,3,4,1,2,1,1,1,1,2,2,0,2,0,0,5,5,5,5,5,5,5,5,4,1,5,1,1,3,1,5,1,3,3,4,3,3,1,1,1,1,1,1,1,1,1,5,1,2,1,1,2,1,1,1,1,1.7646852733884628,1.2227992865708155,1.375,0,1,0,2.066666666666667,0,1.1111111111111112,0,1.9166666666666667,0,1.1666666666666667,0,1,0,1.3333333333333333,0,1.4324324324324325,0,0,0,0,-0.8977447072625341,-0.7629818189422206,-0.7372407672780129,-0.7501112931101168,4,2,2,2,1,2,2,1,1,0.8997354108424374,2.142857142857143,0,1,-0.21938108280548152,5,5,5,4,3,4,1,3,2,4,3,1.4638501094227998,4.428571428571429,0,1.5714285714285714,6.5,3.8333333333333335,3.2559414990859232,1.237100802692087,0,0.12476985334194696,1,1,1,3,1,2,4,2,1,2,2,2,3,3,4,3,5,2,4,2,1.0997835284835873,1.4,0,3.8,0,3.2,0,4,0,3.6666666666666665,0,2,1,2,2,2,2,2,2,2,2,2,2,1,2,1,2,1,2,2,2,0.41039134083406165,2,0,"White, Caucasian, Anglo, European American",0,25,1,2,NA,1,3,5,Unemployed,4,0,145,61,2,5,2,0,0,1,0,0,TRUE,TRUE,TRUE,TRUE,TRUE,2,1.2533151515148806,0.673469387755102,0.19200580353758606,2,0.5353187499998603,0.5727645161292486,1,0.96875,0.027342140282108088,0.01705230902213674,2,0.7056874999996507,0.7682633333332837,1,0.967741935483871,0.009090897257994847,0.00630842866668411,1.5225,0.4947,0.7162,1.3593,0.5139,0.7482,0.2326,1.558822679,0.61254036997786665,0.6983690996666667,1.2591,3.1265,0.3339,3.414,0.3954,-54.8308,1.0523,2.9575,0.3634,4.4016,0.4364,0.8779,1.4135325145333333,3.6035059906666667,3.4378846206666664,0.38251429026666667,0.32186303936666666,1.1191,3.6369,0.5643,4.3944,0.6392,0.8839,0.076,0.536,0.492,0.013,1.5,115.38461538461539,2.105194763,4.709208247333334,3.705162917,0.4849884725333333,0.49839791343333334,346,1.0251851851851852,1,0,0,1,FALSE,FALSE,FALSE
150,2021-11-13T01:24:48Z,2021-11-13T01:54:28Z,1779,1,2021-11-13T01:54:29Z,0.8999999761581421,Safari,15.1,Macintosh,1440,900,The survey was clear and the activities were very well explained.,1.6,626,101,566,223,77,106,-0.4193188183871753,0.10170920919548118,0.6667501171758583,1.4430977755807517,0.06981781516613529,0.010530084214718316,3,3,2,1,3,1,1,4,1,4,3,2,1,2,3,4,1,1,3,3,1.1285761872936695,0,1,3,2,3,1.5,0,3,4,2,4,2,2,3,2,2,3,3,3,2,4,3,2,3,1,2,2,3,2,1,2,4,0,0,4,5,5,5,4,5,5,5,2,3,4,2,2,3,3,2,4,2,1,3,3,4,1,1,1,3,3,2,2,2,1,5,1,1,2,2,2,2,1,2,2,1.404625563263382,0.7745966692414834,2,0,1.75,0,2.4,0,1.5555555555555556,0,2.6666666666666665,0,1.6666666666666667,0,1.2857142857142858,0,2,0,1.972972972972973,0,1,0,0,-0.1727686180276017,-0.11884288910253611,-0.2989446853297732,-0.20889378721615465,3,2,4,1,2,3,3,3,1,0.9759000729485332,2.2857142857142856,0,2,0.2350737771240448,4,3,3,4,2,2,3,1,1,1,2,0.816496580927726,3,0,3,8,3.8333333333333335,3.2559414990859232,2.0842459175790595,0,1.3450523849998008,2,2,2,3,3,2,3,2,2,3,2,4,3,4,4,2,5,2,4,3,1,2.4,0,4.2,0,3.4,0,3.8,0,3.8,0,1,1,1,4,2,1,2,4,1,1,2,4,1,1,1,4,1,1,1,1,1.2085223687584246,1.15,0,"Hispanic of Latino (e.g., Mexican American, Central American, and others)",0,25,0,1,NA,1,4,4,Student,2,0,139,70,3,5,2,0,0,0,0,0,TRUE,TRUE,TRUE,TRUE,TRUE,4,0.7362571428571362,0.7,0.04532672489796584,4,0.42046874999999634,0.4644999999999982,1,1,0.004616257056451497,0.0021914838709664332,4,0.5536562499999986,0.5792333333333357,1,0.9375,0.006208039314516044,0.011077544354838242,1.3358,0.6816,0.3779,0.9855,0.7481,0.5351,0.2597,1.3737848346666666,0.77024202091,0.3718010791333333,1.5099,5.878,0.292,6.4776,0.348,-102.1861,0.766,5.6175,0.3507,5.8427,0.4055,0.9889,1.3191620596333333,5.454523114333333,5.244492406333333,0.35052475946666667,0.2977336385,0.874,5.5693,0.4844,2.0922,0.4541,0.7064,0.065,0.36,0.333,0.039,1.944,49.84615384615385,1.4213595908666667,3.694983107666667,3.0665331433333334,0.35846252053333333,0.36774261233333333,442,1.3096296296296297,1,0,0,1,FALSE,FALSE,FALSE
151,2021-11-13T01:07:46Z,2021-11-13T01:55:08Z,2842,1,2021-11-13T01:55:09Z,1,Chrome,95.0.4638.69,Windows NT 10.0,1920,1080,Everything OK,1.7777777777777777,1839,71,396,99,76,120,2.6973233739158724,-0.1708329401999867,-0.15167053565071972,-0.06801663464064889,0.05600575552929045,0.24700921886666136,3,4,1,1,2,1,1,3,1,4,4,1,2,2,3,4,1,1,1,3,1.2258187382102494,0,1,3,4,3,1.55,0,2,4,2,3,1,1,4,2,1,1,1,5,2,5,4,1,1,1,1,1,1,1,1,1,3,0,0,5,5,4,5,5,5,5,5,5,2,3,2,1,4,2,5,1,1,1,2,2,5,1,1,1,3,2,1,1,1,1,5,1,2,1,2,1,1,2,2,2,1.7168131661446004,1.505545305418162,1,0,1.75,0,1.7333333333333334,0,1.1111111111111112,0,1.6666666666666667,0,1.3333333333333333,0,1,0,1.3333333333333333,0,1.3783783783783783,0,1,0,0,-1.1646199632997414,-1.0906167216480558,-0.2989446853297732,-0.6947807034889145,4,3,2,1,1,1,2,1,2,1.1547005383792515,2,0,1.5,-0.12035443057343476,4,5,5,5,2,3,2,1,6,3,3,1.3801311186847085,4,0,2,5.5,3.8333333333333335,3.2559414990859232,0.6723373927674386,0,0.081401140643933,2,2,1,1,3,2,2,1,1,2,1,1,2,1,5,1,4,1,3,5,1.4573295865416045,1.8,0,3.8,0,3.2,0,3.4,0,3.466666666666667,0,2,1,1,3,2,2,3,3,1,1,2,4,1,2,2,4,1,2,1,2,0.9733285267845752,1.6,0,"Hispanic of Latino (e.g., Mexican American, Central American, and others)",0,21,0,1,NA,1,3,3,Student,4,0,146,63,4,5,2,1,0,1,0,1,TRUE,TRUE,TRUE,TRUE,TRUE,1,1.5219707317076079,0.8723404255319149,0.16117337215513527,1,0.42459333333373067,0.49615312499925496,1,1,0.0023555413340088024,0.005007572893657382,1,0.535156250005588,0.7139517241428638,1,0.90625,0.005363852863150917,0.011790059193797343,1.8078,1.0981,0.9424,0.9445,1.9788,1.3513,0.8471,1.803739611,1.0009878263666667,0.9011877216666667,5.4181,10.5261,0.1672,8.1874,0.1653,-89.8091,0.7624,6.0464,0.3646,5.169,0.4239,0.9833,1.6932602926,4.690659115666667,5.908052759333334,0.3200181682666667,0.2867465779666667,0.9399,4.6422,0.4447,2.9098,0.5828,0.9785,0.087,0.331,0.451,0.01,2.088,208.8,1.739411642,4.398808926333333,2.1708094847,0.338541174,0.354325034,104,0.3081481481481481,1,0,0,1,FALSE,FALSE,FALSE
153,2021-11-13T01:22:20Z,2021-11-13T01:56:37Z,2056,1,2021-11-13T01:56:38Z,0.8999999761581421,Safari,14.1,Macintosh,1792,1120,NA,1.6,798,186,598,101,88,98,0.022612308633537248,0.8739119658159735,0.820805769472626,-0.04364382157256178,0.22175047117142851,-0.12460084987210628,2,3,2,1,2,1,1,2,1,3,2,1,1,1,1,2,1,1,2,3,0.7451598203705946,0,1,1,3,4,1.95,0,4,4,2,3,2,2,4,1,2,4,2,4,3,4,3,3,4,5,2,2,3,2,4,4,2,2,1,4,2,3,4,4,2,2,3,3,2,4,2,1,3,3,3,5,3,2,2,2,2,3,2,2,3,1,2,3,3,1,4,1,1,1,2,1,2,2,2,2,1.0433544884595018,1.0327955589886444,3.125,0,2,0,2.2666666666666666,0,3,0,2.5,0,2.3333333333333335,0,1.7142857142857142,0,1.3333333333333333,0,2.4054054054054053,0,2,2,1,0.7959675475877719,0.49316168691193807,0.5722650532692125,0.5327133700905753,4,2,3,1,1,1,1,1,1,1.2149857925879117,1.5714285714285714,0,1,-0.5612498234260587,3,3,5,4,2,2,2,6,6,2,2,1.1547005383792515,3.2857142857142856,0,2.7142857142857144,3,3.8333333333333335,3.2559414990859232,-0.7395711320441822,0,-0.22619813465469363,2,2,3,4,3,3,5,2,1,2,1,3,4,4,5,1,3,1,5,2,1.52127765851133,2.8,0,3.8,0,3.8,0,4.4,0,4,0,2,1,3,1,2,3,3,2,3,1,3,1,1,3,1,2,3,2,1,3,0.8870412083230169,2.45,0,"White, Caucasian, Anglo, European American",0,30,1,2,NA,1,3,6,Teacher,2,0,144,64,2,5,2,0,0,0,0,0,TRUE,TRUE,TRUE,TRUE,TRUE,6,1.1206249999999869,0.8163265306122449,0.12007762925169585,6,0.5636451612903226,0.6022580645161328,1,0.96875,0.015039969892473724,0.010495587701613077,6,0.7400625000000054,0.8208965517241359,1,0.9354838709677419,0.018413931451612887,0.017161569892471112,1.5803,0.9692,0.6536,1.2713,0.9587,0.799,0.4388,1.5948853636666667,0.9405701326666667,0.638809419,1.4581,3.3517,0.3461,3.3744,0.3948,-50.117,1.0715,3.1643,0.4071,4.2929,0.4733,0.9764,1.64523671,3.565201561,3.663487767,0.3791776943333333,0.3328706746,1.157,2.5426,0.5422,3.0074,0.6452,0.9067,0.073,0.518,0.332,0.017,1.98,116.4705882352941,2.1587218023333334,3.7330363396666666,2.3087856876,0.44796156206666665,0.3938663374,448,1.3274074074074074,1,0,0,1,FALSE,FALSE,FALSE
154,2021-11-13T01:26:53Z,2021-11-13T01:56:46Z,1792,1,2021-11-13T01:56:48Z,0.8999999761581421,Chrome,94.0.4606.71,Macintosh,1440,900,This was a very interesting survey.,1.6,609,49,339,92,59,404,-0.46299805768573404,-0.3706971830899965,-0.4260821663043371,-0.15332148037895377,-0.17879925829707183,5.044157378948934,2,3,1,1,2,1,1,1,1,2,2,1,2,1,2,2,1,1,2,2,0.6048053188292994,0,1,1,3,2,2.05,0,4,4,3,4,2,2,3,2,2,2,1,4,1,3,3,2,1,1,1,1,1,1,1,0,2,3,2,5,2,4,4,5,5,3,4,5,2,4,2,1,4,2,4,2,1,2,1,3,3,3,1,1,1,1,1,1,1,1,5,1,1,1,2,1,2,3,4,4,1.5007505629691607,1.0465362369445672,1.125,0,3.25,0,2.1333333333333333,0,1.8888888888888888,0,1.8333333333333333,0,1.5,0,0.8571428571428571,0,1.3333333333333333,0,1.6216216216216217,0,0,3,2,-0.9355695467008782,-0.7604652731607284,0.9411689737545899,0.09035185029693071,5,1,2,1,1,2,1,2,1,1.4638501094227998,1.5714285714285714,0,1.5,-0.3767559860388676,5,5,5,5,2,3,1,6,6,2,3,1.7043362064926932,4.285714285714286,0,1.7142857142857142,3,3.8333333333333335,3.2559414990859232,-0.7395711320441822,0,-0.783895116604751,2,3,3,3,2,2,4,2,1,2,1,3,1,3,2,2,4,2,4,2,1.0465362369445672,2.6,0,4,0,3.8,0,3.6,0,3.8,0,3,1,1,3,3,1,1,2,1,3,3,3,1,2,2,3,2,2,1,1,0.8870412083230169,1.85,0,"Asian or Asian American (e.g., Chinese, Japanese, and others)",0,18,1,2,NA,1,3,3,Unemployed,3,0,130,63,3,5,2,0,1,2,0,1,TRUE,TRUE,TRUE,TRUE,TRUE,NA,NA,NA,NA,5,0.4456357142840113,0.5226137930935827,0.9032258064516129,0.90625,0.0026703322798492884,0.007883607731792648,5,0.596506451602905,0.6926099999904632,1,0.9375,0.007057545294279032,0.008518031448605756,NA,NA,NA,NA,NA,NA,NA,NA,NA,NA,0.9821,2.5798,0.297,2.696,0.3731,-50.5067,0.5479,3.9159,0.3918,5.0438,0.4597,0.9875,1.0726003106333333,2.941148322,2.9841660963333334,0.36539692723333334,0.2926915019333333,1.0297,5.6698,0.5071,3.7843,0.557,0.9841,0.076,0.397,0.389,0.013,1.775,136.53846153846155,1.6255709453,4.112001713,3.002827395,0.3988704055,0.44550329316666665,434,1.285925925925926,1,0,0,1,FALSE,FALSE,FALSE
155,2021-11-13T01:36:31Z,2021-11-13T01:57:40Z,1269,1,2021-11-13T01:57:41Z,1,Edge,95.0.1020.44,Windows NT 10.0,1536,864,No,1.7777777777777777,660,56,280,89,69,66,-0.3319603397900577,-0.30710401489772066,-0.7101222752265024,-0.18988069998108442,-0.04067866192862343,-0.6651245862194046,4,3,1,2,3,1,1,2,1,4,3,1,1,1,4,4,1,1,3,2,1.2258187382102494,0,1,1,4,3,1.45,0,4,5,2,4,2,1,4,1,2,1,1,5,3,4,4,2,1,1,1,1,1,1,2,0,2,0,0,5,4,5,5,4,5,5,5,3,1,5,1,1,3,2,5,1,1,1,1,2,5,1,1,1,3,1,1,1,1,1,5,1,1,1,2,1,1,1,1,1,1.7578652081687294,1.505545305418162,1.25,0,1,0,1.6666666666666667,0,1.4444444444444444,0,1.3333333333333333,0,1.1666666666666667,0,0.8571428571428571,0,1.3333333333333333,0,1.2972972972972974,0,0,0,0,-1.0595509648598957,-1.046673960694304,-0.7372407672780129,-0.8919573639861584,5,1,2,1,1,2,1,1,1,1.4638501094227998,1.5714285714285714,0,1,-0.5612498234260587,3,3,4,4,2,2,3,3,3,3,2,0.816496580927726,3,0,3,6,3.8333333333333335,3.2559414990859232,0.9547190977297628,0,0.7802889750751523,2,2,2,3,2,2,3,2,1,1,1,4,3,3,4,3,4,2,3,4,1.1126972805283737,2.2,0,4.2,0,2.6,0,3.6,0,3.466666666666667,0,1,3,2,3,3,2,2,1,1,1,2,3,2,2,1,4,1,1,1,2,0.9119095061289915,1.8,0,"White, Caucasian, Anglo, European American",0,29,1,2,NA,1,3,6,Teacher,4,0,110,62,2,5,2,0,0,0,0,0,TRUE,TRUE,TRUE,TRUE,TRUE,2,0.8640382352979744,0.7555555555555555,0.3726247366387821,2,0.4034968750048429,0.5052133333325386,1,0.967741935483871,0.002340293861043407,0.004879074945883507,2,0.5722624999955297,0.6772413793082895,1,0.90625,0.005585745000405044,0.006373648226414728,1.5694,0.7035,0.4572,1.3047,0.5574,0.5095,0.0198,1.5677731743333334,0.7618866591566666,0.4520347193,0.9942,4.7183,0.2981,4.4226,0.3989,-91.8604,0.7801,6.4013,0.3467,4.8473,0.4203,0.9794,1.1323648986333332,4.418487495,4.955955884333333,0.3874557472,0.29094237793333333,0.6476,4.6307,0.5134,4.2799,0.6131,0.9892,0.071,0.441,0.583,0.008,1.308,163.5,1.8028353533333332,4.097760316333333,2.6153771006666666,0.3520193781,0.37225503406666666,374,1.108148148148148,1,0,0,1,FALSE,FALSE,FALSE
156,2021-11-13T00:59:59Z,2021-11-13T01:57:46Z,3466,1,2021-11-13T01:57:47Z,1,Chrome,95.0.4638.69,Windows NT 10.0,1920,1080,nop,1.7777777777777777,1798,171,1046,233,30,105,2.591979326195819,0.7376408911182396,2.9775849016273725,1.5649618409211874,-0.5793489877655722,-0.006361282546134758,2,3,2,2,3,2,2,1,2,1,2,2,2,3,2,3,2,2,2,3,0.5871429486123998,0,1,1,4,4,2.45,0,4,4,3,3,2,2,2,3,2,3,3,2,2,2,3,2,2,1,1,1,1,1,1,0,2,0,0,5,2,4,3,2,4,3,3,3,4,5,4,1,3,2,3,2,3,2,2,3,4,1,1,1,1,1,1,1,4,1,4,2,1,1,1,1,2,1,1,1,1.300842877595981,0.7237468644557459,1.25,0,1.25,0,2.8,0,2.7777777777777777,0,2.5,0,1,0,1.5714285714285714,0,1,0,2.081081081081081,0,0,0,0,-0.5720308120990136,-0.22279558792264442,-0.6588395645607719,-0.44081757624170814,4,2,2,1,2,2,1,1,1,1,2,0,1,-0.3048482679606258,4,4,4,3,2,2,2,3,3,1,2,1,3.2857142857142856,0,2.7142857142857144,6,3.8333333333333335,3.2559414990859232,0.9547190977297628,0,0.6209469802322789,2,2,1,2,2,2,4,3,3,4,2,3,3,3,3,3,3,2,3,3,0.5936168397046637,1.8,0,3.6,0,3.4,0,3,0,3.3333333333333335,0,2,1,1,2,1,2,2,2,2,3,2,2,2,2,2,2,1,2,2,1,0.5231483637805969,2,0,"White, Caucasian, Anglo, European American",0,22,0,1,NA,1,3,4,student,1,0,153,65,2,5,2,0,1,0,0,1,TRUE,TRUE,TRUE,TRUE,TRUE,2,0.9226147058820899,0.6938775510204082,0.07131090776359057,2,0.590763333333532,0.6632300000006954,0.9375,0.967741935483871,0.0222326682259929,0.01006408051603291,2,0.6875125000011176,0.7304366666659713,1,0.967741935483871,0.00608248177428162,0.006476533913994683,1.2539,0.6695,0.5868,0.9462,0.8952,0.7002,0.3116,1.3181679996666666,0.7689248138333333,0.5741661189333334,1.8968,2.3853,0.2319,4.019,0.4274,-31.8618,1.1276,3.7969,0.4251,3.7339,0.5245,0.9762,1.7870534113333334,2.999574297,2.469910587,0.3699291936,0.2428466171,0.9669,6.3697,0.6148,5.1197,0.6375,0.9977,0.067,0.548,0.486,0.016,1.289,80.5625,2.4628081363333334,4.602815745666667,3.6473693393333333,0.4223412290333333,0.40880349526666665,104,0.3081481481481481,1,0,5,6,FALSE,FALSE,FALSE
157,2021-11-13T01:36:25Z,2021-11-13T02:00:36Z,1450,1,2021-11-13T02:00:37Z,0.8999999761581421,Safari,13.1.2,Macintosh,1440,900,those games hurt my eyes.,1.6,636,141,363,100,60,98,-0.3936251482115524,0.4650987417227717,-0.3105404270817614,-0.05583022810660534,-0.16498719866022699,-0.12460084987210628,1,2,3,2,4,2,1,2,2,2,1,3,2,2,2,2,3,2,2,2,0.7181848464596079,0,1,1,4,2,2.6,0,3,4,3,2,3,3,3,4,3,1,3,3,2,2,2,2,3,1,1,2,4,2,1,1,5,0,0,2,3,3,3,2,4,2,2,2,1,4,3,1,2,3,3,2,2,3,3,4,2,1,1,1,3,1,1,1,1,1,3,3,3,1,1,2,2,4,2,2,0.9863939238321437,0.7988086367179802,2,0,2.5,0,3,0,3.4444444444444446,0,2.5833333333333335,0,1.6666666666666667,0,1.7142857142857142,0,1.3333333333333333,0,2.4324324324324325,0,1,0,0,0.11301905772877759,0.3364583169028547,-0.06374107717804986,0.13635861986240244,5,1,3,1,1,3,1,2,1,1.5735915849388864,1.5714285714285714,0,1.5,-0.3767559860388676,4,4,5,5,2,2,2,6,6,3,3,1.3972762620115438,3.7142857142857144,0,2.2857142857142856,3,3.8333333333333335,3.2559414990859232,-0.7395711320441822,0,-0.465211126919004,4,4,4,3,4,3,4,3,3,4,3,2,2,4,3,2,3,4,3,3,0.7037315505489968,3.8,0,2.6,0,3.8,0,3.2,0,3.2,0,1,1,1,3,4,2,3,3,1,3,1,3,1,2,2,3,2,2,2,3,0.9333020044867296,1.95,0,"White, Caucasian, Anglo, European American",0,22,1,2,NA,1,3,5,surgical technologist,3,0,130,67,1,5,2,0,0,1,0,0,TRUE,TRUE,TRUE,TRUE,TRUE,1,0.9691190476190477,0.84,0.06001889795918397,1,0.4504666666666725,0.5035000000000155,0.9375,0.9375,0.005346458669354541,0.005973770161290237,1,0.598193548387093,0.7194137931034503,0.96875,0.90625,0.013990176411290592,0.025633060483869995,1.4748000000000001,1.1845,0.5688,1.2117,1.176,0.6799,0.1241,1.491820158,1.0884924632666666,0.5587140278333333,1.0182,2.7832,0.2861,3.0974,0.3549,-56.0145,0.6811,4.6677,0.385,4.4487,0.43120000000000003,0.99,1.1164252853,3.317898722,3.1542702283333335,0.34761478603333335,0.28077046196666666,1.122,5.8025,0.4887,1.6295,0.5112,0.8502,0.082,0.368,0.335,0.01,1.408,140.79999999999998,1.467954461,3.2652462613333335,1.9298332136,0.38134011826666664,0.37731438873333334,422,1.2503703703703704,1,0,0,1,FALSE,FALSE,FALSE
158,2021-11-13T01:27:49Z,2021-11-13T02:01:22Z,2013,1,2021-11-13T02:01:23Z,1,Chrome,95.0.4638.69,Windows NT 10.0,1536,864,NA,1.7777777777777777,840,84,616,163,89,169,0.1305257233711531,-0.0527313421286173,0.9074620738895578,0.7119133835381386,0.23556253080827336,1.074686190148462,3,3,1,1,4,1,1,2,1,2,2,1,1,1,3,2,1,1,3,3,0.9880869341680844,0,1,2,4,3,1.65,0,4,4,3,5,2,1,4,1,2,1,1,5,3,4,4,1,2,1,1,1,1,1,2,0,2,0,0,5,3,3,4,2,5,4,3,5,1,5,1,1,3,2,5,2,1,1,3,2,5,1,1,1,1,1,1,1,1,1,5,1,1,1,1,1,1,1,1,1,1.5962606453985038,1.486446705914413,1.25,0,1,0,1.7333333333333334,0,2.2222222222222223,0,1.5833333333333333,0,0.8333333333333334,0,0.8571428571428571,0,1,0,1.4864864864864864,0,0,0,0,-0.9418736866072692,-0.9367202680875601,-0.7372407672780129,-0.8369805176827865,5,2,4,1,1,2,2,3,1,1.5118578920369088,1.5714285714285714,0,2,-0.19226214865167657,4,4,4,5,3,3,2,5,5,4,4,0.9759000729485332,3.857142857142857,0,2.142857142857143,4,3.8333333333333335,3.2559414990859232,-0.1748077221195339,0,-0.2625004193781165,2,2,3,3,3,2,5,2,2,2,1,4,3,3,4,3,4,2,4,4,1.1338934190276817,2.6,0,4.2,0,3.4,0,3.4,0,3.6666666666666665,0,2,1,3,1,3,3,3,1,2,2,1,2,1,1,1,2,3,3,2,3,0.8583950752789521,2.4,0,"Hispanic of Latino (e.g., Mexican American, Central American, and others) & Middle Eastern",1,25,1,2,NA,1,3,5,Part business owner,1,0,150,61,1,5,2,0,0,0,0,0,TRUE,TRUE,TRUE,TRUE,TRUE,2,1.0167709677450119,0.6326530612244898,0.21851093171677444,2,0.7247517241280654,0.7974799999952317,1,1,0.06300930472953271,0.034148466495794824,2,1.1723968750089406,1.9461299999793371,1,1,0.2901456338435035,0.4989787104262279,1.6151,0.3469,0.3398,1.0974,0.6923,0.6303,0.5863,1.5951390373333334,0.493394782319,0.34048096466666666,3.2563,3.1474,0.2074,3.274,0.3002,-12.8461,1.6679,1.9379,0.3586,3.1945,0.5409,0.9725,2.203808302,2.666514852,2.779752831,0.37360621406666666,0.3112858713666667,2.5749,1.5472,0.3706,0.8992,1.0158,0.9078,0.193,0.188,0.183,0.003,1.918,639.3333333333333,3.3972561753333332,2.0594057113333335,1.2009506734333333,0.3230867187,0.4848954966333333,380,1.125925925925926,1,0,0,1,FALSE,FALSE,FALSE
159,2021-11-13T01:24:43Z,2021-11-13T02:01:22Z,2198,1,2021-11-13T02:01:23Z,1,Firefox,91.0,Macintosh,1440,900,n/a,1.6,1382,135,373,87,59,78,1.52312264688991,0.4105903118436781,-0.2623980357390215,-0.21425351304917153,-0.17879925829707183,-0.4624281850891678,3,2,3,3,2,2,3,2,3,2,2,3,3,1,3,3,4,1,2,2,0.7591546545162482,0,0,5,5,5,2.65,0,1,3,3,4,2,1,2,5,4,3,1,1,1,1,1,5,4,1,1,4,5,4,4,1,5,0,0,5,2,4,4,5,5,4,4,4,1,4,1,1,1,4,1,5,5,4,5,4,2,1,1,1,1,1,1,1,1,1,4,1,1,5,5,5,4,4,1,1,1.756156053454272,1.3732131246511903,3.5,0,2.5,0,3.2666666666666666,0,1.8888888888888888,0,3.5,0,1.3333333333333333,0,1,0,5,0,2.4594594594594597,0,1,0,0,1.062842803624979,1.1072956478184441,-0.06374107717804986,0.5217772853201972,3,1,3,4,1,2,3,1,1,1.1338934190276817,2.4285714285714284,0,1,-0.048446712495193056,3,2,4,3,1,1,5,1,1,2,3,1.4960264830861913,2.142857142857143,0,3.857142857142857,8,3.8333333333333335,3.2559414990859232,2.0842459175790595,0,1.8230783695284214,2,3,3,3,3,3,4,2,2,2,1,4,1,4,4,1,4,4,4,3,1.245945806357946,2.8,0,3.6,0,4,0,3.8,0,3.8,0,2,1,3,2,3,3,2,2,3,2,3,2,3,3,1,2,2,3,2,3,0.6708203932499369,2.55,0,"Asian or Asian American (e.g., Chinese, Japanese, and others)",0,28,1,2,NA,1,2,6,Dental Assistant,2,0,134,65,4,5,2,0,0,1,0,0,TRUE,TRUE,TRUE,TRUE,TRUE,NA,NA,NA,NA,3,0.4886875,0.5901935483870968,1,1,0.010076092741935485,0.026387427956989253,3,0.76325,0.8537741935483871,1,0.96875,0.05639509677419355,0.02860787096774193,NA,NA,NA,NA,NA,NA,NA,NA,NA,NA,1.461,4.4508,0.3246,3.4194,0.3766,-63.1795,1.1902,4.5174,0.3542,3.3776,0.4035,0.9619,1.6065430336666666,3.5783917516666666,4.608004836666667,0.3639741677666667,0.3142051992,1.4175,2.9182,0.4928,2.5306,0.5974,0.9304,0.096,0.442,0.288,0.018,1.886,104.77777777777779,1.927788466,2.987619425666667,2.8890404296666667,0.43143555353333335,0.5336049559666667,356,1.0548148148148149,1,0,2,3,FALSE,FALSE,FALSE
160,2021-11-13T01:35:43Z,2021-11-13T02:02:02Z,1579,1,2021-11-13T02:02:04Z,1,Chrome,95.0.4638.69,Windows NT 10.0,1920,1080,nope,1.7777777777777777,715,89,466,80,85,78,-0.19064515382413216,-0.0073076505627059805,0.18532620374845948,-0.29955835878747644,0.18031429226089402,-0.4624281850891678,3,4,2,2,3,1,2,2,1,2,1,1,1,1,2,2,2,1,3,2,0.8522416262267903,0,1,1,3,3,2,0,4,4,1,4,2,1,4,2,2,1,2,4,1,3,1,2,2,1,1,1,3,3,2,0,3,1,1,4,2,2,3,3,5,3,4,2,2,5,2,1,3,2,5,2,2,2,1,2,4,2,1,1,3,2,2,1,1,1,4,2,2,2,1,2,2,2,1,2,1.1867638385156536,1.2983506020002016,1.875,0,1.75,0,2,0,2.888888888888889,0,1.75,0,1.6666666666666667,0,1.4285714285714286,0,1.6666666666666667,0,2,0,0,1,1,-0.2337086371227119,-0.3328460707517538,-0.11895430463408513,-0.22590018769291947,4,2,3,1,1,2,2,1,1,1.0690449676496976,1.8571428571428572,0,1,-0.39031545311577004,5,4,4,5,2,3,2,6,4,3,3,1.2724180205607036,3.857142857142857,0,2.142857142857143,4,3.8333333333333335,3.2559414990859232,-0.1748077221195339,0,-0.2625004193781165,3,3,4,5,4,3,4,3,2,2,1,4,4,3,3,4,4,1,2,3,1.0600988273786194,3.8,0,4.2,0,2.4,0,3.2,0,3.2666666666666666,0,3,1,4,1,3,3,4,2,3,2,2,2,1,4,1,2,3,3,3,4,1.050062654772261,2.85,0,"White, Caucasian, Anglo, European American",0,21,1,3,NA,1,3,3,unemployed,3,0,285,68,1,5,2,0,0,1,0,0,TRUE,TRUE,TRUE,TRUE,TRUE,6,0.8393651162302771,0.8775510204081632,0.03348516066071212,6,0.45966875000298024,0.5148843750208616,1,1,0.0018223048073499816,0.0024970807158889116,6,0.6182125000357628,0.6504354838248222,1,0.96875,0.009610740490152607,0.00733811950286896,1.5131,1.6118,0.5014,1.1334,1.9356,0.6058,0.2719,1.510244354,1.2591559185333334,0.4521112213,3.8824,10.4623,0.2741,9.1314,0.3023,-109.2822,0.7396,6.6809,0.4054,6.3872,0.4621,0.9228,1.5535289576666667,5.452801302666667,6.293189444666667,0.37929218806666665,0.3424276168666667,0.7811,3.4166,0.5346,4.7847,0.5784,0.9652,0.069,0.413,0.341,0.022,1.631,74.13636363636364,1.7831094283333333,3.8652717646666668,3.685614881,0.38643670173333333,0.4223657475,424,1.2562962962962962,1,0,0,1,FALSE,FALSE,FALSE
161,2021-11-13T01:37:57Z,2021-11-13T02:02:04Z,1447,1,2021-11-13T02:02:05Z,1,Chrome,95.0.4638.69,Macintosh,1440,900,none!,1.6,703,71,337,112,52,82,-0.22147755803487953,-0.1708329401999867,-0.43571064457288505,0.09040665030191732,-0.2754836757549857,-0.39486271804575546,2,2,3,2,2,1,2,1,1,3,2,2,3,2,2,2,3,2,2,2,0.6048053188292994,0,1,4,3,2,2.55,0,4,4,2,4,2,2,4,3,2,2,2,3,4,4,2,3,2,1,1,1,2,2,3,0,2,0,0,3,1,2,4,4,5,5,4,4,2,5,1,1,2,2,3,2,2,2,1,1,4,1,1,1,1,1,1,1,1,1,4,1,1,1,1,1,1,1,1,1,1.4099602788688723,0.9611501047232549,1.875,0,1,0,2.4,0,2.4444444444444446,0,1.8333333333333333,0,1,0,1,0,1,0,1.6756756756756757,0,0,0,0,-0.435441114127215,-0.3003245560370831,-0.7372407672780129,-0.5187826616575479,5,1,3,1,1,1,1,2,1,1.5735915849388864,1.2857142857142858,0,1.5,-0.5476903563491562,4,4,4,4,3,3,2,3,7,4,4,0.7867957924694432,3.7142857142857144,0,2.2857142857142856,4,3.8333333333333335,3.2559414990859232,-0.1748077221195339,0,-0.18282942195667984,2,2,2,3,2,2,4,2,2,5,1,4,2,4,5,1,5,1,5,1,1.6676187756655838,2.2,0,4.6,0,4.6,0,4.4,0,4.533333333333333,0,3,2,3,1,4,2,3,2,2,2,3,2,2,4,2,2,3,2,3,3,0.7608859102526822,2.8,0,"White, Caucasian, Anglo, European American",0,24,1,2,NA,1,2,6,writer,2,0,210,66,3,5,2,0,0,1,0,0,TRUE,TRUE,TRUE,TRUE,TRUE,1,0.9807794871635926,0.78,0.12830292320049497,1,0.5061687500029802,0.6172033333539962,1,0.967741935483871,0.00783248156900856,0.014294363286018876,1,0.7782812499776482,0.8674843749776483,1,1,0.024782331898510895,0.024348805883428717,1.4992,0.8935,0.5536,1.2156,0.8095,0.6543,0.0624,1.519351639,0.8952905425,0.5435324032666666,1.3526,4.9015,0.3682,2.8329,0.4046,-62.5544,1.2005,5.2628,0.386,4.1006,0.4634,0.9939,1.5486908355,3.0923021483333333,4.997104441666667,0.38801655506666666,0.35294315156666667,1.3867,2.9121,0.5579,2.9214,0.6316,0.8884,0.102,0.49,0.335,0.024,1.938,80.75,2.8625233056666666,3.7510336406666664,3.9085024406666666,0.3946605461666667,0.5040928235,352,1.0429629629629629,1,0,0,1,FALSE,FALSE,FALSE
162,2021-11-13T01:36:04Z,2021-11-13T02:02:58Z,1613,1,2021-11-13T02:02:59Z,1,Chrome,95.0.4638.69,Windows NT 10.0,1536,864,NA,1.7777777777777777,642,83,460,123,94,88,-0.3782089461061787,-0.06181608044179956,0.15644076894281556,0.2244571221763964,0.30462282899249754,-0.293514517480637,4,3,1,1,3,1,1,3,1,4,4,1,2,1,3,3,1,1,4,4,1.3018205875255096,0,1,1,3,2,1.3,0,2,3,3,3,5,4,2,4,3,4,3,2,3,1,2,3,2,1,2,2,3,4,4,0,3,0,0,3,2,4,3,2,4,1,2,2,4,2,4,2,4,3,4,5,4,4,3,3,4,1,1,1,3,1,3,1,1,1,2,5,4,2,2,3,1,2,1,1,1.244205790071742,1.0327955589886444,2.625,0,1.25,0,3.7333333333333334,0,3.4444444444444446,0,3.3333333333333335,0,1.3333333333333333,0,2.5714285714285716,0,2.3333333333333335,0,2.864864864864865,0,0,0,0,0.7707509879622091,1.106037374927698,-0.6588395645607719,0.22359890518346304,4,2,3,2,2,3,3,3,2,0.7559289460184544,2.4285714285714284,0,2.5,0.5050347996663801,4,3,4,5,3,3,2,8,6,NA,3,0.9759000729485332,3.7142857142857144,0,2.2857142857142856,2,3.8333333333333335,3.2559414990859232,-1.3043345419688306,0,-0.7475928318813282,3,4,4,3,3,4,5,3,3,4,2,3,2,4,4,5,4,3,4,3,0.9154754164341269,3.4,0,3.2,0,3.6,0,3.4,0,3.4,0,2,1,2,3,3,2,3,3,2,1,3,3,2,2,2,3,1,2,1,3,0.7677718959499145,2,0,"White, Caucasian, Anglo, European American & Middle Eastern",1,29,0,1,NA,0,3,5,Social Worker,3,0,234,72,2,5,2,0,0,1,0,0,TRUE,TRUE,TRUE,TRUE,TRUE,3,0.6686911111103164,0.9,0.02123268561714808,3,0.4355656249960885,0.5118937500016764,1,1,0.0020422765221942544,0.0027910902821637958,3,0.5691250000018626,0.6298419354836787,1,0.96875,0.009373683870736917,0.016087007085763348,1.4345,1.8638,0.3709,0.9724,2.0921,0.4957,0.1009,1.3875053496666667,1.4308568277333333,0.36710026366666665,2.8115,8.7004,0.274,8.0243,0.3367,-105.9921,0.7459,6.0951,0.3797,5.7635,0.4502,0.999,1.4751007009666666,5.4028381843333335,5.960260082666666,0.38214987996666666,0.3171689321,1.405,7.9215,0.4858,3.5846,0.4443,0.8931,0.078,0.356,0.347,0.02,1.655,82.75,2.1619712753333333,4.13054376,2.908589015,0.307461507,0.2683864113,396,1.1733333333333333,1,0,1,2,FALSE,FALSE,FALSE
163,2021-11-13T01:41:51Z,2021-11-13T02:03:14Z,1282,1,2021-11-13T02:03:15Z,1,Firefox,94.0,Macintosh,1440,900,No,1.6,672,57,289,77,54,77,-0.3011279355793103,-0.2980192765845384,-0.6667941230180365,-0.3361175783896071,-0.24785955648129604,-0.47931955185002084,2,4,3,3,2,1,1,2,1,2,2,3,3,3,2,3,1,1,2,2,0.8750939799154206,0,1,1,3,2,2.35,0,5,5,3,4,2,2,4,3,2,1,1,5,3,5,5,1,1,1,1,1,1,2,1,0,2,0,0,5,5,5,4,5,5,5,5,5,1,5,1,1,4,2,5,3,1,1,1,3,5,1,1,1,4,2,1,1,1,1,5,1,2,1,3,1,3,1,1,1,1.7971448827876204,1.4960264830861913,1.125,0,1.5,0,1.7333333333333334,0,1.1111111111111112,0,1.5,0,1.5,0,1,0,1.6666666666666667,0,1.3783783783783783,0,0,0,0,-1.0868689044542559,-1.03689814823543,-0.5804383618435307,-0.8086682550394804,5,1,5,1,1,1,1,1,1,1.9518001458970664,1,0,1,-0.9031185640466358,3,3,5,3,2,2,4,3,3,2,2,1.0690449676496976,2.857142857142857,0,3.142857142857143,6,3.8333333333333335,3.2559414990859232,0.9547190977297628,0,0.8599599724965891,2,2,2,3,2,2,4,2,1,3,1,4,2,4,4,1,5,2,4,1,1.3972762620115438,2.2,0,4.4,0,4,0,4.4,0,4.266666666666667,0,2,1,2,4,3,1,3,3,1,1,4,3,2,2,1,3,2,2,1,3,1.0052493799000692,1.9,0,"White, Caucasian, Anglo, European American",0,23,1,2,NA,1,2,6,teacher,2,0,160,68,3,5,2,0,0,0,0,0,TRUE,TRUE,TRUE,TRUE,TRUE,4,0.7727941176470589,0.68,0.06633596571428572,4,0.42525,0.4566,1,0.9375,0.00484967741935484,0.002780286290322581,4,0.54990625,0.6020689655172414,1,0.90625,0.0067779586693548395,0.005355394153225807,1.4267,0.5622,0.3538,1.0501,0.612,0.5225,0.2366,1.4499176783333334,0.6782484859133333,0.3490852165666667,0.9617,4.0539,0.3066,4.1942,0.3529,-86.2127,0.8669,5.4866,0.3445,5.554,0.38,0.9037,1.0574882398666667,4.242285737,4.319282261,0.34625776103333333,0.3011533315666667,0.8689,3.6356,0.4429,4.4629,0.5025,0.9028,0.053,0.424,0.486,0.024,2.009,83.70833333333333,1.3251947146666667,4.252222646333333,2.655445322133333,0.39459208376666666,0.3791605765,434,1.285925925925926,1,0,0,1,FALSE,FALSE,FALSE
164,2021-11-13T01:34:22Z,2021-11-13T02:04:33Z,1811,1,2021-11-13T02:04:34Z,1,Safari,15.0,Macintosh,1440,900,NA,1.6,760,219,458,90,85,119,-0.07502363803382947,1.1737083301509883,0.14681229067426757,-0.17769429344704088,0.18031429226089402,0.2301178521058083,3,3,1,2,2,1,2,2,1,2,3,1,1,1,3,2,2,1,2,1,0.7677718959499145,0,1,1,3,3,2,0,2,4,3,4,2,4,2,4,4,4,4,3,2,2,3,2,5,1,1,2,4,4,3,0,2,0,0,4,4,2,3,4,4,5,4,3,1,5,2,1,3,3,5,4,2,2,5,5,1,1,1,1,1,1,1,1,1,1,4,2,2,1,3,2,1,1,1,1,1.4821257357919053,0.9154754164341269,2.75,0,1,0,3.2666666666666666,0,2.3333333333333335,0,2.5,0,1.5,0,1.2857142857142858,0,2,0,2.081081081081081,0,0,0,0,0.3609818940468122,0.6223766337693353,-0.7372407672780129,-0.05743206675433882,5,2,4,2,2,2,2,1,1,1.2535663410560174,1.8571428571428572,0,1,-0.39031545311577004,4,4,5,4,1,1,3,6,1,2,3,1.5735915849388864,3.142857142857143,0,2.857142857142857,5.5,3.8333333333333335,3.2559414990859232,0.6723373927674386,0,0.5594271251725536,2,2,2,3,3,1,4,2,2,2,2,4,3,4,4,2,4,3,4,3,1.0327955589886444,2.4,0,4,0,3.4,0,3.8,0,3.7333333333333334,0,3,3,4,2,3,4,4,2,3,4,3,2,3,3,1,2,4,4,2,2,0.9119095061289915,3.1,0,"Hispanic of Latino (e.g., Mexican American, Central American, and others)",0,25,1,2,NA,1,3,6,Production Assistant,2,0,93,59,3,5,2,0,0,1,0,0,TRUE,TRUE,TRUE,TRUE,TRUE,2,0.8312750000000008,0.8,0.04497634448979478,2,0.6047187499999909,0.6411666666666687,1,1,0.004809434475807099,0.003403522988505413,2,1.0838437500000109,1.5381249999999926,1,1,0.14963955544354865,0.19321024193549252,1.3192,1.1248,0.4904,1.1576,1.0417,0.552,0.1342,1.3594088793333334,1.0506657521666667,0.48167839273333335,10,10.4479,0.1262,10.8226,0.1792,-83.2177,0.7272,3.6597,0.5294,5.2165,0.5878,0.9857,2.305546484,4.938332085333333,5.510253450333333,0.4128589334666667,0.39891220953333334,1.9443,2.6222,0.6858,1.2294,0.9836,0.9683,0.173,0.481,0.29,0,0.51,Inf,3.8333848146666667,2.9997851383333334,1.8904188162,0.43460046333333335,0.5030464858333333,434,1.285925925925926,1,0,0,1,FALSE,FALSE,FALSE
166,2021-11-13T01:27:19Z,2021-11-13T02:04:45Z,2246,1,2021-11-13T02:04:46Z,0.8999999761581421,Chrome,95.0.4638.69,Windows NT 10.0,1440,900,No,1.6,1501,56,377,89,78,95,1.8288773219798216,-0.30710401489772066,-0.24314107920192551,-0.18988069998108442,0.08362987480298012,-0.1752749501546655,3,2,2,2,3,2,1,3,1,2,3,1,3,1,3,2,1,1,2,2,0.7947194142390263,1,1,2,4,4,2,0,2,5,2,5,2,2,4,3,1,2,1,4,2,3,4,3,4,4,2,2,3,3,2,1,3,0,0,4,4,4,5,3,5,5,5,5,2,5,3,1,3,2,5,5,3,4,4,4,2,1,1,1,2,1,3,2,2,1,3,3,3,1,1,1,1,1,1,1,1.489704406658992,1.3201731488169053,2.875,0,1,0,2,0,1.5555555555555556,0,2.75,0,1.5,0,2.2857142857142856,0,1,0,2.081081081081081,0,1,0,0,0.43873295289229775,0.13174699660068598,-0.5341482934814965,-0.20120064844040525,5,1,5,1,1,1,1,1,1,1.9518001458970664,1,0,1,-0.9031185640466358,5,5,5,5,2,3,1,4,4,5,4,1.7043362064926932,4.285714285714286,0,1.7142857142857142,5,3.8333333333333335,3.2559414990859232,0.38995568780511447,0,-0.21913170668010262,2,4,3,4,4,2,3,4,2,1,1,4,4,2,4,5,4,1,4,4,1.3627702877384937,3.4,0,4.4,0,2.2,0,2.8,0,3.1333333333333333,0,1,1,2,3,2,3,3,3,2,1,1,3,1,3,1,3,2,3,2,3,0.8750939799154206,1.95,0,"White, Caucasian, Anglo, European American",0,21,0,1,NA,1,4,3,None,3,0,190,69,1,5,2,1,0,1,0,1,TRUE,TRUE,TRUE,TRUE,TRUE,6,1.077733333332198,0.84,0.18861045630988643,6,0.489006250000326,0.5694937499994412,1,1,0.007816603185429188,0.007361727056510311,6,0.6590096774207007,0.7149838709689437,1,0.96875,0.0070247269032245475,0.01185622708655509,1.7197,0.9557,0.5023,1.7339,0.9678,0.4962,0.2816,1.6753464323333334,0.9250301161,0.5005623271666667,1.462,4.911,0.3402,4.555,0.409,-80.5276,0.9198,4.9507,0.3881,4.5772,0.4678,0.9776,1.6060953265,4.530932549666667,4.95891717,0.3958527488333333,0.3287947749333333,1.0751,4.3594,0.541,3.4411,0.5777,0.8957,0.084,0.446,0.408,0.019,1.579,83.10526315789474,2.0999687226666666,4.504646717333333,3.3062610106666668,0.4280137733,0.4138152132,304,0.9007407407407407,1,1,5,6,FALSE,FALSE,FALSE
167,2021-11-13T01:41:11Z,2021-11-13T02:05:21Z,1450,1,2021-11-13T02:05:22Z,1,Chrome,94.0.4606.81,Windows NT 10.0,1536,864,NA,1.7777777777777777,599,64,432,102,62,134,-0.4886917278613569,-0.23442610839226255,0.02164207318314386,-0.03145741503851823,-0.1373630793865373,0.4834883535186044,3,3,2,2,3,1,1,3,1,4,2,1,1,1,3,3,1,1,3,3,1.0208355710680808,0,1,1,4,4,1.6,0,1,4,3,4,1,3,2,4,3,3,2,3,1,3,4,3,4,4,3,3,4,4,4,4,2,3,1,5,3,4,5,5,5,5,5,5,1,5,4,4,4,1,5,1,3,1,4,4,1,4,5,5,5,5,5,5,1,1,5,1,1,1,1,1,2,2,2,1,1.7710552325200466,1.0997835284835873,3.625,0,1.75,0,2.7333333333333334,0,1.3333333333333333,0,2.25,0,4.666666666666667,0,2,0,1,0,2.324324324324324,0,2,3,1,1.0565386637185885,0.8737408412514783,0.7004970581449952,0.7871189496982367,5,2,3,2,1,1,1,1,1,1.4638501094227998,1.5714285714285714,0,1,-0.5612498234260587,5,5,5,5,1,1,3,4,3,3,3,1.9023794624226837,3.5714285714285716,0,2.4285714285714284,5.5,3.8333333333333335,3.2559414990859232,0.6723373927674386,0,0.32041413290824317,1,5,1,1,1,1,5,1,1,5,1,5,1,5,5,1,5,1,5,5,2.065591117977289,1.8,0,5,0,5,0,4.2,0,4.733333333333333,0,1,1,2,3,1,1,4,4,3,1,1,3,2,4,2,2,1,2,1,1,1.1239029738980326,1.8,0,"White, Caucasian, Anglo, European American",0,23,1,2,NA,1,3,6,Lead Orthodontic Assistant,4,0,175,66,2,5,2,0,0,3,0,0,TRUE,TRUE,TRUE,TRUE,TRUE,6,0.6686468749999913,0.6530612244897959,0.016916583971082328,6,0.43127096774193246,0.5133964285714485,0.96875,0.875,0.003925098135088127,0.006526112741947177,6,0.5678937499999738,0.6375700000000031,1,0.9375,0.007156120604836141,0.007096260796371351,1.1394,0.5882,0.3412,0.8086,1.0522,0.4994,0.352,1.1980409202,0.73591761546,0.3348059178666667,1.0075,4.1602,0.3206,2.0971,0.3204,-59.2967,0.8272,4.2103,0.3401,3.1591,0.3964,0.9971,1.0924112716333334,2.3908235346666666,4.335563997666666,0.3154038811666667,0.31443233136666665,0.8255,3.3306,0.4801,3.8826,0.5392,0.9963,0.063,0.394,0.374,0.011,1.548,140.72727272727275,1.873750544,3.675524836666667,3.1973379206666666,0.3101781987,0.36780000923333334,354,1.0488888888888888,1,0,0,1,FALSE,FALSE,FALSE
168,2021-11-13T01:33:06Z,2021-11-13T02:05:28Z,1941,1,2021-11-13T02:05:29Z,1,Chrome,95.0.4638.69,Windows NT 10.0,1920,1080,Question about education can be more inclusive. My father only attended elementary school in his home country.,1.7777777777777777,829,79,481,105,64,150,0.10226268617796799,-0.09815503369452862,0.25753979076256933,0.0051018045636124325,-0.10973896011284763,0.7537502216922536,2,1,2,2,1,1,1,1,1,2,1,2,2,2,2,3,2,3,2,2,0.6386663736585051,0,1,2,4,3,2.55,0,4,4,2,4,2,1,3,3,2,2,1,3,2,3,4,3,1,2,1,1,1,2,3,1,3,0,3,4,4,4,3,3,4,3,4,4,2,4,1,2,3,2,5,5,5,3,2,3,3,2,5,1,4,1,1,2,1,1,5,2,1,1,2,2,2,2,2,1,1.3710871160797478,1.0465362369445672,1.75,0,1.75,0,2.1333333333333333,0,2.3333333333333335,0,2.5833333333333335,0,2.5,0,1.1428571428571428,0,1.6666666666666667,0,2.2162162162162162,0,1,0,3,-0.1769713779651954,-0.23634621905375758,0.23040425536776904,-0.002970981842994269,3,3,2,1,2,3,2,4,1,0.7559289460184544,2.5714285714285716,0,2.5,0.5905019848215247,4,4,4,3,2,2,2,3,1,2,2,1,3.2857142857142856,0,2.7142857142857144,7,3.8333333333333335,3.2559414990859232,1.5194825076544112,0,0.903328685194603,2,3,2,2,2,2,4,1,2,3,2,3,2,4,3,3,5,2,3,2,1.0327955589886444,2.2,0,4,0,3.4,0,4,0,3.8,0,2,2,3,3,3,3,3,2,1,1,3,3,2,1,1,3,2,2,1,3,0.8335087534664907,2.1,0,"Hispanic of Latino (e.g., Mexican American, Central American, and others)",0,29,1,2,NA,1,2,6,unemployed,2,0,107,64,2,5,2,0,0,1,0,0,TRUE,TRUE,TRUE,TRUE,TRUE,1,0.947806249999674,0.6530612244897959,0.05547745791660036,1,0.4559781249994412,0.5541656250003725,1,1,0.0029934985383356224,0.00650932684472627,1,0.6134187500005355,0.6303500000004424,1,1,0.0045160312500505655,0.006101745806471811,1.5982,0.4403,0.3896,1.2013,0.4604,0.6286,0.1154,1.589368563,0.56954235741141,0.38644216206666665,10,11.3733,0.0164,9.3195,0.0176,-83.0373,0.8195,6.0708,0.3967,4.8088,0.4738,0.9641,2.1260856746666668,4.842889357,5.102764507333333,0.3393484206,0.2497804787,0.7366,4.8458,0.5443,4.9524,0.5575,0.9413,0.154,0.378,0.651,0.082,1.45,17.68292682926829,2.4365724853333335,5.260406051333334,5.188460740333333,0.38699190633333336,0.4038715062,279,0.8266666666666667,1,0,0,1,FALSE,FALSE,FALSE
169,2021-11-13T01:41:28Z,2021-11-13T02:05:48Z,1460,1,2021-11-13T02:05:49Z,0.8999999761581421,Chrome,95.0.4638.69,Windows NT 10.0,1536,864,n/a,1.7777777777777777,589,71,322,262,63,90,-0.5143853980369797,-0.1708329401999867,-0.5079242315869948,1.9183676304084505,-0.12355101974969247,-0.2597317839589309,3,2,2,3,2,2,3,1,2,2,1,2,1,1,2,1,3,1,2,1,0.7451598203705946,0,1,3,4,2,2.65,0,5,5,4,4,2,1,4,1,1,1,1,5,1,4,5,1,1,1,1,1,1,1,1,1,2,0,0,5,5,3,5,5,5,5,5,4,1,5,1,1,3,2,5,1,1,1,1,1,4,1,1,1,2,1,1,2,2,1,5,2,1,1,1,1,1,1,2,2,1.7419915426128034,1.791514389985135,1,0,1.5,0,1.4666666666666666,0,1.3333333333333333,0,1.25,0,1.1666666666666667,0,1.2857142857142858,0,1,0,1.2972972972972974,0,1,0,0,-1.2150530825508667,-1.2400608249797573,-0.3773458880470143,-0.8087033565133859,5,1,5,1,1,1,1,1,1,1.9518001458970664,1,0,1,-0.9031185640466358,5,5,5,5,3,3,1,7,5,5,4,1.5735915849388864,4.428571428571429,0,1.5714285714285714,3,3.8333333333333335,3.2559414990859232,-0.7395711320441822,0,-0.8635661140261877,2,3,2,1,2,2,3,2,2,2,1,3,2,3,3,3,4,2,3,2,0.7432233529572065,2,0,4,0,3,0,3.6,0,3.533333333333333,0,2,2,3,1,2,2,2,2,1,1,2,2,1,2,1,2,1,3,3,2,0.6708203932499369,2.15,0,"White, Caucasian, Anglo, European American",0,23,1,2,NA,1,4,6,student,7,0,128,67,2,5,2,0,1,1,0,1,TRUE,TRUE,TRUE,TRUE,TRUE,2,0.7542883720935084,0.86,0.030856720771175954,2,0.39719374999776486,0.46944999999925496,1,1,0.0014147696370695577,0.0032442716130782136,2,0.5367718749986962,0.6194724137926924,1,0.90625,0.004813216280131937,0.006529731683443942,1.3663,1.4514,0.4427,0.8807,1.586,0.6169,0.2849,1.3809814036666668,1.2385123892,0.4355034544,10,15.1852,0.0679,10.9178,0.0115,-104.5686,0.7639,7.3454,0.348,5.6902,0.4174,0.9496,1.7865078960666667,4.559433528666666,6.758878585333333,0.27736284056666666,0.27215559986666665,0.7906,5.6757,0.4734,3.1073,0.5139,0.9959,0.058,0.404,0.409,0.019,1.852,97.47368421052633,1.2298902901,3.797554182,3.065780064,0.3727468948,0.4458181009,376,1.114074074074074,1,0,0,1,FALSE,FALSE,FALSE
170,2021-11-13T01:38:56Z,2021-11-13T02:05:51Z,1615,1,2021-11-13T02:05:52Z,1,Chrome,95.0.4638.69,Macintosh,1440,900,NA,1.6,627,76,451,107,57,96,-0.41674945136961294,-0.1254092486340754,0.11311261673434965,0.02947461763169954,-0.2064233775707615,-0.15838358339381242,2,2,2,2,2,2,3,2,1,2,2,2,1,3,2,2,2,1,2,2,0.5104177855340404,0,1,2,4,4,2.45,0,2,3,3,3,3,3,3,4,2,4,5,2,2,3,4,3,5,1,1,4,5,4,4,2,2,0,0,5,3,3,4,5,5,5,5,4,1,5,2,4,4,2,5,4,4,5,5,4,1,1,1,1,1,1,1,2,1,1,4,3,2,1,3,2,2,2,1,1,1.6070415621826906,0.8837151016885368,3.375,0,1.5,0,3.2,0,1.6666666666666667,0,2.9166666666666665,0,1.5,0,1.5714285714285714,0,2,0,2.108108108108108,0,1,0,0,0.7665482280246152,0.8739344216962085,-0.3773458880470143,0.2482942668245971,5,1,3,1,1,1,1,1,1,1.5735915849388864,1.2857142857142858,0,1,-0.7321841937363471,4,4,5,4,2,2,3,5,6,NA,2,1.1338934190276817,3.4285714285714284,0,2.5714285714285716,3.5,3.8333333333333335,3.2559414990859232,-0.4571894270818581,0,-0.16467827959496828,3,3,3,4,3,3,5,2,2,4,2,4,2,5,5,2,3,3,5,2,1.2798809468443688,3.2,0,3.4,0,4.4,0,4.4,0,4.066666666666666,0,3,1,2,2,3,2,4,3,1,4,1,2,3,4,2,2,2,3,4,2,1,2.6,0,"White, Caucasian, Anglo, European American",0,22,1,2,NA,1,3,6,Doctoral student/Graduate assistant,7,0,120,68,3,5,2,0,0,0,0,0,TRUE,TRUE,TRUE,TRUE,TRUE,6,0.6348116279119669,0.86,0.021316455027779346,6,0.42823125000670553,0.4800531250089407,1,1,0.0013409964114432472,0.0021678909567167865,6,0.5410451613049353,0.6488096774239694,1,0.96875,0.004289578559008405,0.006798084153396679,1.1948,1.6504,0.4007,0.8456,1.7695,0.5045,0.2071,1.2258649488333333,1.3240521160666667,0.3931897959333333,9.9916,15.7855,0.1118,12.9819,0.0952,-114.0286,0.733,8.5558,0.3853,9.25,0.4436,0.9979,1.5392908728666668,5.3540666413333335,6.619917787,0.34291010876666667,0.31896634646666666,0.7014,5.3291,0.4818,3.8403,0.5735,0.9977,0.082,0.39,0.535,0.014,1.745,124.64285714285715,2.1087719473333335,5.155134316,3.491257488,0.3412015727666667,0.3594747063666667,474,1.4044444444444446,1,0,0,1,FALSE,FALSE,FALSE
171,2021-11-13T01:46:41Z,2021-11-13T02:05:59Z,1158,1,2021-11-13T02:06:00Z,1,Firefox,93.0,Windows NT 10.0,1536,864,NA,1.7777777777777777,689,48,225,47,41,66,-0.2574486962807515,-0.3797819214031788,-0.9749054276115718,-0.7017097744109136,-0.42741633176027893,-0.6651245862194046,2,2,2,1,2,1,2,2,1,2,2,2,1,1,2,2,2,1,2,2,0.47016234598162726,0,1,1,3,3,2.2,0,3,3,2,3,2,2,3,2,2,2,2,3,2,3,3,3,2,2,1,3,2,2,3,1,2,0,0,4,2,4,4,4,4,4,4,4,1,4,1,1,4,1,4,2,2,3,2,2,4,1,5,1,2,2,1,2,1,1,3,3,2,1,1,1,2,2,2,1,1.3254270092150517,0.5163977794943222,2.25,0,1.75,0,2.466666666666667,0,2.2222222222222223,0,1.75,0,2,0,1.7142857142857142,0,1,0,1.8918918918918919,0,1,0,0,-0.0676996195877562,-0.01760031650865043,-0.2989446853297732,-0.1582725009192118,4,1,3,1,1,1,1,1,1,1.2535663410560174,1.4285714285714286,0,1,-0.6467170085812028,3,3,3,3,1,1,3,4,5,NA,3,0.9759000729485332,2.4285714285714284,0,3.5714285714285716,4.5,3.8333333333333335,3.2559414990859232,0.10757398284279028,0,0.6754004073174131,2,4,2,3,2,2,3,2,2,3,3,4,3,2,3,3,4,2,3,3,0.6761234037828132,2.6,0,3.8,0,3,0,3.2,0,3.3333333333333335,0,1,1,1,3,1,1,1,3,1,2,2,3,1,2,1,3,1,2,1,2,0.812727700887249,1.45,0,"White, Caucasian, Anglo, European American",0,27,1,3,NA,1,3,6,unemployed,7,0,130,63,2,5,2,0,0,0,0,0,TRUE,TRUE,TRUE,TRUE,TRUE,2,0.8794285714285714,0.7,0.05786229591836735,2,0.6719032258064516,0.686741935483871,1,1,0.056885490322580654,0.014822064516129031,2,0.698875,0.815516129032258,1,0.96875,0.009014887096774196,0.00668195060483871,1.3124,0.6772,0.5183,1.1625,0.4992,0.596,0.0676,1.3620545906666666,0.7667997372766666,0.5088960664666666,3.0904,3.4501,0.224,4.322,0.3292,-31.7234,1.1334,2.7693,0.4439,2.8685,0.5182,0.8742,2.2467151206666665,3.5601090766666665,3.060475713333333,0.36915560643333334,0.2927020006666667,0.5909,3.5415,0.6554,5.7205,0.769,0.8016,0.234,0.373,0.736,0.009,1.466,162.88888888888889,2.5591349996666666,4.367249377,3.522190369,0.4068503761,0.4677614815,409,1.211851851851852,1,0,0,1,FALSE,FALSE,FALSE
172,2021-11-13T01:17:21Z,2021-11-13T02:06:12Z,2930,1,2021-11-13T02:06:13Z,1,Chrome,95.0.4638.69,Macintosh,1280,800,NA,1.6,785,89,599,338,127,277,-0.010789462594772418,-0.0073076505627059805,0.8256200086069,2.8445345269957607,0.7604207970083773,2.898953800320594,4,4,2,1,2,1,1,3,1,3,2,1,1,1,3,3,2,1,3,4,1.1367080817685316,0,1,4,4,3,1.55,0,3,5,5,4,4,3,2,2,2,2,3,4,1,3,2,4,3,5,2,2,2,3,3,0,2,2,3,3,4,5,5,3,3,2,4,3,3,4,1,2,5,2,5,2,1,1,3,3,3,2,1,1,2,1,2,3,1,1,5,1,1,2,3,1,2,2,2,1,1.3661501990507363,1.1952286093343936,3,0,1.75,0,2.7333333333333334,0,2.4444444444444446,0,1.8333333333333333,0,1.5,0,1.2857142857142858,0,2,0,1.8918918918918919,0,0,2,3,0.3988067334851569,0.4193107472473732,0.4405781967573001,0.42994447200233665,4,2,5,1,1,2,1,1,1,1.6035674514745464,1.4285714285714286,0,1,-0.6467170085812028,4,4,4,4,2,2,1,6,6,6,4,1.2909944487358056,3.5714285714285716,0,2.4285714285714284,3,3.8333333333333335,3.2559414990859232,-0.7395711320441822,0,-0.3855401294975673,3,3,2,2,2,2,5,1,1,1,1,4,1,5,5,1,4,1,5,1,1.8464895909600492,2.4,0,4.4,0,4.2,0,5,0,4.533333333333333,0,1,2,3,3,3,2,4,3,2,2,4,3,2,2,1,3,2,3,2,2,0.8255779474818965,2.25,0,"Asian or Asian American (e.g., Chinese, Japanese, and others) & White, Caucasian, Anglo, European American",1,20,1,2,NA,1,3,4,server,5,0,122,68,2,5,2,1,1,1,0,2,TRUE,TRUE,TRUE,TRUE,TRUE,6,1.0423204545405778,0.88,0.10529103774974533,6,0.4624777777857251,0.5163896551872121,0.8709677419354839,0.90625,0.004929835978674469,0.007165697419988492,6,0.6500624999888241,0.7762000000035322,1,0.8709677419354839,0.008073775323560527,0.013753671979773695,1.6111,1.261,0.5715,1.4824,1.46,0.6358,0.4651,1.589481033,1.1318172535333333,0.5634264905,0.9652,2.1778,0.295,2.5264,0.3484,-43.0573,0.6673,2.9412,0.3825,5.4019,0.4457,0.9853,1.0408481818,2.7827074321,2.5676070715333332,0.3426645788666667,0.29016789983333335,0.9861,3.7201,0.5283,2.3917,0.6179,0.9063,0.072,0.471,0.401,0.009,1.677,186.33333333333334,1.583397109,3.824841381666667,2.0229199260333335,0.44119813546666664,0.4421738137,387,1.1466666666666667,1,0,0,1,FALSE,FALSE,FALSE
173,2021-11-13T01:38:14Z,2021-11-13T02:06:52Z,1717,1,2021-11-13T02:06:53Z,0.8999999761581421,Safari,14.1.2,Macintosh,1440,900,no,1.6,687,162,495,119,102,88,-0.26258743031587606,0.6558782462995992,0.32493913864240515,0.17571149604022218,0.4151193060872563,-0.293514517480637,2,3,2,2,3,1,1,2,1,3,3,1,1,1,2,2,1,1,3,3,0.8522416262267903,0,1,1,3,2,1.8,0,4,4,1,4,1,1,4,1,1,1,1,5,1,4,3,1,2,1,1,1,1,1,1,0,2,0,0,4,2,3,4,2,5,3,3,3,1,5,1,1,4,1,5,1,1,1,1,1,4,1,1,1,2,1,1,1,1,1,5,2,1,1,1,1,1,1,1,1,1.460182225659569,1.5946338585572373,1.125,0,1,0,1.4666666666666666,0,2.7777777777777777,0,1.0833333333333333,0,1.1666666666666667,0,1,0,1,0,1.5405405405405406,0,0,0,0,-0.9860026659520043,-1.0818088114128326,-0.7372407672780129,-0.9095247893454228,5,1,3,1,1,2,1,1,1,1.5275252316519468,1.4285714285714286,0,1,-0.6467170085812028,4,4,5,4,1,1,1,5,3,3,3,1.7728105208558367,3.4285714285714284,0,2.5714285714285716,5,3.8333333333333335,3.2559414990859232,0.38995568780511447,0,0.25889427784851804,2,2,2,2,2,2,3,2,1,1,1,4,2,3,4,1,3,2,3,3,1.0465362369445672,2,0,4,0,3.2,0,3.8,0,3.6666666666666665,0,1,1,1,3,1,1,1,4,1,1,1,4,1,1,1,4,1,1,1,1,1.145931016569864,1.05,0,"White, Caucasian, Anglo, European American",0,25,1,2,NA,1,3,6,Recreational Therapist,4,0,135,68,3,5,2,0,0,0,0,0,TRUE,TRUE,TRUE,TRUE,TRUE,NA,NA,NA,NA,4,0.44187096774192797,0.5146999999999845,1,0.967741935483871,0.0029858494623658644,0.008129361290322419,4,0.6451874999999996,0.8263124999999972,1,1,0.023220092741935528,0.06683370564516204,NA,NA,NA,NA,NA,NA,NA,NA,NA,NA,1.8225,5.921,0.288,3.6045,0.2723,-67.112,0.6167,5.1457,0.3869,4.166,0.459,0.9401,1.6624947656666667,3.4801877126666665,5.3505882756666665,0.2830794844,0.2897469399,1.5099,4.8612,0.4662,2.2804,0.4977,0.8944,0.091,0.386,0.324,0.013,1.685,129.6153846153846,2.2076480216666665,4.014908939333333,2.751510669,0.3698374146,0.4201192978,436,1.2918518518518518,1,0,0,1,FALSE,FALSE,FALSE
174,2021-11-13T01:50:39Z,2021-11-13T02:07:04Z,984,1,2021-11-13T02:07:04Z,1,Chrome,95.0.4638.54,Macintosh,1440,900,NA,1.6,550,44,198,59,36,63,-0.6145907117219087,-0.4161208746559078,-1.1048898842369694,-0.555472896002391,-0.49647662994450314,-0.7157986865019639,3,3,1,2,2,1,1,2,2,2,1,1,1,4,3,2,1,1,1,2,0.8944271909999159,0,1,1,3,2,2.2,0,5,5,2,5,1,1,5,1,1,1,1,5,2,5,3,1,1,1,1,1,1,1,1,1,2,0,0,5,5,2,5,5,5,5,5,5,1,5,1,1,3,1,5,1,1,1,3,4,5,1,1,1,1,1,1,1,5,1,5,1,1,1,1,1,1,1,1,2,1.8907868930884504,1.88477610139267,1,0,1.25,0,1.2666666666666666,0,1.3333333333333333,0,1.5833333333333333,0,0.8333333333333334,0,1.4285714285714286,0,1,0,1.3783783783783783,0,1,0,0,-1.1646199632997414,-1.2911660623885257,-0.4557470907642554,-0.8734565765763905,5,1,3,1,1,1,1,1,1,1.5735915849388864,1.2857142857142858,0,1,-0.7321841937363471,5,5,5,5,5,5,1,6,6,4,4,1.5118578920369088,5,0,1,3,3.8333333333333335,3.2559414990859232,-0.7395711320441822,0,-1.1822501037119346,4,4,4,3,4,2,4,1,2,3,1,4,1,4,4,1,5,2,2,2,1.3557637102737474,3.8,0,4.4,0,3.8,0,4.2,0,4.133333333333334,0,2,4,1,1,4,1,2,2,3,4,3,3,3,3,1,2,1,3,3,3,1.050062654772261,2.65,0,"White, Caucasian, Anglo, European American",0,21,1,2,NA,1,4,4,Student,4,0,125,65,3,5,2,0,0,1,0,0,TRUE,TRUE,TRUE,TRUE,TRUE,2,0.6263866666654746,0.6122448979591837,0.01607146540847145,2,0.3946068965504909,0.5155233333339294,0.9666666666666667,0.9375,0.002748907172302382,0.013489510957846377,2,0.5868687500003725,0.7297500000006208,1,0.7741935483870968,0.009642124153257343,0.025413815612422348,0.9362,0.5032,0.4333,0.7884,0.2776,0.495,0.1875,1.0045236978333334,0.7230084607526667,0.4258671517,1.2559,3.7745,0.235,2.6997,0.3021,-51.5712,1.0569,6.5989,0.3167,4.4686,0.3801,0.837,1.3260669884333334,2.907714847333333,4.022243835666667,0.29844489696666665,0.2327051367,1.0557,4.2022,0.4679,1.8899,0.5025,0.8511,0.068,0.407,0.408,0.009,1.779,197.66666666666669,1.2733486467666666,3.5049459086666666,1.3571332772135,0.40089159686666664,0.378867629,376,1.114074074074074,1,0,0,1,FALSE,FALSE,FALSE
176,2021-11-13T01:49:13Z,2021-11-13T02:07:42Z,1109,1,2021-11-13T02:07:44Z,1,Chrome,95.0.4638.69,Macintosh,1440,900,Enjoyed the study!,1.6,612,53,246,57,34,71,-0.4552899566330472,-0.33435822983726743,-0.873806405791818,-0.5798457090704782,-0.5241007492181928,-0.5806677524151392,2,2,3,2,1,2,2,2,1,2,2,3,3,2,1,1,2,1,2,1,0.6708203932499369,0,1,1,5,5,2.75,0,3,4,2,4,2,2,4,2,2,2,2,4,2,3,3,1,2,1,1,1,1,3,1,0,2,0,0,4,3,4,4,4,4,4,4,5,1,4,2,1,4,2,5,3,2,1,1,1,3,1,1,1,1,1,1,1,1,1,4,2,2,1,1,1,1,1,1,1,1.4347677716475786,0.8837151016885368,1.375,0,1,0,2.2,0,2,0,1.5833333333333333,0,1.1666666666666667,0,1.2857142857142858,0,1,0,1.5675675675675675,0,0,0,0,-0.8136895085106579,-0.6476078738830316,-0.7372407672780129,-0.6924243205805223,5,1,4,1,1,1,1,2,1,1.7320508075688772,1.1428571428571428,0,1.5,-0.6331575415043005,5,5,5,5,3,3,1,7,7,5,3,1.5735915849388864,4.428571428571429,0,1.5714285714285714,2,3.8333333333333335,3.2559414990859232,-1.3043345419688306,0,-1.145947818988512,2,2,2,3,2,2,4,2,2,3,1,3,3,4,4,2,4,2,4,2,1.01418510567422,2.2,0,4,0,3.6,0,4,0,3.8666666666666667,0,1,1,1,3,1,1,1,3,1,1,2,3,1,1,1,3,1,1,1,1,0.8255779474818965,1.25,0,"White, Caucasian, Anglo, European American",0,21,1,2,NA,1,4,4,Merchandiser,2,0,200,68,1,5,2,0,0,1,0,0,TRUE,TRUE,TRUE,TRUE,TRUE,2,0.6681424999937415,0.8,0.02056705748561951,2,0.5056687499973923,0.6218531249947846,1,1,0.004000275120042123,0.005678926440877102,2,0.5954312500059604,0.6905124999955297,1,1,0.005516413185036105,0.007539125645386365,1.1966,1.2836,0.4023,0.961,1.2502,0.4811,0.0636,1.2417641254333334,1.1373463572,0.3950521540333333,2.1521,6.2992,0.3348,6.0336,0.4435,-88.2227,1.0298,4.4914,0.3988,4.2672,0.5058,0.966,1.8397682789333334,5.054382598666667,5.458773166,0.4454659084,0.34081709573333335,0.8984,3.3408,0.4888,3.2563,0.5763,0.9536,0.171,0.33,0.662,0.011,1.377,125.18181818181819,2.307496436,5.289788841,4.651075716,0.3826777285333333,0.4493778583333333,438,1.2977777777777777,1,0,0,1,FALSE,FALSE,FALSE
180,2021-11-13T01:47:16Z,2021-11-13T02:08:45Z,1289,1,2021-11-13T02:08:47Z,1,Chrome,95.0.4638.69,Macintosh,1440,900,NA,1.6,697,50,333,63,34,80,-0.23689376014025323,-0.36161244477681426,-0.454967601109981,-0.5067272698662169,-0.5241007492181928,-0.4286454515674616,3,3,2,2,3,1,1,3,1,2,2,2,2,2,2,2,2,2,2,2,0.6048053188292994,0,1,1,2,1,2.15,0,3,4,3,3,3,1,3,1,1,1,1,2,1,1,1,2,1,1,1,1,1,1,1,0,2,0,0,5,5,3,5,5,5,5,5,5,1,5,1,1,5,1,5,1,1,1,1,1,5,1,1,1,1,1,1,1,1,1,5,1,1,1,1,1,1,1,1,1,1.9234603452371197,1.0997835284835873,1.125,0,1,0,2.466666666666667,0,1.2222222222222223,0,1,0,0.8333333333333334,0,0.8571428571428571,0,1,0,1.054054054054054,0,0,0,0,-1.2886013814587587,-0.8611271044204237,-0.7372407672780129,-0.7991839358492183,3,2,2,2,1,4,1,1,1,1.0690449676496976,2.4285714285714284,0,1,-0.048446712495193056,5,5,5,5,3,3,2,3,1,2,2,1.2909944487358056,4.285714285714286,0,1.7142857142857142,7,3.8333333333333335,3.2559414990859232,1.5194825076544112,0,0.3456317032445457,2,3,2,4,2,1,5,3,1,3,1,4,5,3,5,4,3,3,3,3,1.3557637102737474,2.6,0,4,0,2.8,0,3.8,0,3.533333333333333,0,3,3,3,3,3,3,3,3,2,1,4,2,1,3,3,3,3,3,3,3,0.7163503994113789,2.65,0,"Asian or Asian American (e.g., Chinese, Japanese, and others)",0,19,1,2,NA,1,2,3,student,3,0,165,65,2,5,2,0,0,0,0,0,TRUE,TRUE,TRUE,TRUE,TRUE,NA,NA,NA,NA,5,0.6456483870967734,0.8034966666666713,1,1,0.021932291247308597,0.028848581022992707,5,1.1086066666666652,1.3220677419355018,1,1,0.28486076064368604,0.44179980625804166,NA,NA,NA,NA,NA,NA,NA,NA,NA,NA,4.1343,4.3174,0.1668,4.4584,0.3398,-31.3506,1.0907,2.6765,0.4879,3.5835,0.6559,0.9811,2.347563487,3.286142799,3.4047373733333335,0.4416332696,0.2921227416,2.2183,1.6219,0.4506,1.4085,0.5453,0.9164,0.223,0.141,0.24,0.014,1.938,138.42857142857142,2.7986626236666665,1.9127116923333334,1.6470120038666667,0.34717455313333334,0.44651629493333334,348,1.031111111111111,1,0,0,1,FALSE,FALSE,FALSE
181,2021-11-13T01:40:06Z,2021-11-13T02:09:32Z,1766,1,2021-11-13T02:09:33Z,1,Chrome,95.0.4638.54,Macintosh,1440,900,"No feedback on the study itself but I was impressed by how thorough and thoughtful the options for the demographics were (e.g., sex as assigned at birth and gender being two separate questions).",1.6,689,104,533,130,110,105,-0.2574486962807515,0.12896342413502795,0.5078802257448167,0.3097619679147013,0.525615783182015,-0.006361282546134758,4,4,1,1,3,1,1,2,1,3,3,2,1,2,4,3,1,1,3,3,1.1516578439248717,0,1,2,2,4,1.5,0,3,4,3,3,5,1,4,1,2,1,2,3,3,3,3,3,4,4,1,2,3,3,2,3,2,1,1,4,3,4,3,3,5,4,4,4,3,4,3,1,3,2,5,5,4,5,5,5,1,1,5,1,3,2,1,2,2,1,3,3,3,1,1,2,1,2,2,1,1.4142135623730951,1.162919151265879,2.75,0,1.5,0,2.466666666666667,0,2.2222222222222223,0,3.25,0,2.6666666666666665,0,2,0,1.3333333333333333,0,2.5675675675675675,0,2,1,1,0.6635806095535669,0.487644644237128,0.20882944024170652,0.34823704223941726,5,1,4,1,1,1,1,3,3,1.7320508075688772,1.1428571428571428,0,3,-0.07967602934272733,5,5,5,5,2,1,1,4,3,NA,3,1.9880595947760098,4,0,2,5.5,3.8333333333333335,3.2559414990859232,0.6723373927674386,0,0.081401140643933,4,4,3,3,3,2,4,3,3,3,2,4,3,3,4,3,3,1,3,4,0.8451542547285166,3.4,0,4,0,3.2,0,3,0,3.4,0,2,1,2,4,3,2,4,2,1,1,2,2,3,1,1,2,2,2,1,4,1.0208355710680808,2.1,0,"White, Caucasian, Anglo, European American",0,28,1,2,NA,1,2,7,mental health case manager,2,0,175,64,3,5,2,0,0,1,0,0,TRUE,TRUE,TRUE,TRUE,TRUE,5,1.114410869565185,0.92,0.08661973546539325,5,0.5240750000000698,0.5969933333331098,1,0.9375,0.004434135483824624,0.003499232862944885,5,0.6883249999994878,0.7616687500003027,1,1,0.0053695045161447534,0.004019404798359218,1.8229,1.4714,0.6043,1.3586,1.5713,0.7845,0.3555,1.7022201623333333,1.2350502519,0.601393587,1.1209,4.3752,0.396,3.7964,0.4624,-78.9796,0.7734,5.0484,0.4522,5.4502,0.524,0.9926,1.3248024205333333,3.926045986666667,4.740625349,0.4440938817333333,0.38496351976666665,0.7764,3.5827,0.6024,4.9546,0.6847,0.9909,0.178,0.445,0.761,0.012,1.367,113.91666666666666,2.4057293003333333,5.457407475,5.661399059,0.4740651359333333,0.5589802547,434,1.285925925925926,1,0,0,1,FALSE,FALSE,FALSE
182,2021-11-13T01:42:04Z,2021-11-13T02:09:56Z,1672,1,2021-11-13T02:09:57Z,0.8999999761581421,Chrome,95.0.4638.69,Macintosh,1440,900,None,1.6,726,55,556,111,68,85,-0.16238211663094707,-0.31618875321090295,0.6186077258331184,0.07822024376787376,-0.054490721565468275,-0.34418861776319626,3,3,2,2,3,1,1,3,1,3,2,1,1,1,3,3,1,1,2,2,0.8870412083230169,0,1,1,3,4,1.75,0,3,4,3,4,4,3,2,4,3,3,3,3,2,3,3,3,4,5,3,1,3,3,2,6,1,1,5,5,2,3,4,4,5,3,5,4,4,4,2,3,3,3,5,3,3,3,2,4,1,5,4,1,3,2,5,5,1,1,4,3,3,1,1,2,2,3,3,1,1.3367074424820065,0.6399404734221844,3,0,2.25,0,3,0,2.111111111111111,0,2.75,0,3.1666666666666665,0,2.7142857142857144,0,1.3333333333333333,0,2.5945945945945947,0,3,1,5,0.8358937669949132,0.8358958643067274,1.3529241097866693,1.0944099870466983,5,1,5,1,1,2,1,2,1,1.889822365046136,1.1428571428571428,0,1.5,-0.6331575415043005,5,5,5,5,4,4,1,7,6,4,4,1.4638501094227998,4.714285714285714,0,1.2857142857142858,2.5,3.8333333333333335,3.2559414990859232,-1.0219528370065065,0,-1.1640989613502233,1,1,1,3,2,2,5,2,1,2,2,3,2,4,5,1,5,2,4,3,1.4074631010979937,1.6,0,4,0,4,0,4.2,0,4.066666666666666,0,1,2,1,2,3,2,3,3,1,1,3,3,2,2,2,3,1,2,2,2,0.7591546545162482,1.95,0,"White, Caucasian, Anglo, European American",0,21,1,2,NA,1,2,5,Teacher,2,0,130,70,1,5,2,0,0,0,0,0,TRUE,TRUE,TRUE,TRUE,TRUE,1,0.6913027777738041,0.72,0.027330334701464655,1,0.4665656250417233,0.5497096773962821,1,0.96875,0.0016238932966311133,0.004131696776416996,1,0.7097749999836087,0.8333166666507721,1,0.9375,0.006311644519133184,0.019114304149505094,1.222,0.8283,0.408,0.7515,0.8543,0.5959,0.3419,1.2742902415666666,0.87161867239,0.4007340308,1.586,6.6839,0.3479,4.289,0.3721,-87.6548,0.7435,6.011,0.4084,5.1269,0.4786,0.9617,1.5513112781,4.093463449,5.998154950333333,0.3690876475666667,0.3424686526,1.0181,4.5213,0.5998,2.6408,0.6644,0.9046,0.071,0.548,0.431,0.013,1.661,127.76923076923077,2.262594899333333,4.845393089666667,2.3369522127,0.4793455056,0.3821713078333333,104,0.3081481481481481,1,0,0,1,FALSE,FALSE,FALSE
183,2021-11-13T01:39:50Z,2021-11-13T02:10:52Z,1861,1,2021-11-13T02:10:53Z,1,Chrome,95.0.4638.69,Macintosh,1280,800,NA,1.6,694,93,630,152,113,110,-0.24460186119294008,0.029031302690023072,0.9748614217693936,0.5778629116636594,0.5670519620925495,0.07809555125813061,3,2,1,2,2,1,1,2,1,3,3,1,1,2,2,3,1,1,1,2,0.7863975156570492,0,1,1,2,2,1.95,0,2,4,1,4,2,1,5,1,2,1,1,5,4,4,3,1,3,5,1,2,2,2,1,3,2,0,1,5,3,1,5,5,5,5,5,5,2,5,1,1,3,4,4,3,2,3,3,2,2,1,1,1,3,2,2,1,2,1,4,2,1,1,1,1,2,3,1,2,1.5494840757171082,1.5430334996209192,2.125,0,2,0,1.8666666666666667,0,1.6666666666666667,0,2.25,0,1.8333333333333333,0,1.4285714285714286,0,1,0,1.837837837837838,0,2,0,1,-0.1790727579339924,-0.3523976956695021,0.15899863808316506,-0.09669952879316851,4,1,3,1,1,1,1,1,1,1.2535663410560174,1.4285714285714286,0,1,-0.6467170085812028,5,5,5,5,3,3,2,5,6,4,3,1.2909944487358056,4.285714285714286,0,1.7142857142857142,3.5,3.8333333333333335,3.2559414990859232,-0.4571894270818581,0,-0.6427042641235889,2,5,3,4,4,3,4,5,4,4,1,4,3,3,1,5,3,1,3,2,1.3345232785352157,3.6,0,4,0,3,0,2.2,0,3.066666666666667,0,2,1,1,3,2,1,2,2,1,2,2,2,1,1,1,2,1,1,1,2,0.6048053188292994,1.65,0,"White, Caucasian, Anglo, European American",0,21,1,2,NA,1,2,5,Bank Teller,2,0,130,69,2,5,2,0,0,0,0,0,TRUE,TRUE,TRUE,TRUE,TRUE,2,1.0574736842230748,0.76,0.1159144036526479,2,0.5182290322549882,0.5944156250059605,0.96875,1,0.013054311766039344,0.005167915554828913,2,0.6199645161128813,0.7486290322465281,0.96875,0.96875,0.009423737417432262,0.013856429513022612,1.5758,0.7615,0.5164,1.4607,0.7711,0.5869,0.1412,1.58002838,0.8012297591,0.5083085296333333,1.3568,3.1443,0.3108,4.6774,0.4494,-65.71,1.1246,3.5813,0.3542,4.6647,0.4754,0.9616,1.5205615204333334,4.657019440666667,3.460279372,0.4351517966333333,0.29961600006666667,1.0032,3.2657,0.488,3.2212,0.6171,0.9551,0.342,0.121,0.691,0.012,1.783,148.58333333333331,1.8589217993333333,3.752007477333333,2.6722826898666665,0.3863616632,0.4205542124666667,378,1.12,1,0,0,1,FALSE,FALSE,FALSE
184,2021-11-13T01:48:30Z,2021-11-13T02:11:02Z,1352,1,2021-11-13T02:11:03Z,1,Chrome,95.0.4638.69,Macintosh,1440,900,NA,1.6,664,56,331,93,62,89,-0.3216828717198085,-0.30710401489772066,-0.464596079378529,-0.14113507384491022,-0.1373630793865373,-0.27662315071978394,3,2,4,4,2,3,3,2,3,2,2,3,4,4,2,2,3,3,2,2,0.7863975156570492,0,1,1,4,4,3.15,0,3,5,4,3,3,3,3,4,4,3,4,3,3,3,3,2,2,1,1,2,3,3,3,1,2,0,0,4,2,4,4,3,3,4,4,2,3,5,2,1,3,2,5,3,1,1,1,2,4,1,1,1,3,1,1,2,1,1,4,2,3,1,2,2,2,1,1,1,1.2793110007486985,0.6324555320336759,2.125,0,1.25,0,3.1333333333333333,0,2.6666666666666665,0,1.75,0,1.3333333333333333,0,1.5714285714285714,0,1.6666666666666667,0,1.9189189189189189,0,1,0,0,-0.12863963868286635,0.22679499496320607,-0.4557470907642554,-0.11447604790052467,4,2,2,2,1,3,1,1,1,1.0690449676496976,2.142857142857143,0,1,-0.21938108280548152,5,5,5,5,3,3,1,7,7,4,3,1.5735915849388864,4.428571428571429,0,1.5714285714285714,2,3.8333333333333335,3.2559414990859232,-1.3043345419688306,0,-1.145947818988512,1,3,2,3,3,2,3,2,2,3,2,3,2,4,5,4,4,2,3,3,0.9611501047232549,2.4,0,3.8,0,3,0,4,0,3.6,0,2,1,3,1,2,3,4,2,1,2,3,2,4,3,2,2,1,4,3,3,0.99472291830968,2.7,0,"White, Caucasian, Anglo, European American",0,22,1,2,NA,1,3,6,graduate student,6,0,175,63,3,5,2,0,0,0,0,0,TRUE,TRUE,TRUE,TRUE,TRUE,6,0.8466153846161488,0.78,0.08406272392156584,6,0.45199687500158325,0.5267689655166248,1,0.9354838709677419,0.00718073644141256,0.004871731828062409,6,0.5854999999995344,0.6496066666682562,1,0.9375,0.008366613548502096,0.006762336764138204,1.6054,0.8659,0.3391,1.3142,1.1054,0.48,0.2925,1.5851213773333332,0.8703678338666667,0.33711464713333333,1.0896,3.9986,0.3157,3.4947,0.3845,-71.8907,0.9317,4.8496,0.3535,5.2312,0.4318,0.9927,1.2204644992666667,3.6759440586666665,4.305604317333334,0.37443451533333333,0.3086983016,0.8149,3.1772,0.4926,4.6945,0.5601,0.9931,0.073,0.384,0.41,0.015,1.92,128,1.801115056,3.7932296483333334,3.157363133,0.3459087075,0.38841263633333334,440,1.3037037037037038,1,0,0,1,FALSE,FALSE,FALSE
185,2021-11-13T01:43:58Z,2021-11-13T02:11:26Z,1647,1,2021-11-13T02:11:27Z,1,Opera,80.0.4170.91,Windows NT 10.0,1920,1080,NA,1.7777777777777777,699,205,413,80,64,111,-0.23175502610512866,1.0465219937664365,-0.06982847036806193,-0.29955835878747644,-0.10973896011284763,0.0949869180189837,2,2,2,2,2,1,3,2,1,2,2,2,1,3,2,2,3,1,2,2,0.6048053188292994,1,1,1,3,2,2.45,0,4,4,2,4,3,2,5,1,1,1,1,5,3,5,2,1,2,1,1,1,1,1,1,1,2,4,4,4,4,5,3,4,5,5,5,5,1,5,1,1,4,2,5,1,3,1,1,1,1,3,5,1,4,1,1,2,2,1,5,1,2,1,1,1,2,2,2,2,1.7032031296650734,1.5522640914238175,1.125,0,2,0,1.8,0,1.5555555555555556,0,1.3333333333333333,0,3,0,1.2857142857142858,0,1,0,1.6756756756756757,0,1,4,4,-0.9019474672001281,-0.8804851488934421,1.3117879353562858,0.21565139323142185,5,1,2,1,1,2,1,1,1,1.4638501094227998,1.5714285714285714,0,1,-0.5612498234260587,5,5,4,5,2,3,1,4,2,NA,3,1.618347187425374,4.142857142857143,0,1.8571428571428572,6,3.8333333333333335,3.2559414990859232,0.9547190977297628,0,0.1429209957036584,1,2,2,2,2,2,4,1,1,3,3,4,2,3,5,5,4,1,3,2,1.3557637102737474,1.8,0,4,0,3,0,4.4,0,3.8,0,2,2,4,1,3,4,4,2,4,3,3,2,3,3,1,2,2,4,2,3,0.9787209698591858,3,0,"White, Caucasian, Anglo, European American",0,29,1,2,NA,1,1,2,transcriber,1,0,140,62,2,5,2,0,0,0,0,0,TRUE,TRUE,TRUE,TRUE,TRUE,3,1.1721264705859562,0.68,0.26462373169253234,3,0.5074624999994412,0.6758218749985099,1,1,0.01060449661244984,0.02311444886139153,3,0.7252870967734245,0.752296875,1,1,0.022792641827507783,0.018461948054335268,1.7099,0.4468,0.4983,1.1409,0.5405,0.8035,0.8522,1.684298671,0.5520568554836667,0.49419917366666666,2.3442,4.7685,0.2617,3.7797,0.3657,-51.835,1.1091,4.6003,0.3883,2.1788,0.475,0.9105,1.987299755,3.4491942233333335,4.372692922666666,0.3852051246666667,0.2791045337333333,1.0559,3.4743,0.5885,2.7397,0.5888,0.8402,0.234,0.247,0.491,0.094,1.345,14.308510638297872,2.6878246813333333,3.6568952626666666,3.8014142106666666,0.35461724753333335,0.4017057979,474,1.4044444444444446,1,0,0,1,FALSE,FALSE,FALSE
186,2021-11-13T01:54:39Z,2021-11-13T02:13:34Z,1134,1,2021-11-13T02:13:34Z,0.8999999761581421,Chrome,95.0.4638.69,Macintosh,1440,900,NA,1.6,603,60,257,60,49,70,-0.47841425979110774,-0.2707650616449916,-0.8208497753148042,-0.5432864894683475,-0.31691985466552025,-0.5975591191759924,1,1,4,4,2,3,3,1,1,2,1,4,4,4,1,1,4,1,1,2,1.332784974957958,0,1,2,3,3,3.45,0,2,4,4,3,4,4,2,4,3,3,5,2,1,2,1,3,4,1,1,4,4,4,4,3,2,0,0,3,1,4,2,3,5,3,3,1,1,4,4,1,3,4,2,4,4,5,5,4,2,1,1,1,2,1,1,2,1,1,3,2,2,1,1,2,2,2,2,1,1.365050681609794,1.2227992865708155,3.125,0,1.75,0,3.6,0,3.2222222222222223,0,3.4166666666666665,0,1.5,0,1.5714285714285714,0,1.3333333333333333,0,2.5945945945945947,0,2,0,0,0.9136448258403987,1.1474635900999572,-0.0958522115332568,0.5258056892833503,3,3,2,1,1,2,2,1,1,0.816496580927726,2.2857142857142856,0,1,-0.1339138976503373,2,2,1,1,2,2,3,5,7,4,2,0.6900655593423543,1.8571428571428572,0,4.142857142857143,3,3.8333333333333335,3.2559414990859232,-0.7395711320441822,0,0.570511839559674,3,2,2,1,3,3,5,2,3,4,2,3,2,2,3,1,4,2,3,1,1.1126972805283737,2.2,0,3.6,0,4.2,0,3.4,0,3.7333333333333334,0,3,2,4,1,4,4,4,2,3,3,3,1,2,4,2,1,4,4,4,4,1.145931016569864,3.45,0,"White, Caucasian, Anglo, European American",0,19,1,2,NA,1,3,4,Student,4,0,150,67,2,5,2,0,0,1,0,0,TRUE,TRUE,TRUE,TRUE,TRUE,5,0.6606071428571428,0.84,0.039492183507739136,5,0.42516785713178773,0.4985629629779745,0.9032258064516129,0.84375,0.004419808365343355,0.009806623456074663,5,0.6109624999985099,0.6887760000085831,1,0.78125,0.012989825001648355,0.015055568225480587,1.312,1.3079,0.3188,1.2018,1.5388,0.3846,0.3075,1.3363178983,1.1592238944,0.312942487,0.9159,2.9576,0.30620000000000003,1.8001,0.3076,-45.2267,0.7626,4.3048,0.3427,3.7324,0.3961,0.7401,0.9764693977333333,2.0978622499,3.3030673553333334,0.30350379823333334,0.30220517373333333,0.8853,3.4265,0.4854,2.1658,0.522,0.659,0.059,0.436,0.361,0.012,1.862,155.16666666666669,1.3370381152666666,3.0016774863333335,1.6084128519033334,0.37925720696666665,0.3894775236,400,1.1851851851851851,1,1,0,1,FALSE,FALSE,FALSE
187,2021-11-13T01:20:27Z,2021-11-13T02:13:34Z,3186,1,2021-11-13T02:13:35Z,1,Chrome,95.0.4638.69,Windows NT 10.0,1920,1080,nope,1.7777777777777777,1002,1519,316,143,61,74,0.5467631802162428,12.98386813728793,-0.5368096663926388,0.4681852528572675,-0.15117513902338214,-0.5299936521325801,2,2,2,1,1,1,2,3,1,2,2,1,1,2,2,3,1,1,4,4,0.9679060415469871,0,1,4,3,2,1.9,0,4,5,4,5,2,3,3,2,1,1,2,3,1,3,5,1,2,1,1,1,2,2,3,1,2,0,0,5,4,5,5,5,5,5,5,5,1,5,1,1,5,1,5,1,1,2,1,5,4,1,1,1,1,1,1,1,1,1,5,1,1,1,1,1,1,1,1,1,1.921507791343088,1.4375905768565218,1.625,0,1,0,2,0,1.1111111111111112,0,1.4166666666666667,0,1,0,0.8571428571428571,0,1,0,1.1891891891891893,0,1,0,0,-0.8935419473249401,-0.788728018091335,-0.5341482934814965,-0.6614381557864157,5,1,3,1,1,1,1,1,1,1.5735915849388864,1.2857142857142858,0,1,-0.7321841937363471,5,5,5,5,2,2,2,7,6,5,3,1.6035674514745464,4,0,2,2.5,3.8333333333333335,3.2559414990859232,-1.0219528370065065,0,-0.7657439742430396,3,3,3,1,2,4,5,4,3,2,1,3,1,3,2,1,5,3,3,2,1.3201731488169053,2.4,0,3.6,0,4,0,2.8,0,3.466666666666667,0,1,3,2,2,2,3,2,3,1,1,2,2,3,3,2,1,1,3,4,3,0.8944271909999159,2.4,0,"White, Caucasian, Anglo, European American",0,24,1,2,NA,1,2,6,Rehab Tech,2,0,122,64,2,5,2,1,0,0,0,1,TRUE,TRUE,TRUE,TRUE,TRUE,1,0.714758536585493,0.8367346938775511,0.037284732789256085,1,0.5003580645159368,0.5386566666662693,0.96875,0.967741935483871,0.0043832547983442,0.0027058998494650373,1,0.6100656249992317,0.7770806451612903,1,1,0.007064978457633246,0.012708054279620613,1.2863,1.3728,0.4016,0.9814,1.8294,0.5169,0.1793,1.3169842568666668,1.1894791648333334,0.3944159426,1.1048,3.6276,0.3538,4.3629,0.4182,-75.6618,0.9082,5.2965,0.4159,5.5658,0.4584,0.9993,1.2571610480333333,4.432850953,3.9725642233333334,0.40695065226666666,0.3442580096333333,0.9664,4.2359,0.5105,3.222,0.6584,0.9849,0.366,0.139,0.78,0.01,1.78,178,2.8906328176666665,5.125961219666666,3.995565411333333,0.3326213654,0.41906519103333334,301,0.8918518518518519,1,1,3,4,FALSE,FALSE,FALSE
188,2021-11-13T01:38:52Z,2021-11-13T02:13:38Z,2086,1,2021-11-13T02:13:39Z,0.8999999761581421,Firefox,93.0,Macintosh,1440,900,"No, thank you.",1.6,699,158,728,163,133,107,-0.23175502610512866,0.6195392930468702,1.4466568569282445,0.7119133835381386,0.8432931548294463,0.02742145097557139,2,3,3,2,2,1,2,2,1,2,1,3,4,1,1,2,1,1,2,2,0.8522416262267903,0,0,4,2,3,2.5,0,2,5,5,4,1,2,2,4,2,3,4,1,4,1,3,3,4,1,1,3,5,3,4,1,3,0,0,3,4,1,3,3,4,5,5,2,2,4,5,1,3,2,3,2,5,5,5,3,3,1,1,1,1,1,1,1,2,1,4,1,2,1,1,4,1,4,1,2,1.4992490612795952,1.4074631010979937,3,0,2,0,3.2666666666666666,0,2.6666666666666665,0,3.1666666666666665,0,1.1666666666666667,0,1.2857142857142858,0,2,0,2.324324324324324,0,1,0,0,0.6677833694911609,0.8343472207488856,-0.22054348261253207,0.30690186906817674,5,1,4,1,2,2,1,6,1,1.6035674514745464,1.4285714285714286,0,3.5,0.27575217835475235,5,5,5,5,5,4,1,4,7,6,4,1.4960264830861913,4.857142857142857,0,1.1428571428571428,3.5,3.8333333333333335,3.2559414990859232,-0.4571894270818581,0,-0.9613882538093358,1,2,1,1,1,1,5,1,1,3,1,5,3,5,5,1,5,1,5,3,1.8516401995451028,1.2,0,5,0,4.2,0,4.6,0,4.6,0,1,3,2,4,2,1,1,4,1,2,4,3,2,2,2,4,1,2,2,1,1.105012502906165,1.7,0,"White, Caucasian, Anglo, European American",0,25,1,2,NA,1,4,6,Student,4,0,185,67,2,5,2,0,0,1,0,0,TRUE,TRUE,TRUE,TRUE,TRUE,3,0.9230294117647059,0.68,0.12626492897959185,3,0.4726774193548387,0.5599677419354838,0.96875,0.96875,0.004651902217741935,0.006248564516129031,3,0.61203125,0.67240625,1,1,0.006011773185483871,0.011285797379032257,1.5135,0.5174,0.4388,1.2694,0.4397,0.576,0.3255,1.526368687,0.6326201010576666,0.4329951381666667,1.2531,4.1162,0.3263,3.4206,0.3914,-66.7517,0.8188,6.7387,0.406,5.2319,0.4816,0.9426,1.3826194724333334,3.6049238413333335,4.347134276666667,0.3815962059,0.3183537929333333,0.8498,6.5022,0.5464,3.7594,0.5716,0.9674,0.302,0.196,0.729,0.019,1.349,71,2.314624754,4.955865612666667,4.437290772333333,0.3829628292666667,0.41783512343333334,365,1.0814814814814815,1,0,0,1,FALSE,FALSE,FALSE
189,2021-11-13T01:42:01Z,2021-11-13T02:14:08Z,1927,1,2021-11-13T02:14:09Z,1,Edge,95.0.1020.44,Windows NT 10.0,1600,900,NA,1.7777777777777777,1432,57,204,31,63,98,1.651590997768024,-0.2980192765845384,-1.0760044494313257,-0.8966922789556105,-0.12355101974969247,-0.12460084987210628,3,3,1,1,2,1,1,3,1,3,4,1,1,1,3,3,1,1,3,4,1.145931016569864,0,1,1,5,5,1.45,0,4,3,4,3,3,4,3,3,4,4,3,3,4,4,4,5,5,5,3,4,5,4,4,3,5,2,3,3,3,1,3,2,4,2,1,3,3,3,2,4,4,3,3,3,3,3,2,2,1,3,3,3,2,2,3,3,2,3,2,2,4,1,1,2,2,2,2,3,0.8690542303304526,0.5163977794943222,4.375,0,2.25,0,3.1333333333333333,0,3.5555555555555554,0,2.75,0,2.8333333333333335,0,2.857142857142857,0,1.3333333333333333,0,2.918918918918919,0,2,2,3,1.892887891299757,1.6234779036914775,1.003565549784815,1.3135217267381463,4,2,4,3,3,3,2,2,2,0.816496580927726,2.4285714285714284,0,2,0.32054096227918905,3,3,5,3,3,3,3,4,3,NA,3,0.7559289460184544,3.2857142857142856,0,2.7142857142857144,5.5,3.8333333333333335,3.2559414990859232,0.6723373927674386,0,0.4797561277511168,3,2,2,3,2,3,3,2,2,3,3,3,2,3,4,4,3,3,4,4,0.7037315505489968,2.4,0,3,0,3.2,0,3.4,0,3.2,0,3,2,3,3,3,1,1,2,2,1,3,2,4,4,4,2,4,4,4,3,1.0699237552766379,2.85,0,"Asian or Asian American (e.g., Chinese, Japanese, and others) & Black or African American & White, Caucasian, Anglo, European American",1,22,1,2,NA,1,3,4,student/part time employee,2,0,175,64,2,5,2,0,0,1,0,0,TRUE,TRUE,TRUE,TRUE,TRUE,1,1.1101878048036156,0.82,0.06763891896739545,1,0.8844962963528104,0.8967000000136239,0.9642857142857143,1,0.06250396961397443,0.03228045256139543,NA,NA,NA,NA,NA,NA,NA,1.5976,1.0363,0.6084,1.531,1.1224,0.661,0.3684,1.5943738716666667,0.9844471700666667,0.5982775372333333,2.2166,2.0594,0.3814,2.7467,0.4932,-3.2183,1.6205,1.6863,0.4827,3.0422,0.6394,0.945,2.3960576953333335,2.731809801,2.2149499562333332,0.4465280608,0.3502501424666667,NA,NA,NA,NA,NA,NA,NA,NA,NA,NA,NA,NA,NA,NA,NA,NA,NA,104,0.3081481481481481,1,0,1,2,FALSE,FALSE,FALSE
190,2021-11-13T01:48:03Z,2021-11-13T02:14:17Z,1574,1,2021-11-13T02:14:18Z,1,Chrome,95.0.4638.69,Windows NT 10.0,1366,768,NA,1.7786458333333333,755,75,404,80,67,102,-0.08787047312164088,-0.13449398694725767,-0.11315662257652782,-0.29955835878747644,-0.06830278120231312,-0.057035382828693984,2,3,2,1,3,1,2,3,1,3,2,1,1,2,2,3,2,1,1,3,0.8255779474818965,0,1,1,4,4,1.95,0,1,2,4,3,2,4,1,5,5,5,5,1,4,1,4,5,5,1,1,4,5,5,5,2,2,0,0,5,3,3,3,4,5,5,5,5,1,5,2,1,4,3,5,1,5,5,5,5,1,1,1,1,3,1,1,2,1,1,4,5,5,1,2,3,1,1,1,1,1.7150631013001945,1.6417180315870614,3.875,0,1,0,4.2,0,1.7777777777777777,0,2.6666666666666665,0,1.8333333333333333,0,2.2857142857142856,0,2,0,2.2432432432432434,0,1,0,0,1.161607662158434,1.5766314360667735,-0.5341482934814965,0.5212415712926385,5,1,3,1,1,1,1,1,1,1.5735915849388864,1.2857142857142858,0,1,-0.7321841937363471,3,3,3,3,2,2,2,5,6,3,3,0.5345224838248488,2.857142857142857,0,3.142857142857143,3.5,3.8333333333333335,3.2559414990859232,-0.4571894270818581,0,0.1540057100907786,1,4,2,2,2,1,4,1,1,2,1,5,1,4,4,1,5,1,3,2,1.5946338585572373,2.2,0,5,0,3.8,0,4.4,0,4.4,0,1,1,2,3,2,2,2,4,1,2,2,3,1,3,3,3,1,2,2,2,0.8522416262267903,1.8,0,"White, Caucasian, Anglo, European American",0,30,1,2,NA,1,3,6,Office Manager,2,0,260,64,3,5,2,0,0,1,0,0,TRUE,TRUE,TRUE,TRUE,TRUE,1,0.7532567567438693,0.74,0.05621467478567786,1,0.49792187494039536,0.5918741935453107,1,1,0.005285276600858242,0.009081410643662587,1,0.7208656250238419,0.8589843750447035,1,1,0.012118911370970048,0.0243518923199385,1.3889,0.7858,0.3358,1.2173,0.8729,0.4256,0.4508,1.4146190803333334,0.8336990299,0.3312963508333333,3.2406,7.2845,0.2755,5.4818,0.2963,-74.2721,0.8752,5.2076,0.4156,4.2404,0.4908,0.9719,1.94453033,4.054715972333334,5.568215221333333,0.35308567636666666,0.3271256514,1.1543,4.5438,0.6054,2.3406,0.6772,0.9424,0.243,0.274,0.541,0.013,1.758,135.23076923076923,3.113099727,4.313323070666667,3.5834956163333334,0.36099567476666666,0.4258575523,384,1.1377777777777778,1,0,0,1,FALSE,FALSE,FALSE
191,2021-11-13T01:55:57Z,2021-11-13T02:15:02Z,1144,1,2021-11-13T02:15:03Z,1,Chrome,95.0.4638.69,Windows NT 10.0,1280,720,NA,1.7777777777777777,701,41,208,42,27,66,-0.2266162920700041,-0.44337508959545463,-1.0567474928942295,-0.7626418070811315,-0.6207851666761067,-0.6651245862194046,2,1,2,2,1,1,2,1,1,1,1,2,1,2,1,1,2,2,1,1,0.5026246899500346,0,1,2,2,1,2.8,0,2,3,4,3,5,3,3,4,4,3,5,2,2,2,1,4,4,1,1,4,4,4,4,0,2,0,0,2,2,4,3,2,3,3,5,2,4,5,3,3,2,4,3,5,5,5,5,5,1,2,1,1,2,2,2,1,1,1,4,3,3,1,1,4,2,5,1,2,1.4242642060125392,1.162919151265879,3.25,0,2.5,0,3.7333333333333334,0,3.111111111111111,0,3.9166666666666665,0,2,0,1.7142857142857142,0,2,0,2.891891891891892,0,0,0,0,1.176317321940012,1.3862450686746384,-0.26683355097456624,0.559705758850036,5,1,4,1,1,3,1,2,1,1.7043362064926932,1.4285714285714286,0,1.5,-0.4622231711940119,3,3,4,4,2,1,2,6,6,NA,3,1.1126972805283737,3,0,3,3,3.8333333333333335,3.2559414990859232,-0.7395711320441822,0,-0.0668561398118202,1,3,2,3,2,2,4,2,2,3,1,4,2,3,4,2,5,2,3,3,1.082325538564332,2.2,0,4.4,0,3.6,0,3.6,0,3.8666666666666667,0,2,3,3,1,4,4,3,1,2,2,4,1,2,2,2,1,1,3,3,4,1.0954451150103321,3,0,"Asian or Asian American (e.g., Chinese, Japanese, and others) & White, Caucasian, Anglo, European American & Filipino",1,20,1,2,NA,1,4,4,food service worker and student,5,0,110,70,1,5,2,0,0,1,0,0,TRUE,TRUE,TRUE,TRUE,TRUE,2,0.8908323529292556,0.68,0.039908661223789124,2,0.6231464285765376,0.6196357142754964,0.9333333333333333,0.9333333333333333,0.028196224412728246,0.018848447136457478,2,0.6973124999925494,0.8416862068957296,1,0.90625,0.025004186936662624,0.045677690958082884,1.3382,0.5948,0.496,0.8197,1.0221,0.7235,0.5396,1.384142581,0.70826496569,0.48716959563333334,0.9482,2.3839,0.4765,2.9243,0.4955,-46.6035,1.0643,3.0414,0.461,4.8639,0.4893,0.7434,1.1422258486666668,3.15553871,2.7676527180666666,0.4735091325,0.45319988473333334,1.3848,4.1857,0.5212,1.7264,0.5107,0.7123,0.102,0.326,0.266,0.012,2.07,172.49999999999997,1.7566078906666667,3.00546788,1.8323045343,0.3960493095666667,0.4200504376,412,1.2207407407407407,1,0,0,1,FALSE,FALSE,FALSE
192,2021-11-13T01:38:01Z,2021-11-13T02:15:16Z,2234,1,2021-11-13T02:15:16Z,0.8999999761581421,Chrome,95.0.4638.69,Windows NT 10.0,2048,1152,I did not encounter any technical issues or problems while completing this survey. I enjoyed participating in this survey and I would be very interested in any other future surveys or studies. Thank you! I hope you have a great night! :),1.7777777777777777,689,87,555,593,81,106,-0.2574486962807515,-0.025477127189070508,0.6137934866988445,5.952068193176867,0.12506605371351465,0.010530084214718316,3,2,1,1,2,1,2,1,1,2,1,2,1,1,2,1,2,1,1,1,0.6048053188292994,0,1,2,2,2,2.35,0,4,3,2,3,3,1,3,3,3,1,1,3,3,3,4,2,1,1,1,1,1,1,2,2,2,0,0,5,1,3,4,3,5,3,3,2,2,4,4,2,3,3,4,5,3,3,3,3,4,1,1,1,1,1,1,2,2,1,3,4,3,1,3,1,2,3,2,3,1.274018494027117,0.9759000729485332,1.25,0,2.5,0,2.4,0,2.7777777777777777,0,2.9166666666666665,0,1,0,2.142857142857143,0,1.6666666666666667,0,2.3783783783783785,0,1,0,0,-0.38710937484488595,-0.2669319293211263,-0.06374107717804986,-0.1653365032495881,5,1,2,3,1,2,2,2,1,1.3801311186847085,2,0,1.5,-0.12035443057343476,4,3,4,3,1,1,3,4,5,1,2,1.2535663410560174,2.7142857142857144,0,3.2857142857142856,4.5,3.8333333333333335,3.2559414990859232,0.10757398284279028,0,0.5160584124745394,2,1,1,1,1,2,4,2,1,3,1,3,1,3,4,1,3,2,4,3,1.1254628677422756,1.2,0,3.8,0,4.2,0,3.8,0,3.933333333333333,0,1,2,3,1,2,4,3,2,1,2,2,2,3,2,1,2,2,4,2,3,0.8944271909999159,2.5,0,"White, Caucasian, Anglo, European American",0,29,1,2,NA,1,2,3,Self-employed,1,0,200,69,2,5,2,0,0,1,0,0,TRUE,TRUE,TRUE,TRUE,TRUE,2,0.8902181818160144,0.673469387755102,0.02717414410111965,2,0.4937343750037253,0.5550333333273729,1,0.9375,0.005567386199852311,0.004555585120226285,2,0.6619281250014901,0.713358064524589,1,0.96875,0.0036009743454934605,0.009121074344305166,1.0692,0.7105,0.624,0.9772,0.7579,0.6628,0.1281,1.1440272917666667,0.814653899337,0.6134341117,1.067,4.0306,0.3614,3.6385,0.4237,-75.7385,0.8754,4.7911,0.404,4.9237,0.4633,0.9923,1.2330200051,3.814908818,4.388320412666666,0.4102877218666667,0.3518907697,1.0248,5.6866,0.5775,3.2001,0.567,0.9969,0.06,0.531,0.459,0.024,1.388,57.83333333333333,1.7956858778333333,4.961008934,3.825557009,0.48512811436666664,0.4922172772,340,1.0074074074074075,1,0,0,1,FALSE,FALSE,FALSE
193,2021-11-13T01:49:59Z,2021-11-13T02:15:26Z,1526,1,2021-11-13T02:15:27Z,1,Chrome,95.0.4638.69,Windows NT 10.0,1920,1080,none,1.7777777777777777,852,145,336,80,18,53,0.16135812758190046,0.5014376949755007,-0.44052488370715903,-0.29955835878747644,-0.7450937034077103,-0.8847123541104946,3,2,4,3,1,1,3,3,2,3,2,3,2,3,2,3,3,3,3,3,0.7539370349250519,0,0,3,3,1,2.6,0,3,3,4,3,3,3,2,3,3,3,5,2,3,3,4,2,4,3,4,2,3,2,3,6,2,2,7,3,3,2,4,3,3,3,2,3,2,3,3,2,3,4,3,2,2,2,3,2,1,4,2,3,2,3,3,2,2,3,2,3,3,1,1,1,3,3,2,1,0.8035207810913453,0.7432233529572065,2.875,0,2.25,0,3.2666666666666666,0,3.111111111111111,0,2.5833333333333335,0,3,0,2.7142857142857144,0,1,0,2.72972972972973,0,3,2,6,0.8421979069013039,0.9548510475934248,1.7360069642788738,1.3454290059361493,3,3,2,5,3,3,3,1,2,0.8997354108424374,3.4285714285714284,0,1.5,0.734317420978008,3,2,5,2,3,3,3,3,2,1,2,1,3,0,3,6.5,3.8333333333333335,3.2559414990859232,1.237100802692087,0,0.9214798275563144,4,2,4,2,2,4,2,3,2,4,2,3,3,3,4,2,2,4,4,3,0.8451542547285166,2.8,0,2.6,0,3.4,0,3.4,0,3.1333333333333333,0,2,2,3,2,3,2,3,3,2,2,3,3,2,2,1,3,2,1,3,3,0.6708203932499369,2.25,0,"White, Caucasian, Anglo, European American",0,23,0,1,NA,1,2,3,dasher,1,0,135,71,1,5,2,0,0,1,0,0,TRUE,TRUE,TRUE,TRUE,TRUE,6,0.6630470588233541,0.6938775510204082,0.09336943443093303,6,0.45955862068821646,0.5132580645142063,0.9354838709677419,0.96875,0.005433158516224352,0.004907670160899071,6,0.5658624999979511,0.6227206896574333,1,0.90625,0.005934092742014197,0.006824598458047662,1.4343,0.6082,0.2148,1.1628,0.8574,0.3694,0.3241,1.4469341426666666,0.71254553603,0.21359188466666668,0.9001,3.1813,0.33,4.0409,0.4061,-76.6387,0.8929,4.6561,0.3598,5.5535,0.4251,0.9378,1.006043902,4.137425615,3.557067188,0.3981269139,0.3229551209666667,0.891,3.7043,0.4653,4.2784,0.5218,0.9846,0.058,0.424,0.442,0.015,1.611,107.4,1.5085106940666666,4.368866221,2.5062814823666666,0.3943275621333333,0.35351777323333333,282,0.8355555555555556,1,0,0,1,FALSE,FALSE,FALSE
194,2021-11-13T01:44:33Z,2021-11-13T02:16:24Z,1910,1,2021-11-13T02:16:25Z,1,Chrome,95.0.4638.69,Windows NT 10.0,1536,864,Thank you for giving me the opportunity to complete this study.,1.7777777777777777,963,105,297,99,82,105,0.4465578665313138,0.13804816244821022,-0.6282802099438446,-0.06801663464064889,0.1388781133503595,-0.006361282546134758,4,2,1,1,3,1,2,4,1,4,3,1,1,1,4,4,1,1,4,2,1.332784974957958,0,1,2,2,1,1.35,0,1,3,4,2,5,1,1,4,5,3,4,3,5,3,4,1,5,1,1,1,1,1,3,0,2,2,5,5,3,1,1,1,5,2,2,3,3,4,1,1,1,4,3,5,5,5,5,4,2,4,3,1,2,1,1,1,1,1,3,4,4,1,5,1,4,2,2,4,1.5820881780112646,1.424279266355945,1.75,0,3,0,3.7333333333333334,0,3.4444444444444446,0,3.5833333333333335,0,2.3333333333333335,0,2,0,2.3333333333333335,0,3,0,0,2,5,0.3105487747956867,0.7880814944583723,1.1854835041418672,0.9867824993001197,5,1,3,1,1,1,1,3,1,1.5735915849388864,1.2857142857142858,0,2,-0.3631965189619651,2,3,4,2,1,1,5,4,2,2,2,1.5118578920369088,2,0,4,6,3.8333333333333335,3.2559414990859232,0.9547190977297628,0,1.3379859570252095,1,1,1,1,1,1,5,1,1,3,1,5,1,4,5,1,5,1,4,3,1.791514389985135,1,0,5,0,4.4,0,4.4,0,4.6,0,3,2,1,3,3,2,3,3,1,1,4,2,1,2,3,2,1,1,2,1,0.9445132413883326,2.05,0,"White, Caucasian, Anglo, European American",0,30,1,2,NA,1,2,5,receptionist,2,0,125,62,3,5,2,0,0,2,0,0,TRUE,TRUE,TRUE,TRUE,TRUE,2,0.8790944444868299,0.72,0.09093996149259939,2,0.48342903232574463,0.5466166667620341,1,0.967741935483871,0.004195329462417479,0.0031597401429203807,2,0.6266500000059605,0.6826678571360452,1,0.9032258064516129,0.010472760635524256,0.006326637199381265,1.5079,0.6607,0.4128,1.2573,0.6022,0.5144,0.0043,1.5190301753333333,0.7342841438,0.4075508576333333,1.6973,4.2348,0.283,4.7722,0.3794,-66.5149,0.8118,6.8007,0.4295,5.7297,0.4726,0.8382,1.68544655,4.514625806333333,4.249514937333333,0.37426804053333335,0.2829938841,0.7706,3.5131,0.5382,4.3728,0.6046,0.947,0.064,0.456,0.393,0.022,2.074,94.27272727272727,1.5273497293333334,3.5364234666666667,2.7589676273333334,0.406799418,0.4471519865333333,390,1.1555555555555557,1,0,1,2,FALSE,FALSE,FALSE
195,2021-11-13T01:52:57Z,2021-11-13T02:17:06Z,1448,1,2021-11-13T02:17:06Z,0.800000011920929,Safari,14.1,Macintosh,1280,800,NA,1.6,633,138,340,92,48,110,-0.4013332492642393,0.4378445267832249,-0.4212679271700631,-0.15332148037895377,-0.3307319143023651,0.07809555125813061,4,3,1,1,3,1,1,2,1,4,3,1,1,1,3,4,1,1,3,2,1.190974832912761,0,1,2,4,4,1.45,0,4,5,2,5,1,1,4,2,2,1,1,4,1,5,5,1,1,1,1,1,1,1,1,3,2,0,0,5,5,5,5,5,5,4,5,5,1,5,1,1,5,1,5,1,1,1,1,1,5,1,1,1,1,1,1,2,1,1,5,1,1,1,1,1,2,1,2,1,1.923850618213691,1.7265434778633235,1,0,1.5,0,1.4,0,1.1111111111111112,0,1,0,0.8333333333333334,0,1,0,1,0,1.054054054054054,0,2,0,0,-1.3663524403042442,-1.3732441709541232,-0.17425341425049792,-0.7737487926023106,5,1,4,1,1,1,1,1,1,1.7320508075688772,1.1428571428571428,0,1,-0.8176513788914915,5,5,5,5,4,4,1,6,8,5,4,1.4638501094227998,4.714285714285714,0,1.2857142857142858,2,3.8333333333333335,3.2559414990859232,-1.3043345419688306,0,-1.3052898138313853,2,2,3,3,3,2,5,1,1,4,1,4,1,5,5,1,5,2,5,3,1.7728105208558367,2.6,0,4.4,0,4.8,0,4.6,0,4.6,0,1,1,1,4,2,1,1,3,1,1,1,4,1,3,1,3,1,2,1,1,1.0809352675491624,1.3,0,"White, Caucasian, Anglo, European American",0,24,1,2,NA,1,3,6,Analyst,3,0,115,64,3,5,2,0,0,1,0,0,TRUE,TRUE,TRUE,TRUE,TRUE,6,0.8334749999999942,0.8163265306122449,0.03580899659863852,6,0.4980624999999996,0.5579999999999985,1,0.9375,0.0240664475806454,0.015171628024194625,6,0.6905,0.8135625000000036,1,1,0.01021432258064464,0.017966254032255883,1.3199,1.2363,0.5029,0.9564,1.4671,0.6297,0.2404,1.3574746036666667,1.1144285173666666,0.4941121881666667,1.1959,3.3837,0.3213,2.5335,0.3492,-48.1337,1.2024,4.0339,0.3335,3.0056,0.3632,0.9846,1.3164424825,2.787258077,3.66577524,0.3403699927,0.3123643732,1.3439,3.4136,0.5063,3.4715,0.6176,0.9924,0.309,0.255,0.714,0.013,1.576,121.23076923076924,2.408639545333333,4.736012011333333,4.200052034333333,0.439844466,0.5319174009,340,1.0074074074074075,1,0,0,1,FALSE,FALSE,FALSE
196,2021-11-13T01:54:13Z,2021-11-13T02:17:22Z,1389,1,2021-11-13T02:17:23Z,1,Chrome,94.0.4606.61,Macintosh,1440,900,N/A,1.6,581,50,339,185,97,91,-0.534940334177478,-0.36161244477681426,-0.4260821663043371,0.9800143272870967,0.34605900790303207,-0.2428404171980778,3,3,2,2,3,1,2,3,2,3,3,2,2,2,3,3,2,2,3,3,0.6048053188292994,0,1,1,4,4,1.95,0,2,4,2,3,2,2,3,2,2,2,4,3,2,3,3,2,4,1,1,3,4,4,4,1,2,0,0,3,2,3,3,3,4,3,3,3,2,4,2,1,4,2,3,2,3,4,4,4,3,2,1,1,3,3,1,1,1,1,3,3,2,2,3,3,2,2,3,2,0.9871547368444699,0.7367883976130072,2.875,0,2.25,0,2.6,0,3,0,2.5833333333333335,0,2,0,1.5714285714285714,0,2.6666666666666665,0,2.4594594594594597,0,1,0,0,0.6740875093975516,0.5522037225546441,-0.14214227989529096,0.2050307213296766,3,2,3,2,2,3,3,3,1,0.5345224838248488,2.5714285714285716,0,2,0.4060081474343336,4,4,4,4,2,2,3,3,3,2,2,0.9511897312113419,3.2857142857142856,0,2.7142857142857144,6,3.8333333333333335,3.2559414990859232,0.9547190977297628,0,0.6209469802322789,2,3,2,3,2,2,4,3,2,3,2,4,3,4,3,2,4,3,3,2,0.7988086367179802,2.4,0,3.8,0,3.4,0,3.6,0,3.6,0,2,2,3,2,3,3,3,2,1,2,3,2,2,3,1,2,2,3,2,3,0.6569466853317864,2.5,0,"White, Caucasian, Anglo, European American",0,24,1,2,NA,1,3,7,School-based mental health therapist,3,0,260,68,1,5,2,0,0,2,0,0,TRUE,TRUE,TRUE,TRUE,TRUE,3,0.7261093023211457,0.86,0.04820107789388694,3,0.4760032258110662,0.5320548387150611,1,0.96875,0.0015459069887292765,0.004025808135005669,3,0.5367406249903143,0.6184406249970198,1,1,0.008112736037606313,0.008756640554518486,1.28,1.4925,0.4369,1.0139,1.5231,0.5207,0.1833,1.3079995332666667,1.2593025282666668,0.42879143303333334,1.4575,6.799,0.3688,4.4119,0.3734,-91.377,0.8492,7.8139,0.4269,5.1937,0.4529,0.8307,1.4520493684666667,4.232548358333333,6.068980639,0.36963627413333333,0.3619938429333333,1.0394,5.4806,0.4403,5.2815,0.533,0.7907,0.156,0.25,0.532,0.023,1.924,83.65217391304348,2.3287425176666665,4.566044080666667,4.117302337,0.2845450297,0.34058459573333333,422,1.2503703703703704,1,0,0,1,FALSE,FALSE,FALSE
197,2021-11-13T01:44:25Z,2021-11-13T02:18:17Z,2031,1,2021-11-13T02:18:19Z,1,Chrome,95.0.4638.69,Windows NT 10.0,1366,768,good study :),1.7786458333333333,926,70,657,110,137,76,0.3514912868815093,-0.17991767851316898,1.1048458783947914,0.0660338372338302,0.8985413933768257,-0.4962109186108739,2,2,4,4,2,2,4,3,4,2,3,4,3,4,2,3,4,3,2,2,0.8870412083230169,1,1,4,3,3,3.15,0,4,4,3,4,4,2,4,2,3,2,2,4,2,4,4,3,2,1,1,2,2,2,3,4,2,0,0,5,3,4,5,3,4,4,4,3,2,4,2,2,3,2,3,2,2,2,3,3,4,1,1,1,3,3,1,3,3,1,4,3,3,1,2,4,2,2,3,2,1.1337042318370718,0.9411239481143202,2,0,2.25,0,2.2666666666666666,0,2.111111111111111,0,2.3333333333333335,0,1.6666666666666667,0,2.142857142857143,0,2.3333333333333335,0,2.189189189189189,0,2,0,0,-0.038280300024599465,-0.08322408727218257,0.06095019390122543,-0.011136946685478571,4,2,4,1,1,2,4,3,1,1.3972762620115438,2,0,2,0.06413940681375631,5,5,5,5,3,3,3,6,7,4,3,1.0690449676496976,4.142857142857143,0,1.8571428571428572,2.5,3.8333333333333335,3.2559414990859232,-1.0219528370065065,0,-0.8454149716644763,3,3,3,4,3,3,5,2,2,3,2,4,3,4,4,2,4,2,4,3,0.990430401872025,3.2,0,3.8,0,3.8,0,3.8,0,3.8,0,2,3,3,2,3,3,3,2,3,3,3,2,2,3,1,2,2,3,3,3,0.6048053188292994,2.75,0,"Asian or Asian American (e.g., Chinese, Japanese, and others)",0,23,1,2,NA,1,3,6,currently unemployed,4,0,210,65,2,5,2,0,0,1,0,0,TRUE,TRUE,TRUE,TRUE,TRUE,1,0.8546966666668654,0.6122448979591837,0.13717008278029663,1,0.487328125,0.5693937499998137,1,1,0.003701799506120183,0.004076594798216989,1,0.6305531249986962,0.697612500000745,1,1,0.017164578699637566,0.01305663467768056,1.4399,0.3268,0.4175,1.2266,0.1827,0.5174,0.2277,1.4632952023333334,0.507994968112,0.4113519337666667,6.0011,10.1333,0.1912,8.5676,0.2192,-89.9779,0.7688,6.3518,0.4224,5.9873,0.5103,0.995,1.9434643583333333,4.600949394333333,6.121866333,0.36210926286666667,0.3339167835,1.1985,3.5867,0.4668,5.1562,0.5825,0.9911,0.262,0.152,0.559,0.01,1.206,120.6,2.5054184673333335,4.003855025,3.946323425666667,0.31736722083333335,0.3837701506333333,342,1.0133333333333332,1,0,0,1,FALSE,FALSE,FALSE
198,2021-11-13T01:51:31Z,2021-11-13T02:18:17Z,1606,1,2021-11-13T02:18:19Z,1,Chrome,95.0.4638.69,Windows NT 10.0,1536,864,"it was great, thank you!",1.7777777777777777,720,79,412,101,71,92,-0.17779831873632074,-0.09815503369452862,-0.07464270950233591,-0.04364382157256178,-0.013054542654933752,-0.2259490504372247,4,4,1,1,4,1,1,4,1,4,2,1,1,1,4,4,1,1,3,4,1.460893742308382,0,0,1,4,3,1.15,0,2,3,4,3,4,3,2,4,3,3,5,3,2,3,4,3,5,2,3,3,4,4,3,0,2,0,0,4,4,4,5,4,5,5,5,5,2,4,4,1,3,3,4,2,3,5,5,4,4,1,1,1,2,1,1,1,1,1,5,5,1,1,3,1,2,1,1,1,1.632993161855452,0.8618916073713346,3.375,0,1.25,0,3.3333333333333335,0,1.4444444444444444,0,3,0,1.1666666666666667,0,1.4285714285714286,0,1.6666666666666667,0,1.972972972972973,0,0,0,0,0.6824930292727389,0.8731600999172876,-0.6588395645607719,0.10716026767825787,3,2,3,2,2,4,3,3,2,0.7559289460184544,2.7142857142857144,0,2.5,0.6759691699766689,4,4,4,2,2,4,4,5,6,NA,3,0.9759000729485332,3.142857142857143,0,2.857142857142857,3.5,3.8333333333333335,3.2559414990859232,-0.4571894270818581,0,-0.005336284752094855,4,3,5,5,5,4,5,3,4,3,2,3,4,3,4,5,3,2,5,4,0.9856107606091623,4.4,0,3.2,0,3.2,0,2.8,0,3.066666666666667,0,2,1,4,1,3,4,3,1,4,2,4,2,3,4,2,3,4,4,4,4,1.145931016569864,3.25,0,"White, Caucasian, Anglo, European American",0,22,1,2,NA,1,3,4,teacher,5,0,115,64,1,5,2,0,0,0,0,0,TRUE,TRUE,TRUE,TRUE,TRUE,5,0.8383410256436238,0.7959183673469388,0.03368038427762738,5,0.4666906249988824,0.548818750004284,1,1,0.00795127765074647,0.005592649959870334,5,0.5593468750016763,0.6228548387116002,1,0.96875,0.007265872248324954,0.0056059215225040555,1.3783,1.1141,0.4851,0.961,1.2558,0.6442,0.1796,1.407145644,1.0436431961,0.4776856374333333,6.1453,7.0026,0.0279,8.6531,0.1937,-72.2327,0.908,4.3774,0.3792,4.6909,0.4535,0.9684,1.9301449566666666,5.172472778333334,4.033892827,0.36793516556666667,0.2244551177,0.9663,3.8451,0.4477,4.6325,0.5304,0.8273,0.089,0.364,0.489,0.016,1.837,114.8125,1.9535360943333333,4.568360284,3.576915161666667,0.34772235283333336,0.3619732008666667,390,1.1555555555555557,1,0,0,1,FALSE,FALSE,FALSE
199,2021-11-13T01:15:38Z,2021-11-13T02:19:17Z,3819,1,2021-11-13T02:19:18Z,1,Chrome,94.0.4606.104,CrOS x86_64 14150.64.0,1410,940,None,1.5,928,533,989,445,201,537,0.3566300209166339,4.026316160490219,2.7031732709737555,4.148480026138421,1.7825132101348953,7.290709158142393,4,4,2,2,3,1,1,3,1,4,2,2,1,3,4,4,2,1,2,3,1.145931016569864,0,1,1,3,3,1.65,0,3,4,3,3,2,3,2,3,4,2,4,3,4,2,3,4,4,5,3,2,4,3,4,7,2,4,3,4,5,2,2,3,3,1,2,3,2,3,5,2,3,4,5,3,5,5,3,4,1,5,4,4,5,2,2,5,5,5,4,3,2,3,5,3,2,2,3,3,1.2810703107718722,0.7559289460184544,3.625,0,2.5,0,3.1333333333333333,0,3.2222222222222223,0,3.3333333333333335,0,4,0,3.2857142857142856,0,3.6666666666666665,0,3.4864864864864864,0,4,4,3,1.7794133729847235,1.5450778235757536,1.9014181152811362,1.7232479694284448,2,5,2,4,4,5,4,5,1,1.2535663410560174,4.285714285714286,0,3,1.8006020440704469,2,3,3,2,1,1,5,3,5,2,2,1.3972762620115438,1.8571428571428572,0,4.142857142857143,5,3.8333333333333335,3.2559414990859232,0.38995568780511447,0,1.1352752494843223,2,3,2,5,4,3,4,4,3,1,4,3,5,3,3,2,4,3,4,3,0.9611501047232549,3.2,0,3,0,2.8,0,2.8,0,2.8666666666666667,0,3,3,3,1,4,4,4,2,3,3,4,2,4,4,3,2,4,4,3,3,0.8750939799154206,3.45,0,"White, Caucasian, Anglo, European American",0,30,1,2,NA,1,3,6,Research technologist,5,0,195,64,1,5,2,0,0,1,0,0,TRUE,TRUE,TRUE,TRUE,TRUE,6,0.7098738095238805,0.84,0.02235121035122687,6,0.49169062499981375,0.5721677419365414,1,0.96875,0.0011145931350967733,0.003747724667126742,6,0.6194093749979511,0.7117299999992053,1,0.967741935483871,0.0047332724897517515,0.004141539612896973,1.1534,1.4805,0.4584,0.7463,2.1719,0.5976,0.3825,1.2053391140666667,1.2415787183333333,0.44877995546666666,1.2343,7.7583,0.4121,3.8181,0.4194,-99.4369,0.8544,6.7926,0.4315,4.7553,0.4901,0.9837,1.3277941132666666,3.868730752,6.725716050666667,0.4105143737333333,0.4000033647333333,0.7899,5.379,0.5492,5.9164,0.6494,0.9943,0.075,0.48,0.612,0.013,1.74,133.84615384615384,2.030310495,5.239824278666666,3.7922796586666667,0.4306871528,0.4582965185333333,390,1.1555555555555557,1,0,0,1,FALSE,FALSE,FALSE
200,2021-11-13T01:33:12Z,2021-11-13T02:19:25Z,2772,1,2021-11-13T02:19:27Z,0.800000011920929,Safari,14.1.2,Macintosh,1440,900,"The study was incorrectly calibrated despite the fact that I followed the calibration instructions and used a credit card to size the box. This caused me a lot of trouble throughout the study. I had to change the display size on my laptop, zoom the screen out, and change settings on my browser. I spent an extra 15-20 minutes figuring all of this out. I hope you solve this issue for future participants!",1.6,694,85,1133,449,40,123,-0.24460186119294008,-0.04364660381543503,3.3964237063092098,4.197225652274596,-0.4412283913971238,0.2976833191492206,3,4,1,1,4,1,2,4,1,4,3,1,1,3,4,4,1,2,3,3,1.2773327473170102,0,1,3,5,4,1.4,0,2,5,2,5,1,1,5,2,1,1,2,5,2,4,4,1,2,1,1,1,1,1,1,0,2,0,0,5,5,5,5,5,5,5,5,5,1,5,1,1,5,1,5,1,1,1,1,1,4,1,1,1,2,1,1,1,2,1,5,1,1,1,1,1,1,1,1,2,1.9089641547562237,1.65615734242165,1.125,0,1.25,0,1.6,0,1,0,1,0,1.1666666666666667,0,1,0,1,0,1.0810810810810811,0,0,0,0,-1.2717903417083833,-1.2219610533974852,-0.6588395645607719,-0.9404003089791285,5,2,5,1,1,2,1,1,1,1.8126539343499315,1.2857142857142858,0,1,-0.7321841937363471,5,5,5,5,2,3,1,7,6,6,4,1.7043362064926932,4.285714285714286,0,1.7142857142857142,2.5,3.8333333333333335,3.2559414990859232,-1.0219528370065065,0,-0.9250859690859132,3,2,3,2,3,3,3,2,2,1,2,2,2,3,4,2,3,2,3,3,0.7432233529572065,2.6,0,3.2,0,3,0,3.6,0,3.2666666666666666,0,1,1,1,4,2,1,1,4,1,1,1,4,1,1,1,4,1,1,1,2,1.2182817926554552,1.1,0,"White, Caucasian, Anglo, European American",0,27,1,2,NA,1,2,7,Early Childhood Teacher,3,0,110,62,4,5,2,0,0,0,0,0,TRUE,TRUE,TRUE,TRUE,TRUE,2,0.7673333333333369,0.66,0.02001923469387857,2,0.44132258064516505,0.5060645161290341,1,0.96875,0.005169892473118891,0.0020241118951606603,2,0.5419375000000036,0.6109629629629673,1,0.84375,0.0055786411290336705,0.007368258064515545,1.2663,0.5717,0.417,0.8786,0.6494,0.6018,0.3019,1.317105679,0.7089189668753333,0.41014501093333333,1.0801,4.9856,0.333,4.8202,0.4007,-94.3279,0.6797,5.3639,0.3772,5.9874,0.4506,0.9703,1.1871558418333332,4.730520815,5.033846873333333,0.39239548673333335,0.3254202057666667,0.8021,4.2318,0.4551,2.6288,0.4941,0.9454,0.051,0.411,0.415,0.009,1.35,150.00000000000003,1.3592843841333333,4.040772971,2.0450498919,0.373159137,0.34897825893333334,436,1.2918518518518518,1,0,0,1,FALSE,FALSE,FALSE
202,2021-11-13T01:45:21Z,2021-11-13T02:20:01Z,2080,1,2021-11-13T02:20:02Z,1,Chrome,95.0.4638.69,Macintosh,1440,900,N/A,1.6,660,66,345,521,336,90,-0.3319603397900577,-0.21625663176589804,-0.39719673149869317,5.074646922725731,3.6471412611089487,-0.2597317839589309,4,4,1,1,4,1,1,4,1,4,1,1,1,1,4,4,1,1,4,4,1.5312533566021211,1,1,2,4,4,1.15,0,5,5,1,5,2,1,5,1,1,1,1,5,1,5,5,1,1,1,1,1,1,1,1,1,2,0,0,5,4,5,5,5,5,5,5,5,2,5,1,1,5,1,5,1,1,1,1,1,5,1,1,1,2,1,1,2,2,1,5,1,1,1,1,1,2,1,2,2,1.8776382839954893,2.016597794967223,1,0,1.75,0,1.0666666666666667,0,1.1111111111111112,0,1.0833333333333333,0,1,0,1.1428571428571428,0,1,0,1.135135135135135,0,1,0,0,-1.3159193210531184,-1.481649220003026,-0.2989446853297732,-0.8902969526663996,5,1,4,1,1,1,1,1,1,1.7320508075688772,1.1428571428571428,0,1,-0.8176513788914915,5,5,5,5,4,5,1,7,7,NA,4,1.4960264830861913,4.857142857142857,0,1.1428571428571428,2,3.8333333333333335,3.2559414990859232,-1.3043345419688306,0,-1.3849608112528222,1,1,1,2,1,1,5,1,1,1,1,5,2,4,3,2,5,1,1,1,1.6676187756655838,1.2,0,5,0,3,0,4.4,0,4.133333333333334,0,1,1,3,2,3,3,3,2,2,1,1,3,1,4,4,2,3,3,3,1,1.0310954828418375,2.4,0,"White, Caucasian, Anglo, European American",0,19,1,2,NA,1,4,4,Merchandise associate and student,6,0,180,64,2,5,2,0,1,0,0,1,TRUE,TRUE,TRUE,TRUE,TRUE,2,0.8215536585366581,0.82,0.05896378981221199,2,0.4849258064514687,0.5841156249996274,0.96875,1,0.003167922973738778,0.0073552149092254845,2,0.6269250000001629,0.7036875,1,1,0.00735511806448954,0.007180642419374441,1.2963,1.234,0.524,1.0622,1.4136,0.5774,0.0676,1.337966667,1.1154181650666666,0.5142834332,1.9176,4.7395,0.2909,3.8386,0.3343,-59.0513,0.9529,5.6409,0.4041,4.593,0.4934,0.9678,1.8201750406666666,3.7081162713333335,4.549819697,0.33784123823333334,0.2928102778,1.0249,3.5566,0.5059,3.9111,0.5844,0.9852,0.225,0.288,0.66,0.015,1.472,98.13333333333334,2.669569126,4.764269272666667,5.008069443666667,0.3499564424,0.4447074996,424,1.2562962962962962,1,0,0,1,FALSE,FALSE,FALSE
204,2021-11-13T01:48:22Z,2021-11-13T02:20:23Z,1921,1,2021-11-13T02:20:24Z,0.8999999761581421,Edge,95.0.1020.44,Windows NT 10.0,1920,1080,I thought the exercises in the beginning were fun! I like being able to focus on little games such as those.,1.7777777777777777,936,134,486,112,52,96,0.3771849570571322,0.4015055735304959,0.2816109864339392,0.09040665030191732,-0.2754836757549857,-0.15838358339381242,4,4,1,1,4,1,1,3,1,3,2,1,2,1,4,3,1,1,4,4,1.3416407864998738,0,1,4,3,2,1.3,0,2,4,5,2,3,4,3,4,3,4,4,2,1,2,2,5,5,1,1,5,5,4,5,3,2,1,0,3,2,4,2,2,4,4,3,2,2,5,4,2,1,2,3,4,4,4,4,4,2,2,1,1,5,4,1,3,2,3,2,3,3,2,3,5,3,3,2,2,1.1734039700277465,1.1338934190276817,3.875,0,2.5,0,3.533333333333333,0,3.111111111111111,0,3.25,0,2.6666666666666665,0,2.5714285714285716,0,3.3333333333333335,0,3.054054054054054,0,2,1,0,1.6659388546696912,1.638577178380432,0.34598460421149024,0.9922808912959611,3,2,3,2,2,3,3,4,2,0.5345224838248488,2.5714285714285716,0,3,0.7749958222087157,2,2,3,2,1,1,5,4,1,2,1,1.3801311186847085,1.7142857142857142,0,4.285714285714286,6.5,3.8333333333333335,3.2559414990859232,1.237100802692087,0,1.6385188043492451,3,3,2,4,4,2,4,2,2,2,2,3,2,4,5,3,3,2,2,3,0.9611501047232549,3.2,0,3.6,0,3,0,4,0,3.533333333333333,0,2,2,2,2,3,2,3,2,2,1,3,3,2,1,1,2,1,2,1,2,0.6863327411532597,2.05,0,"White, Caucasian, Anglo, European American",0,28,1,2,NA,1,2,3,Transportation Lead,1,0,230,62,1,5,2,1,0,0,0,1,TRUE,TRUE,TRUE,TRUE,TRUE,6,0.6491368420939696,0.76,0.012755043024064331,6,0.4628677419308693,0.6161633333206177,0.96875,0.967741935483871,0.0036797715729948014,0.009912544945959403,6,0.6352218750230968,1.0003038461529292,1,0.8125,0.01590992305644746,0.09794153576380282,1.2111,1.1239,0.3855,0.7565,1.3142,0.5285,0.2025,1.2710030235666667,1.0161748544333333,0.35097619273333336,1.3557,4.0006,0.3002,2.9717,0.4019,-55.1601,0.9979,4.7887,0.369,4.314,0.5024,0.7511,1.4894330059333334,3.175386652,4.243008082666667,0.39085910016666664,0.2923354826333333,1.4201,3.9886,0.4694,1.1956,0.6125,0.8993,0.09,0.31,0.159,0.007,1.901,271.57142857142856,1.9663872973333334,3.1539433503333334,1.0824845815666666,0.3156630468,0.4058871519666667,104,0.3081481481481481,1,0,1,2,FALSE,FALSE,FALSE
205,2021-11-13T01:57:13Z,2021-11-13T02:20:25Z,1391,1,2021-11-13T02:20:25Z,1,Chrome,95.0.4638.69,Macintosh,1440,900,N/A,1.6,667,65,334,73,50,83,-0.3139747706671217,-0.22534137007908028,-0.45015336197570704,-0.38486320452578127,-0.3031077950286754,-0.3779713512849024,2,1,2,3,1,2,2,1,2,2,2,2,1,1,2,2,2,1,2,1,0.5712405705774795,1,1,1,3,1,2.6,0,1,2,4,2,3,4,1,5,4,4,4,1,2,2,2,4,5,1,2,4,4,4,4,1,3,0,0,2,2,2,2,1,2,3,3,2,2,4,4,1,1,1,2,5,4,4,5,5,1,2,1,1,1,1,1,2,2,3,1,5,5,1,2,1,2,2,2,2,1.4184540923174116,1.3345232785352157,3.5,0,2,0,4.066666666666666,0,3.888888888888889,0,3.5,0,1.6666666666666667,0,3.142857142857143,0,1.3333333333333333,0,3.108108108108108,0,1,0,0,1.4663077576339847,1.7298503580707134,-0.22054348261253207,0.7546534377290907,3,4,2,2,2,3,2,7,4,0.7867957924694432,2.857142857142857,0,5.5,1.8683993794549596,2,2,3,2,1,1,2,6,2,4,2,0.6900655593423543,2.142857142857143,0,3.857142857142857,5,3.8333333333333335,3.2559414990859232,0.38995568780511447,0,0.9759332546414488,1,1,1,1,1,1,4,4,1,4,1,1,1,4,4,1,5,1,2,3,1.5522640914238175,1,0,4.2,0,4,0,3.6,0,3.933333333333333,0,2,3,3,2,3,4,3,2,3,2,2,1,2,2,2,2,1,2,2,2,0.7163503994113789,2.55,0,"White, Caucasian, Anglo, European American",0,28,1,2,NA,1,2,4,Student,5,0,170,67,1,5,2,0,1,2,0,1,TRUE,TRUE,TRUE,TRUE,TRUE,6,0.7492473684227781,0.7755102040816326,0.020858056776660784,6,0.46105333333611487,0.5491625000005588,0.967741935483871,1,0.0036839458277244377,0.004224715967501446,6,0.62746451613307,0.7203275862058689,1,0.90625,0.008291010365832494,0.017766824748030964,1.1072,1.2089,0.5222,0.941,0.9426,0.5768,0.0716,1.1681498351,1.0888066448333333,0.5134108347666667,1.1766,4.4505,0.3454,4.54,0.4196,-83.3988,0.7623,6.3713,0.4059,4.704,0.4737,0.9672,1.3425186642,4.594075069666666,4.663373504333333,0.4068551687,0.334687028,0.9019,3.0687,0.5122,2.7366,0.5813,0.9862,0.064,0.455,0.398,0.012,1.638,136.5,1.703993046,3.8878766473333335,2.2688118154666665,0.4066414955,0.38054644103333335,402,1.1911111111111112,1,0,0,1,FALSE,FALSE,FALSE
206,2021-11-13T01:59:32Z,2021-11-13T02:20:33Z,1261,1,2021-11-13T02:20:34Z,1,Chrome,95.0.4638.54,Macintosh,1440,900,NA,1.6,643,59,311,66,48,73,-0.37563957908861645,-0.2798497999581739,-0.5608808620640088,-0.47016805026408615,-0.3307319143023651,-0.5468850188934331,3,2,2,3,2,2,3,3,1,3,2,2,3,3,2,2,3,2,2,2,0.5871429486123998,0,1,3,3,3,2.55,0,5,3,3,4,2,1,4,1,3,1,1,3,1,4,4,3,2,2,1,1,1,2,2,0,3,1,0,5,2,2,4,4,4,4,4,3,2,3,1,1,1,2,2,1,1,4,4,4,5,2,1,1,1,2,1,1,1,1,4,3,2,2,3,1,2,1,1,1,1.3428712906691034,1.3972762620115438,1.75,0,1.25,0,1.8666666666666667,0,2.4444444444444446,0,2.6666666666666665,0,1.1666666666666667,0,1.4285714285714286,0,2,0,2.135135135135135,0,0,1,0,-0.2274044972163212,-0.38579032238545885,-0.45220635696774814,-0.4189983396766035,4,2,2,2,1,3,2,2,1,0.9511897312113419,2.2857142857142856,0,1.5,0.050579939736853735,2,3,4,3,2,2,4,3,3,NA,2,0.8997354108424374,2.5714285714285716,0,3.4285714285714284,6,3.8333333333333335,3.2559414990859232,0.9547190977297628,0,1.0193019673394625,3,3,4,5,4,4,5,2,2,3,1,5,3,5,5,1,5,1,5,3,1.632993161855452,3.8,0,4.4,0,4.2,0,4.2,0,4.266666666666667,0,4,2,4,2,2,4,4,3,3,3,4,3,2,3,1,3,3,4,3,2,0.8870412083230169,2.85,0,"Asian or Asian American (e.g., Chinese, Japanese, and others)",0,21,1,2,NA,1,2,4,Student,7,0,124,62,3,5,2,0,0,2,0,0,TRUE,TRUE,TRUE,TRUE,TRUE,2,0.7986076923081508,0.7959183673469388,0.024539321633579126,2,0.46297999999920525,0.5175200000007948,0.9375,0.9375,0.0033325380642504846,0.005452827742499574,2,0.5868580645178595,0.7070749999987228,0.96875,0.875,0.00976189338686258,0.012322026602794493,1.3188,1.1436,0.4632,0.919,1.2656,0.6293,0.1425,1.3556520093333333,1.0611317575666666,0.4557756958,0.9658,3.103,0.3217,3.2395,0.3819,-65.0242,0.794,4.7381,0.3851,4.6073,0.4289,0.9859,1.0712575254666667,3.447300412666667,3.495474055333333,0.37377070826666664,0.3162518383333333,0.8401,4.1513,0.4866,2.5478,0.5852,0.9736,0.056,0.442,0.35,0.006,1.276,212.66666666666666,1.459633769,3.4764742273333336,1.9119430245,0.392681621,0.3830550027333333,431,1.2770370370370372,1,0,0,1,FALSE,FALSE,FALSE
207,2021-11-13T01:23:48Z,2021-11-13T02:20:43Z,3414,1,2021-11-13T02:20:44Z,1,Chrome,95.0.4638.54,Windows NT 10.0,1280,720,NA,1.7777777777777777,2640,73,428,88,39,92,4.75538635498326,-0.15266346357362218,0.002385116646047904,-0.202067106515128,-0.4550404510339686,-0.2259490504372247,3,3,1,1,3,1,1,3,1,4,3,1,1,1,4,3,1,1,3,2,1.145931016569864,0,1,1,5,5,1.45,0,1,2,5,2,5,5,1,5,5,4,5,1,2,2,5,1,1,1,1,1,2,4,1,0,2,0,0,5,5,3,2,1,5,5,3,2,2,3,1,1,2,2,1,2,1,1,1,1,5,1,1,1,1,1,1,1,1,1,1,4,3,1,1,4,1,1,1,1,1.460182225659569,1.7593288763724921,1.5,0,1,0,4.266666666666667,0,2.5555555555555554,0,2,0,0.8333333333333334,0,2.142857142857143,0,2,0,2.027027027027027,0,0,0,0,-0.4501507739087931,0.49170983357646164,-0.7372407672780129,-0.12276546685077563,2,5,1,2,4,5,4,1,1,1.6035674514745464,4.142857142857143,0,1,0.9771595093665387,5,5,5,5,2,2,1,1,2,NA,3,1.8126539343499315,4.142857142857143,0,1.8571428571428572,7.5,3.8333333333333335,3.2559414990859232,1.8018642126167355,0,0.5664935531471447,2,2,2,3,3,3,3,3,3,3,1,3,2,3,3,1,3,3,3,4,0.7988086367179802,2.4,0,3.4,0,3.6,0,2.8,0,3.2666666666666666,0,1,1,1,1,1,1,1,1,1,1,1,3,1,2,1,1,1,1,1,2,0.5231483637805969,1.6,0,"Hispanic of Latino (e.g., Mexican American, Central American, and others)",0,28,1,2,NA,1,3,6,Accountant,3,0,140,66,1,5,2,1,0,1,0,1,TRUE,TRUE,TRUE,TRUE,TRUE,4,0.7807419354877164,0.6326530612244898,0.06117000033756975,4,0.5004818181612275,0.6413344827684863,0.7586206896551724,0.9354838709677419,0.021933621700019057,0.028066160128385975,4,0.6335812499858439,0.7244166666600439,1,0.6206896551724138,0.008228153828660665,0.024584911427870986,1.3045,0.4275,0.4279,1.1037,0.2782,0.5497,0.3561,1.3484835386666667,0.6013726391006666,0.42051450436666665,1.2169,1.2447,0.2105,1.8095,0.3327,-4.2146,0.9063,1.8369,0.3051,2.7385,0.497,0.9626,1.2607959268666666,1.9972879264333334,1.59449945048,0.3288072835,0.2106753093,1.0135,5.2131,0.5364,1.1751,0.5,0.5291,0.052,0.466,0.355,0.013,2.133,164.0769230769231,1.5614442033333333,3.309010332,0.5977035238352,0.39164753663333335,0.19352691606333333,104,0.3081481481481481,1,1,4,5,FALSE,FALSE,FALSE
208,2021-11-13T01:46:32Z,2021-11-13T02:21:09Z,2077,1,2021-11-13T02:21:10Z,0.8999999761581421,Chrome,95.0.4638.69,Windows NT 10.0,1920,1080,"Some of these questions were worded in a way that was difficult to answer because of changes in my living situations, i.e. my parents were divorced, both remarried and made a lot of money, but both married abusive people so I spent most of my early childhood completely alone or with my grandma.",1.7777777777777777,744,54,575,75,51,118,-0.11613351031482598,-0.3252734915240852,0.7100782693843243,-0.3604903914576942,-0.28929573539183057,0.2132264853449552,2,3,3,3,1,2,3,1,1,1,1,2,2,1,2,2,3,1,2,1,0.812727700887249,1,1,1,1,2,2.75,0,1,1,3,2,1,2,1,2,4,2,4,1,1,1,3,5,2,4,2,4,5,3,2,7,2,5,2,4,2,2,1,1,1,1,1,1,3,4,5,1,2,2,1,2,4,4,5,5,2,3,5,2,3,1,2,4,3,3,5,1,2,5,1,5,2,3,2,2,1.5102254072756096,1.0997835284835873,3.375,0,2.25,0,3.4,0,4.444444444444445,0,3.5,0,2.8333333333333335,0,2.142857142857143,0,3.6666666666666665,0,3.4324324324324325,0,4,5,2,1.5902891757930024,1.5290106466631481,1.8532004732577383,1.6911055599604432,4,2,3,4,2,2,3,8,8,0.8997354108424374,2.5714285714285716,0,8,2.619934196080626,2,2,2,2,1,1,1,3,4,3,3,0.5345224838248488,2.142857142857143,0,3.857142857142857,5.5,3.8333333333333335,3.2559414990859232,0.6723373927674386,0,1.1171241071226108,3,5,3,1,1,4,5,2,1,1,4,4,1,5,2,3,2,3,3,5,1.4638501094227998,2.6,0,2.6,0,3.4,0,3.4,0,3.1333333333333333,0,1,1,2,4,2,2,3,3,2,2,4,2,1,1,1,2,2,2,1,2,0.9176629354822471,1.9,0,"Asian or Asian American (e.g., Chinese, Japanese, and others) & Native Hawaiian or other Pacific Islander & Filipino",1,27,1,1,NA,1,2,4,Remote operator,2,0,115,60,4,5,2,0,0,1,0,0,TRUE,TRUE,TRUE,TRUE,TRUE,5,0.7401300000011921,0.625,0.30623541473412946,5,0.4460374999991618,0.5128937500007451,1,1,0.003191597257996141,0.004668522540361881,5,0.5522312499994878,0.6077548387096293,1,0.96875,0.014656624798403088,0.015568456088574326,1.3921,0.3708,0.3555,0.8518,0.2629,0.5111,0.3232,1.4186374633333334,0.5487866612257,0.3502949843,0.9836,5.9752,0.3637,4.4455,0.4023,-104.1318,0.7207,4.9873,0.3753,5.7318,0.445,0.9882,1.1678935080666666,4.582785843333333,5.818420195333333,0.38961782493333336,0.35046902106666666,1.5743,5.9634,0.4171,4.4861,0.434,0.9672,0.09,0.284,0.334,0.018,1.655,91.94444444444446,1.7661034503333333,3.346771915666667,3.175020353333333,0.2829916768333333,0.34163212083333333,318,0.9422222222222223,1,0,0,1,FALSE,FALSE,FALSE
209,2021-11-13T02:00:13Z,2021-11-13T02:22:46Z,1353,1,2021-11-13T02:22:47Z,1,Chrome,95.0.4638.69,Macintosh,1440,900,"I felt like I got better at that last game after I figured out to pay attention to the ""+""",1.6,645,67,340,83,46,93,-0.3705008450534919,-0.20717189345271578,-0.4212679271700631,-0.26299913918534573,-0.3583560335760547,-0.20905768367637165,3,4,2,2,2,1,1,4,1,3,2,1,1,1,3,3,1,1,2,2,1.025978352085154,0,1,1,4,4,1.7,0,4,4,3,4,3,1,5,1,1,1,1,5,1,4,5,2,2,1,1,1,1,1,2,1,2,0,0,5,4,5,5,5,5,3,5,4,2,4,2,1,4,1,5,2,5,1,2,1,4,1,1,1,2,1,1,2,2,1,4,1,1,1,1,1,1,1,1,2,1.65763317647414,1.6846647257229665,1.375,0,1.25,0,1.5333333333333334,0,1.4444444444444444,0,1.8333333333333333,0,1.1666666666666667,0,1.2857142857142858,0,1,0,1.5135135135135136,0,1,0,0,-0.8473115880114084,-0.9573365854513246,-0.4557470907642554,-0.70654183810779,5,1,3,1,1,1,1,1,1,1.5735915849388864,1.2857142857142858,0,1,-0.7321841937363471,5,5,5,5,3,2,1,6,3,3,2,1.7043362064926932,4.285714285714286,0,1.7142857142857142,4.5,3.8333333333333335,3.2559414990859232,0.10757398284279028,0,-0.3603225591612647,3,1,1,3,2,3,3,2,2,4,1,4,3,3,4,3,3,1,3,2,0.9611501047232549,2,0,4,0,3.2,0,3.8,0,3.6666666666666665,0,1,1,2,3,3,2,3,3,1,1,2,2,1,3,1,1,1,1,2,2,0.8335087534664907,1.9,0,"White, Caucasian, Anglo, European American",0,30,1,2,NA,1,3,7,Mental Health Professional,3,0,150,67,2,5,2,0,0,1,0,0,TRUE,TRUE,TRUE,TRUE,TRUE,4,0.750567741935532,0.62,0.02575702571444535,4,0.43272187500051223,0.4901517241373658,1,0.90625,0.0020338707963702234,0.003136309516145996,4,0.5620281250004191,0.6439433333327373,1,0.9375,0.003889867892983897,0.005717012741811932,1.2501,0.4202,0.392,0.9676,0.5585,0.5437,0.2764,1.298949749,0.6111871693913333,0.3858690351333333,1.0066,4.8349,0.3286,3.1367,0.3521,-81.1785,0.6735,6.7537,0.3862,4.4783,0.4254,0.8391,1.1070255014666666,3.342933213,4.988323009,0.34456356416666667,0.3233726499333333,0.6982,4.3759,0.5004,3.8491,0.5628,0.9987,0.071,0.421,0.512,0.018,1.859,103.27777777777779,1.818476954,4.574993374666667,3.2521904923333333,0.36565441493333334,0.39277931346666667,373,1.1051851851851853,1,0,0,1,FALSE,FALSE,FALSE
210,2021-11-13T01:58:12Z,2021-11-13T02:23:21Z,1508,1,2021-11-13T02:23:22Z,1,Chrome,95.0.4638.54,Macintosh,1440,900,NA,1.6,967,46,282,57,44,78,0.4568353346015629,-0.39795139802954327,-0.7004937969579544,-0.5798457090704782,-0.3859801528497444,-0.4624281850891678,4,4,1,1,3,2,4,1,1,2,1,2,2,2,2,1,2,1,1,2,1.050062654772261,0,0,1,5,5,2.35,0,2,5,3,5,1,2,1,1,1,1,3,2,1,3,4,1,5,1,1,1,5,3,3,1,2,0,0,5,5,5,5,5,5,5,5,3,1,5,4,1,5,1,5,5,5,5,5,5,1,1,1,2,2,1,1,3,1,1,4,1,1,1,1,3,2,2,1,2,1.8526824963906883,1.4474937289114918,2.5,0,1.75,0,2.2,0,1.2222222222222223,0,2.9166666666666665,0,1.8333333333333333,0,1.2857142857142858,0,1.6666666666666667,0,1.972972972972973,0,1,0,0,0.13823561735434034,0.010081687087766012,-0.2989446853297732,-0.1444314991210036,5,5,3,1,2,1,3,1,3,1.6761634196950514,2.2857142857142856,0,2,0.2350737771240448,5,5,5,5,5,5,1,7,7,6,4,1.5118578920369088,5,0,1,2,3.8333333333333335,3.2559414990859232,-1.3043345419688306,0,-1.464631808674259,4,4,3,5,3,2,5,2,2,5,1,4,1,5,4,1,5,1,5,2,1.7320508075688772,3.8,0,4.6,0,5,0,4.2,0,4.6,0,2,4,2,1,3,3,4,2,4,4,3,2,4,1,1,2,3,3,1,4,1.1367080817685316,2.95,0,"White, Caucasian, Anglo, European American",0,21,1,2,NA,1,5,4,secretary,1,0,158,64,3,5,2,0,0,1,0,0,TRUE,TRUE,TRUE,TRUE,TRUE,3,0.9274861111077998,0.72,0.10793960869001742,3,0.723410714287843,0.813700000005109,0.9655172413793104,1,0.05613899756368245,0.05048125037050653,3,0.7340875000003725,0.9005774193540697,1,0.96875,0.010055469515116452,0.03468868112046995,1.7259,0.596,0.2386,1.4622,0.796,0.4255,0.3494,1.6745361136666668,0.666533150748,0.24231728616666667,1.8571,2.1336,0.307,2.3419,0.4173,-5.0398,1.5424,1.8498000000000001,0.3625,2.2815,0.4966,0.9235,1.9562986903333333,2.4490921996666666,2.3534399286,0.3995882676,0.30078267906666667,1.2964,4.7589,0.6046,2.3958,0.6537,0.9793,0.114,0.477,0.426,0.011,1.82,165.45454545454547,2.792798197,4.550310942666667,2.384640576333333,0.42910292213333334,0.3268896191,104,0.3081481481481481,1,0,1,2,FALSE,FALSE,FALSE
211,2021-11-13T02:07:33Z,2021-11-13T02:24:36Z,1022,1,2021-11-13T02:24:36Z,0.699999988079071,Safari,15.1,Macintosh,1440,900,NA,1.6,644,78,135,24,22,67,-0.3730702120710542,-0.10723977200771087,-1.4081869496962307,-0.9819971246939154,-0.6898454648603309,-0.6482332194585516,3,4,4,4,3,3,3,3,2,4,4,3,3,2,3,3,2,2,3,3,0.6863327411532597,0,1,3,3,4,2.25,0,3,4,3,3,3,4,4,4,3,4,4,3,3,4,4,4,4,3,4,4,3,4,4,1,2,1,1,4,4,4,3,4,4,4,4,3,4,3,4,3,4,4,4,5,4,4,3,4,3,4,4,4,3,4,4,4,4,3,4,4,3,4,3,2,4,4,3,3,0.5708115501860713,0.5163977794943222,3.75,0,3.5,0,3,0,2.2222222222222223,0,3.5,0,3.5,0,3.2857142857142856,0,3,0,3.1621621621621623,0,1,1,1,1.6554319548257066,1.402118665142513,0.632946588183119,1.017532626662816,4,4,4,4,4,4,4,3,3,0,3.4285714285714284,0,3,1.2877989331395812,4,3,3,3,4,3,3,7,7,NA,4,0.4879500364742666,3.2857142857142856,0,2.7142857142857144,2,3.8333333333333335,3.2559414990859232,-1.3043345419688306,0,-0.5085798396170178,5,4,4,3,4,4,4,3,4,3,3,4,3,4,4,4,3,4,3,4,0.50709255283711,4,0,2.8,0,3,0,3,0,2.933333333333333,0,2,3,3,3,3,3,2,3,3,4,3,3,2,3,3,2,3,3,3,2,0.5231483637805969,2.7,0,"White, Caucasian, Anglo, European American",0,19,0,1,NA,1,4,5,retail,3,0,135,73,3,5,2,0,0,0,0,0,TRUE,TRUE,TRUE,TRUE,TRUE,4,0.7611315789473669,0.8085106382978723,0.060898340425539425,4,0.5238999999999923,0.6125625,0.967741935483871,1,0.018100464516128584,0.013626189516129298,4,0.6715937499999969,0.8112333333333305,1,0.9375,0.006382119959677607,0.014073547379032639,1.7318,0.9188,0.2148,1.1398,0.9743,0.5252,0.3798,1.6581499276666667,0.8966418274,0.22069603768666668,1.5805,2.909,0.2801,4.476,0.436,-53.5917,1.2938,6.1352,0.3934,4.8183,0.4669,0.7546,1.708451192,4.375386169,3.208012356333333,0.41989666563333333,0.27469300533333335,1.0564,4.7151,0.5751,2.7463,0.6482,0.9132,0.098,0.461,0.466,0.013,2.042,157.07692307692307,2.165387354,4.225956079,2.6719255483333333,0.4157192613333333,0.4382604537,104,0.3081481481481481,1,0,0,1,FALSE,FALSE,FALSE
212,2021-11-13T01:50:51Z,2021-11-13T02:25:45Z,2094,1,2021-11-13T02:25:47Z,1,Firefox,94.0,Macintosh,1440,900,n/a,1.6,768,115,510,114,85,106,-0.05446870189333121,0.22889554558003286,0.397152725656515,0.11477946337000441,0.18031429226089402,0.010530084214718316,4,4,2,1,3,1,1,3,2,4,3,2,1,2,4,4,1,1,3,4,1.2354415362426845,0,1,1,4,4,1.4,0,1,1,2,2,2,5,3,4,3,3,2,1,5,2,4,2,5,5,1,2,4,5,3,1,2,0,2,5,4,3,4,4,4,4,5,4,2,3,2,3,3,3,5,5,4,4,4,5,2,5,1,1,3,1,1,2,1,1,1,5,5,1,4,4,2,3,1,1,1.4688967484672493,1.3451854182690985,3.375,0,1.75,0,3.6,0,1.8888888888888888,0,3.25,0,2.3333333333333335,0,2.7142857142857144,0,3,0,2.7027027027027026,0,1,0,2,1.1363911025328706,1.3013600436604527,0.053954608468588336,0.6776573260645204,4,2,2,4,2,2,2,1,1,0.9759000729485332,2.5714285714285716,0,1,0.03702047265995151,3,2,3,2,1,1,5,4,4,2,2,1.3972762620115438,1.8571428571428572,0,4.142857142857143,5,3.8333333333333335,3.2559414990859232,0.38995568780511447,0,1.1352752494843223,3,3,2,2,2,2,5,3,2,3,1,3,1,4,4,3,3,1,4,3,1.2071217242444348,2.4,0,4,0,4,0,3.6,0,3.8666666666666667,0,3,1,2,3,3,2,3,3,1,3,3,3,2,1,2,3,2,3,4,3,0.8271701918685112,2.3,0,"Asian or Asian American (e.g., Chinese, Japanese, and others) & White, Caucasian, Anglo, European American",1,29,1,2,NA,1,2,4,dog walker & artist,2,0,120,62,3,5,2,0,0,1,0,0,TRUE,TRUE,TRUE,TRUE,TRUE,5,0.8456842105263158,0.76,0.05144418938775511,5,0.46861290322580645,0.5859375,1,1,0.0063135784946236565,0.006714512096774193,5,0.5904193548387097,0.6703666666666667,1,0.967741935483871,0.007185584946236559,0.00869756559139785,1.384,0.8914,0.4664,0.8758,1.1742,0.6857,0.3791,1.4180557003333334,0.9038868661333334,0.4587882202333333,1.7601,6.3208,0.3294,4.6122,0.3951,-82.9238,0.8875,5.6183,0.3813,3.4523,0.4815,0.9934,1.6732628889,4.295279394666666,5.702176764666667,0.3937961766,0.32639301136666665,1.0657,4.5777,0.4873,4.3915,0.5604,0.8595,0.076,0.437,0.502,0.012,1.468,122.33333333333333,2.139570994666667,4.418749048666666,3.369291580666667,0.3496804515,0.3657910103,376,1.114074074074074,1,0,0,1,FALSE,FALSE,FALSE
213,2021-11-13T02:00:57Z,2021-11-13T02:27:52Z,1614,1,2021-11-13T02:27:53Z,1,Chrome,93.0.4577.82,Macintosh,1440,900,NA,1.6,708,77,425,114,74,85,-0.20863072294706814,-0.11632451032089314,-0.012057600756774062,0.11477946337000441,0.028381636255600768,-0.34418861776319626,3,3,1,1,3,1,1,2,1,3,2,1,1,1,3,2,1,1,2,2,0.8506963092234007,0,1,2,5,5,1.75,0,4,4,2,4,2,1,4,2,1,2,1,4,2,4,4,1,2,1,1,1,1,1,1,0,5,0,0,5,5,5,4,2,4,3,3,3,1,4,1,1,3,2,1,2,1,2,1,1,4,1,1,1,1,1,1,1,1,1,3,4,1,1,1,1,2,2,1,1,1.4099602788688723,1.2798809468443688,1.125,0,1.5,0,1.8,0,2.2222222222222223,0,1.8333333333333333,0,1,0,1.5714285714285714,0,1,0,1.7297297297297298,0,0,0,0,-0.8683253876993774,-0.85725549552582,-0.5804383618435307,-0.7188469286846754,5,1,3,1,1,1,1,1,1,1.5735915849388864,1.2857142857142858,0,1,-0.7321841937363471,3,3,3,3,1,1,3,3,4,1,2,0.9759000729485332,2.4285714285714284,0,3.5714285714285716,5.5,3.8333333333333335,3.2559414990859232,0.6723373927674386,0,0.9577821122797373,2,2,2,3,2,2,5,1,2,2,1,3,2,4,4,3,5,2,2,2,1.2909944487358056,2.2,0,4.2,0,3.2,0,4.2,0,3.8666666666666667,0,1,1,2,3,3,3,2,2,3,1,1,3,1,1,1,3,1,2,2,3,0.8870412083230169,1.85,0,"Asian or Asian American (e.g., Chinese, Japanese, and others)",0,25,1,2,NA,1,2,4,Unemployed,1,0,207,61,2,5,2,0,0,1,0,0,TRUE,TRUE,TRUE,TRUE,TRUE,4,0.956910416662693,0.96,0.08883010384891502,4,0.4284968750029802,0.529480645133603,1,0.96875,0.0017700493453361335,0.005344258942561601,4,0.6390874999985099,0.6916062500029803,1,1,0.015551779201104217,0.017956425767749015,1.8582,1.8202,0.4792,1.659,1.7081,0.5482,0.3072,1.6573566846666667,1.4152118405333334,0.48495269316666667,1.5069,5.6308,0.2947,4.4463,0.3671,-83.8692,1.0087,8.6165,0.3709,3.6086,0.3978,0.953,1.4943036202333333,4.267893155,5.354693971,0.3639211651,0.29204824653333333,0.9438,3.2482,0.5374,3.2234,0.5639,0.8133,0.196,0.212,0.45,0.021,1.283,61.09523809523809,2.489660561,3.740564728333333,3.7319868823333335,0.3045201134666667,0.36074041856666667,384,1.1377777777777778,1,0,0,1,FALSE,FALSE,FALSE
214,2021-11-13T02:03:18Z,2021-11-13T02:28:22Z,1503,1,2021-11-13T02:28:23Z,0.8999999761581421,Chrome,84.0.4147.135,Macintosh,1440,900,NA,1.6,670,72,371,103,76,88,-0.30626666961443483,-0.16174820188680444,-0.27202651400756944,-0.019271008504474677,0.05600575552929045,-0.293514517480637,4,4,1,1,3,1,1,2,1,3,3,1,1,1,4,4,1,1,4,3,1.3218806379747876,1,1,1,4,3,1.3,0,5,4,2,4,3,2,5,2,3,1,2,5,2,5,2,2,3,1,2,1,1,1,1,2,2,0,0,4,4,2,4,5,5,2,2,5,2,5,1,1,2,3,5,5,3,2,1,2,4,1,1,1,3,1,2,2,1,1,4,2,1,1,1,1,1,1,1,1,1.5022505639062869,1.4074631010979937,1.5,0,1,0,1.9333333333333333,0,2.3333333333333335,0,2.1666666666666665,0,1.3333333333333333,0,1.4285714285714286,0,1,0,1.8918918918918919,0,1,0,0,-0.5342059726606693,-0.5691110035449424,-0.5341482934814965,-0.5516296485132195,5,1,4,1,1,1,1,1,1,1.7320508075688772,1.1428571428571428,0,1,-0.8176513788914915,5,5,5,5,3,3,1,4,6,5,4,1.5735915849388864,4.428571428571429,0,1.5714285714285714,4,3.8333333333333335,3.2559414990859232,-0.1748077221195339,0,-0.5811844090638635,2,2,3,3,2,2,2,2,2,2,1,3,3,4,5,3,3,2,2,4,1.0465362369445672,2.4,0,3.8,0,2.4,0,3.8,0,3.3333333333333335,0,1,1,1,4,2,2,1,3,2,2,1,3,2,2,1,4,1,2,1,2,0.9679060415469871,1.5,0,"White, Caucasian, Anglo, European American",0,24,1,2,NA,1,4,4,Retail,6,0,200,67,3,5,2,0,0,1,0,0,TRUE,TRUE,TRUE,TRUE,TRUE,2,1.0384547560867603,0.82,0.09889777733799109,2,0.512320322570421,0.5844943548342393,0.96875,0.96875,0.00275946152326012,0.0026096417564402436,2,0.6963090624994948,0.7189068749976286,1,1,0.028881774708752913,0.008431019323371678,1.7876,0.9281,0.431,1.1932,1.1918,0.7397,0.5591,1.713785119,0.89843385,0.4316346548666667,0.9975,3.6226,0.3801,4.8582,0.487,-85.7133,0.6735,5.5566,0.4579,5.7659,0.5241,0.9621,1.1937081331,4.77942892,4.079117171666667,0.4705435074666667,0.3689419697333333,1.0307,2.539,0.5094,4.3019,0.6087,0.9566,0.112,0.433,0.462,0.014,1.223,87.35714285714286,2.6941590276666667,4.097424636333334,3.9840259446666666,0.36732619233333336,0.38475304126666665,425,1.2592592592592593,1,0,1,2,FALSE,FALSE,FALSE
215,2021-11-13T02:04:09Z,2021-11-13T02:28:42Z,1472,1,2021-11-13T02:28:43Z,1,Chrome,95.0.4638.69,Windows NT 10.0,1920,1080,None. Thank you!,1.7777777777777777,699,88,397,77,52,95,-0.23175502610512866,-0.016392388875888245,-0.14685629651644574,-0.3361175783896071,-0.2754836757549857,-0.1752749501546655,4,3,1,1,3,1,1,2,1,3,3,1,1,1,3,3,1,1,3,2,1.050062654772261,0,1,1,5,4,1.55,0,4,4,4,3,2,1,2,3,3,1,1,3,1,3,2,3,4,5,1,2,3,2,3,3,2,4,4,2,2,3,4,4,3,1,1,2,2,4,3,1,1,3,4,4,3,3,3,4,1,3,3,2,3,1,1,3,3,1,4,2,2,2,2,2,1,2,2,2,1.0440737953277488,1.1254628677422756,2.875,0,1.75,0,2.466666666666667,0,3.5555555555555554,0,2.9166666666666665,0,2.6666666666666665,0,1.8571428571428572,0,2,0,2.810810810810811,0,2,4,4,0.8926310261524294,0.6458966578040526,1.436479206435561,1.0411879321198068,4,2,2,3,2,2,3,1,1,0.7867957924694432,2.5714285714285716,0,1,0.03702047265995151,3,4,4,4,1,2,3,5,6,2,2,1.1547005383792515,3,0,3,3.5,3.8333333333333335,3.2559414990859232,-0.4571894270818581,0,0.07433471266934186,3,3,3,2,3,2,3,4,2,2,2,4,2,3,4,4,4,1,4,4,1.0690449676496976,2.8,0,4.2,0,3,0,3,0,3.4,0,1,2,1,4,2,1,1,4,1,1,1,4,2,1,1,4,2,2,1,1,1.1821033884786185,1.25,0,"White, Caucasian, Anglo, European American",0,27,1,2,NA,1,2,4,Bartender,3,0,177,70,2,5,2,0,0,1,0,0,TRUE,TRUE,TRUE,TRUE,TRUE,1,0.8933387096851103,0.6326530612244898,0.04899955326418937,1,0.5211032258079897,0.713,1,1,0.0021197903225793633,0.016225467741079486,1,0.6413062500031665,0.8017531250016764,1,1,0.004371318024059032,0.020296432892644493,1.0915,0.5011,0.6352,0.9521,0.378,0.6811,0.1576,1.1683249079333333,0.6830865287176666,0.6224084859666666,3.5476,9.622,0.3368,4.8384,0.3464,-77.4806,0.9208,8.2904,0.4643,3.1835,0.5834,0.9921,2.0966720623333335,3.5521143073333334,6.675312122,0.41606169643333335,0.371007432,1.2216,6.5351,0.5565,2.534,0.5934,0.9738,0.142,0.391,0.542,0.011,1.647,149.72727272727275,2.6408923206666666,5.555617915666667,3.8476153133333333,0.4097917688,0.4617859238,320,0.9481481481481481,1,0,1,2,FALSE,FALSE,FALSE
216,2021-11-13T02:08:56Z,2021-11-13T02:29:53Z,1257,1,2021-11-13T02:29:54Z,1,Chrome,95.0.4638.69,Windows NT 10.0,1366,768,none,1.7786458333333333,670,44,283,64,48,92,-0.30626666961443483,-0.4161208746559078,-0.6956795578236804,-0.4945408633321733,-0.3307319143023651,-0.2259490504372247,2,2,1,1,1,1,1,2,1,2,2,1,1,3,2,2,1,1,2,2,0.6048053188292994,0,1,1,2,2,2.15,0,3,4,3,3,4,4,3,4,4,3,2,3,2,3,3,2,2,1,1,2,2,3,1,4,2,0,0,3,3,5,4,4,4,3,4,4,2,4,2,1,4,4,4,4,2,4,4,4,5,1,1,1,3,1,1,2,3,1,3,4,4,1,1,1,1,1,1,1,1.3573291208628593,0.6761234037828132,1.75,0,1,0,3.066666666666667,0,2.2222222222222223,0,2.75,0,1.1666666666666667,0,2.4285714285714284,0,1,0,2.2162162162162162,0,2,0,0,-0.1769713779651954,0.16475246242718228,-0.33105581968498016,-0.08315167862889894,4,1,3,1,1,1,1,1,1,1.2535663410560174,1.4285714285714286,0,1,-0.6467170085812028,4,4,4,4,3,2,2,7,6,NA,3,0.9511897312113419,3.5714285714285716,0,2.4285714285714284,2.5,3.8333333333333335,3.2559414990859232,-1.0219528370065065,0,-0.5267309819787295,2,2,2,3,2,2,4,3,2,3,2,4,2,4,4,2,4,3,3,3,0.8451542547285166,2.2,0,3.8,0,3.6,0,3.6,0,3.6666666666666665,0,1,2,2,3,2,2,2,3,1,1,3,3,2,2,1,3,2,2,1,1,0.7591546545162482,1.75,0,"White, Caucasian, Anglo, European American",0,28,1,2,NA,1,3,6,Administrative Assistant,2,0,220,65,1,5,2,0,0,0,0,0,TRUE,TRUE,TRUE,TRUE,TRUE,2,0.7658131578972465,0.76,0.01823575603046319,2,0.44372500002384185,0.5121931034449874,1,0.90625,0.003770278061075518,0.0072011128583689245,2,0.5855250000059604,0.6658937499672174,1,1,0.003631689669288205,0.006772259311291057,1.0528,1.1469,0.5296,0.8955,1.2432,0.594,0.2048,1.1215576456333334,1.0575535659,0.5199557777,1.0588,4.8309,0.3341,2.4489,0.3297,-68.6025,0.7996,4.4822,0.3579,3.6643,0.4144,0.9674,1.1580091763,2.7211419623333333,4.924718789,0.32314490926666667,0.32742616356666665,0.944,6.116,0.5046,4.0839,0.5547,0.9878,0.061,0.488,0.575,0.026,1.751,67.34615384615384,2.044655582,5.921173823666667,4.934468527666667,0.42036963746666667,0.4664286420666667,350,1.0370370370370372,1,0,0,1,FALSE,FALSE,FALSE
217,2021-11-13T01:54:59Z,2021-11-13T02:29:57Z,2097,1,2021-11-13T02:29:58Z,1,Chrome,95.0.4638.69,Windows NT 10.0,1536,864,No!,1.7777777777777777,1476,136,268,59,36,72,1.7646431465407644,0.4196750501568604,-0.7678931448377903,-0.555472896002391,-0.49647662994450314,-0.5637763856542862,2,2,2,1,3,1,2,3,1,3,2,1,2,2,2,2,1,1,2,2,0.6708203932499369,0,1,2,3,3,2.05,0,4,5,2,5,1,1,4,2,2,1,2,4,1,3,4,2,3,1,1,1,2,2,1,1,2,0,0,5,3,2,4,3,5,5,5,5,4,5,1,1,2,1,3,2,1,1,3,3,3,1,1,1,1,2,1,1,2,1,4,1,1,1,1,1,1,1,1,1,1.5314520382125407,1.486446705914413,1.625,0,1,0,1.6666666666666667,0,1.8888888888888888,0,2.0833333333333335,0,1.3333333333333333,0,1.1428571428571428,0,1,0,1.7027027027027026,0,1,0,0,-0.5741321920678106,-0.7112958401992617,-0.5341482934814965,-0.6227220668403791,5,1,4,1,1,1,1,1,1,1.7320508075688772,1.1428571428571428,0,1,-0.8176513788914915,5,5,5,5,3,3,1,6,6,4,3,1.5735915849388864,4.428571428571429,0,1.5714285714285714,3,3.8333333333333335,3.2559414990859232,-0.7395711320441822,0,-0.8635661140261877,2,3,3,2,2,2,4,5,2,2,1,3,2,3,4,1,4,2,3,3,1.162919151265879,2.4,0,4,0,3.6,0,3,0,3.533333333333333,0,1,2,1,4,1,1,1,3,1,1,1,3,2,1,1,3,1,1,1,2,0.9403246919632545,1.3,0,"Asian or Asian American (e.g., Chinese, Japanese, and others) & White, Caucasian, Anglo, European American",1,19,1,2,NA,1,4,4,Sales Associate,4,0,150,69,2,5,2,1,1,1,0,2,TRUE,TRUE,TRUE,TRUE,TRUE,6,0.6231642857137181,0.84,0.012245912248873591,6,0.42161562500009314,0.48724137931034484,1,0.9354838709677419,0.001098457489917083,0.003995315182859345,6,0.49806875000009315,0.5634290322598912,1,0.96875,0.0039835589920488934,0.00674855700612605,1.1235,1.622,0.4161,0.6626,1.6676,0.5517,0.2396,1.1654509731,1.2978776369666667,0.4085922956,1.0814,6.5724,0.3393,3.4757,0.3455,-93.8048,0.6476,8.4418,0.3851,4.0935,0.4217,0.8374,1.1302873136666667,3.577227639,6.067502223,0.3413357894333333,0.33375942363333333,0.7599,4.6222,0.4345,4.1413,0.4882,0.8732,0.08,0.352,0.559,0.026,1.999,76.88461538461539,1.8438286076666666,4.619744049,3.7104638986666667,0.30123991873333333,0.3277146581,386,1.1437037037037037,1,0,0,1,FALSE,FALSE,FALSE
218,2021-11-13T02:11:24Z,2021-11-13T02:30:06Z,1122,1,2021-11-13T02:30:07Z,1,Chrome,95.0.4638.69,Windows NT 10.0,1920,1080,The break in between the color-changing test was a good idea. Thank you for that.,1.7777777777777777,571,43,263,60,48,59,-0.5606340043531007,-0.4252056129690901,-0.7919643405091602,-0.5432864894683475,-0.3307319143023651,-0.7833641535453761,2,2,2,2,2,2,1,2,1,2,2,1,1,1,2,2,1,1,1,1,0.5104177855340404,0,1,1,3,4,2.25,0,3,4,4,3,5,2,5,3,3,1,2,4,2,3,3,2,5,1,1,1,3,2,2,0,2,0,0,4,5,4,5,5,5,3,3,5,5,4,1,1,4,1,5,3,1,1,1,2,2,1,1,1,1,1,1,1,2,1,4,2,2,1,1,1,2,2,1,2,1.626082453058314,1.1254628677422756,2.125,0,1.75,0,2.6,0,1.6666666666666667,0,1.75,0,1.3333333333333333,0,1.4285714285714286,0,1,0,1.5945945945945945,0,0,0,0,-0.33037211568736946,-0.1417821718030628,-0.5020371591262895,-0.32190966546467614,5,1,4,1,1,1,1,1,1,1.7320508075688772,1.1428571428571428,0,1,-0.8176513788914915,4,5,4,4,3,2,1,7,8,NA,3,1.3801311186847085,3.857142857142857,0,2.142857142857143,1.5,3.8333333333333335,3.2559414990859232,-1.5867162469311549,0,-0.968454681783927,2,3,2,1,2,2,5,3,2,2,1,3,1,3,4,3,4,1,5,4,1.3557637102737474,2,0,4.2,0,4,0,3.2,0,3.8,0,1,3,4,1,3,4,4,1,4,3,3,1,2,4,1,1,4,4,2,4,1.3018205875255096,3.3,0,"Asian or Asian American (e.g., Chinese, Japanese, and others)",0,21,0,1,NA,1,3,2,Unemployed,5,0,145,69,2,5,2,0,0,1,0,0,TRUE,TRUE,TRUE,TRUE,TRUE,3,0.888990909089419,0.88,0.11337387590205109,3,0.34770937499497084,0.4274999999947125,1,0.96875,9.325150706326592e-4,0.003629660645287595,3,0.48901250000158325,0.5187032258063555,1,0.96875,0.005746380483884771,0.0036924795865836105,1.6306,1.3169,0.4045,1.4545,1.4856,0.4738,0.2322,1.5826987413333333,1.1615481502,0.40221147916666666,1.3214,7.5782,0.2605,4.2295,0.2777,-100.1356,1.1311,8.7542,0.2856,6.9507,0.3458,0.9994,1.1961416750666667,3.9680992146666667,6.3847890813333334,0.2836445732333333,0.26049814216666667,0.942,3.5872,0.3779,5.1624,0.4379,0.9647,0.066,0.342,0.444,0.03,1.723,57.43333333333334,1.5791432525,4.516931747666667,3.9718039603333333,0.31653404586666667,0.3323378415666667,278,0.8237037037037037,1,0,1,2,FALSE,FALSE,FALSE
219,2021-11-13T02:05:01Z,2021-11-13T02:30:07Z,1505,1,2021-11-13T02:30:08Z,1,Chrome,93.0.4577.107,CrOS x86_64 14092.77.0,1536,864,NA,1.7777777777777777,814,59,365,72,53,86,0.06372218091453376,-0.2798497999581739,-0.30091194881321337,-0.39704961105982484,-0.2616716161181409,-0.3272972510023432,4,4,1,1,3,1,1,4,1,4,3,1,1,1,4,4,1,1,4,4,1.465390194130093,0,1,1,3,2,1.1,0,5,5,1,5,1,1,3,1,1,1,1,4,1,4,3,2,1,1,1,1,1,1,1,5,2,0,0,4,4,5,5,5,5,5,5,5,1,5,1,1,4,1,4,1,1,1,1,1,4,1,1,1,1,1,1,2,2,2,5,1,1,1,1,1,1,2,2,2,1.7731734670201176,1.7265434778633235,1.125,0,1.75,0,1.4,0,1.2222222222222223,0,1.1666666666666667,0,1,0,1.2857142857142858,0,1,0,1.2162162162162162,0,3,0,0,-1.187735142956507,-1.2498366374386316,0.10724026226325957,-0.571298187587686,5,1,3,1,1,1,1,1,1,1.5735915849388864,1.2857142857142858,0,1,-0.7321841937363471,5,4,5,3,3,2,2,3,3,3,2,1.2724180205607036,3.7142857142857144,0,2.2857142857142856,6,3.8333333333333335,3.2559414990859232,0.9547190977297628,0,0.3819339879679685,2,2,3,1,1,2,4,2,1,3,1,5,1,5,4,2,4,3,3,3,1.3557637102737474,1.8,0,4.2,0,3.8,0,4.2,0,4.066666666666666,0,1,2,1,4,1,1,2,4,1,1,1,4,2,1,1,4,1,1,1,2,1.1964860832322377,1.2,0,"White, Caucasian, Anglo, European American",0,29,1,2,NA,1,3,4,Realtor,5,0,125,61,2,5,2,0,0,1,0,0,TRUE,TRUE,TRUE,TRUE,TRUE,2,0.8063176470586263,0.68,0.03434264150623493,2,0.5305468750001164,0.6055766666668156,1,0.9375,0.007024361280265259,0.007371990312394933,2,0.649421875,0.7160000000002483,1,0.967741935483871,0.011800008860864403,0.011787045698901204,1.1426,0.6587,0.5065,1.0926,0.5898,0.5609,0.2799,1.210333468,0.77209630745,0.4957691083,1.1094,3.8871000000000002,0.3878,2.8516,0.4311,-62.174,0.8525,4.7556,0.4391,3.2779,0.5016,0.9768,1.340813978,3.1702702416666666,4.257506458666667,0.41136481373333333,0.3713832656,0.8288,3.1154,0.5449,3.0538,0.6294,0.9652,0.08,0.444,0.382,0.012,1.324,110.33333333333334,2.231590218,4.0887505116666665,3.099172549,0.37617518603333333,0.3718962010333333,410,1.2148148148148148,1,0,0,1,FALSE,FALSE,FALSE
221,2021-11-13T02:03:57Z,2021-11-13T02:32:01Z,1684,1,2021-11-13T02:32:02Z,1,Chrome,95.0.4638.69,Macintosh,1280,800,thanks!,1.6,827,97,399,76,78,115,0.09712395214284343,0.06537025594275213,-0.13722781824789776,-0.3483039849236506,0.08362987480298012,0.16255238506239597,3,3,1,1,2,1,2,2,1,3,2,1,1,1,2,2,1,1,2,2,0.7326950970650465,0,1,2,3,4,1.9,0,4,4,2,4,2,2,4,2,2,2,2,4,2,3,3,2,2,1,1,1,1,2,2,1,2,0,0,4,3,5,4,4,5,5,5,4,1,4,2,1,4,2,4,2,2,1,1,2,4,1,1,1,2,1,1,2,1,1,4,2,1,1,1,1,1,1,2,1,1.5007505629691607,0.9411239481143202,1.5,0,1.25,0,2.1333333333333333,0,1.6666666666666667,0,1.6666666666666667,0,1.1666666666666667,0,1.2857142857142858,0,1,0,1.5135135135135136,0,1,0,0,-0.7695605291659228,-0.6457688596580947,-0.4557470907642554,-0.5507579752111751,4,2,3,1,1,2,2,1,1,1.0690449676496976,1.8571428571428572,0,1,-0.39031545311577004,5,5,5,5,2,2,1,6,3,3,3,1.8126539343499315,4.142857142857143,0,1.8571428571428572,4.5,3.8333333333333335,3.2559414990859232,0.10757398284279028,0,-0.28065156173982786,2,2,2,3,2,2,3,2,2,3,2,3,3,4,4,4,4,2,3,3,0.7988086367179802,2.2,0,3.8,0,2.8,0,3.8,0,3.466666666666667,0,2,1,1,2,2,2,2,2,2,1,2,3,2,2,2,2,1,2,3,3,0.6048053188292994,2.05,0,"White, Caucasian, Anglo, European American",0,28,1,2,NA,1,2,6,pharmacy technician,1,0,130,68,2,5,2,0,0,1,0,0,TRUE,TRUE,TRUE,TRUE,TRUE,4,0.8456787878796458,0.66,0.030386963367030128,4,0.6322093750000931,0.6758000000000466,1,1,0.008111216360700465,0.00818516580643805,4,0.7044937500003725,0.818724999998929,1,1,0.013675219959709602,0.014701244516203896,1.1442,0.5994,0.5703,0.8987,0.5036,0.6786,0.2775,1.2133056418,0.738293324286,0.5597978860666667,4.346,6.6364,0.3048,6.1752,0.3239,-65.8877,0.999,4.1039,0.514,3.802,0.5623,0.9906,2.268803116,4.34580145,4.780060888,0.4171497902,0.39538598766666666,0.6862,4.6756,0.642,3.3847,0.764,0.9397,0.262,0.25,0.576,0.013,1.698,130.6153846153846,3.1221556906666668,4.416810902666667,3.84745645,0.35232752763333336,0.41572208003333333,386,1.1437037037037037,1,0,0,1,FALSE,FALSE,FALSE
222,2021-11-13T01:54:50Z,2021-11-13T02:32:26Z,2255,1,2021-11-13T02:32:27Z,1,Edge,95.0.1020.44,Windows NT 10.0,1536,864,NA,1.7777777777777777,1531,80,332,105,69,88,1.90595833250669,-0.08907029538134635,-0.459781840244255,0.0051018045636124325,-0.04067866192862343,-0.293514517480637,2,3,3,4,2,2,2,3,1,3,3,1,2,3,2,3,2,2,3,3,0.7591546545162482,0,1,1,3,3,2.25,0,4,4,2,4,2,1,4,2,2,1,2,4,2,4,5,1,1,1,1,1,1,1,1,1,2,0,0,5,5,5,5,5,5,5,5,5,1,5,1,1,4,1,5,1,1,1,2,2,5,1,1,1,2,1,1,2,1,1,5,1,2,1,1,1,1,1,1,1,1.8611727388837298,1.3020130933435712,1,0,1,0,1.8,0,1,0,1.25,0,1,0,1.1428571428571428,0,1,0,1.162162162162162,0,1,0,0,-1.299108281302743,-1.1548854292984765,-0.5341482934814965,-0.8445168613899865,4,2,3,2,2,2,3,1,1,0.7867957924694432,2.2857142857142856,0,1,-0.1339138976503373,5,5,5,4,3,3,1,3,3,4,3,1.4960264830861913,4.285714285714286,0,1.7142857142857142,6,3.8333333333333335,3.2559414990859232,0.9547190977297628,0,0.06324999828222155,3,2,2,2,2,2,5,2,1,3,1,2,1,5,5,1,4,1,4,3,1.5886502207249789,2.2,0,4,0,4.4,0,4.4,0,4.266666666666667,0,1,2,1,4,2,1,2,3,1,1,2,4,2,2,1,4,1,2,1,2,1.050062654772261,1.45,0,"White, Caucasian, Anglo, European American",0,21,1,2,NA,1,2,4,Student,5,0,145,64,2,5,2,0,0,0,0,0,TRUE,TRUE,TRUE,TRUE,TRUE,5,0.9347121951231142,0.82,0.08622242303413777,5,0.4781129032142701,0.5938903225852598,1,0.96875,0.006630503828754568,0.01206177124953195,5,0.680625,0.7447066666483879,1,0.9375,0.021415052255271485,0.013914624800696199,1.6296,0.9972,0.4336,1.309,0.9489,0.5909,0.2524,NA,NA,NA,1.552,5.1446,0.3273,2.8358,0.3305,-58.0704,1.0844,4.9052,0.363,3.6605,0.4524,0.9762,NA,NA,NA,NA,NA,1.5145,3.4377,0.4596,4.1394,0.5544,0.9441,0.071,0.488,0.439,0.018,1.953,108.50000000000001,NA,NA,NA,NA,NA,380,1.125925925925926,1,0,0,1,FALSE,FALSE,FALSE
223,2021-11-13T02:09:30Z,2021-11-13T02:33:44Z,1453,1,2021-11-13T02:33:45Z,1,Chrome,91.0.4472.106,Macintosh,1440,900,"When it asked questions about not knowing if a parent would be home, or when they would get home, my answer was occasionally, but only because my dad is a pilot, so it was hard for me to keep track of when he was coming home from trips... not because there was any instability.",1.6,709,63,339,83,53,81,-0.20606135592950586,-0.24351084670544482,-0.4260821663043371,-0.26299913918534573,-0.2616716161181409,-0.4117540848066085,4,4,1,1,4,1,1,3,1,4,3,1,1,2,4,4,1,1,3,3,1.348488432516786,0,1,1,5,4,1.25,0,5,5,2,5,2,2,4,2,1,1,2,5,2,5,4,2,2,1,1,1,1,2,2,1,2,0,0,5,4,5,5,5,5,5,5,5,1,3,2,4,4,2,5,1,1,2,2,1,5,1,1,1,2,2,1,1,1,1,5,1,1,1,1,1,2,1,1,1,1.7672360122867357,1.5976172734359604,1.5,0,1.25,0,1.5333333333333334,0,1.1111111111111112,0,1.8333333333333333,0,1.1666666666666667,0,0.8571428571428571,0,1,0,1.3513513513513513,0,1,0,0,-0.8704267676681744,-0.9733069721415648,-0.4557470907642554,-0.7145270314529101,4,2,4,1,1,2,1,2,1,1.3451854182690985,1.5714285714285714,0,1.5,-0.3767559860388676,5,5,5,5,3,3,2,7,4,4,4,1.2909944487358056,4.285714285714286,0,1.7142857142857142,3.5,3.8333333333333335,3.2559414990859232,-0.4571894270818581,0,-0.6427042641235889,4,3,4,4,4,4,5,4,3,2,2,3,3,4,4,1,3,2,3,4,1.0600988273786194,3.8,0,3.2,0,3.6,0,3,0,3.2666666666666666,0,1,1,2,4,3,1,3,4,1,1,1,4,1,2,1,4,2,2,1,2,1.190974832912761,1.45,0,"White, Caucasian, Anglo, European American",0,24,1,2,NA,1,3,6,Teacher,2,0,165,66,2,5,2,0,0,1,0,0,TRUE,TRUE,TRUE,TRUE,TRUE,4,0.9206974999979138,0.8,0.06606923626015619,4,0.45753548387365955,0.5297374999970198,0.96875,1,0.0031529122488274325,0.004742376613315845,4,0.6019750000108034,0.6640709677434736,1,0.96875,0.005369578708845973,0.008753958780273569,1.4147,1.0427,0.5255,1.0817,1.1388,0.6627,0.2775,1.443963129,0.9984055119666667,0.5163318675,1.3483,5.4449,0.3407,3.4782,0.3359,-75.0332,0.9422,4.6928,0.361,6.756,0.4649,0.966,1.4573694399666666,3.662748823333333,5.280443742666667,0.32987035606666665,0.33002800883333333,0.8689,5.4176,0.528,3.5077,0.5587,0.9997,0.063,0.464,0.421,0.031,1.787,57.64516129032258,2.053818525,4.322894458666667,3.806251845333333,0.3656777942666667,0.4090801397,374,1.108148148148148,1,0,0,1,FALSE,FALSE,FALSE
224,2021-11-13T02:11:55Z,2021-11-13T02:34:15Z,1339,1,2021-11-13T02:34:17Z,1,Chrome,95.0.4638.69,Windows NT 10.0,1920,1080,NA,1.7777777777777777,619,63,347,114,57,93,-0.43730438751011125,-0.24351084670544482,-0.38756825323014515,0.11477946337000441,-0.2064233775707615,-0.20905768367637165,3,2,2,1,2,1,1,2,1,3,1,1,1,1,2,2,2,1,2,3,0.7326950970650465,0,1,1,5,4,2,0,3,4,4,4,2,1,4,1,1,1,2,3,3,3,4,3,3,1,1,1,3,2,4,1,2,0,0,5,3,5,5,5,5,2,4,3,1,4,1,1,3,1,5,4,4,4,4,4,4,1,1,1,3,1,1,2,1,1,4,3,2,2,1,2,1,1,2,2,1.5299806668193037,1.2344267996967353,2.25,0,1.5,0,2.1333333333333333,0,1.8888888888888888,0,2.5,0,1.3333333333333333,0,1.5714285714285714,0,1.6666666666666667,0,1.972972972972973,0,1,0,0,-0.017266500336630693,-0.12600536555755287,-0.3773458880470143,-0.2516756268022836,5,1,5,1,1,1,1,2,1,1.9518001458970664,1,0,1.5,-0.7186247266594448,5,5,5,4,4,1,1,7,7,NA,3,1.8126539343499315,4.142857142857143,0,1.8571428571428572,2,3.8333333333333335,3.2559414990859232,-1.3043345419688306,0,-0.9866058241456384,3,4,4,3,3,2,4,2,2,2,3,3,3,3,4,3,2,2,3,3,0.7037315505489968,3.4,0,3.2,0,3,0,3.6,0,3.2666666666666666,0,3,1,4,2,3,4,3,1,3,1,1,2,2,2,1,2,2,3,3,3,0.9787209698591858,2.6,0,"White, Caucasian, Anglo, European American",0,24,1,3,NA,1,2,6,unemployed,2,0,265,63,1,5,2,0,0,0,0,0,TRUE,TRUE,TRUE,TRUE,TRUE,2,0.7484000000238419,0.8,0.06706241578795664,2,0.5088000000215346,0.6006387096835721,0.96875,0.96875,0.005094416931383707,0.004418536761143591,2,0.6942125000357627,0.7608964285509927,1,0.875,0.008576504347407126,0.010430953544048282,1.2663,1.0912,0.3962,1.2665,1.2926,0.4145,0.1937,1.309146484,1.0321960700333332,0.3878090422666667,1.2498,3.3407,0.3299,3.8992,0.4483,-63.3172,0.8383,4.2343,0.4184,4.5872,0.5184,0.9705,1.4364740369,4.034754161,3.735133795,0.4324206062666667,0.3193064283,0.6002,3.7862,0.6464,4.425,0.6904,0.8803,0.065,0.526,0.427,0.012,1.618,134.83333333333334,1.71874433,3.356234445,2.2559707036333334,0.4325431405,0.4376260643666667,325,0.9629629629629629,1,0,0,1,FALSE,FALSE,FALSE
225,2021-11-13T02:10:48Z,2021-11-13T02:34:21Z,1413,1,2021-11-13T02:34:23Z,0.8999999761581421,Chrome,95.0.4638.69,Windows NT 10.0,1280,1024,veryyy fun!!! thank you,1.25,669,103,341,84,58,96,-0.3088360366319971,0.1198786858218457,-0.41645368803578914,-0.2508127326513022,-0.19261131793391667,-0.15838358339381242,2,2,4,4,2,2,3,2,2,2,1,2,2,2,2,2,2,2,2,2,0.6958523739384593,1,1,1,2,2,2.8,0,2,4,5,2,5,4,1,5,5,5,3,1,1,1,3,3,4,1,1,2,5,5,5,0,2,0,0,4,2,1,3,3,4,2,4,2,1,4,5,2,2,2,3,5,5,5,5,5,2,3,1,1,1,1,1,1,1,1,2,5,5,1,1,3,1,3,1,1,1.5644319887574043,1.6846647257229665,3.25,0,1.5,0,4.066666666666666,0,3.2222222222222223,0,3.6666666666666665,0,1.6666666666666667,0,2.4285714285714284,0,1.6666666666666667,0,2.891891891891892,0,0,0,0,1.176317321940012,1.5294945977749739,-0.5804383618435307,0.4745281179657216,5,2,4,2,1,1,1,1,1,1.6035674514745464,1.4285714285714286,0,1,-0.6467170085812028,5,5,5,5,3,3,1,5,7,NA,2,1.5735915849388864,4.428571428571429,0,1.5714285714285714,3,3.8333333333333335,3.2559414990859232,-0.7395711320441822,0,-0.8635661140261877,2,2,2,5,3,4,5,2,3,4,3,3,2,3,5,1,5,1,5,2,1.424279266355945,2.8,0,3.6,0,4.6,0,3.8,0,4,0,3,2,4,1,2,4,2,1,4,4,4,2,4,4,2,2,2,4,4,4,1.145931016569864,3.35,0,"White, Caucasian, Anglo, European American",0,25,1,2,NA,1,1,4,stay at home mom,1,0,180,66,2,5,2,0,0,0,0,0,TRUE,TRUE,TRUE,TRUE,TRUE,NA,NA,NA,NA,2,0.5111187499999068,0.5828281250002328,1,1,0.004038863508066193,0.00561266402218366,2,0.6698354838707995,0.7686290322580646,0.96875,0.96875,0.009922706290333493,0.01603590974807067,NA,NA,NA,NA,NA,NA,NA,NA,NA,NA,3.9964,8.3325,0.2713,6.8713,0.292,-84.389,0.9663,5.4962,0.4244,5.581,0.5009,0.9851,1.8824207463333333,4.565155340666666,5.687120927,0.3802430064,0.3499285858,1.1742,4.1102,0.5345,4.3827,0.6332,0.9888,0.112,0.418,0.472,0.012,1.813,151.08333333333331,2.057450736333333,3.642170823333333,2.5101849593333334,0.40818647086666665,0.3660324970666667,488,1.4459259259259258,1,0,0,1,FALSE,FALSE,FALSE
226,2021-11-13T01:59:48Z,2021-11-13T02:34:45Z,2096,1,2021-11-13T02:34:47Z,1,Chrome,95.0.4638.69,Windows NT 10.0,1536,864,NA,1.7777777777777777,678,112,631,314,92,183,-0.2857117334739366,0.20164133064048606,0.9796756609036676,2.552060770178715,0.27699870971880786,1.311165324800405,2,2,1,1,2,1,1,2,1,2,1,1,1,2,2,2,1,1,2,1,0.5104177855340404,0,1,1,2,1,2.15,0,2,3,3,3,3,3,2,4,3,3,3,1,1,2,2,3,4,1,1,2,4,3,3,0,2,0,2,3,2,1,3,3,4,3,3,3,5,3,4,4,2,3,3,3,4,5,5,4,3,3,3,1,3,3,1,1,1,1,4,1,3,2,5,3,1,1,1,1,1.2105641104317713,0.8338093878327919,2.625,0,1,0,3.3333333333333335,0,3.2222222222222223,0,3.9166666666666665,0,2.5,0,1.2857142857142858,0,3.3333333333333335,0,3.027027027027027,0,0,0,2,0.8716172264644607,1.0038269001101612,-0.3843414734796514,0.3097427133152549,3,3,2,3,3,4,3,3,1,0.5773502691896257,3.2857142857142856,0,2,0.8333440732100549,3,2,3,3,2,2,4,3,1,2,1,0.7559289460184544,2.4285714285714284,0,3.5714285714285716,7,3.8333333333333335,3.2559414990859232,1.5194825076544112,0,1.3813546697232235,2,3,2,4,3,2,5,2,2,5,1,5,2,4,4,1,5,2,3,2,1.5118578920369088,2.8,0,4.6,0,4.4,0,4,0,4.333333333333333,0,1,1,3,2,2,3,2,2,1,1,4,2,1,4,3,2,2,4,3,2,1.019545822516343,2.45,0,"Hispanic of Latino (e.g., Mexican American, Central American, and others) & White, Caucasian, Anglo, European American",1,25,1,2,NA,1,1,6,Student,1,0,330,62,1,5,2,0,0,1,0,0,TRUE,TRUE,TRUE,TRUE,TRUE,1,0.9855026315764377,0.76,0.0942921050172971,1,0.4936281250566244,0.6007483871675307,1,0.96875,0.004318765958518769,0.008364279350645001,1,0.7302437499910593,0.774546875,1,1,0.02344674964503584,0.022225762561946992,1.4515,0.8377,0.5106,1.2144,1.0742,0.6256,0.3625,1.4788337433333334,0.8610400699666667,0.5015699296333334,1.0351,4.5264,0.3793,3.5334,0.4601,-80.2781,0.905,5.0731,0.4067,5.2178,0.504,0.9404,1.3012412225333334,3.8030034153333334,4.919709235666667,0.4367082793,0.36279017103333333,1.0323,3.1887,0.5688,2.3227,0.6174,0.9369,0.164,0.382,0.449,0.041,0.951,23.19512195121951,2.5787410343333335,4.1887847376666665,3.6658996993333335,0.4229494993,0.42528304223333335,346,1.0251851851851852,1,0,0,1,FALSE,FALSE,FALSE
227,2021-11-13T02:17:50Z,2021-11-13T02:35:49Z,1078,1,2021-11-13T02:35:50Z,1,Chrome,95.0.4638.69,Macintosh,1792,1120,NA,1.6,606,50,231,58,45,55,-0.4707061587384209,-0.36161244477681426,-0.9460199928059279,-0.5676593025364346,-0.37216809321289956,-0.8509296205887885,2,3,2,3,1,2,2,2,1,1,2,2,1,2,2,2,3,1,1,1,0.6958523739384593,0,1,1,3,1,2.6,0,4,5,2,4,2,1,5,2,1,2,2,4,3,4,5,2,3,1,1,2,3,2,3,0,2,0,0,5,5,5,5,5,5,5,5,5,1,5,3,1,5,2,5,2,3,3,3,2,4,1,1,1,1,1,1,1,1,1,1,1,1,1,1,1,1,1,1,1,1.7958912064001051,1.4375905768565218,2.125,0,1,0,1.7333333333333334,0,1,0,1.9166666666666667,0,1,0,1.4285714285714286,0,1,0,1.4324324324324325,0,0,0,0,-0.43123835418962103,-0.5839199075668012,-0.7372407672780129,-0.6605803374224071,4,1,4,1,1,1,1,1,1,1.4638501094227998,1.2857142857142858,0,1,-0.7321841937363471,5,5,5,5,5,5,1,8,8,6,4,1.5118578920369088,5,0,1,1,3.8333333333333335,3.2559414990859232,-1.869097951893479,0,-1.747013513636583,3,3,3,4,3,4,4,4,3,2,3,3,4,NA,3,3,3,3,4,4,0.6333236937766509,3.2,0,2.8,0,3,0,2.5,1,2.7857142857142856,1,3,3,2,4,2,2,3,3,1,1,2,3,2,1,1,3,1,1,1,2,0.9445132413883326,1.75,0,"White, Caucasian, Anglo, European American",0,28,1,2,NA,1,3,6,Video producer,4,0,120,65,2,5,2,0,0,1,0,0,TRUE,TRUE,TRUE,TRUE,TRUE,2,0.7125236842105851,0.76,0.011891760918397597,2,0.4962000000001242,0.5342827586204071,0.967741935483871,0.9354838709677419,0.0036084853978364875,0.004851351957001301,2,0.6160967741937887,0.7310586206898864,0.96875,0.90625,0.030248626522096256,0.02197715934463918,1.0271,1.2267,0.4819,0.7369,1.7498,0.5868,0.1275,1.0906768632,1.0921593477,0.4744417553333333,1.2925,4.1167,0.3543,2.7556,0.3213,-55.1187,0.747,9.3696,0.4514,6.6997,0.4742,0.9977,1.4038064716666667,3.005894566333333,4.291383484333333,0.31581448576666665,0.3462847675333333,1.3204,2.7751,0.3859,2.5241,0.5025,0.8269,0.067,0.362,0.22,0.011,1.63,148.1818181818182,1.5378249733333333,2.8625395923333334,1.9130990007333333,0.3579125748,0.3747802881333333,440,1.3037037037037038,1,0,1,2,FALSE,FALSE,FALSE
228,2021-11-13T02:16:07Z,2021-11-13T02:37:38Z,1290,1,2021-11-13T02:37:39Z,1,Chrome,95.0.4638.69,Macintosh,1680,1050,"None at the moment, thank you!",1.6,706,45,269,64,63,86,-0.21376945698219268,-0.40703613634272556,-0.7630789057035163,-0.4945408633321733,-0.12355101974969247,-0.3272972510023432,4,4,1,1,4,1,1,4,1,4,3,1,1,2,4,4,1,1,4,4,1.4689774459950382,0,1,1,4,5,1.1,0,4,5,3,5,2,2,5,2,2,1,1,5,2,5,4,2,2,1,1,1,1,3,2,0,3,0,0,5,4,3,3,4,5,5,5,5,1,5,1,1,4,3,2,1,1,1,1,2,5,1,1,1,1,1,1,1,2,2,5,1,1,1,1,1,1,1,1,1,1.6725122711948326,1.5675276256394517,1.625,0,1,0,1.6,0,1.6666666666666667,0,1.5833333333333333,0,0.8333333333333334,0,1.1428571428571428,0,1,0,1.4054054054054055,0,0,0,0,-0.7590536293219384,-0.8677088395412498,-0.7372407672780129,-0.8024748034096314,5,1,4,1,1,1,1,1,1,1.7320508075688772,1.1428571428571428,0,1,-0.8176513788914915,5,5,5,5,4,3,1,6,7,5,3,1.5275252316519468,4.571428571428571,0,1.4285714285714286,2.5,3.8333333333333335,3.2559414990859232,-1.0219528370065065,0,-1.0844279639287866,2,2,1,1,1,1,5,1,1,4,1,5,1,5,5,2,5,2,5,3,1.8309508328682538,1.4,0,4.8,0,4.6,0,4.6,0,4.666666666666667,0,2,1,2,1,1,2,1,2,2,1,1,1,1,2,1,2,2,2,2,1,0.512989176042577,1.9,0,"Hispanic of Latino (e.g., Mexican American, Central American, and others)",0,19,1,2,NA,1,3,4,Substitute Teacher,6,0,141,64,2,5,2,0,0,1,0,0,TRUE,TRUE,TRUE,TRUE,TRUE,5,1.1306166666717756,0.84,0.1954200055366425,5,0.5873312499858439,0.700725806443922,1,1,0.003334253186384315,0.00785358664536801,5,0.7354718750044703,0.8964937500059604,1,1,0.012449267893556578,0.03610095931633496,1.6532,1.0297,0.586,1.5125,1.1688,0.6314,0.0184,1.6370267066666666,0.9795884045333333,0.5766614389,2.9206,7.3799,0.3895,5.6499,0.4423,-79.8733,1.014,6.6067,0.5073,3.789,0.5793,0.969,2.1515647123333332,4.494997943333333,5.795786059666667,0.46436066966666667,0.40606752263333334,1.4313,4.1479,0.5585,2.3244,0.6188,0.9584,0.125,0.462,0.423,0.013,1.731,133.15384615384616,2.8384180686666665,4.825760411,3.2931995466666666,0.4445909796333333,0.4652885154,449,1.3303703703703704,1,0,0,1,FALSE,FALSE,FALSE
229,2021-11-13T02:04:49Z,2021-11-13T02:39:11Z,2062,1,2021-11-13T02:39:13Z,1,Chrome,95.0.4638.54,Macintosh,1440,900,NA,1.6,742,82,533,120,180,351,-0.12127224434995054,-0.07090081875498182,0.5078802257448167,0.18789790257426575,1.4924599577611537,4.148914940623722,2,4,2,1,2,1,3,3,2,3,2,2,1,1,2,2,2,1,2,2,0.7947194142390263,1,1,1,4,4,2.1,0,4,4,2,5,2,1,4,2,2,1,2,5,2,5,5,1,1,1,1,1,1,2,2,5,2,0,0,5,5,5,5,5,5,4,5,4,1,4,1,1,5,1,5,1,1,1,2,2,5,1,3,1,3,1,2,4,4,2,5,1,1,1,1,1,2,2,3,3,1.7612785418843047,1.533747356112131,1.25,0,2.5,0,1.6,0,1.2222222222222223,0,1.25,0,1.5,0,2,0,1,0,1.4594594594594594,0,3,0,0,-0.9586847263576442,-1.0056349064115053,0.3424438704149829,-0.3315955179982612,5,1,4,1,1,2,1,1,1,1.6761634196950514,1.2857142857142858,0,1,-0.7321841937363471,5,5,5,5,3,3,1,7,7,4,4,1.5735915849388864,4.428571428571429,0,1.5714285714285714,2,3.8333333333333335,3.2559414990859232,-1.3043345419688306,0,-1.145947818988512,2,3,2,2,2,2,4,2,2,3,2,4,3,4,3,3,4,1,4,3,0.9611501047232549,2.2,0,4.2,0,3.4,0,3.6,0,3.7333333333333334,0,1,1,2,2,2,2,2,2,1,2,1,3,1,2,1,2,2,2,1,1,0.5871429486123998,1.75,0,"White, Caucasian, Anglo, European American",0,22,1,2,NA,1,3,6,Student and graduate assistant,1,0,131,62,3,5,2,0,1,0,0,1,TRUE,TRUE,TRUE,TRUE,TRUE,1,0.9893949999988079,0.8163265306122449,0.11095581349782109,1,0.4568062499947846,0.5722968749981373,1,1,0.002126288991715513,0.005511995151383017,1,0.6178937500081957,0.7629172413780771,1,0.9354838709677419,0.00440095157294407,0.012453426257434164,1.6282,0.9354,0.4757,1.5748,0.921,0.4826,0.1323,1.6082138996666666,0.9180078523,0.4714727058,3.7126,9.8389,0.2681,6.6721,0.2941,-93.3326,0.8017,6.6463,0.3982,4.4169,0.4939,0.9885,1.6425303339333333,4.37689006,6.325678366666667,0.3879350708666667,0.3333113854,1.0355,4.2982,0.5108,3.7812,0.6224,0.9678,0.069,0.486,0.493,0.012,1.797,149.75,1.997137202,5.235125279,2.4283925206,0.43188038933333334,0.39198270663333334,104,0.3081481481481481,1,0,0,1,FALSE,FALSE,FALSE
230,2021-11-13T02:06:42Z,2021-11-13T02:39:25Z,1962,1,2021-11-13T02:39:26Z,1,Chrome,94.0.4606.104,CrOS x86_64 14150.64.0,1366,768,no,1.7786458333333333,937,60,451,115,213,128,0.37975432407469445,-0.2707650616449916,0.11311261673434965,0.12696586990404798,1.9482579257770334,0.38214015295348597,2,2,3,3,2,4,4,1,1,1,1,3,3,3,1,1,4,3,1,1,1.1516578439248717,0,0,2,3,2,3.4,0,3,3,3,4,2,1,2,3,3,2,3,3,2,3,1,3,3,2,4,2,2,2,3,8,2,2,0,5,1,2,3,2,5,5,5,2,3,2,3,3,3,1,3,3,4,4,5,5,2,3,5,1,3,4,1,3,1,1,4,1,2,2,3,1,1,2,1,1,1.3976599920772768,0.8338093878327919,2.625,0,1.25,0,2.8,0,2.6666666666666665,0,3.4166666666666665,0,3.1666666666666665,0,1.4285714285714286,0,2,0,2.7567567567567566,0,4,2,0,0.7035068289607077,0.6584793867115141,0.5667967458113412,0.6126380662614277,5,1,4,2,1,3,2,1,1,1.5118578920369088,1.7142857142857142,0,1,-0.4757826382709144,1,3,3,3,1,1,3,1,2,2,2,1.0690449676496976,2.142857142857143,0,3.857142857142857,7.5,3.8333333333333335,3.2559414990859232,1.8018642126167355,0,1.6818875170472591,3,3,3,4,2,2,5,3,3,3,2,4,3,4,5,2,5,2,4,2,1.162919151265879,3,0,4.2,0,3.8,0,3.8,0,3.933333333333333,0,3,2,3,1,3,3,1,1,3,3,3,3,3,2,1,3,2,2,2,2,0.8013147091860318,2.5,0,"White, Caucasian, Anglo, European American",0,18,1,2,NA,1,2,3,no job,2,0,100,63,1,5,2,0,0,1,0,0,TRUE,TRUE,TRUE,TRUE,TRUE,2,1.0244161290324503,0.62,0.24425956908448498,2,0.5522290322607564,0.6352700000007947,0.96875,0.9375,0.00882873168318735,0.009135435323383524,2,0.7601124999988824,0.7580531249959022,1,1,0.019128275322221774,0.01372678127898969,1.6874,0.3002,0.3262,1.5462,0.3714,0.4015,0.1181,1.6536494963333332,0.44589799736856667,0.3279823623,1.5069,3.0874,0.3174,2.595,0.3723,-35.4375,0.8314,4.2889,0.4597,3.1779,0.5329,0.9973,1.625587414,2.7928213786666665,3.3511041153333334,0.3630623679,0.3102066351666667,1.1196,2.477,0.5899,3.3038,0.6019,0.9976,0.195,0.356,0.489,0.175,1.708,9.76,2.9414400013333335,3.683002181,4.4934638263333335,0.35789637113333334,0.4364817592,334,0.9896296296296296,1,0,0,1,FALSE,FALSE,FALSE
231,2021-11-13T02:12:17Z,2021-11-13T02:39:39Z,1642,1,2021-11-13T02:39:40Z,0.8999999761581421,Firefox,94.0,Windows NT 10.0,1366,768,NA,1.7786458333333333,775,70,358,151,65,151,-0.036483132770395235,-0.17991767851316898,-0.33461162275313133,0.5656765051296159,-0.09592690047600279,0.7706415884531067,4,4,2,1,1,1,2,3,1,4,1,1,1,1,3,3,3,1,1,2,1.1697953037312037,0,0,1,5,5,1.9,0,5,5,1,5,1,1,5,1,1,1,1,5,1,5,5,1,1,1,1,1,1,1,1,0,2,0,0,5,5,5,5,5,5,3,3,5,2,5,1,1,5,1,5,1,1,1,1,1,5,1,1,1,1,1,1,1,1,1,5,1,1,1,1,1,2,1,1,1,1.8639942259766993,2.065591117977289,1,0,1.25,0,1,0,1.4444444444444444,0,1.0833333333333333,0,0.8333333333333334,0,0.8571428571428571,0,1,0,1.135135135135135,0,0,0,0,-1.3159193210531184,-1.5102991258230931,-0.6588395645607719,-1.0845693451919325,5,1,2,1,1,1,1,1,1,1.4960264830861913,1.4285714285714286,0,1,-0.6467170085812028,5,5,5,5,2,2,3,3,3,2,3,1.4638501094227998,3.857142857142857,0,2.142857142857143,6,3.8333333333333335,3.2559414990859232,0.9547190977297628,0,0.30226299054653183,2,2,2,1,2,1,3,1,1,2,1,3,1,3,5,3,4,1,3,3,1.2909944487358056,1.8,0,4.4,0,3.2,0,4.2,0,3.933333333333333,0,1,1,2,1,2,3,2,1,1,1,2,2,1,3,1,2,1,3,2,1,0.7451598203705946,2.05,0,"White, Caucasian, Anglo, European American",0,20,1,2,NA,1,3,4,Student,2,0,121,68,1,5,2,0,0,1,0,0,TRUE,TRUE,TRUE,TRUE,TRUE,4,0.8106744186046512,0.86,0.019095920000000002,4,0.57525,0.7154838709677419,1,1,0.01690406451612903,0.04083399139784946,4,1.17159375,1.3179666666666667,1,0.9375,0.31962850705645157,0.33897785383064516,1.2776,1.5894,0.5048,0.9017,2.485,0.6502,0.3698,1.3036217013,1.2998220611666667,0.4966542571,1.6517,3.9704,0.3673,2.8732,0.428,-45.941,1.1902,4.3221,0.4154,3.1742,0.5043,0.668,1.8910251733333334,3.073679788,4.193551893,0.4021115502,0.34732030636666666,2.3337,1.328,0.3691,1.271,0.4539,0.8511,0.125,0.378,0.142,0.182,1.835,10.082417582417582,2.4933275846666665,1.6450626243666666,1.3511346301333333,0.3777068274,0.46693062986666667,104,0.3081481481481481,1,0,0,1,FALSE,FALSE,FALSE
232,2021-11-13T02:08:42Z,2021-11-13T02:40:14Z,1892,1,2021-11-13T02:40:15Z,1,Chrome,87.0.4280.88,Macintosh,1440,900,My husband was admitted into an in-patient treatment earlier this week as he was suicidal. It has been a rough week which has had direct impact on my nerves and stress levels. My family life growing up was very calm but my current married life is not due to my husband's mental health issues.,1.6,851,97,494,115,92,89,0.1587887605643382,0.06537025594275213,0.32012489950813117,0.12696586990404798,0.27699870971880786,-0.27662315071978394,2,2,2,2,2,2,3,1,1,1,2,2,2,2,2,1,2,2,1,1,0.5501196042201808,0,1,1,3,1,2.75,0,4,4,3,4,3,2,4,2,3,2,2,4,2,4,4,2,3,1,1,1,2,2,2,3,2,0,0,4,4,4,4,4,5,4,5,5,1,5,3,1,4,2,4,2,2,2,3,3,4,1,1,1,3,1,1,3,3,2,4,3,2,1,1,1,1,1,2,2,1.397122740474849,0.9154754164341269,1.75,0,1.5,0,2.2,0,1.6666666666666667,0,2,0,1.3333333333333333,0,2.142857142857143,0,1,0,1.8108108108108107,0,2,0,0,-0.4291369742208243,-0.3819187134908551,-0.17425341425049792,-0.2780860638706765,5,2,4,2,1,2,2,1,1,1.3972762620115438,1.7142857142857142,0,1,-0.4757826382709144,5,5,5,5,3,3,2,7,7,NA,3,1.2909944487358056,4.285714285714286,0,1.7142857142857142,2,3.8333333333333335,3.2559414990859232,-1.3043345419688306,0,-1.0662768215670753,2,2,2,3,2,2,3,3,2,3,2,4,2,4,4,3,4,2,3,3,0.7988086367179802,2.2,0,4,0,3.2,0,3.6,0,3.6,0,2,2,1,4,2,2,3,3,2,3,3,2,2,4,1,2,1,4,2,3,0.9403246919632545,2.3,0,"White, Caucasian, Anglo, European American",0,29,1,2,NA,1,3,6,Office manager,4,0,95,64,3,5,2,0,0,2,0,0,TRUE,TRUE,TRUE,TRUE,TRUE,3,1.069666363632264,0.88,0.0986212675150723,3,0.554894687498745,0.61652281249917,1,1,0.0031322673699691874,0.004903464824323174,3,0.658517258065272,0.7557115624986182,1,1,0.010733075964217142,0.02526843082956429,1.7991,1.2104,0.5276,1.0431,1.5882,0.8484,0.4681,1.7083871596666667,1.0831016623666667,0.5261355788333333,10,11.6948,0.1274,9.7776,0.1051,-86.5751,0.8263,5.6852,0.486,5.0729,0.548,0.8882,2.175126082,4.609815778,5.860536049666667,0.3844346445,0.3740592808,1.0291,5.5533,0.5621,3.4483,0.6243,0.9659,0.132,0.377,0.453,0.018,1.546,85.8888888888889,2.660654063,4.541969001,3.3933677666666666,0.3680664912666667,0.36462118516666664,422,1.2503703703703704,1,0,0,1,FALSE,FALSE,FALSE
233,2021-11-13T02:21:22Z,2021-11-13T02:40:21Z,1138,1,2021-11-13T02:40:22Z,1,Chrome,95.0.4638.69,Windows NT 10.0,1920,1080,N/A,1.7777777777777777,564,47,333,57,41,61,-0.5786195734760368,-0.38886665971636103,-0.454967601109981,-0.5798457090704782,-0.42741633176027893,-0.74958142002367,2,1,2,2,1,2,4,1,1,2,1,4,1,1,1,1,4,1,1,1,1.0809352675491624,0,0,5,2,1,3,0,3,4,4,3,2,1,3,1,2,1,1,2,2,3,2,3,5,5,5,3,5,3,3,3,3,0,3,4,4,4,4,2,1,5,5,1,1,3,2,1,3,3,4,1,5,5,5,3,1,5,4,1,4,3,3,3,3,3,3,2,1,1,1,3,1,4,1,2,1.429525635846921,1.0327955589886444,4,0,2,0,2.4,0,2.6666666666666665,0,2.8333333333333335,0,3.5,0,2.4285714285714284,0,1.6666666666666667,0,2.7837837837837838,0,2,0,3,1.5755795160114243,1.0890990860138068,0.5118979318815265,0.8004985089476666,5,1,5,1,1,2,1,1,1,1.889822365046136,1.1428571428571428,0,1,-0.8176513788914915,5,5,5,5,4,3,1,6,5,6,4,1.5275252316519468,4.571428571428571,0,1.4285714285714286,3.5,3.8333333333333335,3.2559414990859232,-0.4571894270818581,0,-0.8020462589664623,1,1,1,2,1,1,5,1,1,1,1,5,3,5,3,5,5,1,5,3,1.8516401995451028,1.2,0,5,0,3,0,4.2,0,4.066666666666666,0,4,4,4,4,4,4,4,1,4,4,4,2,3,4,2,2,4,4,1,4,1.0894228312566052,3.45,0,"Hispanic of Latino (e.g., Mexican American, Central American, and others) & Filipino",1,28,1,3,NA,1,3,6,independent contractor,3,0,110,66,1,5,2,0,0,1,0,0,TRUE,TRUE,TRUE,TRUE,TRUE,5,0.6544822222206328,0.9,0.01555185211864936,5,0.42443870967145886,0.4910093749985099,1,1,0.0027545097848164966,0.003966044102519511,5,0.5590906249955296,0.6420166666636864,1,0.9375,0.007960774425874863,0.007670845231631474,1.3095,1.9719,0.3992,0.9309,2.3415,0.5045,0.1737,1.2889915089333333,1.4691066245666666,0.3940625856,2.7157,8.2757,0.2604,6.6703,0.2874,-94.7776,0.9713,5.0416,0.3322,6.275,0.4134,0.9968,1.5362678267666667,4.716870238333334,6.010601807666666,0.3327229138666667,0.30219749646666666,0.9414,3.7809,0.443,4.4246,0.5339,0.9706,0.071,0.417,0.581,0.019,2.02,106.31578947368422,1.7192318513333333,4.870545198333334,2.554685052,0.385862339,0.3249122282,358,1.0607407407407408,1,0,1,2,FALSE,FALSE,FALSE
234,2021-11-13T02:18:59Z,2021-11-13T02:40:35Z,1295,1,2021-11-13T02:40:36Z,0.8999999761581421,Safari,14.1,Macintosh,1440,900,NA,1.6,630,108,305,84,60,66,-0.4090413503169261,0.16530237738775702,-0.5897662968696528,-0.2508127326513022,-0.16498719866022699,-0.6651245862194046,3,2,2,1,3,1,2,3,1,2,2,2,1,2,3,2,2,1,2,2,0.6863327411532597,0,1,2,3,3,2.05,0,4,5,2,5,2,1,4,2,2,2,1,4,2,5,4,2,2,1,1,1,1,1,1,0,2,0,0,5,1,4,4,4,4,4,4,3,2,4,2,1,3,2,5,1,1,1,1,1,4,1,1,1,1,1,1,1,1,1,5,1,1,1,1,1,1,1,1,1,1.5002502293786697,1.4638501094227998,1.25,0,1,0,1.6666666666666667,0,2.3333333333333335,0,1.5,0,1,0,0.8571428571428571,0,1,0,1.5135135135135136,0,0,0,0,-0.9250626468568939,-0.9537553472238163,-0.7372407672780129,-0.8454980572509145,5,2,4,1,1,2,1,1,1,1.6035674514745464,1.4285714285714286,0,1,-0.6467170085812028,5,5,5,5,4,4,1,7,7,3,4,1.4638501094227998,4.714285714285714,0,1.2857142857142858,2,3.8333333333333335,3.2559414990859232,-1.3043345419688306,0,-1.3052898138313853,1,1,2,3,2,2,5,2,2,3,1,4,1,4,4,4,4,1,4,4,1.3627702877384937,1.8,0,4.4,0,3.8,0,3.6,0,3.933333333333333,0,2,4,2,2,1,2,2,2,2,3,3,3,2,3,1,3,1,3,2,1,0.8335087534664907,2.2,0,"White, Caucasian, Anglo, European American",0,19,1,2,NA,1,4,3,Student,3,0,140,65,3,5,2,0,0,1,0,0,TRUE,TRUE,TRUE,TRUE,TRUE,2,0.6201081081081097,0.7551020408163265,0.026753752551019833,2,0.44229032258064516,0.480064516129036,0.96875,0.96875,0.004234435483870781,0.00683478931451541,2,0.5645806451612885,0.6789230769230702,0.96875,0.8125,0.012001361895160555,0.01785941028225734,1.0159,1.1417,0.3886,0.9338,1.4126,0.409,0.0976,1.0779877740333332,1.0513955230666667,0.38094459076666665,1.0404,4.0444,0.3215,3.5391,0.3409,-75.5592,0.9032,4.2183,0.3378,3.076,0.357,0.7859,1.1470193656,3.7434281746666667,4.283401913,0.3342159530666667,0.3147377075,0.9725,4.9997,0.4589,1.898,0.5089,0.9256,0.054,0.403,0.34,0.006,1.304,217.33333333333334,1.2623744954333334,2.9489351335333334,1.6347858616333333,0.3488787911333333,0.3805872583666667,431,1.2770370370370372,1,0,0,1,FALSE,FALSE,FALSE
235,2021-11-13T02:08:34Z,2021-11-13T02:42:25Z,2030,1,2021-11-13T02:42:25Z,1,Chrome,95.0.4638.69,Windows NT 10.0,1920,1080,"For context, most of the questions were answered about my stepfather, not my birth father. My mom and birth father split when I was under age 1, and my stepfather has been around since I was 3. That's why there were issues with custody, they had to do with my birth father. Most of them I answered with my stepfather in mind.",1.7777777777777777,695,98,590,106,97,106,-0.2420324941753778,0.07445499425593438,0.7822918563984341,0.017288211097655985,0.34605900790303207,0.010530084214718316,2,4,2,1,2,1,1,2,1,3,3,1,1,1,4,3,1,1,3,2,1.050062654772261,0,1,1,5,4,1.65,0,1,3,2,3,2,1,4,2,1,1,1,4,3,4,2,3,1,2,4,2,1,4,2,7,2,0,0,4,1,1,1,1,5,3,5,2,3,4,1,1,1,1,1,5,1,1,2,4,4,1,1,3,4,2,1,5,2,2,3,4,2,1,3,1,4,2,2,2,1.4570940680419788,1.162919151265879,2.375,0,2.5,0,2.2666666666666666,0,3.4444444444444446,0,2.5833333333333335,0,2,0,2.5714285714285716,0,1.6666666666666667,0,2.675675675675676,0,4,0,0,0.4975715920186112,0.28699851327429293,0.5455363442114993,0.41626742874289613,5,1,3,1,1,2,1,1,1,1.5275252316519468,1.4285714285714286,0,1,-0.6467170085812028,3,4,5,2,1,1,2,3,3,2,2,1.5118578920369088,2.857142857142857,0,3.142857142857143,6,3.8333333333333335,3.2559414990859232,0.9547190977297628,0,0.8599599724965891,3,5,2,2,3,3,1,4,2,1,3,3,2,1,4,5,3,1,1,4,1.3557637102737474,3,0,3.4,0,1.6,0,2.6,0,2.533333333333333,0,1,1,2,3,4,2,2,2,1,1,1,2,3,3,1,2,1,2,4,3,0.998683343734455,2.15,0,"White, Caucasian, Anglo, European American",0,23,1,2,NA,1,3,6,Data entry editor,4,0,200,67,1,5,2,0,0,0,0,0,TRUE,TRUE,TRUE,TRUE,TRUE,4,0.9634609756106284,0.82,0.12097707296318083,4,0.4173193548389019,0.49880333333363136,0.96875,0.9375,0.004922165070588962,0.005967858709707,4,0.5869312499999069,0.6588899999981125,1,0.9375,0.0093539344756045709,0.007853179102718384,1.4616,1.047,0.5355,1.4225,1.1637,0.5292,0.0376,NA,NA,NA,1.2777,3.0971,0.2202,3.1156,0.3168,-50.2364,0.732,4.2208,0.3516,3.9531,0.4188,0.9792,NA,NA,NA,NA,NA,0.84,3.0573,0.4774,3.2508,0.5619,0.8887,0.075,0.407,0.477,0.018,2.168,120.44444444444446,NA,NA,NA,NA,NA,432,1.28,1,0,1,2,FALSE,FALSE,FALSE
236,2021-11-13T02:01:44Z,2021-11-13T02:42:49Z,2464,1,2021-11-13T02:42:51Z,1,Edge,95.0.1020.44,Windows NT 10.0,1600,900,NA,1.7777777777777777,793,92,569,120,65,117,0.009765473545725838,0.01994656437684081,0.6811928345786803,0.18789790257426575,-0.09592690047600279,0.19633511858410213,2,2,2,2,1,1,3,2,1,2,4,1,1,1,2,3,1,1,2,3,0.8750939799154206,0,1,2,4,2,2.05,0,2,4,5,2,5,4,3,5,5,2,4,2,2,3,3,4,4,5,3,1,4,5,3,7,1,2,0,4,2,3,4,4,4,1,3,2,1,4,5,1,3,3,5,5,5,5,5,1,1,4,3,1,5,1,1,3,2,2,3,5,3,1,3,1,2,3,2,1,1.5082356496167217,1.2421180068162376,3.625,0,2,0,3.6666666666666665,0,3,0,3.0833333333333335,0,3,0,2.5714285714285716,0,1.6666666666666667,0,2.891891891891892,0,4,2,0,1.4095704984764685,1.5187508830924488,0.8020003539630645,1.1603756185277567,5,1,3,1,1,2,2,1,1,1.4638501094227998,1.5714285714285714,0,1,-0.5612498234260587,3,4,5,3,1,1,4,3,3,1,1,1.5275252316519468,2.7142857142857144,0,3.2857142857142856,6,3.8333333333333335,3.2559414990859232,0.9547190977297628,0,0.9396309699180257,2,2,2,2,2,2,4,2,2,3,1,4,1,4,3,4,4,1,3,2,1.1751393027860062,2,0,4.4,0,3.4,0,3.8,0,3.8666666666666667,0,1,2,1,4,3,1,4,3,1,1,1,3,3,1,1,4,1,1,1,4,1.2763022245616642,1.65,0,"White, Caucasian, Anglo, European American",0,30,1,2,NA,1,2,6,Youth Justice,2,0,150,70,1,5,2,0,0,0,0,0,TRUE,TRUE,TRUE,TRUE,TRUE,6,0.7886268292636406,0.8367346938775511,0.055620091524215515,6,0.5730062500238419,0.625453125,1,1,0.0020025522190909232,0.0035778819231876255,6,0.6352937500029803,0.704393750011921,1,1,0.004009750284980689,0.00630877866434605,1.2041,1.3703,0.5362,0.9837,1.2441,0.606,0.1867,1.2586763356,1.1882361668333334,0.5250160126,9.9999,14.0289,0.2166,11.1484,0.177,-100.9895,0.8733,8.6921,0.5218,7.0941,0.564,0.979,2.1887692393333333,4.952281305666666,6.755457986666666,0.40964058093333333,0.4178720918,0.7045,4.6568,0.58,3.8683,0.6277,0.7615,0.093,0.464,0.53,0.023,1.757,76.39130434782608,2.370012780666667,5.484243034,5.080209312666667,0.4254809347,0.47955070213333334,368,1.0903703703703704,1,0,0,1,FALSE,FALSE,FALSE
237,2021-11-13T01:46:18Z,2021-11-13T02:43:05Z,3407,1,2021-11-13T02:43:06Z,1,Chrome,87.0.4280.141,Macintosh,1440,900,Thank you for allowing me to participate!,1.6,1682,259,429,127,595,232,2.2939327521585944,1.537097862678279,0.007199355780321893,0.27320274831257063,7.224464707051762,2.1388422960822058,2,2,1,1,1,1,2,2,1,3,1,1,1,3,2,2,1,1,1,2,0.6863327411532597,0,1,2,3,1,2.25,0,4,4,2,4,3,1,4,1,1,1,1,4,1,4,2,2,2,1,1,1,3,1,2,2,2,0,5,4,2,2,2,3,4,2,4,2,1,4,2,1,3,2,2,1,1,1,1,1,3,3,1,1,2,1,1,1,1,1,4,1,1,1,1,1,2,3,3,1,1.0842857905901357,1.4074631010979937,1.625,0,2.25,0,1.8,0,3.2222222222222223,0,1.6666666666666667,0,1.6666666666666667,0,1,0,1,0,1.9189189189189189,0,1,0,5,-0.4396438740648087,-0.5610774150886396,0.7401059546006128,0.08951426975598659,4,2,2,1,2,3,2,3,1,0.9511897312113419,2.2857142857142856,0,2,0.2350737771240448,4,5,5,4,2,3,2,8,4,NA,3,1.2724180205607036,3.857142857142857,0,2.142857142857143,3,3.8333333333333335,3.2559414990859232,-0.7395711320441822,0,-0.5448821243404407,3,2,3,4,3,2,4,1,1,2,1,2,1,4,4,2,3,1,4,4,1.2983506020002016,3,0,3.8,0,3.8,0,4,0,3.8666666666666667,0,2,1,3,3,2,3,2,2,3,2,3,1,3,4,1,2,2,1,1,1,0.9119095061289915,2.3,0,Black or African American,0,25,1,2,NA,1,3,7,Direct Care Staff,1,0,240,67,2,5,2,0,0,2,0,0,TRUE,TRUE,TRUE,TRUE,TRUE,NA,NA,NA,NA,4,0.7549893548383543,0.8192779310323611,1,0.9666666666666667,0.07044758764620904,0.05610120158792292,NA,NA,NA,NA,NA,NA,NA,NA,NA,NA,NA,NA,NA,NA,NA,NA,NA,1.9795,2.342,0.3324,2.3088,0.4082,-6.4108,1.5138,1.9392,0.4093,2.7915,0.5291,0.9654,2.0659297463333335,2.4051512183333332,2.505313763,0.3922839311333333,0.3228095405,NA,NA,NA,NA,NA,NA,NA,NA,NA,NA,NA,NA,NA,NA,NA,NA,NA,104,0.3081481481481481,1,0,1,2,FALSE,FALSE,FALSE
238,2021-11-13T02:04:18Z,2021-11-13T02:43:18Z,2339,1,2021-11-13T02:43:18Z,1,Chrome,95.0.4638.54,Macintosh,1440,900,Thank you for letting me take part in this survey! Have a great weekend!,1.6,1129,473,387,98,74,91,0.8730727914466526,3.4812318616992832,-0.19499868785918564,-0.08020304117469244,0.028381636255600768,-0.2428404171980778,3,3,2,1,3,1,2,2,1,3,2,2,3,2,3,3,2,1,3,3,0.7863975156570492,1,1,2,4,4,1.95,0,3,4,3,4,3,3,4,3,2,2,2,4,2,4,1,2,2,1,1,2,3,3,3,0,2,0,0,4,2,3,3,2,4,4,4,2,3,3,4,1,4,1,4,3,3,4,4,4,3,1,1,1,3,3,1,1,1,1,4,3,2,1,1,2,2,2,1,1,1.2142794054394872,0.9611501047232549,2.125,0,1.5,0,2.533333333333333,0,2.888888888888889,0,2.8333333333333335,0,1.8333333333333333,0,1.4285714285714286,0,1.3333333333333333,0,2.3513513513513513,0,0,0,0,0.14033699732313704,0.1547830695235775,-0.5804383618435307,-0.2128276461599766,4,1,3,1,1,1,1,1,1,1.2535663410560174,1.4285714285714286,0,1,-0.6467170085812028,4,4,4,4,2,2,3,7,6,2,3,0.9511897312113419,3.2857142857142856,0,2.7142857142857144,2.5,3.8333333333333335,3.2559414990859232,-1.0219528370065065,0,-0.3673889871358558,2,2,3,3,3,3,3,3,2,2,1,4,3,3,4,3,3,2,4,4,0.8837151016885368,2.6,0,3.8,0,3,0,3.2,0,3.3333333333333335,0,2,3,1,3,1,1,2,3,1,2,2,4,2,2,1,4,1,1,1,2,0.998683343734455,1.55,0,"White, Caucasian, Anglo, European American",0,21,1,2,NA,1,3,4,Fine Arts Center staff,2,0,160,69,3,5,2,0,1,1,0,1,TRUE,TRUE,TRUE,TRUE,TRUE,3,0.9257973684072495,0.76,0.12057794890823108,3,0.4225437499880791,0.5058406250178814,1,1,0.003116290925606605,0.002508605069581655,3,0.6113812500089407,0.6897124999985099,1,1,0.0077185377040995705,0.008285146286663584,1.7241,0.7397,0.3581,1.2224,0.7829,0.5616,0.1391,1.6778960686666666,0.7721126702333333,0.35814740586666666,1.7482,6.8516,0.295,6.7118,0.3756,-104.7027,0.5179,5.405,0.3813,5.9629,0.4684,0.9938,1.3742943997666666,5.373984715,5.678480181666667,0.3847667213666667,0.3060997289,0.9316,4.1042,0.5178,4.3428,0.586,0.8849,0.151,0.346,0.56,0.017,1.555,91.4705882352941,2.7289444603333335,4.465542068,4.867209695333333,0.307701095,0.41675621156666665,434,1.285925925925926,1,0,0,1,FALSE,FALSE,FALSE
239,2021-11-13T02:18:44Z,2021-11-13T02:44:02Z,1517,1,2021-11-13T02:44:02Z,1,Chrome,95.0.4638.69,Macintosh,1280,800,I do not have any feedback.,1.6,738,68,373,94,70,109,-0.13154971242019967,-0.1980871551395335,-0.2623980357390215,-0.12894866731086665,-0.026866602291778594,0.06120418449727754,4,4,1,2,4,1,3,4,1,2,4,1,1,1,4,4,1,1,4,4,1.4317821063276353,0,0,1,3,2,1.25,0,4,4,2,4,3,2,1,3,1,1,4,4,3,3,3,1,4,1,1,1,2,4,1,0,2,1,1,4,2,4,4,3,5,3,3,3,1,4,1,1,5,3,5,4,3,2,5,5,1,5,1,1,2,1,1,1,2,1,4,2,3,1,2,1,1,1,1,1,1.4917188827742394,1.1464230084422218,1.875,0,1,0,2.533333333333333,0,2.5555555555555554,0,2.4166666666666665,0,2.3333333333333335,0,1.5714285714285714,0,1.3333333333333333,0,2.2432432432432434,0,0,1,1,-0.08240927936933427,8.866159630821409e-4,-0.35415791278580844,-0.17663564841136314,4,2,2,1,1,2,1,1,1,1.0690449676496976,1.8571428571428572,0,1,-0.39031545311577004,4,4,4,4,3,3,3,7,7,NA,3,0.5345224838248488,3.5714285714285716,0,2.4285714285714284,2,3.8333333333333335,3.2559414990859232,-1.3043345419688306,0,-0.6679218344598915,2,3,3,3,2,2,5,1,3,3,1,5,1,4,3,1,4,1,5,3,1.5675276256394517,2.6,0,4.6,0,4.6,0,3.6,0,4.266666666666667,0,2,1,1,4,3,1,2,3,1,3,3,4,1,2,1,4,1,2,3,2,1.105012502906165,1.7,0,"Black or African American & White, Caucasian, Anglo, European American",1,28,1,2,NA,1,4,6,recruiter,5,0,133,63,3,5,2,0,0,1,0,0,TRUE,TRUE,TRUE,TRUE,TRUE,3,1.0176128205141195,0.78,0.0657823271676161,3,0.4940656249993481,0.5690967741930677,1,1,0.0018558849093099673,0.004032065656008508,3,0.7163656250028871,0.7935838709694724,1,0.96875,0.014094322973514577,0.012728039022174661,1.4418,0.9315,0.6469,1.1072,0.8204,0.7809,0.2284,1.4811735343333334,0.9250465401666667,0.6336899104333333,10,13.9973,0.1369,10.7711,0.1049,-97.9907,0.7984,6.7818,0.4356,5.4781,0.5004,0.961,1.9129970456666667,4.829984451666666,6.517768108666667,0.376070007,0.353751057,0.9724,2.6502,0.5859,3.7641,0.678,0.958,0.099,0.442,0.389,0.011,1.598,145.27272727272728,2.3123965786666667,3.7152084826666667,3.262674527666667,0.4024898658,0.4537606989,370,1.0962962962962963,1,0,0,1,FALSE,FALSE,FALSE
240,2021-11-13T02:23:21Z,2021-11-13T02:44:02Z,1240,1,2021-11-13T02:44:03Z,1,Edge,95.0.1020.44,Windows NT 10.0,1920,1080,NA,1.7777777777777777,641,68,282,58,54,94,-0.380778313123741,-0.1980871551395335,-0.7004937969579544,-0.5676593025364346,-0.24785955648129604,-0.19216631691551858,3,2,3,3,2,2,4,2,2,2,2,3,3,2,2,1,2,1,1,2,0.7677718959499145,0,0,2,2,1,2.8,0,1,2,5,2,5,5,1,5,4,5,5,2,1,1,1,5,5,4,3,5,5,5,5,3,2,0,0,1,1,3,2,2,2,3,4,3,4,3,4,2,3,4,1,5,5,5,5,5,1,1,1,1,3,1,4,2,3,3,2,5,4,2,2,4,4,5,2,2,1.3976599920772768,1.8516401995451028,4.625,0,3.25,0,4.466666666666667,0,3.6666666666666665,0,4.166666666666667,0,1.8333333333333333,0,3.4285714285714284,0,2.6666666666666665,0,3.4594594594594597,0,2,0,0,2.3846108039982328,2.5362097005942914,0.3745550047701899,1.4553823526822407,3,3,1,2,2,4,4,3,2,1.1126972805283737,3.2857142857142856,0,2.5,1.017837910597246,4,4,3,1,3,1,3,4,4,2,2,1.2535663410560174,2.7142857142857144,0,3.2857142857142856,5,3.8333333333333335,3.2559414990859232,0.38995568780511447,0,0.6572492649557016,5,5,5,5,5,5,4,3,4,2,1,3,4,3,5,1,5,1,3,2,1.4375905768565218,5,0,3.8,0,3.2,0,3.4,0,3.466666666666667,0,2,4,2,3,4,3,2,3,2,3,3,2,1,2,1,3,1,3,4,2,0.9459053029269173,2.4,0,"White, Caucasian, Anglo, European American",0,21,1,1,NA,1,3,4,Agricultural Worker,3,0,134,62,3,5,2,0,0,1,0,0,TRUE,TRUE,TRUE,TRUE,TRUE,2,0.8516031249989755,0.64,0.019855455203991745,2,0.5312645161300897,0.6135806451612903,0.96875,0.96875,0.005594821925409284,0.011031281129233402,2,0.6608806451602328,0.740516129030816,1,0.96875,0.015291983612698519,0.012652952903174218,1.0765,0.6551,0.6107,0.9439,0.4777,0.6609,0.1186,1.1615669692666666,0.7284067523043334,0.5775372596666667,1.1158,4.1225,0.4057,2.7518,0.4199,-61.8772,1.2342,4.73,0.3969,4.0891,0.4641,0.9628,1.324326637,3.092118334,4.362521201,0.4038096498,0.3887255164333333,1.207,2.5246,0.4677,4.3068,0.5996,0.9621,0.084,0.435,0.406,0.013,1.689,129.92307692307693,2.165606081,3.9688891406666666,3.152174046333333,0.38672001423333335,0.4093781948,342,1.0133333333333332,1,0,0,1,FALSE,FALSE,FALSE
241,2021-11-13T02:22:28Z,2021-11-13T02:45:40Z,1392,1,2021-11-13T02:45:42Z,0.8999999761581421,Chrome,95.0.4638.69,Windows NT 10.0,1366,768,I think it was a fun and unique experience. For some reason those mini games stressed me out.,1.7786458333333333,703,68,325,65,59,90,-0.22147755803487953,-0.1980871551395335,-0.4934815141841729,-0.4823544567981297,-0.17879925829707183,-0.2597317839589309,2,2,4,3,1,2,1,1,2,1,2,3,3,4,2,1,3,2,3,1,0.9880869341680844,0,1,1,3,4,3.05,0,4,4,2,4,4,3,2,2,3,2,1,3,2,4,3,3,1,1,1,2,3,3,1,0,2,0,0,4,2,2,4,4,4,5,5,5,3,5,4,1,3,1,5,2,3,3,4,3,5,1,1,1,1,1,1,1,1,1,4,2,1,1,2,1,2,2,2,2,1.551904767828364,0.990430401872025,1.875,0,2,0,2.466666666666667,0,2.111111111111111,0,2.4166666666666665,0,0.8333333333333334,0,1.1428571428571428,0,1.3333333333333333,0,1.8108108108108107,0,0,0,0,-0.3513859153753388,-0.21360051679796055,-0.4236359564090485,-0.3186182366035045,5,1,3,1,1,1,1,1,1,1.5735915849388864,1.2857142857142858,0,1,-0.7321841937363471,3,3,3,3,1,1,3,3,3,1,1,0.9759000729485332,2.4285714285714284,0,3.5714285714285716,6,3.8333333333333335,3.2559414990859232,0.9547190977297628,0,1.0989729647608995,2,3,3,2,3,3,4,3,4,3,1,4,2,3,4,4,4,3,4,4,0.8997354108424374,2.6,0,3.8,0,3.4,0,2.8,0,3.3333333333333335,0,1,1,1,3,2,1,3,4,1,1,2,4,2,1,1,4,1,1,2,1,1.1367080817685316,1.35,0,"Hispanic of Latino (e.g., Mexican American, Central American, and others)",0,21,0,1,NA,1,2,5,hotel clerk,1,0,150,72,2,5,2,0,0,3,0,0,TRUE,TRUE,TRUE,TRUE,TRUE,2,0.9006148936170887,0.94,0.08731398942447088,2,0.5354906249999185,0.6131533333333209,1,0.9375,0.002633995715728666,0.004644123538317816,2,0.6784031249999826,0.7739093749999884,1,1,0.020390248699619265,0.006621515070567468,1.7971,1.7144,0.4363,1.5872,1.9912,0.5086,0.1937,1.638763211,1.3670648502333334,0.4391288615,1.0989,4.5851,0.4157,3.4302,0.4687,-77.5887,0.732,6.7223,0.4853,5.3088,0.5401,0.9552,1.3426542171333333,3.6753649166666666,4.925855439333334,0.4479501053666667,0.4006954819333333,1.0842,2.7955,0.5044,4.5008,0.6596,0.9893,0.18,0.341,0.564,0.009,1.495,166.11111111111114,2.6806417373333336,4.017199523666667,4.866070383333334,0.3444646389666667,0.5054030555333333,104,0.3081481481481481,1,1,1,2,FALSE,FALSE,FALSE
242,2021-11-13T02:06:03Z,2021-11-13T02:45:57Z,2393,1,2021-11-13T02:45:57Z,1,Chrome,95.0.4638.69,Windows NT 10.0,1536,864,"No comments, thank you.",1.7777777777777777,1227,81,668,157,104,94,1.1248707591677563,-0.07998555706816408,1.1578025088718051,0.6387949443338773,0.44274342536094596,-0.19216631691551858,3,4,1,1,3,1,1,4,1,4,3,1,1,1,3,4,1,2,4,3,1.3018205875255096,0,0,4,5,5,1.3,0,3,5,2,4,2,2,1,3,2,1,2,4,5,3,4,2,4,1,1,2,3,3,2,0,3,2,0,5,2,1,5,5,4,1,1,3,2,5,5,1,2,3,4,5,2,2,2,1,3,5,1,1,2,1,1,1,5,5,5,1,1,1,1,2,1,2,3,2,1.6725122711948326,1.3020130933435712,2.25,0,2,0,2.466666666666667,0,3,0,2.5,0,2,0,2,0,1.3333333333333333,0,2.4054054054054053,0,0,2,0,0.2517101356693733,0.20308139048375845,-0.010369541223001058,0.0963559246303787,3,3,2,3,1,4,5,5,3,1.2909944487358056,3.2857142857142856,0,4,1.5713194227588192,5,5,5,5,3,3,1,3,2,3,3,1.5735915849388864,4.428571428571429,0,1.5714285714285714,6.5,3.8333333333333335,3.2559414990859232,1.237100802692087,0,0.12476985334194696,2,2,2,1,2,2,4,3,2,5,4,2,1,3,3,2,3,1,2,3,1.1126972805283737,1.8,0,3.2,0,4,0,3.2,0,3.466666666666667,0,2,4,1,3,1,1,2,1,1,1,1,3,2,1,1,3,1,1,1,2,0.9333020044867296,1.65,0,"Hispanic of Latino (e.g., Mexican American, Central American, and others)",0,19,0,1,NA,1,3,4,Full time student,3,0,145,69,3,5,2,0,0,1,0,0,TRUE,TRUE,TRUE,TRUE,TRUE,4,0.9238948717965529,0.7959183673469388,0.03817075514506781,4,0.40530645161290324,0.49132187500130386,1,1,0.0011468132904558566,0.0019122546674802778,4,0.5605906249992549,0.6586593749979511,1,1,0.009375988619329338,0.0121988779738501,1.4049,1.0646,0.5479,1.0737,1.1171,0.6909,0.1913,1.436572606,1.0128380147333333,0.5383823848666667,2.5843,10.8809,0.2866,8.749,0.3436,-121.2752,0.6761,6.9409,0.3554,8.1563,0.4499,0.9652,1.3264091898,5.49168061,6.935305874,0.37747645723333334,0.31760708326666665,1.0885,3.1971,0.4148,3.2969,0.5083,0.8932,0.151,0.274,0.546,0.017,1.81,106.47058823529412,2.183792045,4.435992541333333,4.140729364,0.31645395006666666,0.40000007213333333,350,1.0370370370370372,1,0,0,1,FALSE,FALSE,FALSE
243,2021-11-13T02:27:37Z,2021-11-13T02:46:57Z,1159,1,2021-11-13T02:46:58Z,1,Chrome,95.0.4638.69,Windows NT 10.0,1536,1024,NA,1.5,756,38,221,24,15,61,-0.0853011061040786,-0.4706293045350014,-0.9941623841486678,-0.9819971246939154,-0.7865298823182448,-0.74958142002367,2,1,3,3,2,2,1,2,3,3,1,3,2,1,2,3,2,2,3,3,0.7677718959499145,0,1,2,4,2,2.5,0,4,4,3,3,4,2,2,3,3,4,2,2,3,4,4,2,3,1,1,1,2,3,1,3,2,0,0,4,3,3,3,3,4,3,4,4,3,4,2,1,4,3,4,4,4,2,4,4,3,1,1,1,3,1,1,3,4,4,4,3,2,1,2,1,3,1,3,2,1.166988372633533,0.8338093878327919,1.75,0,2.25,0,2.8666666666666667,0,2.5555555555555554,0,2.75,0,1.5,0,2.5714285714285716,0,1.3333333333333333,0,2.4054054054054053,0,2,0,0,-0.05929409971256879,0.16010653175365794,0.06095019390122543,0.11052836282744169,4,2,4,1,1,1,3,1,1,1.3801311186847085,1.7142857142857142,0,1,-0.4757826382709144,4,3,4,4,2,2,1,6,6,3,3,1.2149857925879117,3.4285714285714284,0,2.5714285714285716,3,3.8333333333333335,3.2559414990859232,-0.7395711320441822,0,-0.3058691320761303,3,4,3,2,2,3,3,2,2,3,4,3,3,3,5,4,4,3,3,4,0.7988086367179802,2.8,0,3,0,2.8,0,3.6,0,3.1333333333333333,0,2,3,2,2,3,3,3,3,2,2,3,4,2,3,3,2,3,2,3,4,0.6569466853317864,2.6,0,"White, Caucasian, Anglo, European American",0,19,1,2,NA,1,3,4,Student,3,0,120,65,2,5,2,0,0,1,0,0,TRUE,TRUE,TRUE,TRUE,TRUE,2,0.6879358974297841,0.78,0.03181262677965995,NA,NA,NA,NA,NA,NA,NA,2,0.46676451613826136,0.5624047619161152,0.96875,0.65625,0.0029551118941138817,0.012494103702223524,1.4463,0.9557,0.2873,0.906,1.0682,0.5269,0.2664,1.4556544223333334,0.9412094874,0.28438910553333335,NA,NA,NA,NA,NA,NA,NA,NA,NA,NA,NA,NA,NA,NA,NA,NA,NA,0.9077,7.4065,0.4046,1.2669,0.3666,0.8607,0.05,0.351,0.391,0.015,2.084,138.93333333333334,1.0468648273666668,4.093595151,0.9617237617007667,0.3491684117666667,0.28711837626666664,474,1.4044444444444446,1,0,0,1,FALSE,FALSE,FALSE
244,2021-11-13T02:22:29Z,2021-11-13T02:47:07Z,1478,1,2021-11-13T02:47:08Z,1,Chrome,95.0.4638.54,Macintosh,1440,900,"No, but this was an enjoyable study to participate in",1.6,758,66,357,62,48,97,-0.08016237206895403,-0.21625663176589804,-0.3394258618874053,-0.5189136764002604,-0.3307319143023651,-0.14149221663295936,3,3,1,2,3,1,2,2,1,3,3,1,1,1,3,3,1,1,3,3,0.9445132413883326,0,1,2,4,4,1.65,0,5,5,1,4,1,1,5,1,1,1,1,4,1,3,4,1,1,1,1,1,2,1,1,6,2,0,0,5,5,5,5,4,5,5,5,5,1,1,1,1,3,3,4,1,1,3,5,5,5,1,1,1,5,1,1,5,5,5,5,1,1,1,1,1,2,1,4,4,1.8995020684663937,1.7674302033770737,1.125,0,2.75,0,1.3333333333333333,0,1.1111111111111112,0,2.5833333333333335,0,1.5,0,2.5714285714285716,0,1,0,1.972972972972973,0,3,0,0,-0.7170260299460003,-0.953271396111991,0.420845073132224,-0.2662131614898835,5,1,5,1,1,1,1,1,1,1.9518001458970664,1,0,1,-0.9031185640466358,5,5,5,5,3,3,3,3,6,4,4,1.0690449676496976,4.142857142857143,0,1.8571428571428572,4.5,3.8333333333333335,3.2559414990859232,0.10757398284279028,0,-0.28065156173982786,1,1,1,1,1,1,5,1,1,4,1,5,1,4,5,1,5,2,5,2,1.8464895909600492,1,0,4.8,0,4.8,0,4.6,0,4.733333333333333,0,1,1,1,3,1,1,1,3,3,2,2,4,1,1,1,3,1,1,1,1,0.9880869341680844,1.35,0,"White, Caucasian, Anglo, European American",0,25,1,2,NA,1,4,5,nurse,4,0,114,65,1,5,2,0,0,1,0,0,TRUE,TRUE,TRUE,TRUE,TRUE,2,1.4943781249970198,0.6666666666666666,0.37423102934302727,2,0.512428571407284,0.5970689655049094,0.9655172413793104,1,0.008421876624199092,0.01837147078718575,2,0.891551612896304,1.053565517232336,0.96875,0.90625,0.15346636544431413,0.22681640112450918,1.8627,0.3652,0.6199,2.0926,0.4112,0.4883,0.0037,1.815544333,0.46814248462933333,0.61004454910000006,1.4532,3.2211,0.3054,3.5731,0.3937,-47.036,1.0414,3.8677,0.389,3.6727,0.4499,0.9077,1.5986030969666667,3.723570608,3.5264746486666665,0.38158486696666666,0.2963953666,1.9995,1.7601,0.357,1.3783,0.3741,0.9876,0.098,0.371,0.148,0.018,1.65,91.66666666666667,2.039738198333333,1.8085678471333333,1.3119093199,0.34137295813333335,0.37838550483333333,498,1.4755555555555555,1,0,0,1,FALSE,FALSE,FALSE
245,2021-11-13T02:26:40Z,2021-11-13T02:47:24Z,1243,1,2021-11-13T02:47:25Z,1,Firefox,94.0,Windows NT 10.0,1920,1080,none,1.7777777777777777,659,52,288,81,42,64,-0.33452970680761995,-0.3434429681504497,-0.6716083621523106,-0.28737195225343287,-0.4136042721234341,-0.6989073197411108,3,3,1,2,3,1,1,3,1,2,2,1,1,2,3,3,1,1,2,2,0.8522416262267903,0,1,2,2,2,1.8,0,2,3,5,3,5,3,2,4,4,5,4,3,2,3,2,5,2,2,2,5,3,4,5,4,2,0,5,3,3,3,2,1,2,1,2,2,5,5,4,5,3,1,2,5,5,5,4,4,2,4,5,3,5,4,4,5,5,4,2,4,5,3,2,2,3,3,2,2,1.3633997428703215,1.1126972805283737,3.5,0,2.5,0,3.7333333333333334,0,3.888888888888889,0,3.8333333333333335,0,4,0,4.285714285714286,0,2.3333333333333335,0,3.891891891891892,0,2,0,5,1.9538279103948673,1.9234308028008964,1.0215996311143702,1.4725152169576332,2,4,2,3,3,3,4,3,1,0.816496580927726,3.5714285714285716,0,2,1.0042784435203436,2,2,3,1,2,2,3,1,1,1,1,0.6900655593423543,2.142857142857143,0,3.857142857142857,8,3.8333333333333335,3.2559414990859232,2.0842459175790595,0,1.8230783695284214,1,1,2,2,2,2,4,2,1,4,1,5,2,5,5,3,5,3,2,3,1.4573295865416045,1.6,0,4.4,0,3.4,0,4.4,0,4.066666666666666,0,1,1,1,2,2,1,1,3,2,2,2,2,1,1,4,3,1,3,3,1,0.9333020044867296,1.85,0,"Hispanic of Latino (e.g., Mexican American, Central American, and others)",0,29,0,1,NA,1,2,4,unemployed,1,0,220,66,2,5,2,0,0,4,0,0,TRUE,TRUE,TRUE,TRUE,TRUE,3,0.9084318181818182,0.88,0.09294160040816325,3,0.41303225806451616,0.4891935483870968,0.96875,0.96875,0.002770958669354838,0.005258813508064516,3,0.6035,0.62609375,1,1,0.012131032258064518,0.011575055443548386,1.6443,1.2699,0.4373,1.4753,1.2628,0.5017,0.2209,1.5983017076666666,1.1361656473666666,0.43467098483333333,1.005,4.4938,0.3096,3.7986,0.3623,-84.4755,0.9464,6.0859,0.3303,5.0977,0.3903,0.8597,1.1021341449333333,3.9404642076666665,4.666384516333333,0.3556093640333333,0.3039135163,0.9583,3.622,0.4966,3.5741,0.5246,0.9512,0.287,0.092,0.555,0.109,1.669,15.311926605504588,2.4144134893333336,3.882485902,4.120779746,0.2917284032,0.3377627746333333,442,1.3096296296296297,1,0,2,3,FALSE,FALSE,FALSE
246,2021-11-13T02:12:08Z,2021-11-13T02:47:27Z,2119,1,2021-11-13T02:47:28Z,1,Chrome,95.0.4638.69,Windows NT 10.0,1536,864,N/A,1.7777777777777777,987,77,602,138,69,134,0.5082226749528086,-0.11632451032089314,0.840062726009722,0.40725322018704974,-0.04067866192862343,0.4834883535186044,4,2,2,2,2,3,3,1,1,2,1,2,1,1,2,2,1,4,2,1,0.9445132413883326,0,1,1,3,2,2.55,0,1,2,2,2,4,4,2,4,4,2,5,1,4,1,1,1,5,5,5,5,5,5,5,4,4,4,1,1,1,1,1,1,1,1,1,1,5,2,5,5,4,5,4,5,5,5,5,5,1,5,5,5,5,5,5,5,5,5,3,2,2,5,5,5,5,5,5,5,1.8034001919297482,1.4040757000349275,4.5,0,5,0,4.066666666666666,0,5,0,4.416666666666667,0,4.833333333333333,0,3.7142857142857144,0,5,0,4.594594594594595,0,2,4,1,3.0129234146685078,2.7984144129813244,1.926345901062153,2.3623801570217386,4,2,3,4,1,1,1,5,3,1.3801311186847085,2,0,4,0.8021147563625206,2,2,2,2,1,1,5,2,4,2,2,1.3451854182690985,1.5714285714285714,0,4.428571428571429,6,3.8333333333333335,3.2559414990859232,0.9547190977297628,0,1.57699894928952,4,4,5,5,5,2,5,2,4,2,3,5,1,3,4,1,4,2,4,1,1.4074631010979937,4.6,0,4,0,4.2,0,3.6,0,3.933333333333333,0,2,1,4,1,4,4,4,1,4,2,3,2,3,4,3,1,4,4,4,4,1.234376040972246,3.45,0,"White, Caucasian, Anglo, European American",0,29,1,3,NA,1,2,5,Self-employed Author and Artist,1,0,320,61,1,5,2,0,1,0,0,1,TRUE,TRUE,TRUE,TRUE,TRUE,2,1.0056000000000807,0.7872340425531915,0.0922100787981069,2,0.6007866666674614,0.6324103448288194,0.967741935483871,0.9354838709677419,0.01754437514005336,0.010124178903333954,2,0.7362516129036103,0.8537172413817767,1,0.90625,0.05222818324723023,0.07129712451569752,1.5988,0.8946,0.5178,1.0886,0.9526,0.7429,0.1554,1.591927295,0.8912702621,0.5103369316333334,1.3017,2.6426,0.3639,2.8512,0.4272,-37.7801,0.9323,3.8754,0.4724,3.4631,0.5062,0.9985,1.4817336353333332,3.07092492,3.006105283666667,0.4096049979,0.35076975513333336,1.0747,3.0229,0.5395,2.7901,0.6349,0.9826,0.074,0.5,0.379,0.018,2.333,129.61111111111114,1.65795151,3.1018431383333334,1.9949724301666667,0.46049646776666664,0.4783560959,380,1.125925925925926,1,0,0,1,FALSE,FALSE,FALSE
247,2021-11-13T02:20:02Z,2021-11-13T02:47:44Z,1661,1,2021-11-13T02:47:45Z,1,Chrome,95.0.4638.69,Macintosh,1440,900,NA,1.6,958,53,333,80,58,79,0.43371103144350237,-0.33435822983726743,-0.454967601109981,-0.29955835878747644,-0.19261131793391667,-0.4455368183283147,2,4,2,1,2,1,1,4,1,3,3,1,1,2,2,3,1,1,2,3,1.025978352085154,1,1,1,1,1,1.7,0,4,5,3,4,5,2,3,3,1,1,4,3,2,4,4,1,2,1,1,2,2,1,3,0,2,0,0,5,5,5,5,5,5,3,4,2,1,5,3,1,5,1,5,1,3,4,5,3,4,1,1,1,1,1,1,1,1,1,4,3,2,1,1,1,1,1,1,2,1.7264068119885534,1.2649110640673518,1.625,0,1.25,0,2.4,0,1.6666666666666667,0,2.0833333333333335,0,1,0,1.4285714285714286,0,1,0,1.6486486486486487,0,0,0,0,-0.6077542715685611,-0.4193765295461455,-0.6588395645607719,-0.5391080470534587,4,2,5,1,1,1,1,1,1,1.6761634196950514,1.2857142857142858,0,1,-0.7321841937363471,5,5,5,5,5,3,1,6,4,5,4,1.5735915849388864,4.714285714285714,0,1.2857142857142858,4,3.8333333333333335,3.2559414990859232,-0.1748077221195339,0,-0.740526403906737,1,2,3,2,2,2,5,3,1,3,5,4,2,5,5,1,4,5,5,3,1.505545305418162,2,0,2.8,0,4.4,0,4.2,0,3.8,0,2,4,4,2,4,4,4,2,3,2,2,2,3,4,1,2,4,4,3,4,1.025978352085154,3.2,0,"White, Caucasian, Anglo, European American",0,18,1,2,NA,1,4,4,Student,7,0,84,60,1,5,2,0,1,0,0,1,TRUE,TRUE,TRUE,TRUE,TRUE,NA,NA,NA,NA,3,0.5708413793115781,0.624700000005109,0.9666666666666667,0.9032258064516129,0.032201468379317914,0.040043406624840454,3,0.6208937499970197,0.7877433333257834,1,0.967741935483871,0.008932775443329311,0.02872999051670524,NA,NA,NA,NA,NA,NA,NA,NA,NA,NA,1.1819,2.8976,0.3939,1.9823,0.4384,-31.5028,1.1944,3.8355,0.4034,3.4687,0.4614,0.8927,1.3389955741,2.2406766338333335,3.1956967316666667,0.4211095197,0.3773839764,0.9077,4.7981,0.5384,4.1859,0.6653,0.9941,0.094,0.408,0.438,0.009,1.678,186.44444444444446,2.499582031666667,4.311906392,2.665373230666667,0.3318310682,0.33088440826666665,424,1.2562962962962962,1,1,5,6,FALSE,TRUE,FALSE
248,2021-11-13T02:21:00Z,2021-11-13T02:48:29Z,1648,1,2021-11-13T02:48:30Z,1,Edge,95.0.1020.44,Windows NT 10.0,1536,864,Good Survey,1.7777777777777777,772,71,467,111,63,96,-0.044191233823082085,-0.1708329401999867,0.19014044288273346,0.07822024376787376,-0.12355101974969247,-0.15838358339381242,2,1,2,3,2,2,4,2,2,3,3,4,3,4,2,2,3,4,3,4,0.910465468000326,1,1,4,3,1,2.85,0,3,4,4,4,3,3,2,3,3,3,1,3,3,2,3,3,5,4,2,3,3,3,4,2,3,1,3,3,2,2,2,3,3,1,2,1,1,1,2,2,2,2,1,2,2,2,4,3,2,2,1,1,3,2,2,3,3,1,3,2,4,2,3,4,2,3,4,3,0.8767945989619056,0.7988086367179802,3.375,0,3,0,2.933333333333333,0,3.888888888888889,0,2.8333333333333335,0,2,0,2.4285714285714284,0,3,0,2.945945945945946,0,1,1,3,1.2876904602862478,1.1193944256140804,0.8290434765469984,0.9742189510805395,3,2,2,4,2,3,2,5,1,0.7867957924694432,2.857142857142857,0,3,0.9459301925190042,3,3,4,4,1,1,4,3,5,2,1,1.3451854182690985,2.5714285714285716,0,3.4285714285714284,5,3.8333333333333335,3.2559414990859232,0.38995568780511447,0,0.7369202623771383,2,3,3,5,4,2,4,3,2,4,4,4,4,4,4,1,3,3,3,4,0.9611501047232549,3.4,0,3.2,0,3.6,0,3.4,0,3.4,0,3,2,2,2,2,1,2,2,2,3,3,2,3,3,3,1,2,2,2,2,0.6155870112510925,2.5,0,"White, Caucasian, Anglo, European American",0,21,1,2,NA,1,1,4,college student,1,0,135,67,5,5,2,1,0,1,0,1,TRUE,TRUE,TRUE,TRUE,TRUE,NA,NA,NA,NA,2,0.7191035713808877,0.8139629629541326,0.9333333333333333,0.9642857142857143,0.04810177264327433,0.025866275087032167,2,0.9152718750238419,1.0499093750044703,1,1,0.050987878215313115,0.09416135379064212,NA,NA,NA,NA,NA,NA,NA,NA,NA,NA,1.912,1.5981,0.2059,2.7643,0.5122,0.7016,1.0249,4.565,0.584,3.6158,0.6816,0.7631,2.01222072,2.6858822013333334,1.8358565809,0.47309341586666664,0.2125565252,1.5081,2.4518,0.6322,2.0426,0.7066,0.9993,0.199,0.381,0.371,0.013,1.437,110.53846153846155,3.1108813703333333,3.2562907313333334,2.709435558,0.43082786523333333,0.4691547149,104,0.3081481481481481,1,1,0,1,FALSE,FALSE,FALSE
249,2021-11-13T02:25:45Z,2021-11-13T02:48:54Z,1388,1,2021-11-13T02:48:55Z,1,Chrome,95.0.4638.69,Macintosh,1440,900,"Interesting survey, thank you! Keep up the good work guys!",1.6,647,58,328,85,51,116,-0.36536211101836735,-0.2889345382713561,-0.479038796781351,-0.23862632611725865,-0.28929573539183057,0.17944375182324906,4,3,1,1,2,1,2,3,1,4,3,2,2,2,4,4,2,1,3,4,1.145931016569864,0,1,4,5,4,1.55,0,2,4,5,4,4,1,4,3,2,2,2,4,2,3,4,1,3,1,1,2,2,1,1,1,2,0,0,5,4,5,4,5,4,4,5,5,2,4,3,1,4,3,5,2,2,3,4,4,3,1,1,1,1,1,1,2,1,1,5,2,2,1,1,1,1,2,1,1,1.5658709882847794,1.162919151265879,1.5,0,1.25,0,2.533333333333333,0,1.4444444444444444,0,2.4166666666666665,0,1.1666666666666667,0,1.2857142857142858,0,1,0,1.7027027027027026,0,1,0,0,-0.6518832509132961,-0.3925656379510154,-0.4557470907642554,-0.4241563643576354,4,2,3,1,1,2,1,4,5,1.1547005383792515,1.7142857142857142,0,4.5,0.8156742234394231,5,5,5,5,4,5,2,8,8,6,4,1.1338934190276817,4.714285714285714,0,1.2857142857142858,1,3.8333333333333335,3.2559414990859232,-1.869097951893479,0,-1.5876715187937096,4,3,3,4,3,3,4,4,3,3,4,3,4,4,4,5,2,3,4,5,0.816496580927726,3.4,0,2.6,0,2.8,0,2.8,0,2.7333333333333334,0,1,1,1,4,2,2,1,3,1,1,1,3,2,2,2,3,1,2,1,2,0.8944271909999159,1.5,0,"White, Caucasian, Anglo, European American",0,25,0,1,NA,0,4,7,Lawyer,5,0,240,69,3,5,2,0,0,1,0,0,TRUE,TRUE,TRUE,TRUE,TRUE,2,1.1569317073269587,0.82,0.10081585941036716,2,0.49994062500447034,0.57203125,1,1,0.0073135482954956735,0.007437897701499999,2,0.6620812499970198,0.768484375,1,1,0.005110199637265707,0.0070479510384331995,1.5701,1.0167,0.6765,1.1907,1.2795,0.848,0.4975,1.5831553453333334,0.9726517317666666,0.6623382236666666,2.2861,6.0573,0.3112,5.117,0.3486,-76.8218,0.8734,4.4657,0.4004,4.2873,0.4767,0.9005,1.8165957177,4.376450573666666,5.19879777,0.36746313626666666,0.32775160113333335,0.7951,5.9259,0.5977,5.0421,0.7034,0.9612,0.095,0.496,0.582,0.007,1.199,171.28571428571428,2.9839263076666667,5.673064502,4.588262234666667,0.40553286503333336,0.44990368236666667,104,0.3081481481481481,1,1,0,1,FALSE,FALSE,FALSE
251,2021-11-13T02:25:53Z,2021-11-13T02:51:26Z,1533,1,2021-11-13T02:51:27Z,1,Chrome,95.0.4638.69,Macintosh,1680,1050,NA,1.6,804,57,393,78,64,99,0.03802851073891094,-0.2980192765845384,-0.1661132530535417,-0.3239311718555635,-0.10973896011284763,-0.10770948311125321,3,3,2,2,3,2,2,3,2,3,3,2,2,2,3,3,2,1,2,3,0.5982430416161189,0,1,1,3,3,2,0,4,5,3,4,2,2,1,1,3,2,3,4,3,3,2,2,3,1,2,1,3,1,2,0,2,0,0,4,4,4,4,4,5,5,5,5,3,2,3,1,2,2,5,4,4,3,3,3,3,1,2,1,2,1,1,1,1,1,3,5,3,1,1,2,2,1,1,1,1.4498627873361334,1.1464230084422218,1.875,0,1.25,0,2.533333333333333,0,1.5555555555555556,0,2.9166666666666665,0,1.5,0,2,0,1.3333333333333333,0,2.108108108108108,0,0,0,0,-0.16646447812121104,-0.057187517455972794,-0.6588395645607719,-0.35801354100837235,5,1,5,1,3,2,1,1,1,1.8126539343499315,1.4285714285714286,0,1,-0.6467170085812028,5,5,5,5,2,2,1,6,6,4,3,1.8126539343499315,4.142857142857143,0,1.8571428571428572,3,3.8333333333333335,3.2559414990859232,-0.7395711320441822,0,-0.7042241191833141,2,2,2,2,2,2,4,3,1,3,2,4,2,5,5,3,4,2,4,3,1.1872336794093274,2,0,4,0,3.6,0,4.2,0,3.933333333333333,0,2,3,1,4,2,1,2,3,1,2,2,3,1,2,3,3,2,2,2,2,0.812727700887249,1.85,0,"White, Caucasian, Anglo, European American",0,29,0,1,NA,1,3,5,retired military,4,0,176,74,4,5,2,0,0,1,0,0,TRUE,TRUE,TRUE,TRUE,TRUE,1,0.7664743589728307,0.8125,0.04074745339972362,1,0.4968034482773008,0.5770310344850195,0.9354838709677419,0.90625,0.008263177848882433,0.010771116088631788,1,0.7142968750009313,0.7881133333305518,1,0.9375,0.02381711192622023,0.02143123983987785,1.3746,1.137,0.3943,1.066,1.1519,0.5398,0.3628,1.4000519503333333,1.0583580579333334,0.3879847809,1.1312,2.782,0.3136,2.3205,0.3715,-40.1479,0.704,4.467,0.416,3.2607,0.4795,0.9968,1.2351753980666667,2.5714115497333334,3.130502848,0.3631656233666667,0.30725172866666667,1.1782,2.9994,0.5237,2.1829,0.578,0.8883,0.083,0.431,0.313,0.008,1.397,174.625,2.06565088,2.9149014226666665,2.560531534,0.35015794046666665,0.4118517555333333,500,1.4814814814814816,1,0,0,1,FALSE,FALSE,FALSE
252,2021-11-13T02:31:30Z,2021-11-13T02:51:27Z,1197,1,2021-11-13T02:51:28Z,0.8999999761581421,Chrome,95.0.4638.69,Windows NT 10.0,2048,1152,N/a,1.7777777777777777,665,48,278,52,40,73,-0.31911350470224625,-0.3797819214031788,-0.7197507534950504,-0.6407777417406959,-0.4412283913971238,-0.5468850188934331,3,3,2,3,3,2,2,3,2,3,3,3,3,2,3,3,3,3,3,3,0.4442616583193193,0,1,1,2,3,2.25,0,5,5,2,5,2,1,5,1,2,1,1,5,5,5,5,2,2,1,2,2,2,2,2,1,2,0,0,5,5,5,5,5,5,5,5,5,5,5,1,1,5,4,5,1,1,4,1,1,5,1,1,1,2,1,4,2,1,1,5,1,1,1,1,1,2,1,1,1,1.92033530605665,1.8771812708978117,1.875,0,1.25,0,1.4666666666666666,0,1,0,1.8333333333333333,0,1,0,1.4285714285714286,0,1,0,1.4054054054054055,0,1,0,0,-0.6035515116309674,-0.8175715043561326,-0.4557470907642554,-0.636659297560194,5,2,3,1,1,1,1,1,1,1.5275252316519468,1.4285714285714286,0,1,-0.6467170085812028,4,5,5,5,4,4,2,7,6,6,3,1.0690449676496976,4.428571428571429,0,1.5714285714285714,2.5,3.8333333333333335,3.2559414990859232,-1.0219528370065065,0,-1.00475696650735,2,2,2,2,2,3,4,4,4,4,4,4,1,4,4,4,4,4,4,4,0.7988086367179802,2,0,3,0,3.8,0,2.8,0,3.2,0,2,3,1,3,3,2,3,3,3,1,2,3,1,1,2,4,1,1,1,2,0.9679060415469871,1.8,0,"White, Caucasian, Anglo, European American",0,22,0,1,NA,1,3,6,Software Engineer,5,0,140,70,2,5,2,0,0,1,0,0,TRUE,TRUE,TRUE,TRUE,TRUE,5,0.7921000000003137,0.7755102040816326,0.08123575581627895,5,0.46357241379289793,0.5083645161294168,0.9666666666666667,0.96875,0.012836265057435847,0.009541445806512571,NA,NA,NA,NA,NA,NA,NA,1.6073,0.8335,0.2441,1.3716,0.9974,0.3847,0.3107,1.5762876446666667,0.8524863212333333,0.24691890123333332,1.2241,3.4297,0.2981,3.248,0.3273,-56.0074,1.1725,5.9899,0.3518,5.3868,0.3908,0.9397,1.3255541202,3.4529401273333336,3.71430378,0.32116651523333334,0.29194263466666664,NA,NA,NA,NA,NA,NA,NA,NA,NA,NA,NA,NA,NA,NA,NA,NA,NA,104,0.3081481481481481,1,0,5,6,FALSE,FALSE,TRUE
253,2021-11-13T02:30:28Z,2021-11-13T02:52:20Z,1311,1,2021-11-13T02:52:21Z,1,Chrome,95.0.4638.69,Windows NT 10.0,1920,1080,NA,1.7777777777777777,725,58,277,56,27,66,-0.16495148364850934,-0.2889345382713561,-0.7245649926293244,-0.5920321156045217,-0.6207851666761067,-0.6651245862194046,3,4,2,3,2,1,2,2,1,3,2,1,1,1,3,3,1,1,3,2,0.9445132413883326,0,1,1,4,3,1.85,0,5,5,2,5,1,1,4,1,1,1,1,5,1,5,5,1,1,1,1,1,1,1,1,2,2,0,0,5,5,5,5,5,5,5,5,4,1,5,1,1,3,1,5,1,1,1,3,1,5,1,1,1,2,1,1,2,2,1,5,1,1,1,1,1,2,1,1,1,1.833947481081005,1.9591057240729093,1,0,1.25,0,1.1333333333333333,0,1.1111111111111112,0,1.3333333333333333,0,1,0,1.1428571428571428,0,1,0,1.2162162162162162,0,1,0,0,-1.2654862018019926,-1.4181548341315258,-0.4557470907642554,-0.9369509624478906,4,2,4,1,1,2,2,1,1,1.2535663410560174,1.7142857142857142,0,1,-0.4757826382709144,4,4,5,4,1,2,1,3,5,2,2,1.632993161855452,3.5714285714285716,0,2.4285714285714284,5,3.8333333333333335,3.2559414990859232,0.38995568780511447,0,0.17922328042708108,3,1,2,1,2,1,5,1,1,3,1,5,1,4,4,1,5,1,4,1,1.7674302033770737,1.8,0,5,0,4.4,0,4.6,0,4.666666666666667,0,1,1,1,3,2,1,1,3,1,1,2,4,2,1,1,3,1,1,2,1,0.9333020044867296,1.35,0,"Asian or Asian American (e.g., Chinese, Japanese, and others)",0,20,1,2,NA,1,2,4,Student,2,0,90,60,2,5,2,0,0,1,0,0,TRUE,TRUE,TRUE,TRUE,TRUE,1,0.958035897436098,0.7959183673469388,0.21512891063766404,1,0.44802812500012806,0.521222580644933,1,1,0.0035013336995772214,0.0028329284731210204,1,0.5940937499998253,0.685234374999709,1,1,0.013226061895138936,0.009654464264122961,1.6853,0.823,0.4496,1.3921,0.7501,0.5749,0.2621,1.6532965443333334,0.8352762380633333,0.44711723676666665,5.8967,9.8194,0.1478,9.9089,0.2237,-94.4383,0.7892,6.6033,0.3901,7.3072,0.4724,0.7287,1.6876271578,5.158027406,5.6771254833333336,0.36356633146666667,0.3036804231,1.231,5.8598,0.4791,6.3104,0.5872,0.7499,0.176,0.253,0.523,0.009,1.264,140.44444444444446,2.3239170536666665,4.333808439666667,4.117504615666666,0.32737066416666666,0.40767809946666667,350,1.0370370370370372,1,0,1,2,FALSE,FALSE,FALSE
254,2021-11-13T02:32:45Z,2021-11-13T02:56:48Z,1443,1,2021-11-13T02:56:49Z,1,Chrome,95.0.4638.69,Windows NT 10.0,1280,720,n/a,1.7777777777777777,766,55,383,67,53,72,-0.05960743592845578,-0.31618875321090295,-0.21425564439628159,-0.45798164373004263,-0.2616716161181409,-0.5637763856542862,3,3,1,1,3,1,1,3,1,4,2,1,1,1,3,3,1,1,4,3,1.145931016569864,0,1,1,3,4,1.45,0,4,5,2,4,2,2,2,2,2,2,1,4,2,4,4,2,1,1,1,1,1,1,1,0,2,0,0,5,4,5,5,5,5,5,5,5,2,5,2,1,4,2,5,1,1,2,1,2,5,1,1,1,3,2,1,1,1,1,5,1,2,1,1,1,2,1,1,1,1.7774023627640307,1.2071217242444348,1.125,0,1.25,0,2,0,1.1111111111111112,0,1.5,0,1.3333333333333333,0,1,0,1,0,1.2972972972972974,0,0,0,0,-1.1373020237053812,-0.9571430050065944,-0.6588395645607719,-0.8079912847836832,5,1,4,1,1,1,1,2,1,1.7320508075688772,1.1428571428571428,0,1.5,-0.6331575415043005,5,5,5,5,2,2,1,6,7,3,3,1.8126539343499315,4.142857142857143,0,1.8571428571428572,2.5,3.8333333333333335,3.2559414990859232,-1.0219528370065065,0,-0.8454149716644763,2,3,2,2,2,2,5,3,3,3,2,2,2,3,3,1,4,2,4,3,1.01418510567422,2.2,0,3.6,0,4.2,0,3,0,3.6,0,2,1,2,3,3,2,2,3,2,1,3,2,3,2,2,3,1,2,2,3,0.6958523739384593,2.1,0,"White, Caucasian, Anglo, European American",0,21,1,2,NA,1,3,4,student,4,0,150,65,3,5,2,0,0,0,0,0,TRUE,TRUE,TRUE,TRUE,TRUE,2,0.5868974999964237,0.8163265306122449,0.009010347611068167,2,0.5219733333269755,0.5870214285424777,0.9375,0.9333333333333333,0.045545470065977874,0.07149252408954034,2,0.5673645161274941,0.6973066666603088,1,0.9375,0.004671859035337047,0.007667512858268369,1.0801,1.5477,0.3721,0.629,2.4521,0.5079,0.2325,1.1254656969333334,1.2517259350333334,0.3661763856333333,1.23,2.235,0.2765,2.122,0.3261,-22.2063,1.343,3.4358,0.2845,4.7492,0.362,0.6548,1.2924280160333332,2.3365261605,2.5126565826666667,0.3217668812666667,0.2726861123,0.9701,4.1436,0.46,4.5424,0.5869,0.9363,0.084,0.409,0.553,0.011,1.793,163,1.6817471151333334,4.752046254,2.873858199133333,0.3935491143,0.4244438801666667,378,1.12,1,0,0,1,FALSE,FALSE,FALSE
255,2021-11-13T02:33:12Z,2021-11-13T02:57:06Z,1434,1,2021-11-13T02:57:08Z,1,Chrome,95.0.4638.69,Windows NT 10.0,1280,720,"The study is inclusive, but there is the assumption that the parents are ""mother"" and ""father"" rather than both women or male, etc. I liked it though! attention games are interesting",1.7777777777777777,699,60,288,78,56,90,-0.23175502610512866,-0.2707650616449916,-0.6716083621523106,-0.3239311718555635,-0.22023543720760635,-0.2597317839589309,2,3,3,2,2,1,1,3,1,2,2,2,2,2,2,2,1,1,2,3,0.6863327411532597,0,1,1,4,4,2.15,0,5,5,1,5,1,1,5,1,1,1,1,5,1,5,5,1,2,1,1,1,2,1,1,1,2,0,0,5,4,5,5,5,5,5,5,5,1,5,1,1,5,1,5,1,1,1,1,1,4,1,1,1,2,2,1,2,2,1,5,1,1,1,2,1,2,2,2,2,1.8327189797835506,2.065591117977289,1.25,0,2,0,1,0,1.1111111111111112,0,1,0,1.3333333333333333,0,1.1428571428571428,0,1.3333333333333333,0,1.1891891891891893,0,1,0,0,-1.1267951238613967,-1.3796323256302194,-0.22054348261253207,-0.8000879041213758,5,1,5,1,1,1,1,1,1,1.9518001458970664,1,0,1,-0.9031185640466358,5,5,5,5,3,3,1,3,5,4,3,1.5735915849388864,4.428571428571429,0,1.5714285714285714,5,3.8333333333333335,3.2559414990859232,0.38995568780511447,0,-0.2988027041015393,2,2,1,1,1,1,3,2,1,4,1,3,1,5,4,2,4,1,3,2,1.3557637102737474,1.4,0,4.4,0,3.8,0,4.4,0,4.2,0,1,2,1,3,3,1,1,3,2,1,1,4,2,2,1,4,1,1,2,2,1.0208355710680808,1.5,0,"Hispanic of Latino (e.g., Mexican American, Central American, and others) & White, Caucasian, Anglo, European American",1,21,1,2,NA,1,3,4,"Student, but looking for chemical industry jobs",5,0,115,63,2,5,2,0,0,1,0,0,TRUE,TRUE,TRUE,TRUE,TRUE,5,0.9034955555703905,0.9,0.04248640156945869,5,0.5688322580399052,0.6164620689852485,1,0.9666666666666667,0.05308451757510373,0.03801386581240596,5,0.5938937499374152,0.6476718750149012,1,1,0.010091746419376673,0.009133236288941542,1.4612,1.6316,0.5572,1.2436,1.6321,0.6246,0.0379,1.4509548076666667,1.3378881899333332,0.5480298252,1.2442,3.0384,0.3641,2.6749,0.4003,-41.6281,0.947,3.2008,0.3861,3.7523,0.4645,0.9232,1.4236081707,2.9451841556666665,3.32937584,0.3845438890333333,0.34551927286666667,0.9884,4.3189,0.5028,3.9618,0.5438,0.6828,0.292,0.163,0.67,0.028,1.532,54.714285714285715,2.4524946793333333,4.266694189666667,4.282841581,0.30781961916666667,0.3667122549333333,376,1.114074074074074,1,0,0,1,FALSE,FALSE,FALSE
256,2021-11-13T02:32:54Z,2021-11-13T02:57:20Z,1465,1,2021-11-13T02:57:21Z,1,Chrome,94.0.4606.81,Macintosh,1440,900,NA,1.6,657,64,304,88,52,66,-0.3396684408427445,-0.23442610839226255,-0.5945805360039267,-0.202067106515128,-0.2754836757549857,-0.6651245862194046,2,2,1,2,2,3,3,2,1,2,2,1,1,1,2,2,2,1,1,2,0.6386663736585051,0,1,3,4,3,2.35,0,1,3,2,2,3,3,3,3,3,3,4,2,2,2,2,3,4,3,3,2,4,4,4,7,2,0,8,4,2,2,3,3,3,2,3,3,3,2,3,5,2,3,3,5,5,5,3,4,1,5,4,4,4,1,3,4,3,2,4,2,3,3,2,2,4,4,4,4,1.100095545945992,0.7432233529572065,3.375,0,4,0,3.3333333333333335,0,3.2222222222222223,0,3.9166666666666665,0,3.6666666666666665,0,2.5714285714285716,0,2.3333333333333335,0,3.3783783783783785,0,4,0,6,1.5566670962922522,1.4771310874754593,2.0746414419100305,1.775886264692745,2,3,1,2,2,3,3,4,1,0.7559289460184544,3.142857142857143,0,2.5,0.9323707254421016,2,4,3,4,1,1,2,6,5,2,2,1.2724180205607036,2.7142857142857144,0,3.2857142857142856,3.5,3.8333333333333335,3.2559414990859232,-0.4571894270818581,0,0.23367670751221528,2,2,2,3,2,2,4,2,2,2,4,3,3,3,4,4,3,3,4,3,0.7988086367179802,2.2,0,3,0,3,0,3.6,0,3.2,0,2,4,2,2,3,3,2,1,1,1,3,2,3,2,1,2,3,3,2,3,0.8506963092234007,2.55,0,"Black or African American & White, Caucasian, Anglo, European American",1,19,1,2,NA,1,3,3,student,3,0,100,63,2,5,2,0,0,1,0,0,TRUE,TRUE,TRUE,TRUE,TRUE,4,0.6922047619081679,0.8571428571428571,0.017605530800724422,4,0.4883968749959022,0.5578642857117312,1,0.9032258064516129,0.0040861751511048995,0.006762104452118421,4,0.6019548387104465,0.6991580645095917,1,1,0.005438590558545082,0.00792873518292825,1.1027,1.728,0.4602,0.8706,2.0097,0.5397,0.2025,1.1470286701,1.3428992858333333,0.4514727460333333,1.2466,4.741,0.3569,2.5489,0.356,-62.3807,0.8282,5.4948,0.4119,3.9518,0.4541,0.9899,1.3586267102333334,2.796749166,4.846690458,0.34825554286666666,0.3491275559,1.0266,4.3812,0.4932,3.742,0.5714,0.9982,0.163,0.353,0.644,0.013,1.438,110.61538461538461,2.4259170483333334,5.117555604666666,4.905170797333334,0.37001101,0.4595551349,348,1.031111111111111,1,0,1,2,FALSE,FALSE,FALSE
257,2021-11-13T02:37:33Z,2021-11-13T02:57:24Z,1190,1,2021-11-13T02:57:26Z,1,Chrome,95.0.4638.69,Windows NT 10.0,1536,864,NA,1.7777777777777777,567,67,323,70,64,57,-0.5709114724233499,-0.20717189345271578,-0.5031099924527209,-0.421422424127912,-0.10973896011284763,-0.8171468870670823,3,3,2,1,2,1,2,2,1,2,2,3,2,3,2,2,2,1,2,3,0.6863327411532597,0,1,1,3,3,2.25,0,2,2,4,3,5,2,3,2,2,1,2,3,3,4,1,2,2,1,2,2,2,2,2,0,2,0,0,4,1,2,3,3,3,2,3,2,5,3,1,1,2,2,3,5,2,2,5,2,4,1,1,1,3,1,1,1,1,1,2,5,3,2,2,1,1,2,1,1,1.292156983369153,1.121223821162776,1.875,0,1.25,0,3,0,3.4444444444444446,0,2.9166666666666665,0,1.3333333333333333,0,2.142857142857143,0,1.6666666666666667,0,2.5945945945945947,0,0,0,0,0.13613423738554362,0.35242870359309486,-0.6588395645607719,-0.1532054304838385,5,3,4,3,1,1,2,1,1,1.4960264830861913,1.8571428571428572,0,1,-0.39031545311577004,4,4,4,3,1,1,2,6,8,4,4,1.3801311186847085,3,0,3,2,3.8333333333333335,3.2559414990859232,-1.3043345419688306,0,-0.34923784477414443,3,3,4,4,4,2,5,2,2,4,2,3,2,4,5,2,4,1,5,3,1.3345232785352157,3.6,0,4,0,4.4,0,4,0,4.133333333333334,0,2,3,1,2,4,2,3,4,1,1,4,4,2,4,2,3,1,3,3,2,1.0990426455975697,2.25,0,"Asian or Asian American (e.g., Chinese, Japanese, and others) & White, Caucasian, Anglo, European American",1,24,1,2,NA,1,3,6,Unemployed,3,0,114,64,1,5,2,0,1,0,0,1,TRUE,TRUE,TRUE,TRUE,TRUE,4,0.5630047619058972,0.84,0.012932590840708543,4,0.3986466666698456,0.45132903226344817,0.967741935483871,0.96875,0.0023157978275992743,0.002234461774631728,4,0.5090281250029802,0.5481656250003726,1,1,0.008242831764741233,0.006761710070895329,1.1162,1.6013,0.3315,0.9078,1.9314,0.4021,0.2409,1.1555931134,1.2898713288666666,0.3252027275666667,1.0558,3.7874,0.2646,5.2415,0.3559,-87.2785,0.7149,6.2298,0.3449,6.5631,0.3939,0.9623,1.1339451993,4.992182823,4.056347535,0.3489846495666667,0.26081633363333334,0.7256,3.4256,0.4446,4.7215,0.4884,0.718,0.178,0.195,0.56,0.041,2.013,49.09756097560975,2.320212779,4.356221392,4.394640719666667,0.24425456003333335,0.28999725406666665,466,1.3807407407407408,1,0,0,1,FALSE,FALSE,FALSE
258,2021-11-13T02:02:57Z,2021-11-13T02:57:54Z,3297,1,2021-11-13T02:57:55Z,1,Chrome,95.0.4638.69,Windows NT 10.0,1920,1080,NA,1.7777777777777777,2323,104,487,89,86,100,3.940897010416017,0.12896342413502795,0.28642522556821326,-0.18988069998108442,0.19412635189773886,-0.09081811635040013,2,3,4,3,2,3,2,3,1,3,2,4,3,3,2,2,3,3,2,2,0.7539370349250519,0,0,5,2,3,2.8,0,1,2,4,2,4,4,3,4,5,3,4,2,3,2,1,5,5,4,3,5,5,4,4,6,5,0,2,3,3,2,4,3,4,3,4,3,4,3,4,5,3,5,2,5,4,4,4,5,1,3,3,2,2,5,3,5,4,3,2,5,4,3,5,4,4,4,3,3,1.0696467380140717,1.2227992865708155,4.375,0,3.5,0,4,0,2.7777777777777777,0,4.166666666666667,0,3.1666666666666665,0,3.857142857142857,0,4,0,3.6486486486486487,0,3,0,2,2.3467859645598885,2.3095269998152466,1.008947975082309,1.6592374874487779,1,5,2,4,4,5,4,3,2,1.5118578920369088,4.428571428571429,0,2.5,1.7015753918384005,1,2,3,1,1,1,5,4,3,1,1,1.5275252316519468,1.4285714285714286,0,4.571428571428571,5.5,3.8333333333333335,3.2559414990859232,0.6723373927674386,0,1.5154790942297942,3,3,2,3,3,2,4,1,1,2,1,4,3,3,4,3,5,2,3,3,1.2227992865708155,2.8,0,4.4,0,3,0,4,0,3.8,0,3,4,3,1,4,2,4,2,3,1,4,2,3,4,2,2,3,2,4,3,1.0052493799000692,3.1,0,"Black or African American & Hispanic of Latino (e.g., Mexican American, Central American, and others)",1,18,1,3,NA,1,2,3,Unemployed,2,0,115,61,1,5,2,0,0,0,0,0,TRUE,TRUE,TRUE,TRUE,TRUE,2,0.8802785714268685,0.84,0.04786305116477078,2,0.6178781249988824,0.8104781249966473,1,1,0.008787328215311752,0.009418243054691442,2,0.6875258064519975,0.7407870967791926,1,1,0.010091697311350543,0.006950423828092225,1.3824,1.2888,0.5037,0.9077,2.3639,0.692,0.5067,1.4073051203333333,1.1510062096333333,0.4948318567,3.6773,6.5595,0.3376,5.5138,0.477,-66.108,1.0133,6.1594,0.5327,3.1003,0.678,0.8773,2.514244498,4.0721054793333336,5.213573755333333,0.5021256986333333,0.3790614988666667,1.0146,3.3423,0.5544,4.7654,0.6397,0.9637,0.143,0.45,0.594,0.021,1.329,63.28571428571428,2.9729826476666665,4.310863989666666,5.2777321273333335,0.34421901573333336,0.4676502503666667,330,0.9777777777777777,1,0,3,4,FALSE,FALSE,FALSE
259,2021-11-13T02:06:20Z,2021-11-13T02:58:31Z,3130,1,2021-11-13T02:58:32Z,0.8999999761581421,Safari,14.0.3,Macintosh,1440,900,NA,1.6,790,803,985,290,90,92,0.0020573724930389916,6.47919550504943,2.6839163144366593,2.25958701336167,0.2493745904451182,-0.2259490504372247,3,3,2,1,2,1,1,2,1,2,2,2,3,2,2,3,1,1,2,2,0.7181848464596079,0,1,2,3,3,2.1,0,5,5,2,4,2,1,5,1,1,1,1,5,1,5,4,1,1,1,1,1,1,1,1,1,2,0,0,5,4,4,4,4,5,4,4,5,1,5,1,1,4,1,5,3,1,1,2,2,4,1,1,1,2,1,1,2,1,1,3,3,3,1,1,1,2,1,1,2,1.55673485970586,1.8464895909600492,1,0,1.5,0,1.2666666666666666,0,1.6666666666666667,0,1.4166666666666667,0,1.1666666666666667,0,1.8571428571428572,0,1,0,1.5405405405405406,0,1,0,0,-1.0637537247974898,-1.2214771022856596,-0.3773458880470143,-0.7994114951663369,5,1,4,2,1,2,1,3,1,1.6035674514745464,1.4285714285714286,0,2,-0.2777293338068208,5,5,5,5,3,3,1,3,8,6,4,1.5735915849388864,4.428571428571429,0,1.5714285714285714,3.5,3.8333333333333335,3.2559414990859232,-0.4571894270818581,0,-0.7223752615450256,2,2,2,3,2,2,5,2,2,3,3,3,2,4,4,1,4,2,4,2,1.1254628677422756,2.2,0,3.6,0,4.2,0,4,0,3.933333333333333,0,2,1,1,2,3,2,3,3,1,2,3,3,2,1,1,3,1,1,1,3,0.8870412083230169,1.85,0,"White, Caucasian, Anglo, European American",0,25,1,2,NA,1,3,6,Actuarial analyst,5,0,170,69,1,5,2,0,1,2,0,1,TRUE,TRUE,TRUE,TRUE,TRUE,6,0.96083870967741,0.7045454545454546,0.24368709672303598,6,0.4546896551724133,0.5010689655172409,0.9666666666666667,0.9354838709677419,0.00982857586206937,0.009692918279569704,6,0.6312666666666715,0.7590000000000011,0.9375,0.78125,0.018188673387097367,0.020529870967741063,1.8822,0.5017,0.2084,1.493,0.5632,0.4031,0.1126,1.777157109,0.5876770377233334,0.21848157418666667,1.0839,3.3443,0.2998,2.8609,0.3274,-54.637,1.067,5.5799,0.3473,4.3887,0.3694,0.9996,1.1824822572,3.112926226,3.664829264,0.3210881717,0.29411937456666665,0.9118,2.5599,0.4986,1.9772,0.5969,0.8212,0.062,0.42,0.3,0.005,1.513,302.59999999999997,1.4233099506666667,2.2025833735666667,1.2833404067133334,0.3280885524,0.3565662656333333,424,1.2562962962962962,1,0,0,1,FALSE,FALSE,FALSE
260,2021-11-13T02:06:36Z,2021-11-13T02:58:40Z,3123,1,2021-11-13T02:58:40Z,1,Chrome,95.0.4638.69,Windows NT 10.0,1366,768,NA,1.7786458333333333,1381,144,870,202,136,194,1.5205532798723476,0.4923529566623185,2.130278813995151,1.1871832383658372,0.8847293337399809,1.496970359169789,3,3,1,1,3,1,1,3,1,3,2,1,1,1,4,3,1,1,3,3,1.0760551736979407,0,1,1,4,4,1.5,0,3,4,2,4,2,3,4,3,3,2,2,3,3,2,2,3,3,1,2,2,3,3,3,4,2,0,1,3,2,2,2,1,3,3,3,3,1,5,2,1,3,3,4,5,3,3,2,2,2,2,3,1,3,1,1,3,3,1,4,3,2,2,2,2,2,2,2,2,1.0433544884595018,0.7745966692414834,2.5,0,2,0,2.6666666666666665,0,3.5555555555555554,0,2.3333333333333335,0,2.1666666666666665,0,2,0,2,0,2.5675675675675675,0,2,0,1,0.5080784918625958,0.4661572148720772,0.15899863808316506,0.3125779264776211,3,2,1,3,2,3,4,3,1,0.9759000729485332,3.142857142857143,0,2,0.7478768880549106,4,4,4,4,2,2,3,1,2,2,2,0.9511897312113419,3.2857142857142856,0,2.7142857142857144,7.5,3.8333333333333335,3.2559414990859232,1.8018642126167355,0,1.0445195376757652,2,2,2,2,2,2,5,1,1,2,2,4,3,4,5,2,4,3,5,3,1.3870146083619754,2,0,3.8,0,3.8,0,4.4,0,4,0,2,1,2,2,2,2,1,2,1,1,1,2,1,1,1,4,2,2,1,2,0.7451598203705946,1.65,0,"White, Caucasian, Anglo, European American",0,28,1,2,NA,1,2,2,Homemaker,3,0,180,66,1,5,2,1,0,1,0,1,TRUE,TRUE,TRUE,TRUE,TRUE,6,1.0844583333334368,0.72,0.08053174120809359,6,0.6284225806452094,0.6677031249998836,1,1,0.01704603047322086,0.0065878570866955335,6,0.7525750000000698,0.7834266666661948,1,0.9375,0.012902936128966203,0.011574754264161402,1.4075,0.7006,0.6704,1.2204,0.663,0.7588,0.2405,1.4570102406666667,0.7719267129466667,0.6559584879333333,8.0931,6.4394,0,8.0356,0.1642,-54.7995,1.0821,2.4999,0.4556,6.7941,0.5945,0.9267,2.3921314006666665,4.387252884,3.775539193,0.3975318281333333,0.3063208546333333,1.0554,2.3489,0.6002,3.8382,0.6515,0.7877,0.062,0.568,0.333,0.014,1.313,93.78571428571428,2.240101097666667,3.6783726276666666,2.7422027106666667,0.4450798174,0.4216386202,344,1.0192592592592593,0,0,0,1,FALSE,FALSE,FALSE
261,2021-11-13T02:39:10Z,2021-11-13T02:59:28Z,1218,1,2021-11-13T02:59:29Z,1,Chrome,95.0.4638.69,Macintosh,1440,900,NA,1.6,639,67,307,66,49,56,-0.3859170471588656,-0.20717189345271578,-0.5801378186011047,-0.47016805026408615,-0.31691985466552025,-0.8340382538279354,2,2,4,3,1,2,4,2,1,2,1,3,1,2,2,1,3,2,2,2,0.9119095061289915,0,1,1,3,1,2.9,0,1,3,4,3,3,4,2,4,3,3,1,1,1,3,4,4,3,5,5,2,4,4,3,6,1,3,2,4,4,1,3,3,3,4,4,3,4,3,1,1,2,3,3,5,5,1,1,4,1,5,5,4,4,1,2,5,3,1,4,1,1,1,1,1,1,3,3,2,1.4982472241738827,1.1751393027860062,3.75,0,2.25,0,3.2,0,2.7777777777777777,0,2.9166666666666665,0,3.8333333333333335,0,2,0,1,0,2.7567567567567566,0,3,3,2,1.4032663585700773,1.3138459823455497,1.2368415842751745,1.2753437833103622,5,1,2,1,1,1,1,3,1,1.4960264830861913,1.4285714285714286,0,2,-0.2777293338068208,4,3,4,3,2,2,4,7,6,2,2,0.8997354108424374,2.857142857142857,0,3.142857142857143,2.5,3.8333333333333335,3.2559414990859232,-1.0219528370065065,0,-0.12837599487154566,2,2,2,2,2,2,5,2,2,2,2,4,1,4,4,4,5,1,5,1,1.533747356112131,2,0,4.4,0,3.8,0,4.2,0,4.133333333333334,0,3,2,4,1,3,4,4,2,4,4,1,1,2,4,2,1,4,4,4,4,1.2523661815266247,3.4,0,"White, Caucasian, Anglo, European American",0,22,1,2,NA,1,2,4,student,1,0,165,63,2,5,2,0,0,1,0,0,TRUE,TRUE,TRUE,TRUE,TRUE,4,0.7039823529439814,0.6938775510204082,0.014574648123611752,4,0.41607999997933703,0.46495999998251597,0.9375,0.9375,0.0026883153936577706,0.003101973538835972,4,0.6317718750014901,0.7437266666650773,1,0.9375,0.00866799111806232,0.011547492493746692,1.0589,0.8252,0.4569,0.5509,1.3992,0.633,0.3292,1.1261950949,0.8827516279666666,0.4491426218,0.9496,4.9304,0.3104,4.6032,0.3618,-82.3477,0.6721,5.0573,0.3556,5.0874,0.3964,0.9401,0.9334223214,3.995424040666667,3.6101978586666665,0.36010316016666666,0.29048555043333335,0.973,3.5324,0.5057,3.6966,0.6227,0.9453,0.085,0.444,0.483,0.011,1.681,152.81818181818184,1.9566056266666667,4.305498090666667,2.5026588243333334,0.40515479023333334,0.3752666419333333,478,1.4162962962962962,1,0,0,1,FALSE,FALSE,FALSE
262,2021-11-13T02:36:56Z,2021-11-13T02:59:53Z,1376,1,2021-11-13T02:59:54Z,1,Chrome,95.0.4638.69,Windows NT 10.0,2560,1440,NA,1.7777777777777777,685,54,358,92,55,84,-0.2677261643510006,-0.3252734915240852,-0.33461162275313133,-0.15332148037895377,-0.2340474968444512,-0.3610799845240493,3,3,1,1,2,1,1,2,1,2,1,3,3,3,2,2,2,1,1,1,0.8335087534664907,0,1,2,4,3,2.4,0,4,5,2,5,1,1,4,1,1,2,2,4,3,3,4,1,2,1,1,1,1,1,1,1,2,1,5,5,1,1,2,4,4,2,4,3,2,5,1,1,3,2,5,1,1,3,3,4,5,3,1,1,4,1,1,3,1,1,5,1,1,1,1,1,1,1,1,1,1.5156837721956706,1.4735767952260144,1.125,0,1,0,1.7333333333333334,0,3.111111111111111,0,1.9166666666666667,0,1.6666666666666667,0,1.1428571428571428,0,1,0,2,0,1,1,5,-0.7002149901956249,-0.7697571345077772,0.554733148607431,-0.10751199295017311,4,1,2,1,1,2,1,1,1,1.1126972805283737,1.7142857142857142,0,1,-0.4757826382709144,3,4,5,5,2,2,2,4,1,3,2,1.3801311186847085,3.5714285714285716,0,2.4285714285714284,6.5,3.8333333333333335,3.2559414990859232,1.237100802692087,0,0.6027958378705673,2,4,2,4,2,2,5,1,1,3,1,4,2,4,4,1,4,1,4,1,1.505545305418162,2.8,0,4.4,0,4.2,0,4.6,0,4.4,0,3,2,2,1,3,2,3,2,1,2,2,3,1,1,1,3,1,3,2,2,0.7947194142390263,2.1,0,"Hispanic of Latino (e.g., Mexican American, Central American, and others)",0,20,0,1,NA,1,2,4,Construction worker and student,1,0,165,69,3,5,2,0,0,0,0,0,TRUE,TRUE,TRUE,TRUE,TRUE,2,0.8411690476565133,0.84,0.04302850033047552,2,0.47046250002086165,0.5406000000317892,1,0.967741935483871,0.0017180753232479864,0.002248492904820596,2,0.5747625000402331,0.6590225806466995,1,0.96875,0.006204247579917024,0.0036063544793432383,1.4461,1.2925,0.4967,0.9834,1.2323,0.6565,0.2356,1.4539592886666666,1.1482915910333333,0.48926795193333333,1.2013,6.549,0.3787,4.4524,0.4121,-98.3959,1.0154,7.5636,0.405,6.8414,0.4682,0.8425,1.2969651434,4.403265862666666,6.049928698,0.4036171847,0.3687648779,1.0064,6.6858,0.5027,8.2782,0.5957,0.9326,0.08,0.419,0.57,0.013,1.682,129.3846153846154,2.2816841246666666,4.827193143666666,3.8492385966666665,0.34188799096666667,0.37723611603333335,104,0.3081481481481481,1,1,0,1,FALSE,FALSE,FALSE
263,2021-11-13T02:40:18Z,2021-11-13T03:00:59Z,1240,1,2021-11-13T03:01:01Z,1,Chrome,95.0.4638.69,Macintosh,1440,900,n/a,1.6,751,40,246,57,34,64,-0.09814794119189,-0.45245982790863687,-0.873806405791818,-0.5798457090704782,-0.5241007492181928,-0.6989073197411108,3,3,2,2,3,1,1,2,1,3,2,1,1,1,3,3,1,1,2,3,0.8870412083230169,0,1,1,4,4,1.75,0,4,4,2,4,2,2,3,2,2,2,2,4,3,4,4,1,4,1,1,1,1,1,1,0,2,0,0,5,5,5,5,5,5,5,5,5,1,5,1,1,5,2,5,2,1,1,1,1,3,1,1,1,2,1,1,1,1,1,5,1,1,1,1,1,1,1,1,1,1.879636409796595,0.9611501047232549,1.375,0,1,0,2.1333333333333333,0,1,0,1.1666666666666667,0,1.3333333333333333,0,0.8571428571428571,0,1,0,1.135135135135135,0,0,0,0,-1.0826661445166619,-0.8620950066440746,-0.7372407672780129,-0.7996678869610437,5,1,5,1,1,1,1,1,1,1.9518001458970664,1,0,1,-0.9031185640466358,4,5,5,5,4,4,1,6,6,6,4,1.4142135623730951,4.571428571428571,0,1.4285714285714286,3,3.8333333333333335,3.2559414990859232,-0.7395711320441822,0,-0.9432371114476243,2,2,2,2,2,2,4,2,2,2,1,3,2,3,4,1,4,2,3,2,0.990430401872025,2,0,4,0,3.6,0,3.8,0,3.8,0,1,1,1,4,1,1,1,4,1,1,2,4,1,2,1,4,1,1,1,1,1.2182817926554552,1.1,0,"White, Caucasian, Anglo, European American",0,27,1,2,NA,1,3,6,Marketing,3,0,123,64,3,5,2,0,0,1,0,0,TRUE,TRUE,TRUE,TRUE,TRUE,2,0.9781857142857143,0.7,0.11960366973180378,2,0.7182354838732751,0.7905593750029802,1,1,0.06167489036250561,0.07480600183869254,2,0.8887999999951571,1.1334375000037253,1,1,0.084367592904661,0.13260328758387682,1.6655,0.5343,0.3255,1.3536,0.5965,0.556,0.3652,1.6336670213333333,0.62644222517,0.32728884793333335,2.5083,2.5005,0.2167,2.5223,0.2933,-3.0193,1.6288,1.8821,0.3435,1.7348,0.4071,0.9405,2.0445080246666665,2.3584836306666666,2.391723950333333,0.34275019986666666,0.2691390807,1.8037,1.4897,0.4313,2.2986,0.7727,0.7341,0.29,0.004,0.332,0.009,2.071,230.11111111111114,2.898901628,2.6241328433333333,2.0678313534333332,0.3224753868,0.4172229530666667,434,1.285925925925926,1,0,0,1,FALSE,FALSE,FALSE
264,2021-11-13T02:39:17Z,2021-11-13T03:01:46Z,1349,1,2021-11-13T03:01:47Z,0.8999999761581421,Chrome,95.0.4638.69,Macintosh,1680,1050,NA,1.6,646,65,364,90,68,77,-0.3679314780359296,-0.22534137007908028,-0.30572618794748735,-0.17769429344704088,-0.054490721565468275,-0.47931955185002084,4,4,2,3,3,1,1,3,1,3,4,1,1,1,4,4,1,1,3,3,1.2732056517228265,0,1,2,5,5,1.4,0,1,1,5,2,5,5,3,5,5,5,3,1,5,1,1,5,5,5,2,5,5,5,5,3,2,2,5,5,1,1,1,1,1,1,1,1,5,3,5,3,1,2,2,5,5,5,5,5,1,4,5,3,3,3,2,5,1,2,2,4,5,4,5,5,2,4,4,2,1.698789535488692,1.8593393604027366,4.625,0,3,0,4.666666666666667,0,4.555555555555555,0,4.333333333333333,0,3.6666666666666665,0,3.142857142857143,0,4.666666666666667,0,4.135135135135135,0,2,2,5,2.804886797757614,2.912530085149767,1.5916684517349,2.2520992684423335,3,3,2,4,3,5,3,2,1,0.9511897312113419,3.5714285714285716,0,1.5,0.8197846061331525,1,1,1,1,1,1,5,3,3,1,1,1.5118578920369088,1,0,5,6,3.8333333333333335,3.2559414990859232,0.9547190977297628,0,1.8956829389752667,1,1,2,3,2,2,5,1,1,1,1,5,1,4,5,2,5,1,5,4,1.8464895909600492,1.8,0,4.8,0,4,0,4.2,0,4.333333333333333,0,1,4,1,2,2,1,3,4,3,2,1,3,4,4,1,3,2,4,2,2,1.145931016569864,2.25,0,"Hispanic of Latino (e.g., Mexican American, Central American, and others)",0,21,1,2,NA,1,2,5,student,3,0,106,65,1,5,2,0,0,1,0,0,TRUE,TRUE,TRUE,TRUE,TRUE,2,0.717126315788611,0.76,0.02955926564856725,2,0.5149343749983236,0.5752812499995343,1,1,0.0035199371673652474,0.006556382862851871,2,0.6140218750000931,0.750737500000745,1,1,0.007426734022309718,0.011101289516186231,1.254,0.9805,0.3861,0.9998,1.23,0.4984,0.2625,1.3006789473333333,0.9650300061366667,0.37918158523333334,5.0491,9.0462,0.2359,7.1965,0.2245,-82.3004,0.9186,5.1854,0.4311,4.6949,0.4827,0.9829,1.9315711746666666,4.498688398666666,5.629349022333333,0.3639468861,0.3473544284,0.9927,3.1111,0.4923,3.3273,0.618,0.943,0.195,0.289,0.605,0.009,1.526,169.55555555555557,2.334277804,4.830813398,4.533543374,0.37651307123333333,0.4995861854,444,1.3155555555555554,1,0,0,1,FALSE,FALSE,FALSE
265,2021-11-13T02:45:24Z,2021-11-13T03:02:26Z,1021,1,2021-11-13T03:02:27Z,0.8999999761581421,Safari,14.0.3,Macintosh,1440,900,NA,1.6,567,43,236,42,25,58,-0.5709114724233499,-0.4252056129690901,-0.9219487971345579,-0.7626418070811315,-0.6484092859497964,-0.8002555203062293,1,2,3,3,2,3,2,2,2,2,1,2,2,3,1,2,2,3,2,2,0.6407232755171874,0,1,1,3,2,2.9,0,3,4,2,4,1,3,3,3,4,4,4,4,3,4,4,4,3,1,1,2,2,4,2,3,2,0,0,4,4,4,5,4,4,3,4,4,4,4,3,2,2,3,2,3,2,3,2,3,4,3,4,2,2,1,1,4,4,2,5,2,2,1,1,1,1,1,1,1,1.187396273326605,0.8997354108424374,2.375,0,1,0,2.6666666666666665,0,2,0,2.9166666666666665,0,2.1666666666666665,0,2.142857142857143,0,1,0,2.324324324324324,0,2,0,0,0.2790280752637333,0.30790520130515253,-0.33105581968498016,-0.011575309189913813,5,1,4,1,1,1,1,2,1,1.7320508075688772,1.1428571428571428,0,1.5,-0.6331575415043005,5,5,5,5,5,5,1,7,7,6,5,1.5118578920369088,5,0,1,2,3.8333333333333335,3.2559414990859232,-1.3043345419688306,0,-1.464631808674259,4,4,4,3,4,2,3,3,3,4,4,4,3,4,4,4,4,3,2,4,0.7367883976130072,3.8,0,3.4,0,2.8,0,3.2,0,3.1333333333333333,0,3,1,3,3,3,4,3,3,3,3,3,3,2,1,3,2,2,3,3,3,0.7326950970650465,2.6,0,"Asian or Asian American (e.g., Chinese, Japanese, and others)",0,21,1,2,NA,1,5,3,student,6,0,100,60,3,5,2,0,0,2,0,0,TRUE,TRUE,TRUE,TRUE,TRUE,1,0.6485806451612899,0.62,0.02869295877551095,1,0.41896774193548014,0.5408620689655093,1,0.90625,0.003831832258065602,0.0069723054435468475,1,0.5978750000000018,0.713814814814817,1,0.84375,0.004742370967741169,0.011758709677419314,1.2803,0.4172,0.3205,0.9047,0.2741,0.4779,0.2202,1.3242900183333333,0.604914149387,0.31526686426666667,1.1343,4.55,0.2943,2.4854,0.3428,-62.3055,0.8492,5.4122,0.3424,3.4193,0.4338,0.9876,1.2333291112666667,2.7381264485333334,4.707776091,0.3361333311,0.288358682,0.8224,5.4794,0.5217,2.761,0.5965,0.9232,0.068,0.464,0.542,0.012,1.82,151.66666666666666,1.3032534775666667,4.545692883333333,1.8540421404333334,0.4565304876333333,0.4188623663,104,0.3081481481481481,1,0,0,1,FALSE,FALSE,FALSE
266,2021-11-13T02:38:12Z,2021-11-13T03:02:27Z,1455,1,2021-11-13T03:02:29Z,1,Chrome,95.0.4638.69,Macintosh,1440,900,NA,1.6,652,94,389,71,71,93,-0.3525152759305559,0.038116041003205335,-0.18537020959063766,-0.4092360175938684,-0.013054542654933752,-0.20905768367637165,2,3,2,2,3,1,1,2,1,3,3,1,1,1,3,3,1,1,3,2,0.8870412083230169,0,1,5,2,3,1.75,0,3,2,2,2,2,1,4,1,4,1,1,1,5,3,5,4,3,1,1,4,4,5,3,0,2,3,0,5,3,4,5,3,5,3,5,5,2,5,5,2,3,3,5,5,5,5,5,5,2,3,1,1,4,3,1,1,1,1,1,5,5,5,5,2,1,1,1,1,1.6093756833288149,1.4573295865416045,3.125,0,1,0,2.6,0,1.7777777777777777,0,3.5,0,2.5,0,2.5714285714285716,0,4,0,2.8378378378378377,0,0,3,0,1.0649441835937759,0.8222484429532494,-0.11734114449894173,0.35245364922715383,5,1,4,1,1,1,1,1,1,1.7320508075688772,1.1428571428571428,0,1,-0.8176513788914915,2,3,3,5,1,1,5,1,3,1,2,1.6761634196950514,2.2857142857142856,0,3.7142857142857144,7,3.8333333333333335,3.2559414990859232,1.5194825076544112,0,1.4610256671446602,1,1,4,2,2,1,5,1,1,5,1,5,1,5,5,1,5,1,5,3,2,2,0,5,0,5,0,4.6,0,4.866666666666666,0,3,4,2,4,2,1,4,3,1,2,4,3,2,1,1,3,1,2,1,1,1.164157703189193,1.95,0,"White, Caucasian, Anglo, European American",0,30,1,2,NA,1,3,6,k12 teacher,4,0,111,67,2,5,2,0,0,1,0,0,TRUE,TRUE,TRUE,TRUE,TRUE,6,0.9113064516130234,0.6326530612244898,0.02467341534011486,6,0.5125718750000233,0.5595387096772751,1,0.96875,0.003981614344689405,0.004752959022195262,6,0.6125156249997672,0.7455968749998138,1,1,0.007770609102836902,0.01761252869958659,1.311,0.4533,0.5549,0.8704,0.3188,0.7588,0.2757,1.363665138,0.622370977619,0.5452292612666667,1.8425,5.8083,0.354,3.7472,0.3232,-69.3282,0.9626,6.0284,0.433,4.8938,0.4691,0.8269,1.770517926,3.647860905,5.351591327,0.3250175094666667,0.35011378256666664,1.0438,4.9205,0.5102,2.4806,0.5936,0.9922,0.176,0.297,0.555,0.01,1.441,144.1,2.687660383,4.835972856333333,3.8804127656666667,0.3383784583,0.40247006343333336,428,1.268148148148148,1,0,0,1,FALSE,FALSE,FALSE
267,2021-11-13T02:29:20Z,2021-11-13T03:02:35Z,1994,1,2021-11-13T03:02:36Z,1,Chrome,95.0.4638.69,Macintosh,1280,800,NA,1.6,960,59,447,117,109,139,0.4388497654786269,-0.2798497999581739,0.09385566019725369,0.15133868297213507,0.5118037235451701,0.5679451873228698,3,2,3,1,3,3,2,2,1,3,2,3,3,3,2,3,2,1,2,2,0.7326950970650465,0,1,2,3,2,2.4,0,2,3,4,3,4,1,2,3,3,2,4,3,2,3,3,3,4,1,1,3,2,4,3,4,1,0,1,4,2,2,3,2,3,2,3,2,3,5,3,3,3,3,3,4,3,4,5,4,3,2,3,1,2,5,1,4,4,1,3,3,3,3,3,1,4,3,2,2,1.0640169792499234,0.8618916073713346,2.625,0,2.75,0,3.066666666666667,0,3.4444444444444446,0,3.25,0,2.5,0,2.5714285714285716,0,2.3333333333333335,0,3.027027027027027,0,2,0,1,0.8716172264644607,0.8892272768298931,0.39420224623488836,0.6417147615323907,3,1,1,2,2,3,2,3,1,0.816496580927726,2.5714285714285716,0,2,0.4060081474343336,3,3,3,3,2,2,3,4,4,1,2,0.4879500364742666,2.7142857142857144,0,3.2857142857142856,5,3.8333333333333335,3.2559414990859232,0.38995568780511447,0,0.6572492649557016,4,4,4,3,3,3,5,4,4,1,2,4,3,4,4,1,4,2,4,2,1.245945806357946,3.6,0,3.8,0,3.6,0,3.2,0,3.533333333333333,0,3,3,3,1,3,3,2,2,3,3,3,3,3,3,3,3,2,3,4,3,0.6155870112510925,2.9,0,"Hispanic of Latino (e.g., Mexican American, Central American, and others) & White, Caucasian, Anglo, European American",1,21,1,3,NA,1,2,3,unemployed,1,0,87,62,1,5,2,0,1,2,0,1,TRUE,TRUE,TRUE,TRUE,TRUE,5,1.0882589743589888,0.78,0.10950808063670919,5,0.5866032258064877,0.6155193548387577,0.96875,0.96875,0.017050983377028775,0.016778212741965615,5,0.7279343749998661,0.8009032258065117,1,1,0.00658135329637958,0.014887130322548583,1.8921,0.7474,0.4122,1.1471,0.8834,0.823,0.5184,1.795618213,0.7596527938,0.41400115383333336,1.697,2.9073,0.3164,2.6388,0.3059,-27.9738,1.3272,2.8536,0.3747,4.1563,0.4469,0.9633,1.7546112963333333,2.7916799833333332,3.08457108,0.30437971416666665,0.31138734236666665,1.2154,3.7592,0.5816,2.8154,0.6123,0.9967,0.087,0.542,0.45,0.034,1.921,56.5,2.792009363,5.36268552,4.114053881333334,0.4728668575666667,0.4664323273666667,378,1.12,1,0,0,1,FALSE,FALSE,FALSE
268,2021-11-13T02:28:25Z,2021-11-13T03:03:27Z,2101,1,2021-11-13T03:03:28Z,1,Chrome,95.0.4638.54,Macintosh,1440,900,n/a,1.6,1623,50,224,56,48,69,2.14234009812242,-0.36161244477681426,-0.9797196667458458,-0.5920321156045217,-0.3307319143023651,-0.6144504859368455,3,3,2,2,3,2,3,3,1,3,2,1,1,2,3,3,2,1,2,2,0.7677718959499145,0,1,1,2,1,2,0,2,5,3,4,3,3,3,4,4,4,5,2,3,2,3,5,5,5,1,5,5,5,5,2,2,0,0,3,3,2,4,4,5,5,5,3,2,3,2,2,1,3,2,5,5,5,5,5,1,1,5,1,3,2,1,2,2,2,5,1,1,1,1,4,2,3,1,1,1.559625734730109,0.9759000729485332,4.5,0,1.75,0,3.3333333333333335,0,2.2222222222222223,0,3.8333333333333335,0,2.6666666666666665,0,1.2857142857142858,0,2,0,2.675675675675676,0,1,0,0,1.819339592391865,1.6586127544100062,-0.2989446853297732,0.6798340345401165,5,1,5,1,1,1,1,1,1,1.9518001458970664,1,0,1,-0.9031185640466358,5,5,5,5,5,5,1,7,6,5,4,1.5118578920369088,5,0,1,2.5,3.8333333333333335,3.2559414990859232,-1.0219528370065065,0,-1.3234409561930969,2,1,2,3,3,2,5,1,1,4,1,5,4,5,5,1,5,1,4,3,1.7674302033770737,2.2,0,4.8,0,4,0,4.6,0,4.466666666666667,0,1,1,4,4,3,4,4,2,1,2,4,2,1,4,2,2,3,4,2,3,1.1821033884786185,2.65,0,"Hispanic of Latino (e.g., Mexican American, Central American, and others) & White, Caucasian, Anglo, European American",1,22,1,2,NA,1,3,6,Postgraduate Fellow (research lab),2,0,112,61,2,5,2,0,0,1,0,0,TRUE,TRUE,TRUE,TRUE,TRUE,6,0.7576388888822662,0.72,0.019576449960841798,6,0.4756838709615892,0.5515562499836087,1,1,0.0043864460664747714,0.006174737385783099,6,0.9121312500238419,0.9580566666523616,1,0.967741935483871,0.15360576931000428,0.05946586837393866,1.0941,0.9004,0.471,0.9374,1.2699,0.5526,0.2534,1.1593886784,0.9211624501566666,0.4624669545,4.3674,8.8287,0.2283,6.5387,0.2176,-80.181,0.7955,4.8988,0.3966,4.2925,0.4797,0.9305,1.8752917376666667,4.145257608666666,5.8771557906666665,0.32709810326666666,0.32106945486666666,1.9959,1.8994,0.3697,2.0738,0.5169,0.796,0.1,0.416,0.2,0.02,1.738,86.89999999999999,2.219683864333333,2.1759372833333335,2.2060894088,0.38129140586666666,0.47293166216666666,104,0.3081481481481481,1,0,2,3,FALSE,FALSE,FALSE
269,2021-11-13T02:44:26Z,2021-11-13T03:03:39Z,1152,1,2021-11-13T03:03:39Z,1,Chrome,95.0.4638.69,Macintosh,1280,800,NA,1.6,601,52,269,64,48,75,-0.4835529938262323,-0.3434429681504497,-0.7630789057035163,-0.4945408633321733,-0.3307319143023651,-0.513102285371727,4,4,2,3,4,1,1,4,1,4,4,1,1,1,4,4,1,1,3,4,1.4290224851827542,0,1,2,3,2,1.2,0,2,5,4,4,1,1,5,5,1,1,4,2,1,3,3,5,5,1,1,5,5,5,5,1,2,0,0,3,1,4,2,2,4,1,1,1,4,4,5,1,2,1,5,1,5,5,5,5,4,1,1,1,2,1,1,2,1,1,5,1,1,1,1,3,1,1,1,1,1.6407901121691928,1.61245154965971,4,0,1,0,2.4,0,3.888888888888889,0,3.25,0,1.1666666666666667,0,1,0,1.6666666666666667,0,2.5675675675675675,0,1,0,0,1.441091198008422,0.9961804725433192,-0.5341482934814965,0.23101608953091135,5,1,4,1,1,3,1,1,1,1.7043362064926932,1.4285714285714286,0,1,-0.6467170085812028,5,5,5,5,4,4,1,6,7,5,3,1.4638501094227998,4.714285714285714,0,1.2857142857142858,2.5,3.8333333333333335,3.2559414990859232,-1.0219528370065065,0,-1.1640989613502233,1,1,1,1,1,1,5,1,1,3,1,5,1,2,3,1,4,2,4,3,1.505545305418162,1,0,4.6,0,4.4,0,3.6,0,4.2,0,1,4,3,3,2,3,3,2,1,3,3,3,2,2,1,3,2,3,3,3,0.8271701918685112,2.4,0,"White, Caucasian, Anglo, European American",0,24,1,2,NA,1,2,6,student,1,0,112,62,3,5,2,0,0,1,0,0,TRUE,TRUE,TRUE,TRUE,TRUE,4,0.8908052631571497,0.76,0.04793731435101328,4,0.5149322580647084,0.5807354838699103,1,0.96875,0.00627367492478991,0.016728959344628737,4,0.7609281249996275,0.8393741935486755,1,1,0.028304207248132526,0.023993796645355715,1.4882,0.8413,0.4275,0.815,1.5381,0.7373,0.5383,1.5010038533333334,0.8636615013333333,0.4222944371333333,1.1531,4.0032,0.3709,3.1443,0.4055,-64.4622,1.1597,5.1288,0.4015,3.4818,0.4003,0.7829,1.372892124,3.403442045,4.377843207333333,0.38543892036666666,0.35675722243333335,1.2028,2.225,0.5304,2.5664,0.6362,0.9702,0.278,0.211,0.512,0.016,1.494,93.375,2.7140501383333335,3.59277384,3.6905121,0.37980420123333336,0.4735533324,370,1.0962962962962963,1,0,0,1,FALSE,FALSE,FALSE
270,2021-11-13T02:35:08Z,2021-11-13T03:03:38Z,1710,1,2021-11-13T03:03:40Z,1,Edge,95.0.1020.44,Windows NT 10.0,1536,864,NA,1.7777777777777777,708,97,394,118,71,151,-0.20863072294706814,0.06537025594275213,-0.1612990139192677,0.16352508950617864,-0.013054542654933752,0.7706415884531067,2,1,2,2,1,1,3,1,1,2,1,2,1,2,1,1,3,1,1,1,0.6882472016116853,0,1,1,4,4,2.8,0,4,4,2,4,2,2,4,1,2,2,2,5,2,4,5,1,2,1,1,1,2,2,2,0,2,0,1,5,5,4,5,5,4,5,5,5,3,4,1,1,3,3,5,2,2,3,1,3,4,2,1,1,2,2,1,1,1,1,4,2,2,1,3,1,2,1,3,2,1.548029843509613,1.3093073414159542,1.5,0,2,0,1.8,0,1.2222222222222223,0,2.0833333333333335,0,1.5,0,1.2857142857142858,0,1.6666666666666667,0,1.6486486486486487,0,0,0,1,-0.6855053304140466,-0.7309442553393755,-0.24718630950986772,-0.4890652824246216,2,4,2,3,2,4,3,3,2,0.8997354108424374,3.4285714285714284,0,2.5,1.1033050957523902,3,3,3,3,2,2,2,2,2,2,2,0.5345224838248488,2.857142857142857,0,3.142857142857143,7,3.8333333333333335,3.2559414990859232,1.5194825076544112,0,1.1423416774589132,3,2,3,3,3,3,5,3,2,3,2,3,2,4,4,4,3,3,4,3,0.8618916073713346,2.8,0,3.2,0,3.6,0,3.6,0,3.466666666666667,0,2,2,4,1,2,4,4,1,4,3,1,1,3,4,3,1,1,4,2,3,1.2354415362426845,3.1,0,"Asian or Asian American (e.g., Chinese, Japanese, and others)",0,21,0,1,NA,1,1,4,Student (& freelance graphic designer in free time),1,0,170,70,2,5,2,0,0,1,0,0,TRUE,TRUE,TRUE,TRUE,TRUE,1,1.061034782609214,0.92,0.31183377546545776,1,0.39748620689737385,0.46272333333492277,0.9666666666666667,0.9375,0.0051121577472106996,0.00610752499990271,1,0.5385250000013039,0.6537483870983124,1,0.96875,0.006733638710104314,0.008940974182908139,1.8465,1.2015,0.4645,2.0895,1.5446,0.3537,0.0376,1.728290924,1.0865833787,0.4747788183,1.0272,3.1902,0.245,3.3746,0.3256,-62.5397,0.9836,4.3323,0.2851,4.9383,0.3564,0.9982,1.1165749836666667,3.5535845006666666,3.5600539953333334,0.3195204856,0.2416059639,1.1844,4.554,0.4143,4.5629,0.5243,0.9856,0.099,0.335,0.513,0.011,1.709,155.36363636363637,1.8622202953333333,4.516544556,3.47326778,0.3342303330333333,0.3990149934,380,1.125925925925926,1,0,0,1,FALSE,FALSE,FALSE
271,2021-11-13T02:41:54Z,2021-11-13T03:05:05Z,1390,1,2021-11-13T03:05:08Z,1,Firefox,94.0,Windows NT 10.0,1536,864,N/A,1.7777777777777777,618,65,377,126,46,82,-0.4398737545276735,-0.22534137007908028,-0.24314107920192551,0.26101634177852706,-0.3583560335760547,-0.39486271804575546,4,4,1,1,4,1,1,3,1,3,4,1,1,1,4,4,1,2,3,3,1.348488432516786,0,1,1,5,3,1.25,0,5,5,4,4,5,5,3,3,2,4,3,2,3,2,1,1,2,3,1,1,1,1,1,1,2,0,0,4,2,4,2,1,4,3,3,3,2,5,1,1,3,1,5,3,1,2,1,1,3,1,1,1,1,1,1,2,2,2,3,4,2,1,1,1,2,2,1,1,1.2508255532105843,1.2983506020002016,1.375,0,1.5,0,3.2666666666666666,0,3.111111111111111,0,1.5,0,1.1666666666666667,0,2.142857142857143,0,1,0,1.972972972972973,0,1,0,0,-0.5615239122550293,-0.014986980504792623,-0.3773458880470143,-0.19616643427590347,4,1,3,1,1,1,1,1,1,1.2535663410560174,1.4285714285714286,0,1,-0.6467170085812028,3,3,3,5,2,3,4,2,3,4,2,0.9511897312113419,3,0,3,6.5,3.8333333333333335,3.2559414990859232,1.237100802692087,0,0.9214798275563144,2,3,3,3,3,3,2,4,2,4,2,4,4,5,4,2,3,2,4,5,1.1126972805283737,2.8,0,3.6,0,3.2,0,3.2,0,3.3333333333333335,0,2,1,1,4,1,1,1,4,1,1,1,4,2,1,1,4,1,1,1,1,1.2182817926554552,1.1,0,"White, Caucasian, Anglo, European American",0,29,0,1,NA,1,2,3,Electrician,6,0,215,75,3,5,2,0,0,0,0,0,TRUE,TRUE,TRUE,TRUE,TRUE,3,0.6725641025641026,0.78,0.017191257551020408,3,0.469,0.498,0.90625,1,0.0073151250000000004,0.004360193548387095,3,0.56921875,0.6542142857142857,1,0.875,0.005265595766129034,0.009644000000000002,1.055,1.295,0.4647,0.6947,1.3896,0.5736,0.0976,1.1158432082,1.1338805264,0.4569374128,1.1873,2.7045,0.2828,3.9534,0.3478,-59.014,0.8536,3.3412,0.3532,5.2592,0.4222,0.99,1.2845486067,4.075613653666666,3.0325008556666666,0.34168828873333335,0.2772776635,0.6769,7.2208,0.5279,2.8693,0.584,0.8899,0.065,0.407,0.399,0.014,1.831,130.78571428571428,1.3699387856,3.82608782,2.282517364533333,0.3882204465,0.4026434631,395,1.1703703703703703,1,0,0,1,FALSE,FALSE,FALSE
272,2021-11-13T02:36:32Z,2021-11-13T03:05:48Z,1755,1,2021-11-13T03:05:49Z,1,Chrome,95.0.4638.69,Macintosh,1440,900,NA,1.6,658,74,574,107,109,75,-0.3370990738251822,-0.14357872526043994,0.7052640302500502,0.02947461763169954,0.5118037235451701,-0.513102285371727,2,3,3,3,1,1,2,2,1,2,3,3,3,3,2,3,2,1,2,1,0.812727700887249,0,1,2,3,4,2.55,0,3,2,5,3,5,3,4,4,2,1,4,1,1,2,1,5,4,5,2,3,4,4,3,3,1,1,3,2,3,5,4,3,4,2,4,2,3,5,2,1,4,2,3,5,2,2,3,5,1,3,3,5,3,2,1,3,1,1,2,4,4,2,4,1,4,2,1,1,1.2944789205219511,1.4375905768565218,3.75,0,2,0,3.4,0,2.7777777777777777,0,2.5833333333333335,0,3.3333333333333335,0,2.4285714285714284,0,2.3333333333333335,0,2.7567567567567566,0,2,1,3,1.4032663585700773,1.3997956998057508,0.7185311394745503,1.0591634196401505,5,1,4,1,1,1,1,1,1,1.7320508075688772,1.1428571428571428,0,1,-0.8176513788914915,2,3,4,4,3,3,4,6,6,NA,3,0.7559289460184544,3,0,3,3,3.8333333333333335,3.2559414990859232,-0.7395711320441822,0,-0.0668561398118202,1,2,2,3,3,1,5,2,2,4,1,5,3,5,5,3,5,1,3,2,1.5976172734359604,2.2,0,5,0,3.6,0,4.4,0,4.333333333333333,0,2,3,3,4,4,2,4,3,1,2,2,3,3,2,2,2,2,2,1,3,0.8885233166386386,2.3,0,"White, Caucasian, Anglo, European American",0,26,1,2,NA,1,3,6,consultant,4,0,168,65,1,5,2,0,1,1,0,1,TRUE,TRUE,TRUE,TRUE,TRUE,5,1.1270463414637417,0.8367346938775511,0.13821157710891285,5,0.4669562499998137,0.5492419354826693,1,0.96875,0.0012484289919824391,0.004857595967768703,5,0.6350562500006054,0.6878451612901784,1,0.96875,0.009669316733809294,0.014831435766100942,1.9942,0.9407,0.4376,1.2048,1.0741,0.8075,0.2376,1.844430807,0.8835257274666667,0.4409350895,1.3767,6.4458,0.3602,4.2271,0.3937,-91.3561,0.8341,8.9588,0.4247,8.5846,0.4948,0.896,1.4189971745333334,4.134837396666667,5.962110998666667,0.3871476802666667,0.35314130103333335,1.2238,4.2626,0.4988,3.6903,0.5234,0.9919,0.074,0.457,0.398,0.012,1.026,85.5,2.475380963,3.933077364,3.3208838223333332,0.3189460681,0.3294775778,440,1.3037037037037038,1,0,0,1,FALSE,FALSE,FALSE
273,2021-11-13T02:46:00Z,2021-11-13T03:06:13Z,1212,1,2021-11-13T03:06:13Z,1,Chrome,95.0.4638.69,Macintosh,1440,900,NA,1.6,611,45,309,75,56,67,-0.4578593236506095,-0.40703613634272556,-0.5705093403325567,-0.3604903914576942,-0.22023543720760635,-0.6482332194585516,2,2,2,2,2,1,2,2,1,3,2,1,1,2,2,2,2,1,2,2,0.5231483637805969,0,1,1,4,3,2.2,0,3,4,2,4,2,2,3,2,2,2,5,3,2,3,2,3,5,5,1,2,4,3,4,1,2,0,1,5,1,4,4,4,5,5,5,5,3,5,3,1,3,2,4,1,4,5,5,5,1,3,1,2,2,1,2,5,5,1,5,1,1,1,1,3,2,3,3,3,1.672961087054567,0.9611501047232549,3.375,0,2.75,0,2.6,0,1.7777777777777777,0,2.9166666666666665,0,2.1666666666666665,0,2.142857142857143,0,1.6666666666666667,0,2.324324324324324,0,1,0,1,0.9010365460276174,0.7090038827860924,0.191109772438372,0.4500568276122322,5,1,4,1,1,1,1,1,1,1.7320508075688772,1.1428571428571428,0,1,-0.8176513788914915,5,5,5,5,4,4,4,6,6,NA,4,0.5345224838248488,4.285714285714286,0,1.7142857142857142,3,3.8333333333333335,3.2559414990859232,-0.7395711320441822,0,-0.783895116604751,1,3,3,3,3,1,5,1,1,4,1,5,2,5,5,1,5,5,5,3,1.869555587629877,2.6,0,4.2,0,4.6,0,4.6,0,4.466666666666667,0,2,2,3,3,3,3,2,3,3,3,2,1,2,3,1,2,2,3,1,4,0.8207826816681233,2.5,0,"White, Caucasian, Anglo, European American",0,27,1,2,NA,1,3,6,Teacher,2,0,125,65,2,5,2,0,0,1,0,0,TRUE,TRUE,TRUE,TRUE,TRUE,5,0.7378418604592945,0.86,0.01741979836725439,5,0.4327933333237966,0.5247781250067055,0.9375,1,0.0027255496679670075,0.005242350151118996,5,0.5665967741935484,0.6326862068895636,0.96875,0.90625,0.0077557844748360975,0.005186309989144534,1.2076,1.6315,0.4737,0.7668,2.3151,0.6273,0.2475,1.2430658722666668,1.3184379188333333,0.46519055146666666,1.232,3.5999,0.2759,4.1067,0.3748,-69.685,0.7734,4.9482,0.3609,4.7873,0.447,0.8686,1.3381709174666667,4.1922493523333335,3.8810201836666667,0.3670520152,0.27045103913333335,0.7675,4.2824,0.4779,2.6329,0.5341,0.9278,0.049,0.453,0.411,0.018,1.725,95.83333333333334,1.1317156964666666,3.6236421853333334,2.9091863646666667,0.4258950096333333,0.46271843576666666,372,1.1022222222222222,1,0,0,1,FALSE,FALSE,FALSE
275,2021-11-13T02:44:13Z,2021-11-13T03:07:13Z,1379,1,2021-11-13T03:07:14Z,1,Chrome,95.0.4638.69,Windows NT 10.0,1920,1080,NA,1.7777777777777777,673,69,324,83,87,96,-0.298558568561748,-0.18900241682635124,-0.49829575331844694,-0.26299913918534573,0.20793841153458367,-0.15838358339381242,3,3,2,1,3,1,1,3,1,3,3,1,1,3,3,3,2,2,3,3,0.910465468000326,0,1,1,3,4,1.75,0,2,4,4,3,3,4,2,4,3,3,3,1,3,2,2,3,4,1,2,2,3,3,3,5,2,0,5,1,1,1,1,1,1,1,3,3,2,3,2,1,3,2,4,4,4,4,5,5,2,4,1,1,4,3,1,4,3,3,4,3,3,1,4,3,4,4,4,4,1.322024110123468,0.9154754164341269,2.625,0,4,0,3.533333333333333,0,4.555555555555555,0,3.0833333333333335,0,2.6666666666666665,0,2.5714285714285716,0,2.6666666666666665,0,3.2972972972972974,0,3,0,5,1.0397276239682132,1.2059248844084727,1.6950993212143333,1.450512102811403,1,4,1,3,4,4,4,3,2,1.4142135623730951,4.142857142857143,0,2.5,1.5306410215281119,3,3,4,2,1,1,3,4,4,2,2,1.1338934190276817,2.4285714285714284,0,3.5714285714285716,5,3.8333333333333335,3.2559414990859232,0.38995568780511447,0,0.8165912597985752,3,2,2,2,3,2,3,3,2,3,1,3,2,3,4,5,4,2,3,4,1.0327955589886444,2.4,0,4,0,2.8,0,3.2,0,3.3333333333333335,0,1,1,1,4,3,2,2,3,1,1,1,4,1,2,1,4,1,2,1,2,1.1192102478745307,1.4,0,"White, Caucasian, Anglo, European American",0,19,0,1,NA,1,3,4,student,4,0,190,70,3,5,2,0,0,1,0,0,TRUE,TRUE,TRUE,TRUE,TRUE,4,0.8944771428627627,0.7142857142857143,0.17088587677776026,4,0.5162466666738192,0.598018750003539,0.967741935483871,1,0.006613907612675412,0.006431478346734297,4,0.6844366666734218,0.7317666666726271,0.967741935483871,0.967741935483871,0.021376807461679435,0.025570173784610455,1.4239,0.6651,0.464,1.1274,0.886,0.5983,0.3895,1.453215364,0.7474458780833333,0.45658610146666667,1.1584,3.302,0.3481,4.6757,0.4741,-73.1498,1.1352,5.0248,0.4032,4.363,0.4665,0.6897,1.4292056948333334,4.721705764666667,3.793760177,0.45080586986666665,0.3310287044333333,1.653,4.6104,0.4975,6.1557,0.5692,0.9769,0.08,0.456,0.344,0.018,1.426,79.22222222222223,1.9620852626666667,2.7131004526666667,3.054826494333333,0.33394975276666666,0.42680108436666664,104,0.3081481481481481,1,0,0,1,FALSE,FALSE,FALSE
276,2021-11-13T02:43:34Z,2021-11-13T03:08:11Z,1476,1,2021-11-13T03:08:12Z,0.800000011920929,Firefox,94.0,Windows NT 10.0,1920,1080,Nothing I can think of!,1.7777777777777777,710,68,390,88,87,70,-0.20349198891194356,-0.1980871551395335,-0.18055597045636368,-0.202067106515128,0.20793841153458367,-0.5975591191759924,3,3,2,2,3,1,2,2,1,2,1,1,1,2,2,2,2,1,2,1,0.6958523739384593,0,1,1,3,3,2.2,0,5,3,3,3,3,3,5,2,1,1,1,4,2,4,3,2,1,3,1,1,1,2,1,2,1,1,1,5,2,5,5,5,5,3,3,5,3,5,1,1,5,3,5,5,4,3,3,5,1,1,3,1,3,3,1,2,2,1,3,4,2,2,4,1,2,1,1,1,1.5235883044055312,1.3020130933435712,1.5,0,1.25,0,2.066666666666667,0,1.7777777777777777,0,2.5833333333333335,0,2.5,0,2,0,2.3333333333333335,0,2.2972972972972974,0,1,1,1,-0.28204037640504065,-0.337588791647643,-0.07266423627205096,-0.205126513959847,4,2,1,1,1,2,1,1,1,1.1126972805283737,2,0,1,-0.3048482679606258,3,3,4,2,1,1,4,3,1,2,2,1.2724180205607036,2.2857142857142856,0,3.7142857142857144,7,3.8333333333333335,3.2559414990859232,1.5194825076544112,0,1.4610256671446602,2,3,4,3,4,3,5,1,2,2,1,4,4,4,5,4,5,2,4,4,1.3972762620115438,3.2,0,4.2,0,3,0,4,0,3.7333333333333334,0,2,1,4,1,4,4,4,1,4,3,1,1,3,3,2,1,1,4,1,2,1.3088765773505315,2.95,0,"Hispanic of Latino (e.g., Mexican American, Central American, and others) & White, Caucasian, Anglo, European American",1,22,0,1,NA,1,3,3,Student,3,0,215,68,1,5,2,0,0,1,0,0,TRUE,TRUE,TRUE,TRUE,TRUE,3,0.7314285714285714,0.84,0.0388761506122449,3,0.49023333333333335,0.5291612903225806,0.967741935483871,0.96875,0.004465873118279571,0.0033828225806451615,3,0.54996875,0.6052666666666666,1,0.9375,0.007613837701612904,0.005451290322580643,1.1813,1.4582,0.4663,0.968,1.5194,0.5344,0.1425,1.2284360987666667,1.2317990059666666,0.4571203161,1.2946,3.3401,0.3049,4.2562,0.3833,-64.5223,0.7998,4.8128,0.4109,4.6167,0.4539,0.935,1.4196889015,4.294894666,3.6562022043333333,0.37320720186666667,0.29837129253333333,0.8138,4.0988,0.471,3.686,0.5215,0.8488,0.089,0.34,0.448,0.016,1.701,106.3125,1.594238908,3.570475936333333,3.3575731463333334,0.32310963313333335,0.3939245977,314,0.9303703703703704,1,0,0,1,FALSE,FALSE,FALSE
277,2021-11-13T02:46:06Z,2021-11-13T03:08:15Z,1329,1,2021-11-13T03:08:16Z,1,Chrome,93.0.4577.82,Macintosh,1280,800,NA,1.6,646,68,348,76,58,87,-0.3679314780359296,-0.1980871551395335,-0.3827540140958712,-0.3483039849236506,-0.19261131793391667,-0.31040588424149007,2,2,3,3,2,1,2,2,1,2,2,1,1,1,2,2,2,2,1,1,0.6386663736585051,0,0,2,3,2,2.45,0,2,4,3,3,2,1,4,2,2,1,1,4,3,4,3,2,3,1,1,1,1,1,1,0,2,0,0,4,4,3,4,5,4,4,4,4,2,4,2,2,3,3,4,1,1,1,1,1,4,1,1,1,1,1,1,1,1,1,5,2,2,1,1,1,2,2,1,2,1.4347677716475786,1.121223821162776,1.375,0,1.75,0,2.2,0,2,0,1.75,0,1,0,1.1428571428571428,0,1,0,1.5675675675675675,0,0,0,0,-0.8136895085106579,-0.6476078738830316,-0.5020371591262895,-0.5748225165046605,5,1,3,1,1,1,1,3,1,1.5735915849388864,1.2857142857142858,0,2,-0.3631965189619651,4,4,4,4,3,3,3,5,6,2,3,0.5345224838248488,3.5714285714285716,0,2.4285714285714284,3.5,3.8333333333333335,3.2559414990859232,-0.4571894270818581,0,-0.24434927701640521,1,1,1,2,1,1,4,1,1,1,1,3,3,4,4,3,4,2,3,3,1.245945806357946,1.2,0,4.2,0,2.8,0,4.2,0,3.7333333333333334,0,2,2,2,1,3,3,3,2,2,2,2,2,2,2,1,2,3,3,1,2,0.6407232755171874,2.4,0,"White, Caucasian, Anglo, European American",0,27,1,2,NA,1,3,7,school counselor,2,0,130,64,1,5,2,0,0,1,0,0,TRUE,TRUE,TRUE,TRUE,TRUE,2,0.975070731707099,0.82,0.02978663339148163,2,0.5433903225794915,0.6387766666650772,1,0.967741935483871,0.00963447490319328,0.012553527312115861,2,0.6326451612908033,0.7581166666671634,0.96875,0.9375,0.012641774838886564,0.01800265032263755,1.325,1.2497,0.6312,0.9267,1.5744,0.7961,0.1275,1.372327717,1.123922734,0.6191470123333334,1.9119,4.6315,0.337,2.9274,0.3252,-45.95,1.0677,5.8014,0.4453,3.1238,0.4928,0.9665,1.8723444146666666,2.9594952203333333,4.504218293666667,0.32791164803333334,0.33466978903333333,1.6105,4.3228,0.4484,4.9731,0.5805,0.9882,0.064,0.461,0.355,0.01,1.526,152.6,2.007985098333333,2.8585940776666665,2.315752508666667,0.2837689992333333,0.34788158096666666,404,1.1970370370370371,1,0,0,1,FALSE,FALSE,FALSE
278,2021-11-13T02:39:07Z,2021-11-13T03:10:09Z,1861,1,2021-11-13T03:10:10Z,0.8999999761581421,Chrome,95.0.4638.54,Windows NT 10.0,1366,768,no feedback,1.7786458333333333,778,67,537,99,71,138,-0.028775031717708392,-0.20717189345271578,0.5271371822819126,-0.06801663464064889,-0.013054542654933752,0.5510538205620167,4,3,1,1,3,1,1,2,1,4,2,1,1,1,4,3,1,1,3,2,1.1697953037312037,0,1,1,1,1,1.5,0,3,4,2,4,2,3,2,2,1,4,4,3,1,3,1,2,2,1,1,1,1,3,1,6,2,0,0,4,1,4,2,2,2,1,1,2,1,2,1,1,2,1,1,1,1,1,1,1,3,1,5,1,1,1,1,5,5,5,4,1,1,1,1,1,2,2,3,3,1.4099602788688723,1.121223821162776,1.5,0,2.5,0,2.7333333333333334,0,3.888888888888889,0,1.8333333333333333,0,1.8333333333333333,0,2.7142857142857144,0,1,0,2.4864864864864864,0,3,0,0,-0.16436309815241404,0.03021405333970467,0.3424438704149829,0.1863289618773438,5,1,4,1,1,1,1,3,3,1.7320508075688772,1.1428571428571428,0,3,-0.07967602934272733,4,4,4,5,2,2,2,1,6,2,2,1.2535663410560174,3.5714285714285716,0,2.4285714285714284,5.5,3.8333333333333335,3.2559414990859232,0.6723373927674386,0,0.32041413290824317,2,2,2,2,2,2,5,2,1,3,1,2,1,4,5,1,5,1,3,2,1.5522640914238175,2,0,4.2,0,4.2,0,4.4,0,4.266666666666667,0,1,1,2,1,1,3,2,1,3,1,4,2,1,2,1,2,1,2,2,2,0.8506963092234007,2.15,0,"Black or African American & White, Caucasian, Anglo, European American",1,24,1,2,NA,0,3,6,unemployed,5,0,173,63,2,5,2,0,0,0,0,0,TRUE,TRUE,TRUE,TRUE,TRUE,3,1.0605499999962356,0.7755102040816326,0.13822577067996816,3,0.5886000000238418,0.6729548386758374,1,0.96875,0.0034208774232464445,0.01700752902701901,3,0.6361483871013888,0.7476531250178814,0.96875,1,0.008096902168713511,0.011847811596346708,1.6135,0.8323,0.5207,1.2591,1.0153,0.6823,0.249,1.6052738603333334,0.8482395497333334,0.5136114244666666,1.3992,5.7656,0.4673,2.6512,0.4191,-65.6988,1.2977,4.9114,0.4628,3.205,0.4866,0.8048,1.6909097836666667,2.9737585236666666,5.611860692333333,0.39354040846666666,0.44168207806666665,0.9787,4.5136,0.5293,3.0652,0.6152,0.987,0.226,0.283,0.645,0.014,1.686,120.42857142857142,2.160472608,3.881188867666667,3.7335274376666665,0.37375804786666667,0.46049902066666665,111,0.32888888888888884,1,0,0,1,FALSE,FALSE,FALSE
279,2021-11-13T02:49:16Z,2021-11-13T03:10:56Z,1299,1,2021-11-13T03:10:57Z,1,Chrome,95.0.4638.69,Macintosh,2048,1152,NA,1.7777777777777777,602,80,393,64,52,73,-0.48098362680867,-0.08907029538134635,-0.1661132530535417,-0.4945408633321733,-0.2754836757549857,-0.5468850188934331,2,4,2,2,3,1,1,2,1,4,3,1,1,1,3,3,1,1,3,3,1.0711528467275955,0,1,1,5,5,1.6,0,4,4,2,5,2,1,4,2,2,1,1,5,3,4,3,1,2,4,3,2,1,2,2,0,1,4,1,5,4,2,3,3,4,4,4,4,2,4,2,1,4,2,5,2,3,1,1,2,2,3,5,4,4,3,2,1,1,1,4,2,2,1,2,1,2,2,1,1,1.3094711584127063,1.4074631010979937,2.125,0,1.5,0,1.8,0,2.3333333333333335,0,1.75,0,3.6666666666666665,0,1.4285714285714286,0,1.3333333333333333,0,2.1621621621621623,0,0,4,1,0.022659719070510696,-0.24166968128383745,0.42254411542774484,0.0904372170719537,5,1,4,1,1,2,2,1,1,1.6035674514745464,1.4285714285714286,0,1,-0.6467170085812028,5,5,5,5,3,3,2,6,6,2,3,1.2909944487358056,4.285714285714286,0,1.7142857142857142,3,3.8333333333333335,3.2559414990859232,-0.7395711320441822,0,-0.783895116604751,2,2,2,2,2,2,3,3,2,3,2,4,1,3,3,3,3,2,3,3,0.7237468644557459,2,0,3.8,0,3.4,0,3.2,0,3.466666666666667,0,1,2,1,1,1,1,1,3,1,1,1,4,1,2,1,3,1,1,1,1,0.8870412083230169,1.35,0,"White, Caucasian, Anglo, European American",0,18,1,2,NA,1,3,3,Student,3,0,160,62,2,5,2,0,0,0,0,0,TRUE,TRUE,TRUE,TRUE,TRUE,3,0.6414552631582084,0.76,0.023195661616318725,3,0.43176774193682976,0.48738620689639756,1,0.9354838709677419,0.003844414258025525,0.005630439591432899,3,0.677881249998929,0.6900937499993015,1,1,0.014439768024078512,0.01088006834680769,0.9974,1.1923,0.4303,0.8464,1.2197,0.4741,0.0525,1.0615032626666667,1.0757134118666667,0.42226912596666666,1.235,4.8032,0.3032,3.0844,0.3123,-68.1719,0.6694,7.3118,0.3836,3.1956,0.4151,0.9514,1.3178576552333334,3.285510273,4.859260312,0.3079283079333333,0.2973009321333333,1.2005,3.6786,0.5166,4.249,0.5549,0.9659,0.129,0.407,0.479,0.181,1.553,8.58011049723757,2.6465298446666665,4.29706726,4.3250008483333335,0.37117244623333334,0.3893996442666667,366,1.0844444444444443,1,0,0,1,FALSE,FALSE,FALSE
280,2021-11-13T02:44:11Z,2021-11-13T03:11:59Z,1667,1,2021-11-13T03:11:59Z,1,Chrome,95.0.4638.69,Windows NT 10.0,1366,768,no,1.7786458333333333,1010,55,356,67,41,80,0.567318116356741,-0.31618875321090295,-0.3442401010216793,-0.45798164373004263,-0.42741633176027893,-0.4286454515674616,1,1,4,4,1,4,4,1,4,1,1,4,4,4,1,1,4,4,1,1,1.538967528127731,0,1,2,4,1,4,0,5,5,5,5,5,1,1,1,1,1,1,5,2,5,5,4,4,5,1,1,4,4,2,3,1,0,0,5,5,5,5,5,5,5,5,5,1,5,3,1,5,1,5,2,1,1,1,5,1,1,5,5,5,5,1,5,5,1,5,2,1,1,5,1,4,4,4,4,1.9199443185119163,2.007130147392398,3.125,0,4,0,1.8666666666666667,0,1,0,1.5833333333333333,0,4.166666666666667,0,2.142857142857143,0,2.3333333333333335,0,2.081081081081081,0,2,0,0,0.5942350705832687,0.18188433178580324,0.6097586129219131,0.3958214723538582,5,1,4,1,1,1,1,3,1,1.7320508075688772,1.1428571428571428,0,2,-0.44866370411710943,4,4,4,4,2,2,2,4,6,NA,3,1.0690449676496976,3.4285714285714284,0,2.5714285714285716,4,3.8333333333333335,3.2559414990859232,-0.1748077221195339,0,-0.023487427113806164,4,4,4,2,4,2,5,3,3,4,1,2,1,5,1,1,3,1,3,5,1.5430334996209192,3.6,0,3.8,0,4.4,0,2.6,0,3.6,0,4,1,4,1,4,4,4,1,4,4,3,1,4,4,4,2,2,4,4,4,1.268027892769755,3.65,0,"White, Caucasian, Anglo, European American",0,26,1,2,NA,1,4,6,healthcare,7,0,124,64,5,5,1,0,0,0,1,0,TRUE,TRUE,TRUE,TRUE,TRUE,NA,NA,NA,NA,NA,NA,NA,NA,NA,NA,NA,5,0.8582482758554919,1.1416249999801318,0.9354838709677419,0.8275862068965517,0.3639301471614663,0.40154075891646623,NA,NA,NA,NA,NA,NA,NA,NA,NA,NA,NA,NA,NA,NA,NA,NA,NA,NA,NA,NA,NA,NA,NA,NA,NA,NA,NA,1.876,2.1061,0.2979,1.1857,0.3597,0.9795,0.077,0.373,0.15,0.008,2.102,262.75,1.901766269,1.4810239423666667,0.95505297467,0.2368241463,0.3162514482,104,0.3081481481481481,1,0,0,1,FALSE,FALSE,FALSE
281,2021-11-13T02:52:04Z,2021-11-13T03:12:18Z,1213,1,2021-11-13T03:12:19Z,1,Chrome,95.0.4638.69,Macintosh,1440,900,NA,1.6,607,47,288,86,62,75,-0.4681367917208586,-0.38886665971636103,-0.6716083621523106,-0.2264399195832151,-0.1373630793865373,-0.513102285371727,2,2,3,2,2,1,1,2,1,2,2,1,1,3,2,2,1,1,2,2,0.6386663736585051,0,1,2,1,4,2.25,0,2,4,3,4,4,3,2,3,1,3,1,4,2,3,2,3,2,1,1,2,2,3,1,1,2,0,0,3,2,3,4,3,3,2,3,3,4,3,3,3,3,2,4,3,3,3,3,3,4,1,1,1,1,1,3,1,1,1,3,2,2,1,1,1,1,1,1,1,1.0368582714503825,1.0327955589886444,1.875,0,1,0,2.7333333333333334,0,3.111111111111111,0,2.9166666666666665,0,1,0,1.7142857142857142,0,1,0,2.324324324324324,0,1,0,0,-0.03197616011820878,0.12168081347471636,-0.5341482934814965,-0.20623374000339006,5,2,4,1,1,2,1,1,3,1.6035674514745464,1.4285714285714286,0,2,-0.2777293338068208,5,5,5,5,5,5,1,8,8,6,4,1.5118578920369088,5,0,1,1,3.8333333333333335,3.2559414990859232,-1.869097951893479,0,-1.747013513636583,2,3,4,4,3,4,3,4,4,4,1,3,2,2,3,3,4,2,3,2,0.9611501047232549,3.2,0,3.6,0,3.4,0,2.6,0,3.2,0,2,2,3,4,4,3,2,2,2,1,3,2,3,3,1,2,1,2,1,3,0.9233805168766387,2.3,0,"White, Caucasian, Anglo, European American",0,28,1,2,NA,1,2,6,student,2,0,140,64,2,5,2,0,0,1,0,0,TRUE,TRUE,TRUE,TRUE,TRUE,4,0.7691555555562178,0.72,0.03290322289370864,4,0.4511903225789147,0.5393124999990687,1,1,0.004851032903262608,0.005739908225766081,4,0.6309687499990687,0.6910258064491134,1,1,0.007231995121104177,0.0148101079784366,1.149,0.8646,0.5096,0.8446,0.8213,0.6205,0.225,1.2131849594666666,0.8970373521333334,0.500071972,2.1711,6.3918,0.2814,5.6653,0.3477,-84.3027,0.8604,5.4118,0.372,5.0505,0.4529,0.98740000000000006,1.6496290158,4.674028266,5.3690627436666665,0.36699139233333333,0.3007908534,1.462,7.0937,0.5375,3.6572,0.5077,0.4583,0.299,0.213,0.715,0.023,1.452,63.130434782608695,2.7338515523333333,4.473539842,4.321829555333333,0.3273884363333333,0.38032747343333334,404,1.1970370370370371,1,0,0,1,FALSE,FALSE,FALSE
284,2021-11-13T02:51:27Z,2021-11-13T03:13:24Z,1317,1,2021-11-13T03:13:25Z,1,Chrome,95.0.4638.69,Windows NT 10.0,2560,1440,None,1.7777777777777777,595,78,388,91,49,71,-0.498969195931606,-0.10723977200771087,-0.19018444872491164,-0.1655078869129973,-0.31691985466552025,-0.5806677524151392,3,2,2,2,3,2,3,2,1,2,1,1,2,2,2,1,2,1,2,1,0.6708203932499369,0,0,1,3,2,2.45,0,4,4,2,4,2,2,4,2,2,2,2,4,2,4,4,2,2,1,1,2,2,2,2,0,2,0,0,4,4,3,4,3,5,5,5,4,1,4,2,2,4,2,4,2,2,2,2,2,4,2,1,1,2,1,3,1,1,1,4,2,2,1,1,1,1,1,1,2,1.34566370643293,1.0327955589886444,1.75,0,1.25,0,2,0,1.8888888888888888,0,1.9166666666666667,0,1.3333333333333333,0,1.5714285714285714,0,1,0,1.7297297297297298,0,0,0,0,-0.4795700934719498,-0.5027129110024894,-0.6588395645607719,-0.5807762377816306,5,1,3,2,1,1,2,1,3,1.4638501094227998,1.5714285714285714,0,2,-0.19226214865167657,4,4,4,4,2,2,2,5,3,3,3,1.0690449676496976,3.4285714285714284,0,2.5714285714285716,5,3.8333333333333335,3.2559414990859232,0.38995568780511447,0,0.25889427784851804,2,2,3,4,3,2,4,3,3,2,3,3,3,3,3,4,3,3,3,3,0.5345224838248488,2.8,0,3.2,0,2.8,0,3,0,3,0,2,4,4,1,3,4,4,1,4,1,2,1,2,4,2,1,1,4,3,4,1.3138933706635727,3.2,0,"White, Caucasian, Anglo, European American",0,19,0,1,NA,1,2,3,None,1,0,170,68,2,5,2,0,0,1,0,0,TRUE,TRUE,TRUE,TRUE,TRUE,5,0.6253486486383386,0.74,0.025095121677862344,5,0.36679677418739565,0.4346333333015442,0.96875,0.9375,0.0034148141870159092,0.006638638669195907,5,0.49744062502682207,0.5514777778519524,1,0.84375,0.005953167644715058,0.008653174674274768,1.0477,1.0425,0.392,0.9004,1.154,0.4465,0.0702,1.1093724503666667,1.0029027559333332,0.3843717628666667,1.1639,4.4039,0.2445,2.5754,0.2305,-61.0655,0.8482,4.9712,0.2837,4.0115,0.3383,0.9978,1.2149006836333334,2.8021452796666666,4.527215143,0.2299991233,0.24199994026666666,0.8324,4.8199,0.4166,2.4085,0.4242,0.978,0.05,0.365,0.379,0.009,1.403,155.88888888888891,1.2194473874,3.584509419333333,2.2572415363333334,0.32353329063333336,0.3404183008,420,1.2444444444444445,1,0,0,1,FALSE,FALSE,FALSE
285,2021-11-13T02:43:39Z,2021-11-13T03:14:31Z,1851,1,2021-11-13T03:14:33Z,1,Chrome,95.0.4638.69,Windows NT 10.0,1536,864,NA,1.7777777777777777,645,50,271,63,60,107,-0.3705008450534919,-0.36161244477681426,-0.7534504274349684,-0.5067272698662169,-0.16498719866022699,0.02742145097557139,4,3,2,2,3,1,2,4,1,3,3,1,1,1,4,3,2,1,3,2,1.0809352675491624,1,1,1,4,1,1.6,0,3,5,3,4,1,2,4,2,1,1,3,4,2,3,3,1,1,1,1,1,1,2,2,0,2,0,0,5,5,5,5,5,5,5,5,5,1,4,3,1,5,1,5,1,1,3,2,3,5,1,1,1,1,1,1,1,1,1,4,2,1,1,2,2,1,1,1,1,1.7896096509302533,1.2227992865708155,1.25,0,1,0,2.066666666666667,0,1,0,1.6666666666666667,0,0.8333333333333334,0,1.1428571428571428,0,1.6666666666666667,0,1.3243243243243243,0,0,0,0,-1.0427399251095204,-0.8631596990900906,-0.7372407672780129,-0.8002002331840518,4,1,3,1,1,3,1,1,1,1.2909944487358056,1.7142857142857142,0,1,-0.4757826382709144,4,4,5,5,2,2,3,4,6,3,3,1.2724180205607036,3.5714285714285716,0,2.4285714285714284,4,3.8333333333333335,3.2559414990859232,-0.1748077221195339,0,-0.10315842453524313,1,3,1,2,1,1,4,2,1,2,1,5,1,5,5,3,5,1,3,4,1.6846647257229665,1.6,0,5,0,3.4,0,4.2,0,4.2,0,3,4,2,3,3,2,4,1,2,3,3,2,3,2,1,3,1,2,1,2,0.9333020044867296,2.45,0,"White, Caucasian, Anglo, European American",0,18,1,2,NA,1,3,3,Student / Unemployed,3,0,135,67,1,5,2,0,0,0,0,0,TRUE,TRUE,TRUE,TRUE,TRUE,1,1.144307317074479,0.82,0.1518873960986294,1,0.42834838709908146,0.5366354838725059,1,0.96875,0.0016210285807507086,0.0036229772582377735,1,0.5858750000018627,0.6402399999996027,1,0.9375,0.008959312257505177,0.01524288887042431,1.7054,0.8947,0.5474,1.5758,0.8911,0.6182,0.372,1.6731328956666667,0.883110241,0.542442279,1.9504,7.3158,0.2951,4.2645,0.317,-81.3814,0.744,6.862,0.3785,4.9553,0.4648,0.9899,1.7028405098333332,3.858285338,6.195863113,0.32457851596666665,0.2967425246666667,0.8688,12.0833,0.5467,3.0312,0.5312,0.9918,0.066,0.399,0.361,0.016,1.507,94.18749999999999,1.946863311,4.015979862333333,2.5024888506666665,0.34271345793333335,0.2798292651666667,378,1.12,1,0,0,1,FALSE,FALSE,FALSE
288,2021-11-13T02:48:49Z,2021-11-13T03:16:33Z,1664,1,2021-11-13T03:16:35Z,0.4000000059604645,Safari,15.0,Macintosh,1440,900,NA,1.6,662,313,285,70,178,84,-0.3268216057549331,2.027673731590121,-0.6860510795551324,-0.421422424127912,1.464835838487464,-0.3610799845240493,3,3,2,1,3,1,2,3,1,4,3,1,1,1,3,3,1,1,2,4,1.0894228312566052,0,1,1,4,4,1.55,0,2,4,1,4,1,1,3,1,1,1,1,5,3,4,5,2,1,1,1,1,1,3,3,0,2,0,0,5,2,5,5,5,5,5,5,5,2,5,1,1,5,2,5,5,1,3,2,4,5,1,1,1,2,1,1,1,1,1,5,2,1,1,1,1,2,2,1,1,1.838444962428813,1.5976172734359604,1.625,0,1.5,0,1.6666666666666667,0,1.3333333333333333,0,2,0,1,0,1,0,1,0,1.4594594594594594,0,0,0,0,-0.7254315498211877,-0.8158292803535607,-0.5804383618435307,-0.6981338210985457,5,1,4,1,1,1,1,1,1,1.7320508075688772,1.1428571428571428,0,1,-0.8176513788914915,4,4,4,4,2,2,2,4,6,4,3,1.0690449676496976,3.4285714285714284,0,2.5714285714285716,4,3.8333333333333335,3.2559414990859232,-0.1748077221195339,0,-0.023487427113806164,1,1,1,1,1,1,4,1,1,2,1,4,1,3,1,1,5,1,4,1,1.486446705914413,1,0,4.8,0,4,0,3.8,0,4.2,0,1,2,1,3,3,1,1,3,1,1,2,4,1,1,1,4,1,1,2,1,1.0699237552766379,1.35,0,"White, Caucasian, Anglo, European American",0,20,1,2,NA,1,3,4,Fuel Clerk,4,0,165,65,2,5,2,0,1,0,0,1,TRUE,TRUE,TRUE,TRUE,TRUE,6,0.5557948717948643,0.78,0.011951871020409737,6,0.4019999999999981,0.48132142857143223,0.967741935483871,0.875,0.0027809397849462565,0.006787028225806848,6,0.5905937500000036,0.6971379310344807,1,0.90625,0.00681786189516153,0.007895353830645015,0.9706,1.3816,0.3682,0.694,1.4395,0.4548,0.1854,1.0289216827,1.1612083784,0.3614691089,0.9849,4.1919,0.2929,2.253,0.3031,-62.4088,0.7075,7.4789,0.351,3.7081,0.3908,0.9856,1.0577739489333333,2.5397944285,4.385830528333333,0.29904587163333335,0.28859160153333335,0.9344,4.1306,0.4873,4.1427,0.587,0.834,0.062,0.451,0.477,0.009,1.555,172.77777777777777,1.5042863135666666,4.306742060666667,2.4825693307,0.4169989068666667,0.42606452056666666,104,0.3081481481481481,1,0,0,1,FALSE,FALSE,FALSE
289,2021-11-13T02:45:05Z,2021-11-13T03:17:13Z,1928,1,2021-11-13T03:17:14Z,1,Edge,95.0.1020.53,Windows NT 10.0,1280,720,Good survey,1.7777777777777777,1115,60,439,81,76,102,0.8371016532007807,-0.2707650616449916,0.05534174712306178,-0.28737195225343287,0.05600575552929045,-0.057035382828693984,4,4,1,1,4,1,1,4,1,4,2,1,1,1,4,4,1,1,4,4,1.500876936643164,1,1,3,4,4,1.1,0,3,2,3,4,3,4,3,3,2,4,1,3,2,2,3,2,3,1,3,1,2,3,2,5,2,0,0,4,1,5,3,4,4,5,5,4,1,4,2,1,3,4,3,5,2,2,3,2,1,1,5,1,3,3,1,4,3,1,4,2,3,2,3,1,2,2,2,2,1.3847084232492477,0.8618916073713346,2.125,0,2,0,2.933333333333333,0,2.111111111111111,0,2.5,0,2.8333333333333335,0,2.142857142857143,0,2,0,2.4054054054054053,0,3,0,0,0.17395907682388775,0.34991215781160245,0.1856414649805007,0.2677768113960516,4,2,3,2,1,2,2,3,1,0.9511897312113419,2,0,2,0.06413940681375631,4,3,3,2,1,1,3,3,3,2,2,1.1338934190276817,2.4285714285714284,0,3.5714285714285716,6,3.8333333333333335,3.2559414990859232,0.9547190977297628,0,1.0989729647608995,3,3,4,3,4,4,3,4,3,2,3,2,3,2,3,3,2,4,3,2,0.7432233529572065,3.4,0,2.2,0,2.8,0,2.8,0,2.6,0,2,2,1,3,3,1,2,2,1,1,2,3,2,1,2,3,1,2,1,2,0.7451598203705946,1.75,0,"White, Caucasian, Anglo, European American",0,18,0,1,NA,1,3,4,Cashier,2,0,185,74,3,5,2,0,0,0,0,0,TRUE,TRUE,TRUE,TRUE,TRUE,2,0.9155102563637953,0.7959183673469388,0.042710200204252265,2,0.4585124999731779,0.5178531250208617,1,1,0.004381728866003174,0.0034631625673449615,2,0.5859937500208616,0.6876124999821186,1,1,0.005136669638296211,0.004540171446186034,1.3327,1.0762,0.5711,1.0246,1.2504,0.6931,0.2144,1.3790852316666666,1.0214369787,0.5601603943666666,3.2751,7.7609,0.2475,7.7392,0.3063,-93.6738,0.8525,5.7321,0.3818,5.8409,0.4478,0.9968,1.7424624583333332,5.119442035,5.662470810666667,0.35340502356666664,0.3088782593666667,0.82,5.9997,0.5168,5.8242,0.6283,0.855,0.184,0.318,0.7,0.014,1.714,122.42857142857143,2.564394173666667,5.709489474333333,4.825607528,0.36797607513333336,0.4293372632333333,346,1.0251851851851852,1,0,0,1,FALSE,FALSE,FALSE
290,2021-11-13T02:56:47Z,2021-11-13T03:17:24Z,1236,1,2021-11-13T03:17:25Z,1,Chrome,93.0.4577.82,Macintosh,1280,800,NA,1.6,619,48,302,73,54,96,-0.43730438751011125,-0.3797819214031788,-0.6042090142724746,-0.38486320452578127,-0.24785955648129604,-0.15838358339381242,4,4,1,3,4,1,1,2,1,4,2,1,1,1,4,4,1,1,3,3,1.3416407864998738,0,1,1,1,1,1.4,0,3,5,5,5,5,3,5,3,2,1,1,5,5,3,5,1,1,1,1,1,1,1,1,2,2,0,0,5,4,5,5,5,5,3,3,5,2,4,1,1,4,1,5,5,1,3,2,5,5,1,1,1,1,1,3,2,2,1,5,3,4,1,1,1,1,1,1,2,1.696135866278665,1.533747356112131,1,0,1.25,0,2.4,0,1.5555555555555556,0,2.1666666666666665,0,0.8333333333333334,0,2.142857142857143,0,1,0,1.7567567567567568,0,1,0,0,-0.9292654067944875,-0.6415100898740308,-0.4557470907642554,-0.5486285903191431,5,1,5,1,1,1,1,1,1,1.9518001458970664,1,0,1,-0.9031185640466358,5,5,5,5,3,3,1,6,6,6,4,1.5735915849388864,4.428571428571429,0,1.5714285714285714,3,3.8333333333333335,3.2559414990859232,-0.7395711320441822,0,-0.8635661140261877,3,2,2,3,2,2,4,2,1,4,1,5,1,5,5,2,5,2,4,5,1.65615734242165,2.4,0,4.6,0,4.2,0,4,0,4.266666666666667,0,2,2,2,4,2,1,2,4,1,1,3,4,2,1,3,2,1,2,1,3,1.0399898784932577,1.75,0,"White, Caucasian, Anglo, European American",0,30,1,2,NA,1,4,7,Financial Analyst,6,0,121,62,3,5,2,0,0,1,0,0,TRUE,TRUE,TRUE,TRUE,TRUE,6,0.9089942857197353,0.7,0.06598407265565367,6,0.4643718750104308,0.5317413793021235,1,0.90625,0.002592929828371839,0.005306323857290735,6,0.7093624999970198,0.879309374973178,1,1,0.004829001124900464,0.011695162818752314,1.3219,0.6792,0.5679,1.0857,0.4307,0.6695,0.2025,1.3714137373333333,0.7692031383733333,0.5580608663666666,1.2183,5.2882,0.3492,2.5761,0.3331,-68.809,0.6476,5.5232,0.4116,3.3441,0.4687,0.9918,1.3049923814333333,2.806238706,5.241732485,0.32786434826666666,0.3424973209666667,1.0602,5.5999,0.6213,3.7293,0.7369,0.9208,0.155,0.449,0.597,0.008,1.561,195.125,2.9700709296666665,5.732243087333333,4.5455617256666665,0.4567898605333333,0.5584516348333334,104,0.3081481481481481,1,0,0,1,FALSE,FALSE,FALSE
292,2021-11-13T02:52:38Z,2021-11-13T03:19:47Z,1628,1,2021-11-13T03:19:47Z,1,Chrome,95.0.4638.69,Windows NT 10.0,1600,900,NA,1.7777777777777777,810,83,390,82,61,133,0.053444712844284634,-0.06181608044179956,-0.18055597045636368,-0.2751855457193893,-0.15117513902338214,0.4665969867577513,2,3,2,1,2,1,2,2,2,3,2,2,1,1,2,3,2,1,2,2,0.6407232755171874,0,1,3,5,3,2.1,0,1,3,1,4,3,2,3,2,1,1,1,4,1,4,5,1,1,1,3,1,1,1,1,0,4,0,0,4,4,4,4,3,5,5,5,5,2,5,3,1,4,2,5,2,3,1,1,3,4,1,1,1,1,1,1,1,2,1,4,1,2,1,1,1,3,3,2,2,1.5730462404120467,1.4040757000349275,1.25,0,2.5,0,2,0,1.6666666666666667,0,1.8333333333333333,0,1,0,1.2857142857142858,0,1,0,1.5405405405405406,0,0,0,0,-0.9082516071065188,-0.7988909914396698,-0.26683355097456624,-0.532862271207118,3,1,2,3,1,1,2,1,2,0.8997354108424374,2.142857142857143,0,1.5,-0.03488724541829051,2,4,4,4,2,3,2,7,3,3,2,1,3.2857142857142856,0,2.7142857142857144,4,3.8333333333333335,3.2559414990859232,-0.1748077221195339,0,0.056183570307630534,1,2,2,2,2,1,2,2,2,1,2,2,2,4,4,3,4,2,1,4,1.121223821162776,1.8,0,3.8,0,2.2,0,3.6,0,3.2,0,2,3,2,2,1,1,4,2,3,2,2,2,2,1,1,2,1,2,1,2,0.7880689256524124,2.1,0,"White, Caucasian, Anglo, European American",0,30,1,2,NA,1,2,7,Policy consultant,2,0,120,67,2,5,2,0,0,1,0,0,TRUE,TRUE,TRUE,TRUE,TRUE,6,0.7501138888878954,0.72,0.03686956428150865,6,0.49729000000059603,0.6590967741945097,0.967741935483871,0.96875,0.005024546924631495,0.015075232539532147,6,0.6688843749975786,0.7389193548396711,1,1,0.009384383941727683,0.007217027612927111,1.1254,0.8977,0.4941,0.8606,0.9556,0.5719,0.1495,1.1878273326666666,0.9196457328666666,0.4855601594,1.6196,2.8524,0.2318,3.4036,0.4327,-39.2441,1.1223,5.7114,0.4026,3.8431,0.5079,0.9972,1.7462984873333334,3.4495550076666666,3.1743942973333334,0.41556923656666667,0.2296501956,0.9364,4.644,0.566,4.0465,0.6364,0.9899,0.169,0.402,0.646,0.01,1.139,113.9,2.7288160766666665,5.056293828333334,4.693991306666667,0.4030317297,0.45517935853333336,356,1.0548148148148149,1,0,0,1,FALSE,FALSE,FALSE
293,2021-11-13T02:39:44Z,2021-11-13T03:20:05Z,2421,1,2021-11-13T03:20:05Z,0.800000011920929,Chrome,95.0.4638.69,Windows NT 10.0,1920,1080,NA,1.7777777777777777,1140,255,530,66,58,69,0.9013358286398376,1.5007589094255498,0.49343750834199473,-0.47016805026408615,-0.19261131793391667,-0.6144504859368455,2,2,3,4,1,3,4,2,1,2,2,3,3,3,2,1,3,2,2,1,0.9233805168766387,0,1,1,2,2,3.1,0,3,3,5,4,2,1,4,4,1,1,1,3,1,3,3,4,1,5,1,5,4,2,4,2,2,0,0,4,1,1,4,2,2,4,5,2,1,5,5,1,2,1,1,1,5,5,5,5,5,1,1,1,4,3,1,2,1,1,4,4,3,1,1,2,1,1,2,3,1.6558205644760369,1.3522468075656264,3.25,0,1.75,0,2.3333333333333335,0,3.2222222222222223,0,3.25,0,1.6666666666666667,0,1.8571428571428572,0,1.3333333333333333,0,2.6216216216216215,0,1,0,0,1.008206924436259,0.6684487796151188,-0.2989446853297732,0.18475204714267282,4,2,2,1,1,2,3,2,1,1.0690449676496976,2.142857142857143,0,1.5,-0.03488724541829051,4,3,5,5,1,1,4,6,6,3,1,1.7043362064926932,3,0,3,3,3.8333333333333335,3.2559414990859232,-0.7395711320441822,0,-0.0668561398118202,3,1,4,5,4,1,4,2,1,2,1,4,3,5,4,5,4,1,2,5,1.5796322658258457,3.4,0,4.6,0,2.4,0,3.8,0,3.6,0,3,4,4,1,4,4,4,1,4,3,3,1,3,4,2,1,1,4,3,4,1.2523661815266247,3.5,0,"Black or African American & Hispanic of Latino (e.g., Mexican American, Central American, and others) & White, Caucasian, Anglo, European American & Native American/Alaskan Native/indigenous",1,22,0,1,NA,1,2,6,Student,5,0,212,74,1,5,2,0,1,1,0,1,TRUE,TRUE,TRUE,TRUE,TRUE,3,0.6909800000000538,0.9183673469387755,0.11626790564621277,3,0.5754093749999883,0.651900000000012,1,1,0.022906805393177226,0.022729525999990778,3,0.5961633333333303,0.6421937499999912,0.967741935483871,1,0.006840556645159035,0.013426657379045703,1.2636,1.846,0.4444,1.5899,2.6728,0.3809,0.0675,1.2780087587,1.4313773865333332,0.4355083851,1.6213,3.5613,0.3478,3.4736,0.4185,-50.0373,1.1307,2.9382,0.3939,3.7954,0.4864,0.9158,1.829150565,3.6315729473333334,3.815096415,0.39845383393333333,0.3310583186,0.9329,4.6038,0.5107,2.9524,0.5219,0.78,0.071,0.416,0.367,0.031,1.422,45.87096774193548,2.157832115666667,3.9180601123333334,3.2557379836666667,0.3343028827333333,0.30987682543333334,430,1.2740740740740741,1,0,3,4,FALSE,FALSE,FALSE
294,2021-11-13T02:47:17Z,2021-11-13T03:20:16Z,1978,1,2021-11-13T03:20:17Z,1,Chrome,95.0.4638.69,Windows NT 10.0,1366,768,The survey was easy to understand,1.7786458333333333,771,87,566,159,92,106,-0.046760600840644366,-0.025477127189070508,0.6667501171758583,0.6631677574019643,0.27699870971880786,0.010530084214718316,4,3,1,1,3,1,2,3,1,4,2,1,1,2,4,3,2,2,2,3,1.0699237552766379,0,0,4,4,5,1.65,0,4,4,2,3,3,1,5,3,3,1,2,4,1,5,3,3,4,5,1,1,2,1,1,7,1,1,2,5,2,3,4,3,4,3,3,4,2,5,2,4,2,1,5,3,2,3,1,2,1,2,5,3,4,2,1,4,4,1,4,2,2,2,3,1,3,3,1,3,1.2657417201396586,1.3345232785352157,2.25,0,2.5,0,2,0,2.5555555555555554,0,2.1666666666666665,0,3.3333333333333335,0,2.142857142857143,0,2,0,2.4864864864864864,0,4,1,2,0.30214325492049876,0.03737652979472142,1.1050688456028845,0.571222687698803,3,3,2,2,2,3,3,1,1,0.5345224838248488,2.857142857142857,0,1,0.20795484297024003,3,2,3,4,1,1,3,1,1,1,2,1.1338934190276817,2.4285714285714284,0,3.5714285714285716,8,3.8333333333333335,3.2559414990859232,2.0842459175790595,0,1.6637363746855478,3,3,2,2,3,3,4,3,3,2,2,3,2,3,4,1,4,1,3,3,0.9611501047232549,2.6,0,3.8,0,3.6,0,3.2,0,3.533333333333333,0,2,2,1,3,1,1,2,2,2,1,3,3,1,1,1,3,1,1,1,2,0.8013147091860318,1.6,0,"Hispanic of Latino (e.g., Mexican American, Central American, and others)",0,19,1,2,NA,1,2,4,student,1,0,165,60,3,5,2,0,0,1,0,0,TRUE,TRUE,TRUE,TRUE,TRUE,4,0.928246874999255,0.64,0.0663067796876988,4,0.5048374999985099,0.572199999999255,1,1,0.007703482419497774,0.008934820645970606,4,0.67069062500074506,0.8625300000011921,1,0.9375,0.01578034733097878,0.056654810953467284,1.2093,0.4786,0.57,1.198,0.6013,0.5826,0.1456,1.2735413508333333,0.6470757021927,0.5580675957333333,4.5177,6.7109,0.1682,6.5265,0.2261,-67.6596,0.8492,4.9963,0.4264,4.5983,0.4828,0.9327,2.0312498503333334,4.3209742386666665,4.645762466,0.33973660803333333,0.28648973873333333,1.2028,3.0248,0.4944,2.0247,0.6053,0.9967,0.084,0.417,0.274,0.013,2.046,157.3846153846154,2.168971964333333,3.7957252406666666,1.9232372126,0.38237551366666667,0.3505138008,374,1.108148148148148,1,0,0,1,FALSE,FALSE,FALSE
295,2021-11-13T02:58:53Z,2021-11-13T03:21:19Z,1345,1,2021-11-13T03:21:20Z,0.8999999761581421,Firefox,94.0,Windows NT 10.0,1280,720,NA,1.7777777777777777,661,61,312,58,43,150,-0.3293909727724954,-0.26168032333180935,-0.5560666229297347,-0.5676593025364346,-0.39979221248658925,0.7537502216922536,2,3,2,2,2,1,1,3,1,2,3,2,1,3,2,3,1,1,2,2,0.7591546545162482,0,1,1,5,5,2.05,0,5,5,1,5,1,1,5,1,1,1,1,5,1,5,5,1,1,1,1,1,1,1,1,0,1,2,NA,5,1,3,1,3,5,5,5,5,5,5,1,1,5,1,5,1,1,1,1,1,1,1,5,1,2,1,1,1,1,1,4,3,1,1,1,1,1,1,1,1,1.782884931418368,2.065591117977289,1,0,1,0,1,0,2.3333333333333335,0,1.3333333333333333,0,2.3333333333333335,0,1.2857142857142858,0,1,0,1.7567567567567568,0,0,2,NA,-0.9292654067944875,-1.24315811209544,-0.2694891481859902,-0.7563236301407151,5,1,1,1,1,1,1,1,1,1.5118578920369088,1.5714285714285714,0,1,-0.5612498234260587,5,5,5,5,3,5,1,5,1,2,2,1.5735915849388864,4.714285714285714,0,1.2857142857142858,6,3.8333333333333335,3.2559414990859232,0.9547190977297628,0,-0.17576299398208856,1,1,1,1,1,1,4,1,1,1,1,4,1,5,1,2,5,2,1,2,1.5522640914238175,1,0,4.6,0,3,0,4,0,3.8666666666666667,0,1,1,1,4,3,1,2,3,1,1,1,4,1,1,1,4,1,1,1,1,1.1742858972247996,1.2,0,Black or African American,0,24,1,2,NA,1,3,7,LPCA,3,0,135,63,1,5,2,0,0,1,0,0,TRUE,TRUE,TRUE,TRUE,TRUE,5,0.7008421052631579,0.7755102040816326,0.025603020408163268,5,0.49392592592592593,0.5384285714285715,1,0.9655172413793104,0.027539917378917377,0.00481088669950739,5,0.626,0.7085806451612904,1,1,0.008463161290322579,0.015536518279569892,1.0799,1.1933,0.4347,0.8338,1.7188,0.5293,0.2882,1.1412419049,1.0810604829666666,0.4263704224666667,1.2867,4.1083,0.3373,3.6451,0.3693,-59.9106,1.0196,4.5383,0.3677,5.9385,0.4501,0.9972,1.4308054404333332,3.850345938,4.304292511666667,0.3603150081,0.3256019309666667,1.0946,4.7374,0.5144,3.4831,0.5732,0.9749,0.256,0.205,0.614,0.015,1.465,97.66666666666667,2.4918997936666667,4.677676018333333,3.876276032333333,0.36290615676666665,0.3911280102,396,1.1733333333333333,1,0,0,1,FALSE,FALSE,FALSE
296,2021-11-13T03:04:45Z,2021-11-13T03:21:22Z,997,1,2021-11-13T03:21:24Z,1,Chrome,95.0.4638.69,Windows NT 10.0,1280,720,"On the second game, I had to scroll down sometimes to see the arrows.",1.7777777777777777,570,37,195,54,41,53,-0.563203371370663,-0.47971404284818364,-1.1193326016397915,-0.6164049286726088,-0.42741633176027893,-0.8847123541104946,4,4,1,1,3,1,1,3,1,3,3,1,1,1,4,3,1,1,4,3,1.2814465510343749,0,1,1,3,4,1.3,0,5,5,2,5,2,1,4,1,1,1,1,5,1,5,4,1,1,1,1,1,1,1,1,0,2,0,0,5,4,5,5,5,5,5,5,5,1,5,1,1,4,1,5,1,1,1,1,1,5,1,1,1,5,1,1,1,1,1,5,1,1,1,3,1,2,1,1,1,1.9199443185119163,1.8464895909600492,1,0,1.25,0,1.2666666666666666,0,1.1111111111111112,0,1.0833333333333333,0,1.5,0,0.8571428571428571,0,1.6666666666666667,0,1.2162162162162162,0,0,0,0,-1.2654862018019926,-1.3608550224913916,-0.6588395645607719,-1.0098472935260818,5,1,3,1,1,1,1,1,1,1.5735915849388864,1.2857142857142858,0,1,-0.7321841937363471,5,5,5,5,2,2,3,5,3,2,3,1.4638501094227998,3.857142857142857,0,2.142857142857143,5,3.8333333333333335,3.2559414990859232,0.38995568780511447,0,0.019881285584207653,5,2,3,3,2,1,5,1,1,3,1,5,3,5,5,1,5,1,5,4,1.869555587629877,3,0,5,0,4.2,0,4.4,0,4.533333333333333,0,1,1,2,4,1,1,2,4,1,1,2,4,2,1,2,4,2,3,2,3,1.1367080817685316,1.55,0,"White, Caucasian, Anglo, European American",0,21,1,2,NA,1,3,6,Student,3,0,210,68,3,5,2,0,0,1,0,0,TRUE,TRUE,TRUE,TRUE,TRUE,2,0.6598052631553851,0.76,0.015740339493077352,NA,NA,NA,NA,NA,NA,NA,2,0.5466374999582767,0.6614827586206896,1,0.90625,0.008193885630162915,0.01374763281567568,1.2482,1.0484,0.3685,0.8401,1.0572,0.5274,0.1678,1.2949756026666666,1.004425399,0.3621890278666667,NA,NA,NA,NA,NA,NA,NA,NA,NA,NA,NA,NA,NA,NA,NA,NA,NA,0.9445,4.4628,0.4426,2.6768,0.5258,0.9477,0.07,0.381,0.42,0.009,1.45,161.11111111111111,1.5865233126666667,4.109656028333333,2.2841464048666666,0.3531521978666667,0.3580349097666667,386,1.1437037037037037,1,0,0,1,FALSE,FALSE,FALSE
297,2021-11-13T02:48:57Z,2021-11-13T03:22:41Z,2023,1,2021-11-13T03:22:42Z,1,Chrome,95.0.4638.69,Macintosh,1366,768,NA,1.7786458333333333,896,79,644,89,68,120,0.2744102763546409,-0.09815503369452862,1.0422607696492294,-0.18988069998108442,-0.054490721565468275,0.24700921886666136,2,3,2,2,3,2,2,3,2,3,3,2,2,2,3,3,2,2,2,2,0.4893604849295929,0,0,2,2,2,2.15,0,1,4,4,2,3,2,4,2,4,2,2,3,2,4,3,5,5,5,1,3,3,3,5,5,1,5,2,2,1,2,3,1,4,3,3,2,2,4,5,2,1,4,2,5,5,5,5,5,1,5,5,5,5,1,2,3,3,3,5,1,1,1,4,5,3,5,5,3,1.5839851669157161,1.01418510567422,3.75,0,4,0,2.8,0,3.6666666666666665,0,4.083333333333333,0,4.166666666666667,0,1.8571428571428572,0,3.3333333333333335,0,3.5675675675675675,0,3,5,2,1.9075975510813352,1.4903913479394768,2.1989164184819097,1.8446538832106931,3,2,2,3,2,2,2,7,3,0.4879500364742666,2.5714285714285716,0,5,1.51297117175748,1,1,1,1,1,1,5,4,3,1,2,1.5118578920369088,1,0,5,5.5,3.8333333333333335,3.2559414990859232,0.6723373927674386,0,1.7544920864941047,3,4,4,4,4,4,4,2,3,4,1,4,2,5,4,3,4,2,3,2,1.1254628677422756,3.8,0,3.8,0,3.6,0,4,0,3.8,0,3,4,2,3,3,1,3,2,2,2,2,3,1,2,2,2,3,2,2,2,0.7326950970650465,2.3,0,"White, Caucasian, Anglo, European American",0,28,1,2,NA,1,3,6,Online English Teacher - English as a Second Language,1,0,100,62,2,5,2,0,0,1,0,0,TRUE,TRUE,TRUE,TRUE,TRUE,3,0.7117289473602646,0.76,0.02025475071321701,NA,NA,NA,NA,NA,NA,NA,3,1.1357281249985098,1.3257062499932946,1,1,0.13525014659919832,0.2585314077015958,1.0055,1.1637,0.5154,0.839,1.1153,0.5637,0.2025,1.0767055736,1.0631730395666668,0.5054574595,NA,NA,NA,NA,NA,NA,NA,NA,NA,NA,NA,NA,NA,NA,NA,NA,NA,2.1989,1.8688,0.5668,1.2873000000000001,0.5934,0.9458,0.151,0.484,0.214,0.024,1.965,81.875,3.237696098,2.3578577083333334,1.8908351523666667,0.43027077333333336,0.45015388863333333,457,1.3540740740740742,1,0,0,1,FALSE,FALSE,FALSE
298,2021-11-13T02:47:11Z,2021-11-13T03:22:42Z,2130,1,2021-11-13T03:22:42Z,1,Opera,80.0.4170.63,Windows NT 10.0,1920,1080,NA,1.7777777777777777,956,40,498,95,314,95,0.4285722974083778,-0.45245982790863687,0.33938185604522714,-0.11676226077682311,3.3432759490983623,-0.1752749501546655,2,3,4,4,2,2,3,1,1,3,3,3,3,4,3,2,4,3,2,2,0.9233805168766387,1,1,1,2,1,2.9,0,5,5,3,4,2,1,5,1,1,1,1,5,1,5,3,1,2,1,1,1,2,1,1,0,2,0,0,4,5,5,4,5,5,5,5,5,1,3,1,3,5,1,5,1,3,3,3,1,4,1,2,1,2,1,1,1,2,2,4,1,1,1,1,1,1,2,1,2,1.6675673242123632,1.8073922282301278,1.25,0,1.5,0,1.4,0,1.2222222222222223,0,1.8333333333333333,0,1.3333333333333333,0,1.2857142857142858,0,1,0,1.4864864864864864,0,0,0,0,-0.9418736866072692,-1.0799697971878957,-0.5804383618435307,-0.8302040795157132,5,1,5,1,1,1,1,1,1,1.9518001458970664,1,0,1,-0.9031185640466358,5,5,5,5,5,3,1,8,8,6,4,1.5735915849388864,4.714285714285714,0,1.2857142857142858,1,3.8333333333333335,3.2559414990859232,-1.869097951893479,0,-1.5876715187937096,4,4,3,3,2,2,4,1,2,3,1,4,2,3,4,2,5,2,4,1,1.2909944487358056,3.2,0,4.4,0,3.8,0,4.2,0,4.133333333333334,0,2,2,4,1,3,4,4,1,3,4,2,2,2,4,1,2,2,4,4,4,1.164157703189193,3.15,0,"White, Caucasian, Anglo, European American",0,22,1,2,NA,1,3,6,Software engineering researcher,2,0,138,64,2,5,2,0,0,0,0,0,TRUE,TRUE,TRUE,TRUE,TRUE,4,0.8704999999973704,0.6938775510204082,0.058278716122005296,4,0.4481354838686605,0.5450387096779962,1,0.96875,0.002594474365792117,0.004855128669009368,4,0.5586500000013038,0.6395500000023416,1,0.9032258064516129,0.011322626451395272,0.01277269178424357,1.3646,0.6262,0.4892,1.2814,0.3906,0.5496,0.1575,1.407067046,0.72739282104,0.4798255316,1.5223,5.6548,0.3135,4.2927,0.377,-80.6324,0.8492,5.6432,0.3742,4.7604,0.4562,0.9963,1.5318709077,4.152397752666666,5.387184648,0.3718202253333333,0.3093591779,0.9119,2.986,0.4333,1.7523,0.5004,0.8773,0.07,0.364,0.356,0.016,1.704,106.5,1.4047768988333333,3.3932675193333335,2.5907275893333335,0.3464750018,0.4081056532333333,478,1.4162962962962962,1,0,0,1,FALSE,FALSE,FALSE
299,2021-11-13T03:02:06Z,2021-11-13T03:22:58Z,1252,1,2021-11-13T03:22:59Z,1,Edge,95.0.1020.44,Windows NT 10.0,1620,1080,NA,1.5,591,63,343,77,53,75,-0.5092466640018551,-0.24351084670544482,-0.4068252097672411,-0.3361175783896071,-0.2616716161181409,-0.513102285371727,1,1,3,1,2,1,2,2,1,3,2,3,3,2,2,2,2,1,1,1,0.7677718959499145,0,1,2,4,5,2.6,0,2,3,2,3,2,1,3,2,2,2,2,3,3,3,2,2,1,1,2,1,1,1,2,1,2,0,0,1,1,5,2,2,5,1,1,1,1,5,1,1,3,1,2,3,1,1,1,3,5,1,1,1,1,1,3,1,1,1,4,1,5,1,1,1,2,1,1,1,1.460182225659569,0.6172133998483676,1.375,0,1.25,0,2.6,0,3.888888888888889,0,1.75,0,0.8333333333333334,0,1.8571428571428572,0,1,0,2.135135135135135,0,1,0,0,-0.4606576737527777,-0.23179707860259807,-0.4557470907642554,-0.34377208468342674,5,1,4,2,1,1,1,1,1,1.6761634196950514,1.2857142857142858,0,1,-0.7321841937363471,3,3,3,2,1,1,5,6,6,NA,3,1.3972762620115438,2,0,4,3,3.8333333333333335,3.2559414990859232,-0.7395711320441822,0,0.49084084213823703,2,2,2,1,1,3,2,2,2,2,2,3,1,2,2,4,3,3,2,4,0.8338093878327919,1.6,0,3.2,0,2.6,0,2.8,0,2.8666666666666667,0,2,3,2,1,2,3,3,1,3,2,3,2,2,3,1,1,2,2,2,2,0.7181848464596079,2.6,0,"White, Caucasian, Anglo, European American",0,27,1,2,NA,1,3,6,freelance designer,1,0,110,66,3,5,2,0,0,1,0,0,TRUE,TRUE,TRUE,TRUE,TRUE,1,0.8730020833333402,0.96,0.07627700942448605,1,0.403058064516123,0.4669225806451042,0.96875,0.96875,5.730551209693789e-4,0.0024354308770136866,1,0.541284374999981,0.5736064516128897,1,0.96875,0.006943494264114925,0.009331594838705394,1.6718,1.8843,0.4793,1.6488,2.1028,0.5056,0.2788,1.5415256486666666,1.4596425848666668,0.4812559079666667,1.0863,6.7597,0.3259,3.9317,0.3339,-99.3292,0.7053,9.4805,0.3666,11.3092,0.4322,0.9546,1.1072917247,3.924648185,6.096955414,0.33171318456666665,0.32140039276666665,0.9047,4.941,0.4636,2.9637,0.459,0.7372,0.177,0.2,0.508,0.055,1.837,33.4,1.7739857223333333,3.804538545,3.509218113,0.30619462236666667,0.337017839,422,1.2503703703703704,1,0,0,1,FALSE,FALSE,FALSE
300,2021-11-13T03:00:44Z,2021-11-13T03:23:17Z,1353,1,2021-11-13T03:23:18Z,0.8999999761581421,Safari,14.0.1,Macintosh,1440,900,NA,1.6,720,63,219,66,46,187,-0.17779831873632074,-0.24351084670544482,-1.0037908624172158,-0.47016805026408615,-0.3583560335760547,1.3787307918438174,4,4,1,1,4,2,1,4,2,4,4,2,1,1,4,4,2,1,3,3,1.3138933706635727,0,1,2,3,2,1.3,0,4,5,3,5,2,1,4,2,1,1,1,5,1,5,5,1,1,1,1,1,1,1,1,0,2,0,0,5,5,5,5,5,5,5,5,5,2,5,5,1,5,1,5,1,1,2,4,1,5,1,1,1,1,2,1,1,1,1,5,1,1,1,1,1,1,1,1,1,1.931250819994578,1.7728105208558367,1,0,1,0,1.4,0,1,0,1.75,0,1,0,0.8571428571428571,0,1,0,1.2702702702702702,0,0,0,0,-1.231864122301242,-1.2803255574836354,-0.7372407672780129,-1.008783162380824,5,1,5,1,1,1,1,1,1,1.9518001458970664,1,0,1,-0.9031185640466358,5,5,5,5,3,2,2,3,6,6,3,1.4638501094227998,4.142857142857143,0,1.8571428571428572,4.5,3.8333333333333335,3.2559414990859232,0.10757398284279028,0,-0.28065156173982786,2,2,3,3,2,2,3,1,2,1,1,3,2,3,2,2,3,2,3,3,0.7745966692414834,2.4,0,3.8,0,3,0,3.4,0,3.4,0,1,1,1,2,1,2,2,3,2,2,3,2,1,1,1,3,2,2,1,2,0.7163503994113789,1.75,0,"White, Caucasian, Anglo, European American",0,28,1,2,NA,1,3,6,Teacher,5,0,220,64,2,5,2,0,0,1,0,0,TRUE,TRUE,TRUE,TRUE,TRUE,1,0.8308421052631579,0.76,0.06387174244897867,1,0.4257000000000194,0.4846333333333372,0.967741935483871,0.9375,0.0037795161290319216,0.004838450604838662,1,0.5713125000000037,0.6741200000000069,1,0.78125,0.006182221774192479,0.008098802419356928,1.2725,0.8962,0.4631,1.3513,0.9544,0.451,0.4066,1.3229464743333332,0.91159231173,0.4533151006,1.1806,4.2415,0.2937,2.7699,0.292,-60.909,0.8298,5.854,0.3539,4.7291,0.4009,0.9527,1.2658536563666667,3.014583251,4.411818088333334,0.2883930021666667,0.28833452453333336,0.7968,3.4137,0.4806,2.1455,0.5402,0.9955,0.055,0.432,0.335,0.015,1.956,130.4,1.2718803616,3.7341526143333335,1.6830776333,0.3983246859333333,0.4236902419,104,0.3081481481481481,1,0,0,1,FALSE,FALSE,FALSE
301,2021-11-13T03:05:04Z,2021-11-13T03:23:44Z,1119,1,2021-11-13T03:23:45Z,1,Chrome,95.0.4638.69,Windows NT 10.0,1920,1080,No - thank you for the opportunity.,1.7777777777777777,610,46,232,70,44,62,-0.46042869066817177,-0.39795139802954327,-0.9412057536716539,-0.421422424127912,-0.3859801528497444,-0.732690053262817,4,4,1,1,3,1,1,4,1,4,4,1,2,1,4,3,1,1,3,4,1.3917047478769187,0,1,1,5,4,1.2,0,5,5,1,4,1,1,4,1,1,1,1,5,2,5,5,1,2,1,1,1,1,1,1,0,2,0,0,5,5,5,5,5,5,5,5,5,1,5,1,1,5,1,5,1,1,2,1,2,5,1,1,1,2,1,1,1,1,1,5,1,1,1,1,1,1,1,1,1,1.921507791343088,1.8973665961010275,1.125,0,1,0,1.2,0,1,0,1.1666666666666667,0,1,0,0.8571428571428571,0,1,0,1.0810810810810811,0,0,0,0,-1.2717903417083833,-1.3938604883178878,-0.7372407672780129,-1.0655506277979503,5,1,5,1,1,1,1,1,1,1.9518001458970664,1,0,1,-0.9031185640466358,5,5,5,5,4,3,1,3,4,4,4,1.5275252316519468,4.571428571428571,0,1.4285714285714286,5.5,3.8333333333333335,3.2559414990859232,0.6723373927674386,0,-0.23728284904181396,2,2,2,2,3,3,3,3,2,1,1,3,2,4,5,2,3,1,4,2,1.1832159566199232,2.2,0,3.8,0,3.2,0,4,0,3.6666666666666665,0,1,1,1,4,1,1,1,4,1,1,1,4,1,1,1,4,1,1,2,1,1.2258187382102494,1.05,0,"White, Caucasian, Anglo, European American",0,26,1,2,NA,1,3,4,services coordinator,3,0,170,65,2,5,2,0,0,1,0,0,TRUE,TRUE,TRUE,TRUE,TRUE,1,0.9834767441867396,0.86,0.10307436548612024,1,0.4343843749999069,0.49287419354819484,1,0.96875,0.0014107336188946974,0.003236709636989274,1,0.6186812499985099,0.6801516129038027,1,1,0.0041829377014133235,0.0085934059140616,1.5684,1.1868,0.5608,1.3027,1.0513,0.6761,0.2697,1.5641084156666667,1.0866788067333333,0.5513821740666667,1.1519,6.6712,0.3481,4.4483,0.369,-102.3927,0.549,4.9572,0.392,7.2358,0.4491,0.6533,1.1959917919333334,4.345237843666666,6.07810622,0.3639697900666667,0.3413763980333333,0.8605,4.7376,0.5355,3.4423,0.5868,0.994,0.133,0.397,0.577,0.042,1.934,46.047619047619044,2.526503154333333,5.632898639666666,4.445465352666667,0.4007617464,0.40195524983333336,310,0.9185185185185185,1,0,2,3,FALSE,FALSE,FALSE
303,2021-11-13T02:53:26Z,2021-11-13T03:24:42Z,1876,1,2021-11-13T03:24:43Z,0.8999999761581421,Chrome,95.0.4638.69,Macintosh,1440,900,The study made me think back to things I had forgotten. It was pleasant.,1.6,765,91,527,135,84,116,-0.06217680294601806,0.010861826063658545,0.4789947909391728,0.370694000584919,0.16650223262404917,0.17944375182324906,2,2,3,3,2,1,2,2,2,2,2,2,1,1,2,2,3,1,2,2,0.6048053188292994,0,1,1,4,4,2.45,0,5,5,1,4,1,1,4,1,1,1,1,4,1,4,4,1,2,1,1,1,1,1,1,0,2,0,0,5,5,5,5,5,5,5,5,5,1,5,2,1,4,1,1,4,2,3,2,1,5,1,1,1,3,2,1,1,2,1,4,3,2,1,2,1,2,1,2,2,1.7018802532482702,1.7265434778633235,1.125,0,1.75,0,1.3333333333333333,0,1,0,2.0833333333333335,0,1.3333333333333333,0,1.5714285714285714,0,1.3333333333333333,0,1.5945945945945945,0,0,0,0,-0.9523805864512536,-1.1158789696853448,-0.5020371591262895,-0.8089580644058172,4,3,3,5,2,3,1,3,1,1.2909944487358056,2.7142857142857144,0,2,0.49147533258947784,4,4,5,4,2,2,3,6,1,2,2,1.1338934190276817,3.4285714285714284,0,2.5714285714285716,5.5,3.8333333333333335,3.2559414990859232,0.6723373927674386,0,0.4000851303296801,2,2,3,3,2,1,4,1,3,1,1,4,2,4,3,1,4,2,3,3,1.245945806357946,2.4,0,4.4,0,3.4,0,3.6,0,3.8,0,1,1,2,2,3,3,3,2,3,3,1,2,1,1,1,2,3,3,2,3,0.8522416262267903,2.3,0,"Hispanic of Latino (e.g., Mexican American, Central American, and others)",0,24,1,2,NA,1,2,4,Hostess,3,0,175,63,3,5,2,0,1,1,0,1,TRUE,TRUE,TRUE,TRUE,TRUE,NA,NA,NA,NA,1,0.4724031250001863,0.5301774193554396,1,1,0.0034679299899186998,0.003814921139808876,1,0.6649687500002328,0.7574625000001397,1,1,0.0123026164113303,0.01232374370965587,NA,NA,NA,NA,NA,NA,NA,NA,NA,NA,2.3037,8.2306,0.3325,6.1165,0.3419,-97.0454,0.757,6.9416,0.4139,5.1701,0.463,0.9982,1.6361145146,4.747234450666666,6.339208145333333,0.36251283743333335,0.3494532111,0.9958,4.1688,0.5562,2.657,0.6125,0.9722,0.266,0.238,0.625,0.017,1.63,95.88235294117646,2.744630937666667,4.268079173666667,4.300852748666666,0.3446554940666667,0.44373770386666667,441,1.3066666666666666,1,0,1,2,FALSE,TRUE,FALSE
304,2021-11-13T03:01:53Z,2021-11-13T03:25:44Z,1431,1,2021-11-13T03:25:44Z,1,Chrome,95.0.4638.69,Windows NT 10.0,1280,720,NA,1.7777777777777777,673,82,310,74,98,120,-0.298558568561748,-0.07090081875498182,-0.5656951011982828,-0.37267679799173775,0.3598710675398769,0.24700921886666136,3,2,2,2,3,1,2,3,1,2,2,2,2,1,2,2,1,1,2,2,0.6407232755171874,0,1,4,2,2,2.1,0,4,4,3,4,2,1,4,2,2,1,2,4,1,4,4,2,1,1,1,1,2,1,2,1,2,0,0,5,3,4,5,5,5,5,5,5,2,5,3,1,5,1,5,1,1,1,2,4,4,1,1,1,4,1,1,3,3,1,4,2,1,1,2,1,1,1,1,2,1.6970208837488947,1.2649110640673518,1.375,0,1.25,0,1.8666666666666667,0,1.3333333333333333,0,1.5833333333333333,0,1.5,0,1.7142857142857142,0,1.3333333333333333,0,1.5675675675675675,0,1,0,0,-0.8136895085106579,-0.7908574029833673,-0.4557470907642554,-0.6233022468738113,5,1,3,1,1,1,1,1,1,1.5735915849388864,1.2857142857142858,0,1,-0.7321841937363471,4,4,4,4,2,2,3,6,7,3,4,0.9511897312113419,3.2857142857142856,0,2.7142857142857144,2.5,3.8333333333333335,3.2559414990859232,-1.0219528370065065,0,-0.3673889871358558,2,3,3,3,3,2,5,2,2,3,1,4,2,4,4,5,3,3,4,3,1.1872336794093274,2.8,0,3.8,0,3.4,0,3.8,0,3.6666666666666665,0,2,2,2,2,3,1,3,3,2,2,3,3,1,3,2,3,1,2,3,2,0.7163503994113789,2.15,0,"White, Caucasian, Anglo, European American",0,21,1,2,NA,1,3,4,Library Assistant and student,1,0,182,68,3,5,2,0,0,1,0,0,TRUE,TRUE,TRUE,TRUE,TRUE,3,0.7322000000033267,0.86,0.017356822958987782,3,0.46068437499180437,0.513615625012666,1,1,0.0018920503933943901,0.005281030389430038,3,0.5759812500067055,0.6377218749970198,1,1,0.005345581572631512,0.00410140240993621,1.2919,1.6276,0.4686,0.8731,1.6233,0.5921,0.1708,1.3069552780666667,1.3174721109,0.4619813459666667,1.8188,7.4513,0.3386,6.3602,0.3706,-104.8657,0.7836,7.1564,0.4085,4.9024,0.4307,0.9358,1.4760445317333333,5.301284599333333,5.993610335333333,0.3807935627,0.34282549586666666,1.746,5.5756,0.4177,5.8957,0.4893,0.9837,0.099,0.415,0.644,0.021,1.6,76.19047619047619,1.9485087212333334,5.261538199666667,5.270105246333333,0.3963898159,0.4618559563333333,325,0.9629629629629629,1,0,0,1,FALSE,FALSE,FALSE
306,2021-11-13T02:58:35Z,2021-11-13T03:26:27Z,1671,1,2021-11-13T03:26:28Z,0.8999999761581421,Edge,95.0.1020.44,Windows NT 10.0,1366,768,NA,1.7786458333333333,674,71,466,152,109,140,-0.29598920154418573,-0.1708329401999867,0.18532620374845948,0.5778629116636594,0.5118037235451701,0.5848365540837228,3,3,1,2,3,2,2,2,1,3,2,1,2,1,3,3,2,1,3,2,0.7880689256524124,0,1,1,2,2,1.9,0,2,5,3,5,2,2,3,3,2,3,2,4,1,4,5,2,3,1,1,2,2,2,1,2,2,0,0,5,5,3,5,5,5,5,5,5,3,4,2,1,4,2,5,4,2,2,3,3,3,1,1,1,1,1,1,2,2,1,5,2,2,1,1,2,1,1,1,1,1.59013475168884,1.2798809468443688,1.75,0,1,0,2.1333333333333333,0,1.2222222222222223,0,2.25,0,1.1666666666666667,0,1.4285714285714286,0,1.3333333333333333,0,1.6486486486486487,0,1,0,0,-0.5300032127230756,-0.4802575794137882,-0.5341482934814965,-0.5072029364476424,5,1,4,2,1,2,2,3,1,1.5118578920369088,1.5714285714285714,0,2,-0.19226214865167657,5,5,5,5,2,2,2,7,5,4,2,1.6035674514745464,4,0,2,3,3.8333333333333335,3.2559414990859232,-0.7395711320441822,0,-0.6245531217618774,3,3,3,2,3,3,5,3,2,3,4,2,3,3,4,1,3,2,5,4,1.1254628677422756,2.8,0,2.8,0,4.2,0,3.2,0,3.4,0,1,3,2,2,3,4,4,1,3,4,4,2,3,3,3,2,1,3,3,3,0.9787209698591858,3,0,Black or African American,0,19,1,2,NA,1,2,4,Cashier,5,0,175,66,2,5,2,0,0,0,0,0,TRUE,TRUE,TRUE,TRUE,TRUE,5,0.8839972972974584,0.74,0.034065650628246326,5,0.515874999997206,0.559865625004284,1,1,0.003448039354999421,0.003922682973374857,5,0.6404483870960052,0.7130774193559923,1,0.96875,0.003288191913721358,0.0036644308771305997,1.4021,0.832,0.5085,0.9869,0.7696,0.692,0.1837,1.4363627313333334,0.8639228906766667,0.5003155769666666,10,11.2937,0.0732,10.8835,0.1005,-89.7358,0.8364,5.3807,0.4444,5.6112,0.4892,0.9972,2.1109480196666666,5.297337158666667,5.350897762,0.36660462283333334,0.3218479170333333,0.7241,5.9238,0.5891,4.5207,0.6416,0.9854,0.067,0.542,0.673,0.016,1.377,86.0625,1.9981880936666667,4.752262458,4.562165339666667,0.43376526456666664,0.5103288461,344,1.0192592592592593,1,0,0,1,FALSE,FALSE,FALSE
307,2021-11-13T02:59:21Z,2021-11-13T03:27:16Z,1674,1,2021-11-13T03:27:18Z,1,Chrome,95.0.4638.69,Macintosh,1440,900,"No, that is all. Thank you.",1.6,931,62,346,99,59,101,0.36433812196932075,-0.2525955850186271,-0.3923824923644192,-0.06801663464064889,-0.17879925829707183,-0.07392674958954705,2,2,2,2,2,2,2,2,2,2,1,2,3,2,2,2,2,2,2,2,0.3244428422615251,0,1,1,3,3,2.6,0,3,3,3,2,2,3,3,3,3,2,2,1,1,2,3,3,5,1,1,3,3,3,3,0,2,0,0,4,4,4,4,4,5,5,5,5,3,3,5,1,3,2,3,3,2,4,3,3,2,2,1,1,1,1,1,1,1,1,4,1,3,1,2,3,1,1,1,1,1.4268973460049732,0.7367883976130072,2.75,0,1,0,2.933333333333333,0,1.5555555555555556,0,2.9166666666666665,0,1.5,0,1.2857142857142858,0,2,0,2.027027027027027,0,0,0,0,0.32735981454606206,0.4558974513013779,-0.7372407672780129,-0.14067165798831752,3,1,2,1,1,2,2,1,1,0.7559289460184544,2,0,1,-0.3048482679606258,3,3,5,3,3,3,3,1,1,2,2,0.7559289460184544,3.2857142857142856,0,2.7142857142857144,8,3.8333333333333335,3.2559414990859232,2.0842459175790595,0,1.1857103901569273,2,2,2,2,2,2,3,3,1,3,2,2,1,2,4,3,3,3,2,4,0.9154754164341269,2,0,3.2,0,3.2,0,3.2,0,3.2,0,1,1,3,1,2,3,4,2,1,2,2,2,1,4,2,1,1,3,3,4,1.0894228312566052,2.55,0,"White, Caucasian, Anglo, European American",0,20,1,2,NA,1,2,5,Student,2,0,150,65,1,5,2,0,0,1,0,0,TRUE,TRUE,TRUE,TRUE,TRUE,2,0.8391354838667378,0.6326530612244898,0.39316286510199433,2,0.5285562499910593,0.6206900000035763,1,0.9375,0.015931488991521362,0.03184178028202896,2,0.6364906250033527,0.8436903225798761,1,0.96875,0.03503908216858431,0.06413392579947795,1.6352,0.3329,0.4092,1.3949,0.1358,0.4917,0.2685,1.618449104,0.47622746342166666,0.4075347907,1.5147,3.1844,0.2907,2.2201,0.3102,-30.2078,1.3177,3.8159,0.3484,2.0177,0.3473,0.9625,1.5777506883333334,2.410711072133333,3.3893003813333333,0.30867928376666665,0.28709826753333334,1.3893,4.7517,0.4714,2.5338,0.5519,0.9905,0.092,0.388,0.367,0.011,1.895,172.27272727272728,2.1983134956666666,3.8249782606666667,2.2820077757,0.34714986523333335,0.3685947961,342,1.0133333333333332,1,0,0,1,FALSE,FALSE,FALSE
308,2021-11-13T03:02:20Z,2021-11-13T03:27:28Z,1507,1,2021-11-13T03:27:29Z,1,Chrome,95.0.4638.69,Windows NT 10.0,1536,864,Nothing specific,1.7777777777777777,673,50,328,80,48,117,-0.298558568561748,-0.36161244477681426,-0.479038796781351,-0.29955835878747644,-0.3307319143023651,0.19633511858410213,2,2,3,2,1,1,3,2,1,2,1,2,1,2,1,2,2,1,1,1,0.6708203932499369,0,1,2,3,4,2.65,0,2,4,2,4,3,2,1,1,1,1,1,5,1,4,4,2,1,3,1,1,1,1,1,0,3,3,0,5,5,5,5,5,5,4,5,5,2,4,1,1,5,1,5,2,2,1,1,3,4,1,1,2,2,3,1,1,1,1,5,1,1,1,1,1,2,2,1,2,1.7646852733884628,1.4540583599999397,1.375,0,1.75,0,2,0,1.1111111111111112,0,1.5,0,1.6666666666666667,0,0.8571428571428571,0,1,0,1.3243243243243243,0,0,3,0,-0.9649888662640349,-0.838091031497532,0.11786246365278161,-0.36011428392237516,5,1,5,1,1,1,2,1,2,1.889822365046136,1.1428571428571428,0,1.5,-0.6331575415043005,5,5,5,5,4,3,2,7,6,5,4,1.2149857925879117,4.428571428571429,0,1.5714285714285714,2.5,3.8333333333333335,3.2559414990859232,-1.0219528370065065,0,-1.00475696650735,1,1,2,2,2,2,5,3,2,5,2,5,2,4,5,1,5,3,4,3,1.4040757000349275,1.6,0,4.2,0,4.6,0,3.8,0,4.2,0,3,2,3,2,2,2,2,3,1,1,3,2,1,2,1,3,1,2,1,2,0.7591546545162482,1.95,0,"White, Caucasian, Anglo, European American",0,18,0,1,NA,1,4,3,Student,5,0,150,71,2,5,2,0,0,0,0,0,TRUE,TRUE,TRUE,TRUE,TRUE,5,0.9109355555521117,0.9,0.04429785959233874,5,0.45922258064535354,0.5857593750013038,1,1,0.0026149324731457686,0.006187497973802546,5,0.5671968750013039,0.6735033333331346,1,1,0.0033857474093361146,0.006313238265023018,1.3433,1.6398,0.5879,1.1629,2.4,0.6676,0.4523,1.369573304,1.3426561369,0.5758838106,3.5584,8.3279,0.2456,7.2293,0.3396,-89.3323,0.9903,5.7031,0.3777,5.3563,0.4898,0.9964,1.8355177556333333,5.046520038,5.6529741116666665,0.40911283206666665,0.3012621605,0.7763,4.7831,0.4921,4.9276,0.5913,0.8924,0.092,0.434,0.751,0.017,1.891,111.23529411764706,2.1906392583333334,6.371525604333334,4.619629825,0.4036799976,0.4433612451,338,1.0014814814814814,1,0,0,1,FALSE,FALSE,FALSE
309,2021-11-13T03:08:35Z,2021-11-13T03:28:15Z,1179,1,2021-11-13T03:28:16Z,0.8999999761581421,Chrome,95.0.4638.69,Windows NT 10.0,1536,864,NA,1.7777777777777777,605,57,293,60,54,71,-0.4732755257559832,-0.2980192765845384,-0.6475371664809406,-0.5432864894683475,-0.24785955648129604,-0.5806677524151392,2,1,4,3,2,4,4,2,3,2,1,4,3,3,1,1,4,4,1,1,1.2354415362426845,1,1,1,3,2,3.6,0,2,3,4,3,3,5,2,5,5,4,5,2,1,2,3,3,3,1,1,2,4,4,3,1,2,0,1,3,3,2,4,4,5,5,5,2,1,5,4,1,3,3,5,2,2,5,5,5,2,2,5,1,1,1,1,2,2,3,3,2,2,1,1,2,1,2,1,2,1.5002502293786697,1.3345232785352157,2.625,0,1.5,0,3.8,0,2.3333333333333335,0,2.75,0,2.1666666666666665,0,2,0,1.3333333333333333,0,2.3513513513513513,0,1,0,1,0.4513412327050791,0.9140055737553562,-0.20089624114783355,0.3565546663037613,4,2,3,1,2,3,1,1,4,1.1126972805283737,2,0,2.5,0.24863324420094737,5,4,5,5,3,2,1,6,7,4,3,1.618347187425374,4.142857142857143,0,1.8571428571428572,2.5,3.8333333333333335,3.2559414990859232,-1.0219528370065065,0,-0.8454149716644763,2,3,2,2,2,2,5,2,1,3,1,5,2,3,3,1,4,1,4,2,1.4040757000349275,2.2,0,4.6,0,4.2,0,3.8,0,4.2,0,3,2,4,2,2,4,4,1,1,3,2,2,2,4,1,2,3,4,2,2,1.0513149660756937,2.8,0,"White, Caucasian, Anglo, European American",0,18,1,2,NA,1,3,4,Student: Nursing,4,0,119,64,3,5,1,0,0,1,1,0,TRUE,TRUE,TRUE,TRUE,TRUE,5,0.8634617647072848,0.6938775510204082,0.206203610161646,5,0.4390249999985099,0.5169333333412807,1,0.9375,0.002462215485776856,0.00434671797484707,5,0.5718468750044704,0.6741107142652784,1,0.9032258064516129,0.00659404386180696,0.008098450727860309,1.398,0.5971,0.4435,1.1981,0.6903,0.4943,0.0526,1.4314218453333334,0.70501761227933335,0.4353689837,1.269,5.1354,0.3155,3.495,0.3515,-77.3319,0.7512,4.8559,0.3707,4.9796,0.4414,0.9461,1.3475947376333333,3.6189900633333334,5.119747327,0.34592499973333335,0.30960159686666666,0.6943,3.6613,0.5096,6.5162,0.6112,0.9548,0.071,0.398,0.447,0.007,1.403,200.42857142857142,1.641955117,4.204910953,2.2806398503666667,0.3768346906666667,0.35126601593333334,392,1.1614814814814816,1,0,0,1,FALSE,FALSE,FALSE
310,2021-11-13T02:54:02Z,2021-11-13T03:28:18Z,2055,1,2021-11-13T03:28:19Z,1,Chrome,95.0.4638.69,Windows NT 10.0,1920,1080,All instructions given were clear.,1.7777777777777777,1228,45,453,78,48,90,1.1274401261853184,-0.40703613634272556,0.12274109500289762,-0.3239311718555635,-0.3307319143023651,-0.2597317839589309,4,3,2,2,3,1,2,3,1,4,4,2,3,1,3,3,2,1,3,4,1.050062654772261,0,1,1,4,5,1.65,0,1,2,4,2,4,5,2,5,3,4,4,1,2,1,2,5,4,1,3,5,5,5,5,7,2,3,0,3,3,2,4,2,4,2,3,2,3,3,4,4,3,4,4,4,4,4,4,4,1,3,1,1,5,3,4,5,3,3,4,2,2,3,5,3,1,2,4,4,1.0759450067999097,1.424279266355945,4.125,0,2.75,0,4.133333333333334,0,3.2222222222222223,0,3.5833333333333335,0,2.8333333333333335,0,2.857142857142857,0,3.6666666666666665,0,3.2972972972972974,0,4,3,0,1.9727403301140392,2.108396917740587,1.2438371697078117,1.6761170437241995,2,4,1,4,3,4,4,7,3,1.2149857925879117,4,0,5,2.367643023308923,3,3,3,3,1,1,5,4,3,1,1,1.3801311186847085,2.142857142857143,0,3.857142857142857,5.5,3.8333333333333335,3.2559414990859232,0.6723373927674386,0,1.1171241071226108,3,2,5,3,3,3,4,2,2,3,2,4,2,3,3,1,4,2,3,3,0.8837151016885368,3.2,0,3.8,0,3.8,0,3.4,0,3.6666666666666665,0,1,2,1,3,2,1,2,3,1,1,3,4,2,2,2,4,1,1,1,2,0.998683343734455,1.55,0,"Black or African American & White, Caucasian, Anglo, European American",1,26,0,1,NA,1,1,4,Content Creator,2,0,260,71,3,5,2,0,0,0,0,0,TRUE,TRUE,TRUE,TRUE,TRUE,5,1.0415558139534538,0.86,0.15114166529012005,5,0.5252968749993016,0.5793093750004191,1,1,0.024177224829085665,0.011802774425356306,5,0.6247624999999534,0.676853124999674,1,1,0.017007497257968997,0.008331142570574858,1.5793,1.1427,0.6001,1.4204,0.949,0.6284,5e-4,1.5809736706666666,1.0581203229333334,0.5888885139,2.5298,3.9387,0.2041,4.3084,0.2857,-45.9801,1.3654,2.6997,0.2908,4.936,0.4417,0.9998,1.823350917,3.61639707,3.5381056946666667,0.32609983356666666,0.26070151243333334,1.2005,3.8744,0.46,3.6645,0.5293,0.9107,0.124,0.375,0.52,0.025,1.77,70.8,2.2462743516666666,4.300700121666667,4.456927596666667,0.3648198742666667,0.4308700243333333,376,1.114074074074074,1,0,2,3,FALSE,FALSE,FALSE
311,2021-11-13T03:07:07Z,2021-11-13T03:29:01Z,1313,1,2021-11-13T03:29:01Z,0.8999999761581421,Chrome,95.0.4638.69,Windows NT 10.0,1920,1080,no,1.7777777777777777,779,44,255,64,43,74,-0.02620566470014611,-0.4161208746559078,-0.8304782535833521,-0.4945408633321733,-0.39979221248658925,-0.5299936521325801,4,4,2,2,3,1,3,3,1,4,3,2,3,2,4,4,1,2,3,3,1.0310954828418375,0,1,3,3,2,1.7,0,2,4,3,5,2,2,4,3,2,2,3,4,2,4,3,2,2,1,1,1,1,2,2,1,2,0,0,4,2,5,5,5,4,4,5,5,2,5,4,1,4,2,5,3,5,4,5,5,5,1,1,1,3,1,1,1,3,1,4,2,3,1,1,1,1,2,1,1,1.6562739034481113,1,1.5,0,1.25,0,2.3333333333333335,0,1.6666666666666667,0,2.9166666666666665,0,1.1666666666666667,0,1.7142857142857142,0,1,0,2,0,1,0,0,-0.46696181365916845,-0.3507522618892957,-0.4557470907642554,-0.40324967632677555,5,1,4,1,1,1,1,1,1,1.7320508075688772,1.1428571428571428,0,1,-0.8176513788914915,5,5,5,5,3,3,1,3,7,NA,3,1.5735915849388864,4.428571428571429,0,1.5714285714285714,4,3.8333333333333335,3.2559414990859232,-0.1748077221195339,0,-0.5811844090638635,3,3,3,4,4,4,3,4,3,3,2,4,5,3,4,1,4,3,5,4,1.0600988273786194,3.4,0,3.4,0,3.4,0,2.8,0,3.2,0,1,4,1,3,4,1,2,3,1,1,3,4,3,2,2,4,1,1,2,3,1.1742858972247996,1.9,0,"White, Caucasian, Anglo, European American",0,19,1,2,NA,1,4,3,delivery driver,6,0,95,61,2,5,2,0,0,3,0,0,TRUE,TRUE,TRUE,TRUE,TRUE,1,0.7717128205146545,0.78,0.10630283469337262,1,0.5292156250011176,0.6020625000046567,1,1,0.006528046521960115,0.004786463064511374,1,0.6494064516117496,0.8152709677392437,1,1,0.021320862624439496,0.02116500612797852,1.6183,0.8387,0.2515,1.4494,0.7995,0.3472,0.0826,1.5904156163333334,0.8507836332333333,0.2522843459333333,10,9.449,0,10.0736,0.1059,-76.7252,0.85,4.3668,0.4408,4.7333,0.525,0.9626,2.0233562653333332,4.812040097666666,4.832477409,0.3964359430666667,0.3208869403333333,0.833,3.505,0.5408,2.9266,0.6898,0.9801,0.199,0.349,0.715,0.005,1.232,246.4,2.5586020443333335,4.624044040333334,3.9975762586666668,0.3753316454,0.4986417268,304,0.9007407407407407,1,0,0,1,FALSE,FALSE,FALSE
312,2021-11-13T03:07:03Z,2021-11-13T03:29:19Z,1335,1,2021-11-13T03:29:20Z,1,Chrome,95.0.4638.54,Macintosh,1792,1120,Nope!,1.6,711,58,321,62,42,83,-0.2009226218943813,-0.2889345382713561,-0.5127384707212689,-0.5189136764002604,-0.4136042721234341,-0.3779713512849024,2,1,3,4,1,1,2,1,1,3,1,2,3,3,1,1,2,1,1,2,0.9514531821875089,0,0,4,2,2,2.9,0,2,3,3,3,4,3,3,3,2,3,4,3,3,3,2,4,4,5,4,3,3,3,5,1,2,3,1,4,3,2,4,4,5,5,5,5,4,4,5,1,5,3,4,5,5,5,5,5,1,3,1,1,3,4,5,2,1,1,4,2,2,1,3,2,2,2,2,2,1.5314520382125407,0.5936168397046637,3.875,0,2,0,3.2,0,1.8888888888888888,0,3.5833333333333335,0,2.6666666666666665,0,2,0,2,0,2.6486486486486487,0,1,3,1,1.4137732584140625,1.3211052490229314,0.5758057870657198,0.9484555180443256,3,3,1,1,1,4,1,1,1,1.2909944487358056,2.5714285714285716,0,1,0.03702047265995151,2,4,5,5,2,2,2,5,5,3,3,1.4638501094227998,3.4285714285714284,0,2.5714285714285716,4,3.8333333333333335,3.2559414990859232,-0.1748077221195339,0,-0.023487427113806164,2,2,1,1,1,1,4,1,1,3,3,4,1,3,5,5,3,2,3,1,1.4474937289114918,1.4,0,3.8,0,3.2,0,4.6,0,3.8666666666666667,0,2,3,3,1,4,2,4,1,4,2,3,2,1,4,1,1,2,3,4,4,1.190974832912761,3.05,0,"White, Caucasian, Anglo, European American",0,19,1,4,Genderfluid,1,3,4,None.,3,0,125,66,1,5,2,0,0,0,0,0,TRUE,TRUE,TRUE,TRUE,TRUE,5,1.2856228571210588,0.7,0.18685730640114273,5,0.48943750001490116,0.5942937500923872,1,1,0.004284952741586085,0.005790583178998846,5,0.676056249961257,0.8540419354131145,1,1,0.006764476087249209,0.021655834511173522,1.834,0.4842,0.5308,1.7356,0.3191,0.6607,0.4565,1.780888559,0.566826976066,0.5255490040333334,6.3659,9.2456,0.1452,8.151,0.2038,-81.3149,0.866,5.1712,0.4113,4.9249,0.5126,0.8561,1.9608677473333334,4.603634721333333,5.416267982,0.3854198882666667,0.31150293663333334,1.1533,4.5155,0.5496,2.315,0.6615,0.9765,0.118,0.461,0.539,0.006,1.261,210.16666666666666,2.8577116023333335,5.47981272,3.6423697256666667,0.4210625069,0.46358464266666666,447,1.3244444444444445,1,0,1,2,FALSE,FALSE,FALSE
313,2021-11-13T03:02:05Z,2021-11-13T03:30:21Z,1695,1,2021-11-13T03:30:22Z,1,Chrome,92.0.4515.162,CrOS x86_64 13982.88.0,1366,768,NA,1.7786458333333333,814,87,444,98,63,112,0.06372218091453376,-0.025477127189070508,0.07941294279443173,-0.08020304117469244,-0.12355101974969247,0.11187828477983676,2,3,2,2,2,1,1,2,1,2,2,1,1,1,1,2,1,1,1,2,0.6048053188292994,0,1,2,4,3,2.15,0,2,4,1,2,1,1,5,1,1,1,1,4,4,4,4,1,3,1,1,1,1,1,1,3,2,0,1,3,3,5,4,4,4,4,4,4,1,4,1,1,5,5,5,1,1,2,2,2,5,1,1,1,1,1,1,4,1,1,5,1,2,1,1,1,1,1,1,1,1.6265440804496034,1.5491933384829668,1.25,0,1,0,1.8666666666666667,0,2.111111111111111,0,1.6666666666666667,0,0.8333333333333334,0,1.4285714285714286,0,1,0,1.5945945945945945,0,2,0,1,-0.8746295276057681,-0.832961149712182,-0.1546061727857994,-0.49378366124899076,5,1,4,1,1,1,1,1,1,1.7320508075688772,1.1428571428571428,0,1,-0.8176513788914915,4,3,4,4,3,3,2,4,6,3,3,0.7559289460184544,3.5714285714285716,0,2.4285714285714284,4,3.8333333333333335,3.2559414990859232,-0.1748077221195339,0,-0.10315842453524313,1,2,1,4,2,2,3,1,1,1,1,2,2,4,5,3,4,3,3,3,1.245945806357946,2,0,3.6,0,2.8,0,4.4,0,3.6,0,2,1,2,3,1,1,3,3,1,1,2,4,2,1,1,4,1,1,1,1,1.0563093645728086,1.4,0,"Hispanic of Latino (e.g., Mexican American, Central American, and others)",0,NA,1,2,NA,1,4,6,stay at home mom,5,0,133,66,4,5,2,0,0,0,0,0,TRUE,TRUE,TRUE,TRUE,TRUE,3,0.9181697674418778,0.86,0.08630887171019286,3,0.5733633333333147,0.6745062499999768,1,1,0.016716961712608214,0.022460703185473968,3,0.9517125000000087,1.0053031250000348,1,1,0.1813966566128481,0.08732176160280454,1.4922,1.2153,0.4659,1.1893,1.4997,0.6261,0.3914,1.4925128906666667,1.1074066589333333,0.4597564762333333,1.5414,3.4383,0.3492,3.7552,0.4693,-53.1599,1.1949,3.7376,0.4083,3.8792,0.5005,0.8114,1.8665524696666667,3.888741266,3.870340184333333,0.4345340538,0.3276605764,1.6534,1.6055,0.4821,1.5885,0.6087,0.889,0.138,0.341,0.246,0.014,1.713,122.35714285714286,2.636092835,2.2724687223333335,2.325131896333333,0.3519085069,0.42769172456666665,358,1.0607407407407408,1,0,0,1,FALSE,FALSE,FALSE
314,2021-11-13T03:11:08Z,2021-11-13T03:31:12Z,1203,1,2021-11-13T03:31:14Z,1,Chrome,94.0.4606.81,Macintosh,1440,900,NA,1.6,688,45,270,59,46,62,-0.2600180632983138,-0.40703613634272556,-0.7582646665692423,-0.555472896002391,-0.3583560335760547,-0.732690053262817,3,3,2,2,3,3,3,2,1,2,2,3,2,3,2,2,3,2,2,2,0.5871429486123998,0,1,2,4,3,2.55,0,4,4,2,4,2,2,4,2,2,2,2,5,3,4,4,1,2,1,1,1,1,2,1,0,2,0,0,5,4,4,4,5,5,4,4,5,1,5,1,1,5,1,5,2,1,1,1,3,4,1,1,1,2,1,1,1,1,1,4,2,2,1,1,1,2,1,1,1,1.6769950245341554,1.0997835284835873,1.25,0,1.25,0,2,0,1.5555555555555556,0,1.25,0,1.1666666666666667,0,1.2857142857142858,0,1,0,1.3513513513513513,0,0,0,0,-1.0259288853591455,-0.8801947782263467,-0.6588395645607719,-0.7695171713935594,4,1,3,1,1,2,1,1,1,1.2149857925879117,1.5714285714285714,0,1,-0.5612498234260587,5,4,5,5,3,3,2,4,3,NA,2,1.2149857925879117,4.142857142857143,0,1.8571428571428572,5.5,3.8333333333333335,3.2559414990859232,0.6723373927674386,0,0.0017301432224963165,4,3,4,5,4,4,4,3,4,3,3,3,3,3,3,3,3,2,4,3,0.560611910581388,4,0,3,0,3.4,0,2.8,0,3.066666666666667,0,2,3,4,2,4,4,3,2,3,3,4,2,2,4,1,2,3,4,4,4,0.9733285267845752,3.2,0,"White, Caucasian, Anglo, European American",0,20,1,2,NA,1,3,4,student,5,0,115,65,2,5,2,0,0,1,0,0,TRUE,TRUE,TRUE,TRUE,TRUE,2,0.6872411764772499,0.68,0.024590879689440574,2,0.43176206897250535,0.4977551724150263,0.90625,0.9666666666666667,0.008537080483751585,0.008778100644359495,2,0.6355343749988824,0.7766999999942451,1,0.9354838709677419,0.010349117167627118,0.03064303045075285,1.1975,0.6807,0.3863,0.7423,0.8576,0.559,0.1575,1.2516641740333334,0.7854405457166667,0.38000216896666666,0.9499,2.4244,0.2676,3.773,0.3781,-59.6332,1.1032,4.4573,0.2962,4.3771,0.3602,0.8639,1.0334456483333334,3.8722750803333335,2.816768263,0.37078729713333336,0.2630003339,1.2017,4.6169,0.5024,2.1668,0.549,0.9976,0.069,0.476,0.398,0.015,1.751,116.73333333333333,1.7583383193333333,4.4441785456666665,2.3071166010333335,0.43920601876666665,0.41726876343333336,429,1.271111111111111,1,0,0,1,FALSE,FALSE,FALSE
315,2021-11-13T03:05:22Z,2021-11-13T03:33:23Z,1680,1,2021-11-13T03:33:25Z,1,Chrome,95.0.4638.69,Macintosh,1792,1120,Fun study!,1.6,695,69,504,105,83,162,-0.2420324941753778,-0.18900241682635124,0.36826729085087107,0.0051018045636124325,0.15269017298720433,0.9564466228224905,4,3,1,2,3,1,1,3,1,3,3,1,1,1,4,3,1,1,4,3,1.1964860832322377,0,1,1,4,3,1.4,0,2,5,3,5,3,1,4,2,2,1,2,5,3,4,5,2,4,1,1,2,4,2,2,9,2,0,0,5,5,5,5,5,5,5,5,5,1,4,2,1,5,2,5,2,2,2,3,3,4,1,1,1,3,1,1,5,5,1,5,1,2,1,1,1,1,2,4,4,1.7638342073763937,1.4573295865416045,2.25,0,2.75,0,1.9333333333333333,0,1,0,1.8333333333333333,0,1.3333333333333333,0,2.142857142857143,0,1,0,1.5945945945945945,0,5,0,0,-0.25262105684188396,-0.3745626565911081,0.8270300207252568,0.22623368206707434,5,2,4,1,1,1,1,2,2,1.6761634196950514,1.2857142857142858,0,2,-0.3631965189619651,5,5,5,5,4,4,1,3,8,6,4,1.4638501094227998,4.714285714285714,0,1.2857142857142858,3.5,3.8333333333333335,3.2559414990859232,-0.4571894270818581,0,-0.881717256387899,2,2,2,3,2,2,3,1,1,2,1,4,3,5,4,2,5,2,3,3,1.3345232785352157,2.2,0,4.4,0,3,0,4.4,0,3.933333333333333,0,1,1,1,4,1,1,1,4,1,1,1,4,1,1,1,4,1,1,1,1,1.231174022502185,1,0,"White, Caucasian, Anglo, European American",0,30,1,2,NA,0,4,6,Performance Marketing Manager,6,0,158,71,3,5,2,0,0,1,0,0,TRUE,TRUE,TRUE,TRUE,TRUE,1,0.9717444444451895,0.72,0.06831872524067656,1,0.5700062499986962,0.6713806451616748,1,1,0.005166227056489258,0.014952056946201392,1,0.7176031249989756,0.8561709677418393,1,1,0.006336608054621669,0.018011179462681673,1.3144,0.7398,0.614,1.2677,0.5736,0.6454,0.1056,1.370421311,0.8063576270666667,0.6013337933666667,2.685,6.1406,0.3514,4.6329,0.3816,-65.9633,1.0446,5.2544,0.4736,3.2108,0.5238,0.9879,2.083925128,3.955764848,5.136826792,0.4085434017333333,0.36933172476666665,1.0631,4.4052,0.6012,2.1361,0.703,0.904,0.109,0.486,0.438,0.012,1.54,128.33333333333334,2.864751011,5.585191723,3.808510081666667,0.4671781904,0.4831053706,382,1.1318518518518519,1,0,0,1,FALSE,FALSE,FALSE
316,2021-11-13T03:00:33Z,2021-11-13T03:33:33Z,1979,1,2021-11-13T03:33:34Z,1,Chrome,95.0.4638.69,Windows NT 10.0,1600,900,"The mood-oriented questions (regarding crying spells, etc) are currently affected by my pregnancy. 

Thank you!",1.7777777777777777,863,100,553,95,65,99,0.1896211647750856,0.09262447088229891,0.6041650084302965,-0.11676226077682311,-0.09592690047600279,-0.10770948311125321,4,4,1,2,4,1,1,4,1,4,2,1,1,2,4,4,1,1,4,4,1.4327007988227578,0,1,2,2,2,1.2,0,3,5,2,3,2,3,3,3,3,3,2,3,2,3,3,3,3,5,1,3,3,3,3,1,2,1,0,4,4,3,5,4,5,5,5,4,1,5,4,3,4,2,5,1,4,4,4,4,3,1,1,2,1,1,1,3,3,2,4,2,2,1,1,3,2,2,2,2,1.4529663145135578,0.7432233529572065,3,0,2,0,2.6,0,1.6666666666666667,0,2.5833333333333335,0,1.3333333333333333,0,2,0,1.6666666666666667,0,2.027027027027027,0,1,1,0,0.4828619322370331,0.4200850690262941,-0.01391027501950836,0.20308739700339287,4,1,3,1,1,2,2,3,1,1.1547005383792515,1.7142857142857142,0,2,-0.10679496349653231,5,5,5,5,5,5,1,6,4,NA,4,1.5118578920369088,5,0,1,4,3.8333333333333335,3.2559414990859232,-0.1748077221195339,0,-0.8998683987496106,3,3,2,2,3,2,3,3,2,2,1,4,3,3,4,3,5,1,4,5,1.2535663410560174,2.6,0,4.6,0,3,0,3,0,3.533333333333333,0,2,1,1,3,2,1,2,4,1,2,2,4,3,1,1,4,2,2,1,2,1.050062654772261,1.55,0,"White, Caucasian, Anglo, European American & Native American/Alaskan Native/indigenous",1,30,1,2,NA,1,1,3,freelance,2,0,115,62,1,5,2,1,1,0,0,2,TRUE,TRUE,TRUE,TRUE,TRUE,6,0.8168595238129298,0.84,0.030728582383561645,6,0.44186562499869614,0.4968656250014901,1,1,0.0013731474897763262,0.0020180603930500156,6,0.5972906249994412,0.6742931034513588,1,0.90625,0.006378107973399765,0.01261604286291184,1.6207,1.2372,0.3896,0.9107,1.4949,0.652,0.0187,1.5762821283333333,1.1040725103666666,0.3865424907,3.2942,10.4566,0.2844,9.4173,0.322,-116.3694,0.5919,5.5464,0.3963,7.3903,0.4568,0.8368,1.3960848528333334,5.766737229666667,6.246052268,0.38363945443333336,0.3363575316333333,0.8646,3.1791,0.488,2.5946,0.55,0.9672,0.063,0.442,0.399,0.013,1.493,114.84615384615385,1.6434087123333334,4.342687916666667,2.2574506673333334,0.40906073383333336,0.3494353895333333,444,1.3155555555555554,1,0,0,1,FALSE,FALSE,FALSE
317,2021-11-13T03:11:40Z,2021-11-13T03:34:14Z,1353,1,2021-11-13T03:34:15Z,1,Chrome,95.0.4638.69,Macintosh,1920,1080,NA,1.7777777777777777,773,47,293,75,46,62,-0.041621866805519804,-0.38886665971636103,-0.6475371664809406,-0.3604903914576942,-0.3583560335760547,-0.732690053262817,2,2,3,2,2,2,2,2,1,2,2,1,1,1,2,2,2,2,2,2,0.4893604849295929,0,1,2,2,1,2.35,0,4,5,3,3,4,1,4,2,2,1,2,4,1,3,1,1,1,1,1,1,1,1,1,0,2,0,0,3,5,3,4,2,5,5,5,5,1,4,5,1,3,1,4,1,1,2,2,3,3,1,1,1,3,3,1,1,1,1,5,2,2,1,1,2,2,2,2,2,1.5382998298011887,1.3451854182690985,1,0,2,0,2.2666666666666666,0,1.8888888888888888,0,2,0,1.8333333333333333,0,1.1428571428571428,0,1.3333333333333333,0,1.7837837837837838,0,0,0,0,-0.9124543670441124,-0.687195074830354,-0.4236359564090485,-0.5554155156197013,4,2,4,2,2,2,2,3,1,0.9759000729485332,2,0,2,0.06413940681375631,5,5,5,5,4,3,2,6,6,5,4,1.2149857925879117,4.428571428571429,0,1.5714285714285714,3,3.8333333333333335,3.2559414990859232,-0.7395711320441822,0,-0.8635661140261877,2,2,2,2,2,2,4,2,1,4,1,3,2,4,4,3,3,1,3,2,1.121223821162776,2,0,4,0,3.6,0,4.2,0,3.933333333333333,0,1,4,4,2,4,4,4,2,1,3,4,2,1,4,1,3,3,4,3,4,1.2096106376585989,3,0,"White, Caucasian, Anglo, European American",0,22,1,2,NA,1,4,7,Student,1,0,117,66,1,5,2,0,0,2,0,0,TRUE,TRUE,TRUE,TRUE,TRUE,6,0.8570936170201352,0.94,0.04564437761573103,6,0.429421874997206,0.5188571428571429,1,0.875,0.0031981624091378825,0.007024682540192432,6,0.5298343749972991,0.6598964285712157,1,0.875,0.003401311360868272,0.007040710282434143,1.5339,1.9735,0.5102,1.3599,2.6174,0.5944,0.371,1.4596398913333333,1.4940819112,0.5046392098666667,1.015,4.5729,0.3184,2.324,0.3519,-67.5446,0.732,5.4103,0.3674,3.9403,0.4173,0.9533,1.1105662714666666,2.6059654628,4.722499012,0.3450690136,0.31227091733333334,0.8283,5.1324,0.449,3.0576,0.5486,0.9296,0.065,0.428,0.652,0.013,1.85,142.30769230769232,1.2493790405333334,4.901704685,2.3875578652666665,0.40592818816666665,0.4328392541666667,308,0.9125925925925925,1,0,0,1,FALSE,FALSE,FALSE
318,2021-11-13T02:40:07Z,2021-11-13T03:34:47Z,3280,1,2021-11-13T03:34:48Z,0.8999999761581421,Chrome,95.0.4638.69,Windows NT 10.0,1536,864,NA,1.7777777777777777,867,379,293,47,26,179,0.1998986328453347,2.6272664602601505,-0.6475371664809406,-0.7017097744109136,-0.6345972263129516,1.2435998577569927,4,4,1,1,4,1,1,3,1,4,3,1,1,1,3,4,2,1,4,3,1.348488432516786,0,1,2,4,4,1.25,0,4,4,2,4,2,4,3,4,5,4,2,3,4,4,5,3,4,3,4,3,4,4,3,5,2,0,0,4,3,4,3,3,4,2,4,2,4,3,4,3,4,3,4,3,4,3,3,3,4,2,4,4,4,2,4,4,2,2,2,4,3,2,2,2,2,2,2,3,0.8337836621061816,0.9856107606091623,3.5,0,2.25,0,2.8,0,2.7777777777777777,0,3.0833333333333335,0,2.8333333333333335,0,3.142857142857143,0,2,0,2.945945945945946,0,3,0,0,1.3654415191317333,1.115813187386572,0.2640426676977418,0.6899279275421569,4,2,3,3,4,2,4,1,1,0.8997354108424374,2.857142857142857,0,1,0.20795484297024003,2,3,4,2,4,3,3,4,3,1,2,0.816496580927726,3,0,3,5.5,3.8333333333333335,3.2559414990859232,0.6723373927674386,0,0.6390981225939902,1,3,1,3,2,2,3,2,3,4,4,2,3,4,2,4,4,2,3,2,0.8837151016885368,2,0,3.2,0,3,0,3.4,0,3.2,0,1,2,1,2,2,1,3,1,2,1,NA,3,2,1,1,4,1,2,1,2,0.8719139396343282,1.736842105263158,1,"White, Caucasian, Anglo, European American",0,30,0,1,NA,1,3,4,retail,2,0,180,65,3,5,2,0,0,1,0,0,TRUE,TRUE,TRUE,TRUE,TRUE,1,0.9782375000000466,0.6530612244897959,0.06616675444728623,1,0.5564178571430967,0.606766666666915,1,1,0.04899017707674215,0.028967469884962307,NA,NA,NA,NA,NA,NA,NA,1.3946,0.4725,0.5241,1.1207,0.7037,0.6831,0.3975,1.4340616426666666,0.6202401131766667,0.5146349265666667,1.8424,2.6324,0.2065,3.5393,0.3465,-30.3888,1.4193,2.3034,0.2757,3.0433,0.3715,0.7841,1.77101638,3.4948779653333335,2.771959100666667,0.3506760158,0.21964562816666666,NA,NA,NA,NA,NA,NA,NA,NA,NA,NA,NA,NA,NA,NA,NA,NA,NA,216,0.64,1,0,1,2,FALSE,FALSE,FALSE
319,2021-11-13T02:57:23Z,2021-11-13T03:34:49Z,2245,1,2021-11-13T03:34:50Z,1,Chrome,95.0.4638.69,Windows NT 10.0,1366,768,I'm interested in the results of the research and I wish you all the best!,1.7786458333333333,655,58,386,76,59,98,-0.34480717487786905,-0.2889345382713561,-0.19981292699345962,-0.3483039849236506,-0.17879925829707183,-0.12460084987210628,2,2,3,2,2,1,1,3,1,2,3,1,2,1,2,4,1,1,3,3,0.9176629354822471,0,1,1,4,4,1.9,0,1,3,3,3,5,2,1,3,2,2,3,3,2,4,3,5,4,4,3,4,4,4,4,9,3,0,0,5,4,3,3,2,5,4,4,5,5,4,4,1,3,2,5,5,5,4,2,2,3,1,1,1,5,3,3,5,5,5,4,3,3,2,4,2,5,3,5,5,1.365050681609794,1.0465362369445672,4,0,4.5,0,3.066666666666667,0,2.111111111111111,0,3,0,2.1666666666666665,0,3.5714285714285716,0,2.6666666666666665,0,2.7837837837837838,0,5,0,0,1.5755795160114243,1.375598144214478,1.3758384397459444,1.3757182919802111,4,3,2,2,3,3,2,2,1,0.7559289460184544,2.7142857142857144,0,1.5,0.3069814952022868,3,3,3,4,1,1,5,5,7,NA,2,1.4638501094227998,2.2857142857142856,0,3.7142857142857144,3,3.8333333333333335,3.2559414990859232,-0.7395711320441822,0,0.33149884729536355,1,2,1,2,1,1,3,1,1,3,1,5,3,5,2,2,5,2,2,3,1.4540583599999397,1.4,0,4.8,0,3,0,4,0,3.933333333333333,0,2,1,2,3,1,2,2,3,1,1,1,3,1,1,1,3,3,2,2,2,0.812727700887249,1.65,0,"Hispanic of Latino (e.g., Mexican American, Central American, and others)",0,25,1,2,NA,1,3,4,ESL Teacher,2,0,150,61,2,5,2,0,0,1,0,0,TRUE,TRUE,TRUE,TRUE,TRUE,2,0.9187676470630309,0.6938775510204082,0.10811019541619234,2,0.41706874999031424,0.4642225806636195,1,0.96875,9.093957663045292e-4,0.002217717489493758,2,0.5358124999776482,0.6472586206814338,1,0.90625,0.0026997559685179107,0.008268486087062809,1.4629,0.5691,0.4661,1.2977,0.4232,0.5594,0.3242,1.486294299,0.6748345215966667,0.4589048398,1.1695,7.3114,0.3371,4.9951,0.3542,-110.7699,0.6344,7.6967,0.3766,6.0211,0.4136,0.978,1.1343210732333333,4.620163927,6.319793828333333,0.3527013420333333,0.33354142223333333,0.7137,5.5713,0.4779,4.5374,0.5631,0.8616,0.079,0.39,0.582,0.012,1.741,145.08333333333334,1.5355922593333333,5.440958326,2.2323808663,0.40017756973333335,0.3382041592,384,1.1377777777777778,1,0,0,1,FALSE,FALSE,FALSE
320,2021-11-13T03:15:23Z,2021-11-13T03:35:16Z,1193,1,2021-11-13T03:35:17Z,1,Chrome,95.0.4638.69,Windows NT 10.0,1423,800,Love you,1.77875,831,63,129,24,19,76,0.10740142021309255,-0.24351084670544482,-1.4370723845018747,-0.9819971246939154,-0.7312816437708655,-0.4962109186108739,2,2,3,2,3,2,1,2,1,2,2,1,1,2,3,2,1,1,2,2,0.6708203932499369,0,1,4,3,2,2.15,0,2,3,2,3,2,2,2,3,2,2,2,3,2,3,3,3,2,3,3,2,3,2,4,2,4,1,1,2,2,3,2,3,2,3,2,3,3,2,2,3,2,3,2,3,2,3,2,2,2,2,2,3,2,3,2,2,3,2,3,2,2,2,2,3,3,2,2,3,0.4916723926983716,0.50709255283711,2.75,0,2.5,0,2.6666666666666665,0,3.5555555555555554,0,2.9166666666666665,0,2.5,0,2.142857142857143,0,2.3333333333333335,0,2.864864864864865,0,1,1,1,0.8485020468076946,0.7013574552192497,0.3193417773141546,0.5103496162667022,2,3,2,3,2,2,3,2,1,0.5345224838248488,3,0,1.5,0.47791586551257526,2,3,2,2,3,2,3,3,3,2,2,0.5345224838248488,2.4285714285714284,0,3.5714285714285716,6,3.8333333333333335,3.2559414990859232,0.9547190977297628,0,1.0989729647608995,2,3,2,3,3,2,2,3,2,3,2,2,3,2,2,3,3,2,3,3,0.5163977794943222,2.6,0,3.4,0,2.8,0,2.8,0,3,0,2,2,1,2,2,2,2,2,2,1,2,2,2,3,2,2,1,2,2,2,0.44721359549995793,2.1,0,"Hispanic of Latino (e.g., Mexican American, Central American, and others)",0,22,0,1,NA,1,2,4,Retail,2,0,200,66,2,5,2,0,0,2,0,0,TRUE,TRUE,TRUE,TRUE,TRUE,6,0.9770374999996274,0.6808510638297872,0.32631797780864197,6,0.6157625000004967,0.736199999999255,0.96,0.9333333333333333,0.025795929933947137,0.01797876510361442,6,0.8521062499987893,0.9731903225803568,1,0.96875,0.056210338669668965,0.0857983585472962,1.4929,0.4891,0.4946,1.5183,0.5635,0.442,0.0377,1.5144029266666668,0.6125547773653334,0.48583244843333334,1.4065,2.3201,0.3271,2.483,0.4825,-21.4339,1.279,4.0742,0.4427,3.9322,0.5617,0.982,1.6289487286666666,2.6636087726666666,2.746575812,0.4514725707,0.3128938805,1.6453,3.4369,0.5773,1.8697,0.5829,0.9826,0.088,0.547,0.298,0.016,1.716,107.25,2.5357618516666665,3.196990541,2.075747581,0.44818682153333333,0.37067768116666666,104,0.3081481481481481,1,1,4,5,FALSE,FALSE,FALSE
321,2021-11-13T03:14:49Z,2021-11-13T03:35:18Z,1228,1,2021-11-13T03:35:18Z,1,Chrome,93.0.4577.107,CrOS x86_64 14092.77.0,1366,768,n/a,1.7786458333333333,633,44,300,62,44,92,-0.4013332492642393,-0.4161208746559078,-0.6138374925410226,-0.5189136764002604,-0.3859801528497444,-0.2259490504372247,4,3,1,1,4,1,1,3,1,4,3,1,1,1,4,4,1,1,4,4,1.4244112357114616,0,1,1,2,2,1.15,0,5,5,1,5,1,1,4,1,1,1,1,5,1,5,5,1,1,1,1,1,1,1,1,5,2,0,0,5,5,5,5,5,5,5,5,5,1,5,1,1,5,1,5,1,1,1,1,1,5,1,3,1,3,2,1,3,3,1,5,1,1,1,1,1,1,1,1,1,1.8768384380448209,2.007130147392398,1,0,1,0,1.0666666666666667,0,1,0,1,0,1.6666666666666667,0,1.4285714285714286,0,1,0,1.2432432432432432,0,3,0,0,-1.2486751620516177,-1.435189913267782,-0.12796334588846375,-0.7815766295781228,5,1,5,1,1,1,1,1,1,1.9518001458970664,1,0,1,-0.9031185640466358,5,5,5,5,4,3,1,1,5,3,3,1.5275252316519468,4.571428571428571,0,1.4285714285714286,6,3.8333333333333335,3.2559414990859232,0.9547190977297628,0,-0.09609199656065187,1,1,1,2,2,1,4,1,1,3,1,4,1,5,5,1,4,1,3,1,1.6388149028228556,1.4,0,4.6,0,4,0,5,0,4.533333333333333,0,2,1,2,4,1,2,1,4,1,1,1,4,1,1,1,4,1,2,1,1,1.1964860832322377,1.2,0,"White, Caucasian, Anglo, European American",0,26,1,2,NA,1,3,3,analyst,4,0,110,59,3,5,2,0,0,1,0,0,TRUE,TRUE,TRUE,TRUE,TRUE,3,0.7858263157894345,0.76,0.057156888412385885,3,0.46442857142830535,0.5842464285708432,1,1,0.006330256190405133,0.018237403320266705,3,0.641268749999581,0.6844375000002328,1,1,0.012215178991864155,0.005156829515985426,1.3162,0.944,0.4422,1.0674,0.9541,0.5347,0.0929,1.356205661,0.9412602863666667,0.4348972123666667,2.1463,6.4031,0.2968,4.0469,0.3191,-62.5531,1.0318,6.138,0.3734,5.0636,0.474,0.989,1.7793221293333332,3.6090265656666665,5.53764299,0.33646323563333336,0.307848584,0.8893,3.6527,0.5327,5.6035,0.6088,0.8464,0.191,0.354,0.698,0.016,1.31,81.875,2.468048736666667,4.354336789333333,5.456693888,0.3595931144,0.46723166963333335,428,1.268148148148148,1,0,0,1,FALSE,FALSE,FALSE
322,2021-11-13T03:12:33Z,2021-11-13T03:35:17Z,1363,1,2021-11-13T03:35:18Z,0.8999999761581421,Chrome,95.0.4638.69,Windows NT 10.0,1280,720,This was an interesting survey,1.7777777777777777,742,69,262,84,59,73,-0.12127224434995054,-0.18900241682635124,-0.7967785796434342,-0.2508127326513022,-0.17879925829707183,-0.5468850188934331,2,3,2,2,1,4,3,2,1,2,2,2,1,2,1,2,3,2,1,1,0.8255779474818965,0,1,1,3,2,2.75,0,5,5,3,5,1,1,2,1,1,1,1,4,1,4,4,1,1,1,1,1,1,1,2,0,2,0,0,5,4,5,5,4,5,5,5,3,1,5,1,1,4,2,5,1,1,1,1,4,4,1,1,1,1,1,1,1,1,1,5,1,2,1,1,1,1,1,1,1,1.7735968103392739,1.7237832147426693,1.125,0,1,0,1.5333333333333334,0,1.4444444444444444,0,1.4166666666666667,0,1,0,1,0,1,0,1.2972972972972974,0,0,0,0,-1.1373020237053812,-1.1576923457470643,-0.7372407672780129,-0.9474665565125386,5,1,3,1,1,1,1,1,1,1.5735915849388864,1.2857142857142858,0,1,-0.7321841937363471,5,5,5,5,2,2,2,6,8,4,3,1.6035674514745464,4,0,2,2,3.8333333333333335,3.2559414990859232,-1.3043345419688306,0,-0.9069348267242017,2,2,2,3,2,2,3,3,2,3,2,4,2,4,4,3,3,2,3,3,0.7432233529572065,2.2,0,3.8,0,3.2,0,3.6,0,3.533333333333333,0,1,2,3,3,2,3,2,2,2,1,2,2,3,4,1,2,2,2,2,1,0.7880689256524124,2.2,0,"White, Caucasian, Anglo, European American",0,22,1,2,NA,1,3,6,Tutor,4,0,180,71,2,5,2,0,0,1,0,0,TRUE,TRUE,TRUE,TRUE,TRUE,2,0.7693184210626702,0.7916666666666666,0.0373532105306384,2,0.45960666666030886,0.6039709677388592,0.9375,0.96875,0.002760508998038962,0.008432056855650353,2,0.6000500000119209,0.6605516128847676,1,0.96875,0.01166651613450204,0.010742111896200142,1.1593,1.1696,0.4562,1.0402,1.4593,0.5247,0.3323,1.2202496114,1.075938271,0.44626273726666665,1.1981,3.3023,0.2956,3.2587,0.4305,-57.883,1.266,5.9188,0.3496,3.4704,0.43120000000000003,0.9958,1.3408310326,3.447976194,3.675976675333333,0.41755649969999997,0.2888667915,1.1305,4.8459,0.4802,4.4307,0.5387,0.8899,0.074,0.397,0.36,0.028,2.011,71.82142857142857,1.9779680266666666,3.864531384,3.27807919,0.34250301753333334,0.3731925077666667,356,1.0548148148148149,1,0,0,1,FALSE,FALSE,FALSE
323,2021-11-13T03:08:02Z,2021-11-13T03:36:00Z,1677,1,2021-11-13T03:36:01Z,1,Chrome,95.0.4638.69,Macintosh,1440,900,NA,1.6,821,50,396,83,45,214,0.08170775003746973,-0.36161244477681426,-0.15167053565071972,-0.26299913918534573,-0.37216809321289956,1.8347976943868503,4,4,1,1,4,1,1,2,1,4,2,1,1,1,4,4,1,1,3,3,1.3611140947574412,0,1,1,3,2,1.3,0,3,4,2,4,3,2,3,3,2,2,1,3,1,4,3,2,4,5,5,1,3,3,2,2,4,0,4,3,1,3,3,2,3,3,5,3,3,4,1,5,2,1,3,3,5,2,1,1,3,5,5,1,5,1,1,2,2,2,5,1,1,1,1,1,1,3,2,2,1.4831384627537982,0.9759000729485332,3.125,0,2,0,2.2666666666666666,0,3.111111111111111,0,2.5833333333333335,0,3.1666666666666665,0,1.2857142857142858,0,1,0,2.4864864864864864,0,1,0,4,0.8464006668388974,0.5280061669633707,0.4852551049841909,0.5066306359737808,4,2,3,2,2,2,1,1,1,0.9511897312113419,2,0,1,-0.3048482679606258,5,5,5,5,2,2,2,3,1,NA,3,1.6035674514745464,4,0,2,7,3.8333333333333335,3.2559414990859232,1.5194825076544112,0,0.5049736980874192,2,2,2,3,2,2,5,1,1,2,1,3,2,3,4,1,3,1,3,4,1.2983506020002016,2.2,0,4,0,3.8,0,3.8,0,3.8666666666666667,0,1,1,1,3,1,1,1,3,2,1,2,3,3,2,2,2,2,2,2,1,0.7677718959499145,1.7,0,Black or African American,0,24,1,2,NA,1,1,4,Fulfillment Associate,7,0,250,62,2,5,2,0,0,1,0,0,TRUE,TRUE,TRUE,TRUE,TRUE,2,0.9837138888883508,0.7346938775510204,0.19634297623363225,2,0.4752032258070765,0.5442068965519811,1,0.90625,0.008778378989115222,0.008976172258060515,2,0.6195483870965338,0.7535366666669647,1,0.9375,0.01223699458077558,0.014387552863178847,1.6023,0.6379,0.4295,1.4908,0.5483,0.428,0.1275,1.591923698,0.7083692193,0.4262129970333333,1.2555,3.0036,0.2662,2.8697,0.3551,-45.9855,0.9073,4.3906,0.3762,3.604,0.4171,0.9899,1.373206744,3.0794839233333335,3.350714645,0.345435959,0.2613234803666667,1.0628,4.2211,0.5012,3.0633,0.6018,0.9522,0.084,0.394,0.382,0.005,1.153,230.6,1.8086376573333334,3.504260437,2.73417604,0.3573240883666667,0.44967724606666665,431,1.2770370370370372,1,0,0,1,FALSE,FALSE,FALSE
324,2021-11-13T03:14:41Z,2021-11-13T03:36:01Z,1279,1,2021-11-13T03:36:02Z,1,Chrome,95.0.4638.69,Windows NT 10.0,1280,720,NA,1.7777777777777777,681,52,290,61,49,78,-0.27800363242124976,-0.3434429681504497,-0.6619798838837625,-0.5311000829343039,-0.31691985466552025,-0.4624281850891678,2,2,1,1,2,1,1,2,1,2,2,1,1,1,2,2,1,1,2,2,0.512989176042577,0,1,2,3,2,2,0,4,4,2,3,2,2,3,2,2,2,2,4,2,3,4,2,2,1,1,1,1,2,2,2,2,0,0,4,3,4,4,4,5,5,5,5,2,4,3,1,3,2,4,2,2,2,3,3,4,1,5,1,1,1,2,3,3,3,4,2,2,1,1,1,2,2,2,2,1.364500590641815,0.8837151016885368,1.5,0,2,0,2.2,0,1.6666666666666667,0,2.25,0,1.6666666666666667,0,2.2857142857142856,0,1,0,1.972972972972973,0,1,0,0,-0.4837728534095438,-0.4196669002132409,-0.22054348261253207,-0.32010519141288646,4,2,2,1,1,2,2,1,2,1,2,0,1.5,-0.12035443057343476,4,4,4,4,2,2,1,3,3,2,3,1.2909944487358056,3.5714285714285716,0,2.4285714285714284,6,3.8333333333333335,3.2559414990859232,0.9547190977297628,0,0.46160498538940525,3,3,3,3,3,3,4,2,3,3,2,3,3,2,3,2,3,2,3,2,0.6172133998483676,3,0,3.4,0,3.4,0,3.2,0,3.3333333333333335,0,2,2,2,3,2,2,2,2,2,1,3,2,1,2,1,2,1,2,2,2,0.5525062514530825,2,0,"White, Caucasian, Anglo, European American",0,28,1,2,NA,1,3,7,Student,7,0,155,64,2,5,2,0,0,1,0,0,TRUE,TRUE,TRUE,TRUE,TRUE,6,0.5973475000016392,0.8163265306122449,0.015104259685198561,6,0.4814624999985099,0.5587374999942258,1,1,0.004224755967961664,0.006363026935781111,6,0.5948387096783807,0.6998838709698569,1,0.96875,0.024467817117750926,0.01169296963685748,1.0587,1.4779,0.3772,0.73,1.8981,0.4897,0.2306,1.1141689422333334,1.2200724519666666,0.36929863636666665,6.5806,9.3801,0.1307,7.9214,0.1434,-79.5274,0.9636,9.1977,0.4262,7.9171,0.4932,0.9201,1.899872506,4.25924348,5.5680124483333335,0.3380499852666667,0.31461977746666664,1.0827,2.8609,0.4259,4.4671,0.5722,0.9955,0.306,0.076,0.606,0.008,1.247,155.875,1.7250240213333334,3.213069471333333,3.5687099533333333,0.31941719376666666,0.4729375157333333,340,1.0074074074074075,1,0,0,1,FALSE,FALSE,FALSE
325,2021-11-13T03:19:57Z,2021-11-13T03:36:32Z,994,1,2021-11-13T03:36:33Z,1,Chrome,94.0.4606.81,Windows NT 10.0,1366,768,No,1.7786458333333333,601,69,147,26,19,73,-0.4835529938262323,-0.18900241682635124,-1.350416080084943,-0.9576243116258283,-0.7312816437708655,-0.5468850188934331,3,3,2,2,3,1,2,2,2,2,1,1,1,2,2,2,1,1,2,2,0.6708203932499369,0,1,3,3,1,2.15,0,3,3,4,4,4,3,4,3,3,2,2,4,3,4,4,2,3,3,3,2,3,3,2,7,2,0,0,3,3,3,4,4,4,3,2,2,3,3,4,4,4,3,3,3,3,4,4,4,3,3,5,4,4,4,3,4,3,4,4,4,3,4,3,2,3,4,3,2,0.688821075805956,0.7237468644557459,2.625,0,3,0,2.6666666666666665,0,2.888888888888889,0,3.3333333333333335,0,3.6666666666666665,0,3.142857142857143,0,3,0,3.27027027027027,0,4,0,0,1.0229165842178378,0.821861282063789,0.7023387496459815,0.7621000158548852,2,3,2,3,3,2,3,3,1,0.5345224838248488,3.142857142857143,0,2,0.7478768880549106,3,3,3,4,4,3,3,4,3,1,1,0.4879500364742666,3.2857142857142856,0,2.7142857142857144,5.5,3.8333333333333335,3.2559414990859232,0.6723373927674386,0,0.4797561277511168,3,4,4,3,3,3,3,4,4,3,3,3,2,3,3,4,4,4,3,3,0.5936168397046637,3.4,0,3,0,3,0,2.6,0,2.8666666666666667,0,2,3,3,2,2,2,3,3,4,3,3,2,2,2,2,2,3,3,3,4,0.6708203932499369,2.75,0,"White, Caucasian, Anglo, European American",0,19,1,2,NA,1,2,4,sales associate,1,0,208,62,2,5,2,0,0,2,0,0,TRUE,TRUE,TRUE,TRUE,TRUE,NA,NA,NA,NA,5,0.5154586206633469,0.6328366666634878,0.9354838709677419,0.9375,0.017321406441113667,0.00660034522631378,5,0.6883937499821186,0.8409096774593476,1,0.96875,0.00476761545040538,0.010525703879964122,NA,NA,NA,NA,NA,NA,NA,NA,NA,NA,1.2175,2.0294,0.2424,3.1034,0.4612,-33.9141,0.7386,3.4085,0.422,3.8597,0.5509,0.9854,1.3485174560666666,3.2314524873333332,2.3924303440333334,0.4453038696666667,0.2364265187,1.1009,4.69,0.577,3.4792,0.7019,0.9115,0.1,0.511,0.562,0.009,1.573,174.7777777777778,2.498828377666667,5.178599565333333,3.30056887,0.4516160770666667,0.4774187744,104,0.3081481481481481,1,0,0,1,FALSE,FALSE,FALSE
326,2021-11-13T03:15:19Z,2021-11-13T03:37:26Z,1326,1,2021-11-13T03:37:27Z,1,Chrome,95.0.4638.69,Windows NT 10.0,1536,864,NA,1.7777777777777777,722,50,301,64,51,78,-0.1726595847011962,-0.36161244477681426,-0.6090232534067487,-0.4945408633321733,-0.28929573539183057,-0.4624281850891678,2,2,3,3,1,4,4,1,2,1,1,4,4,4,1,1,3,3,1,1,1.260743306232687,0,0,2,4,3,3.6,0,5,4,3,4,2,2,4,1,2,1,2,4,2,5,4,1,1,1,1,1,1,1,2,0,2,0,0,5,3,4,5,5,4,3,3,2,1,5,1,1,3,2,5,2,2,1,1,3,3,1,1,1,3,3,1,1,1,1,4,1,2,1,2,1,2,1,1,1,1.4405120877920723,1.3627702877384937,1.125,0,1.25,0,1.8,0,2.2222222222222223,0,1.5833333333333333,0,1.8333333333333333,0,1.1428571428571428,0,1.3333333333333333,0,1.7297297297297298,0,0,0,0,-0.8683253876993774,-0.85725549552582,-0.6588395645607719,-0.758047530043296,5,1,4,2,1,2,2,1,1,1.5118578920369088,1.5714285714285714,0,1,-0.5612498234260587,5,5,5,3,2,2,2,6,4,3,3,1.5118578920369088,3.7142857142857144,0,2.2857142857142856,4,3.8333333333333335,3.2559414990859232,-0.1748077221195339,0,-0.18282942195667984,2,2,2,2,2,2,5,2,3,3,2,4,1,3,3,1,4,2,4,2,1.162919151265879,2,0,4,0,4.4,0,3.4,0,3.933333333333333,0,3,3,3,2,4,3,3,2,3,1,2,2,3,3,1,2,3,3,1,2,0.8255779474818965,2.65,0,"White, Caucasian, Anglo, European American",0,20,1,2,NA,1,3,5,Unemployed but searching,2,0,110,61,1,5,2,0,0,1,0,0,TRUE,TRUE,TRUE,TRUE,TRUE,6,0.8342400000050664,0.8163265306122449,0.05582210255027043,6,0.4455500000044703,0.5594375,1,1,0.0016609606451505991,0.006114055322535115,6,0.6183062499966472,0.7227468750048429,1,1,0.006028754799517091,0.018254891601778605,1.3334,1.2236,0.4967,1.1403,1.4354,0.5508,0.1425,1.3662199506666666,1.1053327072,0.4882657236333333,10,14.0582,0.0899,9.6361,0.0405,-94.3114,0.8048,7.2588,0.3963,4.5644,0.4777,0.9857,1.9032569713333334,4.744618314333334,6.134599743333333,0.3630328646,0.29604575006666667,1.2296,5.096,0.4967,2.927,0.5277,0.9641,0.109,0.394,0.476,0.014,1.553,110.92857142857142,2.414837294333333,5.150814599666667,3.8196046536666666,0.3888552231333333,0.40983052053333335,376,1.114074074074074,1,0,0,1,FALSE,FALSE,FALSE
327,2021-11-13T03:14:34Z,2021-11-13T03:39:09Z,1474,1,2021-11-13T03:39:10Z,1,Firefox,91.0,Macintosh,1280,800,N/A,1.6,660,67,402,89,73,107,-0.3319603397900577,-0.20717189345271578,-0.12278510084507581,-0.18988069998108442,0.014569576618755927,0.02742145097557139,2,3,2,2,2,2,3,2,1,2,1,2,2,2,2,1,2,2,1,2,0.5525062514530825,0,0,3,4,3,2.6,0,4,4,2,4,2,2,4,1,1,4,1,5,3,4,4,2,2,1,2,1,1,1,1,1,3,0,0,4,5,5,5,4,4,4,4,5,1,4,1,1,4,1,4,1,2,1,1,1,5,1,1,1,1,1,1,2,2,1,4,1,1,1,1,1,2,1,2,2,1.6366669418909514,1.3627702877384937,1.375,0,1.75,0,1.9333333333333333,0,1.5555555555555556,0,1.3333333333333333,0,0.8333333333333334,0,1.2857142857142858,0,1,0,1.3243243243243243,0,1,0,0,-0.9649888662640349,-0.8667409373175989,-0.2989446853297732,-0.5828428113236861,4,1,4,1,1,1,1,1,1,1.4638501094227998,1.2857142857142858,0,1,-0.7321841937363471,4,4,4,4,3,3,1,1,1,2,3,1.1126972805283737,3.857142857142857,0,2.142857142857143,8,3.8333333333333335,3.2559414990859232,2.0842459175790595,0,0.8670264004711803,3,3,2,2,2,2,4,2,2,2,2,2,2,2,4,3,3,2,4,3,0.828078671210825,2.4,0,3.4,0,3.4,0,3.4,0,3.4,0,1,1,1,2,1,1,2,3,1,1,1,3,2,1,1,3,1,1,1,1,0.7591546545162482,1.35,0,"Hispanic of Latino (e.g., Mexican American, Central American, and others)",0,23,1,2,NA,1,3,3,Teacher assistant,2,0,120,62,3,5,2,0,0,0,0,0,TRUE,TRUE,TRUE,TRUE,TRUE,2,1.1588125,0.64,0.07552177183673471,2,0.4820625,0.5918,1,0.967741935483871,0.0030998024193548378,0.006045382795698923,2,0.62521875,0.78503125,1,1,0.010355982862903223,0.021471128024193546,1.2903,0.4546,0.7782,1.0885,0.5156,0.8777,0.4179,1.3647449303333334,0.6154624553226666,0.7592626510333333,1.2139,6.0313,0.3814,3.7693,0.4402,-87.9532,0.9617,6.1438,0.3985,5.279,0.4941,0.9508,1.3719495004333333,3.9206652776666666,5.813065060333333,0.42757661036666667,0.36864605283333335,1.0566,4.3202,0.5004,2.3977,0.6054,0.9577,0.176,0.336,0.599,0.007,1.282,183.14285714285714,2.6874056913333333,5.041319318,3.7039661846666667,0.36312042533333333,0.4245969776333333,428,1.268148148148148,1,0,0,1,FALSE,FALSE,FALSE
329,2021-11-13T03:09:33Z,2021-11-13T03:40:12Z,1839,1,2021-11-13T03:40:15Z,1,Safari,13.1.3,Macintosh,1440,900,NA,1.6,879,173,433,125,59,118,0.23073103705608208,0.7558103677446041,0.026456312317417848,0.24882993524448352,-0.17879925829707183,0.2132264853449552,4,4,1,1,4,1,2,1,1,4,4,1,1,1,4,4,1,1,4,4,1.500876936643164,0,1,1,3,2,1.2,0,2,4,5,3,3,5,4,3,3,2,2,4,2,4,5,2,5,1,1,2,4,3,4,1,2,0,0,5,3,1,1,1,4,4,5,4,4,5,2,1,3,3,5,4,3,1,4,5,3,1,1,1,3,3,1,1,1,1,4,3,2,1,1,1,2,2,1,1,1.517663764904237,1.121223821162776,2.75,0,1.5,0,2.7333333333333334,0,2.888888888888889,0,2.6666666666666665,0,1.8333333333333333,0,1.4285714285714286,0,1,0,2.27027027027027,0,1,0,0,0.4786591722994391,0.4744811739954753,-0.3773458880470143,0.048567642974230496,5,1,5,1,1,1,1,1,1,1.9518001458970664,1,0,1,-0.9031185640466358,5,5,5,5,3,3,3,6,8,NA,4,1.0690449676496976,4.142857142857143,0,1.8571428571428572,2,3.8333333333333335,3.2559414990859232,-1.3043345419688306,0,-0.9866058241456384,5,3,3,2,2,2,4,3,1,3,1,4,2,4,4,1,5,1,3,4,1.3732131246511903,3,0,4.6,0,3.8,0,3.6,0,4,0,1,1,1,4,1,1,1,4,1,3,2,4,1,1,1,4,1,1,2,1,1.2396943596157715,1.2,0,"White, Caucasian, Anglo, European American",0,26,1,2,NA,1,3,7,researcher studying mosquitoes,2,0,120,59,3,5,2,0,0,1,0,0,TRUE,TRUE,TRUE,TRUE,TRUE,1,1.1227187500000035,0.6666666666666666,0.10802649468085168,1,0.518612903225814,0.6280624999999891,1,1,0.0033475784946227992,0.009076124999999925,1,0.6649375000000054,0.7638666666666706,1,0.967741935483871,0.010893479838711174,0.009105769892473848,1.5126,0.4785,0.645,1.289,0.3214,0.7785,0.2507,1.545101425,0.6049132654796333,0.6303842899333333,2.7294,7.4545,0.3355,5.2706,0.3691,-79.2745,0.9073,4.4116,0.4232,4.8011,0.5345,0.9662,1.9277767833333332,4.209046673333333,5.865021904,0.40132674043333333,0.35911325666666666,1.0541,3.5133,0.5237,5.2043,0.6524,0.9973,0.084,0.491,0.552,0.012,1.664,138.66666666666666,2.298547629,4.649597229,3.3099900736666665,0.42002206166666667,0.4302329229333333,104,0.3081481481481481,1,0,0,1,FALSE,FALSE,FALSE
330,2021-11-13T02:59:35Z,2021-11-13T03:42:16Z,2560,1,2021-11-13T03:42:17Z,1,Chrome,95.0.4638.69,Macintosh,1440,900,NA,1.6,1574,58,515,116,110,122,2.016441114261868,-0.2889345382713561,0.42122392132788494,0.13915227643809153,0.525615783182015,0.2807919523883675,3,3,4,4,1,4,4,3,1,2,3,3,3,4,1,2,1,4,2,3,1.118033988749895,0,1,1,3,3,2.95,0,3,5,1,4,1,1,4,4,5,2,5,3,1,3,4,2,3,1,1,3,5,3,2,3,2,0,0,5,5,5,5,5,5,1,2,3,1,5,5,5,4,4,1,5,5,5,5,5,3,1,1,1,4,5,1,3,4,1,5,1,1,1,1,1,1,1,1,1,1.8166728655155007,1.533747356112131,2.5,0,1,0,2.4,0,2,0,4,0,2.3333333333333335,0,1.5714285714285714,0,1,0,2.5945945945945947,0,2,0,0,0.5248895316129712,0.36317241827561997,-0.33105581968498016,0.016058299295319906,3,2,2,1,1,4,1,3,1,1.1547005383792515,2.2857142857142856,0,2,0.2350737771240448,1,2,5,5,1,1,4,1,1,2,1,1.889822365046136,2.4285714285714284,0,3.5714285714285716,8,3.8333333333333335,3.2559414990859232,2.0842459175790595,0,1.6637363746855478,2,4,2,3,3,3,5,5,1,5,1,5,1,4,4,1,5,1,5,5,1.8439088914585775,2.8,0,4.6,0,5,0,3,0,4.2,0,1,2,1,1,3,1,3,4,2,1,2,2,1,4,1,2,1,2,3,1,1.0208355710680808,2,0,"Asian or Asian American (e.g., Chinese, Japanese, and others)",0,25,1,2,NA,1,2,6,public health professional,3,0,130,64,1,5,2,0,1,1,0,1,TRUE,TRUE,TRUE,TRUE,TRUE,NA,NA,NA,NA,4,0.48447499999962745,0.5900259259268641,0.8571428571428571,0.9,0.017830023121893402,0.03312483862049658,4,0.6243156250012107,0.8008999999993082,1,0.875,0.00739436394148765,0.035849972863132656,NA,NA,NA,NA,NA,NA,NA,NA,NA,NA,1.2139,1.6918,0.2094,1.7819,0.2959,-8.3279,0.9077,2.2605,0.33,2.8937,0.4298,0.9963,1.2516601642,1.9960876626666666,2.0255993827,0.2947603279666667,0.21102600883333333,1.3259,5.8051,0.5126,1.7483,0.5177,0.9474,0.075,0.43,0.365,0.005,1.285,257,1.8296099133333332,3.6512002446666667,1.7307349274333332,0.3704172649,0.3447339178666667,425,1.2592592592592593,1,0,0,1,FALSE,FALSE,FALSE
331,2021-11-13T03:17:24Z,2021-11-13T03:43:16Z,1552,1,2021-11-13T03:43:17Z,1,Chrome,95.0.4638.69,Macintosh,1440,900,N/A,1.6,724,84,390,87,75,111,-0.1675208506660716,-0.0527313421286173,-0.18055597045636368,-0.21425351304917153,0.04219369589244561,0.0949869180189837,4,3,1,1,3,2,2,2,1,3,2,1,1,2,4,3,2,1,2,2,0.9679060415469871,0,1,2,4,4,1.8,0,1,5,2,4,2,2,3,2,5,2,4,2,2,3,3,3,5,1,1,3,5,3,3,3,2,0,0,3,4,3,5,3,5,5,5,3,2,5,5,1,3,2,4,2,5,5,5,3,2,1,1,1,1,1,1,4,4,3,4,1,1,1,1,3,2,3,3,3,1.5701800742161598,1.2071217242444348,3,0,2.75,0,2.8,0,2,0,3,0,1.3333333333333333,0,2.142857142857143,0,1.6666666666666667,0,2.27027027027027,0,2,0,0,0.6341612899904101,0.6105682266407941,0.21775259933570762,0.4141604129882509,5,1,4,1,1,1,1,1,1,1.7320508075688772,1.1428571428571428,0,1,-0.8176513788914915,4,4,4,4,2,2,2,7,4,NA,3,1.0690449676496976,3.4285714285714284,0,2.5714285714285716,3.5,3.8333333333333335,3.2559414990859232,-0.4571894270818581,0,-0.16467827959496828,2,2,2,3,2,3,4,3,2,3,2,3,4,4,4,3,4,3,4,4,0.7237468644557459,2.2,0,3.4,0,3.2,0,3.4,0,3.3333333333333335,0,2,1,1,4,2,2,1,3,1,2,2,3,2,2,1,3,2,2,2,1,0.8255779474818965,1.65,0,"White, Caucasian, Anglo, European American",0,25,1,2,NA,1,3,7,Teacher,3,0,140,68,4,5,2,0,0,1,0,0,TRUE,TRUE,TRUE,TRUE,TRUE,5,0.812460975609538,0.82,0.0550032674939502,5,0.5302874999999767,0.57803548387089565,1,1,0.0065204475807040035,0.0054009563655613565,5,0.7104312500006054,0.7463406249996042,1,1,0.021493762862976665,0.004174794102851127,1.3584,1.2115,0.4714,1.0768,1.4948,0.5614,0.2025,1.3854427163333334,1.1029592794,0.46420407063333335,5.4945,7.6545,0.1714,7.9501,0.2325,-75.0247,0.8822,3.9164,0.4297,4.4811,0.4891,0.9825,1.9866890563333333,4.819386684,4.796515226666667,0.3768237733,0.3240944577666667,1.2072,2.7509,0.512,8.7834,0.6766,0.8345,0.234,0.29,0.582,0.02,1.665,83.25,2.5055038136666665,3.940013485666667,5.347948254333334,0.3917487587333333,0.5207666662666667,388,1.1496296296296296,1,0,0,1,FALSE,FALSE,FALSE
332,2021-11-13T03:27:44Z,2021-11-13T03:49:12Z,1287,1,2021-11-13T03:49:14Z,1,Chrome,95.0.4638.69,Windows NT 10.0,1920,1080,NA,1.7777777777777777,647,40,339,64,65,73,-0.36536211101836735,-0.45245982790863687,-0.4260821663043371,-0.4945408633321733,-0.09592690047600279,-0.5468850188934331,4,3,2,1,4,1,1,3,1,4,3,1,1,3,2,4,1,1,3,4,1.268027892769755,0,1,2,3,4,1.45,0,1,4,2,3,1,4,2,5,2,1,3,1,1,2,3,2,5,1,1,3,4,5,3,7,2,0,0,4,1,3,1,1,2,1,2,1,1,5,3,4,3,4,3,4,5,4,5,3,2,1,4,3,3,2,1,4,5,2,2,4,3,2,4,1,2,1,1,3,1.3567758992703403,1.2909944487358056,3,0,1.75,0,3,0,4.222222222222222,0,3.3333333333333335,0,2.6666666666666665,0,3.142857142857143,0,2.3333333333333335,0,3.3783783783783785,0,4,0,0,1.3234139197557957,1.172725838137246,0.31033273605977596,0.7415292870985111,2,3,1,4,1,4,3,6,1,1.2724180205607036,3.4285714285714284,0,3.5,1.472292770526772,1,3,4,2,1,1,5,1,1,1,1,1.618347187425374,1.8571428571428572,0,4.142857142857143,8,3.8333333333333335,3.2559414990859232,2.0842459175790595,0,1.9824203643712948,4,5,2,4,2,4,5,2,3,1,1,4,5,1,4,5,3,1,3,5,1.5976172734359604,3.4,0,3.8,0,2.2,0,2.6,0,2.8666666666666667,0,2,3,4,1,2,3,2,4,3,3,2,1,3,4,1,1,1,4,3,2,1.0990426455975697,2.75,0,"White, Caucasian, Anglo, European American",0,25,0,1,NA,1,1,3,Unemployed,1,0,355,72,1,5,2,0,0,1,0,0,TRUE,TRUE,TRUE,TRUE,TRUE,1,0.8436558823506621,0.68,0.09405734675890141,1,0.5032593749994412,0.6810607142868851,1,0.9032258064516129,0.006008249586639282,0.020310889462180463,1,0.6625187499984168,0.814761290321427,1,0.96875,0.011503428669180029,0.022477761935682294,1.6655,0.4889,0.2667,1.2615,0.5325,0.5032,0.5683,1.63567466,0.5931480400781667,0.26759559456666665,1.2913,4.7522,0.3674,2.0183,0.419,-51.3698,1.1213,5.7367,0.3993,2.7302,0.476,0.8997,1.4449734697333334,2.2572919517,4.869613997,0.40233508026666664,0.35577617796666666,1.1876,6.9714,0.5766,3.66,0.6569,0.9913,0.111,0.389,0.408,0.007,1.407,201,2.456321662666667,4.162742296333334,2.6536796236666667,0.36744093336666667,0.3636038950666667,270,0.8,1,0,0,1,FALSE,FALSE,FALSE
333,2021-11-13T03:24:01Z,2021-11-13T03:52:50Z,1729,1,2021-11-13T03:52:52Z,1,Safari,14.0.3,Macintosh,1440,900,I thought the circle game was the most fun!,1.6,736,283,383,101,57,100,-0.13668844645532424,1.7551315821946532,-0.21425564439628159,-0.04364382157256178,-0.2064233775707615,-0.09081811635040013,4,4,1,1,4,1,3,4,1,4,4,2,1,1,4,4,1,1,4,4,1.460893742308382,0,1,2,5,3,1.15,0,3,4,1,4,3,1,4,4,2,1,3,3,1,3,1,3,4,1,1,3,4,3,4,2,2,0,0,4,1,3,5,5,5,5,5,5,3,4,4,1,4,2,5,3,5,5,5,5,3,1,1,1,3,2,1,3,3,3,4,3,1,2,4,3,4,1,2,2,1.4694077579620841,1.245945806357946,2.875,0,2.25,0,2.4,0,1.7777777777777777,0,3.1666666666666665,0,1.6666666666666667,0,2.142857142857143,0,3,0,2.4324324324324325,0,1,0,0,0.6572764696471762,0.4546391784106317,-0.14214227989529096,0.15624844925767034,4,2,3,2,1,3,2,1,1,0.9759000729485332,2.142857142857143,0,1,-0.21938108280548152,5,5,5,5,1,1,4,6,6,4,2,1.889822365046136,3.4285714285714284,0,2.5714285714285716,3,3.8333333333333335,3.2559414990859232,-0.7395711320441822,0,-0.3058691320761303,2,3,1,4,1,2,4,1,1,3,3,3,1,3,4,1,4,1,3,4,1.245945806357946,2.2,0,3.8,0,4,0,3.8,0,3.8666666666666667,0,1,4,1,3,3,2,3,3,2,2,1,4,4,4,3,3,1,2,3,3,1.0462967275611939,2.3,0,"White, Caucasian, Anglo, European American",0,22,1,2,NA,1,2,6,after school teacher,5,0,125,62,3,5,2,0,0,1,0,0,TRUE,TRUE,TRUE,TRUE,TRUE,1,0.773880952380951,0.84,0.01758770163265368,1,0.45990625,0.53896875,1,1,0.002266668346774029,0.0022486764112901636,1,0.7221562499999945,0.7747812499999982,1,1,0.009100523185484656,0.013387466733869782,1.1574,1.5488,0.5198,0.915,1.5903,0.6119,0.1188,NA,NA,NA,4.1973,10.1495,0.2531,9.6312,0.3211,-107.685,0.7285,5.9254,0.4023,6.7179,0.4865,0.991,NA,NA,NA,NA,NA,1.0612,4.8814,0.6264,4.1082,0.6423,0.896,0.301,0.282,0.676,0.029,1.331,45.89655172413793,NA,NA,NA,NA,NA,422,1.2503703703703704,1,0,1,2,FALSE,FALSE,FALSE
335,2021-11-13T03:12:45Z,2021-11-13T03:54:49Z,2523,1,2021-11-13T03:54:50Z,1,Firefox,94.0,Windows NT 6.1,1366,768,It was kind of long for me.,1.7786458333333333,790,60,1021,118,150,233,0.0020573724930389916,-0.2707650616449916,2.857228923270523,0.16352508950617864,1.0780981686558087,2.155733662843059,4,3,1,1,1,1,1,1,1,1,1,1,1,1,4,2,1,1,1,1,0.998683343734455,0,1,1,5,5,2.05,0,2,2,2,2,3,3,2,3,2,2,1,2,2,2,3,3,4,1,1,1,3,3,2,2,2,1,1,3,3,3,3,3,3,2,2,2,2,2,2,1,2,2,3,3,2,2,4,3,2,1,1,1,2,3,1,2,2,1,3,3,2,4,3,3,1,1,1,1,0.8183334709454757,0.560611910581388,2.25,0,1,0,3,0,3.3333333333333335,0,2.6666666666666665,0,1.8333333333333333,0,1.8571428571428572,0,3.3333333333333335,0,2.6486486486486487,0,1,1,1,0.4030094934227509,0.5368140771985941,-0.15106543898929206,0.19287431910465103,4,2,2,2,1,2,3,1,1,0.9511897312113419,2.2857142857142856,0,1,-0.1339138976503373,2,2,2,2,1,1,4,3,3,1,2,1,1.7142857142857142,0,4.285714285714286,6,3.8333333333333335,3.2559414990859232,0.9547190977297628,0,1.497327951868083,2,1,1,1,1,1,1,1,1,1,1,1,1,1,1,1,1,1,1,1,0,1.2,0,3.4,0,2.6,0,3.4,0,3.1333333333333333,0,1,1,1,1,1,1,1,1,1,1,1,1,1,1,2,1,1,1,1,1,0.22360679774997896,1.65,0,Black or African American,0,30,1,2,NA,1,4,4,unemployed,4,0,110,66,2,5,2,1,0,1,0,1,TRUE,TRUE,TRUE,TRUE,TRUE,4,1.0322500000000001,0.72,0.11287184040816327,4,0.5451,0.6101875,0.967741935483871,1,0.013116991397849461,0.009098802419354837,4,0.5958125,0.6471612903225806,1,0.96875,0.005645512096774193,0.00266811995967742,1.5319,0.6338,0.4849,1.4338,0.5829,0.5644,0.2565,1.5435747396666666,0.7141246533333333,0.4778639458,1.3572,3.5755,0.363,3.7537,0.4294,-60.4864,1.1158,4.0084,0.3997,5.1797,0.4975,0.9248,1.5731367071333333,3.9709124723333336,3.867162771,0.4128155055666667,0.3456771896,0.946,4.2273,0.4953,7.2326,0.5857,0.8265,0.062,0.472,0.52,0.023,1.844,80.17391304347827,1.985909468,4.457915841666667,4.466323322666667,0.3749222710333333,0.4398726589,311,0.9214814814814816,1,0,0,1,FALSE,FALSE,FALSE
336,2021-11-13T03:24:55Z,2021-11-13T03:55:09Z,1814,1,2021-11-13T03:55:10Z,1,Chrome,95.0.4638.69,Windows NT 10.0,1920,1080,No,1.7777777777777777,870,70,476,110,94,125,0.20760673389802156,-0.17991767851316898,0.23346859509119935,0.0660338372338302,0.30462282899249754,0.3314660526709267,2,2,3,3,1,3,1,1,1,2,2,1,1,2,2,1,1,1,1,1,0.7539370349250519,0,1,1,3,2,2.6,0,5,3,5,2,5,3,2,1,3,2,2,1,1,2,1,3,2,1,3,2,1,1,1,2,2,5,3,4,1,2,2,3,4,1,1,1,4,3,2,1,1,5,1,4,1,1,1,1,1,5,3,1,4,1,1,2,2,2,4,1,3,4,4,1,2,2,2,2,1.382538032537048,1.4573295865416045,1.75,0,2,0,3.2,0,3.888888888888889,0,2.75,0,3,0,1.7142857142857142,0,3,0,2.945945945945946,0,1,5,3,0.276926695294936,0.5356525945302133,1.3419714960501288,0.938812045290171,1,3,1,2,2,4,3,3,1,1.1126972805283737,3.4285714285714284,0,2,0.9188112583651991,2,2,2,3,1,1,3,5,3,3,2,0.816496580927726,2,0,4,5,3.8333333333333335,3.2559414990859232,0.38995568780511447,0,1.0556042520628854,3,2,3,2,2,2,5,3,2,2,1,3,5,3,2,1,3,1,1,4,1.3557637102737474,2.4,0,4,0,2.8,0,2.8,0,3.2,0,2,4,3,2,1,3,3,2,3,3,3,2,4,3,2,2,1,3,3,1,0.8885233166386386,2.7,0,Black or African American,0,18,1,2,NA,1,2,3,Unemployed,2,0,135,62,2,5,2,0,0,1,0,0,TRUE,TRUE,TRUE,TRUE,TRUE,5,1.3166717948730176,0.8125,0.21100681464062102,5,0.6335687500014902,0.6826499999999068,1,1,0.023986228669028574,0.012181708386689263,5,0.9313225806466033,1.5191066666662694,1,0.967741935483871,0.042511847807218325,0.2215342844519091,1.7878,0.8528,0.687,1.4303,1.0642,0.8953,0.4458,1.7524273806666666,0.8440210985666666,0.6718780987666667,3.6652,4.6579,0.2401,5.1163,0.3245,-47.1861,1.4418,3.9167,0.4433,5.8705,0.5576,0.9267,2.285705850333333,3.931703091,3.7317828973333333,0.3922041333333333,0.3218088937,1.9845,3.5997,0.6342,1.1986,0.8702,0.9954,0.181,0.309,0.229,0.005,1.943,388.6,3.371660373666667,3.5033447166666667,1.5836714545333332,0.4443395977333333,0.49858843313333334,340,1.0074074074074075,1,0,0,1,FALSE,FALSE,FALSE
337,2021-11-13T03:33:04Z,2021-11-13T03:55:30Z,1345,1,2021-11-13T03:55:30Z,1,Chrome,95.0.4638.69,Windows NT 10.0,1920,1080,Nope. Thank you giving me the opportunity to participate!,1.7777777777777777,656,54,308,72,78,85,-0.3422378078603068,-0.3252734915240852,-0.5753235794668308,-0.39704961105982484,0.08362987480298012,-0.34418861776319626,3,3,2,2,3,1,1,3,1,2,3,1,3,1,3,4,1,1,3,3,1.0052493799000692,0,1,1,3,4,1.7,0,4,5,2,4,1,1,4,2,1,1,1,4,1,4,4,1,2,1,1,1,1,3,2,0,2,0,0,5,5,5,4,5,5,4,5,5,1,5,2,1,4,1,5,2,2,1,2,2,5,1,1,1,1,1,1,1,1,1,5,1,1,1,1,1,1,1,1,1,1.8034001919297482,1.5491933384829668,1.5,0,1,0,1.5333333333333334,0,1.2222222222222223,0,1.5,0,0.8333333333333334,0,0.8571428571428571,0,1,0,1.2162162162162162,0,0,0,0,-0.9544819664200506,-1.0313811055606197,-0.7372407672780129,-0.8843109364193162,5,1,4,1,1,1,1,1,1,1.7320508075688772,1.1428571428571428,0,1,-0.8176513788914915,5,5,5,5,4,3,1,6,6,5,3,1.5275252316519468,4.571428571428571,0,1.4285714285714286,3,3.8333333333333335,3.2559414990859232,-0.7395711320441822,0,-0.9432371114476243,3,3,2,4,3,2,4,2,3,4,3,3,1,4,4,2,3,2,4,2,0.990430401872025,3,0,3.4,0,4.2,0,3.8,0,3.8,0,1,1,2,3,2,3,1,3,2,2,3,3,1,2,1,2,1,3,3,2,0.8255779474818965,1.95,0,"Hispanic of Latino (e.g., Mexican American, Central American, and others) & White, Caucasian, Anglo, European American",1,25,0,1,NA,1,4,6,Grad Student,6,0,170,70,2,5,2,0,0,1,0,0,TRUE,TRUE,TRUE,TRUE,TRUE,5,1.2583472222354677,0.72,0.3335454565581729,5,0.3876593750268221,0.45849687500298025,1,1,0.0014840270052027895,0.003989824183680032,5,0.5622906250059605,0.6238838709554364,1,0.96875,0.009648511842290626,0.0036831354434551157,1.6139,0.5766,0.6002,1.684,0.6264,0.534,0.0912,1.6244823363333334,0.6573033416033334,0.5873357262333333,3.6723,11.4033,0.2266,7.5299,0.2146,-106.2548,0.6401,6.7382,0.3408,5.6017,0.4022,0.946,1.5463991022333334,4.686104071666667,6.8211489783333334,0.29783832546666666,0.28160833836666666,0.9755,4.2277,0.4462,5.2426,0.5359,0.966,0.064,0.425,0.516,0.016,1.604,100.25,1.6757364052333332,4.08038729,4.160526949333334,0.3567850248666667,0.4368926778,272,0.8059259259259259,1,0,1,2,FALSE,FALSE,FALSE
338,2021-11-13T03:24:48Z,2021-11-13T03:58:23Z,2014,1,2021-11-13T03:58:24Z,0.8999999761581421,Chrome,95.0.4638.69,Windows NT 10.0,1920,1080,NA,1.7777777777777777,787,95,525,113,89,107,-0.005650728559647855,0.047200779316387595,0.4693663126706248,0.10259305683596086,0.23556253080827336,0.02742145097557139,3,3,1,2,3,1,2,2,1,3,2,1,1,2,3,3,1,1,2,2,0.8255779474818965,0,0,4,3,3,1.85,0,4,2,4,3,5,2,4,2,3,3,2,4,3,3,3,2,1,1,1,1,2,2,4,0,2,1,0,5,3,2,3,4,4,3,3,5,3,4,3,3,3,3,5,4,2,3,3,3,4,1,2,1,3,2,1,1,1,1,3,4,4,1,1,1,1,3,2,5,1.2562157768783506,0.9154754164341269,1.75,0,2.75,0,2.8666666666666667,0,2.4444444444444446,0,2.75,0,1.6666666666666667,0,2,0,1,0,2.27027027027027,0,0,1,0,-0.143349298464445,0.102032398334603,0.018200859335698566,0.06011662883515078,4,2,3,1,1,4,2,1,1,1.2724180205607036,2.142857142857143,0,1,-0.21938108280548152,5,5,5,5,2,2,1,6,6,NA,3,1.8126539343499315,4.142857142857143,0,1.8571428571428572,3,3.8333333333333335,3.2559414990859232,-0.7395711320441822,0,-0.7042241191833141,2,2,3,2,2,2,5,2,2,4,1,4,2,4,5,2,5,3,4,3,1.3201731488169053,2.2,0,4.2,0,4.2,0,4,0,4.133333333333334,0,3,1,2,3,3,2,4,3,3,2,1,2,4,3,2,3,2,2,2,4,0.8870412083230169,2.45,0,"White, Caucasian, Anglo, European American",0,19,1,2,NA,1,3,5,Cake decorator,4,0,225,66,1,5,2,0,0,1,0,0,TRUE,TRUE,TRUE,TRUE,TRUE,5,1.045263414603908,0.82,0.08452266601967862,5,0.6279812500029802,0.7442937499731779,1,1,0.012309263502842189,0.010997498677165395,5,0.7400781250298023,0.7649580644945945,1,1,0.009216111456349397,0.013139237176991041,1.4879,1.0704,0.6198,1.251,1.045,0.6962,0.1125,1.5125327946666667,1.0137968341333334,0.6070839229666667,1.7137,3.7681,0.4006,4.6433,0.5598,-63.1056,0.9824,2.6749,0.4867,4.884,0.6337,0.9297,2.254324709,4.547871910333333,4.257266307,0.49918630086666665,0.3613248148,0.9866,3.9098,0.6201,2.9769,0.6173,0.9805,0.115,0.521,0.537,0.074,1.658,22.405405405405407,2.612975169,5.114935541333334,4.336358717666666,0.4893196402666667,0.4695822594333333,310,0.9185185185185185,1,0,0,1,FALSE,FALSE,FALSE
339,2021-11-13T03:25:53Z,2021-11-13T03:59:13Z,2000,1,2021-11-13T03:59:14Z,1,Edge,95.0.1020.40,Windows NT 10.0,1280,720,n/a,1.7777777777777777,1051,64,416,129,74,137,0.6726621640767946,-0.23442610839226255,-0.05538575296523996,0.2975755613806577,0.028381636255600768,0.5341624538011636,4,3,1,1,3,1,1,4,1,4,3,1,1,1,3,3,1,1,2,2,1.190974832912761,1,1,4,4,3,1.45,0,4,5,3,4,3,2,4,2,2,1,1,4,4,4,4,2,3,1,1,2,1,1,2,1,2,0,0,5,5,5,5,5,5,5,5,5,2,5,2,2,5,2,4,2,2,4,4,4,4,1,1,1,2,2,1,1,1,1,5,2,2,1,2,1,2,1,1,1,1.6666666666666667,1.245945806357946,1.625,0,1.25,0,2.066666666666667,0,1,0,2.3333333333333335,0,1.3333333333333333,0,1.1428571428571428,0,1.3333333333333333,0,1.5945945945945945,0,1,0,0,-0.6413763510693116,-0.5858557120141032,-0.4557470907642554,-0.5208014013891793,5,2,3,2,1,1,2,3,1,1.3801311186847085,1.7142857142857142,0,2,-0.10679496349653231,5,5,5,5,3,2,2,7,3,3,3,1.4638501094227998,4.142857142857143,0,1.8571428571428572,4,3.8333333333333335,3.2559414990859232,-0.1748077221195339,0,-0.42184241422098995,2,2,2,2,2,2,5,2,2,4,1,5,1,5,5,1,4,4,4,2,1.5976172734359604,2,0,4,0,4.6,0,4.4,0,4.333333333333333,0,1,1,1,3,1,1,2,3,2,2,1,4,2,1,1,4,1,1,2,3,1.0399898784932577,1.45,0,"White, Caucasian, Anglo, European American",0,23,1,2,NA,1,2,6,Physical Therapy Tech,1,0,140,70,3,5,2,0,1,1,0,1,TRUE,TRUE,TRUE,TRUE,TRUE,3,0.8582837837934494,0.74,0.1079353474476834,3,0.45649999999230906,0.5220499999920527,1,0.9375,0.008825129333774091,0.0030308883459422473,3,0.6755290322803682,0.7234250000081957,1,1,0.0671040028004955,0.016536787741759092,1.4422,0.7497,0.3871,1.193,0.8939,0.5068,0.4064,1.461704522,0.80449235614,0.3821867344666667,1.3022,3.9203,0.2904,3.5576,0.3565,-63.8829,0.6843,4.3873,0.3864,5.4743,0.4645,0.9764,1.4030195437333333,3.695831863,4.152165717,0.3494287955666667,0.2848661772,1.404,3.6304,0.4512,3.1496,0.514,0.8707,0.159,0.316,0.495,0.022,1.84,83.63636363636364,2.042135040333333,3.2838790673333333,3.77772334,0.3588904295,0.4558044091333333,340,1.0074074074074075,1,0,0,1,FALSE,FALSE,FALSE
340,2021-11-13T03:39:02Z,2021-11-13T03:59:13Z,1211,1,2021-11-13T03:59:15Z,1,Firefox,94.0,Windows NT 10.0,2560,1440,NA,1.7777777777777777,555,64,304,64,61,86,-0.6017438766340972,-0.23442610839226255,-0.5945805360039267,-0.4945408633321733,-0.15117513902338214,-0.3272972510023432,2,2,3,1,1,3,3,1,1,1,1,1,1,3,1,1,3,4,2,1,1.0052493799000692,1,1,1,3,2,3,0,4,4,2,4,2,1,4,1,2,1,1,4,5,5,5,1,1,1,1,1,1,1,1,0,2,0,0,5,3,1,5,4,5,5,5,5,1,5,2,1,3,2,4,3,1,1,2,1,5,1,1,1,1,1,1,1,1,1,4,2,2,1,3,1,1,2,1,2,1.6430762915031365,1.6035674514745464,1,0,1.5,0,1.8,0,1.7777777777777777,0,1.6666666666666667,0,0.8333333333333334,0,1.2857142857142858,0,1.6666666666666667,0,1.5405405405405406,0,0,0,0,-1.0637537247974898,-0.9922778557251226,-0.5804383618435307,-0.7863581087843267,4,2,2,1,2,2,3,6,4,0.9511897312113419,2.2857142857142856,0,5,1.3420368014471913,4,4,4,4,2,2,2,3,1,2,2,1.0690449676496976,3.4285714285714284,0,2.5714285714285716,7,3.8333333333333335,3.2559414990859232,1.5194825076544112,0,0.8236576877731663,1,1,2,3,1,2,5,1,1,2,1,3,3,4,4,2,3,1,4,1,1.3557637102737474,1.6,0,4,0,3.6,0,4.6,0,4.066666666666666,0,1,4,3,1,3,4,2,2,4,3,2,1,4,4,1,1,1,4,2,4,1.2763022245616642,3.05,0,"Hispanic of Latino (e.g., Mexican American, Central American, and others) & White, Caucasian, Anglo, European American",1,25,0,4,"Currently identifying as male, but questioning. Thank you for having a text box option.",1,2,6,Currently unemployed 3D artist,3,0,190,72,2,5,2,0,0,1,0,0,TRUE,TRUE,TRUE,TRUE,TRUE,4,0.6190238095238095,0.84,0.023554284081632654,4,0.4048275862068966,0.4661034482758621,0.90625,0.90625,0.0013645806451612905,0.002611866935483871,4,0.46596875,0.5522333333333334,1,0.9375,0.0013620312500000006,0.0034865443548387095,1.0548,1.604,0.4014,1.0209,1.6847,0.4153,0.0126,1.1048516322666666,1.2832641232333333,0.3932377797666667,0.9138,3.0516,0.2801,3.0601,0.3391,-66.7114,0.4978,5.0152,0.3656,4.529,0.4216,0.9476,0.9921358456333333,3.3038506526666667,3.435101531,0.3344540454,0.2764982075,0.5833,6.8393,0.4251,4.319,0.4969,0.9855,0.066,0.363,0.688,0.025,2.114,84.55999999999999,1.1688695815,6.012390439,3.2834459516666668,0.37606871906666667,0.3880273903,386,1.1437037037037037,1,0,0,1,FALSE,FALSE,FALSE
342,2021-11-13T03:36:48Z,2021-11-13T04:01:44Z,1495,1,2021-11-13T04:01:45Z,1,Firefox,94.0,Windows NT 10.0,1920,1080,"All good, thank you!",1.7777777777777777,650,62,454,90,63,88,-0.3576540099656805,-0.2525955850186271,0.1275553341371716,-0.17769429344704088,-0.12355101974969247,-0.293514517480637,3,4,2,3,3,1,3,2,1,3,3,2,2,2,3,2,2,1,2,3,0.812727700887249,0,1,2,4,4,2.05,0,2,4,4,3,3,4,2,5,3,4,5,2,1,2,4,3,4,1,2,5,5,4,5,0,2,0,2,5,4,3,4,3,4,5,5,4,2,5,5,2,2,3,5,4,5,5,5,5,1,3,1,1,5,1,3,1,1,1,4,1,1,1,3,4,1,2,2,1,1.6075086575456083,1.2071217242444348,3.625,0,1.5,0,3.466666666666667,0,1.8888888888888888,0,3.5,0,2.5,0,1.2857142857142858,0,2.6666666666666665,0,2.5135135135135136,0,0,0,2,1.1742159419712153,1.2701935920588932,-0.22753906804516918,0.521327262006862,3,4,2,4,2,3,3,3,2,0.816496580927726,3.2857142857142856,0,2.5,1.017837910597246,4,3,5,5,1,1,2,6,3,1,2,1.7320508075688772,3.2857142857142856,0,2.7142857142857144,4.5,3.8333333333333335,3.2559414990859232,0.10757398284279028,0,0.19737442278879264,1,3,3,1,2,1,5,1,2,4,2,5,1,4,2,4,5,2,5,2,1.6035674514745464,2,0,4.6,0,4.2,0,3.8,0,4.2,0,1,1,3,4,3,2,3,3,2,2,2,2,3,2,3,2,1,2,3,4,0.8825799501580878,2.3,0,"White, Caucasian, Anglo, European American",0,30,0,1,NA,0,2,6,Fleet Coordinator,2,0,214,74,1,5,2,0,0,1,0,0,TRUE,TRUE,TRUE,TRUE,TRUE,4,0.9389,0.8333333333333334,0.21548596409574466,4,0.4424375,0.4929655172413793,1,0.9354838709677419,0.0014672217741935486,0.002757916129032258,4,0.5820625,0.646483870967742,1,1,0.01823025403225807,0.021981858064516125,1.6137,1.0268,0.4569,1.3855,1.4985,0.5302,0.3141,1.59510393,0.9804194833,0.4518462648666667,1.0183,4.9492,0.3396,4.4173,0.3895,-93.3494,0.7324,6.8096,0.3906,4.9427,0.4202,0.9586,1.1178539150333333,4.355680312,5.074485106666667,0.38084310033333335,0.3343065156666667,1.0183,3.0484,0.4469,5.6335,0.539,0.9972,0.227,0.147,0.526,0.015,1.237,82.46666666666668,2.0868663583333333,3.5505322986666665,3.728907624666667,0.28486548,0.36926210353333333,346,1.0251851851851852,1,0,1,2,FALSE,FALSE,FALSE
343,2021-11-13T03:27:35Z,2021-11-13T04:02:19Z,2084,1,2021-11-13T04:02:20Z,1,Chrome,84.0.4147.136,CrOS armv7l 13099.110.0,1280,800,Thank you for the surey. Excellent survey.,1.6,922,73,642,113,108,130,0.34121381881126023,-0.15266346357362218,1.0326322913806816,0.10259305683596086,0.49799166390832533,0.4159228864751921,3,3,1,3,3,1,1,3,1,3,3,1,1,1,4,4,1,1,3,3,1.1516578439248717,0,1,1,5,5,1.5,0,1,4,4,4,3,2,2,2,1,2,1,4,1,4,4,3,2,1,1,1,1,1,1,1,2,0,0,4,1,4,3,1,1,5,5,4,4,3,4,1,4,5,1,5,5,5,5,5,5,1,1,1,1,1,1,1,1,1,4,5,5,1,1,1,1,1,1,1,1.8129497474521423,1.2983506020002016,1.375,0,1,0,2.3333333333333335,0,2.888888888888889,0,4.083333333333333,0,0.8333333333333334,0,2.142857142857143,0,1,0,2.7027027027027026,0,1,0,0,-0.10762583899489758,-0.10248534152283549,-0.5341482934814965,-0.318316817502166,5,1,3,1,1,1,3,1,4,1.5735915849388864,1.5714285714285714,0,2.5,-0.007768311264485517,4,4,4,4,2,2,1,4,4,2,3,1.2909944487358056,3.5714285714285716,0,2.4285714285714284,5,3.8333333333333335,3.2559414990859232,0.38995568780511447,0,0.17922328042708108,1,1,1,3,2,1,5,3,3,5,2,4,3,3,3,3,5,3,2,4,1.162919151265879,1.6,0,4.2,0,3.6,0,2.8,0,3.533333333333333,0,3,1,4,3,4,2,2,3,1,1,1,2,4,1,2,2,1,1,3,1,1.1192102478745307,2.1,0,Black or African American,0,25,0,1,NA,1,4,3,marketing consultant,3,0,235,77,3,5,2,0,0,1,0,0,TRUE,TRUE,TRUE,TRUE,TRUE,3,0.924337105255721,0.76,0.03894705870500693,3,0.5539142187626567,0.6513481250076438,1,1,0.0051773305449158745,0.008283445332567098,3,0.6748404687677976,0.7356535483737506,1,0.96875,0.017078911337499118,0.010507762342368093,1.1704,1.012,0.6237,1.193,0.9752,0.621,0.1664,1.2429011358333333,0.9868818751666667,0.6105719188,4.8986,8.1556,0.2536,6.6318,0.282,-74.6852,0.9358,4.9876,0.4613,4.9062,0.5565,0.9666,2.248559439666667,4.307772258,5.4701798183333334,0.3928220107666667,0.35185901636666667,0.9295,3.228,0.54990000000000006,3.5403,0.6143,0.8741,0.077,0.452,0.39,0.01,1.424,142.39999999999998,1.9982032826666667,3.751281651333333,3.591064814666667,0.40627713183333336,0.47113351423333333,410,1.2148148148148148,1,0,0,1,FALSE,FALSE,FALSE
344,2021-11-13T03:44:04Z,2021-11-13T04:05:52Z,1307,1,2021-11-13T04:05:53Z,1,Chrome,95.0.4638.69,Windows NT 10.0,1536,864,Thank you too,1.7777777777777777,647,50,345,74,53,72,-0.36536211101836735,-0.36161244477681426,-0.39719673149869317,-0.37267679799173775,-0.2616716161181409,-0.5637763856542862,4,4,2,2,4,1,2,4,1,4,3,1,1,1,4,4,2,1,4,4,1.348488432516786,0,1,1,5,5,1.25,0,1,4,5,4,2,1,5,1,2,1,1,5,3,5,5,5,3,1,1,5,1,1,5,4,2,0,0,5,1,5,4,3,3,3,4,3,2,1,1,1,3,1,4,4,3,2,4,2,5,1,1,1,3,1,1,3,3,4,4,2,2,3,2,1,1,3,2,2,1.322024110123468,1.7728105208558367,2.75,0,2,0,1.9333333333333333,0,2.5555555555555554,0,2.5,0,1.1666666666666667,0,2.2857142857142856,0,2,0,2.27027027027027,0,2,0,0,0.4786591722994391,0.13068230415467,-0.01745100881601569,0.056615647669327154,5,1,1,3,1,1,1,1,1,1.5735915849388864,1.8571428571428572,0,1,-0.39031545311577004,3,3,3,3,1,1,3,1,1,1,2,0.9759000729485332,2.4285714285714284,0,3.5714285714285716,8,3.8333333333333335,3.2559414990859232,2.0842459175790595,0,1.6637363746855478,4,3,4,1,1,2,3,2,1,1,1,2,1,1,3,1,3,1,5,1,1.1872336794093274,2.6,0,3.8,0,3.8,0,3.6,0,3.7333333333333334,0,1,1,1,4,1,1,2,3,1,1,2,4,2,1,1,3,1,1,1,2,1.0310954828418375,1.3,0,"Asian or Asian American (e.g., Chinese, Japanese, and others)",0,20,0,1,NA,1,2,3,student,1,0,124,67,1,5,2,0,0,1,0,0,TRUE,TRUE,TRUE,TRUE,TRUE,3,0.7949186046518558,0.8775510204081632,0.04695125916670925,3,0.4071928571436022,0.47006206896541447,0.9655172413793104,0.90625,0.003236148817703363,0.005961934022035426,3,0.5390093750013039,0.6145468749995343,1,1,0.01170526087732522,0.00790800128019147,1.58,1.4514,0.4109,1.0651,1.4976,0.5849,0.1774,1.533965408,1.2316877962333332,0.40732753153333334,1.0314,4.2546,0.2916,2.2632,0.2718,-56.4073,0.8105,5.2875,0.3317,4.0449,0.381,0.8522,1.1050010739333334,2.547921801933333,4.409092956333334,0.26863978353333334,0.2864287030666667,0.713,3.4643,0.4694,4.8954,0.5548,0.9841,0.308,0.078,0.668,0.013,1.361,104.6923076923077,2.290829120666667,4.186652288333334,4.408277725,0.2663051606333333,0.36057739176666664,104,0.3081481481481481,1,1,1,2,FALSE,FALSE,FALSE
345,2021-11-13T03:44:00Z,2021-11-13T04:06:37Z,1356,1,2021-11-13T04:06:39Z,1,Edge,95.0.1020.44,Windows NT 10.0,1536,864,thanks for having me!,1.7777777777777777,687,69,307,67,51,98,-0.26258743031587606,-0.18900241682635124,-0.5801378186011047,-0.45798164373004263,-0.28929573539183057,-0.12460084987210628,4,4,1,2,2,1,1,4,1,3,3,1,1,1,4,4,2,1,2,3,1.2513150976809202,0,1,3,3,2,1.45,0,5,5,1,5,1,1,5,1,1,1,1,5,1,5,5,1,1,1,1,1,1,1,1,1,2,0,0,5,5,5,5,5,5,5,5,5,1,5,1,1,5,1,5,1,1,1,1,1,5,1,1,1,1,1,1,1,1,1,5,1,1,1,1,1,1,1,1,1,1.9666895707934864,2.065591117977289,1,0,1,0,1,0,1,0,1,0,0.8333333333333334,0,0.8571428571428571,0,1,0,1,0,1,0,0,-1.3999745198049947,-1.568373259242148,-0.5341482934814965,-1.0512607763618222,5,1,4,1,1,1,1,1,1,1.7320508075688772,1.1428571428571428,0,1,-0.8176513788914915,5,5,5,5,3,3,2,3,3,NA,3,1.2909944487358056,4.285714285714286,0,1.7142857142857142,6,3.8333333333333335,3.2559414990859232,0.9547190977297628,0,0.06324999828222155,1,1,1,3,3,3,3,3,3,1,1,4,1,3,4,2,4,1,3,4,1.1751393027860062,1.8,0,4.2,0,3.2,0,3,0,3.466666666666667,0,2,2,2,2,2,3,2,3,1,2,2,2,2,3,1,3,1,2,2,1,0.6488856845230502,2,0,"White, Caucasian, Anglo, European American",0,25,0,1,NA,1,3,3,Customer service,7,0,185,71,3,5,2,0,0,1,0,0,TRUE,TRUE,TRUE,TRUE,TRUE,4,0.9698625000044704,0.64,0.12312368635075824,4,0.4586379310385934,0.5531812499985099,0.9354838709677419,1,0.010034411849764346,0.010191947380106774,4,0.7676806451601367,0.90884375,1,1,0.17732693295419416,0.08392329157176032,1.5026,0.3983,0.5195,1.2575,0.3125,0.6566,0.4503,1.523107649,0.5465905150533333,0.5104043729666666,1.2766,2.9304,0.2625,3.5397,0.3729,-52.9825,0.9663,3.5212,0.3231,4.1146,0.4346,0.9572,1.3836374999666667,3.6956020683333333,3.256900208333333,0.3648787815,0.2573183826666667,1.4092,3.0419,0.4764,2.5626,0.5923,0.8117,0.108,0.421,0.372,0.008,1.453,181.625,2.2014300246666667,2.680885774,2.7275914913333335,0.34385152346666664,0.49935933346666667,347,1.028148148148148,1,0,0,1,FALSE,FALSE,FALSE
346,2021-11-13T03:38:27Z,2021-11-13T04:09:25Z,1857,1,2021-11-13T04:09:27Z,1,Chrome,95.0.4638.69,Windows NT 10.0,1920,1080,Nope it was a very solid survey!,1.7777777777777777,955,64,493,68,48,77,0.4260029303908155,-0.23442610839226255,0.3153106603738572,-0.44579523719599906,-0.3307319143023651,-0.47931955185002084,4,4,2,2,2,1,1,3,1,3,4,2,1,4,3,3,1,2,4,1,1.187655806953123,0,1,1,3,3,1.8,0,4,5,1,5,1,1,3,1,1,1,1,5,3,4,5,3,1,2,1,3,2,3,3,4,2,1,0,5,1,3,5,5,5,2,2,2,1,5,1,1,3,2,5,2,2,3,2,2,1,4,2,3,2,3,1,1,1,1,5,1,3,1,3,1,2,2,2,2,1.464802254792655,1.791514389985135,2.25,0,2,0,1.4,0,2.6666666666666665,0,1.75,0,3,0,1.1428571428571428,0,1.6666666666666667,0,2.108108108108108,0,2,1,0,0.06678869841524551,-0.3830801961592365,0.18918219877700804,-0.09694899869111423,5,1,3,1,1,1,1,3,3,1.5735915849388864,1.2857142857142858,0,3,0.005791155812417015,5,5,5,5,4,4,2,3,1,2,1,1.1126972805283737,4.571428571428571,0,1.4285714285714286,7,3.8333333333333335,3.2559414990859232,1.5194825076544112,0,0.18628970840167225,5,5,5,5,5,5,3,4,5,1,1,5,5,3,2,5,5,3,3,5,1.4960264830861913,5,0,3.8,0,1.8,0,1.8,0,2.466666666666667,0,3,2,4,4,2,3,1,3,1,3,2,2,3,4,4,4,3,2,2,4,1.0052493799000692,2.5,0,"White, Caucasian, Anglo, European American",0,25,0,1,NA,1,2,4,Self employed,3,0,210,74,2,5,2,0,0,1,0,0,TRUE,TRUE,TRUE,TRUE,TRUE,NA,NA,NA,NA,6,0.41782500000018624,0.47691562499990686,0.8571428571428571,1,0.007047352209008952,0.002107746522211119,6,0.6271062499994878,0.7490214285712157,1,0.9032258064516129,0.03685202899170853,0.034510305118299944,NA,NA,NA,NA,NA,NA,NA,NA,NA,NA,1.0183,2.163,0.2308,4.8713,0.3724,-65.9615,0.7825,2.9067,0.3091,6.1222,0.4176,0.9632,1.0834891991666666,4.750009987,2.5800884554666665,0.3671214817,0.22796232243333334,1.1297,3.8656,0.4625,2.5598,0.5529,0.8178,0.076,0.37,0.314,0.008,1.552,194,1.6080587293333333,3.0482366246666666,2.063444435,0.3545932072333333,0.3992066515,224,0.6637037037037037,1,0,1,2,FALSE,FALSE,FALSE
347,2021-11-13T03:47:45Z,2021-11-13T04:13:16Z,1531,1,2021-11-13T04:13:17Z,1,Chrome,94.0.4606.61,Macintosh,1440,900,no,1.6,900,48,329,83,40,76,0.28468774442489003,-0.3797819214031788,-0.474224557647077,-0.26299913918534573,-0.4412283913971238,-0.4962109186108739,3,3,2,4,1,1,2,3,1,2,2,2,2,4,2,2,3,2,2,2,0.8506963092234007,0,1,1,1,1,2.55,0,4,4,2,4,2,1,4,2,2,1,2,3,2,3,3,2,4,1,1,1,2,2,1,3,2,0,0,5,3,4,4,5,3,4,3,3,2,4,2,1,2,2,5,3,2,1,2,2,4,1,1,1,3,1,1,3,3,3,4,2,2,1,1,1,1,2,1,1,1.28224184307959,1.0555973258234952,1.75,0,1.25,0,2.066666666666667,0,2.2222222222222223,0,2,0,1.3333333333333333,0,2.142857142857143,0,1,0,1.945945945945946,0,2,0,0,-0.3450817754689478,-0.3811443917119342,-0.25265461696773905,-0.3168995043398366,5,2,4,1,1,2,1,1,1,1.6035674514745464,1.4285714285714286,0,1,-0.6467170085812028,5,5,5,5,4,2,1,4,7,6,4,1.6761634196950514,4.428571428571429,0,1.5714285714285714,3.5,3.8333333333333335,3.2559414990859232,-0.4571894270818581,0,-0.7223752615450256,2,2,2,5,2,2,4,2,2,4,4,5,3,4,5,1,4,4,4,2,1.2344267996967353,2.6,0,3.4,0,4,0,4.2,0,3.8666666666666667,0,2,1,3,2,3,3,2,2,2,1,3,2,2,3,1,2,2,3,3,2,0.6958523739384593,2.4,0,"White, Caucasian, Anglo, European American",0,28,0,1,NA,1,3,6,Sr Business Analyst,4,0,235,72,2,5,2,0,0,0,0,0,TRUE,TRUE,TRUE,TRUE,TRUE,6,1.0252093750238418,0.64,0.47169251902833687,6,0.5030187499821186,0.5245533332824707,1,0.967741935483871,0.0042605996364145126,0.0027443997840810586,6,0.7084500000178814,0.8568518518695125,1,0.9,0.10712231483766002,0.12190705753669315,1.7635,0.3268,0.4296,1.5106,0.2281,0.5113,0.1725,1.7167594783333333,0.45207177032966667,0.43180546123333335,1.197,5.1498,0.3868,4.1469,0.3886,-85.1858,0.691,6.1518,0.4455,6.8894,0.477,0.962,1.3645062548333333,4.267393521,5.205316574,0.37662279573333335,0.3743487520666667,1.2039,2.924,0.4498,1.7658,0.544,0.7826,0.07,0.442,0.284,0.013,1.779,136.84615384615384,1.6686330546666666,2.757518947,1.6061230168333334,0.3937167286,0.3868578952,388,1.1496296296296296,1,0,0,1,FALSE,FALSE,FALSE
348,2021-11-13T03:49:54Z,2021-11-13T04:14:10Z,1456,1,2021-11-13T04:14:11Z,1,Chrome,95.0.4638.69,Windows NT 10.0,1920,1080,no,1.7777777777777777,699,64,404,100,63,78,-0.23175502610512866,-0.23442610839226255,-0.11315662257652782,-0.05583022810660534,-0.12355101974969247,-0.4624281850891678,3,2,2,2,2,2,2,1,1,2,1,2,1,2,1,1,1,1,1,1,0.6048053188292994,0,1,3,3,3,2.55,0,2,2,3,2,2,2,4,2,2,2,2,3,2,3,3,2,2,4,2,2,3,3,2,3,2,0,0,4,3,3,3,4,3,3,3,3,2,4,3,3,2,3,3,2,2,2,2,2,3,2,1,2,3,3,1,3,3,2,4,2,2,3,2,2,2,2,2,2,0.7583370458279584,0.6324555320336759,2.5,0,2,0,2.6666666666666665,0,2.7777777777777777,0,2.5,0,2.1666666666666665,0,2,0,2.3333333333333335,0,2.4594594594594597,0,2,0,0,0.440834332861095,0.41969790813683366,-0.01745100881601569,0.201123449660409,3,2,2,2,1,2,2,1,1,0.5773502691896257,2.2857142857142856,0,1,-0.1339138976503373,3,3,3,3,1,1,4,5,4,2,2,1.1338934190276817,2.2857142857142856,0,3.7142857142857144,4.5,3.8333333333333335,3.2559414990859232,0.10757398284279028,0,0.7550714047388498,2,2,3,2,2,2,3,3,2,2,3,3,3,3,4,4,4,3,3,3,0.6546536707079771,2.2,0,3.4,0,2.6,0,3.4,0,3.1333333333333333,0,2,1,3,1,2,3,3,1,3,2,3,1,2,3,1,1,1,2,2,3,0.8583950752789521,2.6,0,"White, Caucasian, Anglo, European American",0,28,0,1,NA,1,2,4,IT Analyst,3,0,200,70,2,5,2,0,0,1,0,0,TRUE,TRUE,TRUE,TRUE,TRUE,1,0.8877179487182353,0.78,0.04868439340407696,1,0.5527709677418874,0.6529968749999534,1,1,0.010181403462339606,0.00846959773183207,NA,NA,NA,NA,NA,NA,NA,1.2978,1.0247,0.5241,1.3025,1.0407,0.5281,0.0099,1.34491777,0.9904741543,0.5145248718333333,1.9353,5.4904,0.3765,4.7627,0.4498,-74.7245,0.9684,4.8117,0.4479,4.4841,0.5444,0.955,1.9581232486666666,4.4579550040000004,5.184664725,0.43666812103333336,0.3664958217,NA,NA,NA,NA,NA,NA,NA,NA,NA,NA,NA,NA,NA,NA,NA,NA,NA,104,0.3081481481481481,1,0,1,2,FALSE,FALSE,FALSE
349,2021-11-13T03:20:41Z,2021-11-13T04:14:15Z,3214,1,2021-11-13T04:14:17Z,1,Chrome,95.0.4638.69,Macintosh,1280,800,no,1.6,1203,390,530,66,69,103,1.0632059507462615,2.727198581705155,0.49343750834199473,-0.47016805026408615,-0.04067866192862343,-0.040144016067840904,3,3,2,1,3,1,2,2,1,3,2,1,1,1,2,2,1,1,2,2,0.7677718959499145,0,1,1,3,3,1.9,0,4,4,2,5,2,2,4,2,1,2,1,4,1,4,4,2,2,1,1,1,1,1,1,4,2,0,0,5,4,5,5,5,4,4,4,4,2,4,1,1,3,1,4,1,1,1,1,1,4,2,1,1,4,3,1,3,3,3,5,1,1,1,1,1,2,1,2,2,1.5716138106958624,1.3732131246511903,1.25,0,1.75,0,1.7333333333333334,0,1.5555555555555556,0,1.4166666666666667,0,2,0,1.7142857142857142,0,1,0,1.6216216216216217,0,2,0,0,-0.8578184878553927,-0.8786461346685052,-0.0958522115332568,-0.487249173100881,5,1,4,1,2,1,1,1,1,1.6761634196950514,1.2857142857142858,0,1,-0.7321841937363471,4,4,5,4,3,2,2,7,7,4,3,1.1338934190276817,3.7142857142857144,0,2.2857142857142856,2,3.8333333333333335,3.2559414990859232,-1.3043345419688306,0,-0.7475928318813282,1,1,1,1,1,1,4,2,4,3,1,4,2,4,2,1,3,2,4,2,1.1832159566199232,1,0,4.2,0,4,0,3.2,0,3.8,0,1,2,1,3,2,2,1,2,1,2,3,3,1,2,1,3,1,2,2,1,0.7677718959499145,1.7,0,"Asian or Asian American (e.g., Chinese, Japanese, and others)",0,20,1,2,NA,1,3,3,student,5,0,164,61,2,5,1,0,0,0,1,0,TRUE,TRUE,TRUE,TRUE,TRUE,NA,NA,NA,NA,2,0.5720200000047684,0.6325933333317438,1,0.967741935483871,0.027335914761841447,0.03105886531071951,2,1.009140625,1.117251612913224,1,1,0.24626421409370222,0.10253172458027279,NA,NA,NA,NA,NA,NA,NA,NA,NA,NA,1.2438,2.9391,0.3605,2.986,0.4328,-44.4691,1.3956,3.1396,0.3453,3.9818,0.4321,0.9974,1.4692535661666666,3.220243452666667,3.3274918786666667,0.40944213166666665,0.341649438,2.0943,2.4887,0.4728,2.549,0.689,0.6867,0.161,0.385,0.298,0.01,1.844,184.4,2.8160852783333334,2.310910321,2.5253206556666665,0.3810191173333333,0.5498808471333333,104,0.3081481481481481,1,0,0,1,FALSE,FALSE,FALSE
350,2021-11-13T03:33:31Z,2021-11-13T04:14:54Z,2483,1,2021-11-13T04:14:54Z,0.8999999761581421,Chrome,95.0.4638.69,Windows NT 10.0,1366,768,NA,1.7786458333333333,1742,59,250,55,35,126,2.4480947732123313,-0.2798497999581739,-0.8545494492547221,-0.6042185221385653,-0.510288689581348,0.3483574194317798,4,4,4,4,4,4,4,4,4,4,4,4,4,4,4,4,4,4,4,4,0,0,0,2,3,3,2.5,0,3,4,3,3,3,2,3,2,3,2,2,3,2,3,2,3,3,3,3,3,3,3,3,5,6,0,0,2,1,2,5,2,2,3,4,5,3,2,3,2,3,2,2,3,5,3,4,3,1,1,3,2,3,5,3,NA,3,5,3,4,3,5,5,5,1,1,1,1,1.259881576697424,0.6172133998483676,3,0,1,0,2.6666666666666665,0,3.111111111111111,0,3.25,0,3,0,3.3333333333333335,1,5,0,3.388888888888889,1,3,0,0,1.329951546325386,1.0339931860806149,-0.12796334588846375,0.4530149200960756,2,3,2,3,2,3,3,8,4,0.5345224838248488,3.142857142857143,0,6,2.223827587152439,3,2,3,2,3,2,3,5,5,4,3,0.5345224838248488,2.5714285714285716,0,3.4285714285714284,4,3.8333333333333335,3.2559414990859232,-0.1748077221195339,0,0.45453855741481414,5,5,5,5,5,5,4,5,4,5,5,5,4,5,3,4,2,4,2,3,1.0690449676496976,5,0,2.2,0,3,0,2.8,0,2.6666666666666665,0,2,3,3,1,1,1,1,1,1,1,1,1,1,1,1,1,1,1,1,1,0.6386663736585051,1.85,0,Black or African American,0,25,0,1,NA,1,3,5,NA,5,0,197,69,5,5,2,0,0,1,0,0,TRUE,TRUE,TRUE,TRUE,TRUE,6,0.7897533333331347,0.6382978723404256,0.09958438346851138,6,0.5398900000008444,0.6935612903227729,0.967741935483871,1,0.009327624516048707,0.018435866451875695,6,0.7046468749991618,0.7762838709683668,1,1,0.01375740063510177,0.010325664731174024,1.4089,0.4087,0.2644,1.4698,0.4795,0.2816,0.2585,1.425488509,0.5746310442004,0.26259725246666665,1.523,3.5275,0.3332,3.0569,0.4445,-45.2094,1.1942,5.9921,0.4324,2.8561,0.5037,0.9519,1.7370310033333334,3.264336473,3.8265203616666668,0.42354702476666667,0.31785094236666667,1.1663,3.0612,0.5431,4.2327,0.647,0.9575,0.211,0.389,0.665,0.017,1.523,89.58823529411764,3.1262673613333334,4.46824098,4.40462369,0.35635427836666667,0.426809306,316,0.9362962962962963,1,0,0,1,FALSE,FALSE,FALSE
351,2021-11-13T03:39:11Z,2021-11-13T04:16:35Z,2244,1,2021-11-13T04:16:36Z,1,Chrome,95.0.4638.69,Windows NT 6.3,1366,768,"This was fun!
",1.7786458333333333,772,88,717,135,84,166,-0.044191233823082085,-0.016392388875888245,1.3937002264512306,0.370694000584919,0.16650223262404917,1.0240120898659029,2,2,2,1,2,1,1,2,1,2,2,1,1,2,2,3,1,1,3,2,0.6569466853317864,0,1,1,3,3,2,0,5,5,3,3,4,3,3,3,2,1,2,4,2,4,3,2,1,1,2,1,1,1,1,2,2,0,0,4,3,2,3,3,4,3,3,3,2,4,1,1,4,2,1,5,2,1,1,1,5,1,1,1,3,1,2,2,1,1,3,3,3,1,1,1,2,1,1,1,1.2562157768783506,1.1254628677422756,1.25,0,1.25,0,2.3333333333333335,0,2.888888888888889,0,2.0833333333333335,0,1.1666666666666667,0,2,0,1,0,2.081081081081081,0,1,0,0,-0.5720308120990136,-0.42334492866311435,-0.4557470907642554,-0.43954600971368485,1,4,1,3,2,4,4,2,1,1.3801311186847085,3.857142857142857,0,1.5,0.990718976443441,4,3,4,4,1,1,3,NA,NA,2,1,1.3451854182690985,2.857142857142857,0,3.142857142857143,NA,3.8333333333333335,3.2559414990859232,NA,1,0.7652008472634154,2,3,1,2,1,2,3,2,2,1,2,5,2,4,5,2,5,1,2,5,1.505545305418162,1.8,0,4.6,0,2.8,0,3.6,0,3.6666666666666665,0,1,1,1,3,1,1,3,4,1,1,2,4,1,1,1,4,1,1,1,1,1.1742858972247996,1.2,0,"Hispanic of Latino (e.g., Mexican American, Central American, and others)",0,29,0,1,NA,1,2,3,English Tutor,1,0,240,65,2,5,2,0,0,3,0,0,TRUE,TRUE,TRUE,TRUE,TRUE,NA,NA,NA,NA,1,0.5024935483797904,0.6167562500033528,1,1,0.0016105252904474146,0.00646866834619745,1,0.731562500005588,0.726346875000745,1,1,0.02121335919185274,0.012824657410808458,NA,NA,NA,NA,NA,NA,NA,NA,NA,NA,4.2264,10.6019,0.3032,7.1606,0.3216,-93.8965,0.7064,6.0051,0.4514,5.7259,0.5505,0.9384,1.8361999498,4.744040585333333,6.348053174666667,0.4277050699666667,0.3643685470333333,0.8855,2.9015,0.6283,5.6252,0.6534,0.985,0.286,0.188,0.531,0.143,1.112,7.776223776223778,2.802836022666667,3.5734105123333335,4.152286318333333,0.33577643286666664,0.39353207003333335,400,1.1851851851851851,1,0,0,1,FALSE,FALSE,FALSE
352,2021-11-13T03:50:17Z,2021-11-13T04:17:20Z,1623,1,2021-11-13T04:17:21Z,0.800000011920929,Firefox,94.0,Windows NT 10.0,1920,1080,gg,1.7777777777777777,903,107,329,69,42,95,0.29239584547757685,0.15621763907457475,-0.474224557647077,-0.4336088306619555,-0.4136042721234341,-0.1752749501546655,2,2,1,2,2,1,2,2,2,2,2,2,2,2,2,2,2,2,2,2,0.30779350562554625,0,1,2,3,3,2.4,0,3,3,3,4,4,4,3,3,3,3,3,3,3,3,3,3,3,4,4,3,3,3,3,2,2,1,1,4,4,4,4,4,4,4,4,4,4,4,3,3,3,3,3,2,3,3,3,3,2,2,3,3,3,3,1,2,3,3,3,2,2,3,3,3,2,2,2,3,0.7593263966019992,0.4140393356054125,3.25,0,2.25,0,3.066666666666667,0,2,0,2.9166666666666665,0,2.8333333333333335,0,2.142857142857143,0,3,0,2.5945945945945947,0,1,1,1,0.9913958846858842,0.9719829169520463,0.2409405745969135,0.6064617457744799,3,2,3,3,2,4,4,3,2,0.816496580927726,3,0,2.5,0.8469035402869574,3,3,3,3,2,2,3,7,7,3,3,0.4879500364742666,2.7142857142857144,0,3.2857142857142856,2,3.8333333333333335,3.2559414990859232,-1.3043345419688306,0,-0.189895849931271,2,2,4,4,4,2,4,2,2,4,2,2,2,4,4,3,4,4,4,4,0.990430401872025,3.2,0,3.2,0,3.8,0,3.6,0,3.533333333333333,0,2,2,2,3,3,3,3,3,2,3,3,3,3,3,2,2,2,2,3,3,0.5026246899500346,2.5,0,"Hispanic of Latino (e.g., Mexican American, Central American, and others) & White, Caucasian, Anglo, European American",1,22,0,1,NA,1,2,4,Growing Plants,4,0,150,73,4,5,2,0,0,0,0,0,TRUE,TRUE,TRUE,TRUE,TRUE,3,0.6629166666666667,0.7346938775510204,0.11049280272108841,3,0.5334333333333333,0.6256,1,0.967741935483871,0.06820066781609196,0.030240073118279573,3,0.5719354838709677,0.6823793103448276,0.96875,0.9354838709677419,0.013252705645161289,0.02235796559139785,1.2971,0.8009,0.3195,0.998,0.9151,0.4313,0.2966,1.33557619,0.8519475381,0.3136910041666667,1.4327,2.8193,0.2793,2.7769,0.3788,-34.2807,1.3762,4.1414,0.3167,4.834,0.4578,0.9329,1.540371702,2.9492446973333335,3.105584928,0.3685919907333333,0.2733963040333333,1.4124,5.7131,0.4396,4.7797,0.518,0.9897,0.074,0.372,0.374,0.01,1.496,149.6,1.7168167213333334,3.1363264186666666,2.2008651908,0.30206688956666666,0.31031984543333335,104,0.3081481481481481,1,1,0,1,FALSE,FALSE,FALSE
353,2021-11-13T03:56:55Z,2021-11-13T04:20:33Z,1417,1,2021-11-13T04:20:34Z,1,Edge,95.0.1020.44,Windows NT 10.0,1920,1080,NA,1.7777777777777777,627,50,443,100,38,83,-0.41674945136961294,-0.36161244477681426,0.07459870366015774,-0.05583022810660534,-0.46885251067081346,-0.3779713512849024,4,4,1,1,4,1,1,3,1,4,3,1,1,1,4,3,1,1,3,3,1.332784974957958,0,1,1,4,3,1.25,0,5,5,1,5,1,1,5,1,1,1,1,5,1,5,5,1,3,3,1,1,1,1,1,0,2,1,0,5,5,5,5,5,5,2,4,5,1,5,1,1,5,1,5,1,1,1,1,1,3,1,1,1,2,1,1,1,1,1,5,1,1,1,1,1,1,1,1,1,1.8310796959315705,2.065591117977289,1.5,0,1,0,1,0,1.4444444444444444,0,1,0,1.3333333333333333,0,0.8571428571428571,0,1,0,1.1891891891891893,0,0,1,0,-0.9712930061704257,-1.2721951788049675,-0.5306075596849892,-0.9014013692449783,5,1,2,1,1,1,1,3,2,1.4960264830861913,1.4285714285714286,0,2.5,-0.09323549641962975,5,5,5,5,2,2,1,5,5,2,3,1.8126539343499315,4.142857142857143,0,1.8571428571428572,4,3.8333333333333335,3.2559414990859232,-0.1748077221195339,0,-0.42184241422098995,1,1,1,1,1,1,4,1,1,3,2,4,1,5,5,2,5,2,4,3,1.5522640914238175,1,0,4.4,0,4,0,4.6,0,4.333333333333333,0,1,1,1,4,1,1,1,4,1,1,1,4,1,1,1,4,1,1,1,1,1.231174022502185,1,0,"White, Caucasian, Anglo, European American",0,19,0,1,NA,1,4,4,Student,4,0,210,70,2,5,2,0,0,1,0,0,TRUE,TRUE,TRUE,TRUE,TRUE,5,0.6974714285717124,0.84,0.05447185724588709,5,0.30983437499962746,0.38049032257449245,1,0.96875,0.0012626565221512203,0.0016637970865659203,5,0.4367312499973923,0.5085833333353201,1,0.9375,0.00237001447602435,0.004618981128331366,1.2636,1.341,0.3938,1.1568,1.3476,0.4244,0.0675,1.2988705957333333,1.1752244815666666,0.3860540385333333,1.2271,7.8287,0.2315,4.902,0.2605,-110.7997,0.6074,7.8242,0.2717,6.8099,0.3359,0.7527,1.1051444516,4.3991545473333336,6.508505548333333,0.2632440552,0.23154878713333332,0.6411,5.8446,0.3874,4.3847,0.4502,0.9843,0.054,0.346,0.618,0.016,1.558,97.375,1.4484421978333333,4.9638094803333335,3.4720900353333333,0.2947804193333333,0.3184747117,312,0.9244444444444444,1,0,0,1,FALSE,FALSE,FALSE
354,2021-11-13T03:57:24Z,2021-11-13T04:22:56Z,1532,1,2021-11-13T04:22:57Z,0.8999999761581421,Chrome,95.0.4638.69,Windows NT 10.0,1920,1080,n/a,1.7777777777777777,702,63,435,113,75,81,-0.22404692505244184,-0.24351084670544482,0.03608479058596582,0.10259305683596086,0.04219369589244561,-0.4117540848066085,3,3,2,2,3,1,1,3,1,3,2,1,2,2,3,3,1,1,3,3,0.8750939799154206,0,1,1,3,3,1.75,0,4,4,4,3,3,3,2,3,2,3,2,3,2,4,3,2,3,1,1,3,4,3,3,1,2,0,0,4,3,3,4,4,5,3,3,4,3,5,2,1,4,2,5,4,3,2,2,2,3,1,1,1,3,1,2,2,3,1,3,2,3,1,4,2,2,2,1,2,1.2167499662956562,0.7559289460184544,2.5,0,1.75,0,2.7333333333333334,0,2.3333333333333335,0,2.0833333333333335,0,1.5,0,2.142857142857143,0,2.3333333333333335,0,2.135135135135135,0,1,0,0,0.23910185585659188,0.3089698937511685,-0.2989446853297732,0.005012604210697658,4,2,3,1,1,2,3,1,1,1.1126972805283737,2,0,1,-0.3048482679606258,3,4,4,3,1,1,4,4,3,2,2,1.3451854182690985,2.5714285714285716,0,3.4285714285714284,5.5,3.8333333333333335,3.2559414990859232,0.6723373927674386,0,0.8781111148583004,2,3,3,3,2,3,4,4,2,4,4,3,2,4,4,2,3,2,4,3,0.8618916073713346,2.6,0,3,0,4,0,3.4,0,3.466666666666667,0,2,4,3,2,4,4,4,3,2,1,3,2,2,3,1,3,1,2,2,3,0.998683343734455,2.55,0,"White, Caucasian, Anglo, European American",0,26,0,1,NA,1,3,7,Accountant,5,0,175,69,1,5,2,0,0,2,0,0,TRUE,TRUE,TRUE,TRUE,TRUE,3,0.8578695652173913,0.92,0.12960723135716704,3,0.46417741935291595,0.5328718750011175,0.96875,1,0.002853454153378145,0.0028615098286394022,3,0.6221656249966472,0.6628937499895692,1,1,0.010037620394636964,0.008130914151539593,1.6461,1.5034,0.3827,1.7198,1.5757,0.3653,0.2036,1.5734359956666666,1.2755958515333334,0.38328398906666666,1.2738,5.0637,0.3448,4.8226,0.4008,-89.2511,0.7323,6.0539,0.4045,5.779,0.4753,0.9562,1.3715916082333333,4.750090090333333,5.006033599,0.3927532857666667,0.33593332623333333,0.9293,3.6971,0.5059,3.8562,0.564,0.8644,0.2,0.273,0.581,0.021,1.362,64.85714285714286,2.4844672543333335,4.696548584,4.215203596,0.36067827766666666,0.3732484632333333,517,1.5318518518518518,1,0,0,1,FALSE,FALSE,FALSE
355,2021-11-13T03:39:39Z,2021-11-13T04:31:16Z,3097,1,2021-11-13T04:31:19Z,1,Firefox,94.0,Windows NT 10.0,1536,864,No,1.7777777777777777,1003,169,1275,198,115,243,0.5493325472338051,0.719471414491875,4.080045663376116,1.1384376122296629,0.5946760813662392,2.3246473304515893,4,4,1,1,3,1,1,4,1,4,4,1,1,1,4,3,1,1,3,3,1.3803127029389886,0,1,1,4,4,1.2,0,1,5,2,4,2,1,5,1,2,2,1,5,3,5,4,1,1,1,1,1,1,1,1,0,2,0,0,4,4,4,4,4,4,4,4,4,2,4,2,2,4,2,5,1,1,2,1,1,5,1,1,1,2,1,2,1,2,1,5,1,1,1,1,1,1,1,1,1,1.4821257357919053,1.6417180315870614,1,0,1,0,1.8,0,2,0,1.5833333333333333,0,1,0,1.1428571428571428,0,1,0,1.5135135135135136,0,0,0,0,-1.0805647645478649,-1.0038926824089338,-0.7372407672780129,-0.8705667248434734,5,1,3,1,1,1,2,3,1,1.5275252316519468,1.4285714285714286,0,2,-0.2777293338068208,4,5,4,5,4,4,2,6,6,4,3,1,4.285714285714286,0,1.7142857142857142,3,3.8333333333333335,3.2559414990859232,-0.7395711320441822,0,-0.783895116604751,1,1,1,1,1,1,3,2,1,3,1,4,1,4,5,1,5,2,3,4,1.4960264830861913,1,0,4.6,0,3.8,0,4,0,4.133333333333334,0,1,1,1,4,1,1,1,4,1,1,2,4,1,1,1,4,1,1,1,1,1.2258187382102494,1.05,0,Middle Eastern,0,29,0,1,NA,0,3,6,Computer engineer,5,0,225,74,2,5,2,0,0,1,0,0,TRUE,TRUE,TRUE,TRUE,TRUE,6,1.74965625,0.64,0.3265709914285715,6,0.8350344827586207,0.9238064516129032,0.9354838709677419,0.96875,0.013129049462365589,0.01075456451612903,6,1.030125,1.15396875,1,1,0.006217790322580645,0.009228998991935487,1.9716,0.3036,0.8825,1.9274,0.2456,0.9371,0.2035,1.9348357363333333,0.3998563176898,0.8380601511333333,1.4508,1.968,0.4969,3.5849,0.7302,-31.2359,0.977,3.2783,0.7117,3.8471,0.8039,0.9723,2.1903374743333335,3.2107418163333334,2.5134137316666667,0.5918694703666667,0.4177723541666667,0.9382,4.608,0.9442,3.2148,1.0388,0.8098,0.429,0.484,0.77,0.011,1.388,126.18181818181819,4.527091715,5.188422079666666,4.421478564,0.5955774671666667,0.6436079565333334,289,0.8562962962962963,1,0,0,1,FALSE,FALSE,FALSE
356,2021-11-13T04:06:53Z,2021-11-13T04:33:05Z,1572,1,2021-11-13T04:33:06Z,1,Chrome,95.0.4638.69,Windows NT 6.3,1440,960,NA,1.5,709,85,429,125,67,106,-0.20606135592950586,-0.04364660381543503,0.007199355780321893,0.24882993524448352,-0.06830278120231312,0.010530084214718316,3,4,1,1,3,1,1,2,1,3,2,1,1,1,3,2,1,1,3,2,0.9880869341680844,0,1,2,2,2,1.65,0,4,4,3,4,2,3,2,3,2,3,2,3,2,3,4,1,1,1,1,1,2,2,2,5,2,0,0,4,4,5,5,3,5,4,4,5,2,5,1,1,4,1,5,2,1,1,2,1,4,1,3,1,3,1,1,3,3,1,4,1,1,1,1,1,1,1,2,2,1.590606811889736,0.7988086367179802,1.375,0,1.5,0,2.533333333333333,0,1.6666666666666667,0,1.3333333333333333,0,1.6666666666666667,0,1.5714285714285714,0,1,0,1.5405405405405406,0,3,0,0,-0.8305005482610333,-0.5159731714665071,0.028839059546018453,-0.24356705596024433,5,1,3,1,1,2,2,4,1,1.4638501094227998,1.5714285714285714,0,2.5,-0.007768311264485517,4,5,5,5,2,2,2,6,5,4,3,1.5118578920369088,3.857142857142857,0,2.142857142857143,3.5,3.8333333333333335,3.2559414990859232,-0.4571894270818581,0,-0.40369127185927867,2,3,2,2,2,3,3,3,1,3,3,3,2,4,4,2,4,3,3,4,0.8451542547285166,2.2,0,3.2,0,3.4,0,3.6,0,3.4,0,2,1,2,3,3,3,3,2,1,1,2,3,2,1,1,2,1,3,1,3,0.8583950752789521,2,0,"White, Caucasian, Anglo, European American",0,26,0,1,NA,1,3,4,Student,1,0,315,72,2,5,2,0,0,1,0,0,TRUE,TRUE,TRUE,TRUE,TRUE,1,0.8985999999962202,0.82,0.05759747035006367,1,0.5285749999973923,0.5999413793169219,1,0.9354838709677419,0.0027609258061179237,0.004658719785375593,1,0.6537343749981374,0.743215624999255,1,1,0.00405711974779473,0.01015490781280612,1.3712,1.1402,0.5408,1.224,1.073,0.606,0.3024,1.407811811,1.0619327555666667,0.5305113781666667,1.4131,5.4662,0.3993,3.1016,0.3996,-69.6432,0.7906,5.3806,0.4607,4.0542,0.5175,0.939,1.5475579364333334,3.2916231193333334,5.360312543666667,0.38914235173333334,0.3873170347,1.1035,5.6108,0.561,3.3883,0.5924,0.973,0.078,0.522,0.54,0.032,2.089,65.28125,2.6013223526666667,5.778789673666667,4.579094257666666,0.4354291057,0.46549956476666665,104,0.3081481481481481,1,1,0,1,FALSE,FALSE,FALSE
357,2021-11-13T04:10:22Z,2021-11-13T04:34:00Z,1417,1,2021-11-13T04:34:01Z,1,Chrome,95.0.4638.69,Macintosh,1680,1050,NA,1.6,622,51,396,155,55,66,-0.42959628645742437,-0.35252770646363196,-0.15167053565071972,0.6144221312657902,-0.2340474968444512,-0.6651245862194046,3,4,2,2,3,1,4,2,1,3,2,3,1,1,2,3,2,2,2,3,0.9233805168766387,0,1,1,4,4,2.1,0,5,5,1,5,1,1,3,2,2,1,4,4,2,4,5,2,4,4,1,1,2,1,1,0,2,0,0,5,5,5,5,5,5,5,5,5,1,5,1,1,4,1,5,1,3,3,3,4,3,1,1,1,1,1,1,1,1,1,5,2,2,1,1,1,1,1,1,1,1.8050646133194952,1.647508942095828,2,0,1,0,1.6666666666666667,0,1,0,1.8333333333333333,0,1.1666666666666667,0,1.1428571428571428,0,1,0,1.3783783783783783,0,0,0,0,-0.5426114925358573,-0.6895180401671162,-0.7372407672780129,-0.7133794037225645,5,1,5,1,1,2,1,1,1,1.889822365046136,1.1428571428571428,0,1,-0.8176513788914915,5,5,5,5,3,3,1,8,8,4,3,1.5735915849388864,4.428571428571429,0,1.5714285714285714,1,3.8333333333333335,3.2559414990859232,-1.869097951893479,0,-1.428329523950836,2,1,2,1,2,1,5,1,1,4,1,4,1,4,5,1,4,1,4,3,1.6761634196950514,1.6,0,4.6,0,4.6,0,4.4,0,4.533333333333333,0,2,1,1,4,2,1,2,2,2,1,2,3,2,3,2,2,1,1,1,2,0.812727700887249,1.75,0,"White, Caucasian, Anglo, European American",0,24,0,1,NA,1,4,6,Student,4,0,130,69,3,5,2,0,0,1,0,0,TRUE,TRUE,TRUE,TRUE,TRUE,6,0.7071487179474953,0.78,0.048822708319217985,6,0.46639375000447036,0.5546354838801969,1,0.96875,0.01036011479551198,0.015352493140375767,6,0.8183387096620375,0.7691870967495826,1,0.96875,0.24622727242910555,0.043232969630467806,1.297,1.0405,0.3411,1.0477,1.4843,0.45,0.2475,1.3347308813333334,1.0022551411333334,0.3345321093,1.4057,4.2384,0.3006,2.7201,0.3067,-53.438,1.1017,4.2023,0.3306,3.5074,0.4015,0.9867,1.4823965017,2.916591723,4.356262453666667,0.3036680235,0.2948418937,1.7309,1.9747,0.3291,2.901,0.4547,0.7612,0.089,0.374,0.22,0.032,1.738,54.3125,1.9293493,2.0764035152,2.492480415,0.3299435984333333,0.38909303613333335,408,1.208888888888889,1,0,1,2,FALSE,FALSE,FALSE
358,2021-11-13T04:13:28Z,2021-11-13T04:36:21Z,1373,1,2021-11-13T04:36:22Z,1,Edge,95.0.1020.44,Windows NT 10.0,1920,1080,nope,1.7777777777777777,681,64,329,73,57,83,-0.27800363242124976,-0.23442610839226255,-0.474224557647077,-0.38486320452578127,-0.2064233775707615,-0.3779713512849024,4,4,1,1,4,1,2,3,1,4,4,2,1,2,4,4,2,1,3,4,1.3138933706635727,0,1,1,4,4,1.3,0,3,3,4,4,3,4,4,2,2,2,2,5,3,4,4,3,3,5,3,2,2,3,2,3,2,0,0,4,4,4,5,5,5,4,5,5,2,3,2,1,5,2,5,3,3,3,2,4,3,1,4,2,4,4,2,2,2,3,4,2,2,2,2,1,2,3,4,4,1.2944789205219511,0.9611501047232549,2.875,0,3.25,0,2.466666666666667,0,1.4444444444444444,0,2.25,0,2.8333333333333335,0,2,0,1.6666666666666667,0,2.108108108108108,0,2,0,0,0.4555439926426731,0.3439111640249665,0.3745550047701899,0.3592330843975782,2,3,4,3,3,3,4,4,2,0.6900655593423543,3.142857142857143,0,3,1.1168645628292926,4,4,4,4,2,2,2,6,3,2,2,1.0690449676496976,3.4285714285714284,0,2.5714285714285716,4.5,3.8333333333333335,3.2559414990859232,0.10757398284279028,0,0.11770342536735592,4,3,4,3,3,3,4,3,2,3,2,4,2,3,3,3,4,3,3,3,0.6546536707079771,3.4,0,3.6,0,3.4,0,3.2,0,3.4,0,1,1,1,4,2,2,1,3,1,1,2,3,2,2,1,3,1,2,2,2,0.8750939799154206,1.55,0,"White, Caucasian, Anglo, European American",0,30,0,1,NA,1,3,4,unemployed,3,0,215,73,3,5,2,0,0,1,0,0,TRUE,TRUE,TRUE,TRUE,TRUE,2,1.1917684210507493,0.76,0.18801290782149493,2,0.48814193548646667,0.4944781250008382,1,1,0.004829711849401184,0.0024876075706578064,2,0.6280687499986961,0.6819750000000931,1,1,0.009842872540121936,0.009728854838567707,1.8817,0.6575,0.4507,1.5328,0.7131,0.6507,0.1726,1.7969620956666668,0.6925629473666667,0.4518456269,5.4857,8.7862,0.176,10.091,0.2227,-92.6478,0.9329,4.7351,0.3965,7.9685,0.4399,0.7201,1.8064710716,5.600691676666667,5.200570211666666,0.3403901279666667,0.3171371067666667,1.0479,4.5347,0.5048,3.0021,0.5372,0.9516,0.127,0.391,0.563,0.027,1.8,66.66666666666667,2.0964630603333334,4.85356556,4.290102731666667,0.4160276328333333,0.4435308386333333,314,0.9303703703703704,1,0,0,1,FALSE,FALSE,FALSE
359,2021-11-13T04:20:27Z,2021-11-13T04:40:27Z,1199,1,2021-11-13T04:40:29Z,1,Firefox,94.0,Windows NT 10.0,2048,1152,NA,1.7777777777777777,590,52,324,78,53,59,-0.5118160310194174,-0.3434429681504497,-0.49829575331844694,-0.3239311718555635,-0.2616716161181409,-0.7833641535453761,3,4,1,1,3,1,2,3,1,3,3,1,2,2,3,3,1,1,3,4,1.0699237552766379,0,1,1,3,3,1.55,0,3,4,2,4,3,4,3,3,3,2,2,4,2,3,4,1,1,1,1,2,2,3,2,3,2,0,0,4,5,5,5,5,4,4,5,4,1,4,1,1,3,2,5,1,2,2,1,3,5,1,2,1,2,1,1,3,3,3,5,2,2,1,1,1,2,1,3,3,1.5749541201192117,0.7988086367179802,1.625,0,2.25,0,2.533333333333333,0,1.4444444444444444,0,1.6666666666666667,0,1.1666666666666667,0,2,0,1,0,1.5945945945945945,0,2,0,0,-0.6413763510693116,-0.38530637127363354,0.06095019390122543,-0.16217808868620406,5,2,4,2,1,2,1,2,1,1.5118578920369088,1.5714285714285714,0,1.5,-0.3767559860388676,5,5,5,5,3,2,2,7,7,4,3,1.4638501094227998,4.142857142857143,0,1.8571428571428572,2,3.8333333333333335,3.2559414990859232,-1.3043345419688306,0,-0.9866058241456384,2,2,3,2,3,2,4,3,2,2,1,4,3,4,4,2,4,3,4,4,1.0327955589886444,2.4,0,4,0,3.4,0,3.4,0,3.6,0,2,1,1,4,4,3,3,3,1,1,2,4,1,1,1,4,1,2,1,2,1.2096106376585989,1.6,0,"White, Caucasian, Anglo, European American",0,23,0,1,NA,1,4,4,Student,6,0,145,66,3,5,2,0,0,1,0,0,TRUE,TRUE,TRUE,TRUE,TRUE,6,1.0252682926829269,0.82,0.18921450979591836,6,0.3944375,0.5064333333333333,1,0.9375,0.0017014798387096773,0.007458447580645163,6,0.55309375,0.6076451612903225,1,0.96875,0.00838744254032258,0.00955482157258065,1.8711,0.8823,0.3775,1.4283,1.1137,0.6165,0.5236,1.771772947,0.8610351367666667,0.38129787866666665,1.2526,6.3296,0.2955,2.8291,0.3039,-78.2127,0.8449,6.8315,0.3317,6.2268,0.4217,0.8355,1.2748878858333332,2.971052870333333,5.893830721333333,0.30302500753333333,0.2910325586333333,1.0315,3.993,0.4285,4.2063,0.4872,0.995,0.069,0.383,0.448,0.015,1.469,97.93333333333334,1.945700706,4.788839919333333,3.1898647356666667,0.3530617268,0.31317963216666667,289,0.8562962962962963,1,0,1,2,FALSE,FALSE,FALSE
360,2021-11-13T04:20:20Z,2021-11-13T04:43:00Z,1360,1,2021-11-13T04:43:01Z,1,Chrome,95.0.4638.69,Windows NT 6.3,1920,1080,NA,1.7777777777777777,813,49,278,61,36,75,0.06115281389697148,-0.3706971830899965,-0.7197507534950504,-0.5311000829343039,-0.49647662994450314,-0.513102285371727,2,1,3,2,1,2,3,1,1,2,2,2,2,3,2,2,3,1,2,1,0.7181848464596079,0,1,1,4,4,2.8,0,2,3,2,4,2,1,3,3,2,2,2,2,1,3,3,4,4,3,1,2,3,3,2,1,2,0,0,4,5,4,3,3,5,4,5,4,2,4,2,2,4,2,4,2,4,3,3,3,2,1,1,2,3,1,1,3,1,2,4,2,2,1,1,1,1,3,1,1,1.2880835218102742,0.816496580927726,2.75,0,1.5,0,2.466666666666667,0,1.8888888888888888,0,2.4166666666666665,0,1.8333333333333333,0,1.7142857142857142,0,1,0,2,0,1,0,0,0.3105487747956867,0.2437332838770968,-0.3773458880470143,-0.06680630208495875,4,1,3,1,1,2,1,2,1,1.2149857925879117,1.5714285714285714,0,1.5,-0.3767559860388676,5,5,5,5,2,2,2,3,4,3,3,1.6035674514745464,4,0,2,5.5,3.8333333333333335,3.2559414990859232,0.6723373927674386,0,0.081401140643933,2,3,3,3,3,3,2,2,2,3,4,3,3,4,3,4,3,2,4,3,0.7559289460184544,2.8,0,3,0,2.8,0,3.6,0,3.1333333333333333,0,1,1,1,4,1,2,2,4,2,2,1,3,1,1,1,3,1,2,1,2,1.0052493799000692,1.4,0,"Hispanic of Latino (e.g., Mexican American, Central American, and others)",0,24,0,1,NA,1,3,4,Unemployed,3,0,183,72,4,5,2,0,0,1,0,0,TRUE,TRUE,TRUE,TRUE,TRUE,6,1.0123046511772067,0.86,0.048738260222410616,6,0.49497419356530714,0.583835483874044,0.96875,0.96875,0.007502052485815152,0.007601973701675562,6,1.2056275862167622,1.0674483870998506,0.9666666666666667,1,0.6415830403656204,0.3177509046128657,1.5166,1.2757,0.6069,1.1304,1.3339,0.7745,0.4089,1.5222188413333333,1.1396890035,0.5959171166666667,1.2149,4.0783,0.3568,2.9157,0.3834,-60.4599,0.7459,5.8822,0.4219,3.8927,0.5094,0.7077,1.3800164731666666,3.2048934583333333,4.308596325,0.3722188346,0.34411865876666664,2.3575,1.2465,0.2315,2.027,0.4012,0.3907,0.113,0.332,0.146,0.166,1.613,9.716867469879517,2.263852391,1.3124098248,1.8404973465,0.3215067744,0.4314307230666667,104,0.3081481481481481,1,1,1,2,FALSE,FALSE,FALSE
361,2021-11-13T04:23:18Z,2021-11-13T04:44:38Z,1279,1,2021-11-13T04:44:39Z,1,Chrome,95.0.4638.69,Windows NT 10.0,1920,1080,N/A,1.7777777777777777,572,38,407,100,67,61,-0.5580646373355385,-0.4706293045350014,-0.09871390517370586,-0.05583022810660534,-0.06830278120231312,-0.74958142002367,2,2,2,2,2,2,2,1,1,2,1,1,2,1,1,1,1,1,1,1,0.5104177855340404,0,1,2,3,3,2.55,0,2,4,2,2,2,3,4,2,3,1,1,4,2,4,1,5,5,5,3,3,4,4,3,7,1,3,1,1,1,1,1,1,2,2,2,1,2,4,2,2,2,3,2,5,5,5,5,5,1,5,5,2,5,5,2,3,3,3,2,5,2,3,5,2,1,2,2,2,1.5417123197525786,1.1254628677422756,4,0,1.75,0,2.466666666666667,0,4.666666666666667,0,3.6666666666666665,0,4.333333333333333,0,3,0,3.3333333333333335,0,3.918918918918919,0,4,3,1,2.2816431855271846,1.6055717125539355,1.106682005738028,1.3561268591459816,4,2,3,2,1,3,2,8,8,0.9759000729485332,2.142857142857143,0,8,2.363532640615193,4,4,4,4,1,1,5,1,3,2,1,1.6035674514745464,2.7142857142857144,0,3.2857142857142856,7,3.8333333333333335,3.2559414990859232,1.5194825076544112,0,1.22201267488035,3,3,3,2,3,5,4,3,3,2,3,2,4,3,2,2,3,3,2,3,0.8837151016885368,2.8,0,2.4,0,2.8,0,2.8,0,2.6666666666666665,0,1,4,4,1,4,4,4,1,4,3,2,1,1,4,2,2,1,2,2,4,1.3168942730211068,3.05,0,"White, Caucasian, Anglo, European American",0,27,0,1,NA,1,1,1,Unemployed,2,0,126,71,1,5,2,0,0,1,0,0,TRUE,TRUE,TRUE,TRUE,TRUE,3,0.7049871794864153,0.78,0.012970844260550528,3,0.3837187500018626,0.4708266666650772,1,0.9375,9.917454436041127e-4,0.0035033845059560856,3,0.5180062499986962,0.5381333333323399,1,0.967741935483871,0.004598684475358781,0.002650380365664284,1.0791,1.2523,0.4639,0.8337,1.4553,0.5606,0.1663,1.1418085507666667,1.1138653253666666,0.4555340384,1.1586,8.0321,0.3135,3.7677,0.3328,-107.9537,0.4973,7.3078,0.3516,6.3239,0.4244,0.8789,1.1702917941666666,3.2964418183333333,6.878444414666666,0.30673582073333333,0.3059028973333333,0.6878,3.9786,0.4425,4.8187,0.4773,0.7834,0.063,0.378,0.429,0.044,1.502,34.13636363636364,1.5247762267333334,4.925518981,4.025475126333333,0.36686743276666667,0.36397400803333335,316,0.9362962962962963,1,0,0,1,FALSE,FALSE,FALSE
362,2021-11-13T04:24:58Z,2021-11-13T04:46:30Z,1292,1,2021-11-13T04:46:31Z,1,Chrome,95.0.4638.69,Windows NT 10.0,1920,1080,N/A,1.7777777777777777,629,48,368,79,50,86,-0.4116107173344884,-0.3797819214031788,-0.28646923141039143,-0.31174476532151996,-0.3031077950286754,-0.3272972510023432,4,4,1,1,4,1,1,3,1,4,3,1,1,1,4,4,1,1,4,4,1.465390194130093,0,1,1,1,2,1.1,0,3,4,4,3,4,1,2,3,2,2,4,3,3,3,4,4,4,5,1,4,4,2,4,0,1,2,1,5,3,2,3,3,3,3,4,4,1,5,4,2,3,3,4,4,4,4,5,3,1,2,4,2,3,1,1,1,1,1,4,1,2,1,2,1,2,4,1,1,1.3305150394754168,0.9258200997725514,3.5,0,2,0,2.8666666666666667,0,2.6666666666666665,0,3,0,2.6666666666666665,0,1.1428571428571428,0,1.3333333333333333,0,2.4324324324324325,0,0,2,1,1.0460317638746037,0.9237813862142307,0.1660801056761797,0.5449307459452052,1,3,1,4,3,3,5,8,4,1.4638501094227998,4,0,6,2.736630698083305,2,3,3,2,1,1,5,2,4,3,2,1.3972762620115438,1.8571428571428572,0,4.142857142857143,6,3.8333333333333335,3.2559414990859232,0.9547190977297628,0,1.4176569544466464,2,2,3,4,3,3,3,1,1,4,4,3,1,4,5,3,3,5,4,4,1.3201731488169053,2.8,0,2.4,0,3.8,0,4.2,0,3.466666666666667,0,1,1,1,3,1,1,2,3,1,1,4,3,1,1,1,4,1,1,1,1,1.0894228312566052,1.35,0,"White, Caucasian, Anglo, European American",0,28,0,1,NA,1,2,3,Custodian,2,0,230,71,4,5,2,0,0,1,0,0,TRUE,TRUE,TRUE,TRUE,TRUE,3,0.8111766666680574,0.6122448979591837,0.05251185187056104,3,0.45229666666686535,0.5009656249997206,0.9375,1,0.006688620604519712,0.0059204597481103075,3,0.6085193548404402,0.6743218749994412,0.96875,1,0.0061099702823565845,0.011738003054080784,1.3428,0.3582,0.3894,1.0348,0.5357,0.5646,0.451,1.3806639693333334,0.5500586239516333,0.38241210293333333,1.3292,3.2039,0.2646,3.9005,0.3306,-59.6212,0.7628,6.0323,0.3794,7.2559,0.4481,0.9412,1.4082259442,3.9928145403333333,3.4747310376666665,0.3253852502,0.26114651963333335,0.9682,4.0198,0.4976,2.9278,0.5525,0.9055,0.068,0.449,0.37,0.053,1.769,33.37735849056604,1.9493334316666666,4.157639186,3.5048495293333333,0.38960939083333335,0.39719871516666666,317,0.9392592592592592,1,0,0,1,FALSE,FALSE,FALSE
363,2021-11-13T04:23:05Z,2021-11-13T04:47:27Z,1461,1,2021-11-13T04:47:28Z,0.8999999761581421,Chrome,95.0.4638.69,Windows NT 10.0,1536,864,NA,1.7777777777777777,600,63,482,86,83,94,-0.48612236084379457,-0.24351084670544482,0.2623540298968433,-0.2264399195832151,0.15269017298720433,-0.19216631691551858,3,3,1,2,2,1,1,2,1,2,3,1,1,1,3,3,1,1,3,2,0.8750939799154206,0,1,1,3,3,1.75,0,3,3,2,2,2,3,3,4,4,3,5,2,2,2,2,4,5,5,1,4,5,4,4,3,2,0,0,4,2,3,3,3,3,2,2,1,3,4,5,2,3,2,3,2,5,5,5,5,1,5,5,2,4,2,3,2,1,1,4,1,1,1,3,3,2,3,2,3,1.377642151611912,0.9411239481143202,4,0,2.5,0,3.3333333333333335,0,3.4444444444444446,0,3.5,0,3.6666666666666665,0,1.4285714285714286,0,2.3333333333333335,0,3.081081081081081,0,2,0,0,1.7605009532655516,1.6179608610166674,0.13935139661846652,0.8786561288175669,4,2,3,4,2,2,2,3,1,0.9511897312113419,2.4285714285714284,0,2,0.32054096227918905,2,3,4,4,1,2,3,6,6,2,2,1.1126972805283737,2.7142857142857144,0,3.2857142857142856,3,3.8333333333333335,3.2559414990859232,-0.7395711320441822,0,0.09248585503105322,1,1,2,2,3,1,4,3,1,3,1,5,2,5,4,2,5,4,4,2,1.486446705914413,1.8,0,4.4,0,3.8,0,4.2,0,4.133333333333334,0,1,1,1,4,2,2,2,3,1,2,3,4,1,1,1,4,1,1,1,2,1.1192102478745307,1.4,0,"Asian or Asian American (e.g., Chinese, Japanese, and others) & White, Caucasian, Anglo, European American",1,24,0,1,NA,1,3,6,Chemist,4,0,220,71,3,5,2,0,0,1,0,0,TRUE,TRUE,TRUE,TRUE,TRUE,3,0.6740424999999813,0.8,0.024567845097879702,3,0.4741812500001397,0.4623548387097976,1,0.96875,0.005099315766122206,0.0044567516128844855,3,0.5798000000000466,0.6179843749998836,1,1,0.00981192774197075,0.0068713039415235575,1.0816,1.3126,0.4268,0.852,1.7495,0.5034,0.3428,1.1399359669666667,1.1475781034666668,0.4181015795,1.1949,4.0998,0.3285,4.6804,0.3417,-81.7938,0.7477,4.5806,0.3977,4.8292,0.3838,0.9925,1.3037613433333333,4.628332932,4.327861227333333,0.3330863689,0.3220006524333333,0.9293,3.1324,0.4609,5.1182,0.5349,0.8669,0.186,0.242,0.556,0.029,1.525,52.586206896551715,2.258185608,4.331137991333334,4.620252331,0.3206773118333333,0.3806577881666667,390,1.1555555555555557,1,0,1,2,FALSE,FALSE,FALSE
365,2021-11-13T04:12:15Z,2021-11-13T04:55:09Z,2573,1,2021-11-13T04:55:10Z,0.8999999761581421,Chrome,95.0.4638.69,Windows NT 10.0,1920,1080,"Nope, great survey!",1.7777777777777777,790,182,1053,220,128,106,0.0020573724930389916,0.8375730125632445,3.0112845755672906,1.4065385559786212,0.7742328566452221,0.010530084214718316,4,4,2,2,3,1,2,3,1,4,4,2,1,1,4,4,1,1,3,3,1.2354415362426845,0,1,1,4,4,1.4,0,4,4,3,4,5,2,4,2,2,2,2,4,2,4,4,3,3,1,1,2,3,3,2,2,2,0,0,5,3,4,5,5,4,4,4,5,3,4,2,4,5,4,5,5,3,4,4,3,4,1,1,1,3,3,2,2,2,1,4,2,2,1,3,2,2,2,2,2,1.3361456826578775,1.082325538564332,2.25,0,2,0,2.2666666666666666,0,1.6666666666666667,0,3,0,1.6666666666666667,0,1.7142857142857142,0,2,0,2.189189189189189,0,1,0,0,0.11722181766637156,0.024213059553069287,-0.22054348261253207,-0.09816521152973139,4,2,2,2,1,3,4,3,4,1.1338934190276817,2.5714285714285716,0,3.5,0.9594896595959068,4,5,4,4,2,2,3,2,2,5,3,1.1338934190276817,3.4285714285714284,0,2.5714285714285716,7,3.8333333333333335,3.2559414990859232,1.5194825076544112,0,0.8236576877731663,2,3,3,3,3,2,5,3,2,3,2,4,2,4,5,2,4,2,5,2,1.245945806357946,2.8,0,4,0,4.2,0,4,0,4.066666666666666,0,2,1,3,3,3,4,2,4,1,1,3,2,2,4,3,4,1,3,4,2,1.0954451150103321,2.3,0,"White, Caucasian, Anglo, European American",0,18,0,1,NA,1,2,3,Unemployed,3,0,176,72,2,5,2,0,0,0,0,0,TRUE,TRUE,TRUE,TRUE,TRUE,4,0.959218749994412,0.6530612244897959,0.06936333341955578,4,0.5065533333301544,0.6318258064543048,0.967741935483871,1,0.01978481318121958,0.012233129977209168,4,0.7191937500108033,0.7185,1,1,0.024262177378159635,0.01051601096832014,1.7941,0.3932,0.2911,1.1657,0.3911,0.67490000000000006,0.3213,1.7304894166666667,0.508807776153,0.29378658236666666,1.359,3.2508,0.3247,3.8549,0.4556,-56.8552,2.1084,5.4298,0.2984,7.9751,0.4869,0.9848,1.5528440175666667,4.006385683333333,3.576466594,0.4389256038,0.3102079185,1.142,2.7712,0.5336,5.0076,0.6151,0.9782,0.16,0.348,0.434,0.064,1.054,16.46875,2.752918389,3.738128268,4.145974418333333,0.34833604356666664,0.39112755146666667,282,0.8355555555555556,1,0,4,5,FALSE,FALSE,FALSE
366,2021-11-13T03:19:09Z,2021-11-13T04:58:34Z,5964,1,2021-11-13T04:58:36Z,1,Safari,14.1.1,Macintosh,1440,900,none,1.6,4270,133,615,79,96,485,8.94345459360978,0.3924208352173136,0.9026478347552838,-0.31174476532151996,0.3322469482661872,6.412358086578033,2,3,3,2,2,1,1,2,1,2,2,2,1,1,2,2,1,1,1,2,0.6569466853317864,0,1,1,3,2,2.2,0,3,3,3,2,4,2,3,2,2,3,3,3,2,3,3,2,3,1,1,2,2,1,2,0,2,0,1,4,3,3,3,2,5,5,5,5,2,3,2,3,3,3,3,4,3,3,3,4,3,2,4,1,1,1,1,1,2,1,1,4,2,2,3,2,2,2,1,1,1.2339053944782488,0.5936168397046637,1.75,0,1.5,0,2.8666666666666667,0,2.111111111111111,0,3,0,1.8333333333333333,0,2.142857142857143,0,2.3333333333333335,0,2.4324324324324325,0,0,0,1,-0.04248305996219344,0.1717213584374688,-0.40398871494434996,-0.11613367825344058,4,2,4,1,1,3,2,3,2,1.2724180205607036,1.8571428571428572,0,2.5,0.1631660590458031,3,4,4,3,1,1,3,7,6,4,2,1.2535663410560174,2.7142857142857144,0,3.2857142857142856,2.5,3.8333333333333335,3.2559414990859232,-1.0219528370065065,0,-0.04870499745010898,2,3,3,2,2,3,3,4,3,5,3,3,2,3,3,1,3,3,5,3,0.990430401872025,2.4,0,3,0,4.4,0,2.8,0,3.4,0,1,2,3,2,2,2,2,2,2,2,2,2,2,2,2,2,2,2,2,2,0.3244428422615251,2.2,0,Other & multiple,1,25,0,1,NA,1,2,6,legal intern,3,0,195,68,2,5,3,0,0,1,1,0,TRUE,TRUE,TRUE,TRUE,TRUE,NA,NA,NA,NA,NA,NA,NA,NA,NA,NA,NA,6,0.6549687500000219,0.7429333333333256,1,0.967741935483871,0.006665644153220522,0.013368122580643725,NA,NA,NA,NA,NA,NA,NA,NA,NA,NA,NA,NA,NA,NA,NA,NA,NA,NA,NA,NA,NA,NA,NA,NA,NA,NA,NA,0.8961,4.778,0.5706,4.4557,0.6355,0.9362,0.071,0.493,0.432,0.015,1.575,105,2.009450234,4.491645315,3.337553434666667,0.43339125663333333,0.4546964262666667,104,0.3081481481481481,1,0,2,4,FALSE,FALSE,FALSE
367,2021-11-13T04:34:29Z,2021-11-13T04:58:39Z,1449,1,2021-11-13T04:58:40Z,0.8999999761581421,Firefox,94.0,Windows NT 10.0,1920,1080,NA,1.7777777777777777,629,57,437,79,69,111,-0.4116107173344884,-0.2980192765845384,0.0457132688545138,-0.31174476532151996,-0.04067866192862343,0.0949869180189837,4,3,1,2,4,1,1,4,1,4,4,1,1,1,4,4,1,1,4,4,1.4689774459950382,0,1,2,1,1,1.1,0,1,3,5,2,5,1,1,5,4,2,4,1,2,1,1,5,5,5,5,5,5,5,4,7,3,4,11,5,1,3,1,1,1,1,1,3,2,4,5,3,2,1,3,1,5,5,5,1,1,3,3,2,4,3,1,4,4,2,5,1,4,1,1,5,2,3,5,2,1.5673086666181797,1.6417180315870614,4.875,0,3,0,4,0,4.111111111111111,0,3.0833333333333335,0,3.1666666666666665,0,2.2857142857142856,0,2.3333333333333335,0,3.189189189189189,0,4,4,6,2.3720025241854517,2.3269492398409626,2.587569461413161,2.4572593506270617,4,1,2,1,1,1,2,3,3,1.1126972805283737,1.7142857142857142,0,3,0.2621927112778498,5,5,5,5,3,1,1,3,2,2,2,1.9023794624226837,4.142857142857143,0,1.8571428571428572,6.5,3.8333333333333335,3.2559414990859232,1.237100802692087,0,0.2841118481848205,4,4,5,2,2,2,5,1,1,1,1,5,1,2,5,1,1,1,2,1,1.6035674514745464,3.4,0,4,0,3.6,0,4.4,0,4,0,2,4,3,1,4,4,2,1,1,1,4,3,2,1,2,3,2,2,2,3,1.0894228312566052,2.55,0,"Hispanic of Latino (e.g., Mexican American, Central American, and others) & Native American/Alaskan Native/indigenous",1,22,0,1,NA,1,3,3,Food service,4,0,110,64,4,5,2,0,0,1,0,0,TRUE,TRUE,TRUE,TRUE,TRUE,NA,NA,NA,NA,1,0.5343448275862069,0.60090625,0.9666666666666667,1,0.010733040229885056,0.012381442540322581,1,0.714375,0.76175,1,1,0.01438282258064516,0.018131548387096765,NA,NA,NA,NA,NA,NA,NA,NA,NA,NA,1.917,3.2324,0.2501,3.9817,0.3602,-43.8255,1.0595,3.9495,0.3987,3.552,0.4577,0.9976,1.8563979303333333,3.860512339,3.311233565333333,0.3604650300666667,0.2552589861,1.1922,3.2435,0.5467,2.7876,0.5741,0.9537,0.082,0.51,0.388,0.022,1.225,55.68181818181819,2.936337204,4.139407395666667,4.123429824,0.3600945578,0.4097802781666667,294,0.8711111111111112,1,0,0,1,FALSE,FALSE,FALSE
368,2021-11-13T04:41:40Z,2021-11-13T04:58:41Z,1021,1,2021-11-13T04:58:42Z,1,Firefox,94.0,Windows NT 10.0,1920,1080,thanks,1.7777777777777777,607,70,183,48,22,66,-0.4681367917208586,-0.17991767851316898,-1.1771034712510793,-0.6895233678768702,-0.6898454648603309,-0.6651245862194046,4,4,1,1,4,1,1,4,1,3,3,1,1,1,3,3,1,1,3,3,1.2814465510343749,0,1,1,4,4,1.3,0,5,5,1,5,1,1,4,1,1,1,1,4,1,5,4,1,1,1,1,1,1,1,1,1,2,0,0,5,5,5,5,5,5,5,5,5,1,5,1,1,5,1,4,1,1,1,1,1,5,1,1,1,1,1,1,3,2,1,5,1,1,1,1,1,2,1,1,2,1.9081774396373994,1.8771812708978117,1,0,1.5,0,1.2,0,1,0,1.0833333333333333,0,0.8333333333333334,0,1.2857142857142858,0,1,0,1.1081081081081081,0,1,0,0,-1.3327303608034937,-1.4359642350467026,-0.3773458880470143,-0.9066550615468585,5,1,3,1,1,1,1,1,1,1.5735915849388864,1.2857142857142858,0,1,-0.7321841937363471,5,5,5,5,3,3,1,4,4,3,2,1.5735915849388864,4.428571428571429,0,1.5714285714285714,5,3.8333333333333335,3.2559414990859232,0.38995568780511447,0,-0.2988027041015393,1,1,1,1,1,1,4,1,1,4,1,4,1,4,4,1,4,4,4,1,1.5491933384829668,1,0,4,0,4.4,0,4.6,0,4.333333333333333,0,1,1,1,4,1,1,1,4,1,1,1,4,1,1,1,4,1,1,1,1,1.231174022502185,1,0,Black or African American,0,24,0,1,NA,1,2,3,construction,5,0,168,70,3,5,2,0,0,1,0,0,TRUE,TRUE,TRUE,TRUE,TRUE,4,0.7471951219512195,0.8367346938775511,0.03731618962585035,4,0.4255,0.4940322580645161,1,0.96875,0.0031169032258064524,0.003274337701612903,4,0.5443125,0.6341379310344828,1,0.90625,0.005536028225806451,0.010570641129032258,1.2812,1.3292,0.4307,1.148,1.1918,0.4861,0.1504,1.3185659541666668,1.1666076359,0.4225186415,1.1231,5.4785,0.323,4.2737,0.3735,-93.2934,0.5703,4.5185,0.3721,4.0105,0.4426,0.9926,1.2158703707,4.283538723,5.401683837666667,0.3660423642,0.31624378506666667,0.5677,4.325,0.5033,3.5583,0.5813,0.9505,0.066,0.389,0.448,0.014,1.8,128.57142857142858,1.5338582739333333,4.036270315,2.4598820153,0.3536420758666667,0.35985111696666666,558,1.6533333333333333,1,0,0,1,FALSE,FALSE,FALSE
370,2021-11-13T04:03:55Z,2021-11-13T05:00:45Z,3409,1,2021-11-13T05:00:46Z,1,Firefox,94.0,Windows NT 10.0,1536,864,"nope, thanks!",1.7777777777777777,1769,64,1332,80,58,64,2.517467682686513,-0.23442610839226255,4.354457294029733,-0.29955835878747644,-0.19261131793391667,-0.6989073197411108,2,2,3,3,2,3,4,2,3,2,2,3,3,2,2,2,3,2,2,1,0.6805570473787206,0,1,2,3,2,3,0,2,3,3,3,3,3,3,3,2,2,3,3,3,3,3,2,3,1,2,2,3,3,3,6,2,0,0,4,4,4,4,3,3,3,3,3,3,4,3,1,4,2,3,3,3,4,4,4,3,1,1,1,3,3,1,2,3,1,3,3,4,1,1,2,1,2,1,2,1.0904995136125413,0.4140393356054125,2.375,0,1.5,0,2.933333333333333,0,2.5555555555555554,0,2.8333333333333335,0,1.8333333333333333,0,2.2857142857142856,0,1.3333333333333333,0,2.4324324324324325,0,3,0,0,0.3462722342652341,0.46896413132066517,0.028839059546018453,0.2489015954333418,5,1,5,2,1,2,2,1,3,1.7182493859684491,1.4285714285714286,0,2,-0.2777293338068208,5,5,5,5,4,3,1,6,8,6,4,1.5275252316519468,4.571428571428571,0,1.4285714285714286,2,3.8333333333333335,3.2559414990859232,-1.3043345419688306,0,-1.2256188164099486,3,3,3,3,3,3,4,4,3,3,2,3,3,2,3,3,3,3,2,4,0.6546536707079771,3,0,3.2,0,3,0,2.4,0,2.8666666666666667,0,2,2,1,2,3,2,4,3,4,3,2,3,3,3,2,4,1,3,2,3,0.8825799501580878,2.4,0,"Asian or Asian American (e.g., Chinese, Japanese, and others)",0,25,0,1,NA,1,4,7,Unemployed,5,0,135,69,1,5,2,1,1,1,0,2,TRUE,TRUE,TRUE,TRUE,TRUE,5,1.170075,0.8,0.11399012897959185,NA,NA,NA,NA,NA,NA,NA,5,0.9231,1.14359375,1,1,0.08787967931034484,0.20093211995967739,1.7069,0.8442,0.5791,1.1466,1.1057,0.8903,0.5484,1.680468897,0.8461989248,0.5711239958666666,NA,NA,NA,NA,NA,NA,NA,NA,NA,NA,NA,NA,NA,NA,NA,NA,NA,1.7327,1.7285,0.5066,1.3613,0.6695,0.6876,0.2,0.18,0.249,0.015,2.006,133.73333333333332,2.709084572666667,2.4031499294,1.8544064263666666,0.34131813623333335,0.39425122993333334,383,1.1348148148148147,1,1,14,15,FALSE,FALSE,FALSE
371,2021-11-13T04:41:31Z,2021-11-13T05:03:42Z,1331,1,2021-11-13T05:03:43Z,1,Chrome,93.0.4577.82,Macintosh,1440,900,NA,1.6,658,56,332,82,66,89,-0.3370990738251822,-0.30710401489772066,-0.459781840244255,-0.2751855457193893,-0.08211484083915795,-0.27662315071978394,4,3,1,2,3,1,2,3,1,4,3,1,1,1,4,3,1,1,3,3,1.164157703189193,0,1,2,5,4,1.45,0,4,5,3,4,2,1,5,2,1,1,1,5,1,5,3,2,1,1,1,1,1,1,1,2,2,0,0,5,4,5,5,5,5,5,5,5,1,5,1,1,5,1,5,1,1,2,1,2,5,1,1,1,1,1,1,3,3,1,5,1,1,1,1,1,2,1,1,2,1.8740362888727669,1.6846647257229665,1.125,0,1.5,0,1.5333333333333334,0,1.1111111111111112,0,1.1666666666666667,0,0.8333333333333334,0,1.4285714285714286,0,1,0,1.1891891891891893,0,1,0,0,-1.2045461827068822,-1.2041516524823082,-0.3773458880470143,-0.7907487702646612,4,2,3,2,1,1,3,1,1,1.1126972805283737,2,0,1,-0.3048482679606258,4,5,5,5,3,3,2,4,6,3,3,1.2149857925879117,4.142857142857143,0,1.8571428571428572,4,3.8333333333333335,3.2559414990859232,-0.1748077221195339,0,-0.42184241422098995,1,1,2,2,2,2,4,2,1,2,1,4,2,5,5,3,4,1,3,5,1.486446705914413,1.6,0,4.4,0,3.2,0,4,0,3.8666666666666667,0,2,1,2,2,4,1,3,2,2,2,1,3,3,4,1,2,1,3,1,3,0.9880869341680844,2.25,0,"White, Caucasian, Anglo, European American",0,24,0,1,NA,1,3,6,Strength and Conditioning Coach,2,0,160,70,4,5,2,0,0,1,0,0,TRUE,TRUE,TRUE,TRUE,TRUE,5,0.9260125000089406,0.8,0.14152547857594866,5,0.5819968750067055,0.6779781249761582,1,1,0.007302947410378193,0.0067639624074519065,5,0.7791250000074506,0.7813781250081956,1,1,0.0052008412890774975,0.0017532991841419895,1.3646,1.005,0.5728,1.1222,0.92,0.6123,0.0042,1.4107657556666666,0.9776172322333333,0.5597952537666666,10,8.8938,0.0197,9.038,0.1247,-69.4394,0.8756,3.6661,0.4751,4.8484,0.5901,0.9533,2.41153263,4.663007647666666,4.585465446333333,0.42305830056666666,0.3189148937,0.9257,4.8339,0.6885,7.4775,0.7247,0.9344,0.119,0.609,0.703,0.229,1.448,6.323144104803493,2.962927448,5.393806446666667,6.545839546666667,0.5098914379333334,0.5660550750666666,104,0.3081481481481481,1,0,0,1,FALSE,FALSE,FALSE
372,2021-11-13T04:38:23Z,2021-11-13T05:03:57Z,1533,1,2021-11-13T05:03:58Z,0.8999999761581421,Firefox,94.0,Windows NT 10.0,1920,1200,NA,1.6,625,107,435,126,61,109,-0.42188818540473755,0.15621763907457475,0.03608479058596582,0.26101634177852706,-0.15117513902338214,0.06120418449727754,2,4,2,1,1,2,3,2,1,3,1,1,2,3,1,1,2,1,2,1,0.8944271909999159,0,1,1,2,2,2.5,0,5,4,2,4,2,1,4,1,2,1,1,5,1,5,4,1,1,1,1,1,1,1,1,0,2,0,0,5,2,5,3,4,5,4,4,5,2,5,1,2,2,2,3,2,1,1,1,1,5,1,1,1,2,1,1,1,1,1,3,3,2,1,1,1,1,1,1,1,1.5102254072756096,1.65615734242165,1,0,1,0,1.4666666666666666,0,1.8888888888888888,0,1.75,0,1,0,1.5714285714285714,0,1,0,1.6216216216216217,0,0,0,0,-1.0133206055463637,-1.1006829047740254,-0.7372407672780129,-0.9189618360260192,4,2,3,1,1,2,3,3,1,1.1126972805283737,2,0,2,0.06413940681375631,5,5,5,5,3,2,2,6,4,4,3,1.4638501094227998,4.142857142857143,0,1.8571428571428572,4,3.8333333333333335,3.2559414990859232,-0.1748077221195339,0,-0.42184241422098995,2,2,1,3,2,2,4,2,2,1,1,3,2,2,4,3,5,1,3,1,1.2421180068162376,2,0,4.4,0,3,0,3.8,0,3.7333333333333334,0,1,3,4,1,2,4,2,1,4,3,3,2,4,3,1,1,1,3,2,3,1.142481141154959,2.9,0,"White, Caucasian, Anglo, European American",0,28,0,1,NA,1,3,6,Unemployed,4,0,160,71,2,5,2,0,0,0,0,0,TRUE,TRUE,TRUE,TRUE,TRUE,2,1.0409473684210526,0.76,0.13588492081632653,2,0.51553125,0.6131666666666666,1,0.9375,0.0015842570564516135,0.006750176411290321,2,0.62690625,0.6952258064516129,1,0.96875,0.006948926411290324,0.0075667701612903236,1.4983,0.7779,0.6064,1.3279,0.6221,0.6551,0.0378,1.527871084,0.8159567574866666,0.5935177949666667,1.4503,5.2915,0.3785,3.4673,0.4248,-72.7432,0.7357,8.1527,0.4762,4.2748,0.5322,0.9013,1.5670140439666667,3.5255947056666668,5.291927225666667,0.41093258456666665,0.37028981046666665,0.9032,4.3719,0.5315,4.9852,0.5958,0.98,0.067,0.479,0.461,0.021,1.865,88.80952380952381,2.0924890456666665,4.800452418333333,3.55314582,0.41210875653333334,0.41358059983333334,244,0.7229629629629629,1,0,0,1,FALSE,FALSE,FALSE
373,2021-11-13T04:49:40Z,2021-11-13T05:09:20Z,1179,1,2021-11-13T05:09:22Z,1,Chrome,95.0.4638.69,Macintosh,1440,900,n/a,1.6,782,35,185,21,18,81,-0.018497563647459265,-0.4978835194745482,-1.1674749929825314,-1.0185563442960461,-0.7450937034077103,-0.4117540848066085,2,2,1,2,2,1,1,1,1,1,1,1,1,1,2,2,2,2,2,2,0.512989176042577,0,1,1,4,3,2.3,0,1,2,1,2,2,2,1,2,1,1,1,1,2,1,2,2,1,1,1,1,1,1,2,1,2,0,0,2,1,2,2,2,1,2,1,1,1,2,2,1,1,2,2,1,2,1,1,2,1,1,1,1,1,1,2,1,2,1,2,1,1,1,2,2,1,1,2,1,0.5022472023339226,0.5163977794943222,1.25,0,1.25,0,2.933333333333333,0,4.444444444444445,0,2.1666666666666665,0,1.5,0,1.5714285714285714,0,1.6666666666666667,0,2.5135135135135136,0,1,0,0,-0.3030541760930097,0.020341450658465283,-0.4557470907642554,-0.21770282005289507,1,2,2,2,1,2,1,2,1,0.5345224838248488,2.4285714285714284,0,1.5,0.13604712489199797,2,1,2,3,3,2,2,6,3,4,3,0.6900655593423543,2.4285714285714284,0,3.5714285714285716,4.5,3.8333333333333335,3.2559414990859232,0.10757398284279028,0,0.6754004073174131,1,2,1,1,2,1,2,2,1,1,1,1,2,1,2,1,1,1,1,1,0.45773770821706344,1.4,0,3.4,0,2.6,0,3.4,0,3.1333333333333333,0,1,2,1,2,2,2,1,1,2,2,1,1,1,2,1,1,2,1,2,2,0.512989176042577,2,0,"White, Caucasian, Anglo, European American",0,23,0,1,NA,1,3,6,Analyst,4,0,215,72,3,5,2,0,0,1,0,0,TRUE,TRUE,TRUE,TRUE,TRUE,NA,NA,NA,NA,1,0.5095903225781456,0.601262068964284,1,0.9354838709677419,0.01380876290303995,0.03341910000023842,NA,NA,NA,NA,NA,NA,NA,NA,NA,NA,NA,NA,NA,NA,NA,NA,NA,1.3274,3.546,0.3224,2.2663,0.3329,-39.8023,1.1226,4.1045,0.3685,3.6477,0.4219,0.9641,1.4392873592,2.508641067166667,3.785521687666667,0.3253655384333333,0.3142490416666667,NA,NA,NA,NA,NA,NA,NA,NA,NA,NA,NA,NA,NA,NA,NA,NA,NA,104,0.3081481481481481,1,1,6,7,FALSE,TRUE,TRUE
374,2021-11-13T04:35:14Z,2021-11-13T05:14:13Z,2339,1,2021-11-13T05:14:14Z,1,Chrome,95.0.4638.69,Windows NT 10.0,1366,768,Thanks,1.7786458333333333,1538,76,374,92,73,99,1.9239439016296258,-0.1254092486340754,-0.2575837966047475,-0.15332148037895377,0.014569576618755927,-0.10770948311125321,2,2,3,3,2,2,2,2,1,2,2,1,2,2,2,2,2,1,2,2,0.5104177855340404,0,0,2,1,1,2.45,0,2,4,5,4,2,3,2,4,3,3,3,2,2,2,4,4,4,4,2,3,4,4,4,1,2,1,1,4,3,3,4,4,2,2,4,1,3,3,5,2,3,2,4,1,5,5,5,5,2,2,1,5,4,3,2,4,4,1,4,1,1,2,2,4,3,5,2,2,1.3639502778182058,1,3.625,0,3,0,3.1333333333333333,0,3,0,3.4166666666666665,0,3,0,2,0,2.6666666666666665,0,2.972972972972973,0,1,1,1,1.4600036177275941,1.3243961165833447,0.47614418274863685,0.9002701496659907,5,2,4,2,1,1,2,2,2,1.5118578920369088,1.5714285714285714,0,2,-0.19226214865167657,4,4,5,4,4,4,1,5,5,4,4,1.2535663410560174,4.285714285714286,0,1.7142857142857142,4,3.8333333333333335,3.2559414990859232,-0.1748077221195339,0,-0.5015134116424268,1,1,1,2,3,2,5,4,2,3,1,4,3,5,4,4,4,1,3,3,1.2649110640673518,1.6,0,4.4,0,3.2,0,3.6,0,3.7333333333333334,0,3,3,2,2,3,4,3,2,4,3,3,2,2,4,2,1,1,4,2,2,0.9403246919632545,2.9,0,"White, Caucasian, Anglo, European American",0,24,0,1,NA,1,1,4,Cook,2,0,130,72,1,5,2,1,0,1,0,1,TRUE,TRUE,TRUE,TRUE,TRUE,5,1.1542694444447341,0.72,0.16579419100342818,5,0.45021612903211383,0.5058793103450845,1,0.90625,0.00165244139787013,0.006045568387033584,5,0.5653687500003726,0.630922580644969,1,0.96875,0.00656348350797073,0.010892509828737532,1.6161,0.6039,0.585,1.3237,0.6202,0.7337,0.334,1.6207035546666666,0.67968702004,0.5744228617333333,1.0931,5.1188,0.3434,2.8067,0.338,-74.2191,1.0748,10.4854,0.4007,5.3348,0.3993,0.8922,1.1802674046666666,3.0297249573333334,5.165926150333333,0.3317418101,0.3382828917,0.9709,3.2728,0.446,3.5581,0.5063,0.9215,0.081,0.397,0.516,0.009,1.143,127.00000000000001,1.7450224593333334,4.59081021,3.253667851,0.3779441129,0.3735988503,373,1.1051851851851853,1,0,0,1,FALSE,FALSE,FALSE
375,2021-11-13T04:52:30Z,2021-11-13T05:14:15Z,1305,1,2021-11-13T05:14:16Z,1,Chrome,95.0.4638.69,Windows NT 10.0,2560,1440,No.,1.7777777777777777,662,52,233,55,30,65,-0.3268216057549331,-0.3434429681504497,-0.9363915145373799,-0.6042185221385653,-0.5793489877655722,-0.6820159529802577,3,2,2,1,3,1,2,3,2,3,1,3,3,1,2,2,3,1,2,1,0.8255779474818965,0,1,2,2,3,2.35,0,2,3,3,2,2,4,2,4,3,3,1,2,4,2,3,1,3,1,5,3,2,3,3,1,3,0,0,4,2,2,4,3,2,3,3,4,1,4,2,1,3,1,5,4,2,1,4,4,3,1,1,1,4,3,2,1,3,1,3,3,2,1,4,1,2,1,1,1,1.238763308519644,0.8997354108424374,2.625,0,1.25,0,3.3333333333333335,0,3,0,2.1666666666666665,0,2,0,2,0,2,0,2.3513513513513513,0,1,0,0,0.4513412327050791,0.7134562330148865,-0.4557470907642554,0.12885457112531554,1,5,1,3,3,5,4,6,2,1.6761634196950514,4.285714285714286,0,4,2.169589718844829,2,2,4,3,1,1,5,3,6,2,2,1.5118578920369088,2,0,4,4.5,3.8333333333333335,3.2559414990859232,0.10757398284279028,0,0.9144133995817233,3,3,2,3,2,2,4,2,1,2,3,2,3,2,3,4,1,4,2,5,1.1751393027860062,2.6,0,2.4,0,2.6,0,3,0,2.6666666666666665,0,1,1,2,3,1,1,1,2,2,3,2,3,1,1,2,3,1,1,1,2,0.8013147091860318,1.6,0,"White, Caucasian, Anglo, European American",0,29,0,1,NA,1,3,3,Retail,4,0,208,73,2,5,2,0,1,1,0,1,TRUE,TRUE,TRUE,TRUE,TRUE,1,1.1167324324330767,0.74,0.08645007412404411,1,0.45191874999925497,0.4960193548394788,1,0.96875,0.0033370486697503338,0.0045561864420647115,1,0.5881968750022352,0.6643709677438582,1,0.96875,0.008210334506563693,0.010903786934265263,1.546,0.698,0.5865,1.2778,0.912,0.7476,0.7419,1.5661228726666667,0.7547263300466667,0.5746885298666666,1.3324,5.3545,0.3275,4.1274,0.3413,-83.6315,0.941,5.3299,0.3631,5.3979,0.4107,0.9944,1.3906067716,4.127226411666666,5.224392785666667,0.3361710742,0.3214181446666667,1.0859,3.5942,0.4475,3.0472,0.5167,0.8769,0.073,0.414,0.389,0.02,1.681,84.05,1.9488814843333333,4.556841507333333,3.146604163,0.3767729307666667,0.3667389551,392,1.1614814814814816,1,0,1,2,FALSE,FALSE,FALSE
376,2021-11-13T04:49:33Z,2021-11-13T05:14:45Z,1511,1,2021-11-13T05:14:46Z,1,Chrome,95.0.4638.69,Windows NT 10.0,1536,864,NA,1.7777777777777777,764,48,405,91,68,81,-0.06474616996358035,-0.3797819214031788,-0.10834238344225383,-0.1655078869129973,-0.054490721565468275,-0.4117540848066085,3,2,1,1,4,1,2,2,1,3,1,2,1,1,3,2,3,1,4,2,1.025978352085154,0,1,3,3,2,1.9,0,4,5,2,5,2,1,4,2,1,1,1,3,2,4,2,1,2,1,1,2,1,1,1,0,2,0,0,4,4,3,4,4,5,4,5,4,3,4,2,1,4,2,4,3,1,1,3,3,4,1,1,1,1,1,1,1,1,1,5,1,1,1,1,1,1,1,1,1,1.5017507300664965,1.4540583599999397,1.25,0,1,0,1.8,0,1.8888888888888888,0,2.0833333333333335,0,1,0,0.8571428571428571,0,1,0,1.5945945945945945,0,0,0,0,-0.8746295276057681,-0.861611055532249,-0.7372407672780129,-0.799425911405131,5,1,3,1,1,1,1,1,1,1.5735915849388864,1.2857142857142858,0,1,-0.7321841937363471,5,5,5,5,3,3,1,6,6,6,4,1.5735915849388864,4.428571428571429,0,1.5714285714285714,3,3.8333333333333335,3.2559414990859232,-0.7395711320441822,0,-0.8635661140261877,2,3,2,3,2,2,5,2,2,3,3,4,2,4,5,3,4,3,5,3,1.1126972805283737,2.4,0,3.6,0,4,0,4,0,3.8666666666666667,0,1,1,3,2,1,3,3,1,2,1,1,2,2,3,1,1,3,4,3,3,0.998683343734455,2.45,0,"White, Caucasian, Anglo, European American",0,21,0,1,NA,1,4,5,Dairy Clerk,5,0,125,68,2,5,2,0,0,1,0,0,TRUE,TRUE,TRUE,TRUE,TRUE,3,0.8183562500006519,0.64,0.06689531105654165,3,0.4381218749997206,0.480113333333532,1,0.967741935483871,0.0035481443447771704,0.0058581012257902165,3,0.6066531250006519,0.7102312500025145,1,1,0.00889824902214695,0.01510519576586315,1.4735,0.4188,0.3947,1.3268,0.2081,0.4952,0.1954,1.490408907,0.568531832588,0.3898903588666667,1.8329,5.2465,0.2712,5.1304,0.3066,-77.4577,1.1729,6.212,0.3471,4.6384,0.3511,0.9994,1.6171102600333334,4.585429157,4.047315509333333,0.3154622674,0.2353267464,1.184,3.5987,0.459,3.1674,0.5315,0.828,0.177,0.299,0.578,0.011,1.394,126.72727272727272,2.593287467,4.840217624,3.9427157453333335,0.342141803,0.3849105842666667,366,1.0844444444444443,1,0,1,2,FALSE,FALSE,FALSE
377,2021-11-13T04:48:05Z,2021-11-13T05:15:08Z,1622,1,2021-11-13T05:15:09Z,0.8999999761581421,Firefox,94.0,Windows NT 10.0,1600,900,NA,1.7777777777777777,765,99,396,115,61,119,-0.06217680294601806,0.08353973256911665,-0.15167053565071972,0.12696586990404798,-0.15117513902338214,0.2301178521058083,2,2,3,3,2,2,3,2,1,2,1,2,1,2,2,2,3,3,2,1,0.6863327411532597,0,1,1,3,3,2.75,0,5,5,1,5,1,1,5,1,1,1,1,4,1,4,4,1,1,1,1,1,1,1,1,2,2,0,0,5,5,5,5,3,5,5,5,4,2,4,1,1,5,1,4,1,1,1,1,1,5,1,1,1,1,1,1,2,2,1,5,1,2,1,1,1,1,1,1,1,1.7735968103392739,1.8771812708978117,1,0,1,0,1.2,0,1.3333333333333333,0,1.25,0,0.8333333333333334,0,1.2857142857142858,0,1,0,1.2432432432432432,0,1,0,0,-1.2486751620516177,-1.3778901016276477,-0.5341482934814965,-0.9560191975545721,5,1,4,1,1,1,1,1,1,1.7320508075688772,1.1428571428571428,0,1,-0.8176513788914915,5,5,5,4,4,3,2,8,8,4,3,1.1547005383792515,4.285714285714286,0,1.7142857142857142,1,3.8333333333333335,3.2559414990859232,-1.869097951893479,0,-1.3486585265293993,1,3,1,1,1,1,4,1,1,3,1,4,2,4,4,4,4,1,3,3,1.3451854182690985,1.4,0,4.6,0,3.2,0,4.2,0,4,0,2,2,2,3,2,2,2,2,1,1,3,3,3,2,1,2,1,2,2,2,0.6488856845230502,2,0,"Asian or Asian American (e.g., Chinese, Japanese, and others)",0,26,0,1,NA,1,4,8,resident physician,3,0,155,65,2,5,2,0,0,1,0,0,TRUE,TRUE,TRUE,TRUE,TRUE,5,0.9158648648648648,0.74,0.06356129346938777,5,0.4293125,0.5213225806451613,1,0.96875,0.0018884798387096779,0.0036815483870967737,5,0.5753125,0.6681612903225806,1,0.96875,0.007360286290322582,0.018401773185483875,1.5166,0.7236,0.4486,1.1123,0.7698,0.6726,0.4006,1.5284085913333334,0.7783993301933333,0.44263826766666664,1.39,6.9274,0.329,4.0212,0.358,-91.8294,0.732,6.5485,0.3729,4.83,0.4528,0.993,1.383540786,3.92342392,6.196055145333333,0.3553374544333333,0.3233155990666667,0.8892,4.0525,0.4799,2.9082,0.5352,0.9537,0.08,0.388,0.437,0.01,1.366,136.6,2.239582470333333,4.674418955,2.765812132333333,0.33842334786666667,0.2735069733,330,0.9777777777777777,1,0,0,1,FALSE,FALSE,FALSE
378,2021-11-13T04:44:14Z,2021-11-13T05:15:24Z,1869,1,2021-11-13T05:15:24Z,1,Chrome,95.0.4638.69,Windows NT 10.0,1536,864,Nope,1.7777777777777777,684,80,565,151,74,150,-0.2702955313685629,-0.08907029538134635,0.6619358780415844,0.5656765051296159,0.028381636255600768,0.7537502216922536,3,3,2,2,2,2,2,3,2,2,2,2,1,1,2,2,2,1,2,1,0.6048053188292994,0,1,1,2,2,2.25,0,3,4,3,3,2,2,4,2,3,2,2,2,2,3,3,3,4,4,1,2,4,2,3,1,2,0,0,4,3,2,3,3,4,3,3,3,1,5,3,1,3,3,1,2,3,4,4,5,2,1,1,2,2,1,1,2,1,1,4,2,2,2,3,2,2,2,2,1,1.1695588347184027,0.7237468644557459,2.875,0,1.75,0,2.533333333333333,0,2.888888888888889,0,2.9166666666666665,0,1.6666666666666667,0,1.4285714285714286,0,2.3333333333333335,0,2.4324324324324325,0,1,0,0,0.6572764696471762,0.5119389900507657,-0.2989446853297732,0.10649715236049626,4,2,3,1,1,3,2,1,1,1.1126972805283737,2,0,1,-0.3048482679606258,4,4,4,4,2,2,3,5,3,3,2,0.9511897312113419,3.2857142857142856,0,2.7142857142857144,5,3.8333333333333335,3.2559414990859232,0.38995568780511447,0,0.3385652752699547,2,3,3,3,3,2,3,2,2,2,2,4,2,4,5,3,4,2,2,2,1.0327955589886444,2.8,0,4,0,2.8,0,4.2,0,3.6666666666666665,0,1,1,1,3,1,1,2,2,1,1,2,3,1,1,1,3,1,2,2,2,0.7539370349250519,1.5,0,"White, Caucasian, Anglo, European American",0,21,0,1,NA,1,2,4,Self Employed,1,0,140,73,1,5,2,0,0,0,0,0,TRUE,TRUE,TRUE,TRUE,TRUE,4,0.8916309523752758,0.84,0.06738224393230956,4,0.420125,0.5355624999925495,1,1,0.0035665148391166813,0.004769089516445323,4,0.5426312500014902,0.6663483870644723,1,0.96875,0.009378071241346694,0.013072897051102131,1.5199,1.1374,0.4634,1.3028,0.983,0.56,0.3012,1.519462975,1.0566408976333332,0.45666770353333336,1.3821,6.2013,0.3087,5.2462,0.4038,-99.1181,0.791,5.5457,0.3448,4.3778,0.4497,0.9928,1.3930955618333334,4.871688515,5.749781255,0.3975573486,0.3035607188,1.0999,3.2754,0.4023,3.7011,0.521,0.9389,0.085,0.363,0.455,0.016,2.001,125.06249999999999,2.1671241576666667,4.118665418333333,3.1506384283333335,0.2795931735666667,0.3345102482333333,388,1.1496296296296296,1,0,1,2,FALSE,FALSE,FALSE
379,2021-11-13T04:53:12Z,2021-11-13T05:22:18Z,1746,1,2021-11-13T05:22:20Z,1,Chrome,95.0.4638.69,Windows NT 10.0,1536,864,Thank you for the opportunity.,1.7777777777777777,767,101,505,115,79,102,-0.0570380689108935,0.10170920919548118,0.37308152998514504,0.12696586990404798,0.09744193443982496,-0.057035382828693984,3,3,2,1,3,1,1,4,2,3,2,1,1,2,3,3,1,1,2,3,0.9679060415469871,0,1,1,3,3,1.7,0,4,5,2,4,2,1,3,2,2,2,2,4,3,3,3,2,4,1,1,1,3,1,1,1,2,0,0,5,3,2,3,3,4,3,3,4,2,5,4,1,3,3,4,4,4,4,4,3,2,1,1,1,1,1,1,2,1,1,3,3,2,1,1,1,2,1,1,1,1.3037253160461753,1.082325538564332,1.75,0,1.25,0,2.1333333333333333,0,2.6666666666666665,0,2.9166666666666665,0,1.3333333333333333,0,1.7142857142857142,0,1,0,2.27027027027027,0,1,0,0,-0.143349298464445,-0.21311656568613527,-0.4557470907642554,-0.33443182822519535,4,2,4,1,1,2,1,1,1,1.3451854182690985,1.5714285714285714,0,1,-0.5612498234260587,5,5,5,5,3,4,2,6,3,4,3,1.2149857925879117,4.428571428571429,0,1.5714285714285714,4.5,3.8333333333333335,3.2559414990859232,0.10757398284279028,0,-0.4399935565827014,2,3,3,2,2,1,5,2,2,4,3,4,2,4,4,2,5,2,4,2,1.2798809468443688,2.4,0,4.2,0,4.2,0,4,0,4.133333333333334,0,1,1,2,3,2,2,1,1,2,2,1,3,4,3,1,4,1,2,2,1,0.998683343734455,1.85,0,"White, Caucasian, Anglo, European American",0,30,0,1,NA,1,3,6,Buyer,5,0,195,71,1,5,2,0,0,1,0,0,TRUE,TRUE,TRUE,TRUE,TRUE,1,0.9425088235069724,0.6938775510204082,0.04127507795380456,1,0.4783062500655651,0.5632906249910593,1,1,0.0023660960929056136,0.005120999577424275,1,0.6704624999761581,0.7851062500029802,1,1,0.0066649101651579355,0.019333574165954555,1.3366,0.6585,0.5808,1.0112,0.489,0.7427,0.2875,1.3887649483333333,0.7550760121156667,0.5700488475333333,2.9373,9.5596,0.3247,6.166,0.3251,-96.6711,0.8594,6.8062,0.4138,4.6255,0.4793,0.9988,1.7181256073666666,4.407087212666666,6.708255150666667,0.37166049426666664,0.35729657156666667,1.2772,4.7746,0.544,5.3608,0.6365,0.8655,0.436,0.183,0.9,0.011,1.313,119.36363636363636,2.4057557343333333,4.930169592333334,4.337816968666667,0.43074331423333334,0.5132876961666667,376,1.114074074074074,1,0,0,1,FALSE,FALSE,FALSE
380,2021-11-13T04:58:44Z,2021-11-13T05:23:00Z,1455,1,2021-11-13T05:23:02Z,1,Chrome,91.0.4472.101,Windows NT 10.0,1920,1080,i accidentally pressed the left button by mistake one time when i meant to press right button. i apologize,1.7777777777777777,734,51,352,98,55,93,-0.1418271804904488,-0.35252770646363196,-0.36349705755877526,-0.08020304117469244,-0.2340474968444512,-0.20905768367637165,3,4,2,2,3,1,2,3,1,3,3,1,1,1,3,3,1,1,3,2,0.9880869341680844,0,1,1,3,3,1.65,0,3,3,3,3,2,1,2,2,2,2,2,3,2,3,3,3,2,1,1,1,1,2,1,3,2,1,2,4,4,3,3,2,3,3,3,2,1,4,3,3,3,2,4,3,2,2,3,3,4,2,1,1,2,1,2,3,3,3,4,1,2,2,2,2,2,2,2,1,0.9291734839971293,0.6324555320336759,1.5,0,1.75,0,2.533333333333333,0,3,0,2.4166666666666665,0,1.3333333333333333,0,2.142857142857143,0,2,0,2.3513513513513513,0,2,1,2,-0.24841829690429024,-0.11380979753955131,0.4636802898581284,0.17493524615928857,3,2,2,3,2,3,3,2,3,0.5345224838248488,2.857142857142857,0,2.5,0.7614363551318132,3,3,3,3,1,1,3,3,3,2,2,0.9759000729485332,2.4285714285714284,0,3.5714285714285716,6,3.8333333333333335,3.2559414990859232,0.9547190977297628,0,1.0989729647608995,1,1,2,3,2,1,2,2,1,2,1,3,2,2,4,2,4,2,3,2,0.9411239481143202,1.8,0,4.2,0,3,0,3.8,0,3.6666666666666665,0,2,2,3,3,2,2,3,2,2,1,3,2,3,1,2,2,1,2,2,2,0.6407232755171874,2.2,0,"White, Caucasian, Anglo, European American",0,25,0,1,NA,1,2,7,teachers assistant,2,0,180,74,2,5,2,0,0,1,0,0,TRUE,TRUE,TRUE,TRUE,TRUE,4,1.058110256415147,0.7959183673469388,0.15869713456317064,4,0.5246548386850665,0.6333838709092909,0.96875,1,0.004584185439791447,0.00888904606916557,4,1.0098968750834465,1.0587093750089407,1,1,0.17764869062985938,0.10444602088562302,1.4053,0.9558,0.646,1.2492,1.0824,0.67,0.253,1.4556256916666668,0.9440533282666667,0.6300287208,1.217,3.4968,0.3572,4.7151,0.5043,-73.5881,0.9877,5.2386,0.436,5.0088,0.5204,0.8087,1.5135757855333334,4.701970824666667,4.025310944666667,0.4764252501333333,0.3404628823,1.9419,1.7317,0.4894,1.7718,0.5785,0.8165,0.209,0.227,0.278,0.022,1.724,78.36363636363637,2.841746074,2.1820706346666667,2.2757190576666666,0.33807352943333335,0.42276691203333333,104,0.3081481481481481,1,0,1,2,FALSE,FALSE,FALSE
381,2021-11-13T05:08:57Z,2021-11-13T05:23:39Z,881,1,2021-11-13T05:23:40Z,1,Chrome,95.0.4638.69,Windows NT 10.0,1280,720,None.,1.7777777777777777,556,35,156,24,21,60,-0.599174509616535,-0.4978835194745482,-1.307087927876477,-0.9819971246939154,-0.7036575244971758,-0.7664727867845231,3,3,2,1,3,1,1,3,1,3,3,2,1,1,3,3,1,1,3,3,0.9679060415469871,0,1,2,5,4,1.6,0,4,4,2,4,2,2,4,2,2,2,1,5,2,4,4,2,1,1,1,2,1,2,2,3,2,1,3,4,4,5,4,4,4,4,5,4,2,4,4,4,3,3,2,3,5,2,2,3,4,4,3,2,2,2,4,3,3,2,3,4,2,3,3,2,3,3,2,4,0.9617301726185599,1.2227992865708155,1.5,0,3,0,1.8666666666666667,0,1.7777777777777777,0,3.0833333333333335,0,2.3333333333333335,0,2.857142857142857,0,2.6666666666666665,0,2.6216216216216215,0,2,1,3,-0.08030789940053812,-0.2841605889021127,1.0321359503435148,0.37398768072070104,3,2,4,2,2,3,3,1,1,0.7559289460184544,2.4285714285714284,0,1,-0.048446712495193056,3,4,3,3,4,3,3,5,3,3,2,0.4879500364742666,3.2857142857142856,0,2.7142857142857144,5,3.8333333333333335,3.2559414990859232,0.38995568780511447,0,0.3385652752699547,3,2,2,3,2,2,2,1,3,4,3,3,3,2,3,3,3,2,2,3,0.7367883976130072,2.4,0,3.4,0,2.8,0,3.2,0,3.1333333333333333,0,2,3,3,2,2,1,1,3,2,2,2,3,1,1,1,3,2,2,2,1,0.7591546545162482,1.85,0,"Asian or Asian American (e.g., Chinese, Japanese, and others)",0,27,0,1,NA,1,3,6,Analyst,4,0,145,68,5,5,2,0,0,1,0,0,TRUE,TRUE,TRUE,TRUE,TRUE,6,0.6614451612907071,0.6326530612244898,0.03569860147862422,6,0.446868965517858,0.5515689655203244,0.90625,0.9354838709677419,0.0012688640222404957,0.011617231613029768,6,0.584534375000745,0.6309222222235468,1,0.84375,0.00786263845831985,0.009041415474200395,1.4064,0.4109,0.2124,0.9702,0.4842,0.45,0.3983,1.4239978346666666,0.5785699568848,0.21081498246666666,1.0241,3.6165,0.3291,2.4746,0.3631,-57.0743,0.8626,6.7711,0.3835,6.4165,0.4618,0.8621,1.1142239081666667,2.7444025366666667,3.8984518786666666,0.35668412693333335,0.3234643447,0.9293,3.9431,0.4785,2.5274,0.4788,0.9908,0.051,0.439,0.339,0.018,1.646,91.44444444444444,1.2349861221333334,3.5755475603333333,2.201844486466667,0.4080138118666667,0.4071332089,362,1.0725925925925925,1,0,0,1,FALSE,FALSE,FALSE
382,2021-11-13T04:51:25Z,2021-11-13T05:26:03Z,2078,1,2021-11-13T05:26:04Z,1,Chrome,95.0.4638.69,Windows NT 10.0,1920,1080,no,1.7777777777777777,1051,76,440,155,50,200,0.6726621640767946,-0.1254092486340754,0.060155986257335765,0.6144221312657902,-0.3031077950286754,1.5983185597349072,2,2,3,3,2,1,1,2,1,3,2,1,3,2,3,2,1,2,2,2,0.7254762501100116,0,1,2,5,4,2.3,0,3,4,2,4,3,2,4,2,2,2,2,4,2,3,2,2,2,3,2,1,2,2,2,5,2,2,2,3,4,5,4,3,3,4,4,3,3,3,3,1,3,2,4,2,2,3,3,4,3,1,3,1,2,1,2,4,3,1,3,2,2,1,1,1,2,2,3,2,1.1143346632595352,0.8837151016885368,2,0,2.25,0,2.3333333333333335,0,2.3333333333333335,0,2.5833333333333335,0,1.6666666666666667,0,2.2857142857142856,0,1,0,2.2432432432432434,0,3,2,2,-0.004658220523848765,-0.03134452808449325,1.0302083766821508,0.49943192429882877,4,1,3,1,1,2,1,3,3,1.2149857925879117,1.5714285714285714,0,3,0.17672552612270553,5,5,5,5,3,2,2,6,5,6,4,1.4638501094227998,4.142857142857143,0,1.8571428571428572,3.5,3.8333333333333335,3.2559414990859232,-0.4571894270818581,0,-0.563033266702152,3,3,3,2,2,3,4,3,2,2,2,3,2,3,3,3,3,2,4,3,0.6761234037828132,2.6,0,3.4,0,3.4,0,3.2,0,3.3333333333333335,0,2,2,2,2,2,3,2,3,1,3,1,3,2,1,1,3,1,2,1,3,0.7947194142390263,1.9,0,"White, Caucasian, Anglo, European American",0,20,0,1,NA,1,4,5,Student,1,0,115,68,2,5,2,0,0,0,0,0,TRUE,TRUE,TRUE,TRUE,TRUE,3,0.9112657894586262,0.76,0.060868902965406646,3,0.4458419354807946,0.49272187500447034,0.96875,1,0.005075200482594408,0.004040501761975548,3,0.5111193548402478,0.6237379310501033,0.96875,0.90625,0.012221135482674261,0.012102959021157341,1.2688,0.9072,0.5575,0.9582,1.0569,0.7023,0.3952,1.329237282,0.9195453396333333,0.5452337779666667,1.3223,3.7999,0.2803,5.6246,0.3752,-82.5134,0.7906,4.8356,0.3741,5.8565,0.4215,0.8557,1.3804529122,5.250431832,3.9779702136666666,0.367204972,0.27698896953333335,0.8867,2.8112,0.3932,3.5459,0.4973,0.99,0.077,0.314,0.402,0.009,1.501,166.77777777777777,1.4781992693333332,3.1990265993333336,2.1229092326,0.2823720437666667,0.3064200478333333,104,0.3081481481481481,1,1,3,4,FALSE,FALSE,FALSE
383,2021-11-13T04:57:17Z,2021-11-13T05:30:30Z,1993,1,2021-11-13T05:30:31Z,0.800000011920929,Chrome,95.0.4638.69,Windows NT 10.0,2560,1440,no,1.7777777777777777,1090,72,486,98,79,85,0.7728674777617236,-0.16174820188680444,0.2816109864339392,-0.08020304117469244,0.09744193443982496,-0.34418861776319626,4,4,3,3,3,1,1,4,2,4,4,1,1,1,4,4,1,1,3,3,1.3138933706635727,0,1,1,2,2,1.4,0,2,5,2,4,2,1,3,2,1,2,2,4,1,4,4,2,1,1,1,1,1,1,1,3,2,3,2,5,5,4,5,5,5,5,5,5,2,5,2,1,5,2,5,3,3,2,2,2,5,1,3,1,3,2,1,4,4,1,5,1,2,1,1,1,2,1,1,2,1.6562739034481113,1.2983506020002016,1.125,0,1.5,0,1.9333333333333333,0,1.1111111111111112,0,1.8333333333333333,0,1.6666666666666667,0,1.8571428571428572,0,1,0,1.6216216216216217,0,2,3,2,-0.9355695467008782,-0.8464149906209297,0.7985455023269348,-0.023934744146997478,5,1,3,1,1,1,1,2,2,1.5735915849388864,1.2857142857142858,0,2,-0.3631965189619651,4,4,4,4,3,2,2,6,6,1,2,0.9511897312113419,3.5714285714285716,0,2.4285714285714284,3,3.8333333333333335,3.2559414990859232,-0.7395711320441822,0,-0.3855401294975673,1,1,1,1,1,1,5,1,1,5,1,5,1,5,5,1,5,1,5,5,2.065591117977289,1,0,5,0,5,0,4.2,0,4.733333333333333,0,1,1,1,2,2,2,2,2,2,1,2,3,2,3,1,3,1,3,2,1,0.7451598203705946,1.85,0,"Hispanic of Latino (e.g., Mexican American, Central American, and others)",0,21,0,1,NA,1,3,4,student,3,0,175,72,3,5,2,0,0,1,0,0,TRUE,TRUE,TRUE,TRUE,TRUE,3,0.9097027026986754,0.7551020408163265,0.05944145246733419,3,0.3965599999984105,0.42300800000071526,0.9375,0.8064516129032258,0.005740791844718046,0.006204156129223249,3,0.4799562499979511,0.5804769230702749,1,0.8125,0.006886205120779053,0.01376526770087017,1.471,0.8056,0.4587,1.1981,0.8229,0.6139,0.3773,1.4907262863333333,0.8401764472333333,0.45159891096666666,0.9528,3.5055,0.2891,1.6044,0.2534,-48.9989,0.6154,3.9909,0.3317,3.3963,0.3542,0.9198,1.0091003823666667,1.9219698274333334,3.7771707736666666,0.2509721778,0.2857690896333333,0.7849,4.521,0.4058,2.3942,0.4583,0.7082,0.06,0.314,0.343,0.013,2.013,154.84615384615384,1.3132079508666668,3.3582679963333333,1.7546665333,0.2788356742,0.2935828446666667,380,1.125925925925926,0,0,1,2,FALSE,FALSE,FALSE
385,2021-11-13T05:15:13Z,2021-11-13T05:32:28Z,1034,1,2021-11-13T05:32:29Z,1,Edge,95.0.1020.44,Windows NT 10.0,1920,1080,"Nothing at all, good study",1.7777777777777777,637,33,206,25,30,65,-0.39105578119399015,-0.5160529961009127,-1.0663759711627776,-0.9698107181598719,-0.5793489877655722,-0.6820159529802577,3,4,1,2,3,1,2,3,2,4,3,2,1,2,3,3,1,2,3,4,0.998683343734455,0,1,2,3,3,1.65,0,1,4,2,4,2,4,1,4,3,4,4,1,2,2,3,4,4,1,1,2,5,4,2,2,3,3,6,1,2,3,3,1,2,3,2,3,2,3,2,2,3,2,3,2,4,4,5,5,1,1,2,1,2,1,1,2,3,2,4,2,2,1,1,3,1,1,2,2,1.1068989227681203,1.2227992865708155,2.875,0,1.5,0,3.4,0,3.7777777777777777,0,3.0833333333333335,0,1.8333333333333333,0,1.8571428571428572,0,1.6666666666666667,0,2.7567567567567566,0,1,3,6,0.8590089466516787,1.0237656859173703,1.3012516161271415,1.162508651022256,4,3,4,2,3,2,3,3,2,0.816496580927726,2.4285714285714284,0,2.5,0.5050347996663801,5,4,3,4,3,4,2,6,6,5,4,0.9759000729485332,3.857142857142857,0,2.142857142857143,3,3.8333333333333335,3.2559414990859232,-0.7395711320441822,0,-0.5448821243404407,2,3,2,2,3,2,3,2,3,2,3,3,2,3,2,3,2,2,3,3,0.5163977794943222,2.4,0,3.2,0,3,0,3,0,3.066666666666667,0,2,3,2,3,2,3,3,2,3,3,2,2,3,4,3,2,1,3,3,4,0.7451598203705946,2.75,0,"White, Caucasian, Anglo, European American",0,26,0,1,NA,1,3,7,Analyst,3,0,245,77,3,5,2,0,0,1,0,0,TRUE,TRUE,TRUE,TRUE,TRUE,NA,NA,NA,NA,1,0.5553562500004191,0.6876724137933604,1,0.90625,0.0037686831855083553,0.00822709515125445,1,0.6268749999995343,0.7294899999996026,1,0.967741935483871,0.003640157419403104,0.00866918346246709,NA,NA,NA,NA,NA,NA,NA,NA,NA,NA,1.4628,3.4859,0.3455,2.8196,0.4695,-46.0698,0.7787,5.7855,0.493,4.1173,0.5905,0.9989,1.6907357703333334,2.9529730093333333,3.9287107916666666,0.4401796117,0.3361209051,1.0793,6.791,0.5575,4.0002,0.5964,0.8984,0.087,0.453,0.498,0.017,1.937,113.94117647058823,1.9950197566666668,5.035253051,3.6752277513333333,0.4329729404,0.4724388344666667,104,0.3081481481481481,1,0,0,1,FALSE,FALSE,FALSE
386,2021-11-13T05:05:13Z,2021-11-13T05:32:44Z,1651,1,2021-11-13T05:32:45Z,1,Edge,95.0.1020.44,Windows NT 10.0,1504,1003,NA,1.4995014955134596,916,58,351,88,77,93,0.32579761670588653,-0.2889345382713561,-0.36831129669304924,-0.202067106515128,0.06981781516613529,-0.20905768367637165,4,4,2,3,4,1,1,2,1,3,2,1,1,1,4,4,1,1,4,4,1.353358395757909,0,1,1,3,4,1.4,0,3,5,1,5,1,1,5,5,1,1,1,5,3,5,3,1,3,2,1,1,1,1,1,1,2,5,30,5,5,3,5,5,5,5,5,5,2,3,1,1,3,1,5,1,1,1,1,1,3,5,1,1,3,1,1,5,5,5,5,1,1,1,1,1,4,3,2,4,1.8534927664912628,1.8516401995451028,1.375,0,3.25,0,1.6666666666666667,0,1.2222222222222223,0,1.4166666666666667,0,2.1666666666666665,0,2.5714285714285716,0,1,0,1.7297297297297298,0,1,5,6,-0.7128232700084064,-0.8071181603407025,2.2633264503338766,0.728104144996587,5,1,1,1,1,1,1,1,1,1.5118578920369088,1.5714285714285714,0,1,-0.5612498234260587,5,5,4,4,3,5,1,6,4,3,2,1.4638501094227998,4.428571428571429,0,1.5714285714285714,4,3.8333333333333335,3.2559414990859232,-0.1748077221195339,0,-0.5811844090638635,3,3,2,3,2,2,5,1,2,3,1,3,1,5,3,4,3,1,3,1,1.4074631010979937,2.6,0,4,0,3.6,0,4.4,0,4,0,1,1,1,4,2,2,2,4,2,1,1,4,1,2,1,4,1,1,1,1,1.1821033884786185,1.25,0,"Asian or Asian American (e.g., Chinese, Japanese, and others) & White, Caucasian, Anglo, European American",1,28,0,1,NA,1,4,6,Paralegal,3,0,185,71,1,5,2,0,0,0,0,0,TRUE,TRUE,TRUE,TRUE,TRUE,6,1.080965789474939,0.7755102040816326,0.10228046585675724,6,0.6184806451605213,0.6741781250014901,0.96875,1,0.0058794535384446905,0.002290326925558419,6,0.8018687499985099,1.1818312499988823,1,1,0.01266291189703509,0.0428753318935862,1.4397,0.8907,0.6637,1.2093,0.7367,0.7316,0.0426,1.483438917,0.8976515955,0.6484139199666666,1.4177,3.9458,0.4542,4.7529,0.5324,-84.9516,0.6276,7.2921,0.5693,7.3361,0.6385,0.8163,1.9183916426666667,5.4402376383333335,4.0450339809999996,0.5041740242333334,0.38747016366666664,1.3633,3.6758,0.6269,2.1918,0.9239,0.9966,0.355,0.297,0.712,0.003,1.26,420,3.8135186216666668,4.963829523333334,3.0717624526666665,0.4209525248,0.5571761149666666,104,0.3081481481481481,1,0,0,1,FALSE,FALSE,FALSE
387,2021-11-13T05:16:03Z,2021-11-13T05:39:11Z,1388,1,2021-11-13T05:39:14Z,1,Chrome,95.0.4638.69,Windows NT 10.0,1920,1080,NA,1.7777777777777777,652,81,321,94,63,109,-0.3525152759305559,-0.07998555706816408,-0.5127384707212689,-0.12894866731086665,-0.12355101974969247,0.06120418449727754,3,3,2,2,3,1,1,3,1,3,2,2,2,2,3,3,2,1,3,3,0.7863975156570492,0,1,2,3,3,1.85,0,4,4,2,4,3,2,4,2,1,2,1,4,2,4,3,3,1,1,1,1,1,2,1,2,2,0,0,5,5,5,5,5,5,5,5,2,2,4,1,1,5,1,5,3,1,1,1,2,5,1,5,1,3,1,1,2,2,1,5,1,2,1,1,1,1,1,2,2,1.8013175024810992,1.1464230084422218,1.375,0,1.5,0,2,0,1.3333333333333333,0,1.4166666666666667,0,1.8333333333333333,0,1.2857142857142858,0,1,0,1.4594594594594594,0,1,0,0,-0.8809336675121587,-0.780016898078477,-0.3773458880470143,-0.5786813930627457,5,1,3,1,1,1,1,1,1,1.5735915849388864,1.2857142857142858,0,1,-0.7321841937363471,5,5,5,5,2,2,1,4,7,4,3,1.8126539343499315,4.142857142857143,0,1.8571428571428572,3.5,3.8333333333333335,3.2559414990859232,-0.4571894270818581,0,-0.563033266702152,3,2,2,2,2,3,4,3,2,2,4,3,2,3,4,5,3,3,2,5,1.01418510567422,2.2,0,2.8,0,2.6,0,3,0,2.8,0,1,1,3,4,2,2,3,2,1,1,3,4,2,1,1,4,1,2,1,3,1.1192102478745307,1.7,0,"Hispanic of Latino (e.g., Mexican American, Central American, and others)",0,24,0,1,NA,1,3,4,Unemployed,5,0,210,71,2,5,2,0,0,1,0,0,TRUE,TRUE,TRUE,TRUE,TRUE,4,0.7435621621614775,0.74,0.06789574377568618,4,0.3636781249991618,0.42932258064492096,1,0.96875,0.0013591269254363163,0.0017928651612525723,4,0.6275843750010245,0.7153875000008848,1,1,0.024186089102635457,0.03304918241931183,1.2244,0.8724,0.4201,1.1279,1.019,0.458,0.1063,NA,NA,NA,1.2682,6.2031,0.2615,5.4657,0.3185,-103.7329,0.7547,6.9588,0.3109,6.2002,0.3723,0.9266,NA,NA,NA,NA,NA,1.4016,3.2755,0.4138,2.1626,0.4387,0.8915,0.11,0.312,0.323,0.011,1.149,104.45454545454547,NA,NA,NA,NA,NA,312,0.9244444444444444,1,0,0,1,FALSE,FALSE,FALSE
388,2021-11-13T05:04:05Z,2021-11-13T05:39:16Z,2110,1,2021-11-13T05:39:17Z,1,Chrome,95.0.4638.69,Windows NT 10.0,1920,1080,No feedback,1.7777777777777777,723,96,609,179,119,233,-0.17009021768363392,0.05628551762956986,0.8737623999496399,0.9068958880828354,0.6499243199136185,2.155733662843059,2,4,2,1,1,1,2,3,1,3,3,2,2,1,3,3,1,1,3,3,0.9679060415469871,0,1,1,4,3,1.8,0,1,4,1,4,1,1,4,1,2,1,1,5,1,5,4,1,1,1,1,1,1,1,1,0,3,0,0,5,2,2,2,5,4,3,3,2,3,4,1,1,1,1,2,2,1,1,1,1,5,1,1,1,1,1,1,1,1,1,4,2,2,1,1,1,1,1,1,1,1.3111900011894613,1.6818357317441643,1,0,1,0,1.6,0,2.888888888888889,0,1.9166666666666667,0,0.8333333333333334,0,1.2857142857142858,0,1,0,1.837837837837838,0,0,0,0,-0.8788322875433621,-0.9504644796634032,-0.7372407672780129,-0.843852623470708,5,1,4,1,1,1,1,1,1,1.7320508075688772,1.1428571428571428,0,1,-0.8176513788914915,5,5,5,5,5,3,1,3,3,3,3,1.5735915849388864,4.714285714285714,0,1.2857142857142858,6,3.8333333333333335,3.2559414990859232,0.9547190977297628,0,-0.17576299398208856,1,3,1,1,1,1,5,2,2,1,1,3,1,3,3,1,5,1,3,3,1.3972762620115438,1.4,0,4.6,0,3.8,0,3.4,0,3.933333333333333,0,1,2,2,1,1,3,1,1,3,3,1,1,1,3,1,1,1,3,1,3,0.9233805168766387,2.3,0,"White, Caucasian, Anglo, European American",0,21,0,1,NA,1,3,5,Student,3,0,128,72,1,5,2,0,0,1,0,0,TRUE,TRUE,TRUE,TRUE,TRUE,2,1.0293102040814655,1,0.09859358010217167,2,0.4410468749996508,0.47717741935435803,1,0.96875,0.0032872432157684856,0.003061271925413355,2,0.575545161290635,0.6538258064517811,1,0.96875,0.00419519589254329,0.010218741683451455,2.439,2.4106,0.5234,2.0204,2.3806,0.6014,0.3129,1.7029411363333333,1.5618830054666666,0.5739269538,1.3126,4.9508,0.3085,4.5674,0.3392,-84.8041,0.7641,7.0424,0.3872,7.4807,0.4226,0.9925,1.3622030582,4.459225837333333,4.9272405736666665,0.33379283103333335,0.3041500265666667,1.0492,5.3338,0.4727,4.0348,0.5261,0.8388,0.061,0.453,0.497,0.016,1.604,100.25,1.7640791858666667,5.281745749666666,3.2543399336666665,0.4138718530666667,0.39312762846666666,326,0.965925925925926,1,0,1,2,FALSE,FALSE,FALSE
389,2021-11-13T05:05:46Z,2021-11-13T05:42:35Z,2208,1,2021-11-13T05:42:37Z,1,Chrome,95.0.4638.69,Windows NT 10.0,1920,1080,All was great,1.7777777777777777,1278,56,495,92,85,138,1.2559084770634326,-0.30710401489772066,0.32493913864240515,-0.15332148037895377,0.18031429226089402,0.5510538205620167,4,4,1,1,1,1,1,4,1,3,3,2,1,1,4,4,1,1,3,2,1.3088765773505315,0,1,1,4,4,1.45,0,3,4,2,4,2,1,4,1,1,1,1,4,3,4,4,1,2,1,1,1,2,1,2,2,2,0,0,4,4,5,5,5,5,5,5,5,1,4,1,5,4,2,4,1,1,1,1,1,5,1,1,1,2,1,1,2,1,1,5,3,1,1,1,1,2,1,2,2,1.7849891277501346,1.3522468075656264,1.375,0,1.75,0,1.8,0,1.2222222222222223,0,1.6666666666666667,0,1,0,1.2857142857142858,0,1,0,1.3783783783783783,0,1,0,0,-0.9313667867632848,-0.9008110955901112,-0.2989446853297732,-0.5998778904599422,5,1,3,1,1,1,2,3,2,1.5275252316519468,1.4285714285714286,0,2.5,-0.09323549641962975,4,4,5,5,3,3,4,6,6,2,4,0.816496580927726,3.7142857142857144,0,2.2857142857142856,3,3.8333333333333335,3.2559414990859232,-0.7395711320441822,0,-0.465211126919004,2,2,2,2,2,2,4,3,2,2,1,4,2,2,3,1,3,2,3,3,0.9154754164341269,2,0,4,0,3.6,0,3,0,3.533333333333333,0,1,1,1,2,1,1,2,1,1,1,1,3,2,1,1,4,1,1,1,1,0.8207826816681233,1.4,0,"White, Caucasian, Anglo, European American",0,22,0,1,NA,0,3,6,student,2,0,209,75,1,5,2,0,0,1,0,0,TRUE,TRUE,TRUE,TRUE,TRUE,6,0.9160200000013624,0.7,0.06732935500430963,6,0.38051935483947874,0.4588612903241188,0.96875,0.96875,0.0013765612802592352,0.0042134138309262974,6,0.5822875000070781,0.6587000000039116,1,1,0.004372986290570565,0.005044798064375809,1.2717,0.6713,0.5656,1.1611,0.583,0.6195,0.2417,1.3324005125666667,0.7663639334903334,0.5533744223,1.2337,4.614,0.2519,3.9563,0.309,-78.2964,0.6149,7.2276,0.3402,5.24,0.403,0.9856,1.2795127698,3.9949110456666665,4.678475066666667,0.30587428716666665,0.24921877846666668,0.7902,4.7565,0.5031,4.1576,0.5803,0.9667,0.094,0.415,0.57,0.021,1.891,90.04761904761904,2.5031675296666664,5.966512821666667,4.682459473,0.3797760932,0.3985884116,348,1.031111111111111,1,1,2,3,FALSE,FALSE,FALSE
390,2021-11-13T05:17:40Z,2021-11-13T05:42:49Z,1509,1,2021-11-13T05:42:50Z,1,Chrome,95.0.4638.69,Windows NT 10.0,1536,864,n/a,1.7777777777777777,955,41,233,32,30,172,0.4260029303908155,-0.44337508959545463,-0.9363915145373799,-0.884505872421567,-0.5793489877655722,1.1253602904310211,1,1,3,2,1,2,3,1,2,1,1,3,2,2,1,1,2,2,1,1,0.7451598203705946,0,1,3,3,2,3.15,0,1,1,2,3,1,4,2,3,4,1,4,2,1,4,2,3,4,5,1,2,3,3,4,2,1,1,1,1,4,1,2,1,1,4,1,2,4,1,2,5,5,2,1,4,4,4,2,3,3,5,3,2,4,2,3,1,4,5,3,1,4,4,1,4,2,3,3,4,1.416865380869865,1.2344267996967353,3.125,0,3,0,3.1333333333333333,0,4.111111111111111,0,3.4166666666666665,0,3,0,2.857142857142857,0,3,0,3.4324324324324325,0,1,1,1,1.4347870581020314,1.3069738765576282,0.47614418274863685,0.8915590296531325,1,4,2,3,3,2,3,3,1,0.9759000729485332,3.4285714285714284,0,2,0.9188112583651991,2,3,1,4,1,1,4,6,6,1,2,1.3801311186847085,2,0,4,3,3.8333333333333335,3.2559414990859232,-0.7395711320441822,0,0.49084084213823703,2,4,4,1,3,3,5,3,1,5,1,1,2,4,3,5,2,4,1,5,1.6035674514745464,2.8,0,2.6,0,3.2,0,3.2,0,3,0,4,1,3,4,2,4,2,1,4,2,3,1,2,3,2,4,1,3,3,4,1.1367080817685316,2.65,0,"Asian or Asian American (e.g., Chinese, Japanese, and others)",0,28,0,1,NA,1,3,6,Channel Sales Executive,5,0,175,70,2,5,2,0,0,1,0,0,TRUE,TRUE,TRUE,TRUE,TRUE,NA,NA,NA,NA,6,0.6066812500001397,0.6667843750000466,1,1,0.006226837056508379,0.006555574909363486,6,0.8616967741943174,0.9403531250008382,1,1,0.07893153432282461,0.05423691740904169,NA,NA,NA,NA,NA,NA,NA,NA,NA,NA,6.1178,7.8635,0.2177,7.9104,0.2801,-73.6188,1.0142,4.0856,0.487,4.7608,0.5621,0.9336,2.326958474,4.836976943,4.860634414333333,0.4306160774,0.3679323422,1.372,2.3921,0.5655,2.3021,0.6637,0.96,0.127,0.48,0.367,0.024,2.04,85,2.6426243746666667,3.130962839,3.123808050666667,0.4317467385,0.5150716763333333,446,1.3214814814814815,1,0,0,1,FALSE,FALSE,FALSE
391,2021-11-13T05:25:05Z,2021-11-13T05:43:35Z,1110,1,2021-11-13T05:43:36Z,0.8999999761581421,Chrome,95.0.4638.69,Windows NT 10.0,1920,1080,NA,1.7777777777777777,610,53,248,53,41,69,-0.46042869066817177,-0.33435822983726743,-0.86417792752327,-0.6285913352066523,-0.42741633176027893,-0.6144504859368455,3,3,2,1,3,2,2,3,1,2,2,2,1,2,2,3,2,2,3,2,0.6708203932499369,0,1,1,4,4,2.05,0,5,3,2,5,1,1,5,2,1,1,1,5,1,5,5,1,2,1,1,1,2,2,2,1,2,0,0,5,5,5,5,5,5,5,5,5,1,5,1,1,4,1,3,3,2,2,2,1,4,1,1,1,2,1,1,2,2,2,4,3,3,1,1,1,1,1,1,1,1.6608004871923232,1.88477610139267,1.5,0,1,0,1.2666666666666666,0,1,0,1.6666666666666667,0,1.1666666666666667,0,2,0,1,0,1.4864864864864864,0,1,0,0,-0.7863715689162981,-1.0298324620027786,-0.5341482934814965,-0.7819903777421375,5,1,4,1,1,2,1,1,1,1.6761634196950514,1.2857142857142858,0,1,-0.7321841937363471,5,5,5,5,3,3,1,3,7,NA,4,1.5735915849388864,4.428571428571429,0,1.5714285714285714,4,3.8333333333333335,3.2559414990859232,-0.1748077221195339,0,-0.5811844090638635,3,3,3,3,3,3,4,4,2,3,1,3,4,3,4,5,4,2,3,5,1.1126972805283737,3,0,3.8,0,2.6,0,2.8,0,3.066666666666667,0,1,1,1,3,2,1,1,2,1,1,1,4,2,2,1,3,1,2,2,1,0.8750939799154206,1.45,0,"Asian or Asian American (e.g., Chinese, Japanese, and others)",0,18,0,1,NA,1,4,4,Student,7,0,155,66,3,5,2,0,0,1,0,0,TRUE,TRUE,TRUE,TRUE,TRUE,2,0.7696666666697233,0.78,0.031961580066280915,2,0.44071250000130385,0.5523066666672627,1,0.967741935483871,0.0019051456452254753,0.006930224924384986,2,0.6653833333333333,0.7348172413778716,1,0.90625,0.04471235178155551,0.031725883226724635,1.3594,1.0109,0.3813,1.0983,1.1429,0.5196,0.0525,1.3888821056666667,0.9831797971666667,0.37563232123333334,1.3642,5.3243,0.3126,4.3454,0.4024,-83.5166,0.8388,7.2914,0.3865,4.4362,0.4559,0.9988,1.4430003750333333,4.241663817666667,5.28843149,0.3923229829,0.30731157686666666,0.9691,3.7858,0.5321,2.7491,0.5671,0.9712,0.072,0.401,0.3,0.013,1.83,140.76923076923077,1.7414166936666666,2.7919908416666668,2.0722315811666667,0.3414093760333333,0.35088319156666664,274,0.8118518518518519,1,0,0,1,FALSE,FALSE,FALSE
392,2021-11-13T05:25:51Z,2021-11-13T05:44:15Z,1103,1,2021-11-13T05:44:16Z,1,Firefox,94.0,Macintosh,1440,900,n/a,1.6,595,52,228,68,39,81,-0.498969195931606,-0.3434429681504497,-0.9604627102087498,-0.44579523719599906,-0.4550404510339686,-0.4117540848066085,4,4,1,1,3,1,1,3,1,3,3,1,1,1,4,3,1,1,3,3,1.2258187382102494,0,1,1,3,3,1.35,0,5,5,1,5,1,1,5,1,1,1,1,5,1,5,4,1,1,1,1,1,1,1,1,1,2,0,0,5,5,5,5,5,5,5,5,5,1,5,1,1,5,1,5,1,1,1,1,2,5,1,1,1,1,1,1,2,2,1,5,1,1,1,1,1,2,1,1,2,1.921507791343088,2.007130147392398,1,0,1.5,0,1.0666666666666667,0,1,0,1.0833333333333333,0,0.8333333333333334,0,1.1428571428571428,0,1,0,1.0810810810810811,0,1,0,0,-1.3495414005538688,-1.5048788733706477,-0.3773458880470143,-0.9411123807088311,5,2,4,2,1,1,1,1,1,1.6035674514745464,1.4285714285714286,0,1,-0.6467170085812028,5,5,5,5,3,3,1,6,6,5,3,1.5735915849388864,4.428571428571429,0,1.5714285714285714,3,3.8333333333333335,3.2559414990859232,-0.7395711320441822,0,-0.8635661140261877,2,2,2,2,2,2,4,3,2,5,1,4,3,4,4,2,4,2,3,3,1.0997835284835873,2,0,4.2,0,3.8,0,3.6,0,3.8666666666666667,0,1,1,1,4,1,1,1,4,1,1,2,4,2,1,1,4,1,1,1,2,1.2085223687584246,1.15,0,"Asian or Asian American (e.g., Chinese, Japanese, and others) & White, Caucasian, Anglo, European American",1,27,0,1,NA,1,3,6,Resident Physician,3,0,185,68,3,5,2,0,0,1,0,0,TRUE,TRUE,TRUE,TRUE,TRUE,2,0.8535227272727273,0.88,0.050933766938775514,2,0.42275,0.5110967741935484,1,0.96875,0.0018581935483870968,0.004645725806451612,2,0.54721875,0.6763225806451613,1,0.96875,0.0036418538306451607,0.01374317641129032,1.4883,1.4713,0.4968,0.941,1.8402,0.6829,0.3638,1.476517582,1.2509136904666667,0.489719733,1.205,6.2489,0.3263,3.8165,0.3604,-91.1278,0.7566,7.2473,0.3715,5.0139,0.4381,0.9441,1.2706542058,3.869155314,5.883571829666667,0.3546000241666667,0.31962261556666666,1.1701,5.5721,0.4421,3.9597,0.5428,0.949,0.07,0.428,0.581,0.012,1.642,136.83333333333331,2.3257548526666665,5.717263074,2.732780398,0.3503155732,0.2643181354,400,1.1851851851851851,1,0,0,1,FALSE,FALSE,FALSE
395,2021-11-13T05:31:44Z,2021-11-13T05:52:30Z,1245,1,2021-11-13T05:52:31Z,1,Chrome,95.0.4638.69,Windows NT 10.0,1504,1003,NA,1.4995014955134596,668,34,292,57,76,83,-0.31140540364955943,-0.5069682577877305,-0.6523514056152145,-0.5798457090704782,0.05600575552929045,-0.3779713512849024,3,3,1,1,3,1,1,2,1,3,3,1,1,1,3,3,1,1,3,2,0.9679060415469871,0,1,1,3,3,1.6,0,5,5,1,5,1,1,5,1,1,1,1,5,3,5,4,1,1,1,1,1,1,1,1,0,2,0,0,5,5,4,5,5,5,5,5,5,2,5,2,1,5,2,5,1,1,1,1,1,5,1,1,1,3,1,1,1,1,1,4,1,2,1,1,1,1,1,1,1,1.8310796959315705,1.9444671200491874,1,0,1,0,1.2,0,1.1111111111111112,0,1.25,0,1.1666666666666667,0,1.1428571428571428,0,1,0,1.2162162162162162,0,0,0,0,-1.2654862018019926,-1.3895049283114589,-0.7372407672780129,-1.063372847794736,4,3,3,3,2,3,2,1,1,0.6900655593423543,2.5714285714285716,0,1,0.03702047265995151,5,5,5,5,4,4,2,2,2,4,4,1.1126972805283737,4.571428571428571,0,1.4285714285714286,7,3.8333333333333335,3.2559414990859232,1.5194825076544112,0,0.18628970840167225,1,1,1,1,1,1,3,2,2,1,1,1,3,5,4,2,2,1,1,5,1.4375905768565218,1,0,3.6,0,2.4,0,3.6,0,3.2,0,1,1,1,4,1,1,3,3,1,1,1,3,2,1,1,3,1,1,1,1,0.99472291830968,1.3,0,Other & Indo-Caribbean,1,20,0,1,NA,1,4,4,Student,5,0,160,67,3,5,2,0,0,1,0,0,TRUE,TRUE,TRUE,TRUE,TRUE,NA,NA,NA,NA,4,0.4689310344837863,0.586131250000326,0.9354838709677419,1,0.0034852344730692845,0.00726943318537662,4,0.6375593750008848,0.6912800000001986,1,0.967741935483871,0.011124307006188092,0.0058501418493306385,NA,NA,NA,NA,NA,NA,NA,NA,NA,NA,1.77,3.4214,0.2343,3.7869,0.3524,-47.7633,0.9009,5.5891,0.385,4.6276,0.496,0.9095,1.75482143,3.726779652333333,3.555121849,0.3500504916,0.23757021846666668,1.0765,4.0254,0.5037,5.1558,0.5943,0.9244,0.077,0.467,0.501,0.015,1.531,102.06666666666666,2.03693051,4.447729328,3.591878898,0.4101930699,0.42072480526666667,104,0.3081481481481481,1,1,6,7,FALSE,TRUE,FALSE
396,2021-11-13T05:13:28Z,2021-11-13T05:57:08Z,2619,1,2021-11-13T05:57:11Z,1,Chrome,95.0.4638.69,Windows NT 10.0,2560,1440,nope. thanks :),1.7777777777777777,740,106,778,177,104,156,-0.12641097838507512,0.1471329007613925,1.687368813641944,0.8825230750147484,0.44274342536094596,0.855098422257372,3,3,1,1,3,1,2,3,1,3,2,1,1,1,3,3,2,1,3,2,0.9176629354822471,0,1,2,3,3,1.7,0,2,3,3,3,2,1,2,3,2,1,3,3,2,3,3,3,3,1,1,1,2,3,1,7,3,0,0,4,2,2,3,3,4,4,5,3,1,4,3,1,3,2,3,5,3,3,4,4,2,2,5,1,3,1,1,5,5,3,2,4,2,3,3,2,2,1,3,3,1.2357293502329008,0.7367883976130072,1.875,0,2.25,0,2.6666666666666665,0,2.6666666666666665,0,2.8333333333333335,0,2.5,0,3.2857142857142856,0,2.6666666666666665,0,2.864864864864865,0,4,0,0,0.30424463488929604,0.3253274413308691,0.4671351414942582,0.39623129141256364,4,2,3,3,1,2,2,3,1,0.9759000729485332,2.142857142857143,0,2,0.14960659196890055,2,2,3,4,1,1,5,1,3,NA,1,1.5118578920369088,2,0,4,7,3.8333333333333335,3.2559414990859232,1.5194825076544112,0,1.6203676619875336,2,2,2,2,2,2,3,4,2,1,1,4,2,3,4,5,4,2,3,4,1.2227992865708155,2,0,4.2,0,2.4,0,3,0,3.2,0,2,1,2,3,3,3,2,3,1,3,2,3,2,2,1,4,2,3,2,2,0.8013147091860318,2,0,"Hispanic of Latino (e.g., Mexican American, Central American, and others) & White, Caucasian, Anglo, European American",1,23,0,1,NA,1,1,1,I am currently unemployed,2,0,180,64,1,5,2,1,1,0,0,2,TRUE,TRUE,TRUE,TRUE,TRUE,4,0.9562176470581223,0.68,0.2793249725054637,4,0.43659000000009934,0.49006250000139695,0.967741935483871,1,0.0031457607958959833,0.007933436612976649,4,0.5595531249996275,0.6307451612891689,1,1,0.00618939740918229,0.01118383389283409,1.6643,0.4697,0.3797,1.3951,0.3572,0.4827,0.1687,1.6414376966666666,0.57693646643,0.37836034453333334,1.1881,4.675,0.3147,3.7678,0.3324,-76.7705,0.9912,5.2569,0.3405,3.783,0.36870000000000003,0.9988,1.2893650960333334,3.924543972,4.763195532666667,0.3262376688333333,0.3076386798,1.4067,4.8444,0.4259,7.4547,0.525,0.9381,0.174,0.301,0.671,0.012,1.21,100.83333333333333,2.7087295196666665,5.057844810333333,4.230072207,0.29627059256666666,0.31555406333333336,356,1.0548148148148149,1,0,1,2,FALSE,FALSE,FALSE
397,2021-11-13T05:22:32Z,2021-11-13T05:58:30Z,2158,1,2021-11-13T05:58:31Z,1,Firefox,94.0,Windows NT 10.0,1920,1080,NA,1.7777777777777777,1406,42,356,66,36,126,1.5847874553114047,-0.43429035128227234,-0.3442401010216793,-0.47016805026408615,-0.49647662994450314,0.3483574194317798,2,1,3,2,1,2,3,1,2,1,1,3,2,3,1,1,3,3,2,1,0.8522416262267903,0,1,2,3,3,3.2,0,2,3,2,4,2,3,1,3,4,3,3,2,4,2,1,2,2,4,2,2,1,4,1,2,6,4,1,4,2,2,4,4,4,4,3,1,2,4,1,1,3,1,4,2,2,1,2,3,2,2,3,2,1,3,3,2,3,2,3,2,2,1,2,1,2,1,2,2,1.0368582714503825,0.9856107606091623,2.25,0,1.75,0,3.4,0,2.888888888888889,0,1.8333333333333333,0,2.3333333333333335,0,2.2857142857142856,0,1.3333333333333333,0,2.27027027027027,0,1,4,1,0.16765493691749705,0.5461059385456428,0.7040377919415024,0.6250718652435726,4,2,3,2,1,4,2,3,2,1.1338934190276817,2.2857142857142856,0,2.5,0.41956761451123586,4,3,5,3,2,3,2,1,6,2,3,1.0690449676496976,3.4285714285714284,0,2.5714285714285716,5.5,3.8333333333333335,3.2559414990859232,0.6723373927674386,0,0.4000851303296801,3,4,3,2,3,2,3,4,4,2,2,4,5,3,4,5,3,2,2,4,1.0997835284835873,3,0,3.8,0,1.8,0,2.6,0,2.7333333333333334,0,2,1,3,2,3,3,2,1,3,3,2,1,2,4,2,1,2,3,2,3,0.8506963092234007,2.75,0,"White, Caucasian, Anglo, European American",0,27,0,1,NA,1,3,2,Social Media Evaluator,1,0,125,67,2,5,2,0,0,0,0,0,TRUE,TRUE,TRUE,TRUE,TRUE,4,0.659921052631579,0.76,0.05257280979591836,4,0.41396666666666665,0.492,0.9375,0.967741935483871,0.002873047379032259,0.004380836559139786,4,0.57096875,0.6762333333333334,1,0.9375,0.005478869959677419,0.012644490927419356,1.1043,1.0221,0.3779,1.1379,1.0811,0.3688,0.1227,1.1631468325333334,0.9921793827333333,0.36912270906666667,0.9151,3.458,0.2929,3.7048,0.3738,-75.5589,0.8052,5.0633,0.3329,5.3172,0.415,0.9339,1.0188385201666668,3.862887070333333,3.828190277,0.36598912883333334,0.28765323373333335,0.9077,4.3778,0.4797,3.3109,0.5443,0.9011,0.095,0.349,0.447,0.008,1.39,173.74999999999997,1.8793842796666667,4.516477772,2.578401279,0.36485057946666666,0.3397501753,404,1.1970370370370371,1,0,9,10,FALSE,FALSE,FALSE
398,2021-11-13T05:29:21Z,2021-11-13T05:59:29Z,1807,1,2021-11-13T05:59:31Z,0.800000011920929,Chrome,95.0.4638.69,Windows NT 10.0,1366,768,NA,1.7786458333333333,714,96,535,129,96,141,-0.19321452084169444,0.05628551762956986,0.5175087040133647,0.2975755613806577,0.3322469482661872,0.6017279208445759,3,3,2,1,2,1,1,2,1,2,3,1,1,1,3,2,1,1,3,2,0.8335087534664907,0,1,1,4,3,1.8,0,3,3,4,3,4,3,2,4,3,3,4,1,2,2,3,4,5,1,1,4,4,3,4,2,2,0,0,4,4,4,4,3,4,5,5,2,3,4,5,3,2,3,4,4,5,5,5,5,2,1,1,1,3,3,1,3,1,1,3,3,3,2,4,3,2,1,3,1,1.3299506640356134,0.8837151016885368,3.25,0,1.75,0,3.466666666666667,0,2.111111111111111,0,3.8333333333333335,0,2,0,2,0,3,0,2.7567567567567566,0,1,0,0,1.0922621231881353,1.2135713119753146,-0.2989446853297732,0.4573133133227707,5,1,2,2,1,2,2,1,1,1.3451854182690985,1.8571428571428572,0,1,-0.39031545311577004,3,4,3,3,2,2,4,6,6,NA,2,0.816496580927726,2.7142857142857144,0,3.2857142857142856,3,3.8333333333333335,3.2559414990859232,-0.7395711320441822,0,0.09248585503105322,2,2,4,2,3,3,5,2,1,4,2,3,2,4,5,2,3,2,3,4,1.1952286093343936,2.6,0,3.4,0,4,0,4,0,3.8,0,1,1,3,4,3,3,4,2,1,2,3,1,1,4,1,1,1,3,1,2,1.1652874052533586,2.3,0,"White, Caucasian, Anglo, European American",0,24,0,1,NA,1,2,4,Facilities Associate,1,0,145,72,3,5,2,0,0,1,0,0,TRUE,TRUE,TRUE,TRUE,TRUE,5,0.8014235294136931,0.68,0.04385278122656727,5,0.47205937500111755,0.5308290322605641,1,0.96875,0.004809792167820138,0.002655889314569209,5,0.620862500000745,0.6988624999970198,1,1,0.007136965645262484,0.00993452693534001,1.2515,0.6311,0.4783,1.053,0.5323,0.5542,0.1974,1.3068776746666666,0.74189377811,0.46891970483333334,1.3223,4.414,0.3223,4.9259,0.4032,-82.7625,0.7883,5.1489,0.3943,5.4899,0.461,0.9894,1.4232364738333334,4.767842039333333,4.556030021,0.39344889163333335,0.3154069523,0.8908,3.7353,0.5189,3.4861,0.5884,0.9965,0.157,0.364,0.6,0.017,1.505,88.52941176470587,2.7572818536666666,5.373457525,4.180144253666667,0.36957318206666667,0.3739095814,338,1.0014814814814814,1,0,0,1,FALSE,FALSE,FALSE
399,2021-11-13T05:36:48Z,2021-11-13T06:03:32Z,1603,1,2021-11-13T06:03:33Z,0.800000011920929,Safari,14.1.2,Macintosh,1440,900,no,1.6,728,151,312,112,90,96,-0.1572433825958225,0.5559461248545944,-0.5560666229297347,0.09040665030191732,0.2493745904451182,-0.15838358339381242,4,4,1,1,3,1,2,2,1,4,4,1,1,1,4,4,1,1,4,3,1.3869694338832115,0,1,1,5,5,1.25,0,5,5,2,4,1,1,5,2,1,1,1,5,1,5,4,2,2,1,1,1,1,1,1,0,2,0,0,5,3,4,5,5,5,5,5,4,2,5,2,1,3,2,5,1,1,1,2,2,4,1,1,1,1,1,1,1,1,1,5,1,2,1,1,1,1,1,1,1,1.6934780387911346,1.8464895909600492,1.25,0,1,0,1.2666666666666666,0,1.4444444444444444,0,1.5833333333333333,0,1,0,1,0,1,0,1.3513513513513513,0,0,0,0,-1.0259288853591455,-1.195343742247085,-0.7372407672780129,-0.966292254762549,5,1,3,1,1,1,1,1,1,1.5735915849388864,1.2857142857142858,0,1,-0.7321841937363471,4,4,5,4,2,3,2,6,6,4,3,1.1338934190276817,3.7142857142857144,0,2.2857142857142856,3,3.8333333333333335,3.2559414990859232,-0.7395711320441822,0,-0.465211126919004,2,3,3,2,2,1,5,2,1,3,1,5,2,5,5,1,5,2,4,5,1.7674302033770737,2.4,0,4.8,0,4.2,0,4,0,4.333333333333333,0,2,2,2,3,1,2,2,3,1,2,2,3,2,3,1,3,1,2,1,2,0.7254762501100116,1.8,0,"White, Caucasian, Anglo, European American",0,19,0,1,NA,1,4,4,student,5,0,180,69,4,5,2,0,0,1,0,0,TRUE,TRUE,TRUE,TRUE,TRUE,4,1.0572750000000088,0.8,0.1248585453061265,4,0.4673124999999927,0.5667096774193454,1,1,0.0017731895161293113,0.007447879569892766,4,0.6508437500000018,0.7512812499999991,1,1,0.00877091028225865,0.014374337701611704,1.6265,0.9152,0.5529,1.1149,0.9783,0.7639,0.3042,1.616727955,0.9031028223333334,0.5446044045666667,6.0371,11.7819,0.2111,7.7142,0.1754,-90.8656,0.6156,6.7761,0.4256,7.103,0.5194,0.8162,1.861413353,4.588485566666667,6.164241064,0.3677930581,0.32210029646666666,1.1083,5.7375,0.5541,3.5283,0.6151,0.9072,0.179,0.335,0.557,0.01,1.261,126.1,2.832784471666667,4.848167180333333,4.015713539333333,0.3622195074333333,0.4025428498,423,1.2533333333333332,1,0,0,1,FALSE,FALSE,FALSE
400,2021-11-13T05:43:40Z,2021-11-13T06:04:13Z,1233,1,2021-11-13T06:04:14Z,1,Chrome,95.0.4638.69,Windows NT 10.0,1920,1080,Not at the moment.,1.7777777777777777,574,67,308,68,58,91,-0.5529259033004139,-0.20717189345271578,-0.5753235794668308,-0.44579523719599906,-0.19261131793391667,-0.2428404171980778,3,2,4,3,2,2,2,2,3,2,2,2,3,1,2,1,2,2,2,1,0.7451598203705946,0,1,2,3,3,2.75,0,4,4,3,4,3,2,3,3,3,2,3,3,2,4,3,2,4,3,1,1,2,2,2,5,2,0,0,4,3,3,3,2,4,2,3,3,3,4,3,3,3,3,4,4,4,3,4,4,2,1,3,1,4,5,1,3,3,3,3,2,2,1,1,1,1,2,2,2,1.067539057664702,0.7037315505489968,2.125,0,1.75,0,2.533333333333333,0,3,0,3.1666666666666665,0,2.8333333333333335,0,2.2857142857142856,0,1,0,2.7837837837837838,0,3,0,0,0.40931363332914156,0.3406202964645538,0.10724026226325957,0.22393027936390666,3,2,2,2,2,2,2,1,1,0.3779644730092272,2.4285714285714284,0,1,-0.048446712495193056,5,5,5,5,2,2,2,8,8,3,2,1.6035674514745464,4,0,2,1,3.8333333333333335,3.2559414990859232,-1.869097951893479,0,-1.1893165316865257,3,2,3,1,2,2,4,3,2,3,2,4,2,2,3,3,5,3,3,3,0.8837151016885368,2.2,0,4,0,3.4,0,3,0,3.466666666666667,0,2,1,1,3,1,3,2,2,3,2,1,1,1,1,3,2,1,3,3,2,0.8522416262267903,2.1,0,"Asian or Asian American (e.g., Chinese, Japanese, and others)",0,27,0,1,NA,1,1,6,Unemployed (looking for work),5,0,155,75,1,5,2,0,0,1,0,0,TRUE,TRUE,TRUE,TRUE,TRUE,4,0.657583333330495,0.84,0.033931699763547714,4,0.4494156249910593,0.5133548387173683,1,0.96875,0.001504668456669911,0.002098261775303195,4,0.530175000000745,0.5458258064485365,1,0.96875,0.00729695161271576,0.008443067006412225,1.3381,1.3508,0.3534,0.9577,1.3094,0.4758,0.1615,1.357052481,1.1792751746666668,0.34726076553333335,1.1987,6.5495,0.3579,4.8626,0.3949,-103.5884,0.7656,5.8217,0.388,7.1676,0.4607,0.9995,1.2347938447333333,4.627066082,5.997206139333334,0.3892229902666667,0.3517002640333333,0.8073,10.6153,0.4953,5.3869,0.4708,0.9596,0.071,0.333,0.344,0.064,1.107,17.296875,1.6401972448,3.8267213113333334,3.6187467696666666,0.3138410051,0.3355266712,482,1.4281481481481482,1,0,0,1,FALSE,FALSE,FALSE
401,2021-11-13T05:28:03Z,2021-11-13T06:05:32Z,2249,1,2021-11-13T06:05:33Z,1,Chrome,95.0.4638.69,Windows NT 10.0,1366,768,"I just think the credit card screen resolution adjusting might be off, I did it and it seemed like it filled my screen up too much. Possible I could've made a mistake but the blue box seemed the same to me",1.7786458333333333,733,84,429,238,57,79,-0.1443965475080111,-0.0527313421286173,0.007199355780321893,1.625893873591405,-0.2064233775707615,-0.4455368183283147,2,2,3,3,2,1,1,1,1,2,3,1,2,1,2,3,2,1,2,3,0.7880689256524124,0,1,2,4,4,2.2,0,3,4,2,3,2,2,3,3,1,1,1,2,1,3,2,2,3,1,2,1,3,1,2,2,2,0,0,4,4,3,4,2,5,3,5,2,2,4,1,2,3,4,5,4,4,3,5,3,3,1,1,1,3,1,1,3,1,1,3,2,1,1,1,1,3,2,2,1,1.4014149863491412,0.9411239481143202,1.875,0,2,0,2.3333333333333335,0,2.4444444444444446,0,2.8333333333333335,0,1.5,0,1.5714285714285714,0,1,0,2.189189189189189,0,1,0,0,-0.11603135887008498,-0.10829275486474121,-0.22054348261253207,-0.16441811873863665,4,2,3,1,1,1,2,2,1,1.1547005383792515,1.7142857142857142,0,1.5,-0.2912888008837234,4,5,5,3,2,2,2,5,6,2,3,1.3801311186847085,3.5714285714285716,0,2.4285714285714284,3.5,3.8333333333333335,3.2559414990859232,-0.4571894270818581,0,-0.24434927701640521,3,4,3,4,3,2,4,3,2,3,2,3,4,4,3,4,4,2,2,3,0.8451542547285166,3.4,0,3.8,0,2.6,0,3.4,0,3.2666666666666666,0,2,3,4,2,3,4,3,1,2,3,3,3,1,4,1,2,1,4,4,3,1.0894228312566052,2.85,0,"White, Caucasian, Anglo, European American",0,20,0,1,NA,1,3,4,Social Media Marketing Consultant,3,0,145,70,2,5,2,0,0,0,0,0,TRUE,TRUE,TRUE,TRUE,TRUE,6,0.7142608695522599,0.9387755102040817,0.04606242682832435,6,0.4968593749925494,0.5627468749843538,1,1,0.006203027653393122,0.009285269022583628,6,0.5375687500014901,0.6206133333365123,1,0.967741935483871,0.004393468669031301,0.006189920367911053,1.6554,1.9471,0.3393,1.4347,2.221,0.4107,0.1607,1.5209395823333334,1.4693117642333333,0.3396390426,3.2625,6.2661,0.2365,5.9128,0.2869,-71.5719,1.0865,4.7913,0.3823,4.5693,0.4416,0.9741,1.9320371896666666,4.607353527,4.617947727333333,0.35689395176666666,0.2878595722,1.0873,4.6061,0.4267,5.187,0.5175,0.921,0.072,0.404,0.543,0.016,1.706,106.625,1.9472140173333334,5.259739335,3.535939260666667,0.35736291026666667,0.3579516722,346,1.0251851851851852,1,0,0,1,FALSE,FALSE,FALSE
402,2021-11-13T05:47:34Z,2021-11-13T06:06:17Z,1122,1,2021-11-13T06:06:18Z,1,Chrome,95.0.4638.69,Macintosh,1440,900,NA,1.6,589,50,226,59,50,106,-0.5143853980369797,-0.36161244477681426,-0.9700911884772978,-0.555472896002391,-0.3031077950286754,0.010530084214718316,3,3,2,2,3,1,3,1,1,3,2,2,1,2,2,2,3,1,2,2,0.7591546545162482,0,1,2,4,2,2.25,0,5,4,3,4,1,2,4,3,1,1,3,5,1,3,1,1,2,1,1,1,1,2,1,0,2,0,0,5,5,5,5,3,5,4,5,3,1,5,1,1,5,1,5,2,1,1,4,3,4,1,1,1,2,1,1,1,1,1,5,2,2,1,1,1,1,1,1,2,1.7394037844978736,1.486446705914413,1.25,0,1.25,0,2.066666666666667,0,1.5555555555555556,0,1.5,0,1.1666666666666667,0,1.1428571428571428,0,1,0,1.4054054054054055,0,0,0,0,-0.9923068058583949,-0.8283152190386573,-0.6588395645607719,-0.7435773917997146,5,1,3,2,2,1,1,1,1,1.4638501094227998,1.5714285714285714,0,1,-0.5612498234260587,5,5,5,4,4,4,2,1,1,2,3,1.0690449676496976,4.428571428571429,0,1.5714285714285714,8,3.8333333333333335,3.2559414990859232,2.0842459175790595,0,0.5483424107854333,4,2,4,4,3,3,4,2,1,3,1,3,1,2,5,3,5,1,3,5,1.4735767952260144,3.4,0,4.2,0,3.6,0,3.4,0,3.7333333333333334,0,1,1,1,2,1,1,3,3,2,1,1,3,1,3,1,3,1,2,4,2,0.9880869341680844,1.75,0,"Hispanic of Latino (e.g., Mexican American, Central American, and others)",0,20,0,1,NA,1,3,4,Student,2,0,132,68,2,5,2,0,0,0,0,0,TRUE,TRUE,TRUE,TRUE,TRUE,2,0.9555676470521618,0.68,0.06973914989384754,2,0.443868965514775,0.5009233333309492,0.9354838709677419,0.967741935483871,0.004259775978709091,0.00417966184913946,2,0.6453000000026077,0.8535592592623499,1,0.84375,0.02115808128866165,0.10745541128122599,1.3682,0.5583,0.5597,1.2922,0.437,0.6117,0.2596,1.4159861156666667,0.6763124188426667,0.5482346053,1.1014,3.2815,0.3105,3.8371,0.371,-65.245,0.8261,3.9916,0.3513,6.1583,0.4297,0.9978,1.1989840528333333,3.8533917983333335,3.5106267386666667,0.3522525563,0.28205986023333335,1.2036,2.2669,0.4411,2.1413,0.5181,0.8822,0.072,0.384,0.222,0.011,2.043,185.72727272727275,1.68583136,3.09483933,1.3367423886,0.3645985992333333,0.33654922433333334,434,1.285925925925926,1,0,0,1,FALSE,FALSE,FALSE
403,2021-11-13T05:50:30Z,2021-11-13T06:08:38Z,1087,1,2021-11-13T06:08:39Z,0.8999999761581421,Chrome,95.0.4638.69,Windows NT 10.0,1920,1080,No feedback.,1.7777777777777777,601,39,219,52,63,55,-0.4835529938262323,-0.46154456622181916,-1.0037908624172158,-0.6407777417406959,-0.12355101974969247,-0.8509296205887885,3,3,2,2,3,1,1,3,1,3,3,1,1,1,3,3,1,1,3,3,0.9679060415469871,0,1,1,2,2,1.6,0,5,5,1,5,1,1,5,1,1,1,1,5,1,5,1,1,1,1,1,1,1,1,1,0,2,0,0,5,2,5,4,2,5,5,5,3,1,5,1,1,3,1,4,1,1,1,1,1,5,1,1,1,1,1,1,1,1,1,5,1,1,1,1,1,1,1,1,1,1.6970208837488947,2.02837021134844,1,0,1,0,1.2666666666666666,0,2,0,1.25,0,0.8333333333333334,0,0.8571428571428571,0,1,0,1.3243243243243243,0,0,0,0,-1.1982420428004914,-1.3143957157561477,-0.7372407672780129,-1.0258182415170802,5,1,3,1,1,1,1,1,1,1.5735915849388864,1.2857142857142858,0,1,-0.7321841937363471,5,5,5,5,3,3,1,4,6,NA,3,1.5735915849388864,4.428571428571429,0,1.5714285714285714,4,3.8333333333333335,3.2559414990859232,-0.1748077221195339,0,-0.5811844090638635,3,3,3,1,3,3,3,3,3,1,1,3,1,4,3,4,4,1,3,4,1.162919151265879,2.6,0,4,0,2.8,0,3,0,3.2666666666666666,0,1,1,1,4,1,1,1,3,1,1,1,4,1,1,1,4,1,1,1,1,1.145931016569864,1.05,0,"Asian or Asian American (e.g., Chinese, Japanese, and others)",0,24,0,1,NA,1,3,6,Engineer,4,0,150,68,1,5,2,0,0,1,0,0,TRUE,TRUE,TRUE,TRUE,TRUE,2,0.7124142857141793,0.7,0.039309959873567404,2,0.595386206896526,0.8112888888887785,0.90625,0.84375,0.03678772603827246,0.035974257419409954,2,0.5896406250006985,0.6788965517245233,1,0.90625,0.00668808313502301,0.014164024475889703,1.1518,0.7562,0.417,1.0679,0.8343,0.4583,0.2775,1.2104882078333334,0.83261225584,0.4090343694333333,1.4694,1.5872,0.1961,1.2929,0.4071,14.372,1.1446,1.9552,0.3775,1.7044,0.5681,0.9823,1.5150030173333333,1.4297012290333333,1.8307014931333334,0.3950824121,0.2014224211,0.7676,4.5745,0.5261,3.2925,0.5788,0.9165,0.063,0.418,0.381,0.01,1.515,151.5,1.8376209126666667,3.6903025426666667,2.3044361239,0.3376676608,0.32034338403333334,416,1.2325925925925925,1,0,2,3,FALSE,FALSE,FALSE
404,2021-11-13T05:40:44Z,2021-11-13T06:09:28Z,1724,1,2021-11-13T06:09:30Z,1,Chrome,95.0.4638.69,Windows NT 10.0,1920,1080,NA,1.7777777777777777,752,62,405,154,142,66,-0.09557857417432772,-0.2525955850186271,-0.10834238344225383,0.6022357247317466,0.9676016915610499,-0.6651245862194046,2,2,3,3,2,2,4,2,2,2,2,2,2,3,2,2,3,2,2,2,0.5712405705774795,0,0,4,4,4,2.8,0,4,4,2,4,2,2,4,2,2,2,2,4,2,4,4,3,3,4,2,3,3,3,3,0,2,0,0,4,4,3,3,2,4,4,4,3,2,4,4,2,3,2,4,3,4,4,4,4,3,2,1,2,2,1,1,2,1,1,4,1,2,1,1,3,2,2,1,2,1.179784680309035,1.0327955589886444,3,0,1.75,0,2,0,2.5555555555555554,0,3,0,1.6666666666666667,0,1.2857142857142858,0,1.6666666666666667,0,2.2972972972972974,0,0,0,0,0.6509723297407854,0.27838418348379973,-0.5020371591262895,-0.11182648782124491,5,2,4,1,1,2,2,1,1,1.5118578920369088,1.5714285714285714,0,1,-0.5612498234260587,4,4,4,4,4,4,2,6,6,6,4,0.7559289460184544,4,0,2,3,3.8333333333333335,3.2559414990859232,-0.7395711320441822,0,-0.6245531217618774,2,2,2,2,2,2,4,3,2,3,2,3,3,3,3,3,4,2,3,3,0.6399404734221844,2,0,3.8,0,3.2,0,3.2,0,3.4,0,2,2,3,1,2,3,3,2,3,4,3,2,2,3,2,2,1,3,3,3,0.7591546545162482,2.75,0,"Asian or Asian American (e.g., Chinese, Japanese, and others)",0,24,0,1,NA,1,3,4,Unemployed,5,0,140,71,1,5,2,0,0,0,0,0,TRUE,TRUE,TRUE,TRUE,TRUE,6,0.6824461538462112,0.78,0.0254157172897447,6,0.3969677419354839,0.4650322580645762,0.96875,0.96875,0.003397397903241063,0.0031957722479658583,6,0.751362500000163,0.852635483871124,1,0.96875,0.052318052742021635,0.04079592587698166,1.1844,1.1144,0.3892,0.6542,1.7165,0.5991,0.3232,1.2364699725,1.0464133407,0.3815628064666667,1.346,3.9301,0.2324,3.9569,0.304,-67.6205,0.8704,5.7306,0.3292,5.7346,0.3938,0.6288,1.3868139882333332,3.9870472096666667,4.096839979,0.30108098803333333,0.23125772276666667,1.4357,2.2825,0.4582,1.9416,0.5464,0.9994,0.086,0.426,0.272,0.018,2.086,115.88888888888889,1.9998773546666666,2.992488067,2.500392583,0.40849975493333335,0.4613892924,312,0.9244444444444444,1,0,0,1,FALSE,FALSE,FALSE
406,2021-11-13T05:43:51Z,2021-11-13T06:17:20Z,2008,1,2021-11-13T06:17:21Z,0.8999999761581421,Chrome,95.0.4638.69,Windows NT 10.0,1920,1080,Nope.,1.7777777777777777,1003,79,477,101,71,91,0.5493325472338051,-0.09815503369452862,0.23828283422547336,-0.04364382157256178,-0.013054542654933752,-0.2428404171980778,2,2,2,1,2,2,1,2,1,2,2,1,1,1,2,2,2,1,2,2,0.4893604849295929,0,1,2,1,1,2.15,0,2,3,3,3,3,3,3,3,4,2,3,2,2,2,2,3,3,1,1,2,2,2,2,4,2,0,0,2,2,3,3,2,3,2,2,2,4,2,3,1,2,3,2,4,3,4,4,3,3,1,2,1,3,3,1,2,2,2,3,3,3,2,3,3,2,1,2,2,0.837377573858532,0.6172133998483676,2,0,1.75,0,3.2,0,3.6666666666666665,0,3.4166666666666665,0,2,0,2.142857142857143,0,2.6666666666666665,0,3,0,2,0,0,0.46605089248665776,0.6663193947230869,-0.0958522115332568,0.285233591594915,3,3,2,2,1,3,3,8,8,0.7867957924694432,2.7142857142857144,0,8,2.7054013812357707,2,3,4,3,2,2,3,3,4,2,2,0.7559289460184544,2.7142857142857144,0,3.2857142857142856,5.5,3.8333333333333335,3.2559414990859232,0.6723373927674386,0,0.7984401174368636,2,2,2,3,2,3,2,3,2,3,3,2,3,3,3,4,3,3,2,3,0.560611910581388,2.2,0,2.8,0,2.4,0,3.2,0,2.8,0,1,2,1,2,2,1,2,2,2,1,3,2,1,1,1,2,1,1,1,1,0.6069769786668839,1.7,0,"Asian or Asian American (e.g., Chinese, Japanese, and others)",0,28,0,1,NA,1,2,4,Production Associate,2,0,172,63,1,5,2,0,0,1,0,0,TRUE,TRUE,TRUE,TRUE,TRUE,5,1.1143588235290611,0.85,0.1330453753595087,5,0.5862968749988359,0.723914814815477,1,1,0.01706993515127976,0.0318190651565032,NA,NA,NA,NA,NA,NA,NA,1.7527,1.0678,0.5267,1.7348,1.1165,0.5541,0.0017,1.6854949376666666,0.9862725909,0.5211704720333333,2.0539,4.2253,0.3432,3.2153,0.4045,-42.2278,1.049,4.0881,0.4541,2.8352,0.54990000000000006,0.9979,2.0568580923333335,3.1908621893333335,4.196093881333334,0.3960697274666667,0.3386272315,NA,NA,NA,NA,NA,NA,NA,NA,NA,NA,NA,NA,NA,NA,NA,NA,NA,104,0.3081481481481481,1,0,0,1,FALSE,FALSE,FALSE
407,2021-11-13T05:35:51Z,2021-11-13T06:17:27Z,2496,1,2021-11-13T06:17:29Z,1,Firefox,94.0,Windows NT 10.0,1920,1080,NA,1.7777777777777777,978,81,690,163,118,111,0.485098371794748,-0.07998555706816408,1.263715769825833,0.7119133835381386,0.6361122602767737,0.0949869180189837,2,2,1,1,2,1,2,1,1,3,1,1,2,2,3,2,1,1,2,2,0.6708203932499369,0,1,4,4,5,2.15,0,4,4,2,4,3,1,5,2,2,2,2,4,3,4,4,2,4,5,1,2,2,2,1,0,2,0,0,4,2,3,4,3,4,2,3,3,2,3,4,2,3,3,4,3,2,3,3,3,2,1,3,1,4,3,1,1,1,1,4,2,3,1,3,2,2,2,1,1,1.0126823418651703,1.162919151265879,2.375,0,1.5,0,2,0,2.888888888888889,0,2.75,0,2.5,0,1.4285714285714286,0,2,0,2.4864864864864864,0,0,0,0,0.37989431376598426,0.09109510320734764,-0.5804383618435307,-0.24467162931809153,5,2,3,2,1,1,2,4,3,1.3801311186847085,1.7142857142857142,0,3.5,0.4466865486650409,5,5,5,4,2,2,3,4,4,3,3,1.3801311186847085,3.7142857142857144,0,2.2857142857142856,5,3.8333333333333335,3.2559414990859232,0.38995568780511447,0,0.09955228300564435,3,2,2,3,2,3,4,3,3,2,4,4,4,3,4,3,4,2,2,3,0.7745966692414834,2.4,0,3.4,0,2.6,0,3.2,0,3.066666666666667,0,1,2,3,1,2,4,3,1,4,3,2,2,1,3,2,1,2,3,2,3,0.9665456669582609,2.75,0,"Black or African American & White, Caucasian, Anglo, European American & Native American/Alaskan Native/indigenous",1,22,0,1,NA,1,2,4,unemployed,2,0,175,71,1,5,2,0,1,0,0,1,TRUE,TRUE,TRUE,TRUE,TRUE,3,0.9356486486486486,0.74,0.04548373918367347,3,0.4035,0.49648387096774194,1,0.96875,0.002335741935483871,0.005007354838709677,3,0.6236875,0.6479333333333334,1,1,0.007072737903225805,0.003601374712643678,1.3642,0.8199,0.5492,1.1329,0.7492,0.6688,0.2176,1.409144932,0.8564538402033334,0.5392394712666667,1.7127,6.7862,0.2773,3.7058,0.2746,-78.7984,0.5564,5.9955,0.3587,5.1758,0.455,0.9841,1.5384239911666666,3.509800804,5.946905477333333,0.28388873223333333,0.2790939005,0.8994,4.5839,0.5276,4.7876,0.5621,0.9862,0.116,0.426,0.627,0.047,2.014,42.85106382978723,2.386049936,4.889918726,5.7047970926666665,0.3839209697666667,0.44913741,366,1.0844444444444443,1,0,2,3,FALSE,FALSE,FALSE
408,2021-11-13T05:51:41Z,2021-11-13T06:21:12Z,1771,1,2021-11-13T06:21:13Z,1,Firefox,94.0,Windows NT 10.0,1366,768,NA,1.7786458333333333,886,67,447,103,70,95,0.24871660617901806,-0.20717189345271578,0.09385566019725369,-0.019271008504474677,-0.026866602291778594,-0.1752749501546655,4,3,2,2,2,2,2,1,1,2,2,3,2,3,2,2,3,1,2,2,0.7451598203705946,0,1,3,3,4,2.45,0,2,2,3,3,2,2,1,3,2,4,2,1,1,2,4,3,4,1,1,2,3,3,3,1,2,1,3,5,5,3,5,1,5,5,5,4,2,5,5,2,3,2,4,4,4,5,5,3,1,5,1,1,2,1,3,1,2,1,4,2,2,2,3,3,2,1,2,2,1.5304712811230214,0.9611501047232549,2.5,0,1.75,0,3.066666666666667,0,1.7777777777777777,0,3.1666666666666665,0,2.3333333333333335,0,1.7142857142857142,0,2.6666666666666665,0,2.4324324324324325,0,1,1,3,0.4240232931107196,0.5799825163734255,0.43703746296079277,0.5085099896671091,1,5,1,4,5,5,5,8,8,1.889822365046136,4.857142857142857,0,8,3.9874091585629348,1,1,3,3,1,3,4,4,4,1,1,1.2535663410560174,2,0,4,5,3.8333333333333335,3.2559414990859232,0.38995568780511447,0,1.0556042520628854,3,2,3,3,3,2,4,3,3,3,2,3,3,3,4,1,4,2,3,4,0.8837151016885368,2.8,0,3.8,0,3.6,0,3,0,3.466666666666667,0,2,1,3,2,2,3,2,1,4,2,1,2,1,4,2,2,1,3,4,2,1.0052493799000692,2.5,0,"Asian or Asian American (e.g., Chinese, Japanese, and others) & Black or African American",1,26,0,1,NA,1,1,6,Sofware Engineer,2,0,174,75,3,5,2,0,0,1,0,0,TRUE,TRUE,TRUE,TRUE,TRUE,4,1.0241777777777779,0.9,0.23731179959183674,4,0.44315625,0.5109032258064516,1,0.96875,0.0019271038306451615,0.0035013941532258067,4,0.58715625,0.6489354838709678,1,0.96875,0.007011039314516129,0.007971757056451612,1.7476,1.2262,0.5016,1.829,1.4182,0.4351,0.0376,1.6768044493333334,1.1048674852666667,0.5008886107333334,1.2894,6.0733,0.337,4.3106,0.3671,-92.1749,0.8959,7.4996,0.3852,5.1272,0.4217,0.9743,1.3416576971333334,4.248877066,5.7325062136666665,0.36145406746666664,0.33041941376666667,0.8492,4.1692,0.4965,5.681,0.5655,0.9591,0.066,0.425,0.379,0.022,1.74,79.0909090909091,1.6106433509333333,4.147143566333333,3.7403202666666666,0.39328995833333336,0.4517361359,290,0.8592592592592593,1,0,2,3,FALSE,FALSE,FALSE
411,2021-11-13T06:00:24Z,2021-11-13T06:22:57Z,1353,1,2021-11-13T06:23:01Z,1,Chrome,95.0.4638.69,Windows NT 10.0,1536,864,Thanks!,1.7777777777777777,730,38,366,70,25,64,-0.15210464856069794,-0.4706293045350014,-0.2960977096789394,-0.421422424127912,-0.6484092859497964,-0.6989073197411108,3,3,1,1,3,1,2,3,1,3,2,1,1,2,3,3,1,1,2,3,0.9176629354822471,0,1,3,3,3,1.7,0,4,4,2,4,2,2,4,2,2,2,2,4,2,4,4,2,2,1,1,2,2,2,1,1,2,1,3,4,3,3,4,3,4,4,4,4,2,4,2,2,3,2,3,2,2,2,2,3,4,1,1,1,3,3,1,3,1,1,4,2,2,2,2,2,2,1,2,1,1.0419143849595252,1.0327955589886444,1.625,0,1.5,0,2,0,2.3333333333333335,0,2.25,0,1.6666666666666667,0,1.5714285714285714,0,2,0,2.081081081081081,0,1,1,3,-0.33877763556255713,-0.40543873752557247,0.35863626024355166,-0.023401238641010402,4,2,3,2,2,2,2,1,1,0.7867957924694432,2.142857142857143,0,1,-0.21938108280548152,4,4,4,4,2,2,2,6,3,3,3,1.0690449676496976,3.4285714285714284,0,2.5714285714285716,4.5,3.8333333333333335,3.2559414990859232,0.10757398284279028,0,0.11770342536735592,2,1,1,2,2,2,4,2,1,3,1,4,2,4,5,2,4,2,4,2,1.2649110640673518,1.6,0,4.2,0,3.8,0,4.4,0,4.133333333333334,0,2,1,2,2,1,2,3,2,2,1,1,3,1,2,1,3,1,2,1,2,0.7163503994113789,1.75,0,"White, Caucasian, Anglo, European American",0,30,0,1,NA,1,2,3,online English teacher,2,0,156,70,3,5,2,0,0,1,0,0,TRUE,TRUE,TRUE,TRUE,TRUE,4,0.8880444444815317,0.72,0.06306818393777351,4,0.4009281250089407,0.46428709674650626,1,0.96875,0.0019218633763511143,0.0016144851220517968,4,0.5431656249985098,0.5956124999970198,1,1,0.0034304281329476925,0.0025971462919820508,1.4035,0.6937,0.4728,1.0128,0.7541,0.6683,0.4679,1.437208188,0.7682442205,0.46480778666666667,1.2415,6.3702,0.3035,5.128,0.3502,-103.0728,0.589,5.8751,0.358,5.4756,0.417,0.9911,1.2195752273666667,4.749297814666667,5.813469494666666,0.3477273725,0.30059423986666667,0.7528,4.4168,0.468,6.327,0.5347,0.9817,0.265,0.251,0.935,0.019,1.422,74.84210526315789,1.6181462582666666,5.3597682503333335,5.675460036666666,0.39832908483333335,0.4633576292,370,1.0962962962962963,1,0,2,3,FALSE,FALSE,FALSE
412,2021-11-13T05:58:29Z,2021-11-13T06:24:39Z,1570,1,2021-11-13T06:24:40Z,1,Chrome,95.0.4638.69,Windows NT 10.0,1920,1080,Thank you,1.7777777777777777,708,91,394,98,85,91,-0.20863072294706814,0.010861826063658545,-0.1612990139192677,-0.08020304117469244,0.18031429226089402,-0.2428404171980778,3,3,2,3,1,1,1,2,1,2,4,1,1,1,2,2,2,1,3,2,0.9119095061289915,0,1,1,3,1,2,0,5,5,2,5,1,1,5,2,1,1,1,5,2,5,5,1,1,1,1,1,1,1,1,2,2,0,0,5,5,5,5,5,5,5,5,5,2,5,1,1,5,2,5,1,1,1,2,2,5,1,1,1,3,1,1,2,2,2,5,1,1,1,1,1,1,1,1,1,1.8318995212226723,1.9073791542572855,1,0,1,0,1.2,0,1,0,1.3333333333333333,0,1.1666666666666667,0,1.2857142857142858,0,1,0,1.2432432432432432,0,1,0,0,-1.2486751620516177,-1.3778901016276477,-0.5341482934814965,-0.9560191975545721,4,2,3,1,1,2,2,1,1,1.0690449676496976,1.8571428571428572,0,1,-0.39031545311577004,4,5,5,5,3,5,3,5,3,3,3,0.9511897312113419,4.285714285714286,0,1.7142857142857142,5,3.8333333333333335,3.2559414990859232,0.38995568780511447,0,-0.21913170668010262,1,1,1,3,2,1,4,1,1,3,2,3,3,5,4,3,4,1,4,1,1.3972762620115438,1.6,0,4.2,0,3.4,0,4.8,0,4.133333333333334,0,1,1,2,4,3,2,3,4,1,1,3,4,2,2,1,3,1,2,1,3,1.105012502906165,1.7,0,"White, Caucasian, Anglo, European American",0,28,0,1,NA,1,4,5,Pharmacy Technician,4,0,160,71,1,5,2,0,0,1,0,0,TRUE,TRUE,TRUE,TRUE,TRUE,6,0.8950650000000373,0.8,0.14038220096331552,6,0.5028870967742536,0.5890031250000466,0.96875,1,0.009335489667358142,0.006400432570549223,6,0.6751250000000583,0.7719312500000524,1,1,0.009164055483863232,0.010069130604860923,1.4946,0.9407,0.5099,1.2197,0.8037,0.5853,0.1072,1.512390132,0.9283288775,0.5011540336,1.9815,3.7683,0.2505,4.2352,0.3551,-52.668,0.9996,3.5642,0.3671,4.0902,0.4795,0.9655,1.8643689836666666,3.993652545333333,3.7510011586666665,0.35644956,0.2585597317,0.8238,3.293,0.5813,4.3458,0.6806,0.9775,0.258,0.294,0.68,0.012,1.459,121.58333333333334,2.7330343053333332,4.849151018666666,4.633326392666667,0.39696001243333334,0.4836768332333333,310,0.9185185185185185,1,0,0,1,FALSE,FALSE,FALSE
413,2021-11-13T06:00:49Z,2021-11-13T06:25:10Z,1460,1,2021-11-13T06:25:11Z,1,Chrome,95.0.4638.69,Windows NT 10.0,1920,1080,"I accidently clicked 'yes' for the question asking if I had color blindness. I am not color blind, I just couldn't go back and change that answer.",1.7777777777777777,684,49,383,88,49,71,-0.2702955313685629,-0.3706971830899965,-0.21425564439628159,-0.202067106515128,-0.31691985466552025,-0.5806677524151392,2,3,1,1,2,1,2,3,1,3,3,1,2,2,2,2,2,1,2,2,0.7181848464596079,0,1,1,5,5,2,0,3,3,4,2,2,1,4,4,4,2,2,2,1,2,2,2,5,5,1,1,2,3,2,1,2,0,1,4,1,2,3,2,4,5,3,2,2,2,4,3,1,1,1,4,4,5,5,2,1,2,2,1,4,4,2,1,1,1,3,4,3,2,4,3,1,1,1,1,1.3169032744413063,1.0600988273786194,2.625,0,1,0,2.933333333333333,0,3.111111111111111,0,3.6666666666666665,0,2.8333333333333335,0,2,0,3,0,3.081081081081081,0,1,0,1,0.9052393059652108,0.8551571185573803,-0.35769864658231576,0.24872923598753227,3,2,1,2,2,3,3,4,2,0.7559289460184544,2.857142857142857,0,3,0.9459301925190042,3,3,3,2,1,1,5,1,1,1,1,1.3972762620115438,2,0,4,8,3.8333333333333335,3.2559414990859232,2.0842459175790595,0,1.902749366949858,2,3,2,2,2,2,5,3,2,5,1,5,1,5,3,1,4,3,3,2,1.5118578920369088,2.2,0,4.2,0,4.6,0,3.8,0,4.2,0,3,1,2,3,3,4,3,3,2,1,1,2,2,4,2,2,1,3,2,1,0.9665456669582609,2.25,0,"Asian or Asian American (e.g., Chinese, Japanese, and others)",0,20,0,1,NA,1,2,3,Student,1,1,154,69,4,5,2,0,0,1,0,0,TRUE,TRUE,TRUE,TRUE,TRUE,6,0.6738153846156902,0.78,0.009187965555135062,6,0.48978666666671633,0.550767741935628,1,0.96875,0.0015078005057652406,0.005203675554450656,6,0.6447218750002794,0.7088931034484814,1,0.90625,0.0035990901512115633,0.005903986411279873,0.9629,1.3626,0.4822,0.6352,1.6177,0.5985,0.2086,1.0310826434333333,1.1535323644,0.47361246626666664,1.3265,7.0914,0.3963,3.8006,0.3838,-88.7918,0.5611,6.8057,0.4492,4.7466,0.501,0.9021,1.3898056025333334,3.8173859953333333,6.308909062333333,0.3768160613,0.3860226825,0.8699,4.3589,0.5609,4.0124,0.5995,0.9978,0.056,0.539,0.552,0.021,1.711,81.47619047619048,1.5446634708666667,4.383670789,2.9405725653333334,0.4698573117,0.4780919584666667,306,0.9066666666666667,1,0,0,1,FALSE,FALSE,FALSE
414,2021-11-13T05:55:54Z,2021-11-13T06:25:16Z,1761,1,2021-11-13T06:25:18Z,1,Chrome,95.0.4638.69,Windows NT 10.0,1920,1080,N/A,1.7777777777777777,657,73,564,108,66,217,-0.3396684408427445,-0.15266346357362218,0.6571216389073103,0.04166102416574309,-0.08211484083915795,1.8854717946694095,2,2,2,3,1,1,4,1,1,2,1,2,2,2,2,1,2,1,1,1,0.8013147091860318,0,1,1,3,4,2.8,0,1,3,4,4,2,2,1,4,3,3,3,1,1,2,1,4,5,2,3,4,5,4,4,3,5,2,2,5,1,3,3,1,1,2,2,1,3,4,5,4,3,2,2,3,3,4,5,5,2,1,1,1,4,2,3,3,1,1,4,2,1,1,3,2,3,4,2,3,1.34566370643293,1.1751393027860062,3.875,0,3,0,3.4,0,3.888888888888889,0,3.5833333333333335,0,2,0,1.7142857142857142,0,2,0,2.972972972972973,0,2,2,2,1.6155057354185651,1.5464328866888646,1.0623195110373578,1.3043761988631113,3,5,2,4,3,4,4,8,1,0.9759000729485332,3.857142857142857,0,4.5,2.0976820007665875,3,5,4,4,2,2,3,1,1,2,2,1.1126972805283737,3.2857142857142856,0,2.7142857142857144,8,3.8333333333333335,3.2559414990859232,2.0842459175790595,0,1.1857103901569273,1,1,3,3,3,1,5,1,1,4,3,5,3,5,3,2,4,2,5,3,1.505545305418162,2.2,0,4.2,0,4.2,0,4.2,0,4.2,0,3,1,1,2,1,4,1,2,4,1,3,1,4,4,2,2,1,1,1,1,1.2139539573337679,2.3,0,"Asian or Asian American (e.g., Chinese, Japanese, and others) & White, Caucasian, Anglo, European American",1,25,0,1,NA,1,3,3,"Self employed, small business owner",5,0,250,75,2,5,2,0,0,1,0,0,TRUE,TRUE,TRUE,TRUE,TRUE,5,1.099078787878833,0.66,0.1816251681795729,5,0.4906875,0.5499838709673814,1,0.96875,0.0036766604838679635,0.005559312217738711,5,0.6733093749993714,0.7148187499997439,1,1,0.005133095715753153,0.003255679637073336,1.8127,0.37,0.5117,1.5199,0.3622,0.5365,0.0056,1.65842499,0.5344582683906667,0.4453860561,1.3093,4.56,0.3471,4.0893,0.3973,-76.7959,0.9654,6.4544,0.4198,4.3837,0.4357,0.8721,1.4742645198666666,4.164875115,4.767745036,0.38325961356666666,0.33688516566666665,0.695,3.7767,0.6072,8.9835,0.6695,0.9076,0.15,0.467,0.745,0.014,1.058,75.57142857142857,2.4146511756666666,5.270926365,6.041331796333333,0.4499120692,0.5252522974666667,318,0.9422222222222223,1,0,0,1,FALSE,FALSE,FALSE
415,2021-11-13T05:35:59Z,2021-11-13T06:25:22Z,2962,1,2021-11-13T06:25:23Z,0.8999999761581421,Chrome,95.0.4638.69,Windows NT 10.0,1366,768,Nothing comes to mind.,1.7786458333333333,2006,111,382,84,102,104,3.1264076658487734,0.19255659232730382,-0.21906988353055556,-0.2508127326513022,0.4151193060872563,-0.02325264930698783,2,2,1,3,1,1,1,2,1,2,2,1,1,3,2,4,1,1,2,1,0.8645047258706176,0,1,3,2,2,2.2,0,1,1,5,2,5,4,1,5,5,4,5,1,1,1,1,5,5,5,5,5,5,5,2,7,3,6,4,1,1,1,1,1,1,1,1,1,5,1,5,5,1,5,2,5,5,2,5,5,1,5,4,3,5,3,5,5,5,5,2,4,5,2,5,5,1,1,1,5,1.8277967175922056,1.8973665961010275,4.625,0,2,0,4.533333333333333,0,5,0,4.666666666666667,0,4,0,4.571428571428571,0,4,0,4.621621621621622,0,4,6,4,3.107485513264368,3.0642971538182313,2.334331771931882,2.6993144628750567,1,5,1,5,5,4,5,8,4,1.889822365046136,4.857142857142857,0,6,3.24943380901417,2,2,1,2,1,1,5,5,4,2,1,1.4142135623730951,1.4285714285714286,0,4.571428571428571,4.5,3.8333333333333335,3.2559414990859232,0.10757398284279028,0,1.2330973892674701,2,2,3,1,2,2,5,2,2,3,1,5,1,4,5,4,5,1,3,3,1.533747356112131,2,0,4.8,0,3.6,0,4,0,4.133333333333334,0,3,2,3,2,1,2,3,1,3,1,4,2,3,2,2,3,2,3,3,2,0.812727700887249,2.55,0,"Black or African American & White, Caucasian, Anglo, European American",1,21,0,1,NA,1,1,3,looking for work,1,0,320,72,3,5,2,0,0,1,0,0,TRUE,TRUE,TRUE,TRUE,TRUE,6,1.0050303030284968,0.66,0.35278047198628726,6,0.581631034488308,0.6354387096791498,0.90625,0.96875,0.04088085032164549,0.01925458410334233,6,0.6779312500003725,0.7731965517257822,1,0.90625,0.010603903507950896,0.024875241936004457,1.8387,0.3747,0.2622,1.4993,0.3546,0.4482,0.3825,1.762766416,0.4836664355952333,0.2698842528,1.2592,1.8276,0.2817,2.9144,0.4287,-27.0881,1.3178,2.6684,0.3107,3.1616,0.418,0.9567,1.3710757315,3.058184762333333,2.138294317566667,0.4149429614333333,0.27436380016666667,0.9342,3.7507,0.5683,2.6794,0.606,0.9831,0.076,0.471,0.393,0.015,1.895,126.33333333333334,1.8425340516666666,3.551392126,2.218766964,0.4145029070333333,0.40118011396666664,250,0.7407407407407408,1,1,4,5,FALSE,FALSE,FALSE
416,2021-11-13T05:49:27Z,2021-11-13T06:28:23Z,2336,1,2021-11-13T06:28:24Z,1,Chrome,95.0.4638.69,Windows NT 10.0,1536,864,n/a,1.7777777777777777,981,249,436,103,173,219,0.49280647284743484,1.4462504795464564,0.040899029720239816,-0.019271008504474677,1.39577554030324,1.9192545281911157,4,3,1,1,3,1,2,2,1,3,2,2,1,1,3,3,2,3,3,3,0.9514531821875089,0,1,4,4,2,1.8,0,2,4,3,3,2,3,2,4,2,2,1,3,1,3,3,2,5,1,5,3,4,4,3,3,4,0,0,5,2,5,4,2,4,1,2,2,5,4,3,2,2,2,4,3,5,5,5,5,3,1,1,1,3,1,4,5,5,5,4,2,2,1,1,2,2,3,4,4,1.5265419517099195,0.9154754164341269,3.375,0,3.25,0,2.6666666666666665,0,3,0,3.5833333333333335,0,1.5,0,3.4285714285714284,0,1.3333333333333333,0,2.945945945945946,0,2,0,0,1.2876904602862478,1.0047948023338122,0.3745550047701899,0.6896749035520011,5,1,4,1,1,1,2,1,2,1.6761634196950514,1.2857142857142858,0,1.5,-0.5476903563491562,5,5,5,3,3,3,2,5,5,4,3,1.2535663410560174,4,0,2,4,3.8333333333333335,3.2559414990859232,-0.1748077221195339,0,-0.34217141679955326,3,3,2,2,3,2,2,2,2,3,3,4,4,3,4,4,4,4,4,3,0.8618916073713346,2.6,0,3.4,0,2.6,0,3.6,0,3.2,0,3,2,2,1,2,2,2,1,4,3,2,2,2,3,1,2,1,2,3,3,0.812727700887249,2.55,0,"Asian or Asian American (e.g., Chinese, Japanese, and others) & Black or African American & Filipino",1,22,0,1,NA,1,3,6,Unemployed,4,0,154,71,1,5,2,0,0,2,0,0,TRUE,TRUE,TRUE,TRUE,TRUE,1,0.9641349999999628,0.8163265306122449,0.2396209279680326,1,0.5557225806465553,0.6171225806462669,0.96875,0.96875,0.03558701982845939,0.041448591441573646,1,0.5955312499993015,0.7051241379318566,1,0.90625,0.020615922863058283,0.012352139959642681,1.897,0.8162,0.3032,1.5732,0.6684,0.4516,0.2006,1.78202581,0.8101473508333333,0.31501461903333333,1.2909,2.5532,0.3126,2.7065,0.3924,-35.3775,1.4057,3.3047,0.3205,3.8251,0.3943,0.7515,1.4099391891666666,2.9068948876666667,2.849963953,0.3808624238,0.30316186263333333,0.7286,4.7008,0.5058,3.2228,0.6217,0.9733,0.074,0.388,0.42,0.01,1.778,177.8,1.692813136,3.579409089,2.2401615252,0.3549519036666667,0.3664822308,104,0.3081481481481481,1,0,4,5,FALSE,FALSE,FALSE
417,2021-11-13T05:06:13Z,2021-11-13T06:29:12Z,4978,1,2021-11-13T06:29:13Z,1,Chrome,95.0.4638.69,Windows NT 10.0,1536,864,n/a,1.7777777777777777,1146,55,412,69,55,74,0.9167520307452114,-0.31618875321090295,-0.07464270950233591,-0.4336088306619555,-0.2340474968444512,-0.5299936521325801,2,4,1,2,2,1,2,2,2,3,4,2,1,2,2,2,1,3,3,3,0.8944271909999159,0,1,1,4,4,2,0,2,2,2,4,3,1,3,3,2,1,2,3,2,3,3,2,3,1,1,1,2,3,3,1,3,0,0,4,5,5,4,3,3,4,4,4,3,3,2,2,3,4,5,1,2,2,3,3,3,1,1,1,2,1,1,2,1,1,4,1,3,2,2,1,1,2,3,2,1.300842877595981,0.828078671210825,2,0,2,0,2.533333333333333,0,2,0,2.4166666666666665,0,1.3333333333333333,0,1.4285714285714286,0,1.6666666666666667,0,1.945945945945946,0,1,0,0,-0.1895796577779768,-0.07315790414621297,-0.22054348261253207,-0.1468506933793725,4,2,3,2,1,2,2,3,1,0.9511897312113419,2,0,2,0.06413940681375631,5,5,4,5,3,3,2,1,1,3,3,1.2149857925879117,4.142857142857143,0,1.8571428571428572,8,3.8333333333333335,3.2559414990859232,2.0842459175790595,0,0.7076844056283068,2,2,2,1,2,2,4,4,2,3,3,4,3,4,5,5,4,3,3,4,0.9154754164341269,1.8,0,3.6,0,2.8,0,3.4,0,3.2666666666666666,0,1,1,1,2,2,1,2,2,1,1,2,3,1,3,1,2,1,1,1,2,0.6863327411532597,1.65,0,"Asian or Asian American (e.g., Chinese, Japanese, and others)",0,24,0,1,NA,1,3,6,Student,3,0,180,70,2,5,2,0,0,1,0,0,TRUE,TRUE,TRUE,TRUE,TRUE,1,0.8029358974374258,0.78,0.10288383957514792,1,0.4724900000075499,0.6194903225879516,1,0.96875,0.003149394723406389,0.02702938641137846,1,0.5266593750044704,0.6167806451551375,1,0.96875,0.007120021845557834,0.007189200282562015,1.446,0.8995,0.38,1.2398,1.0396,0.4739,0.3544,1.462165844,0.9053857999666667,0.3746095535333333,1.7043,5.5711,0.3195,2.8659,0.3341,-57.2116,0.9161,4.8312,0.3838,2.6681,0.4638,0.8641,1.6780347743333333,2.9195239096666667,5.273016319666667,0.3364405176333333,0.3161498279666667,0.9913,4.2541,0.4192,4.4119,0.5064,0.9989,0.079,0.368,0.541,0.015,1.737,115.80000000000001,1.783931688,4.2782390789999996,3.946118373,0.31886237463333333,0.403732492,420,1.2444444444444445,1,0,0,1,FALSE,FALSE,FALSE
418,2021-11-13T05:31:03Z,2021-11-13T06:29:15Z,3492,1,2021-11-13T06:29:16Z,1,Chrome,93.0.4577.95,CrOS x86_64 14092.66.0,1366,768,NA,1.7786458333333333,1965,75,757,279,119,200,3.02106361812872,-0.13449398694725767,1.5862697918221902,2.125536541487191,0.6499243199136185,1.5983185597349072,3,4,2,1,2,1,1,2,1,2,2,1,1,1,3,2,1,1,4,2,0.9880869341680844,0,1,1,4,4,1.75,0,5,5,2,5,1,1,5,1,1,1,2,4,1,4,3,1,1,1,1,1,1,1,1,0,2,0,0,4,5,5,5,5,5,5,5,5,1,5,1,1,5,1,5,1,1,1,1,3,5,1,1,1,1,1,1,1,1,1,5,1,1,1,1,1,1,1,1,1,1.9234603452371197,1.7511900715418263,1,0,1,0,1.4,0,1.1111111111111112,0,1.1666666666666667,0,0.8333333333333334,0,0.8571428571428571,0,1,0,1.0810810810810811,0,0,0,0,-1.3495414005538688,-1.3616293442703125,-0.7372407672780129,-1.0494350557741627,5,2,3,1,1,1,1,1,1,1.5275252316519468,1.4285714285714286,0,1,-0.6467170085812028,5,5,5,5,2,2,1,6,6,3,3,1.8126539343499315,4.142857142857143,0,1.8571428571428572,3,3.8333333333333335,3.2559414990859232,-0.7395711320441822,0,-0.7042241191833141,2,2,2,1,2,2,3,5,1,1,2,2,2,5,3,2,4,2,3,4,1.2798809468443688,1.8,0,3.6,0,3,0,3.2,0,3.2666666666666666,0,3,1,2,3,2,3,2,3,1,1,2,3,2,3,1,3,1,2,1,2,0.8255779474818965,1.85,0,"White, Caucasian, Anglo, European American",0,26,0,1,NA,1,3,4,Student,3,0,120,69,3,5,2,1,0,1,0,1,TRUE,TRUE,TRUE,TRUE,TRUE,NA,NA,NA,NA,3,0.5402419354836306,0.6126464285709496,0.96875,0.875,0.01156988958670178,0.019860680393371594,3,0.6473906250004656,0.6828774193542139,1,0.96875,0.018634296361092623,0.01228533136089609,NA,NA,NA,NA,NA,NA,NA,NA,NA,NA,0.9916,3.3084,0.4048,1.9919,0.4475,-48.0429,0.9698,3.7038,0.399,3.1248,0.4472,0.7912,1.1164323498,2.2701856920333334,3.594871260666667,0.4337995141666667,0.3926972612,1.172,3.4099,0.4849,3.5056,0.5228,0.9821,0.081,0.441,0.402,0.036,1.658,46.05555555555556,1.892874129,3.3034448216666665,3.8781515173333334,0.3549524914,0.455068239,444,1.3155555555555554,1,0,0,1,FALSE,FALSE,FALSE
419,2021-11-13T06:10:15Z,2021-11-13T06:31:23Z,1267,1,2021-11-13T06:31:24Z,1,Chrome,95.0.4638.69,Windows NT 10.0,1280,720,N/A,1.7777777777777777,699,61,236,63,38,74,-0.23175502610512866,-0.26168032333180935,-0.9219487971345579,-0.5067272698662169,-0.46885251067081346,-0.5299936521325801,2,3,3,2,2,1,1,2,1,3,4,2,1,1,3,3,1,1,4,3,1.0399898784932577,0,1,2,4,3,1.75,0,4,5,3,4,3,1,5,1,2,1,1,5,1,5,3,1,1,1,1,1,1,1,1,0,2,0,0,5,4,5,5,3,5,5,5,5,2,5,1,1,4,2,5,2,1,1,1,1,5,1,1,1,3,1,1,1,1,1,4,2,1,1,1,1,1,2,1,1,1.757438075321173,1.6676187756655838,1,0,1.25,0,1.6,0,1.3333333333333333,0,1.3333333333333333,0,1.1666666666666667,0,1.1428571428571428,0,1,0,1.2972972972972974,0,0,0,0,-1.2150530825508667,-1.182761013339623,-0.6588395645607719,-0.9208002889501974,5,2,3,2,1,3,2,1,1,1.2724180205607036,2,0,1,-0.3048482679606258,5,5,5,5,2,2,2,6,6,NA,2,1.6035674514745464,4,0,2,3,3.8333333333333335,3.2559414990859232,-0.7395711320441822,0,-0.6245531217618774,2,2,2,1,2,2,4,3,2,4,1,4,1,4,5,1,4,2,3,2,1.3201731488169053,1.8,0,4.2,0,4.2,0,4,0,4.133333333333334,0,1,1,1,4,1,1,2,4,1,1,2,4,1,1,1,4,1,1,1,2,1.2085223687584246,1.15,0,"White, Caucasian, Anglo, European American",0,18,0,1,NA,1,2,4,Student,1,0,154,70,4,5,2,0,0,1,0,0,TRUE,TRUE,TRUE,TRUE,TRUE,3,0.6864157894747822,0.76,0.020677335118759067,3,0.47674375000037256,0.503734375,1,1,0.004740496088866463,0.0030912087798055524,3,0.5707999999960884,0.6603312499951571,1,1,0.007670987097170276,0.0053720435071775655,1.0871,1.137,0.4439,0.8739,1.2362,0.5193,0.0375,1.1463529553,1.0516235003333334,0.436481245,3.4622,7.0294,0.2305,8.5111,0.3003,-91.4818,0.7343,4.0541,0.3984,4.217,0.4317,0.9205,1.7407971617,5.681341099,4.924178302333333,0.35780459663333336,0.30146627423333333,1.3639,4.2975,0.4279,10.3982,0.5889,0.7502,0.213,0.234,0.63,0.014,1.507,107.64285714285714,2.2092552793333335,4.508141856666667,5.153715878666667,0.3283437052,0.45451588493333334,373,1.1051851851851853,1,0,1,2,FALSE,FALSE,FALSE
420,2021-11-13T06:08:31Z,2021-11-13T06:35:50Z,1638,1,2021-11-13T06:35:51Z,1,Chrome,95.0.4638.69,Windows NT 10.0,1366,768,No,1.7786458333333333,710,91,436,103,73,127,-0.20349198891194356,0.010861826063658545,0.040899029720239816,-0.019271008504474677,0.014569576618755927,0.3652487861926329,1,2,3,3,1,1,2,1,2,1,1,2,3,3,1,1,3,3,1,1,0.8944271909999159,0,1,1,4,4,3.2,0,5,5,5,5,5,3,3,2,2,2,1,2,1,2,2,1,1,1,1,1,1,1,1,3,3,0,0,5,5,5,5,5,5,5,5,5,1,5,1,1,3,3,5,1,1,1,1,1,5,1,1,1,1,1,1,2,2,1,5,1,1,1,1,1,1,1,3,3,1.8788374144747144,1.5583874449479591,1,0,2,0,2.6,0,1,0,1.3333333333333333,0,0.8333333333333334,0,1.1428571428571428,0,1,0,1.162162162162162,0,2,0,0,-1.299108281302743,-0.8110865594576713,-0.01745100881601569,-0.4142687841368435,3,3,3,2,1,4,4,4,3,1.0690449676496976,2.857142857142857,0,3.5,1.1304240299061954,5,5,5,5,5,5,1,6,3,3,2,1.5118578920369088,5,0,1,4.5,3.8333333333333335,3.2559414990859232,0.10757398284279028,0,-0.7586775462684484,4,2,4,1,4,3,2,2,4,2,2,3,2,4,4,4,4,4,2,2,0.9611501047232549,3,0,3.2,0,2.4,0,3.6,0,3.066666666666667,0,1,1,1,1,1,1,1,3,2,1,2,3,4,3,1,3,1,2,1,2,0.9665456669582609,1.75,0,"Hispanic of Latino (e.g., Mexican American, Central American, and others)",0,24,0,1,NA,1,2,4,Electrician,2,0,160,68,2,5,2,0,0,0,0,0,TRUE,TRUE,TRUE,TRUE,TRUE,4,0.7355128205143489,0.78,0.018103193469785672,4,0.5343187500033527,0.5253437499981374,1,1,0.006318385443325065,0.005184663830345921,4,0.624512499999255,0.6447625000011176,1,1,0.014636934033323043,0.01141505403108044,1.1163,1.2149,0.4766,0.9123,1.4104,0.5582,0.2338,NA,NA,NA,1.7509,5.2282,0.3669,5.4502,0.3647,-83.5464,1.0174,4.1937,0.4169,4.3996,0.4144,0.9993,NA,NA,NA,NA,NA,1.0057,5.2918,0.532,6.266,0.5714,0.8281,0.299,0.133,0.609,0.078,1.879,24.08974358974359,NA,NA,NA,NA,NA,376,1.114074074074074,1,0,0,1,FALSE,FALSE,FALSE
421,2021-11-13T06:14:26Z,2021-11-13T06:38:03Z,1417,1,2021-11-13T06:38:04Z,1,Chrome,95.0.4638.69,Windows NT 10.0,1536,864,NA,1.7777777777777777,613,59,296,77,47,76,-0.45272058961548495,-0.2798497999581739,-0.6330944490781186,-0.3361175783896071,-0.34454397393920994,-0.4962109186108739,3,2,2,2,2,2,2,1,1,1,1,2,1,3,2,1,2,1,2,1,0.6569466853317864,0,1,2,3,2,2.6,0,3,3,3,3,5,3,2,2,4,2,3,2,3,3,1,3,4,1,1,3,3,3,3,1,2,0,0,1,1,1,1,1,1,1,1,2,4,3,3,2,1,3,1,3,4,3,3,4,2,1,1,1,5,4,1,2,1,1,3,2,3,2,3,3,2,1,1,1,1.1823273226555742,0.9411239481143202,2.625,0,1.25,0,3.3333333333333335,0,4.888888888888889,0,3.5,0,2.5,0,1.7142857142857142,0,2.6666666666666665,0,3.324324324324324,0,1,0,0,1.0565386637185885,1.131589993632082,-0.4557470907642554,0.3379214514339133,4,1,1,3,1,1,1,6,4,1.2535663410560174,2,0,5,1.1711024311369027,1,1,1,1,1,1,5,1,3,NA,1,1.5118578920369088,1,0,5,7,3.8333333333333335,3.2559414990859232,1.5194825076544112,0,2.178064643937591,2,2,3,2,2,2,3,2,2,3,3,4,2,3,3,4,4,3,3,2,0.7432233529572065,2.2,0,3.6,0,3,0,3.6,0,3.4,0,3,4,4,1,3,4,4,1,4,3,4,1,3,4,2,1,1,4,3,3,1.2258187382102494,3.45,0,"White, Caucasian, Anglo, European American",0,28,0,1,NA,1,1,3,Freelancer,1,0,240,69,1,5,2,0,0,1,0,0,TRUE,TRUE,TRUE,TRUE,TRUE,6,0.8768894736843037,0.76,0.04784965851428018,6,0.4332187500001164,0.5639620689654338,1,0.90625,0.0036773989919290976,0.012763782540322843,6,0.6304531250001164,0.7131000000000771,1,0.9354838709677419,0.010998278054415623,0.017029244989220656,1.5639,0.7858,0.3847,1.0069,0.93,0.6839,0.4725,1.5569532443333334,0.8183748551333333,0.3816312024333333,1.4955,4.3568,0.2616,2.4488,0.3011,-49.7371,0.8092,5.6466,0.3641,3.4018,0.4514,0.9836,1.52887165,2.619697196,4.432945746,0.3009599763333333,0.2598534442666667,1.1621,5.6126,0.525,3.1085,0.537,0.9671,0.073,0.454,0.421,0.02,1.962,98.1,1.9644894536666666,3.557726474,2.730298211,0.3502406294666667,0.3982618257,330,0.9777777777777777,1,0,1,2,FALSE,FALSE,FALSE
422,2021-11-13T06:12:48Z,2021-11-13T06:38:04Z,1516,1,2021-11-13T06:38:05Z,1,Chrome,95.0.4638.69,Windows NT 10.0,1920,1080,you didn't ask what sort of area I grew up in - I lived in a rural environment. this fact might change the context of my answers and you might want to think about including it in addition to the general descriptors you asked for,1.7777777777777777,730,55,358,80,63,95,-0.15210464856069794,-0.31618875321090295,-0.33461162275313133,-0.29955835878747644,-0.12355101974969247,-0.1752749501546655,4,4,2,3,3,2,1,3,1,3,3,2,1,2,4,3,2,2,3,3,0.9445132413883326,0,1,1,3,3,1.75,0,3,4,3,5,5,4,4,4,3,3,3,4,2,3,5,2,3,1,1,1,2,3,2,0,2,0,0,5,5,4,5,4,5,4,5,4,4,4,2,2,4,2,5,3,2,3,3,3,5,1,1,1,4,1,1,1,1,1,3,5,4,1,1,2,2,1,1,2,1.5456030825826172,0.8997354108424374,1.875,0,1.5,0,2.7333333333333334,0,1.4444444444444444,0,2.4166666666666665,0,1.3333333333333333,0,2.142857142857143,0,1.3333333333333333,0,1.9189189189189189,0,0,0,0,-0.28414175637383765,-0.05254158678244845,-0.5804383618435307,-0.3164899743129896,5,1,3,1,1,2,2,1,3,1.4638501094227998,1.5714285714285714,0,2,-0.19226214865167657,5,5,5,5,3,3,2,7,6,4,4,1.2909944487358056,4.285714285714286,0,1.7142857142857142,2.5,3.8333333333333335,3.2559414990859232,-1.0219528370065065,0,-0.9250859690859132,3,2,3,4,3,3,4,4,3,3,2,5,3,4,5,3,5,1,3,4,1.1254628677422756,3,0,4.4,0,3.2,0,3.2,0,3.6,0,2,1,1,4,3,1,2,3,2,2,2,3,1,2,2,3,1,2,1,2,0.8583950752789521,1.7,0,"White, Caucasian, Anglo, European American",0,30,0,1,NA,1,4,6,lab tech,3,0,200,72,3,5,2,0,0,1,0,0,TRUE,TRUE,TRUE,TRUE,TRUE,5,1.024551282060452,0.78,0.12727284498194968,5,0.46216874999552965,0.5212968750074506,1,1,0.002162136411175593,0.0027128699890755547,5,0.6470156249962747,0.6697687500044703,1,1,0.009070872974773648,0.0024780306057277605,1.6172,0.8247,0.4692,1.3214,0.9742,0.6137,0.1575,1.6046456226666668,0.8410544200333333,0.46435663303333335,2.6865,8.1984,0.2983,8.0076,0.3535,-104.7677,0.4448,5.947,0.4342,6.2065,0.4877,0.7304,1.4687722123,5.5383699276666665,5.714797545333333,0.39601120543333335,0.3383169759333333,0.8665,2.8785,0.537,7.179,0.6059,0.9537,0.222,0.356,0.781,0.034,1.492,43.882352941176464,2.2207684976666666,4.486569167666667,6.199458039666666,0.4019442422,0.5015066812333333,350,1.0370370370370372,1,0,0,1,FALSE,FALSE,FALSE
423,2021-11-13T06:14:48Z,2021-11-13T06:39:35Z,1486,1,2021-11-13T06:39:36Z,1,Chrome,95.0.4638.69,Windows NT 10.0,1536,864,NA,1.7777777777777777,650,68,454,141,61,74,-0.3576540099656805,-0.1980871551395335,0.1275553341371716,0.4438124397891804,-0.15117513902338214,-0.5299936521325801,4,3,2,1,4,1,1,3,1,3,3,1,1,2,3,3,1,2,3,3,1.0699237552766379,0,1,3,3,4,1.55,0,4,5,2,5,2,1,4,1,2,2,1,5,1,5,4,1,2,1,1,1,1,2,1,1,2,0,0,5,2,4,5,3,4,4,5,3,2,4,2,1,4,2,3,4,2,4,5,3,4,1,1,1,1,1,1,2,3,1,4,2,2,1,1,1,2,5,1,2,1.4184540923174116,1.6676187756655838,1.25,0,2.5,0,1.4666666666666666,0,2.111111111111111,0,2.6666666666666665,0,1,0,1.7142857142857142,0,1,0,2,0,1,0,0,-0.6224639313501394,-0.8306381843754198,-0.06374107717804986,-0.44718963077673485,5,1,4,1,1,2,2,1,1,1.6035674514745464,1.4285714285714286,0,1,-0.6467170085812028,4,5,5,5,4,4,2,2,4,1,4,1.0690449676496976,4.428571428571429,0,1.5714285714285714,6,3.8333333333333335,3.2559414990859232,0.9547190977297628,0,-0.01642099913921513,2,2,1,1,1,2,4,2,1,2,2,4,1,3,3,4,3,2,3,5,1.162919151265879,1.4,0,3.8,0,3.2,0,3.2,0,3.4,0,1,1,2,1,1,1,1,4,1,1,2,4,2,2,1,3,1,1,1,2,0.9880869341680844,1.45,0,"White, Caucasian, Anglo, European American",0,23,0,1,NA,1,3,3,Student,2,0,175,69,3,5,2,0,0,1,0,0,TRUE,TRUE,TRUE,TRUE,TRUE,2,1.0948484848475817,0.66,0.09997247807750388,2,0.5434656249992549,0.5771333333363136,1,0.9375,0.0026197100701820337,0.003534897086750826,2,0.7010812499998137,0.7680677419343303,1,0.96875,0.01163892931499311,0.009189492006699131,1.3902,0.4795,0.6616,1.4527,0.3476,0.6477,0.0385,NA,NA,NA,1.2567,5.3942,0.427,3.4364,0.4179,-79.2162,0.8072,4.9136,0.4677,4.9488,0.4993,0.9627,NA,NA,NA,NA,NA,1.0346,3.7177,0.5794,3.8763,0.6396,0.9956,0.08,0.479,0.376,0.014,1.647,117.64285714285714,NA,NA,NA,NA,NA,104,0.3081481481481481,1,0,0,1,FALSE,FALSE,FALSE
424,2021-11-13T06:20:30Z,2021-11-13T06:42:15Z,1305,1,2021-11-13T06:42:18Z,0.8999999761581421,Chrome,95.0.4638.69,Windows NT 10.0,1920,1080,thanks homies,1.7777777777777777,715,39,317,66,48,73,-0.19064515382413216,-0.46154456622181916,-0.5319954272583648,-0.47016805026408615,-0.3307319143023651,-0.5468850188934331,3,3,1,1,3,1,1,3,1,3,3,1,2,1,3,3,1,1,3,3,0.998683343734455,0,1,1,3,3,1.55,0,5,3,3,3,3,1,4,2,2,1,1,5,1,5,5,1,1,1,1,1,1,1,1,2,3,0,1,5,3,2,3,5,5,1,1,2,1,5,1,1,3,1,5,3,1,1,1,1,1,1,5,3,4,2,1,2,1,1,5,1,1,1,1,1,2,2,2,2,1.5835111327387337,1.5796322658258457,1,0,2,0,1.7333333333333334,0,3,0,1.3333333333333333,0,3.1666666666666665,0,1,0,1,0,2,0,1,0,1,-0.7779660490411104,-0.8234757079204031,-0.04409383571335133,-0.43378477181687725,2,5,1,5,5,5,5,8,3,1.7320508075688772,4.857142857142857,0,5.5,3.0649399716269796,3,3,3,2,1,1,5,3,3,2,1,1.3972762620115438,2,0,4,6,3.8333333333333335,3.2559414990859232,0.9547190977297628,0,1.3379859570252095,1,1,1,1,1,1,4,1,1,5,1,5,1,5,5,1,5,1,5,3,1.9444671200491874,1,0,5,0,4.8,0,4.6,0,4.8,0,1,1,1,4,4,2,1,4,1,1,2,4,1,1,1,4,1,2,1,2,1.2763022245616642,1.35,0,"Hispanic of Latino (e.g., Mexican American, Central American, and others)",0,29,0,1,NA,1,2,6,Marriage and Family Therapist Trainee,4,0,210,70,2,5,2,0,0,1,0,0,TRUE,TRUE,TRUE,TRUE,TRUE,1,0.8424874999985099,0.8163265306122449,0.07305979612325515,1,0.4810999999960264,0.5228374999994412,1,1,0.0029253227586011213,0.0053127682261253995,1,0.836593749997206,1.0667064516082887,1,0.96875,0.14918716770493085,0.4744848692629974,1.4647,1.0709,0.4125,1.162,1.1139,0.5527,0.2954,1.474504448,1.0153813443,0.40654703546666665,3.8471,9.0793,0.2692,7.1566,0.2541,-88.4226,0.8164,6.493,0.4206,4.9052,0.4488,0.9083,1.74269816,4.725200634,5.886587953,0.3427133707,0.3382091368333333,2.782,2.022,0.1419,1.6252,0.1828,0.7711,0.119,0.217,0.164,0.024,1.611,67.125,2.117936503666667,2.0448256433,1.3893204074,0.2941841692666667,0.34878103243333336,104,0.3081481481481481,1,0,0,1,FALSE,FALSE,FALSE
425,2021-11-13T06:22:56Z,2021-11-13T06:43:55Z,1258,1,2021-11-13T06:43:57Z,0.8999999761581421,Firefox,94.0,Macintosh,1280,800,NA,1.6,610,53,318,97,54,83,-0.46042869066817177,-0.33435822983726743,-0.5271811881240909,-0.092389447708736,-0.24785955648129604,-0.3779713512849024,3,4,2,2,3,1,1,3,1,2,2,1,1,1,3,4,1,1,3,3,1.0711528467275955,0,1,1,3,3,1.6,0,4,4,2,4,2,2,3,2,3,2,2,4,2,4,3,1,3,1,1,1,1,2,1,2,2,0,0,4,2,4,4,3,5,2,3,2,2,4,1,1,2,1,3,3,1,1,2,4,5,1,1,1,2,1,2,2,3,2,4,2,2,1,1,1,1,1,2,2,1.244205790071742,0.9154754164341269,1.375,0,1.5,0,2.2,0,2.7777777777777777,0,2.0833333333333335,0,1,0,2,0,1,0,2.027027027027027,0,1,0,0,-0.5279018327542786,-0.45015582025824447,-0.3773458880470143,-0.41375085415262935,5,2,3,1,1,1,1,1,1,1.5275252316519468,1.4285714285714286,0,1,-0.6467170085812028,4,5,5,5,1,1,1,7,7,NA,3,2.0354009783964297,3.7142857142857144,0,2.2857142857142856,2,3.8333333333333335,3.2559414990859232,-1.3043345419688306,0,-0.7475928318813282,4,4,4,2,4,4,4,4,3,3,2,3,1,2,2,5,3,1,2,4,1.1872336794093274,3.6,0,3.4,0,3,0,2.2,0,2.8666666666666667,0,2,2,2,3,3,2,2,3,1,2,2,2,1,4,1,2,1,1,1,2,0.8255779474818965,1.95,0,"Asian or Asian American (e.g., Chinese, Japanese, and others)",0,25,0,1,NA,1,3,6,Systems Engineer,3,0,125,69,1,5,2,0,0,1,0,0,TRUE,TRUE,TRUE,TRUE,TRUE,1,0.6924,0.8,0.01080436285714286,1,0.43253125,0.46820689655172415,1,0.9354838709677419,0.001855934475806452,0.004738879569892474,1,0.6363548387096775,0.7162413793103448,0.96875,0.90625,0.017113544354838705,0.01208618951612903,1.2726,1.2563,0.3865,0.7291,1.5557,0.5959,0.225,1.3092044006666668,1.1232312576666668,0.38040868073333334,1.0045,5.2882,0.3376,3.4902,0.3374,-87.5999,0.802,6.6304,0.3734,4.758,0.3819,0.9999,1.0932550476,3.654582816,5.279035688,0.3310872605,0.33184236003333334,1.1145,2.9872,0.4561,3.6146,0.5605,0.9267,0.066,0.442,0.382,0.013,1.738,133.6923076923077,1.3829227749333333,3.175877712666667,2.284308853733333,0.4257903883333333,0.4420078387,404,1.1970370370370371,1,0,1,2,FALSE,FALSE,FALSE
426,2021-11-13T06:19:13Z,2021-11-13T06:44:15Z,1501,1,2021-11-13T06:44:16Z,1,Chrome,95.0.4638.69,Windows NT 10.0,1920,1080,"No additional comments at this time, thank you for letting me participate in your study.",1.7777777777777777,668,51,438,100,55,93,-0.31140540364955943,-0.35252770646363196,0.050527507988787794,-0.05583022810660534,-0.2340474968444512,-0.20905768367637165,3,3,1,1,3,1,1,3,1,3,3,1,1,1,3,3,1,1,3,3,1.025978352085154,0,1,1,3,2,1.5,0,3,3,2,3,2,3,3,3,2,2,3,2,1,3,1,2,3,1,3,2,3,3,2,8,2,0,0,3,1,2,2,1,2,2,3,3,2,5,3,1,3,3,2,4,3,3,3,3,4,1,1,1,4,3,3,5,5,4,2,4,4,3,3,2,2,2,4,4,1.1579468212490764,0.7367883976130072,2.375,0,3,0,2.8,0,3.888888888888889,0,2.75,0,1.8333333333333333,0,4,0,2.6666666666666665,0,3.1621621621621623,0,4,0,0,0.8001703075253659,0.7252646401434276,0.7023387496459815,0.7138016948947046,3,3,2,3,2,3,3,2,2,0.4879500364742666,3,0,2,0.6624097028997663,3,4,4,3,1,1,5,5,3,2,1,1.5275252316519468,2.4285714285714284,0,3.5714285714285716,5,3.8333333333333335,3.2559414990859232,0.38995568780511447,0,0.8165912597985752,3,3,3,2,3,3,4,3,4,3,1,3,2,3,3,5,3,2,3,4,0.9611501047232549,2.8,0,3.6,0,3,0,2.6,0,3.066666666666667,0,2,1,2,3,2,2,2,3,2,2,3,3,2,1,2,3,1,2,2,2,0.6407232755171874,1.9,0,"White, Caucasian, Anglo, European American",0,25,0,1,NA,1,2,3,Lead Pharmacy Technician,3,0,180,68,3,5,2,0,0,1,0,0,TRUE,TRUE,TRUE,TRUE,TRUE,4,0.9570945945954,0.7551020408163265,0.07567686666690143,4,0.47608620689655173,0.5860249999994412,0.9666666666666667,1,0.0019588859881392996,0.006363889031505229,4,0.719515625002794,0.8421375000039115,1,1,0.011204809102974425,0.02324834242027868,1.4057,0.83,0.5876,0.6078,1.2597,0.9079,0.616,1.4485065923333333,0.8613344909466667,0.5754620126333333,1.4028,5.4499,0.3465,4.1977,0.4289,-81.0792,1.0476,7.4102,0.4122,4.862,0.4775,0.8486,1.6145332460666666,4.563085710666667,4.484603276666666,0.4127883987666667,0.3027994369,1.1477,5.3095,0.6056,2.3278,0.6529,0.9568,0.095,0.484,0.371,0.023,1.88,81.73913043478261,2.856188439,4.784418556666667,3.5162356476666665,0.4243767272333333,0.4374394376,298,0.882962962962963,1,0,0,1,FALSE,FALSE,FALSE
427,2021-11-13T05:44:47Z,2021-11-13T06:44:30Z,3583,1,2021-11-13T06:44:31Z,1,Chrome,94.0.4606.81,Macintosh,1440,900,NA,1.6,1868,99,770,212,120,329,2.7718350174251785,0.08353973256911665,1.648854900567752,1.3090473037062726,0.6637363795504634,3.777304871884954,2,2,1,1,2,1,1,3,1,3,2,1,1,1,3,3,1,1,2,3,0.8506963092234007,0,1,2,3,3,1.75,0,4,4,2,4,2,1,3,2,1,1,3,4,1,4,4,2,3,1,2,1,2,1,3,3,2,0,0,5,5,4,4,4,4,4,4,4,2,4,1,1,3,1,4,2,1,2,2,4,3,1,1,1,3,1,1,2,2,1,4,1,1,1,1,2,2,2,2,2,1.4062281029326207,1.2909944487358056,1.875,0,2,0,1.8666666666666667,0,1.7777777777777777,0,1.9166666666666667,0,1.5,0,1.2857142857142858,0,1.3333333333333333,0,1.7027027027027026,0,2,0,0,-0.41863007437683963,-0.5179089759138089,-0.01745100881601569,-0.2676799923649123,5,1,4,1,1,1,1,1,1,1.7320508075688772,1.1428571428571428,0,1,-0.8176513788914915,5,5,5,4,3,3,2,6,6,3,3,1.2149857925879117,4.142857142857143,0,1.8571428571428572,3,3.8333333333333335,3.2559414990859232,-0.7395711320441822,0,-0.7042241191833141,4,3,4,3,4,3,3,5,2,2,4,3,2,3,3,4,2,2,3,4,0.9258200997725514,3.6,0,2.8,0,2.8,0,2.6,0,2.7333333333333334,0,1,1,1,2,2,1,1,3,2,1,1,4,1,2,2,4,1,1,2,1,0.9787209698591858,1.4,0,"White, Caucasian, Anglo, European American",0,23,0,1,NA,1,2,4,Delivery Driver,2,0,130,71,3,5,2,0,1,2,0,1,TRUE,TRUE,TRUE,TRUE,TRUE,1,1.0555421052645695,0.7755102040816326,0.1856584202292594,1,0.3911517241371089,0.46788928571449856,0.90625,0.875,0.001920281895034938,0.003900813216004493,1,0.5300000000009313,0.6621499999985099,1,0.875,0.005194170967888831,0.008971347378889374,1.6102,0.7942,0.5295,1.3512,0.8826,0.6462,0.3558,1.6068003883333333,0.8193394799,0.5220622482333334,0.7309,3.9085,0.3101,2.459,0.3518,-78.4708,0.6904,5.0408,0.3222,3.7801,0.3849,0.9967,0.7855180586333333,2.7765485966333334,4.138143188666667,0.3482878549,0.3062113855333333,0.7191,3.8156,0.4546,2.7036,0.5681,0.9317,0.059,0.398,0.424,0.009,1.613,179.22222222222223,1.3126358781666667,4.026016978666667,2.3537726798333334,0.3664960252666667,0.43132871353333335,404,1.1970370370370371,1,0,3,4,FALSE,FALSE,FALSE
428,2021-11-13T06:23:10Z,2021-11-13T06:45:33Z,1342,1,2021-11-13T06:45:34Z,0.8999999761581421,Chrome,95.0.4638.69,Windows NT 10.0,1600,900,NA,1.7777777777777777,773,47,300,68,39,70,-0.041621866805519804,-0.38886665971636103,-0.6138374925410226,-0.44579523719599906,-0.4550404510339686,-0.5975591191759924,4,4,2,1,3,1,1,4,1,3,4,1,3,1,3,4,1,1,3,4,1.3168942730211068,0,1,1,3,3,1.35,0,3,5,1,4,1,1,5,1,3,1,1,4,1,4,4,1,1,1,1,3,1,2,1,1,2,0,0,3,3,5,5,5,5,5,5,5,1,5,1,1,5,1,5,3,2,2,1,1,5,1,1,1,2,2,1,1,3,1,5,1,5,1,1,1,2,2,1,2,1.8050646133194952,1.6388149028228556,1.375,0,1.75,0,1.5333333333333334,0,1.4444444444444444,0,1.3333333333333333,0,1.1666666666666667,0,1.7142857142857142,0,1,0,1.4324324324324325,0,1,0,0,-0.8977447072625341,-0.9921810655027575,-0.2989446853297732,-0.6455628754162653,5,1,4,1,1,1,2,2,1,1.6761634196950514,1.2857142857142858,0,1.5,-0.5476903563491562,5,5,5,5,2,1,1,4,7,3,3,1.9880595947760098,4,0,2,3.5,3.8333333333333335,3.2559414990859232,-0.4571894270818581,0,-0.48336226928071535,2,2,1,1,2,2,5,1,1,3,1,5,1,5,5,1,4,1,5,3,1.8073922282301278,1.6,0,4.6,0,4.6,0,4.6,0,4.6,0,2,1,2,3,1,3,4,4,1,2,2,3,3,2,1,4,2,2,2,1,1.019545822516343,1.85,0,"White, Caucasian, Anglo, European American",0,20,0,3,NA,1,2,4,Student/Food Service,1,0,200,76,4,5,2,0,0,1,0,0,TRUE,TRUE,TRUE,TRUE,TRUE,1,1.1096999999996275,0.8,0.2977239618325536,1,0.4853843749985099,0.5621266666685542,1,0.9375,0.0031829897480949963,0.00497261512113743,1,0.6064874999988824,0.7431333333328366,1,0.967741935483871,0.004072915967858616,0.013358504623869949,2.0479,0.7323,0.3174,1.5025,0.7898,0.6031,0.084,NA,NA,NA,1.241,5.601,0.3746,3.1414,0.3808,-77.7685,0.9256,5.8797,0.4054,4.178,0.4533,0.9636,NA,NA,NA,NA,NA,1.3294,5.486,0.4868,3.8608,0.5704,0.9997,0.081,0.469,0.585,0.009,1.434,159.33333333333334,NA,NA,NA,NA,NA,104,0.3081481481481481,1,1,1,2,FALSE,FALSE,FALSE
429,2021-11-13T06:24:34Z,2021-11-13T06:45:36Z,1261,1,2021-11-13T06:45:37Z,0.8999999761581421,Chrome,95.0.4638.69,Windows NT 10.0,1707,960,NA,1.778125,654,51,291,98,45,78,-0.3473765418954314,-0.35252770646363196,-0.6571656447494886,-0.08020304117469244,-0.37216809321289956,-0.4624281850891678,3,3,1,1,3,1,1,3,1,3,2,1,1,1,3,3,1,1,4,2,1.050062654772261,0,1,1,3,3,1.55,0,5,5,2,5,1,2,4,2,1,1,1,4,3,4,3,1,1,1,1,1,1,1,1,1,2,0,0,4,1,4,4,3,5,3,3,4,2,4,1,1,3,1,5,1,1,1,1,1,5,1,1,1,1,1,1,1,1,1,5,1,1,1,1,1,1,2,2,2,1.5161790127814059,1.5522640914238175,1,0,1.75,0,1.6666666666666667,0,2.5555555555555554,0,1.3333333333333333,0,0.8333333333333334,0,0.8571428571428571,0,1,0,1.4864864864864864,0,1,0,0,-1.0973758042982402,-1.072807320732879,-0.2989446853297732,-0.6858760030313261,5,1,5,1,1,1,1,1,3,1.9518001458970664,1,0,2,-0.5341308892722537,5,5,5,5,2,2,1,7,7,4,3,1.8126539343499315,4.142857142857143,0,1.8571428571428572,2,3.8333333333333335,3.2559414990859232,-1.3043345419688306,0,-0.9866058241456384,3,3,3,3,3,2,4,3,2,3,1,3,1,3,3,2,5,2,3,3,1.0465362369445672,3,0,4.2,0,3.8,0,3.2,0,3.7333333333333334,0,2,1,1,4,2,1,1,3,1,1,2,3,1,1,1,3,1,2,1,1,0.9333020044867296,1.35,0,"White, Caucasian, Anglo, European American",0,22,0,1,NA,1,4,4,Retail shopper,5,0,130,69,2,5,2,0,0,1,0,0,TRUE,TRUE,TRUE,TRUE,TRUE,5,1.0171249999983443,0.72,0.08262335526972343,5,0.4908093749997206,0.5794999999971159,1,0.96875,0.008361904748076495,0.013263363225820928,5,0.6292499999981374,0.7481124999988824,1,1,0.010443739999673561,0.02685186435467746,1.5127,0.6597,0.5538,1.106,0.5586,0.7562,0.202,1.533926498,0.73508024184,0.5441498606333334,1.275,4.454,0.3477,3.014,0.3771,-64.2888,1.0837,4.8058,0.3749,3.0848,0.4171,0.9994,1.4438205057,3.254361978,4.663272783333333,0.3631946682,0.3360891648666667,1.2757,3.7375,0.4756,3.3199,0.5476,0.9612,0.232,0.229,0.557,0.02,1.791,89.55,2.591704813,4.200767681333334,3.8650297443333335,0.32130173013333335,0.41577994086666664,236,0.6992592592592592,1,0,0,1,FALSE,FALSE,FALSE
430,2021-11-13T06:25:00Z,2021-11-13T06:46:38Z,1298,1,2021-11-13T06:46:39Z,1,Chrome,95.0.4638.69,Windows NT 10.0,1920,1080,NA,1.7777777777777777,699,65,279,101,45,60,-0.23175502610512866,-0.22534137007908028,-0.7149365143607764,-0.04364382157256178,-0.37216809321289956,-0.7664727867845231,3,3,4,4,3,1,1,3,1,3,1,1,1,1,3,3,1,2,3,3,1.118033988749895,0,1,1,2,1,1.95,0,5,5,1,5,1,1,5,1,1,1,1,5,2,5,5,2,2,1,1,1,1,1,1,0,2,0,0,5,5,5,5,5,5,4,4,5,1,5,1,1,5,1,5,1,1,1,2,1,5,1,1,1,2,1,1,1,1,1,5,1,1,1,1,1,1,1,1,1,1.8800357801208292,2.016597794967223,1.25,0,1,0,1.0666666666666667,0,1.2222222222222223,0,1.0833333333333333,0,1,0,0.8571428571428571,0,1,0,1.1081081081081081,0,0,0,0,-1.1772282431125227,-1.3858268998615852,-0.7372407672780129,-1.061533833569799,5,1,5,1,1,1,1,1,1,1.9518001458970664,1,0,1,-0.9031185640466358,5,5,5,5,2,2,1,4,7,3,3,1.8126539343499315,4.142857142857143,0,1.8571428571428572,3.5,3.8333333333333335,3.2559414990859232,-0.4571894270818581,0,-0.563033266702152,3,3,2,3,2,2,5,1,1,5,1,4,1,5,4,1,5,1,3,1,1.7994708216848747,2.6,0,4.6,0,4.6,0,4.8,0,4.666666666666667,0,1,1,2,3,4,2,2,2,1,2,2,3,1,1,1,3,1,2,2,3,0.8870412083230169,1.85,0,"White, Caucasian, Anglo, European American",0,27,0,1,NA,1,3,6,Software Engineer,4,0,162,70,3,5,2,0,0,1,0,0,TRUE,TRUE,TRUE,TRUE,TRUE,6,0.8390552631569536,0.76,0.05533297380012391,6,0.4636718750002328,0.5057343750002329,1,1,0.0030311278931665748,0.003330558457585537,6,0.618962500001071,0.7208000000007451,1,1,0.007456317903330582,0.014605549032152382,1.3544,0.9033,0.4818,0.9878,0.8974,0.6315,0.1448,1.3939710746666667,0.9137557113,0.47348636606666666,2.4448,8.335,0.317,6.697,0.3232,-100.8521,0.5556,6.1415,0.4168,7.1277,0.4682,0.7135,1.5961010396,5.066270148666667,6.126290216,0.3540144645666667,0.339280415,0.9733,4.4351,0.5193,3.4445,0.5815,0.8146,0.109,0.403,0.513,0.014,1.569,112.07142857142857,2.543549875666667,4.825334820666667,4.181128265333333,0.3587443535,0.4214385136,336,0.9955555555555555,1,0,1,2,FALSE,FALSE,FALSE
431,2021-11-13T06:27:53Z,2021-11-13T06:49:58Z,1324,1,2021-11-13T06:49:59Z,0.8999999761581421,Chrome,95.0.4638.69,Windows NT 10.0,1920,1080,No feedback,1.7777777777777777,672,43,361,73,68,72,-0.3011279355793103,-0.4252056129690901,-0.32016890535030934,-0.38486320452578127,-0.054490721565468275,-0.5637763856542862,4,3,1,2,3,1,1,3,1,3,4,1,1,1,4,3,1,1,4,4,1.3018205875255096,0,1,1,3,2,1.3,0,3,5,1,3,1,3,1,1,1,1,1,4,1,4,1,4,1,5,1,3,3,2,4,1,1,0,1,5,4,1,5,4,4,5,5,5,2,5,1,1,3,1,5,5,1,4,1,1,1,1,2,1,3,2,1,2,1,1,3,4,1,1,2,1,2,1,1,1,1.6589913357978252,1.4375905768565218,2.875,0,1.25,0,2.066666666666667,0,1.7777777777777777,0,1.8333333333333333,0,2.1666666666666665,0,1.7142857142857142,0,1.3333333333333333,0,1.864864864864865,0,1,0,1,0.30424463488929604,0.06747828895026543,-0.27929744386507466,-0.10590957745740462,5,1,4,1,1,1,4,2,1,1.8126539343499315,1.5714285714285714,0,1.5,-0.3767559860388676,3,4,4,4,1,2,4,7,6,3,3,1.2149857925879117,2.857142857142857,0,3.142857142857143,2.5,3.8333333333333335,3.2559414990859232,-1.0219528370065065,0,-0.12837599487154566,1,1,1,1,1,1,5,1,1,2,1,5,1,5,5,1,5,3,5,5,1.9444671200491874,1,0,4.6,0,4.4,0,4.2,0,4.4,0,1,2,2,4,2,3,4,3,2,1,2,3,2,3,1,3,1,3,1,3,0.9787209698591858,2,0,"White, Caucasian, Anglo, European American",0,26,0,1,NA,1,3,6,Digital Advertising Strategist,5,0,208,75,3,5,2,0,0,1,0,0,TRUE,TRUE,TRUE,TRUE,TRUE,3,0.6786931818188592,0.88,0.04101521715924314,3,0.4572937500001863,0.5198903225785302,1,1,0.006947921250636234,0.0077454189032154334,3,0.5626645161269173,0.6790464285697256,1,0.875,0.016099027698432834,0.017526299959010918,1.343,1.5576,0.3625,1.1321,1.5555,0.4345,0.2022,1.349737982,1.2966937796,0.356710665,4.2668,6.7503,0.1413,6.7033,0.2016,-70.07,0.9823,4.5053,0.3495,5.2307,0.4232,0.9829,1.9145987883333333,4.704755626666667,4.388141375,0.3206816457666667,0.2382303988,0.8492,3.1428,0.4636,3.3897,0.5624,0.771,0.089,0.293,0.383,0.008,1.852,231.5,1.4474360353666667,3.152371188,1.883413762,0.3252365238,0.3396140239666667,104,0.3081481481481481,1,0,10,11,FALSE,FALSE,FALSE
432,2021-11-13T06:15:46Z,2021-11-13T06:50:35Z,2089,1,2021-11-13T06:50:36Z,1,Edge,95.0.1020.44,Windows NT 10.0,1366,768,I enjoyed the survey,1.7786458333333333,769,81,741,154,85,164,-0.05189933487576893,-0.07998555706816408,1.5092419656738063,0.6022357247317466,0.18031429226089402,0.9902293563441966,2,4,1,1,4,1,1,3,1,3,3,1,1,1,3,3,1,1,3,3,1.145931016569864,0,1,2,3,3,1.45,0,2,3,3,2,3,5,2,4,4,5,5,2,2,1,2,4,5,5,3,4,4,5,4,6,2,3,50,3,2,3,2,2,2,1,1,2,5,2,5,5,2,5,2,5,5,5,5,5,2,5,5,5,5,5,4,5,5,5,2,4,4,5,5,5,4,4,5,5,1.4745081126172803,1.3093073414159542,4.25,0,4.5,0,3.933333333333333,0,4,0,4.75,0,4.666666666666667,0,4.285714285714286,0,5,0,4.54054054054054,0,3,3,6,2.823799217476786,2.6104478011483163,2.6482509963270675,2.629349398737692,3,4,1,4,1,3,4,6,4,1.3451854182690985,3.4285714285714284,0,5,2.0257742826883454,1,4,3,4,2,1,5,5,3,2,2,1.5735915849388864,2.2857142857142856,0,3.7142857142857144,5,3.8333333333333335,3.2559414990859232,0.38995568780511447,0,0.8962622572200118,2,2,3,1,2,2,4,2,2,4,1,4,2,4,3,2,4,3,5,4,1.162919151265879,2,0,4,0,4.2,0,3.4,0,3.8666666666666667,0,2,1,1,4,2,2,2,3,2,2,2,3,2,1,2,3,2,2,2,2,0.7181848464596079,1.8,0,"White, Caucasian, Anglo, European American",0,21,0,1,NA,1,2,3,Factory Employee,2,0,152,74,4,5,2,0,1,3,0,1,TRUE,TRUE,TRUE,TRUE,TRUE,3,1.0842289473696758,0.7755102040816326,0.10866586583424077,3,0.6693781249988824,0.7552468750011175,1,1,0.038970809505978435,0.03610589741017762,3,1.1069249999988824,1.314828125,1,1,0.06449302645361911,0.1628523001507486,1.5168,0.858,0.5909,1.4168,0.7851,0.6467,0.1807,1.538221511,0.8711587850333333,0.5797249680333333,2.2184,2.6935,0.2576,3.5261,0.4407,-25.9735,1.4472,2.1477,0.3894,3.056,0.5128,0.9902,2.127681667,3.3352152673333335,2.7816453676666666,0.4323842692666667,0.2723476378333333,2.0018,2.1458,0.6761,1.6708,0.7663,0.941,0.205,0.388,0.275,0.006,1.263,210.49999999999997,3.6885961966666665,2.750509745,2.150980520666667,0.4235021181333333,0.4437444273,346,1.0251851851851852,1,0,1,2,FALSE,FALSE,FALSE
433,2021-11-13T05:51:13Z,2021-11-13T06:53:42Z,3749,1,2021-11-13T06:53:43Z,1,Chrome,95.0.4638.69,Windows NT 10.0,1477,831,N/A,1.7773766546329723,1954,43,666,52,121,76,2.992800580935535,-0.4252056129690901,1.1481740306032573,-0.6407777417406959,0.6775484391873082,-0.4962109186108739,4,3,2,2,3,1,2,3,1,3,3,2,1,2,3,3,2,1,3,3,0.8750939799154206,0,1,1,2,3,1.75,0,2,4,4,3,3,3,3,3,3,3,3,3,3,3,3,4,4,2,3,3,3,3,4,0,2,0,0,3,3,4,4,3,3,4,4,4,2,3,3,3,4,1,4,1,3,3,3,3,3,1,1,1,3,1,1,2,1,1,3,3,3,1,1,1,1,2,3,3,1.1455620071878747,0.45773770821706344,3.25,0,2.25,0,3.066666666666667,0,2.4444444444444446,0,2.4166666666666665,0,1.5,0,1.8571428571428572,0,1,0,2.108108108108108,0,0,0,0,0.6887971691791296,0.7629160366434483,-0.34523475369180734,0.2088406414758205,4,1,4,2,1,5,5,4,6,1.7728105208558367,2.5714285714285716,0,5,1.51297117175748,4,4,4,4,3,3,2,7,7,5,3,0.7867957924694432,3.7142857142857144,0,2.2857142857142856,2,3.8333333333333335,3.2559414990859232,-1.3043345419688306,0,-0.7475928318813282,2,2,2,2,2,2,4,2,2,4,2,4,2,4,2,2,4,4,4,3,1,2,0,3.6,0,4,0,3.4,0,3.6666666666666665,0,2,2,1,3,2,1,2,3,2,2,1,3,2,2,1,3,1,1,2,1,0.7451598203705946,1.65,0,"Asian or Asian American (e.g., Chinese, Japanese, and others)",0,21,0,1,NA,1,4,3,Full-time college student,6,0,170,65,2,5,2,0,0,0,0,0,TRUE,TRUE,TRUE,TRUE,TRUE,4,0.9240968749979511,0.6530612244897959,0.1367302666585981,4,0.6759750000024214,0.7680482758622745,1,0.9666666666666667,0.05702553419443631,0.05142254723065537,4,0.8569741935470412,0.9006766666680575,1,0.9375,0.052953451978067854,0.06576849383224978,1.7297,0.4011,0.3363,1.1961,0.3737,0.6249,0.0302,1.686739759,0.5226261131186667,0.3365309058666667,1.5863,2.8137,0.3941,2.2234,0.4325,-21.9964,1.4934,2.7977,0.3848,2.7935,0.48,0.8605,1.8347664503333334,2.469234828133333,3.0567064373333332,0.4049821544666667,0.3637914701,1.6306,2.9307,0.5687,2.1039,0.5343,0.9851,0.073,0.562,0.226,0.137,1.076,7.854014598540146,2.0385273036666667,2.90305415,2.0661704921666666,0.4949460998333333,0.48699642146666666,255,0.7555555555555555,1,1,13,14,FALSE,FALSE,FALSE
435,2021-11-13T06:38:42Z,2021-11-13T06:54:51Z,969,1,2021-11-13T06:54:53Z,1,Chrome,95.0.4638.69,Windows NT 10.0,1920,1080,NA,1.7777777777777777,577,51,182,39,40,50,-0.5452178022477271,-0.35252770646363196,-1.1819177103853533,-0.7992010266832621,-0.4412283913971238,-0.9353864543930538,2,1,3,3,2,2,3,2,3,2,2,3,4,4,2,2,3,4,2,3,0.8207826816681233,0,1,2,3,2,3.1,0,5,4,3,4,1,1,4,1,1,1,1,4,1,4,4,1,1,1,1,1,1,1,1,1,4,0,0,5,4,4,4,3,4,2,5,5,2,5,3,1,5,2,5,1,1,2,2,2,5,1,1,1,1,1,1,3,3,3,5,1,2,1,1,1,1,1,1,2,1.5849328099361222,1.5946338585572373,1,0,1.25,0,1.5333333333333334,0,2,0,1.5833333333333333,0,0.8333333333333334,0,1.8571428571428572,0,1,0,1.6216216216216217,0,1,0,0,-1.0133206055463637,-1.072032998953958,-0.4557470907642554,-0.7638900448591067,5,1,4,1,1,1,1,1,1,1.7320508075688772,1.1428571428571428,0,1,-0.8176513788914915,5,5,5,5,4,4,1,7,8,6,5,1.4638501094227998,4.714285714285714,0,1.2857142857142858,1.5,3.8333333333333335,3.2559414990859232,-1.5867162469311549,0,-1.4464806663125476,3,3,3,3,3,3,4,2,2,4,1,4,2,3,4,1,4,1,4,2,1.2227992865708155,3,0,4.2,0,4.2,0,3.8,0,4.066666666666666,0,3,1,1,3,1,1,3,3,1,2,3,3,4,3,2,3,1,1,2,3,1.0052493799000692,2,0,"Asian or Asian American (e.g., Chinese, Japanese, and others)",0,22,0,1,NA,1,3,6,Product Development,5,0,140,69,3,5,2,0,0,1,0,0,TRUE,TRUE,TRUE,TRUE,TRUE,3,0.5801111111135946,0.72,0.01428670612236901,3,0.44328387096620375,0.5245899999986092,0.96875,0.9375,0.00684076418370719,0.004043709828460586,3,0.5391624999982305,0.5996000000007691,1,0.96875,0.004436134032236067,0.005719382248326065,0.8968,1.0627,0.4207,0.8329,0.755,0.4483,0.0675,NA,NA,NA,0.8554,4.2182,0.3572,3.2804,0.4089,-83.0583,0.9077,5.1253,0.3565,4.8532,0.4264,0.9129,NA,NA,NA,NA,NA,0.8492,6.3165,0.478,3.012,0.4933,0.7102,0.087,0.36,0.488,0.025,1.904,76.16,NA,NA,NA,NA,NA,240,0.7111111111111111,1,0,2,3,FALSE,FALSE,FALSE
436,2021-11-13T06:39:59Z,2021-11-13T06:58:43Z,1123,1,2021-11-13T06:58:43Z,1,Chrome,95.0.4638.69,Windows NT 10.0,1920,1080,NA,1.7777777777777777,660,34,239,49,34,63,-0.3319603397900577,-0.5069682577877305,-0.9075060797317359,-0.6773369613428266,-0.5241007492181928,-0.7157986865019639,3,3,1,1,3,1,1,3,1,2,2,2,1,3,3,3,2,2,2,3,0.8522416262267903,0,1,1,5,5,1.9,0,4,4,1,4,1,1,4,1,1,1,1,4,1,4,4,1,1,1,1,1,1,1,1,1,2,1,1,4,4,4,4,4,4,3,3,4,1,1,1,1,3,1,3,2,1,1,1,1,5,1,1,1,1,1,1,2,2,1,4,3,1,1,1,1,2,1,2,2,1.3495633817354862,1.5491933384829668,1,0,1.75,0,1.4666666666666666,0,2.2222222222222223,0,1.75,0,0.8333333333333334,0,1.5714285714285714,0,1,0,1.6756756756756757,0,1,1,1,-0.9796985260456136,-1.0774532514064032,0.08413816916243128,-0.496657541121986,4,1,2,2,1,1,1,1,1,1.1126972805283737,1.7142857142857142,0,1,-0.4757826382709144,4,4,4,3,3,3,1,1,1,1,2,1.0690449676496976,3.7142857142857144,0,2.2857142857142856,8,3.8333333333333335,3.2559414990859232,2.0842459175790595,0,0.946697397892617,2,2,2,2,2,2,3,3,2,3,1,2,3,2,3,3,4,1,2,3,0.8338093878327919,2,0,4,0,2.8,0,3,0,3.2666666666666666,0,1,1,1,2,1,1,1,3,2,2,1,3,1,1,1,3,1,1,1,1,0.7591546545162482,1.35,0,"Hispanic of Latino (e.g., Mexican American, Central American, and others)",0,22,0,1,NA,1,2,4,Unemployed,1,0,245,70,1,5,2,0,0,1,0,0,TRUE,TRUE,TRUE,TRUE,TRUE,6,0.8298885714279753,0.7142857142857143,0.04028388273040863,6,0.4446785714285714,0.56696666666617,0.9032258064516129,0.9375,0.004712153978600934,0.017158363941265995,6,0.5077833333303531,0.5414592592622395,0.9375,0.8709677419354839,0.00416973741925732,0.004942486516204387,1.3125,0.7415,0.4803,1.0788,0.5888,0.6016,0.1275,1.3617876066666668,0.810691611,0.47115976,1.116,2.913,0.2823,2.1377,0.3294,-37.8009,0.8583,3.9526,0.3394,2.8698,0.4408,0.9973,1.195514084,2.377740621766667,3.240383674333333,0.32359695346666667,0.2778523301,0.7288,3.443,0.4235,3.0774,0.4443,0.9965,0.044,0.387,0.341,0.037,1.981,53.54054054054055,0.9817354513333333,3.1863304003333335,2.743062244133333,0.3631825093666667,0.3953808406666667,356,1.0548148148148149,1,0,0,1,FALSE,FALSE,FALSE
438,2021-11-13T06:31:52Z,2021-11-13T07:01:15Z,1763,1,2021-11-13T07:01:17Z,1,Firefox,94.0,Macintosh,1440,900,NA,1.6,804,124,460,65,45,90,0.03802851073891094,0.3106581903986732,0.15644076894281556,-0.4823544567981297,-0.37216809321289956,-0.2597317839589309,3,3,2,1,2,1,2,2,1,3,3,1,1,2,3,3,4,1,2,2,0.9119095061289915,1,1,1,4,4,2,0,4,5,2,4,2,2,4,2,2,2,2,4,2,4,5,1,2,1,1,1,1,2,2,1,3,0,0,5,3,3,4,4,4,3,3,4,2,5,2,2,3,2,5,1,2,2,3,3,4,1,1,1,1,2,1,2,1,1,5,1,3,2,2,1,2,2,2,2,1.324860466334193,1.2227992865708155,1.375,0,2,0,1.8666666666666667,0,2.3333333333333335,0,2,0,1.1666666666666667,0,1.2857142857142858,0,1.6666666666666667,0,1.837837837837838,0,1,0,0,-0.6455791110069055,-0.6747091361452571,-0.22054348261253207,-0.4476263093788946,4,3,3,3,2,3,3,3,1,0.5773502691896257,2.7142857142857144,0,2,0.49147533258947784,3,3,4,4,1,1,2,6,4,4,3,1.2724180205607036,2.857142857142857,0,3.142857142857143,4,3.8333333333333335,3.2559414990859232,-0.1748077221195339,0,0.2951965625719407,2,2,2,3,2,2,3,2,2,2,1,4,2,3,4,2,3,1,4,3,0.990430401872025,2.2,0,4.2,0,3.4,0,3.6,0,3.7333333333333334,0,2,1,2,3,1,2,2,2,1,1,1,3,3,2,1,2,1,2,1,2,0.7163503994113789,1.75,0,"Asian or Asian American (e.g., Chinese, Japanese, and others) & Filipino",1,19,0,1,NA,1,3,4,Student,4,0,135,66,3,5,2,0,0,0,0,0,TRUE,TRUE,TRUE,TRUE,TRUE,2,1.113658536585366,0.8367346938775511,0.1231800399659864,2,0.47090625,0.5291612903225806,1,1,0.0011783457661290325,0.0018830731182795694,2,0.5783125,0.6796875,1,1,0.008861576612903226,0.008176157258064516,1.6104,1.0601,0.6478,1.3735,0.8708,0.7213,0.0375,1.611398639,0.9996796532333333,0.6348953841666667,7.3323,14.6042,0.2199,12.6491,0.2393,-117.3231,0.7245,6.079,0.4156,5.9031,0.4697,0.9361,1.5217290538,5.806978479,6.601187086666667,0.4061548912,0.36262862856666667,1.0776,4.5056,0.4614,3.8971,0.5462,0.9996,0.176,0.321,0.712,0.015,1.747,116.46666666666668,2.2258737786666667,4.693115403,4.856940535333333,0.3443516744,0.45786554766666665,432,1.28,1,0,0,1,FALSE,FALSE,FALSE
439,2021-11-13T06:44:18Z,2021-11-13T07:09:06Z,1487,1,2021-11-13T07:09:06Z,1,Chrome,95.0.4638.69,Windows NT 10.0,1536,864,NA,1.7777777777777777,929,45,234,99,53,58,0.3591993879341962,-0.40703613634272556,-0.9315772754031059,-0.06801663464064889,-0.2616716161181409,-0.8002555203062293,2,4,2,1,3,1,2,4,1,4,2,2,1,1,4,3,2,1,3,3,1.1285761872936695,0,1,1,4,4,1.6,0,5,5,2,5,2,2,5,2,1,1,1,4,1,4,1,1,5,1,1,1,3,3,1,0,2,0,0,5,3,4,4,1,5,4,5,5,1,5,4,1,4,1,4,1,1,1,2,4,2,1,1,1,2,1,1,1,1,1,5,1,1,1,1,1,1,1,1,1,1.653552005300781,1.709915063331955,2,0,1,0,1.6666666666666667,0,2,0,1.75,0,1.5,0,0.8571428571428571,0,1,0,1.5945945945945945,0,0,0,0,-0.40812317453285496,-0.5965994266966284,-0.7372407672780129,-0.6669200969873206,5,1,5,1,1,1,1,1,1,1.9518001458970664,1,0,1,-0.9031185640466358,5,5,5,5,3,3,1,6,7,5,3,1.5735915849388864,4.428571428571429,0,1.5714285714285714,2.5,3.8333333333333335,3.2559414990859232,-1.0219528370065065,0,-1.00475696650735,4,5,4,2,3,4,2,5,3,1,4,3,2,2,3,4,3,4,5,4,1.162919151265879,3.6,0,2.4,0,2.8,0,2.2,0,2.466666666666667,0,1,3,1,2,2,2,3,2,1,1,2,2,3,3,1,2,1,2,2,3,0.7591546545162482,2.15,0,"White, Caucasian, Anglo, European American",0,19,0,1,NA,1,4,4,Student,6,0,190,70,2,5,2,0,0,0,0,0,TRUE,TRUE,TRUE,TRUE,TRUE,3,0.911884210526306,0.76,0.03490334963674074,3,0.516737500000003,0.6010166666666589,1,1,0.027091165645160065,0.014913149712647749,3,0.6255483870967742,0.7236187499999979,0.96875,1,0.008760230554435628,0.008295118346775373,1.3574,0.9418,0.5477,0.9663,0.9158,0.705,0.1885,1.3992066937666667,0.9364328716333333,0.5385773703333333,1.3051,4.0685,0.3563,4.0197,0.4387,-69.627,0.7289,5.3739,0.4332,3.6342,0.499,0.9374,1.5590391529666667,4.183621982,4.397578362,0.4163458899333333,0.3381908498333333,0.9747,3.6561,0.5061,4.7616,0.6158,0.7722,0.189,0.357,0.706,0.013,1.444,111.07692307692308,1.8870986653333333,3.7358020303333332,4.409523940333333,0.3905701093,0.5152686776666666,339,1.0044444444444445,1,1,2,3,FALSE,FALSE,FALSE
440,2021-11-13T06:38:51Z,2021-11-13T07:14:52Z,2160,1,2021-11-13T07:14:53Z,0.8999999761581421,Chrome,95.0.4638.69,Macintosh,1280,800,Survey went by smoothly.,1.6,1193,74,521,98,68,123,1.0375122805706387,-0.14357872526043994,0.45010935613352887,-0.08020304117469244,-0.054490721565468275,0.2976833191492206,4,1,1,1,4,1,1,4,1,4,3,1,1,1,4,3,1,1,4,4,1.446411166701189,0,1,2,3,3,1.25,0,4,5,2,4,2,1,3,2,2,1,1,5,3,5,4,1,1,1,1,1,1,1,1,1,2,0,2,5,3,4,4,3,5,5,5,5,1,4,2,2,3,2,5,1,1,1,1,1,4,2,1,1,3,1,1,3,1,1,5,1,2,1,1,1,1,1,2,2,1.5920221526519456,1.486446705914413,1,0,1.5,0,1.7333333333333334,0,1.6666666666666667,0,1.5,0,1.5,0,1.2857142857142858,0,1,0,1.5135135135135136,0,1,0,2,-1.0805647645478649,-1.032542588229001,-0.024446594248652788,-0.5284945912388268,5,1,3,1,1,2,2,1,1,1.4638501094227998,1.5714285714285714,0,1,-0.5612498234260587,5,5,5,3,3,3,3,1,1,NA,2,1.0690449676496976,3.857142857142857,0,2.142857142857143,8,3.8333333333333335,3.2559414990859232,2.0842459175790595,0,0.8670264004711803,1,2,2,2,2,1,5,1,1,1,1,4,2,3,5,3,5,2,3,3,1.5430334996209192,1.8,0,4.6,0,3.2,0,4.2,0,4,0,1,1,1,3,1,1,2,3,1,1,1,3,1,1,1,3,1,1,1,1,0.8255779474818965,1.25,0,"Hispanic of Latino (e.g., Mexican American, Central American, and others)",0,27,0,1,NA,1,2,6,Currently unemployed.,7,0,200,73,2,5,2,0,0,1,0,0,TRUE,TRUE,TRUE,TRUE,TRUE,5,1.3407282051280713,0.78,0.38590284016736986,5,0.48356562499981376,0.5582781250001863,1,1,0.0011865752318470238,0.003511965635078265,5,0.6606937499997438,0.8020468749998836,1,1,0.008620976088601443,0.011028099344754568,1.8294,0.6789,0.5934,1.8614,0.7832,0.5297,0.0676,1.782084682,0.7117394045333333,0.5864896921666667,3.7566,11.5385,0.3208,8.2204,0.3298,-110.1107,0.7679,7.3927,0.4325,5.1228,0.4885,0.9977,1.5463424205,5.099989974,6.755538688333333,0.4125794940333333,0.3764427857,1.218,5.2563,0.5429,3.7857,0.6593,0.9881,0.167,0.363,0.567,0.011,1.697,154.27272727272728,2.808904763,4.9880225173333335,4.237927624,0.38326147076666667,0.4757945583666667,105,0.3111111111111111,1,1,4,5,FALSE,FALSE,FALSE
441,2021-11-13T06:50:58Z,2021-11-13T07:15:24Z,1466,1,2021-11-13T07:15:25Z,1,Chrome,95.0.4638.69,Windows NT 10.0,1920,1080,NA,1.7777777777777777,807,55,331,71,57,87,0.045736611791597784,-0.31618875321090295,-0.464596079378529,-0.4092360175938684,-0.2064233775707615,-0.31040588424149007,3,2,2,2,3,1,1,1,1,3,1,1,1,1,3,1,1,1,2,2,0.812727700887249,0,1,1,5,3,2.05,0,2,3,5,2,3,4,1,5,3,3,4,2,3,1,3,4,5,2,2,4,4,3,3,0,3,0,0,4,2,4,4,4,4,5,5,2,2,4,5,3,3,3,4,5,5,3,5,5,3,1,1,1,2,1,3,1,1,1,2,4,4,3,4,5,3,1,1,1,1.4305755997312923,1.2227992865708155,3.375,0,1.5,0,3.8666666666666667,0,2.2222222222222223,0,3.5833333333333335,0,1.3333333333333333,0,2.4285714285714284,0,4,0,2.7567567567567566,0,0,0,0,1.1700131820336208,1.439189320308343,-0.5804383618435307,0.42937547923240615,1,5,1,5,3,4,4,4,2,1.7043362064926932,4.428571428571429,0,3,1.8860692292255914,2,2,3,3,1,1,4,3,3,2,2,1.1126972805283737,2,0,4,6,3.8333333333333335,3.2559414990859232,0.9547190977297628,0,1.3379859570252095,1,1,2,3,2,1,5,2,1,3,1,4,1,4,4,1,5,1,4,2,1.5946338585572373,1.8,0,4.8,0,4.4,0,4.2,0,4.466666666666667,0,2,3,2,1,2,4,4,1,4,1,2,1,2,3,2,1,1,2,3,3,1.0563093645728086,2.8,0,"Hispanic of Latino (e.g., Mexican American, Central American, and others) & Native Hawaiian or other Pacific Islander",1,25,0,1,NA,1,2,6,Unemployed,1,0,140,72,2,5,2,0,0,1,0,0,TRUE,TRUE,TRUE,TRUE,TRUE,5,1.0643902439053465,0.82,0.06250767347080782,5,0.5012258064554583,0.5407187499962747,0.96875,1,0.004036219314659713,0.0033027306045624433,5,0.6283999999910593,0.6855281250104308,1,1,0.010948115484307505,0.008070254342888716,1.8096,0.966,0.5097,1.2079,0.9283,0.7977,0.1928,1.732446266,0.9185502647333333,0.5062907026666666,1.5882,4.5816,0.3357,4.6718,0.3707,-74.3101,0.8573,5.7527,0.4266,6.3446,0.475,0.9437,1.6261423768666667,4.532257041666667,4.543234610666667,0.3648307525666667,0.3297009696,1.2422,5.1943,0.5066,6.1575,0.5858,0.9989,0.207,0.273,0.608,0.018,1.568,87.11111111111111,2.421815444,4.466655081,4.538015848333333,0.35974506196666667,0.425179174,104,0.3081481481481481,1,1,3,4,FALSE,FALSE,FALSE
443,2021-11-13T06:48:41Z,2021-11-13T07:18:30Z,1789,1,2021-11-13T07:18:31Z,0.8999999761581421,Chrome,95.0.4638.54,Windows NT 10.0,1366,768,The colored dot game was very hard for me compared to the other games; it was hard to tell when they moved a lot of the time.,1.7786458333333333,667,74,530,110,91,101,-0.3139747706671217,-0.14357872526043994,0.49343750834199473,0.0660338372338302,0.26318665008196307,-0.07392674958954705,2,3,3,3,2,2,1,2,1,2,1,1,1,3,1,2,1,1,2,1,0.7863975156570492,0,1,1,3,4,2.45,0,4,3,5,4,3,5,4,3,3,2,2,4,1,4,4,4,2,5,3,4,3,5,4,0,3,0,0,5,1,4,3,4,5,2,2,3,2,5,2,2,2,2,3,5,4,5,5,1,3,1,4,3,1,1,1,1,1,1,2,5,3,1,2,2,2,3,1,1,1.4729798605784363,1.121223821162776,3.75,0,1.75,0,2.6,0,2.7777777777777777,0,3,0,2,0,2.142857142857143,0,1.6666666666666667,0,2.5675675675675675,0,0,0,0,1.285589080317451,0.9746930431782689,-0.5020371591262895,0.23632794202598967,5,1,3,1,1,3,1,1,1,1.5735915849388864,1.5714285714285714,0,1,-0.5612498234260587,5,5,5,5,3,4,2,5,4,3,2,1.2149857925879117,4.428571428571429,0,1.5714285714285714,4.5,3.8333333333333335,3.2559414990859232,0.10757398284279028,0,-0.4399935565827014,3,3,3,3,3,3,5,4,2,3,2,3,5,4,3,5,4,3,2,4,1.0600988273786194,3,0,3.4,0,2.4,0,3,0,2.933333333333333,0,1,2,4,2,3,4,3,1,4,1,2,2,2,3,1,1,2,3,2,3,1.0310954828418375,2.7,0,"White, Caucasian, Anglo, European American",0,23,0,1,NA,1,1,3,N/A,2,0,230,69,1,5,2,0,0,0,0,0,TRUE,TRUE,TRUE,TRUE,TRUE,6,1.089739999985695,0.8,0.13091249012922296,6,0.3888071428707668,0.411977777754819,0.9032258064516129,0.84375,0.0013698809454670466,0.0033196094240203495,6,0.5540062500014901,0.6590645161136505,1,0.96875,0.003658554150272166,0.010674039023802874,1.9983,0.789,0.3766,1.4545,0.7396,0.6511,0.1425,1.858729335,0.7793934577333334,0.3821110182333333,0.7875,3.82,0.3034,2.2368,0.2847,-71.7794,0.5561,5.3247,0.3394,3.4111,0.3491,0.9989,0.8401937049333333,2.5794076053,4.073281476666667,0.2824001076,0.29989541686666665,1.0258,5.8435,0.4685,3.827,0.5249,0.9706,0.077,0.423,0.579,0.018,1.848,102.66666666666669,1.800340728,5.357052945333334,3.299323194333333,0.3912811711333333,0.39677623666666667,336,0.9955555555555555,1,0,0,1,FALSE,FALSE,FALSE
444,2021-11-13T07:00:40Z,2021-11-13T07:19:45Z,1145,1,2021-11-13T07:19:48Z,1,Chrome,95.0.4638.69,Windows NT 10.0,1920,1080,NA,1.7777777777777777,607,33,284,73,48,64,-0.4681367917208586,-0.5160529961009127,-0.6908653186894065,-0.38486320452578127,-0.3307319143023651,-0.6989073197411108,4,4,1,1,4,1,1,3,1,4,3,1,1,1,4,4,1,1,4,4,1.465390194130093,0,1,2,4,4,1.1,0,4,5,1,5,1,1,4,1,1,1,1,4,1,4,3,1,3,1,1,1,1,1,1,1,2,0,0,5,5,5,5,5,5,4,4,4,1,5,1,1,2,1,4,1,1,1,1,1,4,1,1,1,1,1,1,2,2,1,5,1,1,1,1,1,1,1,2,2,1.735514912644663,1.6846647257229665,1.25,0,1.5,0,1.4,0,1.3333333333333333,0,1.3333333333333333,0,1,0,1.1428571428571428,0,1,0,1.2702702702702702,0,1,0,0,-1.076362004610271,-1.172888410658384,-0.3773458880470143,-0.7751171493526992,5,1,5,1,1,1,1,1,2,1.9518001458970664,1,0,1.5,-0.7186247266594448,5,5,5,5,3,2,1,7,6,6,4,1.7043362064926932,4.285714285714286,0,1.7142857142857142,2.5,3.8333333333333335,3.2559414990859232,-1.0219528370065065,0,-0.9250859690859132,2,2,2,2,2,2,4,2,2,5,4,4,1,4,4,1,5,4,4,4,1.3451854182690985,2,0,3.4,0,4.6,0,3.6,0,3.8666666666666667,0,1,1,1,3,2,2,2,2,2,1,1,2,1,3,1,2,1,3,1,1,0.7451598203705946,1.75,0,"White, Caucasian, Anglo, European American",0,20,0,1,NA,1,4,3,Student,6,0,170,70,3,5,2,0,0,1,0,0,TRUE,TRUE,TRUE,TRUE,TRUE,1,0.779262500000745,0.8333333333333334,0.02475863808539215,1,0.4357064516135762,0.5152366666659712,0.96875,0.9375,0.0010228929738501785,0.002855373135066533,1,0.6058812500000931,0.693467741936926,1,0.96875,0.011127475121083301,0.01669126387058847,1.2284,1.4715,0.5051,0.8715,1.8738,0.613,0.2175,1.268697624,1.2315139961666666,0.49642747713333335,0.7476,5.8613,0.3779,3.4033,0.4139,-103.853,0.6806,6.479,0.3845,5.4866,0.4497,0.9467,0.8178913820666667,3.5997129893333333,5.574072895666666,0.409028475,0.3728569315,1.1746,5.1758,0.4991,6.8309,0.597,0.9884,0.085,0.367,0.364,0.021,2.101,100.04761904761904,2.325266365666667,4.123688755666667,2.7449029156666667,0.32397816226666665,0.28003010516666665,326,0.965925925925926,1,1,2,3,FALSE,FALSE,FALSE
445,2021-11-13T06:52:28Z,2021-11-13T07:19:52Z,1644,1,2021-11-13T07:19:53Z,1,Chrome,94.0.4606.81,Macintosh,1920,1080,No thank you,1.7777777777777777,831,56,425,92,67,106,0.10740142021309255,-0.30710401489772066,-0.012057600756774062,-0.15332148037895377,-0.06830278120231312,0.010530084214718316,2,2,1,1,2,2,2,2,1,2,1,1,1,2,2,2,2,1,2,2,0.4893604849295929,0,1,2,3,3,2.25,0,4,4,2,3,2,1,4,2,2,1,2,3,2,3,3,2,3,1,1,1,2,1,2,2,2,0,0,5,5,3,4,4,5,5,5,4,2,4,2,2,2,2,3,3,3,4,3,3,4,1,1,1,4,2,1,2,1,1,4,3,2,1,3,1,2,2,2,2,1.364500590641815,0.990430401872025,1.625,0,2,0,2.1333333333333333,0,1.5555555555555556,0,2.75,0,1.6666666666666667,0,1.5714285714285714,0,1.6666666666666667,0,2.027027027027027,0,1,0,0,-0.37239971506330755,-0.3713685792530602,-0.22054348261253207,-0.29595603093279615,4,1,3,1,1,1,1,1,1,1.2535663410560174,1.4285714285714286,0,1,-0.6467170085812028,4,3,4,3,2,2,3,3,3,3,3,0.816496580927726,3,0,3,6,3.8333333333333335,3.2559414990859232,0.9547190977297628,0,0.7802889750751523,3,3,3,2,3,3,4,2,2,3,2,3,3,3,4,3,3,3,3,3,0.5936168397046637,2.8,0,3.2,0,3.2,0,3.6,0,3.3333333333333335,0,2,2,3,2,2,3,2,1,2,2,2,1,3,3,2,2,2,3,3,3,0.6386663736585051,2.65,0,"White, Caucasian, Anglo, European American & Filipino",1,19,0,1,NA,1,3,3,College student,3,0,165,70,4,5,2,0,0,1,0,0,TRUE,TRUE,TRUE,TRUE,TRUE,1,0.8736692307545588,0.78,0.05239145356835077,1,0.4346062500104308,0.5064548386681464,1,0.96875,0.0010685489928681045,0.005435951249091916,1,0.5790468750149012,0.6291812499985099,1,1,0.0037263535372033616,0.0034953944764558155,1.4646,0.9627,0.4818,1.0596,0.8262,0.6377,0.0126,1.481923504,0.9444748088333333,0.47491795096666667,1.1752,6.8087,0.3483,3.9787,0.3662,-97.7775,1.1315,9.5731,0.3786,4.8317,0.3908,0.8031,1.2270260631666667,3.9773499266666668,6.185721034666667,0.36082837183333333,0.34136044483333333,0.6753,5.8204,0.5193,5.2049,0.5732,0.8773,0.152,0.368,0.731,0.032,1.844,57.625,2.024938279066667,5.527126885666667,5.4297241456666665,0.4024710373,0.4519929984666667,304,0.9007407407407407,1,0,0,1,FALSE,FALSE,FALSE
446,2021-11-13T06:48:03Z,2021-11-13T07:19:53Z,1910,1,2021-11-13T07:19:55Z,0.8999999761581421,Chrome,95.0.4638.69,Windows NT 10.0,2560,1440,NA,1.7777777777777777,777,238,493,182,87,91,-0.03134439873527067,1.3463183581014513,0.3153106603738572,0.9434551076849661,0.20793841153458367,-0.2428404171980778,4,3,1,2,3,2,3,4,1,4,4,2,3,2,3,4,2,1,3,4,1.0699237552766379,1,1,1,2,1,1.65,0,4,3,3,3,3,2,4,4,3,1,4,2,2,4,3,3,5,1,1,2,3,3,3,1,2,0,2,4,3,1,1,1,1,1,1,1,3,2,1,1,1,1,3,5,5,4,5,5,2,4,1,1,4,1,1,1,1,1,1,4,3,1,3,2,1,1,1,1,1.4876872027456622,0.9258200997725514,2.625,0,1,0,2.7333333333333334,0,4.444444444444445,0,3.5,0,2.3333333333333335,0,2.142857142857143,0,2,0,3.2162162162162162,0,1,0,2,0.989294504717087,0.8272815345162342,-0.18124899968313501,0.3230162674165496,4,2,1,1,1,2,1,1,3,1.1126972805283737,2,0,2,0.06413940681375631,2,3,3,2,1,3,5,3,1,1,1,1.2535663410560174,2.142857142857143,0,3.857142857142857,7,3.8333333333333335,3.2559414990859232,1.5194825076544112,0,1.5406966645660969,4,3,3,3,4,4,5,3,3,4,3,3,2,4,4,5,5,2,1,3,1.1832159566199232,3.4,0,3.4,0,3,0,3.4,0,3.2666666666666666,0,3,3,2,2,4,2,3,2,3,1,2,3,2,3,2,3,1,2,3,3,0.7591546545162482,2.45,0,"White, Caucasian, Anglo, European American",0,25,0,1,NA,1,2,1,Unemployed,2,0,160,67,2,5,2,0,0,0,0,0,TRUE,TRUE,TRUE,TRUE,TRUE,2,0.7530205882366966,0.6938775510204082,0.014983831249830092,2,0.7472062499942258,0.9057419354848323,1,0.96875,0.011866689637120804,0.018463897257578413,2,0.9729781249985099,1.0526281249988825,1,1,0.02432186627985378,0.015929456279693787,1.1694,0.7584,0.4592,0.7407,0.9684,0.6414,0.2813,1.2304934472,0.8372901117333333,0.45173911133333333,2.38,4.0987,0.4569,2.8643,0.5067,-31.9532,0.7906,3.6815,0.6605,3.3569,0.8122,0.9602,2.5608328823333335,2.804501177666667,3.997625565,0.4587839824,0.42257780926666666,1.4475,2.6238,0.7291,3.5025,0.8558,0.9295,0.314,0.393,0.534,0.021,1.763,83.95238095238095,3.9966335226666665,3.9270903876666665,4.071876573666667,0.4617789522333333,0.5639965489333333,104,0.3081481481481481,1,0,2,3,FALSE,FALSE,FALSE
447,2021-11-13T07:01:39Z,2021-11-13T07:23:34Z,1314,1,2021-11-13T07:23:35Z,1,Chrome,95.0.4638.69,Windows NT 10.0,1920,1080,Have good day! :),1.7777777777777777,753,62,251,86,46,73,-0.09300920715676544,-0.2525955850186271,-0.8497352101204481,-0.2264399195832151,-0.3583560335760547,-0.5468850188934331,3,3,1,1,3,1,1,2,1,3,3,1,1,1,3,3,1,1,3,3,0.998683343734455,0,1,1,3,3,1.55,0,5,5,2,5,2,1,4,1,1,1,1,5,2,5,3,1,1,1,1,1,1,1,1,1,2,0,0,4,1,5,4,3,5,5,5,5,2,5,1,1,4,1,5,1,1,1,1,1,5,1,1,1,1,1,1,2,2,1,5,1,1,1,1,1,1,1,1,1,1.7514472779868562,1.7674302033770737,1,0,1,0,1.4,0,1.8888888888888888,0,1.1666666666666667,0,0.8333333333333334,0,1.1428571428571428,0,1,0,1.3243243243243243,0,1,0,0,-1.1982420428004914,-1.2570959041160135,-0.5341482934814965,-0.895622098798755,5,1,5,1,1,2,1,2,2,1.889822365046136,1.1428571428571428,0,2,-0.44866370411710943,5,5,5,5,2,2,1,6,7,5,3,1.8126539343499315,4.142857142857143,0,1.8571428571428572,2.5,3.8333333333333335,3.2559414990859232,-1.0219528370065065,0,-0.8454149716644763,2,3,2,2,2,1,5,2,2,3,1,5,1,4,4,1,5,2,3,4,1.5522640914238175,2.2,0,4.8,0,4.2,0,3.6,0,4.2,0,1,1,1,4,1,1,1,4,1,4,1,4,1,1,1,4,1,1,1,1,1.332784974957958,1.15,0,"White, Caucasian, Anglo, European American",0,19,0,1,NA,1,2,4,Manager at Chick-fil-A,1,0,125,69,1,5,2,1,0,1,0,1,TRUE,TRUE,TRUE,TRUE,TRUE,1,0.9516702702722034,0.7551020408163265,0.10693821558000186,1,0.4519310344858416,0.516448387096005,0.9354838709677419,1,0.006529939848622366,0.014644945247618753,1,0.6087874999977648,0.6318518518507481,1,0.8709677419354839,0.020825563709762306,0.013520757569278565,1.5402,0.7583,0.4528,1.31,0.7047,0.5804,0.3147,1.5462626353333333,0.8024561121666667,0.4472423435333333,1.2008,3.3514,0.288,3.3349,0.3364,-57.228,1.0036,4.561,0.3401,3.7504,0.3767,0.8793,1.2990723556333332,3.5341542153333334,3.6476744516666666,0.33058638183333333,0.2823029342,1.0373000000000001,4.2033,0.4758,2.943,0.4759,0.9316,0.066,0.361,0.265,0.026,2.066,79.46153846153845,1.4493808971333333,2.7693700543333333,2.1567004055,0.335260508,0.35609484523333335,310,0.9185185185185185,1,0,0,1,FALSE,FALSE,FALSE
448,2021-11-13T07:02:25Z,2021-11-13T07:28:50Z,1584,1,2021-11-13T07:28:50Z,1,Chrome,95.0.4638.69,Windows NT 10.0,1920,1080,NA,1.7777777777777777,723,60,392,98,76,182,-0.17009021768363392,-0.2707650616449916,-0.1709274921878157,-0.08020304117469244,0.05600575552929045,1.294273958039552,3,2,1,2,2,1,3,4,1,3,3,1,2,2,2,3,2,1,2,4,0.9514531821875089,0,0,3,4,5,1.9,0,2,5,1,3,1,2,4,2,1,1,3,5,5,5,3,1,1,1,1,1,1,1,2,1,2,0,0,4,2,3,3,2,4,2,4,3,1,5,1,1,4,2,4,2,1,1,3,3,5,1,1,1,2,1,1,3,3,1,5,1,2,1,1,1,2,1,1,1,1.3512312258920847,1.5976172734359604,1.125,0,1.25,0,2.066666666666667,0,3,0,1.6666666666666667,0,1,0,1.5714285714285714,0,1,0,1.864864864864865,0,1,0,0,-0.7842701889475012,-0.6845817388264964,-0.4557470907642554,-0.5701644147953759,4,1,3,1,1,2,2,3,1,1.1547005383792515,1.7142857142857142,0,2,-0.10679496349653231,5,5,5,5,3,3,1,2,2,NA,3,1.5735915849388864,4.428571428571429,0,1.5714285714285714,7,3.8333333333333335,3.2559414990859232,1.5194825076544112,0,0.265960705823109,2,2,3,1,1,1,4,2,1,3,1,4,1,4,3,2,4,5,3,4,1.3732131246511903,1.8,0,3.8,0,3.8,0,3.6,0,3.7333333333333334,0,2,1,1,2,1,3,2,3,2,1,2,2,3,3,1,2,2,3,2,2,0.7254762501100116,2.1,0,"White, Caucasian, Anglo, European American",0,19,0,1,NA,1,3,2,furniture factory worker,7,0,176,67,2,5,2,0,0,1,0,0,TRUE,TRUE,TRUE,TRUE,TRUE,2,0.8581268292687289,0.82,0.06431406050593737,2,0.4843843749999069,0.5884225806440077,1,1,0.00845003942553164,0.007383664473053891,2,0.6489999999993015,0.7477806451604251,1,0.96875,0.006752745806463361,0.014415538377184563,1.6852,1.0873,0.4025,1.3003,0.936,0.5262,0.2316,1.6346780363333333,0.9647626723666667,0.3473757242666667,2.1485,5.7246,0.2967,4.9019,0.3693,-73.7554,0.8854,4.9372,0.3886,4.5967,0.4883,0.7623,1.795774481,4.25933995,5.116201297666667,0.379940506,0.31123054203333334,1.0553,6.0242000000000004,0.5586,2.75,0.5881,0.9674,0.076,0.474,0.41,0.019,1.851,97.42105263157895,2.256220955,4.906462293,2.972211608,0.4226552799666667,0.38124381556666664,314,0.9303703703703704,1,0,1,2,FALSE,FALSE,FALSE
449,2021-11-13T07:01:36Z,2021-11-13T07:32:57Z,1880,1,2021-11-13T07:32:58Z,0.8999999761581421,Chrome,95.0.4638.69,Windows NT 10.0,1366,768,None,1.7786458333333333,714,111,677,111,83,95,-0.19321452084169444,0.19255659232730382,1.201130661080271,0.07822024376787376,0.15269017298720433,-0.1752749501546655,3,2,2,2,2,1,1,3,2,2,1,2,1,3,2,2,2,2,2,2,0.6048053188292994,0,0,2,2,2,2.35,0,4,4,2,4,2,1,4,2,2,2,1,3,1,4,4,3,3,1,2,2,3,3,3,1,3,0,0,5,3,3,3,1,4,3,3,5,2,4,3,2,2,2,4,3,2,3,2,2,4,1,5,1,1,1,2,3,3,1,4,3,2,2,1,3,2,3,3,3,1.1835965955091712,1.2344267996967353,2.5,0,2.75,0,1.8666666666666667,0,2.6666666666666665,0,2.4166666666666665,0,1.6666666666666667,0,2.142857142857143,0,2,0,2.324324324324324,0,1,0,0,0.3567791341092188,0.01782490487697288,0.01466012553919125,0.016242515208082065,3,2,3,1,1,3,2,2,1,0.8997354108424374,2.142857142857143,0,1.5,-0.03488724541829051,1,2,3,3,1,2,2,1,6,1,2,0.816496580927726,2.2857142857142856,0,3.7142857142857144,5.5,3.8333333333333335,3.2559414990859232,0.6723373927674386,0,1.037453109701174,2,2,2,2,2,2,3,4,2,3,3,3,2,3,3,4,3,2,3,4,0.7037315505489968,2,0,3.4,0,3,0,2.8,0,3.066666666666667,0,1,1,2,3,3,2,2,2,2,1,2,3,3,3,1,2,1,2,3,2,0.7591546545162482,2.05,0,Black or African American,0,28,0,1,NA,0,1,6,Currently unemployed but studied Psychology,1,0,125,68,3,5,2,0,0,0,0,0,TRUE,TRUE,TRUE,TRUE,TRUE,4,0.7654424242415663,0.673469387755102,0.020721780340105807,4,0.5244281250000932,0.62023333333383,1,0.9375,0.0044449317641940085,0.0036750026512124357,4,0.6190612903230133,0.6733678571432828,0.96875,0.9032258064516129,0.005647513619019642,0.005598943333316892,0.981,0.7785,0.5514,0.7653,0.821,0.6203,0.1972,1.0495510078333334,0.8617116814366667,0.5436830804333334,1.2695,4.2308,0.3744,3.6553,0.4653,-70.5072,0.7604,5.3843,0.4565,4.0216,0.5374,0.9931,1.4710955667,3.7947659666666667,4.552790057666667,0.44690320263333333,0.36241973936666666,0.6947,5.0097,0.55,2.6464,0.5855,0.6652,0.046,0.515,0.407,0.008,0.981,122.625,1.4062650914333332,3.3194529156666666,2.8441682623333335,0.4175385162,0.4678843748666667,334,0.9896296296296296,1,0,0,1,FALSE,FALSE,FALSE
450,2021-11-13T07:03:49Z,2021-11-13T07:34:48Z,1858,1,2021-11-13T07:34:50Z,1,Chrome,95.0.4638.69,Windows NT 10.0,1536,864,Some questions/ answers are a bit too vague and should account for more factors concerning more complex family dynamics.,1.7777777777777777,716,69,515,120,87,81,-0.1880757868065699,-0.18900241682635124,0.42122392132788494,0.18789790257426575,0.20793841153458367,-0.4117540848066085,2,1,3,4,1,1,4,1,2,1,1,2,3,2,1,1,3,2,1,1,1.0399898784932577,0,1,1,2,1,3.25,0,3,4,5,2,5,3,1,3,4,5,5,2,4,2,2,3,5,5,2,4,5,3,3,3,2,2,2,5,1,2,5,1,5,5,5,2,5,1,1,5,2,5,2,5,5,5,5,5,1,2,5,1,5,5,1,3,3,1,4,1,1,1,5,2,2,2,2,2,1.8079736637376023,1.3451854182690985,3.75,0,2,0,4,0,2.5555555555555554,0,4.5,0,3.6666666666666665,0,1.5714285714285714,0,2.6666666666666665,0,3.2432432432432434,0,2,2,2,1.7058650740768326,1.8667117324949531,0.7487147001683933,1.3077132163316731,4,2,2,2,1,1,1,8,1,1.0690449676496976,1.8571428571428572,0,4.5,0.9011414085945675,1,4,4,3,2,2,4,2,1,NA,2,1.2149857925879117,2.5714285714285716,0,3.4285714285714284,7.5,3.8333333333333335,3.2559414990859232,1.8018642126167355,0,1.4428745247829489,1,1,1,1,1,2,5,1,1,5,2,5,1,5,5,1,5,1,5,1,1.9639610121239315,1,0,4.6,0,5,0,5,0,4.866666666666666,0,4,4,4,1,2,4,4,1,4,4,4,1,4,4,4,1,1,4,4,4,1.348488432516786,3.75,0,"Hispanic of Latino (e.g., Mexican American, Central American, and others)",0,27,0,1,NA,1,2,4,Unemployed,2,0,90,65,1,5,2,0,0,0,0,0,TRUE,TRUE,TRUE,TRUE,TRUE,6,0.911248936196591,0.94,0.04682031478414324,6,0.46906774191702566,0.54235,0.96875,0.9375,0.0034525787075830277,0.004683184153033572,6,0.6619718750119209,0.7239187500476837,1,1,0.013527470483496343,0.015585897056015386,1.5393,1.8483,0.5585,1.4026,1.9069,0.5972,0.2893,1.4847584733333334,1.4467996771333334,0.5513915893,1.2119,3.5715,0.3103,3.2097,0.3748,-60.0171,0.7541,4.5379,0.3955,4.0008,0.4628,0.9878,1.3397962815,3.413403415,3.8998165316666666,0.36521317973333334,0.30404397023333335,1.2493,4.0147,0.5163,5.6212,0.6072,0.9743,0.302,0.175,0.639,0.017,1.487,87.47058823529412,2.4911254053333334,4.20399537,3.960226659,0.3666147186666667,0.41343553326666665,352,1.0429629629629629,1,0,0,1,FALSE,FALSE,FALSE
451,2021-11-13T07:01:09Z,2021-11-13T07:37:09Z,2159,1,2021-11-13T07:37:09Z,0.8999999761581421,Chrome,95.0.4638.69,Windows NT 10.0,1920,1080,NA,1.7777777777777777,744,42,286,40,77,57,-0.11613351031482598,-0.43429035128227234,-0.6812368404208585,-0.7870146201492185,0.06981781516613529,-0.8171468870670823,2,2,3,3,2,3,4,1,2,2,1,3,2,4,1,1,3,2,1,1,0.9880869341680844,0,1,1,3,3,3.25,0,4,4,2,4,1,1,4,1,2,1,1,4,1,4,3,2,2,1,1,2,2,1,2,2,4,0,0,4,4,4,4,2,5,5,5,3,1,5,2,2,3,2,5,1,1,2,1,1,5,1,1,1,2,1,1,3,3,1,4,1,1,1,2,1,2,2,2,2,1.5382998298011887,1.4074631010979937,1.625,0,2,0,1.6666666666666667,0,2,0,1.5,0,1,0,1.5714285714285714,0,1.3333333333333333,0,1.5945945945945945,0,1,0,0,-0.6413763510693116,-0.7577551469345059,-0.22054348261253207,-0.489149314773519,2,4,2,4,4,4,4,1,1,0.9759000729485332,4,0,1,0.8916923242113942,4,3,3,3,1,1,2,4,4,NA,2,1.1338934190276817,2.7142857142857144,0,3.2857142857142856,5,3.8333333333333335,3.2559414990859232,0.38995568780511447,0,0.6572492649557016,3,3,3,3,3,3,3,3,3,2,3,3,2,3,2,4,3,3,3,3,0.5163977794943222,3,0,3,0,2.8,0,2.8,0,2.8666666666666667,0,3,2,4,1,3,4,3,1,4,2,1,2,3,3,2,2,2,3,3,4,0.99472291830968,3,0,"Black or African American & White, Caucasian, Anglo, European American",1,25,0,1,NA,1,2,3,Unemployed,2,0,190,70,1,5,2,0,0,1,0,0,TRUE,TRUE,TRUE,TRUE,TRUE,NA,NA,NA,NA,2,0.5405692307696892,0.5463846153811767,0.8125,0.896551724137931,0.04537445305523142,0.022694802562596105,2,0.7035718750003725,0.777066666668212,1,0.9,0.021017112409436992,0.008475311540262969,NA,NA,NA,NA,NA,NA,NA,NA,NA,NA,1.1368,1.142,0.2486,2.4195,0.3939,-9.5915,0.8522,2.1378,0.387,1.8667,0.4161,0.9426,1.1981646249333333,2.6058538713333332,1.4215603287333334,0.3855105749666667,0.24460633683333333,0.8158,3.3713,0.5897,2.9639,0.6631,0.9994,0.069,0.521,0.404,0.01,1.43,143,1.4111453883666667,3.4878490563333333,2.881567427333333,0.4968535504666667,0.5852476639333334,104,0.3081481481481481,1,1,20,21,FALSE,FALSE,FALSE
452,2021-11-13T07:17:03Z,2021-11-13T07:40:28Z,1404,1,2021-11-13T07:40:31Z,1,Chrome,95.0.4638.69,Windows NT 10.0,1920,1080,NA,1.7777777777777777,673,73,343,85,55,111,-0.298558568561748,-0.15266346357362218,-0.4068252097672411,-0.23862632611725865,-0.2340474968444512,0.0949869180189837,3,3,2,1,3,1,3,2,2,3,3,3,2,1,3,3,3,1,3,3,0.8207826816681233,0,1,1,4,4,2,0,5,5,2,5,1,1,5,1,1,1,1,5,1,5,4,1,1,1,1,1,1,1,1,1,2,0,0,5,4,3,4,5,5,5,5,5,1,5,1,1,3,1,5,1,1,1,1,1,5,1,1,1,2,1,1,2,1,1,5,1,1,1,1,1,1,1,1,2,1.7866707005467437,1.9591057240729093,1,0,1.25,0,1.1333333333333333,0,1.4444444444444444,0,1.1666666666666667,0,1,0,1,0,1,0,1.2162162162162162,0,1,0,0,-1.2654862018019926,-1.4181548341315258,-0.4557470907642554,-0.9369509624478906,5,1,4,1,1,1,1,2,1,1.7320508075688772,1.1428571428571428,0,1.5,-0.6331575415043005,5,5,5,5,2,2,2,6,4,3,3,1.6035674514745464,4,0,2,4,3.8333333333333335,3.2559414990859232,-0.1748077221195339,0,-0.34217141679955326,2,2,2,3,2,2,4,4,2,2,3,3,2,4,4,1,4,3,3,4,1,2.2,0,3.4,0,3.6,0,3.2,0,3.4,0,1,2,1,4,3,2,1,2,1,2,1,3,1,2,1,2,1,2,1,2,0.8506963092234007,1.65,0,"White, Caucasian, Anglo, European American",0,22,0,1,NA,1,3,3,Unemployed,3,0,163,72,2,5,2,0,0,1,0,0,TRUE,TRUE,TRUE,TRUE,TRUE,2,0.7345714285714285,0.7,0.0172580729015323,2,0.5327193548352488,0.5801281249988824,1,1,0.0041011582796154095,0.004539739505797383,2,0.6952562499968334,0.7684906250014901,1,1,0.01546806318542994,0.008276725393623221,1.2582,0.7533,0.3849,0.8806,1.1524,0.546,0.1692,1.3075593176666667,0.82750641565,0.3787351771333333,9.9997,10.6433,0.063,10.604,0.1086,-84.1227,0.8259,5.6035,0.4596,4.9512,0.5022,0.8873,2.126158142,5.133889349333334,5.239530291666667,0.3787154138666667,0.33263641773333336,1.2666,3.7242,0.5297,4.1153,0.6249,0.9581,0.194,0.354,0.588,0.016,1.628,101.74999999999999,2.779114989,4.190456357666666,4.734462629,0.3641527711,0.4817528217666667,324,0.96,1,0,0,1,FALSE,FALSE,FALSE
453,2021-11-13T07:18:33Z,2021-11-13T07:41:00Z,1346,1,2021-11-13T07:41:01Z,0.8999999761581421,Chrome,95.0.4638.69,Windows NT 10.0,1536,864,No,1.7777777777777777,595,79,357,61,98,84,-0.498969195931606,-0.09815503369452862,-0.3394258618874053,-0.5311000829343039,0.3598710675398769,-0.3610799845240493,4,4,1,1,4,1,1,4,1,4,4,1,1,1,4,4,1,1,4,4,1.538967528127731,0,1,2,5,5,1,0,5,5,1,5,1,1,5,1,1,1,1,5,1,5,5,1,1,1,1,1,1,1,1,0,2,0,0,5,5,5,5,5,5,5,5,5,1,5,1,1,5,1,5,1,1,1,1,1,5,1,1,1,1,1,1,1,1,1,5,1,1,1,1,1,1,1,1,1,1.9666895707934864,2.065591117977289,1,0,1,0,1,0,1,0,1,0,0.8333333333333334,0,0.8571428571428571,0,1,0,1,0,0,0,0,-1.3999745198049947,-1.568373259242148,-0.7372407672780129,-1.1528070132600805,5,1,5,1,1,1,1,1,1,1.9518001458970664,1,0,1,-0.9031185640466358,5,5,5,5,5,5,5,3,3,4,3,0,4.428571428571429,0,1.5714285714285714,6,3.8333333333333335,3.2559414990859232,0.9547190977297628,0,-0.01642099913921513,1,1,3,1,1,1,4,1,1,3,1,3,2,4,4,1,3,2,2,5,1.3557637102737474,1.4,0,4,0,3.6,0,3.8,0,3.8,0,1,1,1,4,1,1,1,4,1,1,1,4,1,1,1,4,1,1,1,1,1.231174022502185,1,0,"White, Caucasian, Anglo, European American",0,29,0,1,NA,1,3,3,manufacturing,3,0,230,69,3,5,2,0,0,1,0,0,TRUE,TRUE,TRUE,TRUE,TRUE,4,0.7005538461540755,0.78,0.020963124636685863,4,0.4623866666669647,0.5075749999981906,0.967741935483871,0.875,0.0026065125807642705,0.0034554470867074727,4,0.5669096774189702,0.6466916666645557,1,0.75,0.004512048903137541,0.00693556942560671,1.3101,1.0819,0.3515,0.8256,1.7317,0.5496,0.2167,1.344891123,1.0253557069333334,0.3456042966,0.8279,4.2369,0.3685,2.6386,0.3857,-76.7959,0.7375,4.8083,0.3879,3.0655,0.4121,0.9592,0.9150029855333334,2.933512615,4.449288863666666,0.37933656313333336,0.3628439546,0.6402,3.8078,0.5074,2.4369,0.5525,0.8708,0.052,0.426,0.362,0.014,1.893,135.21428571428572,1.2054850828333334,3.857729597,1.5377924767333333,0.40847741783333336,0.40266526773333333,390,1.1555555555555557,1,0,0,1,FALSE,FALSE,FALSE
454,2021-11-13T07:19:27Z,2021-11-13T07:43:33Z,1446,1,2021-11-13T07:43:34Z,0.8999999761581421,Chrome,95.0.4638.69,Macintosh,1440,900,NA,1.6,812,64,332,77,39,77,0.058583446879409196,-0.23442610839226255,-0.459781840244255,-0.3361175783896071,-0.4550404510339686,-0.47931955185002084,4,4,1,1,3,1,1,3,1,3,3,1,1,1,4,4,1,1,3,3,1.2814465510343749,1,1,1,4,3,1.3,0,4,4,2,4,1,1,3,1,2,2,1,4,1,4,4,2,2,1,1,2,1,1,1,0,2,0,0,5,1,2,3,1,5,3,4,4,2,4,1,1,4,1,2,2,1,1,1,1,5,1,1,1,2,1,1,1,1,1,4,1,3,1,1,1,2,1,1,2,1.4040909769211791,1.3557637102737474,1.375,0,1.5,0,1.7333333333333334,0,2.888888888888889,0,1.5833333333333333,0,1,0,1.2857142857142858,0,1,0,1.7567567567567568,0,0,0,0,-0.696012230258031,-0.7668534278368243,-0.5804383618435307,-0.6736458948401776,3,2,3,2,2,2,1,2,1,0.6900655593423543,2.142857142857143,0,1.5,-0.03488724541829051,4,4,4,4,3,2,2,3,3,3,3,0.9511897312113419,3.5714285714285716,0,2.4285714285714284,6,3.8333333333333335,3.2559414990859232,0.9547190977297628,0,0.46160498538940525,2,3,3,2,3,3,3,4,3,2,3,3,2,4,4,3,3,2,3,3,0.6546536707079771,2.6,0,3.2,0,3,0,3.2,0,3.1333333333333333,0,1,1,1,1,1,1,1,4,1,1,1,4,1,1,1,4,1,1,1,1,1.0990426455975697,1.15,0,"Hispanic of Latino (e.g., Mexican American, Central American, and others)",0,18,0,1,NA,1,3,3,University student,3,0,180,75,3,5,2,0,0,1,0,0,TRUE,TRUE,TRUE,TRUE,TRUE,5,0.7742952380955574,0.84,0.03340963028968948,5,0.48193749999953434,0.561596666666617,1,0.967741935483871,0.001734710161285254,0.006972735118131363,5,0.6426781249998603,0.7221906249995809,1,1,0.010944617893025253,0.01223361636084099,1.1634,1.5045,0.5173,0.7273,1.9855,0.6418,0.1939,1.2111664825,1.2504440542,0.5077940797,1.5038,5.9652,0.3559,3.8895,0.3763,-79.8084,0.7832,7.696,0.4361,3.789,0.4703,0.9991,1.5409785747,3.853687139333333,5.62451552,0.37026018773333336,0.3491916077,1.1336,3.1961,0.488,4.537,0.6002,0.9071,0.252,0.245,0.644,0.021,1.835,87.38095238095238,2.7709335636666665,4.436086663,4.145680630333334,0.3322334075666667,0.39255022096666664,444,1.3155555555555554,1,0,0,1,FALSE,FALSE,FALSE
456,2021-11-13T07:01:40Z,2021-11-13T07:52:28Z,3047,1,2021-11-13T07:52:29Z,1,Chrome,94.0.4606.81,Windows NT 10.0,1536,864,NA,1.7777777777777777,733,52,872,685,392,137,-0.1443965475080111,-0.3434429681504497,2.139907292263699,7.073217594308874,4.420616600772259,0.5341624538011636,3,2,1,1,3,1,2,1,1,3,2,1,1,1,3,1,2,1,1,2,0.812727700887249,0,1,2,5,3,2.05,0,2,5,4,5,3,1,5,1,1,1,1,5,1,5,3,2,1,1,1,1,1,1,1,1,2,0,0,5,5,5,5,4,5,5,5,5,1,4,1,1,5,1,4,3,1,2,3,2,5,1,1,1,1,1,1,2,1,1,5,2,2,1,1,1,2,1,1,1,1.7646852733884628,1.8073922282301278,1.125,0,1.25,0,1.6666666666666667,0,1.1111111111111112,0,1.6666666666666667,0,0.8333333333333334,0,1.2857142857142858,0,1,0,1.3243243243243243,0,1,0,0,-1.120490983955006,-1.088777707423119,-0.4557470907642554,-0.7722623990936872,5,1,3,1,1,1,1,1,1,1.5735915849388864,1.2857142857142858,0,1,-0.7321841937363471,5,5,5,5,4,4,1,6,6,5,3,1.4638501094227998,4.714285714285714,0,1.2857142857142858,3,3.8333333333333335,3.2559414990859232,-0.7395711320441822,0,-1.022908108869061,2,2,3,3,2,2,5,3,2,4,3,4,3,5,4,1,3,4,4,3,1.1126972805283737,2.4,0,3.2,0,4.2,0,3.8,0,3.7333333333333334,0,2,2,4,4,2,3,2,3,2,2,3,1,1,4,2,2,4,4,1,4,1.0954451150103321,2.6,0,"White, Caucasian, Anglo, European American",0,19,0,1,NA,1,3,4,Student,1,0,145,68,3,5,2,0,0,0,0,0,TRUE,TRUE,TRUE,TRUE,TRUE,2,0.95174358970691,0.7959183673469388,0.17423973944445859,2,0.4054593750089407,0.4911333333333333,1,0.9375,0.002740178610545263,0.005709751514081265,2,0.5521125000119209,0.5868156249970198,1,1,0.004110212739320877,0.006101084592810694,1.4501,0.9294,0.5723,1.2922,0.7895,0.6231,0.1987,1.485049006,0.9234839013666667,0.5593547468666666,1.364,4.5504,0.2556,3.5203,0.3154,-69.2193,0.7906,5.7486,0.3416,4.5313,0.4043,0.9924,1.4038438161333333,3.602838912,4.624462744333333,0.31287127033333334,0.25362704873333336,1.0249,5.957,0.4686,3.9287,0.4674,0.9912,0.106,0.383,0.598,0.056,1.341,23.94642857142857,2.1653940796666666,5.137551666666667,5.088386001,0.34650089283333335,0.38233121663333336,390,1.1555555555555557,1,0,0,1,FALSE,FALSE,FALSE
457,2021-11-13T07:21:18Z,2021-11-13T07:53:12Z,1913,1,2021-11-13T07:53:13Z,0.8999999761581421,Firefox,100.0,Windows NT 10.0,1920,1080,NA,1.7777777777777777,730,105,539,149,111,133,-0.15210464856069794,0.13804816244821022,0.5367656605504606,0.5413036920615288,0.5394278428188598,0.4665969867577513,4,4,1,1,3,1,1,3,1,3,4,1,1,1,4,4,1,1,4,4,1.4244112357114616,0,1,2,4,4,1.15,0,4,5,2,4,2,1,4,1,1,1,1,5,2,5,4,1,2,1,1,1,1,1,2,0,5,0,0,5,4,5,3,3,3,4,4,5,2,5,1,1,5,1,4,1,1,1,2,2,5,1,1,1,1,1,1,1,1,1,5,1,1,1,1,1,1,1,2,2,1.6508256192660766,1.65615734242165,1.25,0,1.5,0,1.4666666666666666,0,2,0,1.3333333333333333,0,0.8333333333333334,0,0.8571428571428571,0,1,0,1.3513513513513513,0,0,0,0,-1.0259288853591455,-1.1093940247868836,-0.5804383618435307,-0.8449161933152072,4,1,3,1,1,3,2,1,3,1.2149857925879117,1.8571428571428572,0,2,-0.021327778341387937,5,5,5,5,3,3,1,5,7,4,4,1.5735915849388864,4.428571428571429,0,1.5714285714285714,3,3.8333333333333335,3.2559414990859232,-0.7395711320441822,0,-0.8635661140261877,2,2,2,2,2,3,2,3,2,3,2,2,2,3,2,3,3,3,4,5,0.8618916073713346,2,0,3,0,3.2,0,2.6,0,2.933333333333333,0,1,1,1,4,2,1,2,2,1,2,1,4,2,1,2,4,1,1,1,3,1.0894228312566052,1.45,0,"White, Caucasian, Anglo, European American",0,18,0,1,NA,1,4,4,I'm a student but I do a lot of IT stuff.,5,0,132,64,2,5,2,0,0,1,0,0,TRUE,TRUE,TRUE,TRUE,TRUE,1,0.8299761904761904,0.8571428571428571,0.016880308673469385,1,0.4150967741935484,0.4579375,1,1,0.0026282903225806455,0.002884447580645161,1,0.54775,0.6125483870967742,1,1,0.001379419354838709,0.0031146559139784945,1.1384,1.701,0.602,0.9968,1.4258,0.6477,0.0821,NA,NA,NA,2.3816,8.6297,0.2771,6.8699,0.2846,-102.7252,0.7671,7.8935,0.3636,6.323,0.4014,0.8533,NA,NA,NA,NA,NA,0.7021,6.4968,0.5018,5.8126,0.5518,0.966,0.092,0.433,0.771,0.038,2.02,53.15789473684211,NA,NA,NA,NA,NA,312,0.9244444444444444,1,0,0,1,FALSE,FALSE,FALSE
458,2021-11-13T07:17:03Z,2021-11-13T07:53:45Z,2201,1,2021-11-13T07:53:46Z,1,Chrome,95.0.4638.69,Windows NT 10.0,1536,864,Everything was good :),1.7777777777777777,1082,93,558,125,82,157,0.7523125416212253,0.029031302690023072,0.6282362041016665,0.24882993524448352,0.1388781133503595,0.8719897890182251,3,4,2,2,3,1,2,2,1,3,2,2,2,1,3,3,3,2,3,3,0.812727700887249,0,0,3,5,3,1.95,0,2,4,3,4,2,2,4,2,3,3,2,4,2,4,3,1,2,1,1,1,3,2,2,1,2,0,0,3,2,4,4,2,4,5,5,4,2,4,2,1,3,2,5,2,1,2,1,2,3,1,3,1,2,2,1,2,1,1,5,2,2,1,1,1,1,2,2,2,1.3428712906691034,0.8837151016885368,1.625,0,1.75,0,2.4,0,2.3333333333333335,0,1.75,0,1.8333333333333333,0,1.2857142857142858,0,1,0,1.8108108108108107,0,1,0,0,-0.5068880330663098,-0.3496875694432797,-0.2989446853297732,-0.3243161273865265,5,1,3,1,1,2,2,1,2,1.4638501094227998,1.5714285714285714,0,1.5,-0.3767559860388676,4,5,5,4,2,2,1,4,4,2,3,1.6035674514745464,3.857142857142857,0,2.142857142857143,5,3.8333333333333335,3.2559414990859232,0.38995568780511447,0,0.019881285584207653,3,3,2,1,2,3,4,3,2,4,2,3,1,4,3,1,4,2,4,4,1.0997835284835873,2.2,0,3.6,0,4.4,0,3.2,0,3.7333333333333334,0,2,1,1,2,3,2,3,3,2,2,1,2,2,3,2,2,1,3,2,2,0.6863327411532597,2.15,0,"White, Caucasian, Anglo, European American",0,20,0,1,NA,1,3,3,Student,2,0,141,67,3,5,2,0,0,0,0,0,TRUE,TRUE,TRUE,TRUE,TRUE,6,0.8154769230767702,0.7959183673469388,0.051330464447260034,6,0.5751968750001397,0.6470709677417913,1,1,0.02671520934500982,0.030657730129410535,6,0.7462843749998137,1.0073406250001862,1,1,0.033460995554123824,0.03600689345728552,1.4382,1.0269,0.4074,1.1394,1.3223,0.5392,0.3287,1.4548788003333333,0.9886340593,0.40112547253333336,2.7616,3.9799,0.2282,4.3534,0.3299,-43.2283,1.3539,4.4917,0.4108,3.7534,0.4441,0.9388,2.1359991016666666,3.864723427,3.452861019333333,0.37036253836666666,0.2585543359,1.3049,3.5956,0.5459,2.1048,0.7757,0.9331,0.156,0.376,0.429,0.008,1.951,243.875,3.0040417593333335,4.175971168666667,2.901775365,0.3866575679,0.4856760651,104,0.3081481481481481,1,0,0,1,FALSE,FALSE,FALSE
459,2021-11-13T07:19:40Z,2021-11-13T07:54:25Z,2085,1,2021-11-13T07:54:26Z,1,Chrome,95.0.4638.69,Windows NT 10.0,1920,1080,"The third attention game with the asterisk wasn't sized properly. With 1080p monitor and card setting set, it didn't find within the web container. I had to resize Chrome's view to 80%.",1.7777777777777777,897,45,302,273,145,257,0.27697964337220315,-0.40703613634272556,-0.6042090142724746,2.0524181022829295,1.0090378704715843,2.5611264651035324,3,3,1,1,3,1,1,2,1,3,2,1,1,1,2,2,1,1,3,2,0.8506963092234007,0,1,1,3,3,1.75,0,5,5,1,5,1,1,4,1,2,1,1,4,1,5,4,1,1,1,1,1,1,1,1,0,3,0,0,5,3,4,4,1,4,3,4,3,1,4,1,1,4,1,5,1,1,1,2,3,4,1,1,1,1,1,1,1,1,1,5,1,2,1,2,1,1,1,1,1,1.4688967484672493,1.8309508328682538,1,0,1,0,1.2666666666666666,0,2.5555555555555554,0,1.4166666666666667,0,1,0,1,0,1.3333333333333333,0,1.5945945945945945,0,0,0,0,-1.030131645296739,-1.198247448918038,-0.7372407672780129,-0.9677441080980254,5,1,4,1,1,2,1,1,1,1.6761634196950514,1.2857142857142858,0,1,-0.7321841937363471,4,4,4,3,1,1,2,1,1,2,3,1.3801311186847085,3,0,3,8,3.8333333333333335,3.2559414990859232,2.0842459175790595,0,1.3450523849998008,2,1,1,1,2,2,3,2,2,2,1,4,1,3,4,4,5,2,2,4,1.2227992865708155,1.4,0,4.4,0,2.8,0,3.4,0,3.533333333333333,0,2,1,1,4,3,2,2,3,1,1,1,3,2,2,2,3,1,1,2,2,0.8870412083230169,1.65,0,"Asian or Asian American (e.g., Chinese, Japanese, and others)",0,27,0,1,NA,1,3,5,Artist,2,0,140,69,2,5,2,0,0,2,0,0,TRUE,TRUE,TRUE,TRUE,TRUE,3,0.7064217391506485,0.92,0.025886081670636257,NA,NA,NA,NA,NA,NA,NA,3,0.4608843750171363,0.5092250000089407,1,1,0.004682586521717133,0.004064649676385541,1.2211,2.0882,0.4689,1.0834,2.4987,0.508,0.198,1.224304137,1.5208687746666667,0.46067754596666666,NA,NA,NA,NA,NA,NA,NA,NA,NA,NA,NA,NA,NA,NA,NA,NA,NA,0.9077,4.3402,0.3703,5.9744,0.4453,0.5051,0.08,0.297,0.462,0.028,1.64,58.57142857142857,1.9765471336666667,5.215463947333333,4.72223729,0.2766870465,0.3073409468666667,382,1.1318518518518519,1,0,5,6,FALSE,FALSE,FALSE
460,2021-11-13T07:32:55Z,2021-11-13T07:56:01Z,1385,1,2021-11-13T07:56:03Z,0.8999999761581421,Chrome,95.0.4638.69,Windows NT 10.0,1536,864,no,1.7777777777777777,666,46,405,80,54,65,-0.316544137684684,-0.39795139802954327,-0.10834238344225383,-0.29955835878747644,-0.24785955648129604,-0.6820159529802577,2,2,1,1,3,1,1,3,1,3,3,1,1,1,3,3,1,1,3,3,0.9679060415469871,0,0,1,3,3,1.6,0,5,5,1,5,1,1,5,1,1,1,1,5,1,5,3,1,1,1,1,1,1,1,1,1,2,0,0,4,1,1,2,2,3,1,1,3,3,2,2,1,2,2,2,2,2,2,2,2,5,5,1,1,1,1,1,3,3,3,5,1,1,1,2,1,2,1,3,3,1.187396273326605,1.98086080374405,1,0,2.25,0,1.1333333333333333,0,4,0,2.5,0,1.5,0,1.7142857142857142,0,1.3333333333333333,0,2.5135135135135136,0,1,0,0,-0.4585562937839808,-0.8606431533085982,-0.14214227989529096,-0.5013927166019446,5,1,4,1,1,1,1,1,1,1.7320508075688772,1.1428571428571428,0,1,-0.8176513788914915,3,3,5,3,1,1,2,1,1,3,2,1.3972762620115438,2.857142857142857,0,3.142857142857143,8,3.8333333333333335,3.2559414990859232,2.0842459175790595,0,1.4247233824212375,1,1,2,2,2,1,5,1,1,1,1,5,1,4,5,1,2,1,5,4,1.8464895909600492,1.6,0,4.4,0,4.2,0,4.2,0,4.266666666666667,0,1,1,1,3,1,1,1,3,1,1,1,3,1,1,1,3,1,1,1,1,0.8207826816681233,1.2,0,"Hispanic of Latino (e.g., Mexican American, Central American, and others)",0,24,0,1,NA,1,3,4,military,2,0,170,68,4,5,2,0,0,1,0,0,TRUE,TRUE,TRUE,TRUE,TRUE,1,0.7017076923174735,0.78,0.0489792292923733,1,0.528617857166699,0.6535199999809265,0.9655172413793104,0.9375,0.008177040663751217,0.007479323715584971,1,0.6442406250238418,0.7254033333778381,1,0.9375,0.0044462179746330936,0.009893419912938822,1.3306,0.9952,0.3081,1.1722,1.2408,0.4057,0.4443,1.3604292367,0.9710037932333333,0.3029661123,1.2246,3.1448,0.3444,3.0626,0.4803,-49.9325,0.8671,4.5786,0.4366,4.2329,0.5509,0.8705,1.4164801349,3.261137112,3.5826362233333335,0.4610095304,0.3338382938,0.9617,5.778,0.5621,2.5509,0.5824,0.9969,0.065,0.519,0.498,0.021,1.791,85.28571428571428,1.863003296,4.0902486253333334,3.326185506,0.4162892383333333,0.47317412236666667,104,0.3081481481481481,1,0,0,1,FALSE,FALSE,FALSE
463,2021-11-13T07:39:30Z,2021-11-13T08:01:51Z,1341,1,2021-11-13T08:01:52Z,0.8999999761581421,Chrome,95.0.4638.69,Windows NT 10.0,1920,1080,could've just asked for my screen resolution,1.7777777777777777,593,54,309,61,66,69,-0.5041079299667306,-0.3252734915240852,-0.5705093403325567,-0.5311000829343039,-0.08211484083915795,-0.6144504859368455,2,2,2,2,2,2,3,2,1,2,1,1,1,1,2,2,1,1,1,2,0.5871429486123998,0,1,1,2,2,2.35,0,4,3,2,3,2,2,4,2,2,2,2,3,2,3,3,2,3,3,2,2,2,2,2,0,7,0,0,4,4,3,3,3,5,4,4,3,2,4,2,2,3,2,2,4,2,2,2,2,3,1,1,1,1,1,1,1,1,1,4,2,2,1,1,2,2,2,1,1,1.179784680309035,0.7367883976130072,2.25,0,1.5,0,2.3333333333333335,0,2.3333333333333335,0,2.4166666666666665,0,1.1666666666666667,0,1.2857142857142858,0,1.3333333333333333,0,1.945945945945946,0,0,0,0,-0.034077540087006045,-0.051670474781162705,-0.5804383618435307,-0.3160544183123467,4,2,3,2,2,2,2,2,1,0.7867957924694432,2.142857142857143,0,1.5,-0.03488724541829051,3,3,4,4,1,1,2,5,5,2,2,1.2724180205607036,2.857142857142857,0,3.142857142857143,4,3.8333333333333335,3.2559414990859232,-0.1748077221195339,0,0.2951965625719407,2,2,2,2,2,2,5,2,2,2,1,5,1,3,3,3,5,2,2,3,1.3345232785352157,2,0,4.6,0,3.4,0,3.4,0,3.8,0,1,1,3,1,3,3,2,1,4,1,3,1,1,3,1,2,1,4,2,2,1.0760551736979407,2.5,0,"Asian or Asian American (e.g., Chinese, Japanese, and others)",0,22,0,1,NA,1,3,6,engineer,3,0,127,67,2,5,2,0,0,1,0,0,TRUE,TRUE,TRUE,TRUE,TRUE,6,0.8697849999986589,0.8,0.02924828597600922,6,0.5930866666674613,0.6939031249983236,0.967741935483871,1,0.04677260189118381,0.0678407390210682,6,0.6547366666684548,0.6985531250005588,0.967741935483871,1,0.006027819183183104,0.003264284506065785,1.3662,1.1343,0.5108,0.7321,1.7228,0.7519,0.353,1.399764438,1.0567186271333333,0.5026405711666667,1.7539,2.7088,0.2844,2.1614,0.2882,-14.2848,1.3671,2.8644,0.3204,1.9841,0.38,0.5257,1.7508072286666667,2.2695754397666668,2.8804435903333334,0.29208984753333334,0.28868716646666664,0.9377,4.5467,0.5607,5.7472,0.6284,0.8929,0.22,0.377,0.786,0.025,1.303,52.12,1.95108967,4.05399261,5.032777102,0.42728948466666666,0.5126422102666667,104,0.3081481481481481,1,1,0,1,FALSE,FALSE,FALSE
464,2021-11-13T07:41:52Z,2021-11-13T08:08:23Z,1591,1,2021-11-13T08:08:25Z,0.8999999761581421,Firefox,94.0,Windows NT 10.0,1536,864,NA,1.7777777777777777,735,63,472,101,55,90,-0.13925781347288652,-0.24351084670544482,0.2142116385541034,-0.04364382157256178,-0.2340474968444512,-0.2597317839589309,4,4,2,2,3,1,2,3,1,3,2,1,1,1,4,4,2,1,3,3,1.1367080817685316,0,1,1,4,4,1.55,0,4,3,4,3,3,2,4,1,2,1,1,4,1,4,4,1,1,2,1,1,1,2,1,3,2,0,0,5,4,4,5,4,5,5,5,5,2,4,1,4,2,2,4,2,2,1,1,1,3,1,1,2,3,2,1,3,3,3,4,2,2,2,2,2,2,3,2,3,1.3911992795553898,1.2798809468443688,1.25,0,2.5,0,2.066666666666667,0,1.3333333333333333,0,2,0,1.8333333333333333,0,2.142857142857143,0,2,0,1.8918918918918919,0,2,0,0,-0.6897080903516403,-0.6192483387300597,0.13935139661846652,-0.23994847105579659,3,2,2,2,1,3,2,4,2,0.6900655593423543,2.4285714285714284,0,3,0.6895286370535711,4,5,5,4,2,2,3,5,1,NA,1,1.2724180205607036,3.5714285714285716,0,2.4285714285714284,6,3.8333333333333335,3.2559414990859232,0.9547190977297628,0,0.46160498538940525,4,4,4,2,3,5,4,2,2,2,1,2,2,3,3,4,3,2,3,4,1.082325538564332,3.4,0,3,0,3,0,3.2,0,3.066666666666667,0,1,1,2,3,3,1,1,2,1,1,1,4,1,1,1,3,1,1,1,2,0.9403246919632545,1.4,0,"Hispanic of Latino (e.g., Mexican American, Central American, and others)",0,25,0,1,NA,1,2,4,Unemployed,3,0,145,64,1,5,2,0,0,0,0,0,TRUE,TRUE,TRUE,TRUE,TRUE,2,1.1273783783783784,0.74,0.09577692285714284,2,0.50259375,0.5384375,1,1,0.00288270060483871,0.0020694153225806443,2,0.66709375,0.74340625,1,1,0.00524137802419355,0.008292248991935485,1.4653,0.7124,0.7065,1.2033,0.5041,0.8556,0.2085,1.5161549596666666,0.7704229711333334,0.6870994364666667,2.1772,7.2515,0.3525,7.9672,0.4018,-106.6334,0.6843,5.4507,0.4434,6.4724,0.4838,0.9705,1.5440244731666666,5.898889552,5.660408387666667,0.4156700690333333,0.3704935426,0.673,4.688,0.5999,3.8343,0.6769,0.7919,0.122,0.463,0.593,0.018,1.562,86.77777777777779,2.6909379456666667,5.546918089333333,4.667585435666667,0.4307086008,0.46213259483333335,359,1.0637037037037036,1,0,0,1,FALSE,FALSE,FALSE
465,2021-11-13T07:44:48Z,2021-11-13T08:09:37Z,1489,1,2021-11-13T08:09:39Z,1,Firefox,89.0,Windows NT 10.0,1920,1080,n/a,1.7777777777777777,644,58,278,61,55,69,-0.3730702120710542,-0.2889345382713561,-0.7197507534950504,-0.5311000829343039,-0.2340474968444512,-0.6144504859368455,3,3,2,1,3,1,2,3,1,4,4,2,2,1,3,3,2,1,2,3,0.9787209698591858,0,1,1,2,2,1.7,0,2,3,5,2,5,5,3,5,4,5,5,1,1,1,3,1,5,5,3,5,5,5,5,4,5,3,1,5,4,2,4,4,5,2,2,3,2,4,1,3,2,4,5,5,5,5,5,5,2,5,5,5,4,4,5,5,5,5,3,4,4,1,3,3,2,4,4,4,1.2938988268694636,1.632993161855452,4.25,0,3.5,0,4.133333333333334,0,2.5555555555555554,0,3.5,0,4.333333333333333,0,4.285714285714286,0,2.3333333333333335,0,3.5135135135135136,0,2,3,1,2.184979706962527,2.2550341046237006,1.2493054771656829,1.7521697908946918,2,5,1,3,3,3,3,4,3,1.2149857925879117,3.7142857142857144,0,3.5,1.6432271408370611,3,3,5,3,1,1,3,5,3,2,2,1.3801311186847085,2.7142857142857144,0,3.2857142857142856,5,3.8333333333333335,3.2559414990859232,0.38995568780511447,0,0.6572492649557016,2,2,2,3,2,2,5,2,4,5,1,5,1,5,5,1,3,1,5,1,1.8309508328682538,2.2,0,4.4,0,5,0,4.2,0,4.533333333333333,0,2,3,4,1,3,4,4,1,4,4,4,1,3,2,4,1,3,4,4,4,1.2139539573337679,3.6,0,"White, Caucasian, Anglo, European American",0,NA,0,1,NA,1,2,3,Retail Worker,2,0,300,70,2,5,2,0,0,0,0,0,TRUE,TRUE,TRUE,TRUE,TRUE,NA,NA,NA,NA,2,0.527483870967742,0.6202333333333333,0.96875,0.967741935483871,0.003430931451612902,0.003062995698924731,2,0.6961935483870968,0.73425,1,1,0.0037615612903225807,0.008380709677419355,NA,NA,NA,NA,NA,NA,NA,NA,NA,NA,0.9172,4.4533,0.4301,3.8026,0.5042,-86.765,0.7964,4.5409,0.4416,5.9169,0.5519,0.9289,1.1092358926666666,4.0604746726666665,4.691215762333333,0.4904882448333333,0.41606607463333334,0.8094,7.2289,0.6495,3.8018,0.639,0.9283,0.175,0.434,0.63,0.073,1.379,18.89041095890411,2.807189024,5.437399923333333,5.015125418666667,0.4438787992666667,0.4618346745333333,104,0.3081481481481481,1,1,0,1,FALSE,FALSE,FALSE
466,2021-11-13T07:44:04Z,2021-11-13T08:10:52Z,1608,1,2021-11-13T08:10:54Z,1,Chrome,95.0.4638.69,Windows NT 10.0,2560,1440,N/A,1.7777777777777777,645,61,363,119,36,342,-0.3705008450534919,-0.26168032333180935,-0.3105404270817614,0.17571149604022218,-0.49647662994450314,3.996892639776044,2,2,2,3,2,1,1,2,1,3,2,1,1,1,2,3,1,1,2,2,0.7163503994113789,0,1,1,3,3,2.05,0,4,4,2,4,2,1,3,2,2,1,1,4,2,3,3,2,3,1,1,1,2,2,2,0,2,0,0,4,4,4,4,5,5,4,4,3,2,4,2,2,3,1,3,2,2,2,3,3,3,1,1,1,2,1,1,1,1,1,5,1,2,1,1,1,1,1,1,1,1.365050681609794,1.1254628677422756,1.75,0,1,0,2,0,1.8888888888888888,0,2.25,0,1.3333333333333333,0,1,0,1,0,1.7297297297297298,0,0,0,0,-0.4795700934719498,-0.5027129110024894,-0.7372407672780129,-0.6199768391402511,4,2,3,1,1,2,2,1,1,1.0690449676496976,1.8571428571428572,0,1,-0.39031545311577004,4,4,5,4,3,3,2,3,3,4,4,0.9759000729485332,3.857142857142857,0,2.142857142857143,6,3.8333333333333335,3.2559414990859232,0.9547190977297628,0,0.30226299054653183,3,2,2,2,2,2,3,3,2,2,3,3,1,2,3,3,2,3,1,3,0.7367883976130072,2.2,0,3,0,2.8,0,3,0,2.933333333333333,0,1,2,2,1,2,3,3,1,2,1,2,1,2,4,1,2,2,3,2,3,0.8583950752789521,2.5,0,"White, Caucasian, Anglo, European American",0,22,0,1,NA,1,3,4,Full Time Student,2,0,165,70,1,5,2,0,0,1,0,0,TRUE,TRUE,TRUE,TRUE,TRUE,6,0.8148642857138599,0.84,0.05217319193872678,6,0.4900843749996275,0.5542625000029803,1,1,0.009801927812360996,0.009536665645043485,6,0.6433656250019558,0.6876187500013039,1,1,0.009833351361037823,0.008964842863045839,1.4058,1.2458,0.4311,1.3108,1.4468,0.4902,0.3059,1.4211537283333333,1.1254080452666666,0.4244104029333333,1.5122,4.4326,0.3195,3.8116,0.3559,-66.6335,0.9459,4.2606,0.375,4.2414,0.4503,0.9262,1.6136278215666666,3.8959953026666665,4.521325935,0.3479121163666667,0.31135011896666664,0.9943,2.8031,0.5122,3.8758,0.5608,0.9868,0.182,0.336,0.608,0.035,1.828,52.22857142857143,2.382610855333333,4.307509105,4.98993319,0.36816232086666667,0.45656279936666666,368,1.0903703703703704,1,0,0,1,FALSE,FALSE,FALSE
467,2021-11-13T07:44:41Z,2021-11-13T08:12:14Z,1652,1,2021-11-13T08:12:16Z,1,Chrome,95.0.4638.69,Windows NT 10.0,1920,1080,I do not.,1.7777777777777777,724,82,462,99,66,111,-0.1675208506660716,-0.07090081875498182,0.1660692472113635,-0.06801663464064889,-0.08211484083915795,0.0949869180189837,1,1,4,4,1,2,4,1,1,1,1,4,4,4,1,1,4,4,1,1,1.4823523268955432,0,1,2,2,1,3.75,0,2,3,5,2,4,3,2,5,5,4,3,1,1,1,1,5,5,5,1,5,5,5,5,1,2,1,1,1,1,2,2,2,3,2,2,1,3,2,5,2,2,3,5,5,5,5,5,5,1,1,3,3,1,1,1,3,1,1,3,3,2,3,3,5,5,5,5,5,1.4570940680419788,1.52127765851133,4.5,0,5,0,4,0,4.222222222222222,0,3.9166666666666665,0,2.1666666666666665,0,1.8571428571428572,0,3.6666666666666665,0,3.3513513513513513,0,1,1,1,2.239615586151246,2.2354824797059516,1.1033538044865656,1.6694181420962586,3,2,3,2,2,3,3,3,1,0.5345224838248488,2.5714285714285716,0,2,0.4060081474343336,3,3,3,3,1,1,3,7,6,NA,2,0.9759000729485332,2.4285714285714284,0,3.5714285714285716,2.5,3.8333333333333335,3.2559414990859232,-1.0219528370065065,0,0.11063699739276467,5,3,5,5,5,4,4,4,4,2,4,2,5,2,5,5,3,1,3,3,1.2421180068162376,4.6,0,2.8,0,2.2,0,2.8,0,2.6,0,1,4,4,1,4,4,4,1,4,4,4,1,1,4,4,1,1,4,1,4,1.5078740698501039,3.4,0,"White, Caucasian, Anglo, European American",0,21,0,1,NA,1,2,4,Student,2,0,135,67,2,5,2,0,0,0,0,0,TRUE,TRUE,TRUE,TRUE,TRUE,2,1.0018810810811214,0.7708333333333334,0.3523096134574627,2,0.40105937500006983,0.5058806451613744,1,0.96875,0.0023206179737739066,0.003509660645165922,2,0.5927906249998487,0.6448483870969184,1,0.96875,0.009733634425388495,0.011465611249995407,1.7131,0.716,0.4246,1.3401,0.776,0.5219,0.0188,1.6756307803333332,0.75491335859,0.42359194570000003,2.4261,6.4999,0.2144,4.3429,0.2379,-70.0134,0.8572,6.245,0.3364,6.2951,0.4405,0.9714,1.9434290173333333,3.804073865,5.471894245666666,0.2599606209,0.2268695543,0.9866,5.3255,0.5044,3.5712,0.5279,0.8228,0.081,0.398,0.408,0.017,1.303,76.6470588235294,1.9951201956666667,4.030933785333334,3.319108159333333,0.34500720333333335,0.3560926879,527,1.5614814814814815,1,0,1,2,FALSE,FALSE,FALSE
468,2021-11-13T07:37:26Z,2021-11-13T08:12:21Z,2094,1,2021-11-13T08:12:22Z,1,Chrome,95.0.4638.69,Windows NT 10.0,1366,768,I do not.,1.7786458333333333,939,150,611,80,78,103,0.384893058109819,0.546861386541412,0.8833908782181878,-0.29955835878747644,0.08362987480298012,-0.040144016067840904,2,3,2,2,2,1,2,2,2,2,2,3,1,1,2,2,2,2,2,2,0.5104177855340404,0,1,2,2,2,2.35,0,2,4,3,3,3,4,4,3,2,2,3,4,2,4,2,4,3,3,3,3,4,3,3,5,2,5,1,4,1,2,1,1,3,1,1,1,1,3,3,1,2,3,4,3,3,4,4,4,2,4,5,2,3,1,3,3,3,2,3,1,2,2,3,3,2,2,2,2,1.1455620071878747,0.8451542547285166,3.25,0,2,0,2.7333333333333334,0,4.333333333333333,0,2.9166666666666665,0,3,0,2.2857142857142856,0,2.6666666666666665,0,3.189189189189189,0,3,5,1,1.3612387591941397,1.0842595748955521,1.3952571498447999,1.239758362370176,2,5,3,4,3,3,4,6,4,0.9759000729485332,3.7142857142857144,0,5,2.1967086529986344,4,4,4,4,3,4,3,3,4,2,2,0.4879500364742666,3.7142857142857144,0,2.2857142857142856,5.5,3.8333333333333335,3.2559414990859232,0.6723373927674386,0,0.24074313548680643,2,2,2,2,2,2,4,2,2,3,2,4,3,4,4,1,5,2,3,2,1.1254628677422756,2,0,4.2,0,3.6,0,4,0,3.933333333333333,0,1,1,3,2,2,4,2,2,4,1,4,2,2,4,1,2,2,3,3,3,1.0462967275611939,2.6,0,Black or African American,0,29,0,1,NA,1,2,5,Unemployed,1,0,290,65,1,5,2,0,0,1,0,0,TRUE,TRUE,TRUE,TRUE,TRUE,4,0.7165305555562178,0.72,0.03659390816304017,4,0.4737874999940395,0.5092483871040806,1,1,0.0029171469352139963,0.0011465919143787838,4,0.5585749999955296,0.5830928571373224,1,0.875,0.008223620001198553,0.007398769032466526,1.1724,0.8013,0.4005,1.0872,0.8698,0.4624,0.3702,1.2307279483333333,0.8585340411566666,0.3917427706666667,3.7106,8.9147,0.2657,11.5757,0.349,-112.5027,0.4275,6.4855,0.4382,6.0278,0.4834,0.7476,1.5440034820666666,6.504531867,5.568384245,0.40018032393333336,0.339148276,0.8846,4.5603,0.4684,2.799,0.4548,0.9239,0.053,0.404,0.317,0.031,1.606,51.80645161290323,1.2357838974333333,3.259305822,2.7332240283333333,0.36267422483333334,0.4005217623333333,348,1.031111111111111,1,0,0,1,FALSE,FALSE,FALSE
469,2021-11-13T07:46:55Z,2021-11-13T08:12:42Z,1547,1,2021-11-13T08:12:43Z,0.8999999761581421,Chrome,95.0.4638.69,Windows NT 10.0,1920,1080,NA,1.7777777777777777,662,72,466,104,56,117,-0.3268216057549331,-0.16174820188680444,0.18532620374845948,-0.007084601970431121,-0.22023543720760635,0.19633511858410213,1,2,2,3,1,3,3,1,2,1,1,2,1,3,1,1,2,3,1,1,0.8506963092234007,0,1,2,2,2,3.15,0,3,3,4,2,3,1,3,2,2,3,1,2,2,2,2,2,3,1,1,2,1,2,2,5,2,0,0,3,3,2,3,2,2,3,3,3,4,3,2,4,3,3,4,3,4,5,5,5,3,1,2,1,4,4,2,3,3,3,4,2,2,2,3,1,3,2,2,3,1.0526671402243484,0.816496580927726,1.75,0,2.5,0,2.8666666666666667,0,3.3333333333333335,0,3.5833333333333335,0,2.3333333333333335,0,2.2857142857142856,0,2,0,3,0,3,0,0,0.3105487747956867,0.4156327187974994,0.3424438704149829,0.37903829460624117,3,1,2,1,1,2,1,1,2,0.7867957924694432,1.8571428571428572,0,1.5,-0.20582161572857902,3,3,3,3,1,1,4,4,6,NA,3,1.1338934190276817,2.2857142857142856,0,3.7142857142857144,4,3.8333333333333335,3.2559414990859232,-0.1748077221195339,0,0.6138805522576877,2,2,1,1,2,1,2,3,2,3,2,3,2,2,2,5,3,2,2,4,0.990430401872025,1.6,0,3.8,0,2.4,0,2.6,0,2.933333333333333,0,2,2,3,1,3,4,3,1,2,2,3,1,2,1,2,1,1,3,2,3,0.9119095061289915,2.7,0,Black or African American,0,21,0,1,NA,1,2,4,none,3,0,230,75,2,5,2,0,0,0,0,0,TRUE,TRUE,TRUE,TRUE,TRUE,3,0.7454949999999255,0.8,0.01859850040821814,3,0.42710000000020554,0.4818937500006286,0.90625,1,0.003317412096770125,0.0031608515725899257,3,0.5579343749999535,0.588153571428598,1,0.875,0.014306284909291174,0.005619544354855868,1.1556,1.2767,0.4993,0.8797,1.1547,0.5906,0.2476,1.2132351843333333,1.1341469678,0.48996248303333334,0.9911,3.5841,0.311,3.5911,0.3439,-73.4353,0.4678,4.6193,0.3844,5.2675,0.4516,0.9686,1.1036073072333332,3.8417092556666668,3.877289706,0.33807772303333333,0.3030421804333333,0.8468,2.8575,0.4425,3.5224,0.4857,0.7406,0.057,0.395,0.378,0.019,1.817,95.63157894736842,1.4306544087,2.962612896,2.565435755633333,0.3068636429666667,0.35982663466666664,279,0.8266666666666667,1,0,0,1,FALSE,FALSE,FALSE
470,2021-11-13T07:50:24Z,2021-11-13T08:14:03Z,1418,1,2021-11-13T08:14:03Z,1,Chrome,93.0.4577.82,Macintosh,1280,800,NA,1.6,623,51,452,102,57,80,-0.4270269194398621,-0.35252770646363196,0.11792685586862363,-0.03145741503851823,-0.2064233775707615,-0.4286454515674616,4,4,1,1,3,1,1,2,1,3,3,1,1,1,4,4,1,1,3,2,1.2523661815266247,0,1,1,3,2,1.4,0,1,5,1,4,1,1,3,1,1,1,1,3,2,4,4,2,2,1,1,1,1,1,1,1,4,0,0,5,4,5,4,3,3,1,4,3,3,5,1,1,2,1,2,1,1,1,1,1,4,1,1,1,5,2,1,2,1,1,3,3,2,1,3,1,2,2,1,2,1.4268973460049732,1.4735767952260144,1.25,0,1.75,0,1.8,0,2.4444444444444446,0,1.6666666666666667,0,1.8333333333333333,0,1.7142857142857142,0,1.6666666666666667,0,1.945945945945946,0,1,0,0,-0.6560860108508899,-0.7106183086427063,-0.2989446853297732,-0.5047814969862398,5,1,3,1,1,3,2,4,3,1.4960264830861913,1.7142857142857142,0,3.5,0.4466865486650409,4,4,5,4,4,3,2,1,3,2,2,0.9511897312113419,4,0,2,7,3.8333333333333335,3.2559414990859232,1.5194825076544112,0,0.5049736980874192,4,4,4,1,4,4,2,5,3,2,5,1,1,3,3,5,1,5,2,5,1.5976172734359604,3.4,0,1.2,0,2.4,0,2.2,0,1.9333333333333333,0,1,1,1,3,2,1,1,2,1,1,3,3,1,1,1,3,1,2,1,1,0.8255779474818965,1.45,0,"Asian or Asian American (e.g., Chinese, Japanese, and others)",0,26,0,1,NA,1,2,5,Freelance Writer,2,0,120,60,3,5,2,0,0,1,0,0,TRUE,TRUE,TRUE,TRUE,TRUE,5,0.9214500000476837,0.64,0.04318328366595294,5,0.505246666653951,0.5691406249701977,0.967741935483871,1,0.002428493035036804,0.0036319128021363683,5,0.6750343750715255,0.7391354838032876,1,0.96875,0.00950159328717493,0.015543563691625288,1.2063,0.5048,0.5883,0.8836,0.6065,0.7156,0.2789,1.2682133335333334,0.6684569172766334,0.577997564,1.474,4.9712,0.3648,4.8133,0.416,-80.8735,0.7494,6.3298,0.4495,6.2401,0.5097,0.8048,1.5615752647666667,4.700819944,4.890865399,0.4069935167666667,0.35514014823333334,1.2432,3.4535,0.5083,3.2135,0.5463,0.9921,0.064,0.509,0.35,0.041,1.923,46.90243902439024,1.7657457368333334,4.079175970333333,3.391115728,0.45858481796666667,0.4979951667,428,1.268148148148148,1,0,0,1,FALSE,FALSE,FALSE
471,2021-11-13T07:37:42Z,2021-11-13T08:14:27Z,2204,1,2021-11-13T08:14:28Z,0.8999999761581421,Chrome,95.0.4638.69,Macintosh,1792,1120,Simple and easy to understand. Fun aswell.,1.6,772,49,464,87,91,119,-0.044191233823082085,-0.3706971830899965,0.1756977254799115,-0.21425351304917153,0.26318665008196307,0.2301178521058083,3,3,2,2,3,2,3,2,2,3,3,2,2,2,3,3,3,2,3,3,0.5104177855340404,0,1,4,3,3,2.15,0,3,4,4,4,2,2,4,2,2,1,2,4,2,4,3,3,2,1,1,2,1,1,3,3,2,0,0,4,3,3,5,3,3,4,3,3,2,4,3,1,4,2,3,2,3,3,1,2,4,1,2,1,3,1,2,3,2,2,3,2,3,1,1,1,2,2,2,2,1.070348375831741,1.0600988273786194,1.75,0,2,0,2.2,0,2.5555555555555554,0,2.1666666666666665,0,1.5,0,2.2857142857142856,0,1,0,2.135135135135135,0,2,0,0,-0.2274044972163212,-0.2425407932851232,-0.01745100881601569,-0.12999590105056946,4,2,3,2,2,2,3,1,3,0.7867957924694432,2.2857142857142856,0,2,0.2350737771240448,3,4,4,4,3,3,3,6,6,1,3,0.5345224838248488,3.4285714285714284,0,2.5714285714285716,3,3.8333333333333335,3.2559414990859232,-0.7395711320441822,0,-0.3058691320761303,3,3,2,2,2,3,4,2,2,3,2,4,1,3,3,3,3,2,3,3,0.7988086367179802,2.4,0,3.6,0,3.6,0,3.4,0,3.533333333333333,0,1,1,2,2,2,1,2,2,1,1,3,2,3,2,1,3,2,2,2,1,0.6958523739384593,1.9,0,"Asian or Asian American (e.g., Chinese, Japanese, and others)",0,21,0,1,NA,0,3,5,Student,1,0,230,68,1,5,2,0,0,0,0,0,TRUE,TRUE,TRUE,TRUE,TRUE,2,1.1446437499895692,0.6956521739130435,0.23241963420518566,2,0.5099031250029802,0.5611299999872843,1,0.967741935483871,0.004264328052748999,0.005018665161472265,2,0.654362500011921,0.7702928571403026,1,0.9032258064516129,0.011257220485668492,0.02137272606968794,1.4695,0.5519,0.6363,1.3263,0.5168,0.6702,0.1194,1.513242051,0.662655001421,0.6189877991333333,1.3679,5.0271,0.3738,4.1162,0.4036,-78.5268,0.801,6.5302,0.441,4.8203,0.4801,0.8356,1.5100919032333333,4.172360681,5.060274363666666,0.391577034,0.36273796696666666,1.031,3.4511,0.5192,2.5938,0.6141,0.9936,0.087,0.449,0.448,0.011,1.88,170.9090909090909,1.9151060886666667,3.724891007666667,1.9643088330333334,0.39449837513333336,0.3321234815333333,447,1.3244444444444445,1,0,4,5,FALSE,FALSE,FALSE
472,2021-11-13T07:24:43Z,2021-11-13T08:15:11Z,3028,1,2021-11-13T08:15:13Z,1,Chrome,95.0.4638.69,Windows NT 10.0,1280,720,"Thanks! I didn't start the study right away, but once I started I completed it in one sitting.",1.7777777777777777,2415,85,280,56,32,77,4.177278776031747,-0.04364660381543503,-0.7101222752265024,-0.5920321156045217,-0.5517248684918825,-0.47931955185002084,3,3,1,1,1,1,1,4,1,4,3,1,1,1,3,4,1,1,3,3,1.234376040972246,0,1,1,3,3,1.45,0,5,5,2,4,3,1,3,2,2,2,2,5,2,3,4,2,2,1,1,1,1,1,1,0,2,0,0,4,4,3,4,4,5,5,5,5,2,4,2,1,3,2,4,2,2,2,2,2,5,1,1,1,1,1,1,1,1,1,3,3,3,1,1,1,1,1,1,1,1.464802254792655,1.3093073414159542,1.25,0,1,0,1.9333333333333333,0,1.6666666666666667,0,2,0,0.8333333333333334,0,1.7142857142857142,0,1,0,1.6486486486486487,0,0,0,0,-0.8410074481050176,-0.781081590524493,-0.7372407672780129,-0.7591611789012529,5,1,4,1,1,2,1,1,1,1.6761634196950514,1.2857142857142858,0,1,-0.7321841937363471,5,5,5,5,5,3,1,6,8,5,3,1.5735915849388864,4.714285714285714,0,1.2857142857142858,2,3.8333333333333335,3.2559414990859232,-1.3043345419688306,0,-1.3052898138313853,2,2,3,3,3,3,3,3,3,3,3,2,3,2,3,3,3,2,3,4,0.5163977794943222,2.6,0,3,0,3,0,2.6,0,2.8666666666666667,0,2,1,1,4,2,1,2,3,1,1,2,3,1,1,1,3,1,1,1,1,0.9333020044867296,1.35,0,Black or African American,0,22,0,1,NA,1,3,4,student (studying information science),6,0,130,71,3,5,2,0,0,1,0,0,TRUE,TRUE,TRUE,TRUE,TRUE,2,1.0607588235280092,0.68,0.0673436527570011,2,0.4559481481479274,0.5149874999995033,0.84375,0.7741935483870968,0.004130404354946127,0.004700297333268484,2,0.5289677419316384,0.6183565217399078,1,0.71875,0.00436588625804471,0.005725897006246658,1.4663,0.5519,0.5527,1.3098,0.6851,0.669,0.2435,1.495487946,0.66379984691,0.5430899754,0.7715,2.3486,0.3468,1.6808,0.3881,-51.3753,0.4607,4.7128,0.4089,2.7379,0.4727,0.9632,0.8275884565333333,2.0558558714066666,2.7919884844333334,0.3830272268666667,0.34256995036666665,0.7236,5.0947,0.4649,2.2765,0.5106,0.6672,0.053,0.395,0.41,0.008,1.423,177.875,1.0330082839,3.725517216,1.5194305671233332,0.3872973614333333,0.4093386480333333,374,1.108148148148148,1,0,0,1,FALSE,FALSE,FALSE
473,2021-11-13T07:55:54Z,2021-11-13T08:15:30Z,1176,1,2021-11-13T08:15:31Z,1,Chrome,94.0.4606.61,Windows NT 10.0,1536,864,NA,1.7777777777777777,704,44,223,47,27,92,-0.21890819101731726,-0.4161208746559078,-0.9845339058801198,-0.7017097744109136,-0.6207851666761067,-0.2259490504372247,4,4,1,1,4,1,1,4,1,4,4,1,1,1,4,4,1,1,4,4,1.538967528127731,0,1,1,3,3,1,0,5,5,1,5,1,1,5,1,1,1,1,5,1,5,5,1,1,1,1,1,1,1,1,0,2,0,0,5,5,5,5,5,5,5,5,5,1,5,1,1,5,1,5,1,1,1,1,1,5,1,1,1,2,1,1,1,1,1,5,1,1,1,1,1,1,1,1,1,1.9521298140264163,2.065591117977289,1,0,1,0,1,0,1,0,1,0,1,0,0.8571428571428571,0,1,0,1.027027027027027,0,0,0,0,-1.3831634800546193,-1.556758432558337,-0.7372407672780129,-1.146999599918175,5,1,5,1,1,1,1,1,2,1.9518001458970664,1,0,1.5,-0.7186247266594448,5,5,5,5,2,2,1,8,7,3,3,1.8126539343499315,4.142857142857143,0,1.8571428571428572,1.5,3.8333333333333335,3.2559414990859232,-1.5867162469311549,0,-1.1277966766268004,1,1,1,1,1,1,4,1,1,4,1,4,1,5,4,1,5,1,4,1,1.7265434778633235,1,0,4.8,0,4.4,0,4.8,0,4.666666666666667,0,1,1,1,1,1,1,1,4,1,1,1,4,1,1,1,4,1,1,1,1,1.0990426455975697,1.15,0,"Asian or Asian American (e.g., Chinese, Japanese, and others)",0,19,0,1,NA,1,3,4,Student,4,0,185,65,3,5,2,0,0,1,0,0,TRUE,TRUE,TRUE,TRUE,TRUE,3,0.9298878048454843,0.82,0.06760752613893951,3,0.5226249999403954,0.7073093750029802,1,1,0.01249996258653087,0.01630834087848904,3,0.8402064516159796,1.0742781250178814,1,1,0.029759411969301142,0.20338684174743982,1.5078,1.0589,0.5112,1.2659,0.9899,0.6298,0.3474,1.5164900373333334,1.0068941478666666,0.5034618074333334,2.1092,4.7299,0.2997,3.54,0.4094,-52.5484,0.9687,3.5205,0.3851,3.2575,0.5873,0.9725,1.9629297843333333,3.3380520203333335,4.554713576666667,0.41008889016666666,0.3068168011,1.4138,2.7957,0.6146,1.5554,0.6702,0.8644,0.133,0.399,0.239,0.013,1.693,130.23076923076925,2.8449973936666666,3.4216733813333335,2.1907417386666665,0.4188993999,0.4123740602,382,1.1318518518518519,1,0,0,1,FALSE,FALSE,FALSE
474,2021-11-13T08:05:04Z,2021-11-13T08:27:59Z,1375,1,2021-11-13T08:28:01Z,1,Chrome,95.0.4638.69,Windows NT 10.0,1500,1000,thanks,1.5,695,66,316,79,52,108,-0.2420324941753778,-0.21625663176589804,-0.5368096663926388,-0.31174476532151996,-0.2754836757549857,0.04431281773642447,4,2,1,1,4,2,3,4,1,3,3,2,1,3,4,3,1,1,3,3,1.145931016569864,0,1,1,4,3,1.65,0,5,5,1,5,2,1,4,1,1,1,2,4,1,4,4,1,1,1,1,1,1,1,1,3,2,0,0,5,5,5,3,3,4,5,5,4,2,5,1,1,5,1,5,2,2,1,1,1,5,1,1,1,3,1,1,3,3,3,5,1,1,1,1,1,2,1,2,2,1.7032031296650734,1.709915063331955,1,0,1.75,0,1.4,0,1.6666666666666667,0,1.25,0,1.1666666666666667,0,1.7142857142857142,0,1,0,1.4594594594594594,0,2,0,0,-1.1141868440486153,-1.1990217706969584,-0.0958522115332568,-0.6474369911151076,5,3,4,1,1,2,2,3,1,1.5118578920369088,1.7142857142857142,0,2,-0.10679496349653231,5,5,5,5,4,3,1,4,7,6,5,1.5275252316519468,4.571428571428571,0,1.4285714285714286,3.5,3.8333333333333335,3.2559414990859232,-0.4571894270818581,0,-0.8020462589664623,3,3,4,3,3,3,4,3,3,3,2,3,1,4,2,1,4,2,5,3,1.1254628677422756,3.2,0,3.6,0,4.4,0,3,0,3.6666666666666665,0,1,1,1,4,1,2,1,3,1,1,1,4,1,3,1,4,1,2,1,2,1.1516578439248717,1.3,0,"Hispanic of Latino (e.g., Mexican American, Central American, and others)",0,23,0,1,NA,1,4,6,software engineer,5,0,140,66,3,5,2,0,0,1,0,0,TRUE,TRUE,TRUE,TRUE,TRUE,2,1.0312861111097866,0.72,0.07608234093471006,2,0.563828125,0.709512903224076,1,0.96875,0.004967971118917582,0.009424340554189484,2,0.8481774193548387,1.0127593750022352,0.96875,1,0.015458947580859812,0.021252387650312416,1.6027,0.6451,0.4994,1.1528,0.6583,0.7353,0.3448,1.5993879613333333,0.7144519016266667,0.49347406813333333,2.0452,5.0249,0.3603,3.679,0.4477,-58.1328,1.0456,5.1428,0.468,4.8116,0.5968,0.979,2.0618353716666666,3.543569633,4.858392791333333,0.4330685338333333,0.3525411352,1.2162,3.1707,0.6834,2.804,0.8203,0.9777,0.327,0.27,0.567,0.011,1.92,174.54545454545456,2.8575370806666665,3.366487723666667,3.4138285303333333,0.4419219588666667,0.5935667169333333,104,0.3081481481481481,1,1,1,2,FALSE,FALSE,FALSE
476,2021-11-13T08:01:27Z,2021-11-13T08:32:46Z,1878,1,2021-11-13T08:32:48Z,0.8999999761581421,Chrome,95.0.4638.69,Windows NT 10.0,1366,768,NA,1.7786458333333333,1170,62,328,86,39,103,0.9784168391667062,-0.2525955850186271,-0.479038796781351,-0.2264399195832151,-0.4550404510339686,-0.040144016067840904,3,3,1,1,3,1,1,3,1,4,3,1,1,1,4,3,1,1,3,4,1.2258187382102494,0,1,1,4,4,1.35,0,4,5,3,4,2,2,4,2,2,1,1,4,3,4,5,2,1,1,1,1,1,1,2,1,2,0,0,5,4,5,5,5,5,5,5,5,2,5,3,2,5,2,5,2,2,2,2,2,5,1,1,1,3,1,2,2,2,1,5,1,5,1,1,1,2,1,2,2,1.699673171197595,1.3345232785352157,1.25,0,1.75,0,1.8666666666666667,0,1.1111111111111112,0,1.8333333333333333,0,1.1666666666666667,0,1.8571428571428572,0,1,0,1.5405405405405406,0,1,0,0,-0.9082516071065188,-0.8561908030798041,-0.2989446853297732,-0.5775677442047886,5,1,5,1,1,1,2,1,1,1.889822365046136,1.1428571428571428,0,1,-0.8176513788914915,5,5,5,5,3,3,2,6,6,5,4,1.2909944487358056,4.285714285714286,0,1.7142857142857142,3,3.8333333333333335,3.2559414990859232,-0.7395711320441822,0,-0.783895116604751,2,3,2,1,2,2,4,2,1,3,2,5,2,4,4,2,4,1,4,2,1.2649110640673518,2,0,4.4,0,3.8,0,4.2,0,4.133333333333334,0,1,1,1,4,1,1,1,4,1,1,1,4,1,1,1,4,1,1,1,1,1.231174022502185,1,0,"White, Caucasian, Anglo, European American",0,26,0,1,NA,1,4,4,tech support,4,0,135,67,3,5,2,0,0,1,0,0,TRUE,TRUE,TRUE,TRUE,TRUE,6,1.0132222222222158,0.72,0.08850988850612927,6,0.6414468749999869,0.7028199999999953,1,0.967741935483871,0.01930765676411203,0.021358012580644056,6,0.6617906249999869,0.7424161290322701,1,0.96875,0.01871506216734104,0.0057102288608847345,1.4334,0.6626,0.5867,1.342,0.5413,0.6531,0.3189,1.4752104413333333,0.74160902258,0.5737649229333334,1.5871,2.9881,0.3759,2.9116,0.4515,-35.5647,1.1847,3.7044,0.4819,2.1865,0.4867,0.9598,1.8830744053333333,3.1011352756666666,3.36913448,0.4164854641,0.3534818657666667,0.9534,2.7862,0.5303,5.5893,0.6503,0.9895,0.311,0.183,0.645,0.017,1.628,95.76470588235293,1.875817948,3.2172396716666665,4.129474024,0.3637240295333333,0.5322632007,400,1.1851851851851851,1,0,0,1,FALSE,FALSE,FALSE
477,2021-11-13T07:10:49Z,2021-11-13T08:35:28Z,5078,1,2021-11-13T08:35:29Z,1,Chrome,95.0.4638.69,Windows NT 10.0,1920,1080,None,1.7777777777777777,593,33,193,27,37,54,-0.5041079299667306,-0.5160529961009127,-1.1289610799083394,-0.9454379050917848,-0.4826645703076583,-0.8678209873496415,2,2,1,1,1,1,1,2,1,3,1,1,1,1,2,2,1,1,1,1,0.5871429486123998,0,1,2,3,3,2.15,0,3,2,3,3,3,1,2,3,2,2,2,2,3,2,2,3,2,5,1,3,3,3,2,6,1,1,1,2,2,1,2,2,3,2,2,2,2,3,2,2,1,2,1,4,3,2,2,2,1,1,1,1,5,5,1,5,5,5,4,2,2,2,2,2,1,2,5,5,1.2769614836128107,0.6172133998483676,2.75,0,3.25,0,3,0,4,0,2.8333333333333335,0,2.8333333333333335,0,3,0,2,0,3.135135135135135,0,3,1,1,1.016612444311447,0.9607552511576953,0.9607303330589108,0.960742792108303,4,2,1,2,2,2,2,3,2,0.8997354108424374,2.4285714285714284,0,2.5,0.5050347996663801,3,3,5,5,1,1,3,3,3,2,2,1.632993161855452,3,0,3,6,3.8333333333333335,3.2559414990859232,0.9547190977297628,0,0.7802889750751523,2,1,1,1,1,2,3,2,2,1,1,4,4,4,4,4,3,2,2,3,1.0997835284835873,1.2,0,4,0,2,0,3.8,0,3.2666666666666666,0,2,1,1,1,1,3,3,2,2,1,3,2,4,2,1,1,1,1,1,3,0.9514531821875089,2.2,0,"White, Caucasian, Anglo, European American",0,29,0,1,NA,1,2,3,Computer Technician Supervisor,2,0,135,68,2,5,2,0,0,1,0,0,TRUE,TRUE,TRUE,TRUE,TRUE,3,0.9551677419408675,0.62,0.10696001225375167,3,0.5013633333563805,0.5572161290453327,0.9375,1,0.008151378712460996,0.003919305398803814,3,0.7401750000081957,0.7875870967641954,1,0.96875,0.01956386709574157,0.0222306825399176,1.5175,0.3301,0.3829,1.1216,0.5318,0.6302,0.4702,1.5226055626666666,0.4945912560681833,0.3796943505,1.2579,3.0434,0.3201,5.0928,0.4337,-70.3533,0.8217,4.3807,0.4,5.6458,0.4838,0.9795,1.3838405099666666,4.942530559,3.3599508503333335,0.4221166869,0.3119475421333333,1.3193,2.6459,0.5252,3.3015,0.5847,0.9978,0.074,0.496,0.318,0.017,1.591,93.58823529411764,2.1229267376666665,3.4065543773333333,3.2147749763333335,0.4236752472,0.47071810366666667,290,0.8592592592592593,1,0,0,1,FALSE,FALSE,FALSE
478,2021-11-13T07:56:48Z,2021-11-13T08:37:29Z,2440,1,2021-11-13T08:37:30Z,1,Opera,80.0.4170.91,Windows NT 10.0,1536,864,None,1.7777777777777777,903,84,700,131,60,355,0.29239584547757685,-0.0527313421286173,1.311858161168573,0.32194837444874486,-0.16498719866022699,4.216480407667134,3,3,3,3,3,2,2,2,2,3,2,3,3,2,3,3,3,2,3,3,0.4893604849295929,0,1,2,3,3,2.35,0,4,4,2,4,2,2,2,2,2,2,2,4,2,4,4,3,3,2,2,2,2,2,2,3,2,0,0,4,3,4,4,4,4,4,4,4,2,2,3,2,4,2,4,3,3,3,3,2,4,2,1,3,3,1,2,3,3,3,4,2,2,2,2,2,2,2,2,2,0.936417042175588,1.01418510567422,2.25,0,2,0,2.1333333333333333,0,2.111111111111111,0,2.5833333333333335,0,1.8333333333333333,0,2.2857142857142856,0,2,0,2.2972972972972974,0,2,0,0,0.18446597666787243,0.013372554648178757,-0.01745100881601569,-0.002039227083918466,3,2,3,2,3,2,2,1,1,0.5345224838248488,2.4285714285714284,0,1,-0.048446712495193056,4,4,4,4,3,3,3,3,3,3,2,0.5345224838248488,3.5714285714285716,0,2.4285714285714284,6,3.8333333333333335,3.2559414990859232,0.9547190977297628,0,0.46160498538940525,3,3,3,3,3,2,4,2,3,2,3,4,3,3,3,3,3,2,3,3,0.6399404734221844,3,0,3.6,0,3,0,3.2,0,3.2666666666666666,0,2,2,2,2,2,2,2,3,1,2,2,2,2,2,2,2,1,2,2,1,0.44721359549995793,2,0,Prefer not to say,0,19,3,5,NA,1,3,3,stocks,7,0,143,63,2,5,2,0,0,0,0,0,TRUE,TRUE,TRUE,TRUE,TRUE,NA,NA,NA,NA,6,0.5430387096774216,0.6130935483871013,0.96875,0.96875,0.017042679354839493,0.015272903870969204,6,0.861765625,0.8642437500000196,1,1,0.07051352684476203,0.04466776770161948,NA,NA,NA,NA,NA,NA,NA,NA,NA,NA,1.7533,2.7143,0.2327,2.7799,0.3102,-25.597,1.1186,4.1123,0.399,5.3198,0.5059,0.92490000000000006,1.734768628,2.8665305593333334,2.8726427146666667,0.3140168456,0.2382901247,1.4108,1.8549,0.5408,1.9297,0.5836,0.995,0.141,0.398,0.318,0.052,1.621,31.173076923076923,2.8720952846666665,2.72352622,3.039977459666667,0.32258889416666664,0.3890039971,432,1.28,1,0,0,1,FALSE,FALSE,FALSE
479,2021-11-13T07:55:14Z,2021-11-13T08:38:29Z,2594,1,2021-11-13T08:38:30Z,1,Chrome,95.0.4638.69,Windows NT 10.0,1366,768,N/A,1.7786458333333333,765,289,432,106,57,88,-0.06217680294601806,1.8096400120737468,0.02164207318314386,0.017288211097655985,-0.2064233775707615,-0.293514517480637,2,2,3,2,2,1,3,1,3,1,1,4,2,4,1,1,3,2,1,1,1.025978352085154,0,1,2,2,2,3.2,0,3,4,4,3,4,3,3,4,4,3,3,2,1,2,1,2,3,4,2,1,4,3,4,2,2,0,0,4,4,3,4,4,5,4,4,5,2,4,1,1,2,2,4,5,3,3,5,5,2,1,3,1,5,5,1,4,1,1,3,5,4,1,2,1,1,1,1,1,1.5161790127814059,1.0327955589886444,2.875,0,1,0,3.3333333333333335,0,1.8888888888888888,0,2.9166666666666665,0,3,0,2.5714285714285716,0,1.3333333333333333,0,2.5405405405405403,0,1,0,0,0.7245206286486771,0.902197166626815,-0.5341482934814965,0.18402443657265927,5,2,3,1,1,2,1,1,1,1.4638501094227998,1.5714285714285714,0,1,-0.5612498234260587,4,4,5,4,2,2,3,6,6,NA,2,1.1338934190276817,3.4285714285714284,0,2.5714285714285716,3,3.8333333333333335,3.2559414990859232,-0.7395711320441822,0,-0.3058691320761303,3,2,5,3,4,2,3,3,4,2,1,3,4,4,5,4,4,2,3,5,1.162919151265879,3.4,0,4,0,2.4,0,3,0,3.1333333333333333,0,3,1,3,1,3,3,4,4,4,4,2,1,1,4,2,2,1,3,3,3,1.142481141154959,2.8,0,"White, Caucasian, Anglo, European American",0,27,0,1,NA,1,4,6,Freelance artist,7,0,190,69,2,5,2,0,0,1,0,0,TRUE,TRUE,TRUE,TRUE,TRUE,2,0.9178083333348235,0.72,0.07004887218011878,2,0.4487937499987893,0.5271290322590259,1,0.96875,0.002205985120979724,0.003658209828599464,2,0.5683062499999069,0.6839290322589298,1,0.96875,0.006799052217942457,0.006414565231945262,1.2117,0.7913,0.6229,1.0734,0.5842,0.6546,0.0387,1.2785315376,0.8468658850266667,0.6103098381333333,1.1718,5.8484,0.3486,3.8473,0.381,-89.5817,0.9493,7.4576,0.3856,6.6655,0.456,0.9897,1.2937454779333333,3.97966416,5.680777928,0.3722613587,0.3390895909666667,0.9929,4.1574,0.4627,5.7997,0.6019,0.5662,0.103,0.382,0.592,0.008,1.357,169.625,1.93759979,4.764809006,3.470738448666667,0.3681239222666667,0.41680101313333334,336,0.9955555555555555,1,0,1,2,FALSE,FALSE,FALSE
480,2021-11-13T08:09:44Z,2021-11-13T08:38:30Z,1725,1,2021-11-13T08:38:31Z,1,Chrome,94.0.4606.81,Macintosh,1440,900,No,1.6,691,89,568,106,103,113,-0.2523099622456269,-0.0073076505627059805,0.6763785954444064,0.017288211097655985,0.4289313657241011,0.12876965154068984,2,2,3,3,2,3,2,2,1,3,2,1,2,2,2,2,3,2,2,2,0.5871429486123998,0,1,2,4,4,2.55,0,2,4,2,4,2,3,3,4,2,2,3,3,5,3,3,3,4,5,2,3,4,3,3,7,1,3,3,5,3,3,3,4,4,3,3,3,2,4,4,2,3,2,4,2,3,3,4,4,2,2,1,2,5,1,2,4,1,1,4,1,2,1,1,2,2,2,1,1,1.1987230443004493,0.9258200997725514,3.375,0,1.5,0,2.8666666666666667,0,2.5555555555555554,0,2.75,0,2.3333333333333335,0,1.7142857142857142,0,1.3333333333333333,0,2.3783783783783785,0,4,3,3,0.9346586255283681,0.8468331594339827,1.3811800968191483,1.1140066281265655,5,2,4,1,1,3,2,1,1,1.5118578920369088,1.7142857142857142,0,1,-0.4757826382709144,5,5,5,5,3,3,2,7,7,6,4,1.2909944487358056,4.285714285714286,0,1.7142857142857142,2,3.8333333333333335,3.2559414990859232,-1.3043345419688306,0,-1.0662768215670753,2,2,2,3,2,2,4,3,2,4,3,4,3,3,3,3,4,2,3,3,0.7037315505489968,2.2,0,3.8,0,3.4,0,3.2,0,3.466666666666667,0,2,2,1,1,2,2,3,2,2,2,2,2,1,3,2,3,2,2,2,1,0.6048053188292994,2.15,0,"Asian or Asian American (e.g., Chinese, Japanese, and others) & White, Caucasian, Anglo, European American",1,18,0,1,NA,1,4,4,Assistant/College student,6,0,111,68,1,5,2,0,0,1,0,0,TRUE,TRUE,TRUE,TRUE,TRUE,4,0.7891951219454044,0.8367346938775511,0.1039671439612157,4,0.4702290322588336,0.5315300000230472,1,0.9375,0.0028297561280799673,0.005198726288899415,4,0.6200593750029803,0.657696774182781,1,1,0.007601781198724721,0.005897156988337912,1.4013,1.2411,0.3962,1.1855,1.6015,0.4642,0.1801,1.416619029,1.1207924417333333,0.3896712178,1.0185,4.8997,0.3663,3.2757,0.3894,-80.4244,0.761,4.9442,0.3975,3.8793,0.4374,0.7272,1.1614200740666667,3.503677699,5.055111309333333,0.3783296982,0.3574308164,0.9352,3.2757,0.5083,4.296,0.5608,0.9862,0.179,0.329,0.615,0.024,1.33,55.41666666666667,2.5449121166666666,4.758831313,4.998621528666667,0.35602607896666666,0.41134818296666664,104,0.3081481481481481,1,0,0,1,FALSE,FALSE,FALSE
481,2021-11-13T08:21:03Z,2021-11-13T08:41:20Z,1217,1,2021-11-13T08:41:21Z,1,Chrome,95.0.4638.69,Windows NT 10.0,1280,720,NA,1.7777777777777777,601,45,306,58,44,114,-0.4835529938262323,-0.40703613634272556,-0.5849520577353787,-0.5676593025364346,-0.3859801528497444,0.1456610183015429,2,2,2,1,3,1,2,3,1,3,2,1,1,2,3,3,2,2,3,2,0.7591546545162482,0,0,4,4,4,1.95,0,3,3,3,3,4,2,2,4,2,2,2,2,1,3,3,2,4,4,3,2,3,3,3,4,2,3,0,3,3,3,4,4,4,3,3,3,3,3,4,3,3,3,4,3,4,4,4,4,2,4,4,4,4,4,3,3,3,1,3,2,3,2,2,2,2,2,2,2,0.775952383914182,0.828078671210825,3,0,2,0,2.8666666666666667,0,2.6666666666666665,0,3.3333333333333335,0,3.8333333333333335,0,2.4285714285714284,0,2,0,3.027027027027027,0,2,3,0,1.1048704030009173,0.9644332796075691,0.6024486139630555,0.7834409467853123,2,4,2,2,3,3,3,3,1,0.7559289460184544,3.2857142857142856,0,2,0.8333440732100549,4,4,4,4,1,1,2,4,6,2,2,1.4638501094227998,3.142857142857143,0,2.857142857142857,4,3.8333333333333335,3.2559414990859232,-0.1748077221195339,0,0.13585456772906723,3,3,3,2,3,3,3,2,2,4,2,4,1,4,3,2,4,4,3,3,0.9611501047232549,2.8,0,3.4,0,3.8,0,3.6,0,3.6,0,1,1,1,1,1,1,1,3,1,1,2,3,2,1,2,3,1,1,1,2,0.7608859102526822,1.5,0,"White, Caucasian, Anglo, European American",0,29,0,1,NA,1,3,8,research associate,4,0,150,70,3,5,2,0,0,1,0,0,TRUE,TRUE,TRUE,TRUE,TRUE,6,0.6983108107914796,0.74,0.02128745792160262,6,0.46360400005340574,0.5946392857091768,0.8333333333333334,0.875,0.010269709242556735,0.027897738545736347,6,0.579551724137931,0.6349958333472411,0.90625,0.75,0.014023092104654005,0.029719468992015777,1.0479,1.0283,0.4495,0.9493,1.1252,0.4975,0.1545,1.1128132465666667,0.9946585830566667,0.44121984536666664,1.1068,1.5887,0.2232,1.8103,0.3435,-14.4006,0.7391,3.9203,0.3704,3.1591,0.4755,0.7838,1.1605872591333333,2.0389362703,1.9363426649333333,0.3385174682,0.2216256629,0.7646,2.9544,0.4762,1.9567,0.486,0.8575,0.05,0.385,0.257,0.011,1.531,139.1818181818182,1.2979437573333332,2.269284713433333,1.1134059606366666,0.30868430026666666,0.24968402833333334,320,0.9481481481481481,1,0,0,1,FALSE,FALSE,FALSE
482,2021-11-13T07:58:26Z,2021-11-13T08:44:04Z,2737,1,2021-11-13T08:44:05Z,0.8999999761581421,Firefox,94.0,Windows NT 10.0,1536,864,NA,1.7777777777777777,1637,88,547,158,64,126,2.178311236368292,-0.016392388875888245,0.5752795736246525,0.6509813508679207,-0.10973896011284763,0.3483574194317798,1,2,3,3,1,3,4,1,2,1,1,3,2,2,1,1,3,2,1,1,0.9679060415469871,0,1,2,3,1,3.3,0,3,4,3,4,1,2,2,4,3,1,4,2,4,2,4,2,5,1,1,2,5,2,3,0,2,0,0,5,2,4,4,5,3,5,5,2,1,5,1,2,2,1,4,3,3,1,5,5,2,1,1,1,2,2,1,1,3,1,5,2,2,1,2,1,2,1,2,2,1.5538386062955234,1.1254628677422756,2.625,0,1.75,0,2.8666666666666667,0,2.111111111111111,0,2.4166666666666665,0,1.6666666666666667,0,1.4285714285714286,0,1.3333333333333333,0,2,0,0,0,0,0.2327977159502012,0.36191414538487376,-0.5020371591262895,-0.07006150687070789,5,1,3,1,1,1,1,1,1,1.5735915849388864,1.2857142857142858,0,1,-0.7321841937363471,5,5,5,5,3,3,3,3,1,NA,3,1.0690449676496976,4.142857142857143,0,1.8571428571428572,7,3.8333333333333335,3.2559414990859232,1.5194825076544112,0,0.4253027006659825,2,2,1,1,1,2,3,2,2,2,5,4,2,3,4,4,4,3,3,2,1,1.4,0,3.2,0,2.8,0,3.8,0,3.2666666666666666,0,1,1,4,1,4,4,4,1,4,4,2,1,1,4,2,1,2,4,4,4,1.4244112357114616,3.25,0,"White, Caucasian, Anglo, European American",0,27,0,1,NA,1,3,1,unemployed,1,0,180,70,1,5,2,0,0,1,0,0,TRUE,TRUE,TRUE,TRUE,TRUE,1,0.8391025641025641,0.78,0.12811102040816327,1,0.5773333333333334,0.7052068965517242,0.967741935483871,0.9666666666666667,0.03423413978494624,0.04880075402298851,1,0.5970625,0.6565806451612903,1,0.96875,0.020989673387096768,0.012883016129032258,1.3594,0.9313,0.4828,1.1419,0.767,0.5304,0.0073,1.3998965506666667,0.9283190198666667,0.4729680695333333,1.5087,2.0232,0.2183,2.9255,0.4621,-20.543,1.3266,2.9319,0.3432,3.4206,0.46,0.3993,1.6742127683333334,2.9802563706666665,2.373258276966667,0.43267663976666665,0.21516030903333333,1.4348,4.493,0.4291,5.5706,0.5296,0.973,0.092,0.329,0.357,0.013,1.542,118.61538461538463,1.8317422806666666,3.3116289356666666,3.1251107453333336,0.3147548503,0.3793439103333333,407,1.2059259259259258,1,1,1,2,FALSE,FALSE,FALSE
483,2021-11-13T08:11:10Z,2021-11-13T08:45:05Z,2035,1,2021-11-13T08:45:06Z,0.8999999761581421,Chrome,95.0.4638.69,Windows NT 10.0,1360,768,NA,1.7708333333333333,963,51,553,93,210,85,0.4465578665313138,-0.35252770646363196,0.6041650084302965,-0.14113507384491022,1.9068217468664987,-0.34418861776319626,3,3,1,1,3,1,2,2,1,3,2,1,2,1,3,3,1,1,2,2,0.8522416262267903,0,1,1,3,2,1.8,0,4,4,2,4,2,2,5,2,2,1,1,5,2,5,2,2,2,1,1,1,1,1,1,1,2,0,0,4,4,2,5,4,4,3,4,4,3,5,1,1,2,1,4,4,1,3,1,1,5,1,1,1,2,4,1,2,1,1,4,1,2,1,3,1,1,1,2,1,1.464802254792655,1.4573295865416045,1.25,0,1.25,0,1.8,0,2.2222222222222223,0,1.9166666666666667,0,1.5,0,1.2857142857142858,0,1.6666666666666667,0,1.837837837837838,0,1,0,0,-0.723330169852391,-0.75707761537795,-0.4557470907642554,-0.6064123530711027,4,2,3,1,1,2,1,1,1,1.1547005383792515,1.7142857142857142,0,1,-0.4757826382709144,3,4,4,3,1,1,3,6,3,1,1,1.2535663410560174,2.7142857142857144,0,3.2857142857142856,4.5,3.8333333333333335,3.2559414990859232,0.10757398284279028,0,0.5160584124745394,2,3,1,4,1,3,2,4,3,1,2,2,4,3,3,4,3,4,2,4,0.9611501047232549,2.2,0,2.8,0,1.8,0,2.6,0,2.4,0,1,1,2,3,1,2,2,2,1,2,2,4,2,1,1,4,2,2,1,3,0.9445132413883326,1.65,0,"White, Caucasian, Anglo, European American",0,23,0,1,NA,1,1,2,unemployed,1,0,170,66,1,5,2,0,0,0,0,0,TRUE,TRUE,TRUE,TRUE,TRUE,2,0.8312674999999814,0.8163265306122449,0.034582752346970884,2,0.45093125000060535,0.517971874999348,1,1,0.00226263124999412,0.002407768538357174,2,0.5949250000003958,0.6485937500001164,1,1,0.003888285161265287,0.005962122540314511,1.3406,1.22,0.4828,1.0327,1.516,0.6133,0.2785,1.373342332,1.1063925134333332,0.4748653263666667,6.6874,11.6091,0.1629,11.2237,0.2201,-105.5562,0.7797,5.8819,0.3889,5.8799,0.4543,0.6624,1.7721323364666666,5.562053383666667,6.134842893,0.3658537963333333,0.31213124313333335,0.8395,5.0523,0.5213,4.5517,0.5578,0.7341,0.166,0.353,0.692,0.016,1.224,76.5,2.3791277273333336,5.550314706666667,5.034913542666667,0.3867907374,0.42058028356666666,300,0.8888888888888888,1,0,1,2,FALSE,FALSE,FALSE
484,2021-11-13T08:06:03Z,2021-11-13T08:45:09Z,2346,1,2021-11-13T08:45:12Z,1,Chrome,95.0.4638.69,Windows NT 10.0,1920,1080,NA,1.7777777777777777,931,44,310,94,44,107,0.36433812196932075,-0.4161208746559078,-0.5656951011982828,-0.12894866731086665,-0.3859801528497444,0.02742145097557139,3,3,1,1,3,1,1,3,1,4,3,1,1,1,3,3,1,1,3,3,1.0990426455975697,0,1,4,3,3,1.45,0,2,2,4,2,4,3,1,3,4,4,4,2,1,2,2,3,3,5,1,3,3,3,3,15,3,0,1,1,4,1,4,1,4,5,5,5,2,5,5,1,2,1,5,5,5,5,5,5,1,1,5,5,5,5,2,5,5,5,3,3,4,2,2,3,3,5,5,5,1.6421622017013717,1.1126972805283737,3,0,4.5,0,3.7333333333333334,0,2.6666666666666665,0,3.3333333333333335,0,4.166666666666667,0,3.7142857142857144,0,2.3333333333333335,0,3.3513513513513513,0,6,0,1,1.3066028800054197,1.4762599754741736,1.7553805604416417,1.6158202679579077,4,1,3,1,1,2,2,3,3,1.1547005383792515,1.7142857142857142,0,3,0.2621927112778498,4,4,5,5,4,4,1,6,1,5,4,1.3451854182690985,4.428571428571429,0,1.5714285714285714,5.5,3.8333333333333335,3.2559414990859232,0.6723373927674386,0,-0.15761185162037722,2,2,2,2,2,2,5,2,2,4,1,4,2,5,4,1,5,2,4,1,1.533747356112131,2,0,4.4,0,4.4,0,4.4,0,4.4,0,1,2,2,4,4,2,1,4,2,1,3,4,1,2,4,4,2,2,2,2,1.145931016569864,1.85,0,Black or African American,0,23,0,1,NA,1,2,3,IT Manager,3,0,190,73,2,5,2,0,0,0,0,0,TRUE,TRUE,TRUE,TRUE,TRUE,1,0.7818878048785576,0.82,0.021590756326738788,1,0.46468709677481845,0.5803225806451613,0.96875,0.96875,0.0021684678931149035,0.0033118044758133442,1,0.5911064516137684,0.62268387096855915,1,0.96875,0.0062450539570534,0.005954771250039111,1.1528,1.442,0.5304,1.0762,1.5508,0.5516,0.1717,1.2412060425666667,1.196572514,0.49359018866666665,1.1697,4.6166,0.3473,4.083,0.4441,-82.0103,0.8065,6.6611,0.4034,4.5502,0.5011,0.9017,1.3025944514666667,4.162146716,4.787975258333334,0.43313339153333336,0.33919226573333333,0.6786,3.4085,0.5265,3.5316,0.559,0.9488,0.254,0.217,0.674,0.051,1.771,34.72549019607843,1.9249199583333334,4.3856287426666665,3.751126989,0.37301466656666665,0.3840951976,322,0.9540740740740741,1,0,0,1,FALSE,FALSE,FALSE
485,2021-11-13T08:10:11Z,2021-11-13T08:45:52Z,2141,1,2021-11-13T08:45:53Z,1,Edge,95.0.1020.44,Windows NT 10.0,1920,1080,NA,1.7777777777777777,648,541,540,208,49,115,-0.362792744000805,4.098994066995677,0.5415798996847346,1.2603016775700986,-0.31691985466552025,0.16255238506239597,4,4,1,1,4,1,1,4,1,4,4,1,1,1,4,4,1,1,4,4,1.538967528127731,0,1,1,3,2,1,0,2,4,1,3,2,3,3,4,4,3,2,1,1,3,3,3,4,4,1,4,4,4,4,0,2,1,0,4,4,1,4,4,4,4,4,4,1,4,1,1,1,1,1,5,5,5,5,5,1,1,1,1,1,5,1,1,1,1,5,1,1,1,1,2,1,4,1,1,1.7419915426128034,1.0555973258234952,3.5,0,1.75,0,2.8666666666666667,0,2.3333333333333335,0,3.4166666666666665,0,2.1666666666666665,0,0.8571428571428571,0,1.3333333333333333,0,2.3513513513513513,0,0,1,0,0.9955986446234777,0.8889369061627975,-0.2954039515332659,0.2967664773147658,4,1,3,1,1,1,1,1,3,1.2535663410560174,1.4285714285714286,0,2,-0.2777293338068208,5,5,5,5,1,1,1,7,1,2,3,2.138089935299395,3.857142857142857,0,2.142857142857143,5,3.8333333333333335,3.2559414990859232,0.38995568780511447,0,0.019881285584207653,2,3,3,1,1,1,4,2,3,2,2,2,1,1,3,2,2,2,1,1,0.8837151016885368,2,0,3.4,0,3.2,0,3.2,0,3.2666666666666666,0,1,1,1,2,1,1,1,1,2,1,1,3,1,1,1,3,1,1,1,1,0.6569466853317864,1.4,0,"White, Caucasian, Anglo, European American",0,21,0,1,NA,1,3,4,IT,3,0,154,70,1,5,2,0,0,0,0,0,TRUE,TRUE,TRUE,TRUE,TRUE,2,1.01570285714282,0.7,0.08332807217957132,2,0.48427499999993595,0.5732285714283851,1,0.9032258064516129,0.006650286451593352,0.009368586903211714,2,0.547903125000099,0.6171548387096714,1,0.96875,0.00762136224797981,0.00945671248989676,1.4615,0.6036,0.5475,1.3587,0.5649,0.6209,0.4307,1.493931994,0.6976696937133333,0.5367807434,1.1288,3.3243,0.3145,2.7409,0.3993,-53.4016,0.8788,4.5341,0.3919,3.2589,0.4443,0.9967,1.2802754545333332,2.9734295976666667,3.71691752,0.38501864636666666,0.30634460236666666,0.7333,3.5877,0.4676,3.4066,0.5467,0.9883,0.082,0.351,0.428,0.01,1.275,127.49999999999999,2.049941474666667,4.431888327333334,3.212138279,0.31809307136666665,0.3115454505,315,0.9333333333333332,1,0,0,1,FALSE,FALSE,FALSE
486,2021-11-13T07:58:27Z,2021-11-13T08:46:25Z,2877,1,2021-11-13T08:46:27Z,1,Chrome,95.0.4638.69,Windows NT 10.0,1366,768,I just had to go to the bathroom due to the long duration of the study,1.7786458333333333,1648,128,772,102,74,84,2.206574273561477,0.3469971436514023,1.6584833788363,-0.03145741503851823,0.028381636255600768,-0.3610799845240493,3,3,2,2,3,2,1,2,1,3,2,2,1,1,3,2,1,2,2,2,0.7254762501100116,0,1,2,2,2,2,0,4,4,3,3,3,2,4,3,2,1,2,4,3,4,3,2,2,1,1,2,2,2,2,0,2,0,0,4,3,3,3,4,4,3,4,4,4,3,3,3,3,3,4,4,4,3,4,4,3,1,1,1,2,4,1,1,1,1,4,3,3,1,3,1,2,3,3,3,1.166988372633533,0.9258200997725514,1.75,0,2.75,0,2.3333333333333335,0,2.4444444444444446,0,3.3333333333333335,0,1.8333333333333333,0,1.5714285714285714,0,1.6666666666666667,0,2.4594594594594597,0,0,0,0,-0.02567202021181809,-0.04586306143925698,-0.18843234825732513,-0.11714770484829105,4,2,3,2,2,3,3,4,3,0.7559289460184544,2.4285714285714284,0,3.5,0.8740224744407622,4,5,4,3,3,3,3,4,4,3,3,0.7867957924694432,3.5714285714285716,0,2.4285714285714284,5,3.8333333333333335,3.2559414990859232,0.38995568780511447,0,0.17922328042708108,2,3,2,1,2,2,4,2,2,3,1,3,4,4,3,3,4,3,3,3,0.8837151016885368,2,0,3.8,0,3,0,3.6,0,3.466666666666667,0,3,3,3,4,3,2,2,3,2,1,4,2,2,2,2,2,1,3,2,2,0.8207826816681233,2.3,0,"White, Caucasian, Anglo, European American",0,30,0,1,NA,1,3,3,Unemployed,2,0,160,66,2,5,2,1,0,1,0,1,TRUE,TRUE,TRUE,TRUE,TRUE,2,1.0388318181810055,0.88,0.09854823086253944,2,0.5750249999947846,0.6581290322657555,1,0.96875,0.0173060909690695,0.01315217208534989,2,0.7987999999970198,0.8605,1,1,0.018803703226133704,0.03328002709582036,1.6506,1.2463,0.5423,1.475,1.4788,0.6314,0.5562,1.6166429483333333,1.1199622422,0.5357361876333333,1.551,3.446,0.35,3.1796,0.4261,-47.0681,1.2991,4.8297,0.4276,3.0936,0.469,0.9049,1.7582735266666667,3.3579769863333335,3.747128845,0.40593148356666664,0.33509895423333336,1.6603,4.9485,0.6307,3.424,0.6095,0.9534,0.193,0.342,0.419,0.02,1.279,63.949999999999996,3.0264809666666665,3.7953045236666667,3.467639144,0.39796163356666664,0.4250965828666667,69,0.20444444444444443,1,0,8,9,FALSE,FALSE,FALSE
487,2021-11-13T08:06:00Z,2021-11-13T08:47:05Z,2464,1,2021-11-13T08:47:06Z,1,Chrome,95.0.4638.69,Windows NT 10.0,1280,720,NA,1.7777777777777777,718,100,1176,107,138,149,-0.1829370527714453,0.09262447088229891,3.6034359890829912,0.02947461763169954,0.9123534530136705,0.7368588549314005,4,3,1,1,3,1,1,3,1,3,2,1,1,2,4,3,1,1,3,3,1.1192102478745307,0,1,1,2,2,1.5,0,4,4,3,4,3,2,5,2,2,2,3,5,3,4,4,2,2,1,1,1,1,2,2,0,2,0,0,5,4,3,3,3,3,2,3,3,2,4,2,1,4,2,3,3,3,2,3,3,5,1,2,1,3,4,2,1,2,1,4,1,2,1,1,1,1,2,1,1,1.1695588347184027,1.0465362369445672,1.5,0,1.25,0,2.1333333333333333,0,2.7777777777777777,0,2.3333333333333335,0,1.8333333333333333,0,1.4285714285714286,0,1,0,2.135135135135135,0,0,0,0,-0.3829066149072922,-0.3786278459304421,-0.6588395645607719,-0.5187337052456069,4,2,4,1,1,2,2,2,1,1.2535663410560174,1.7142857142857142,0,1.5,-0.2912888008837234,5,5,5,5,4,4,1,7,6,4,4,1.4638501094227998,4.714285714285714,0,1.2857142857142858,2.5,3.8333333333333335,3.2559414990859232,-1.0219528370065065,0,-1.1640989613502233,2,2,3,3,3,2,4,3,2,4,1,4,3,4,5,3,3,2,3,4,1.0600988273786194,2.6,0,4,0,3.4,0,3.6,0,3.6666666666666665,0,2,2,1,4,2,2,2,3,1,2,2,4,2,2,2,4,1,2,2,2,0.8944271909999159,1.7,0,"Asian or Asian American (e.g., Chinese, Japanese, and others)",0,20,0,1,NA,1,4,4,student studying aerospace engineering,5,0,145,70,2,5,2,0,0,3,0,0,TRUE,TRUE,TRUE,TRUE,TRUE,1,1.1532923076932247,0.78,0.37062570295891517,1,0.5858937499988824,0.6159687499990687,1,1,0.07049773157249113,0.0434886893139751,1,0.5951193548373638,0.7180419354852169,1,0.96875,0.012609034279998403,0.03705332500010964,1.7284,0.7179,0.5426,1.5771,0.6212,0.5565,8e-4,1.6993096066666666,0.7531295661333334,0.5371768251333333,1.5487,2.5266,0.2794,2.957,0.3541,-30.6434,1.3933,2.4541,0.2902,3.2432,0.3732,0.7821,1.616634809,3.0854920926666667,2.7529096633333334,0.3483735051333333,0.276735566,1.1677,4.0964,0.4484,4.1895,0.5496,0.9577,0.072,0.419,0.444,0.013,1.659,127.61538461538463,1.8148324703333334,4.234608644,2.8018813516666667,0.3811845551,0.40212411226666667,360,1.0666666666666667,1,1,6,7,FALSE,FALSE,FALSE
488,2021-11-13T08:32:35Z,2021-11-13T08:52:03Z,1168,1,2021-11-13T08:52:05Z,0.8999999761581421,Chrome,94.0.4606.71,Macintosh,1440,900,The second arrow test seemed easier because it the symbols were bigger.,1.6,570,45,285,61,48,83,-0.563203371370663,-0.40703613634272556,-0.6860510795551324,-0.5311000829343039,-0.3307319143023651,-0.3779713512849024,4,4,1,1,4,1,3,4,1,4,3,2,2,1,4,4,2,1,4,4,1.3416407864998738,0,1,2,2,3,1.3,0,4,4,3,4,5,2,4,3,3,1,1,4,1,5,5,4,3,1,1,2,1,2,1,5,4,0,0,3,4,5,5,5,5,5,5,5,3,5,2,3,4,5,3,4,3,2,2,2,4,1,1,1,3,3,1,4,4,3,3,1,3,1,1,1,3,2,4,4,1.4678741957860881,1.4375905768565218,1.875,0,3.25,0,2.066666666666667,0,1.3333333333333333,0,2.6666666666666665,0,1.6666666666666667,0,2.5714285714285716,0,1,0,2.081081081081081,0,3,0,0,-0.1832755178715861,-0.2693516848802533,0.5776474785667063,0.1541478968432265,5,1,4,1,2,2,3,3,3,1.5118578920369088,1.7142857142857142,0,3,0.2621927112778498,3,3,4,2,1,3,3,6,6,NA,2,0.9511897312113419,2.7142857142857144,0,3.2857142857142856,3,3.8333333333333335,3.2559414990859232,-0.7395711320441822,0,0.09248585503105322,3,3,2,2,2,2,3,4,3,2,1,3,4,3,4,5,5,4,3,5,1.1832159566199232,2.4,0,3.8,0,2.2,0,2.6,0,2.8666666666666667,0,2,1,1,2,4,3,3,1,3,3,2,3,2,3,1,3,1,2,1,4,1.019545822516343,2.35,0,"Asian or Asian American (e.g., Chinese, Japanese, and others)",0,24,0,1,NA,1,2,4,student,7,0,195,71,3,5,2,0,0,1,0,0,TRUE,TRUE,TRUE,TRUE,TRUE,2,0.7766352941148421,0.6938775510204082,0.0221807263539146,2,0.4527599999944369,0.4889366666555405,0.9375,0.9375,0.003218162811099007,0.0031523891010175396,2,0.5919625000059605,0.6352406250052154,1,1,0.010405581127617747,0.006600063778295539,1.143,0.7568,0.4882,0.6161,1.3037,0.6778,0.4496,1.2064044722666667,0.8357251702366667,0.4798619997,0.8622,3.8359,0.3506,3.3159,0.3711,-79.7999,0.741,4.216,0.3714,5.232,0.4205,0.9939,0.9524733933333334,3.5482345246666664,4.092786126666667,0.3656895450666667,0.3442566572333333,0.8651,2.9015,0.4858,4.3293,0.5465,0.9453,0.229,0.222,0.632,0.018,1.234,68.55555555555556,2.2792332786666667,4.369397957,4.711025861666666,0.3329885358333333,0.400448405,468,1.3866666666666665,1,0,0,1,FALSE,FALSE,FALSE
489,2021-11-13T08:34:54Z,2021-11-13T08:53:21Z,1106,1,2021-11-13T08:53:22Z,1,Chrome,95.0.4638.69,Macintosh,1440,900,NA,1.6,577,43,263,62,50,73,-0.5452178022477271,-0.4252056129690901,-0.7919643405091602,-0.5189136764002604,-0.3031077950286754,-0.5468850188934331,2,3,2,1,2,1,2,3,1,2,2,2,2,1,2,2,2,1,3,2,0.6407232755171874,0,1,2,3,3,2.1,0,5,5,2,5,2,1,4,2,2,1,2,5,2,4,3,2,2,1,1,2,2,2,1,0,2,0,0,4,3,5,4,3,5,4,5,3,2,5,2,1,4,2,5,1,2,2,2,2,4,1,1,1,1,1,1,1,2,1,5,1,1,1,1,1,1,1,1,1,1.5373234413627352,1.5118578920369088,1.625,0,1,0,1.6666666666666667,0,2,0,1.6666666666666667,0,1,0,1,0,1,0,1.5135135135135136,0,0,0,0,-0.6918094703204373,-0.7925996269859388,-0.7372407672780129,-0.7649201971319759,5,2,4,1,1,1,1,2,3,1.6761634196950514,1.2857142857142858,0,2.5,-0.17870268157477404,5,5,5,5,3,3,1,7,7,5,4,1.5735915849388864,4.428571428571429,0,1.5714285714285714,2,3.8333333333333335,3.2559414990859232,-1.3043345419688306,0,-1.145947818988512,2,2,3,1,2,2,4,2,1,5,2,3,2,5,4,3,4,2,3,3,1.1952286093343936,2,0,3.8,0,3.8,0,4.2,0,3.933333333333333,0,2,1,2,3,3,1,2,3,1,1,3,3,2,3,1,3,1,2,2,2,0.8255779474818965,1.85,0,"Asian or Asian American (e.g., Chinese, Japanese, and others)",0,23,0,1,NA,1,4,6,Medical Student,5,0,150,69,3,5,2,0,0,1,0,0,TRUE,TRUE,TRUE,TRUE,TRUE,5,0.7467069767242254,0.86,0.01824047118357775,5,0.43857741934253325,0.46017500000447037,1,1,9.391158059999505e-4,0.0018320141939454696,5,0.5693843750208616,0.6601906249970197,1,1,0.0032403774900163188,0.00618266345421201,1.2511,1.6644,0.481,0.9023,1.6561,0.5768,0.1125,1.2733596542666668,1.3305158454666666,0.47334667616666665,10,17.6356,0.1551,13.9551,0.1019,-120.6088,0.7036,7.9032,0.3959,6.6334,0.4118,0.9671,1.4735080842333332,5.505608225333333,6.969552086333334,0.33346313503333336,0.34073334163333335,0.986,5.3696,0.4845,5.5802,0.5662,0.8844,0.103,0.422,0.709,0.021,1.937,92.23809523809524,1.8062032979666667,5.571818397666667,5.02109177,0.4139069761,0.4886826987333333,438,1.2977777777777777,1,0,0,1,FALSE,FALSE,FALSE
491,2021-11-13T08:33:59Z,2021-11-13T09:02:56Z,1736,1,2021-11-13T09:02:56Z,0.8999999761581421,Firefox,94.0,Windows NT 10.0,1920,1080,NA,1.7777777777777777,723,50,560,143,63,90,-0.17009021768363392,-0.36161244477681426,0.6378646823702144,0.4681852528572675,-0.12355101974969247,-0.2597317839589309,3,3,1,1,3,1,1,2,1,3,2,1,1,1,3,2,1,1,2,2,0.8506963092234007,0,1,1,3,2,1.75,0,3,4,3,3,2,2,4,2,2,3,2,3,2,2,3,1,3,1,1,1,1,2,1,0,3,0,0,5,4,2,2,2,4,4,2,2,1,5,1,1,3,1,5,3,2,2,1,1,3,1,1,1,1,1,1,1,1,1,4,1,2,1,1,1,1,1,1,1,1.3434302381608079,0.7237468644557459,1.375,0,1,0,2.533333333333333,0,3,0,1.5,0,1.1666666666666667,0,1.1428571428571428,0,1,0,1.7567567567567568,0,0,0,0,-0.696012230258031,-0.42305455799601904,-0.7372407672780129,-0.580147662637016,4,2,3,1,2,3,2,1,1,0.9759000729485332,2.142857142857143,0,1,-0.21938108280548152,4,4,5,4,2,2,1,4,3,3,2,1.4638501094227998,3.7142857142857144,0,2.2857142857142856,5.5,3.8333333333333335,3.2559414990859232,0.6723373927674386,0,0.24074313548680643,2,2,2,2,2,2,2,3,2,2,2,4,2,3,4,4,4,2,3,3,0.8618916073713346,2,0,4,0,2.6,0,3.4,0,3.3333333333333335,0,1,1,2,3,1,2,1,2,3,2,2,1,1,3,1,1,1,2,2,2,0.7326950970650465,2,0,"Asian or Asian American (e.g., Chinese, Japanese, and others)",0,27,0,1,NA,1,2,2,Unemployed,4,0,132,68,1,5,2,0,0,1,0,0,TRUE,TRUE,TRUE,TRUE,TRUE,3,1.1051944444444444,0.7659574468085106,0.28986854024051806,3,0.4211875,0.49734375000000003,1,1,0.005002028225806453,0.007076361895161291,3,0.59875,0.6710625,1,1,0.004209225806451614,0.004707221774193548,1.7126,0.6944,0.5584,1.4144,0.4905,0.6333,0.056,1.6900066666666667,0.73864885684,0.5501804906666666,5.27,8.276,0.1028,7.4277,0.1426,-78.1669,0.7945,7.3222,0.3651,7.2321,0.4377,0.9407,1.8820969476666667,4.550779345666666,5.033433714666667,0.2941294079333333,0.23623937336666667,0.7315,4.2176,0.5297,5.5079,0.6074,0.9858,0.168,0.378,0.774,0.023,1.846,80.26086956521739,2.3638738923333333,5.543338929,5.276012427,0.39195505336666664,0.45579980356666666,316,0.9362962962962963,1,0,0,1,FALSE,FALSE,FALSE
492,2021-11-13T08:48:38Z,2021-11-13T09:05:30Z,1012,1,2021-11-13T09:05:32Z,0.8999999761581421,Firefox,94.0,Windows NT 10.0,1680,1050,NA,1.6,614,34,187,35,37,56,-0.4501512225979226,-0.5069682577877305,-1.1578465147139834,-0.8479466528194364,-0.4826645703076583,-0.8340382538279354,3,3,1,1,3,1,1,4,1,4,3,1,1,1,4,4,1,1,1,4,1.348488432516786,0,1,1,3,4,1.35,0,4,4,2,4,1,1,4,1,1,1,1,4,1,4,4,1,1,1,1,1,1,1,1,0,2,0,0,5,4,4,4,4,4,4,4,4,1,5,1,1,4,4,4,1,1,1,1,1,5,1,1,1,1,1,1,1,1,1,5,1,1,1,1,1,1,1,1,1,1.6508256192660766,1.505545305418162,1,0,1,0,1.5333333333333334,0,1.8888888888888888,0,1.4166666666666667,0,0.8333333333333334,0,0.8571428571428571,0,1,0,1.3513513513513513,0,0,0,0,-1.1814310030501165,-1.1881812657920683,-0.7372407672780129,-0.9627110165350405,4,1,3,1,1,2,2,1,1,1.1547005383792515,1.7142857142857142,0,1,-0.4757826382709144,4,4,4,4,4,4,1,3,6,5,3,1.1338934190276817,4.142857142857143,0,1.8571428571428572,4.5,3.8333333333333335,3.2559414990859232,0.10757398284279028,0,-0.28065156173982786,3,1,1,5,4,4,4,2,2,4,4,2,4,4,4,3,4,4,4,4,0.8338093878327919,2.8,0,2.4,0,3.4,0,3.6,0,3.1333333333333333,0,1,1,1,3,1,1,1,4,1,1,1,4,1,1,1,3,1,1,1,1,1.0513149660756937,1.1,0,"Asian or Asian American (e.g., Chinese, Japanese, and others)",0,21,0,1,NA,1,3,4,Scientific Researcher,5,0,145,68,1,5,2,0,0,1,0,0,TRUE,TRUE,TRUE,TRUE,TRUE,5,0.7019705882352941,0.68,0.03434441469387755,5,0.596625,0.6276875,1,1,0.04241217741935484,0.04468293145161291,5,0.922,0.97684375,1,1,0.1123251612903226,0.07753394254032259,1.1945,0.6666,0.3739,1.0497,0.8076,0.4531,0.2503,1.2477248421,0.7759770254366667,0.3670184753,1.3736,2.6694,0.3393,2.9081,0.3915,-36.9429,1.3328,2.2496,0.3291,3.0189,0.3874,0.5269,1.559453057,3.1307677506666667,2.96959099,0.3732596313,0.3214400209666667,1.655,1.8512,0.5239,2.503,0.6484,0.9937,0.202,0.228,0.298,0.018,1.492,82.8888888888889,2.8460886063333333,2.5211354846666665,2.507337676,0.3429392813,0.40132870573333335,350,1.0370370370370372,1,0,2,3,FALSE,FALSE,FALSE
493,2021-11-13T08:24:33Z,2021-11-13T09:08:00Z,2607,1,2021-11-13T09:08:01Z,1,Chrome,95.0.4638.69,Windows NT 10.0,1920,1080,"None, thank you!",1.7777777777777777,580,49,685,721,138,373,-0.5375097011950403,-0.3706971830899965,1.239644574154463,7.511928229534442,0.9123534530136705,4.520525009362489,2,3,1,1,2,1,1,3,1,3,2,2,2,2,3,3,1,1,3,3,0.8583950752789521,0,1,1,3,3,1.8,0,1,4,4,4,2,1,1,4,3,4,2,1,1,2,3,2,4,1,1,1,4,2,1,0,2,0,0,3,4,4,4,4,5,4,4,4,2,4,4,4,4,3,4,4,4,2,4,4,2,1,1,1,1,1,1,1,1,1,5,1,1,1,1,1,1,1,1,1,1.4881917600614225,1.3020130933435712,2,0,1,0,3.1333333333333333,0,2,0,3.0833333333333335,0,1.3333333333333333,0,0.8571428571428571,0,1,0,2,0,0,0,0,-0.15595757827722637,0.20792090160201304,-0.7372407672780129,-0.26465993283799993,4,2,3,2,4,1,3,1,1,1.1126972805283737,2.4285714285714284,0,1,-0.048446712495193056,5,5,5,5,3,3,1,1,1,6,3,1.5735915849388864,4.428571428571429,0,1.5714285714285714,8,3.8333333333333335,3.2559414990859232,2.0842459175790595,0,0.5483424107854333,2,2,2,3,2,2,4,2,4,4,2,4,2,4,4,2,3,3,4,4,0.9411239481143202,2.2,0,3.6,0,4,0,3.2,0,3.6,0,2,2,2,1,1,2,2,3,2,2,3,2,2,1,1,2,2,2,1,2,0.5871429486123998,2.05,0,"Asian or Asian American (e.g., Chinese, Japanese, and others)",0,27,0,1,NA,1,3,6,registered nurse,6,0,163,71,3,5,2,0,0,1,0,0,TRUE,TRUE,TRUE,TRUE,TRUE,NA,NA,NA,NA,6,0.3467032258029907,0.3973899999966224,0.96875,0.967741935483871,7.604088709679103e-4,0.0028300820645775545,6,0.5285562500017695,0.619679310345958,1,0.9666666666666667,0.009501079314818426,0.005954027540131798,NA,NA,NA,NA,NA,NA,NA,NA,NA,NA,0.7859,5.9396,0.2873,4.0862,0.3055,-108.005,0.5951,7.9866,0.3133,6.4838,0.354,0.9204,0.8321761087,4.103409475666667,5.600760301333334,0.30214004726666666,0.28358683826666664,0.9582,4.6324,0.4215,4.4735,0.519,0.9756,0.071,0.382,0.491,0.011,1.456,132.36363636363637,1.4148819879333334,4.451234182666667,3.861367811,0.3713555050333333,0.45821132206666665,316,0.9362962962962963,1,0,6,7,FALSE,TRUE,FALSE
494,2021-11-13T08:37:44Z,2021-11-13T09:09:26Z,1902,1,2021-11-13T09:09:27Z,0.8999999761581421,Chrome,95.0.4638.54,Windows NT 10.0,1280,720,no,1.7777777777777777,674,34,557,77,110,51,-0.29598920154418573,-0.5069682577877305,0.6234219649673924,-0.3361175783896071,0.525615783182015,-0.9184950876322008,3,3,1,1,3,1,1,3,1,3,3,1,1,1,3,3,1,1,3,3,1.025978352085154,0,1,1,4,4,1.5,0,4,4,2,4,2,2,4,2,2,2,2,4,2,4,4,2,2,2,2,2,2,2,2,1,2,0,0,4,4,4,4,4,4,4,4,4,4,4,2,2,4,3,4,2,2,2,2,2,4,1,1,1,3,1,1,1,1,1,4,1,1,1,1,1,2,1,2,1,1.346221494521727,1.0327955589886444,2,0,1.5,0,2,0,2,0,2.25,0,1.3333333333333333,0,1,0,1,0,1.7567567567567568,0,1,0,0,-0.30725693603060344,-0.3836609374934269,-0.3773458880470143,-0.3805034127702206,4,2,4,2,2,2,2,2,1,0.9759000729485332,2,0,1.5,-0.12035443057343476,4,4,4,4,3,3,2,6,6,4,3,0.7867957924694432,3.7142857142857144,0,2.2857142857142856,3,3.8333333333333335,3.2559414990859232,-0.7395711320441822,0,-0.465211126919004,2,2,2,2,2,2,2,2,2,4,2,4,2,4,4,2,4,2,3,3,0.9411239481143202,2,0,4,0,3.4,0,3.8,0,3.7333333333333334,0,1,1,1,3,1,1,1,3,1,1,1,3,1,1,1,3,1,1,1,1,0.8207826816681233,1.2,0,"Asian or Asian American (e.g., Chinese, Japanese, and others)",0,28,0,1,NA,1,3,7,Engineer,5,0,130,66,2,5,2,0,0,1,0,0,TRUE,TRUE,TRUE,TRUE,TRUE,4,0.9220428571360452,0.84,0.11376379003568367,4,0.46143437500298023,0.5810343749895692,1,1,0.004027958460270453,0.013085743614080003,4,1.361237500011921,1.4467968749925495,1,1,0.13795315339438285,0.1697741699799048,1.5465,1.079,0.5186,1.3118,0.9028,0.628,0.237,1.547656955,1.0187380236,0.5105036141,2.447,6.818,0.282,4.75,0.3235,-76.2773,0.9309,5.1421,0.376,4.1694,0.4689,0.9964,1.805712908,3.9683849336666666,5.603261969,0.35449077726666667,0.30422987186666667,2.0231,2.6684,0.9786,2.6299,1.0819,0.9931,0.314,0.274,0.278,0.317,1.317,4.1545741324921135,3.867830008,2.12569815,1.8619512927666666,0.428401525,0.38899693583333333,104,0.3081481481481481,1,0,1,2,FALSE,FALSE,FALSE
495,2021-11-13T09:00:24Z,2021-11-13T09:17:35Z,1030,1,2021-11-13T09:17:36Z,1,Firefox,94.0,Linux x86_64,1920,1080,NA,1.7777777777777777,627,40,202,36,30,56,-0.41674945136961294,-0.45245982790863687,-1.0856329276998735,-0.8357602462853928,-0.5793489877655722,-0.8340382538279354,2,3,2,2,1,2,1,2,1,2,1,2,2,2,2,1,1,1,2,2,0.5712405705774795,0,1,2,3,2,2.4,0,5,5,3,4,2,1,5,2,3,1,2,5,2,4,4,2,2,1,1,1,2,2,2,0,2,0,0,3,4,4,5,4,5,4,5,5,2,4,2,1,3,2,4,2,2,2,1,1,5,1,1,1,3,1,1,1,1,1,5,1,3,1,1,1,1,1,1,1,1.55673485970586,1.4735767952260144,1.625,0,1,0,1.7333333333333334,0,1.6666666666666667,0,1.8333333333333333,0,1.1666666666666667,0,1.1428571428571428,0,1,0,1.5405405405405406,0,0,0,0,-0.6749984305700623,-0.7523348944820606,-0.7372407672780129,-0.7447878308800367,5,2,4,1,2,2,1,1,1,1.5118578920369088,1.5714285714285714,0,1,-0.5612498234260587,4,4,4,4,4,4,2,6,6,6,4,0.7559289460184544,4,0,2,3,3.8333333333333335,3.2559414990859232,-0.7395711320441822,0,-0.6245531217618774,3,3,3,2,2,3,2,4,2,3,3,3,2,4,3,5,3,4,4,3,0.8618916073713346,2.6,0,2.8,0,2.8,0,3.2,0,2.933333333333333,0,1,1,1,2,3,4,2,2,2,1,2,3,2,2,1,2,1,3,3,3,0.8870412083230169,2.15,0,"White, Caucasian, Anglo, European American",0,19,0,1,NA,1,4,3,None,1,0,149,72,2,5,2,0,0,1,0,0,TRUE,TRUE,TRUE,TRUE,TRUE,NA,NA,NA,NA,4,0.4977741935483871,0.595741935483871,0.96875,0.96875,0.012194951612903225,0.01376677016129032,4,0.7783125,0.8448064516129032,1,0.96875,0.06129777016129031,0.02317962802419355,NA,NA,NA,NA,NA,NA,NA,NA,NA,NA,2.1663,3.8478,0.2348,3.7322,0.298,-45.2309,0.91,2.9037,0.3651,4.4722,0.495,0.8353,1.689266628,2.4688641952,3.6992639273333334,0.25283262023333336,0.2729597891,1.4299,2.5285,0.4931,2.6681,0.5905,0.8848,0.106,0.369,0.267,0.015,2.05,136.66666666666666,2.362503179,2.8537913623333333,2.669283848666667,0.35379870286666665,0.41312962523333335,246,0.7288888888888888,1,1,5,6,FALSE,FALSE,FALSE
496,2021-11-13T08:49:09Z,2021-11-13T09:18:31Z,1761,1,2021-11-13T09:18:32Z,0.8999999761581421,Chrome,95.0.4638.69,Windows NT 10.0,1920,1080,no,1.7777777777777777,645,83,570,147,102,152,-0.3705008450534919,-0.06181608044179956,0.6860070737129543,0.5169308789934417,0.4151193060872563,0.7875329552139597,3,3,1,2,3,2,1,3,1,3,2,2,1,2,3,3,1,2,3,3,0.8335087534664907,1,1,1,4,3,1.8,0,2,3,4,2,2,4,3,4,3,4,5,1,1,3,4,2,2,1,1,1,2,4,1,4,2,0,0,5,5,4,5,5,2,3,4,3,2,4,5,1,4,2,5,2,3,2,5,5,4,1,1,1,1,1,1,3,4,3,4,4,4,1,3,3,4,2,4,5,1.4678741957860881,1.1952286093343936,1.75,0,3.75,0,3.4,0,2,0,2.6666666666666665,0,1,0,2.857142857142857,0,2.3333333333333335,0,2.2972972972972974,0,2,0,0,-0.12653825871406965,0.34284647157895054,0.5313574102046721,0.4371019408918113,3,2,3,1,1,2,3,4,1,0.8997354108424374,2.142857142857143,0,2.5,0.33410042935609163,2,4,3,5,2,2,3,1,3,1,2,1.1547005383792515,3,0,3,7,3.8333333333333335,3.2559414990859232,1.5194825076544112,0,1.0626706800374763,3,3,3,1,2,3,5,3,3,5,4,4,2,4,3,4,3,2,2,4,0.9856107606091623,2.4,0,3.2,0,3.6,0,3,0,3.2666666666666666,0,1,2,4,3,3,2,3,2,1,3,2,2,2,4,1,2,1,3,2,2,0.910465468000326,2.35,0,"White, Caucasian, Anglo, European American",0,21,0,1,NA,0,2,4,student,2,0,165,73,3,5,2,0,0,1,0,0,TRUE,TRUE,TRUE,TRUE,TRUE,5,0.8899200000000005,0.9,0.15973604202449368,5,0.42434666666666937,0.5486666666666744,1,0.9375,0.00285545498850638,0.008272996038306805,5,0.5844612903225822,0.6503259259259018,0.96875,0.84375,0.008520280635082929,0.013275787056451379,1.6354,1.3712,0.4921,1.3095,1.2772,0.5628,0.038,1.5916089536666667,1.1972921165333332,0.4874670314,1.4909,5.4599,0.2862,4.3601,0.3817,-75.6743,1.0293,5.8964,0.3369,4.6578,0.4287,0.9949,1.4584660067666666,3.2598225123333333,5.10233804,0.3400483447666667,0.2836978678,0.8623,3.8768,0.4848,2.7824,0.5306,0.8245,0.059,0.41,0.375,0.011,1.712,155.63636363636365,1.3083202572,3.3024132243333333,1.7311567825,0.3899121529333333,0.33378407753333333,104,0.3081481481481481,1,0,1,2,FALSE,FALSE,FALSE
497,2021-11-13T09:03:39Z,2021-11-13T09:19:54Z,975,1,2021-11-13T09:19:55Z,1,Firefox,94.0,Windows NT 10.0,1920,1080,Nope,1.7777777777777777,557,34,213,52,35,55,-0.5966051425989727,-0.5069682577877305,-1.0326762972228596,-0.6407777417406959,-0.510288689581348,-0.8509296205887885,3,2,1,1,3,1,2,3,1,4,2,1,1,2,4,4,2,1,3,3,1.105012502906165,0,1,3,2,2,1.6,0,3,5,4,5,2,1,3,3,2,1,3,4,2,3,4,2,3,4,1,1,2,1,1,0,2,0,5,5,5,4,5,5,5,5,5,5,2,5,1,3,3,5,3,5,5,4,5,5,2,5,3,1,1,1,1,1,1,1,5,1,1,1,1,2,1,2,1,1,1.7925437827883628,1.2535663410560174,1.875,0,1.25,0,2.2,0,1.1111111111111112,0,3.5,0,2.3333333333333335,0,0.8571428571428571,0,1.3333333333333333,0,2.108108108108108,0,0,0,5,-0.16646447812121104,-0.20043704655630842,0.22340866993513192,0.011485811689411748,5,1,5,1,1,2,2,2,4,1.8126539343499315,1.2857142857142858,0,3,0.005791155812417015,5,5,5,5,5,5,1,6,6,5,4,1.5118578920369088,5,0,1,3,3.8333333333333335,3.2559414990859232,-0.7395711320441822,0,-1.1822501037119346,2,3,3,1,2,3,5,2,3,5,4,5,1,5,4,1,4,3,5,1,1.5491933384829668,2.2,0,3.4,0,5,0,4.2,0,4.2,0,1,1,1,4,3,1,2,2,3,2,4,4,1,1,1,4,1,1,1,2,1.2139539573337679,1.6,0,"Asian or Asian American (e.g., Chinese, Japanese, and others)",0,27,0,1,NA,1,2,6,Article Writer,1,0,150,70,2,5,2,0,0,1,0,0,TRUE,TRUE,TRUE,TRUE,TRUE,2,0.6590571428571429,0.7,0.01818894734693877,2,0.41435714285714287,0.48244,0.9333333333333333,0.78125,0.002053627586206897,0.008660564516129031,2,0.53934375,0.60692,1,0.78125,0.008230039314516128,0.01382082258064516,1.1344,0.7909,0.4139,0.7815,0.629,0.551,0.2338,1.1960617161333333,0.85804425927,0.40644363036666664,0.7943,4.3687,0.3338,1.4748000000000001,0.3099,-61.521,0.6829,4.5301,0.3467,2.5591,0.3741,0.9898,0.8422859471666667,1.82463158897,4.4729204566666665,0.3062289824,0.3299605694,0.7531,3.874,0.4644,2.2971,0.4912,0.8606,0.055,0.368,0.33,0.016,2.005,125.31249999999999,1.230511253,3.36318711,1.54942730496,0.3508752482333333,0.3210889522,472,1.3985185185185185,1,0,0,1,FALSE,FALSE,FALSE
498,2021-11-13T08:57:35Z,2021-11-13T09:21:32Z,1437,1,2021-11-13T09:21:34Z,1,Chrome,95.0.4638.69,Windows NT 10.0,1366,768,None,1.7786458333333333,714,64,365,108,49,93,-0.19321452084169444,-0.23442610839226255,-0.30091194881321337,0.04166102416574309,-0.31691985466552025,-0.20905768367637165,2,2,2,3,1,3,1,2,1,3,3,1,2,1,2,1,1,1,3,3,0.8522416262267903,0,1,1,4,4,2.2,0,4,5,2,5,1,1,1,1,1,1,2,4,3,4,2,3,2,2,1,1,1,1,1,3,2,0,3,5,3,4,4,4,4,3,4,4,1,4,1,1,4,1,5,1,1,1,1,1,4,1,1,1,4,1,1,4,4,1,1,1,1,1,1,1,1,2,4,3,1.543172505386673,1.5522640914238175,1.5,0,2.5,0,1.9333333333333333,0,2.111111111111111,0,1.1666666666666667,0,1.5,0,2.2857142857142856,0,1,0,1.7027027027027026,0,2,0,3,-0.6518832509132961,-0.6504147903316194,0.6687003373160088,0.009142773492194667,3,2,3,2,1,1,1,2,1,0.8997354108424374,1.8571428571428572,0,1.5,-0.20582161572857902,4,4,5,4,5,4,1,3,6,4,3,1.3451854182690985,4.428571428571429,0,1.5714285714285714,4.5,3.8333333333333335,3.2559414990859232,0.10757398284279028,0,-0.4399935565827014,3,4,4,3,4,2,4,2,1,4,1,4,1,5,4,3,4,1,4,1,1.486446705914413,3.6,0,4.4,0,4,0,4.6,0,4.333333333333333,0,2,2,1,3,2,1,1,3,2,1,2,3,2,1,1,3,1,1,1,1,0.8013147091860318,1.5,0,"White, Caucasian, Anglo, European American",0,28,0,1,NA,1,3,4,Technical Stage Manager,3,0,185,66,5,5,2,0,0,1,0,0,TRUE,TRUE,TRUE,TRUE,TRUE,1,0.8519292682926852,0.82,0.039393255710202,1,0.5485387096774554,0.6427548387096744,0.96875,0.96875,0.004984866764102903,0.005819197006050893,1,0.7403062499999651,0.7684781250000232,1,1,0.026266522540329528,0.02347719208670476,1.5418,1.1117,0.4029,0.8791,1.7849,0.6819,0.5022,1.531645836,1.0362634683666667,0.39809224883333333,1.1492,4.0662,0.4135,3.2098,0.476,-67.0789,1.024,4.7524,0.4404,5.5095,0.5498,0.9948,1.3942902729333333,3.520459822,4.379005471666667,0.45608860496666664,0.39523171856666667,1.3897,2.5408,0.504,2.7024,0.5301,0.9579,0.143,0.36,0.368,0.086,1.812,21.069767441860467,2.6061348586666666,3.5120668906666666,3.59204865,0.36516905273333333,0.40767421016666666,328,0.9718518518518519,1,0,0,1,FALSE,FALSE,FALSE
499,2021-11-13T08:38:22Z,2021-11-13T09:21:58Z,2616,1,2021-11-13T09:21:59Z,1,Chrome,95.0.4638.69,Windows NT 10.0,1280,1024,N/A,1.25,576,57,279,85,79,68,-0.5477871692652894,-0.2980192765845384,-0.7149365143607764,-0.23862632611725865,0.09744193443982496,-0.6313418526976985,2,3,3,2,2,1,1,2,1,2,3,2,2,2,2,3,1,1,2,2,0.6863327411532597,0,1,3,3,2,2.15,0,5,5,2,5,1,1,4,1,1,1,1,5,1,5,5,1,1,1,1,1,1,1,1,0,2,0,0,5,5,5,5,5,5,5,5,5,1,5,1,1,5,2,5,1,1,1,1,1,5,1,1,1,1,1,1,1,1,1,5,1,1,1,1,1,1,1,1,1,1.9521298140264163,1.9591057240729093,1,0,1,0,1.1333333333333333,0,1,0,1.0833333333333333,0,0.8333333333333334,0,0.8571428571428571,0,1,0,1.027027027027027,0,0,0,0,-1.3831634800546193,-1.4994586209182028,-0.7372407672780129,-1.118349694098108,3,1,3,1,1,1,1,1,1,0.9759000729485332,1.5714285714285714,0,1,-0.5612498234260587,4,4,4,3,3,3,3,6,6,NA,3,0.5345224838248488,3.4285714285714284,0,2.5714285714285716,3,3.8333333333333335,3.2559414990859232,-0.7395711320441822,0,-0.3058691320761303,1,2,3,2,2,3,4,2,2,3,1,3,2,3,4,4,4,1,3,4,1.0600988273786194,2,0,4,0,3.2,0,3.4,0,3.533333333333333,0,2,1,1,3,2,1,3,3,2,1,1,3,3,2,1,3,1,1,2,3,0.8870412083230169,1.75,0,Prefer not to say,0,21,3,5,NA,1,3,4,Student,7,0,140,70,3,5,2,0,0,1,0,0,TRUE,TRUE,TRUE,TRUE,TRUE,2,0.9625249999978326,0.88,0.08410022216009373,2,0.4527129032275369,0.5458482758618635,0.96875,0.90625,0.0018128077017237438,0.012101860635823468,2,0.543587096773809,0.6092566666642825,0.96875,0.9375,0.005858051361274707,0.00899798931435611,1.5534,1.4038,0.5638,1.2655,1.6965,0.6489,0.1859,1.536165994,1.2136303107333333,0.5550060816,1.1255,4.7922,0.3432,2.2084,0.3222,-61.1016,0.929,6.1835,0.3778,2.7759,0.402,0.983,1.2044757579,2.4591658144,4.8296364726666665,0.3173562973,0.337366776,0.9571,4.2486,0.4399,3.8141,0.4777,0.8466,0.056,0.398,0.343,0.016,1.406,87.875,1.3593418500333334,3.657272053,2.932116674,0.3670606817666667,0.39500319263333333,295,0.874074074074074,1,0,0,1,FALSE,FALSE,FALSE
500,2021-11-13T09:02:02Z,2021-11-13T09:22:40Z,1238,1,2021-11-13T09:22:41Z,1,Chrome,94.0.4606.81,Macintosh,1440,900,No everything worked fine.,1.6,627,55,318,64,48,81,-0.41674945136961294,-0.31618875321090295,-0.5271811881240909,-0.4945408633321733,-0.3307319143023651,-0.4117540848066085,4,3,1,2,4,1,1,3,1,4,3,1,1,1,4,4,1,1,1,3,1.3218806379747876,0,1,1,5,3,1.4,0,2,3,3,4,3,3,4,4,4,3,4,2,2,3,2,4,4,4,1,3,4,4,3,2,2,3,0,3,2,2,2,2,2,2,2,2,5,3,4,3,2,3,2,4,4,4,5,5,2,3,3,1,3,1,1,1,1,1,2,4,4,3,3,3,3,4,2,2,1.179784680309035,0.7988086367179802,3.375,0,2.75,0,3.2,0,3.888888888888889,0,4,0,2.3333333333333335,0,2.142857142857143,0,3,0,3.324324324324324,0,1,3,0,1.5230450167915015,1.396601622467703,0.6345597483182625,1.0155806853929827,4,2,2,2,2,1,1,1,2,1,2,0,1.5,-0.12035443057343476,4,3,4,4,2,2,2,1,3,3,3,1,3.2857142857142856,0,2.7142857142857144,7,3.8333333333333335,3.2559414990859232,1.5194825076544112,0,0.903328685194603,2,2,3,3,3,3,3,2,2,3,1,3,2,4,5,1,4,2,4,3,1.1464230084422218,2.6,0,3.8,0,3.8,0,4,0,3.8666666666666667,0,1,2,1,3,1,1,2,3,1,1,1,4,1,2,1,3,1,2,1,1,0.9333020044867296,1.35,0,"Hispanic of Latino (e.g., Mexican American, Central American, and others) & White, Caucasian, Anglo, European American",1,22,0,1,NA,1,3,4,Student,3,0,155,70,2,5,2,0,0,1,0,0,TRUE,TRUE,TRUE,TRUE,TRUE,5,0.8972794871697058,0.78,0.048861601104445415,5,0.4096451612903226,0.5300333333333334,0.96875,0.9375,0.0029323316022900796,0.00785692253371212,5,0.5511032258002989,0.6091275861920982,0.96875,0.90625,0.005784395117240318,0.009743193778444702,1.2638,1.3165,0.559,1.1693,1.2234,0.5961,0.485,1.3814765163333333,0.9675687516,0.5078051767,1.2878,3.8132,0.2515,2.9459,0.3308,-56.645,0.7166,4.6401,0.3396,3.4126,0.4496,0.9851,1.3718640401,3.1371435946666666,4.055298982,0.3252538744,0.2479873556,0.8162,7.4482,0.5002,4.5644,0.5099,0.9649,0.059,0.38,0.328,0.023,2.058,89.4782608695652,1.3425934135,3.3089284903333334,2.5419805475333335,0.3598318614666667,0.37096462376666667,434,1.285925925925926,1,0,0,1,FALSE,FALSE,FALSE
501,2021-11-13T09:00:15Z,2021-11-13T09:27:10Z,1614,1,2021-11-13T09:27:12Z,0.8999999761581421,Chrome,95.0.4638.69,Macintosh,1920,1080,Cheers!,1.7777777777777777,745,117,460,101,46,59,-0.11356414329726369,0.2470650222063974,0.15644076894281556,-0.04364382157256178,-0.3583560335760547,-0.7833641535453761,3,2,1,3,2,2,3,2,1,2,3,2,2,4,3,2,2,4,2,3,0.8207826816681233,0,1,2,4,5,2.5,0,5,5,1,4,1,1,4,3,1,1,3,2,3,3,3,2,3,1,1,1,2,2,2,0,2,0,0,5,2,2,5,3,4,4,5,4,2,4,2,1,3,4,5,4,4,3,4,5,3,1,1,1,3,5,1,1,1,1,5,2,3,1,1,1,3,2,3,3,1.5304712811230214,1.4474937289114918,1.75,0,2.75,0,2,0,2.2222222222222223,0,2.9166666666666665,0,2.1666666666666665,0,1.2857142857142858,0,1,0,2.2162162162162162,0,0,0,0,-0.1769713779651954,-0.2936460306938916,-0.18843234825732513,-0.24103918947560837,5,2,2,2,2,2,3,2,3,1.1338934190276817,2.2857142857142856,0,2.5,0.41956761451123586,5,5,4,5,3,3,1,3,3,4,3,1.4960264830861913,4.285714285714286,0,1.7142857142857142,6,3.8333333333333335,3.2559414990859232,0.9547190977297628,0,0.06324999828222155,2,2,4,4,4,3,4,2,3,4,1,4,5,4,4,1,4,3,4,4,1.1751393027860062,3.2,0,3.8,0,3.6,0,3.4,0,3.6,0,2,1,2,3,3,2,2,2,3,2,3,3,3,2,2,3,1,2,2,3,0.6569466853317864,2.2,0,"Hispanic of Latino (e.g., Mexican American, Central American, and others) & White, Caucasian, Anglo, European American",1,23,0,1,NA,1,3,3,N/A Student,5,0,220,72,2,5,2,0,0,1,0,0,TRUE,TRUE,TRUE,TRUE,TRUE,6,0.9005675675675613,0.7551020408163265,0.14784585147109253,6,0.5587700000000012,0.638296875,1,1,0.003940589068965195,0.0032384816028226343,6,0.7163374999999979,0.777158064516126,1,1,0.006911576612905116,0.0067310491827958195,1.3999,0.8149,0.523,1.2091,0.8374,0.5919,0.2426,1.4377195976666666,0.8487727959333333,0.5128769456666666,10,11.1799,0.1115,11.2595,0.1942,-88.035,0.769,5.8343,0.4908,5.2644,0.5724,0.786,2.248972987666667,5.081388765333333,5.771296000333333,0.4226202199333333,0.36845392946666666,0.8818,4.3841,0.6243,4.5225,0.6776,0.6092,0.085,0.56,0.551,0.016,1.288,80.5,2.809479437333333,5.046054858333333,5.368413578,0.44247244016666665,0.5241894561333333,105,0.3111111111111111,1,0,1,2,FALSE,FALSE,FALSE
502,2021-11-13T08:48:47Z,2021-11-13T09:27:28Z,2321,1,2021-11-13T09:27:29Z,1,Chrome,95.0.4638.69,Windows NT 10.0,1920,1080,nope,1.7777777777777777,712,62,529,112,47,97,-0.198353254876819,-0.2525955850186271,0.48862326920772076,0.09040665030191732,-0.34454397393920994,-0.14149221663295936,4,4,1,2,4,1,1,4,1,4,3,1,1,1,4,4,1,1,4,4,1.4689774459950382,0,1,2,2,1,1.1,0,4,4,2,3,3,1,4,1,1,1,1,5,1,5,3,1,1,5,1,1,1,1,1,4,1,0,1,4,3,3,1,1,5,3,4,4,5,5,1,1,3,1,5,2,1,1,1,1,3,1,1,1,3,1,1,3,1,1,3,2,3,1,1,1,1,1,1,1,1.436336681653387,1.5491933384829668,1.5,0,1,0,1.6666666666666667,0,2.888888888888889,0,1.5833333333333333,0,1.5,0,1.8571428571428572,0,1,0,1.945945945945946,0,2,0,1,-0.5005838931599188,-0.6604809734575887,-0.1546061727857994,-0.4075435731216941,3,2,2,1,1,2,1,1,1,0.7559289460184544,2,0,1,-0.3048482679606258,5,5,5,5,3,3,2,4,5,2,3,1.2909944487358056,4.285714285714286,0,1.7142857142857142,4.5,3.8333333333333335,3.2559414990859232,0.10757398284279028,0,-0.3603225591612647,2,1,2,2,2,1,2,1,1,1,1,5,3,4,3,5,4,1,4,4,1.5886502207249789,1.8,0,4.8,0,2.2,0,3.8,0,3.6,0,1,1,1,4,1,1,1,3,1,1,2,3,1,1,1,3,1,1,1,2,0.9445132413883326,1.25,0,"White, Caucasian, Anglo, European American",0,22,0,1,NA,1,4,3,unemployed,4,0,315,72,2,5,2,0,0,1,0,0,TRUE,TRUE,TRUE,TRUE,TRUE,6,0.6649156250003725,0.64,0.01940194653075701,6,0.46866250000102444,0.5643516129026971,1,0.96875,0.0024258224193531874,0.004734491522176696,6,0.6798593749990687,0.7594419354837267,1,0.96875,0.011769056683695546,0.022941033699509537,1.1499,0.5408,0.403,0.6839,0.3957,0.5884,0.2747,1.2100866765,0.7037847963196666,0.39573969923333335,1.2501,5.5839,0.3567,4.3743,0.428,-90.7336,0.9414,7.5328,0.4029,4.4638,0.4588,0.943,1.3700709267333333,4.326220478333333,5.533203382666667,0.4159089058666667,0.3484889114,1.0249,3.0415,0.5333,2.3818,0.6075,0.9387,0.074,0.488,0.382,0.01,1.259,125.89999999999999,2.224427567,4.142768998666667,2.8227590586666667,0.4114781013666667,0.3779487284,310,0.9185185185185185,1,0,0,1,FALSE,FALSE,FALSE
503,2021-11-13T09:09:52Z,2021-11-13T09:29:58Z,1205,1,2021-11-13T09:29:59Z,1,Chrome,95.0.4638.69,Macintosh,1440,900,No,1.6,614,59,285,73,50,76,-0.4501512225979226,-0.2798497999581739,-0.6860510795551324,-0.38486320452578127,-0.3031077950286754,-0.4962109186108739,3,4,1,1,3,1,4,3,2,3,3,2,1,1,3,3,3,1,3,3,1.0462967275611939,0,1,1,3,4,1.8,0,5,5,2,5,1,1,4,2,1,1,1,5,2,5,3,1,2,1,1,1,1,1,1,3,2,0,0,5,5,5,5,5,5,5,5,5,1,5,1,1,5,2,5,5,1,1,2,1,5,1,1,1,3,1,1,2,2,2,3,4,1,1,1,1,2,1,2,2,1.8335380721059111,1.7674302033770737,1.125,0,1.75,0,1.4,0,1,0,1.5,0,1.1666666666666667,0,2,0,1,0,1.4324324324324325,0,2,0,0,-1.0532468249535052,-1.1569180239681438,-0.0958522115332568,-0.6263851177507003,5,2,2,1,1,2,1,1,1,1.4142135623730951,1.7142857142857142,0,1,-0.4757826382709144,5,5,5,5,4,4,2,6,6,6,4,1.1126972805283737,4.571428571428571,0,1.4285714285714286,3,3.8333333333333335,3.2559414990859232,-0.7395711320441822,0,-0.9432371114476243,2,1,1,2,1,1,1,1,1,5,5,5,2,4,5,1,5,2,2,4,1.791514389985135,1.4,0,4,0,3.4,0,4.2,0,3.8666666666666667,0,1,1,1,4,1,2,1,3,2,2,1,4,1,1,1,4,1,2,1,1,1.118033988749895,1.25,0,"White, Caucasian, Anglo, European American",0,18,0,1,NA,1,4,3,Student,6,0,190,73,3,5,2,0,0,1,0,0,TRUE,TRUE,TRUE,TRUE,TRUE,2,0.9962428571428571,0.7142857142857143,0.057728816514386626,2,0.43207812500279397,0.49019642857355733,1,0.9333333333333333,0.0010961585383521082,0.003864193516779168,2,0.6113999999975785,0.6787366666644812,1,0.967741935483871,0.00726894516120803,0.006669373333502807,1.2674,0.7644,0.6437,1.1099,0.8355,0.7187,0.2027,1.3310676233333334,0.8280572083733333,0.6308841899,1.4582,6.1544,0.3136,3.5253,0.3079,-78.0375,0.5044,7.2167,0.4023,4.637,0.451,0.9688,1.4314621418333333,3.5213793443333334,5.689257305333333,0.3089220294666667,0.31063875956666664,1.094,3.8476,0.4811,4.7867,0.5607,0.9651,0.065,0.466,0.489,0.019,1.819,95.73684210526316,1.7846247483333333,4.493620780666666,3.7530468586666665,0.4148217497666667,0.45414691786666667,430,1.2740740740740741,1,0,0,1,FALSE,FALSE,FALSE
504,2021-11-13T09:08:31Z,2021-11-13T09:35:40Z,1629,1,2021-11-13T09:35:42Z,1,Firefox,94.0,Windows NT 10.0,1536,864,No feedback,1.7777777777777777,711,117,411,163,88,72,-0.2009226218943813,0.2470650222063974,-0.0794569486366099,0.7119133835381386,0.22175047117142851,-0.5637763856542862,4,3,3,2,4,1,1,3,2,4,3,2,3,2,4,3,1,1,3,4,1.0894228312566052,0,0,3,4,3,1.65,0,5,5,5,4,5,5,3,3,5,3,1,4,2,4,4,5,5,1,1,1,5,5,3,7,2,0,0,5,2,5,5,5,5,5,5,5,4,4,4,3,5,4,4,3,5,4,3,5,4,1,1,1,5,1,1,5,5,5,5,1,3,3,1,1,3,4,4,4,1.5891902106184537,1.245945806357946,3.25,0,3.75,0,2.8,0,1.3333333333333333,0,3.3333333333333335,0,1.6666666666666667,0,2.857142857142857,0,1.6666666666666667,0,2.4054054054054053,0,4,0,0,0.8737186064332574,0.7760795068851004,0.9375423577977049,0.8568109323414026,3,3,2,2,2,2,2,1,1,0.4879500364742666,2.5714285714285716,0,1,0.03702047265995151,4,5,5,5,1,1,1,3,3,NA,3,2.0354009783964297,3.7142857142857144,0,2.2857142857142856,6,3.8333333333333335,3.2559414990859232,0.9547190977297628,0,0.3819339879679685,5,5,5,5,5,4,2,3,4,3,3,4,4,4,3,3,3,3,2,2,0.7432233529572065,5,0,3,0,2.4,0,3.2,0,2.8666666666666667,0,3,1,3,2,2,2,2,2,2,2,2,3,1,3,1,4,1,1,3,1,0.8870412083230169,1.95,0,Black or African American,0,21,0,1,NA,1,3,3,None,6,0,221,65,1,5,2,0,1,0,0,1,TRUE,TRUE,TRUE,TRUE,TRUE,1,0.9535277777777778,0.72,0.058849375102040816,1,0.5139375,0.6827741935483871,1,1,0.0028992862903225816,0.016562380645161287,1,0.812875,0.92921875,1,1,0.026249725806451612,0.03549572479838709,1.3676,0.7151,0.5421,1.1688,0.7083,0.6481,0.29,1.4141781356666667,0.7869229185666666,0.5312249222333333,4.2224,8.617,0.2689,5.4281,0.2938,-72.4027,0.9403,7.0659,0.4524,2.6101,0.5422,0.9351,2.098858869,3.8262729183333333,5.818843657666666,0.4081293271,0.33808963406666664,1.3424,2.624,0.5911,2.7548,0.708,0.9905,0.267,0.224,0.456,0.018,2.041,113.3888888888889,3.096591789666667,3.717815482333333,3.1912568583333334,0.3938205944666667,0.44239688986666664,103,0.30518518518518517,1,0,2,3,FALSE,FALSE,FALSE
505,2021-11-13T09:16:35Z,2021-11-13T09:40:44Z,1448,1,2021-11-13T09:40:45Z,1,Opera,80.0.4170.63,Windows NT 10.0,1280,720,No feedback.,1.7777777777777777,811,64,287,74,39,113,0.056014079861846915,-0.23442610839226255,-0.6764226012865845,-0.37267679799173775,-0.4550404510339686,0.12876965154068984,4,4,1,1,4,1,1,3,1,4,2,1,1,1,4,4,1,1,4,3,1.4179302929937965,0,1,1,5,4,1.2,0,5,5,1,5,1,1,5,1,1,1,1,5,1,5,5,1,1,1,1,1,1,1,1,3,2,0,0,5,4,5,5,5,5,5,5,5,4,5,1,1,5,1,5,1,1,1,1,1,5,1,1,1,4,1,1,2,2,1,5,2,1,1,1,1,1,1,1,1,1.8804350656260471,2.065591117977289,1,0,1,0,1,0,1.1111111111111112,0,1.25,0,1.3333333333333333,0,1.2857142857142858,0,1,0,1.2702702702702702,0,2,0,0,-1.231864122301242,-1.452224992404038,-0.33105581968498016,-0.8916404060445091,5,1,4,1,1,1,1,1,1,1.7320508075688772,1.1428571428571428,0,1,-0.8176513788914915,5,5,5,5,2,2,2,6,6,4,4,1.6035674514745464,4,0,2,3,3.8333333333333335,3.2559414990859232,-0.7395711320441822,0,-0.6245531217618774,2,1,1,1,1,2,4,2,2,4,1,5,1,3,4,1,5,1,4,3,1.4735767952260144,1.2,0,4.8,0,4.4,0,3.6,0,4.266666666666667,0,1,1,1,4,1,1,1,4,2,1,1,3,1,1,1,4,1,1,1,1,1.142481141154959,1.1,0,"White, Caucasian, Anglo, European American",0,29,0,1,NA,1,2,7,Online Map Quality Analyst,2,0,120,65,4,5,2,0,0,1,0,0,TRUE,TRUE,TRUE,TRUE,TRUE,6,0.8501955555412505,0.9,0.015538138061335579,6,0.43018387095389826,0.5031593750044704,0.96875,1,0.0035260044756003544,0.005546128298352062,6,0.6110312499925494,0.6465428571445602,1,0.875,0.010727535122936638,0.01309921603644578,1.2808,1.9308,0.5884,0.7492,2.3207,0.7497,0.2517,1.2873892027,1.4595622703333333,0.5790956281666667,1.7545,4.751,0.2529,4.4336,0.3053,-69.521,0.822,5.26,0.3511,5.3694,0.4275,0.9027,1.6687143781333333,4.215334868666667,4.580333749333334,0.30707759403333335,0.25492594983333333,0.9047,3.4128,0.5057,2.9532,0.5108,0.9918,0.054,0.441,0.327,0.018,1.578,87.66666666666667,1.6252539763333334,3.0343086662666665,2.203016457,0.3347229035666667,0.331429399,416,1.2325925925925925,1,0,0,1,FALSE,FALSE,FALSE
506,2021-11-13T09:25:32Z,2021-11-13T09:43:51Z,1099,1,2021-11-13T09:43:51Z,1,Chrome,95.0.4638.69,Windows NT 10.0,2560,1440,NA,1.7777777777777777,622,45,266,42,35,56,-0.42959628645742437,-0.40703613634272556,-0.7775216231063383,-0.7626418070811315,-0.510288689581348,-0.8340382538279354,3,3,2,2,2,1,2,2,1,3,2,2,2,2,2,2,2,1,2,2,0.5619514869490163,0,1,2,3,3,2.2,0,4,4,2,4,2,4,4,2,2,2,2,4,2,4,3,2,1,1,1,2,1,1,1,0,2,1,1,4,3,5,4,3,4,4,4,4,2,4,5,2,4,4,4,3,3,5,5,4,4,3,1,1,3,2,2,1,1,1,4,2,2,1,1,1,2,2,2,2,1.3639502778182058,1,1.25,0,2,0,2.2,0,2.111111111111111,0,3.25,0,1.8333333333333333,0,1.4285714285714286,0,1,0,2.27027027027027,0,0,1,1,-0.45435353384638705,-0.39934095351657173,-0.04055310191684401,-0.21994702771670788,4,2,4,2,2,2,2,3,2,0.9759000729485332,2,0,2.5,0.24863324420094737,5,5,5,5,3,3,2,5,6,NA,3,1.2909944487358056,4.285714285714286,0,1.7142857142857142,3.5,3.8333333333333335,3.2559414990859232,-0.4571894270818581,0,-0.6427042641235889,3,3,2,3,2,3,2,3,2,2,4,2,3,2,3,2,2,3,2,3,0.6399404734221844,2.6,0,2.4,0,2.6,0,3,0,2.6666666666666665,0,1,2,1,2,2,2,2,2,2,2,2,2,2,2,2,2,2,2,2,2,0.30779350562554625,2.1,0,"Asian or Asian American (e.g., Chinese, Japanese, and others)",0,19,0,1,NA,1,4,4,Student,6,0,120,70,2,5,2,0,0,0,0,0,TRUE,TRUE,TRUE,TRUE,TRUE,4,0.6791538461507896,0.78,0.04414924262910702,4,0.39057499999925493,0.43448709677496267,1,0.96875,0.0029764645163384176,0.002913049959994747,4,0.5683906249906868,0.6186699999948343,1,0.9375,0.0039951363609970515,0.003920888871169032,1.1509,1.1519,0.4574,0.9677,0.9654,0.5053,0.0376,1.2060230898333333,1.0660165519666667,0.44882949683333334,1.0629,5.9913,0.3019,4.0393,0.3079,-97.1417,0.8395,6.6527,0.3172,5.1777,0.3562,0.7969,1.1209330040333334,4.090519327333333,5.680167295666666,0.3042046700666667,0.29613522653333335,0.9077,5.479,0.4834,4.4028,0.5172,0.962,0.056,0.452,0.518,0.026,1.868,71.84615384615385,1.2515063145,4.835800070666667,3.533563154,0.44240862433333333,0.4582025843,374,1.108148148148148,1,0,2,3,FALSE,FALSE,FALSE
507,2021-11-13T09:21:12Z,2021-11-13T09:53:10Z,1917,1,2021-11-13T09:53:10Z,1,Chrome,95.0.4638.69,Windows NT 10.0,1366,768,Thank you for the opportunity to do this survey,1.7786458333333333,746,159,499,137,81,185,-0.11099477627970142,0.6286240313600524,0.3441960951795011,0.39506681365300617,0.12506605371351465,1.3449480583221112,3,4,2,1,3,2,1,3,1,3,2,2,1,1,3,3,1,1,2,3,0.9679060415469871,0,1,1,5,5,1.7,0,4,4,3,4,2,2,3,2,2,2,2,5,2,4,3,2,2,1,1,2,1,1,2,1,2,0,0,4,4,4,5,4,4,5,5,4,2,4,2,2,5,2,5,3,1,2,2,3,5,1,1,1,2,1,1,2,1,1,4,2,2,1,2,3,2,1,2,2,1.4606962838433024,1.0327955589886444,1.5,0,1.75,0,2.1333333333333333,0,1.6666666666666667,0,1.9166666666666667,0,1,0,1.4285714285714286,0,2,0,1.6756756756756757,0,1,0,0,-0.6686942906636716,-0.5760798995552289,-0.2989446853297732,-0.437512292442501,4,3,5,2,3,5,5,1,1,1.2149857925879117,3,0,1,0.2934220281253842,4,3,5,4,2,1,3,5,7,3,2,1.3451854182690985,3.142857142857143,0,2.857142857142857,3,3.8333333333333335,3.2559414990859232,-0.7395711320441822,0,-0.14652713723325692,1,1,2,3,2,1,5,2,2,5,1,5,2,5,5,1,5,1,4,3,1.7674302033770737,1.8,0,5,0,4.6,0,4.2,0,4.6,0,1,2,1,3,2,1,2,4,1,2,1,3,2,1,1,3,1,2,1,1,0.910465468000326,1.45,0,"White, Caucasian, Anglo, European American",0,20,0,1,NA,1,3,4,Civil engineering student,3,0,117,68,2,5,2,0,0,1,0,0,TRUE,TRUE,TRUE,TRUE,TRUE,1,0.9511243243217469,0.74,0.09389765108598215,1,0.46648064516292465,0.5487437499985098,0.96875,1,0.0022780154435526733,0.0021434283467823274,1,0.6051468750000931,0.6730517241384448,1,0.90625,0.008534532247787763,0.01798947990925265,1.5364,0.7144,0.4772,1.3544,0.5566,0.5886,0.231,1.5461989,0.7693037728,0.4703260726333333,1.3475,5.3108,0.3456,4.9453,0.4125,-89.7435,0.7711,6.0511,0.4055,6.5835,0.4935,0.9932,1.4241331097666667,4.798414091333333,5.145569147333333,0.40492146813333335,0.3370023622666667,0.9174,5.7759,0.5248,2.2449,0.5294,0.9478,0.068,0.405,0.327,0.026,2.059,79.19230769230771,1.5877656093333334,3.5042349826666666,2.377193012333333,0.3741941338,0.37488252946666667,342,1.0133333333333332,1,0,0,1,FALSE,FALSE,FALSE
508,2021-11-13T09:39:12Z,2021-11-13T09:56:01Z,1009,1,2021-11-13T09:56:03Z,1,Chrome,95.0.4638.69,Windows NT 10.0,1920,1080,Excellent format and interesting gameplay!,1.7777777777777777,584,27,206,43,42,66,-0.5272322331247911,-0.5705614259800063,-1.0663759711627776,-0.7504554005470879,-0.4136042721234341,-0.6651245862194046,4,4,1,1,4,1,1,4,1,4,4,1,1,1,4,4,1,1,4,4,1.538967528127731,0,1,1,4,5,1,0,5,4,4,3,2,2,2,1,1,1,1,4,1,4,4,2,2,1,1,1,1,1,1,3,2,0,0,5,5,5,5,4,5,5,5,5,2,4,1,1,1,1,5,1,1,1,1,1,5,1,1,1,1,1,1,3,3,3,5,1,1,2,1,1,3,3,3,3,1.8034001919297482,1.4540583599999397,1.25,0,3,0,1.9333333333333333,0,1.1111111111111112,0,1.5,0,0.8333333333333334,0,1.7142857142857142,0,1.3333333333333333,0,1.3783783783783783,0,2,0,0,-1.0091178456087704,-0.8972298573626029,0.2961538020529488,-0.30053802765482707,4,2,3,1,1,3,2,1,1,1.1126972805283737,2,0,1,-0.3048482679606258,3,2,4,3,1,1,3,7,7,4,2,1.1338934190276817,2.4285714285714284,0,3.5714285714285716,2,3.8333333333333335,3.2559414990859232,-1.3043345419688306,0,-0.030553855088397364,1,1,1,2,1,1,4,4,1,2,1,5,1,3,4,4,5,1,4,4,1.5796322658258457,1.2,0,5,0,3.4,0,3.2,0,3.8666666666666667,0,1,1,1,4,1,1,1,4,1,1,1,4,1,1,1,4,1,1,1,1,1.231174022502185,1,0,"White, Caucasian, Anglo, European American",0,23,0,1,NA,1,4,6,Healthcare Management Specialist,6,0,160,69,4,5,2,0,0,1,0,0,TRUE,TRUE,TRUE,TRUE,TRUE,4,0.6713294117617257,0.68,0.01743479928559115,4,0.5165874999975786,0.6235612903237343,1,1,0.00667326177387362,0.005815961117579267,4,0.7445281249983237,0.8002406249949708,1,1,0.03011340982812141,0.026871134103419354,1.0659,0.7419,0.4085,0.6933,1.2912,0.5531,0.2962,1.1294951716333332,0.8330988282133334,0.40122598996666664,3.1423,6.5996,0.2785,6.2886,0.3737,-76.9243,0.9077,6.0448,0.4405,4.3196,0.5308,0.8776,1.9651991336666668,4.639865181666667,5.182028573,0.4161168005,0.32944194086666667,1.6159,4.4979,0.5626,3.9584,0.5829,0.9605,0.217,0.279,0.46,0.043,1.718,39.95348837209303,2.8119549673333335,3.439797011,3.5650728856666665,0.3309644633666667,0.4069174805333333,292,0.8651851851851852,1,0,0,1,FALSE,FALSE,FALSE
510,2021-11-13T09:33:16Z,2021-11-13T09:58:45Z,1528,1,2021-11-13T09:58:46Z,1,Chrome,95.0.4638.69,Windows NT 10.0,1920,1080,no,1.7777777777777777,708,88,436,90,40,89,-0.20863072294706814,-0.016392388875888245,0.040899029720239816,-0.17769429344704088,-0.4412283913971238,-0.27662315071978394,2,2,3,1,1,4,3,1,2,2,1,3,2,2,1,1,2,1,2,1,0.8750939799154206,0,0,1,2,1,2.95,0,1,5,3,4,3,4,2,4,3,3,4,1,3,1,1,5,5,1,1,5,5,5,5,0,2,0,0,1,1,1,1,1,1,1,1,1,1,5,5,1,3,3,1,5,5,5,5,5,1,1,1,1,2,2,1,1,5,5,3,3,3,1,1,3,1,1,1,1,1.6868151485403922,1.3201731488169053,4,0,1,0,3.6,0,5,0,3.6666666666666665,0,1.8333333333333333,0,2.857142857142857,0,1.6666666666666667,0,3.4324324324324325,0,0,0,0,1.97904447002043,1.883553231186479,-0.7372407672780129,0.5731562319542332,5,1,5,2,1,1,1,1,1,1.889822365046136,1.1428571428571428,0,1,-0.8176513788914915,5,5,5,5,3,3,1,4,6,5,3,1.5735915849388864,4.428571428571429,0,1.5714285714285714,4,3.8333333333333335,3.2559414990859232,-0.1748077221195339,0,-0.5811844090638635,5,5,5,5,5,5,3,5,5,1,5,3,5,3,1,5,3,3,1,3,1.5491933384829668,5,0,2.2,0,1.4,0,1.8,0,1.8,0,4,4,4,1,4,4,4,1,4,3,4,1,4,4,3,1,4,4,4,4,1.2182817926554552,3.9,0,"Hispanic of Latino (e.g., Mexican American, Central American, and others)",0,20,0,1,NA,1,2,3,Crew Worker,1,0,115,67,2,5,2,0,0,1,0,0,TRUE,TRUE,TRUE,TRUE,TRUE,2,1.053394444445769,0.72,0.09313455255738762,2,0.4827499999925494,0.5335187499970198,1,1,0.004285652257516461,0.003479588668757522,2,0.6175874999910593,0.6929312500059605,1,1,0.005068270163142681,0.007151191894876032,1.4219,0.6729,0.6635,1.2385,0.4684,0.7808,0.3348,1.4740042426666666,0.7483290282586667,0.6472333943666667,1.2323,5.2416,0.3652,5.5074,0.4216,-98.4661,0.8559,4.6867,0.3918,6.011,0.4592,0.9973,1.4126875448,5.299422857333333,5.267505586,0.40668723716666666,0.35175238243333334,1.0159,5.847,0.5349,6.8215,0.6098,0.9875,0.19,0.368,0.774,0.008,1.054,131.75,2.459969541,5.290136203333334,5.034612288333333,0.3905723526,0.45678906033333333,312,0.9244444444444444,1,0,1,2,FALSE,FALSE,FALSE
512,2021-11-13T09:34:18Z,2021-11-13T09:59:30Z,1511,1,2021-11-13T09:59:30Z,1,Firefox,94.0,Windows NT 10.0,1920,1080,NA,1.7777777777777777,698,49,407,132,72,89,-0.23432439312269096,-0.3706971830899965,-0.09871390517370586,0.33413478098278837,7.57516981911087e-4,-0.27662315071978394,4,3,1,1,4,1,1,2,1,2,4,1,1,1,3,2,1,1,1,2,1.1367080817685316,0,1,1,5,4,1.65,0,4,5,1,4,1,1,3,2,2,1,2,4,1,4,2,2,3,4,1,1,1,2,2,1,2,0,0,2,2,3,3,3,3,4,3,2,5,2,3,3,2,4,4,4,4,3,3,4,2,1,1,2,1,1,1,1,4,2,4,2,1,3,2,1,1,3,2,2,1.1435942496391838,1.4074631010979937,2,0,2,0,1.8,0,3.2222222222222223,0,3.5833333333333335,0,1.5,0,1.7142857142857142,0,2,0,2.72972972972973,0,1,0,0,0.29794049498290537,-0.051476894336432474,-0.22054348261253207,-0.13601018847448226,2,3,3,3,2,4,3,3,2,0.6900655593423543,3.142857142857143,0,2.5,0.9323707254421016,3,4,4,4,2,2,2,3,6,2,2,1,3.2857142857142856,0,2.7142857142857144,4.5,3.8333333333333335,3.2559414990859232,0.10757398284279028,0,0.19737442278879264,1,1,1,1,1,1,5,3,1,5,2,5,1,5,4,1,5,2,1,2,1.7674302033770737,1,0,4.6,0,4.2,0,4.2,0,4.333333333333333,0,1,1,1,1,1,1,1,3,1,1,1,1,1,1,2,1,1,1,2,1,0.5231483637805969,1.6,0,Black or African American,0,23,0,1,NA,1,2,4,Resturant,1,0,140,76,2,5,2,0,0,1,0,0,TRUE,TRUE,TRUE,TRUE,TRUE,4,0.7378648648648649,0.74,0.05050151020408165,4,0.4848125,0.5414666666666667,1,0.967741935483871,0.0041824153225806454,0.0052121311827957,4,0.57665625,0.6194375,1,1,0.002933007056451613,0.002982705645161292,1.2818,0.8627,0.3904,1.0446,0.8546,0.4878,0.1965,NA,NA,NA,1.2367,4.7729,0.3553,4.1442,0.3997,-80.8469,0.8475,5.8487,0.407,4.691,0.4484,0.8987,NA,NA,NA,NA,NA,0.8149,5.892,0.5073,5.3725,0.5476,0.9948,0.082,0.464,0.739,0.037,1.769,47.810810810810814,NA,NA,NA,NA,NA,317,0.9392592592592592,1,1,1,2,FALSE,FALSE,FALSE
513,2021-11-13T09:15:49Z,2021-11-13T09:59:36Z,2626,1,2021-11-13T09:59:37Z,1,Chrome,95.0.4638.69,Windows NT 10.0,1536,864,NA,1.7777777777777777,788,79,450,99,65,110,-0.0030813615420855725,-0.09815503369452862,0.10829837760007566,-0.06801663464064889,-0.09592690047600279,0.07809555125813061,2,2,3,1,2,1,1,3,1,2,1,3,2,1,2,2,2,1,1,2,0.7163503994113789,0,0,2,4,3,2.35,0,3,4,3,4,4,4,4,2,3,1,3,2,1,4,4,1,3,1,1,1,2,2,1,0,2,NA,NA,5,5,4,5,5,5,5,5,4,3,5,3,5,4,2,5,3,3,4,5,5,5,1,1,1,4,2,1,1,2,1,4,5,3,3,1,1,2,1,1,1,1.5891902106184537,1.0997835284835873,1.5,0,1.25,0,2.533333333333333,0,1.2222222222222223,0,3.0833333333333335,0,1.5,0,2,0,1.6666666666666667,0,2.108108108108108,0,0,NA,NA,-0.39971765465766756,-0.2183432376938503,-0.8521929756973453,-0.5352681066955978,5,2,3,1,1,2,3,1,8,1.3972762620115438,1.8571428571428572,0,4.5,0.9011414085945675,5,5,5,5,3,2,2,8,7,NA,4,1.4638501094227998,4.142857142857143,0,1.8571428571428572,1.5,3.8333333333333335,3.2559414990859232,-1.5867162469311549,0,-1.1277966766268004,1,2,2,1,2,1,4,2,2,2,3,4,2,4,4,2,5,2,3,4,1.162919151265879,1.6,0,4.2,0,3.4,0,3.6,0,3.7333333333333334,0,2,1,2,1,2,1,2,2,3,1,2,2,3,1,1,2,1,3,3,2,0.7451598203705946,2.15,0,"White, Caucasian, Anglo, European American",0,25,0,1,NA,0,4,4,Student,7,0,154,72,3,5,2,1,1,1,0,2,TRUE,TRUE,TRUE,TRUE,TRUE,2,0.9102837209320346,0.8775510204081632,0.17149172290908515,2,0.5224781250022351,0.5494000000001923,1,1,0.0039007604737379717,0.007124435333486081,2,0.605534375003539,0.6440451612905148,1,0.96875,0.014376632650777006,0.009245655150776634,1.7437,1.2609,0.4503,0.8057,2.1592,0.7672,0.3043,1.66538617,1.1164268306666667,0.44812984413333334,1.9002,6.0606,0.3657,5.2575,0.36870000000000003,-84.0095,0.9233,5.3937,0.4353,4.5892,0.4441,0.9353,1.7117025234333334,4.729890646333334,5.358082617,0.3728701073,0.3661109495666667,0.9618,2.516,0.462,3.576,0.5344,0.9007,0.072,0.413,0.4,0.018,1.629,90.5,1.9488540163333334,3.9253011993333335,3.30395583,0.35616508816666664,0.3615097952,406,1.202962962962963,1,0,0,1,FALSE,FALSE,FALSE
514,2021-11-13T09:41:31Z,2021-11-13T10:04:20Z,1368,1,2021-11-13T10:04:22Z,1,Firefox,94.0,Windows NT 10.0,2560,1440,NA,1.7777777777777777,641,80,363,101,61,81,-0.380778313123741,-0.08907029538134635,-0.3105404270817614,-0.04364382157256178,-0.15117513902338214,-0.4117540848066085,3,4,2,2,3,2,2,1,1,3,1,1,1,2,2,2,2,2,2,3,0.8255779474818965,0,1,1,2,2,2.15,0,5,4,1,3,2,1,5,2,2,1,1,5,2,5,3,1,1,1,1,2,2,2,2,2,2,0,0,3,5,5,4,4,5,3,5,5,2,5,1,1,4,1,5,2,1,1,1,1,5,1,1,1,3,1,1,2,2,2,4,2,3,1,1,1,1,1,1,2,1.6251588048991217,1.61245154965971,1.5,0,1.25,0,1.6,0,1.6666666666666667,0,1.25,0,1.1666666666666667,0,1.8571428571428572,0,1,0,1.4864864864864864,0,1,0,0,-0.7863715689162981,-0.8865829329024428,-0.4557470907642554,-0.6711650118333491,4,2,4,1,1,2,2,1,1,1.2535663410560174,1.7142857142857142,0,1,-0.4757826382709144,5,5,5,5,3,2,1,6,8,5,4,1.7043362064926932,4.285714285714286,0,1.7142857142857142,2,3.8333333333333335,3.2559414990859232,-1.3043345419688306,0,-1.0662768215670753,2,2,3,2,2,3,5,2,2,3,2,3,3,4,5,2,4,3,4,2,1.0600988273786194,2.2,0,3.4,0,3.8,0,4.2,0,3.8,0,1,2,3,2,2,3,3,1,4,1,2,2,2,3,1,2,1,2,2,3,0.8522416262267903,2.4,0,"White, Caucasian, Anglo, European American",0,24,0,1,NA,1,4,6,unemployed,5,0,180,72,2,5,2,0,0,1,0,0,TRUE,TRUE,TRUE,TRUE,TRUE,6,0.7247837837837838,0.74,0.028265520000000002,6,0.45934375,0.5147419354838709,1,0.96875,0.0018985554435483865,0.0033792862903225802,6,0.6305625,0.7022903225806452,1,0.96875,0.00434528629032258,0.004298447580645161,1.1569,0.9825,0.4709,0.8602,0.9278,0.5704,0.137,1.2148347278666667,0.9663956237333333,0.4630860632666667,1.7364,5.49,0.3012,4.9736,0.3498,-81.3405,0.7906,7.5548,0.4147,5.4202,0.4449,0.7525,1.6398967227333334,4.606383942,5.098620787,0.3501451336333333,0.3007188323666667,0.9763,5.6853,0.5425,4.9218,0.6073,0.7251,0.08,0.495,0.642,0.02,1.929,96.45,2.049919382666667,5.614153617333334,3.7012757493333335,0.45398547423333335,0.4387581524,366,1.0844444444444443,1,0,0,1,FALSE,FALSE,FALSE
515,2021-11-13T09:41:35Z,2021-11-13T10:06:17Z,1481,1,2021-11-13T10:06:18Z,0.8999999761581421,Chrome,95.0.4638.69,Windows NT 10.0,1536,864,NA,1.7777777777777777,816,66,324,95,54,79,0.06886091494965832,-0.21625663176589804,-0.49829575331844694,-0.11676226077682311,-0.24785955648129604,-0.4455368183283147,1,3,4,4,1,1,2,1,1,2,2,4,2,3,1,1,2,1,1,1,1.1192102478745307,0,1,1,4,4,3,0,5,4,4,4,3,2,3,3,5,2,5,1,3,1,2,4,4,1,1,1,3,5,3,5,2,0,0,2,4,1,1,2,1,4,3,3,2,3,5,5,2,5,5,5,5,3,5,5,1,1,5,3,5,5,1,3,4,4,5,1,1,1,3,1,4,5,2,3,1.6293110981806558,1.3557637102737474,2.75,0,3.5,0,3.2666666666666666,0,3.6666666666666665,0,4,0,3.8333333333333335,0,2,0,1.6666666666666667,0,3.3783783783783785,0,3,0,0,1.1679118020648247,1.179888314592263,0.6560486812839473,0.9179684979381051,2,4,1,4,4,5,5,8,5,1.5118578920369088,4.428571428571429,0,6.5,3.1775260909359293,1,5,5,3,2,2,4,6,6,2,2,1.5735915849388864,2.857142857142857,0,3.142857142857143,3,3.8333333333333335,3.2559414990859232,-0.7395711320441822,0,0.012814857609616537,3,5,5,2,4,5,5,4,4,3,5,4,3,2,4,1,3,1,5,3,1.3557637102737474,3.8,0,2.8,0,4.2,0,2.6,0,3.2,0,1,1,1,4,2,1,2,3,1,1,2,3,1,2,1,3,1,2,2,2,0.8944271909999159,1.5,0,"White, Caucasian, Anglo, European American",0,24,0,1,NA,1,2,6,Salesman,2,0,183,71,2,5,2,0,0,1,0,0,TRUE,TRUE,TRUE,TRUE,TRUE,4,0.9961156250033527,0.6530612244897959,0.22244689748886984,4,0.7946160000038147,0.916806896557068,0.9615384615384616,0.9666666666666667,0.07690392654079377,0.08526836253978134,4,1.5569206896568166,1.53411666666468,0.9666666666666667,0.9375,0.5947514680524554,0.47838362257197353,1.8716,0.3595,0.1881,1.2043,0.7125,0.6007,0.5736,1.7782616793333332,0.4710514792853333,0.19922716887666667,2.1632,2.1223,0.3178,1.5056,0.2335,18.5156,1.8205,1.837,0.346,2.2907,0.5303,0.9592,2.041482168,1.5677583707,2.1946626517666665,0.2611095891333333,0.32741987926666666,2.6462,0.8009,0.4133,1.206,0.4715,0.8408,0.139,0.356,0.111,0.243,1.835,7.551440329218107,2.7396794656666668,1.1794276806333333,1.1936612692333333,0.3819786959,0.4786689872,104,0.3081481481481481,1,0,1,2,FALSE,FALSE,FALSE
516,2021-11-13T09:38:27Z,2021-11-13T10:12:12Z,2024,1,2021-11-13T10:12:14Z,0.8999999761581421,Firefox,94.0,Windows NT 10.0,1920,1080,NA,1.7777777777777777,723,91,494,93,40,111,-0.17009021768363392,0.010861826063658545,0.32012489950813117,-0.14113507384491022,-0.4412283913971238,0.0949869180189837,3,3,3,2,2,1,1,3,1,3,3,1,2,2,3,3,1,1,2,2,0.8522416262267903,0,0,2,4,4,1.9,0,2,3,2,3,1,1,1,1,1,3,1,2,1,2,1,3,2,1,1,1,1,3,1,0,2,0,0,4,1,1,3,1,4,4,4,4,1,4,2,1,2,1,5,4,3,4,4,1,1,1,5,1,4,3,1,1,1,2,4,1,1,1,1,1,4,1,1,1,1.4760347823404023,0.816496580927726,1.625,0,1.75,0,2.6,0,3.111111111111111,0,2.3333333333333335,0,3,0,1.1428571428571428,0,1,0,2.3513513513513513,0,0,0,0,-0.17066723805880474,-0.031441318306858645,-0.5020371591262895,-0.2667392387165741,4,1,2,1,1,1,2,1,1,1.1126972805283737,1.7142857142857142,0,1,-0.4757826382709144,2,4,4,4,1,1,2,1,1,1,1,1.3972762620115438,2.857142857142857,0,3.142857142857143,8,3.8333333333333335,3.2559414990859232,2.0842459175790595,0,1.4247233824212375,2,3,3,1,1,1,3,2,1,1,3,4,2,4,3,1,2,3,2,2,1.0327955589886444,2,0,3.4,0,3,0,4,0,3.466666666666667,0,1,2,1,2,1,1,1,2,1,1,1,2,1,2,1,2,1,1,1,2,0.4893604849295929,1.55,0,"White, Caucasian, Anglo, European American",0,24,0,1,NA,0,2,6,surveyor,3,0,209,69,1,5,2,0,0,1,0,0,TRUE,TRUE,TRUE,TRUE,TRUE,3,0.64759375,0.64,0.01985289795918367,3,0.40874193548387094,0.4615806451612903,0.96875,0.96875,0.0046694989919354845,0.005060129032258065,3,0.5365625,0.6249677419354839,1,0.96875,0.0034146411290322583,0.0039770393145161275,1.0459,0.5754,0.38,0.8621,0.8322,0.4582,0.3286,1.1076602343333333,0.739681860788,0.37329741363333335,1.093,3.9598,0.2763,3.3029,0.3026,-69.1893,0.7906,5.7009,0.3376,4.7605,0.3868,0.9989,1.1850055544666667,3.5213573796666666,4.201692678666666,0.2977830496,0.2711802216,0.8805,5.5767,0.4575,4.7643,0.5418,0.9821,0.229,0.275,0.884,0.014,1.559,111.35714285714285,1.8354167396666667,5.419385467,3.924940789,0.3728370305,0.41229843303333336,104,0.3081481481481481,1,0,0,1,FALSE,FALSE,FALSE
517,2021-11-13T09:51:05Z,2021-11-13T10:18:25Z,1639,1,2021-11-13T10:18:25Z,1,Firefox,94.0,Windows NT 10.0,1536,864,N/A,1.7777777777777777,697,43,443,246,63,96,-0.23689376014025323,-0.4252056129690901,0.07459870366015774,1.7233851258637536,-0.12355101974969247,-0.15838358339381242,3,2,2,3,2,1,2,2,1,3,2,2,1,1,3,3,2,1,2,2,0.7254762501100116,0,1,2,3,3,2.1,0,3,4,2,4,2,3,2,3,2,2,2,2,1,2,3,2,3,2,1,2,2,3,2,0,2,0,1,5,4,4,4,4,3,4,5,4,1,3,3,2,4,2,5,4,3,3,4,4,3,2,1,1,1,1,1,1,1,1,3,3,3,1,1,2,2,2,1,1,1.367248832279395,0.8338093878327919,2.125,0,1.5,0,2.6,0,1.8888888888888888,0,2.6666666666666665,0,1.3333333333333333,0,1.7142857142857142,0,1.3333333333333333,0,2.027027027027027,0,0,0,1,-0.06139547968136551,0.044055055137912885,-0.40398871494434996,-0.17996682990321855,4,2,4,1,1,2,3,1,1,1.2724180205607036,1.8571428571428572,0,1,-0.39031545311577004,4,4,4,4,1,1,1,8,4,2,4,1.6035674514745464,3.2857142857142856,0,2.7142857142857144,3,3.8333333333333335,3.2559414990859232,-0.7395711320441822,0,-0.22619813465469363,3,3,2,4,3,1,4,2,2,3,1,5,3,3,3,3,4,2,4,3,1.1254628677422756,3,0,4.6,0,3.4,0,3.4,0,3.8,0,3,1,2,3,2,2,3,2,1,3,2,3,2,2,2,3,1,2,2,2,0.6708203932499369,2.05,0,"Asian or Asian American (e.g., Chinese, Japanese, and others) & White, Caucasian, Anglo, European American",1,23,0,1,NA,1,3,6,Retail Associate,1,0,185,70,3,5,2,0,0,1,0,0,TRUE,TRUE,TRUE,TRUE,TRUE,2,0.6033571428571428,0.84,0.05372363265306123,2,0.3905806451612903,0.46540625,0.96875,1,0.00404991935483871,0.005079152217741934,2,0.5145,0.58465625,1,1,0.006341483870967742,0.002996813508064515,1.1751,1.3971,0.3335,1.0414,1.3276,0.3682,0.1262,1.2153072867333334,1.2031810398666667,0.32600740133333334,1.0486,4.8008,0.286,3.9171,0.3315,-86.1508,0.8265,4.7403,0.3019,5.6063,0.3942,0.9192,1.1432974935333333,4.061745234,4.865719930333333,0.3260203923,0.2793053856666667,1.0817,3.9623,0.3904,7.273,0.5085,0.9796,0.126,0.333,0.726,0.007,0.981,140.14285714285714,2.1561218066666665,5.176674687666667,5.536418173666667,0.31128691523333335,0.39938584716666664,359,1.0637037037037036,1,0,0,1,FALSE,FALSE,FALSE
518,2021-11-13T09:56:35Z,2021-11-13T10:20:09Z,1413,1,2021-11-13T10:20:11Z,0.8999999761581421,Chrome,95.0.4638.69,Windows NT 10.0,1920,1080,NA,1.7777777777777777,791,60,273,57,81,73,0.0046267395106012734,-0.2707650616449916,-0.7438219491664203,-0.5798457090704782,0.12506605371351465,-0.5468850188934331,3,2,2,2,3,1,1,2,1,3,3,1,2,1,4,3,1,2,3,3,0.9333020044867296,0,1,2,3,3,1.75,0,4,5,2,3,2,2,4,2,2,2,4,3,2,3,4,2,2,1,1,1,1,1,1,0,2,0,0,4,4,3,4,2,4,4,4,5,2,4,2,2,4,2,4,4,2,2,4,4,4,1,1,1,2,1,2,1,1,1,4,2,2,1,1,1,1,1,1,1,1.322024110123468,1.0327955589886444,1.25,0,1,0,2.2666666666666666,0,2.2222222222222223,0,2.5,0,1.1666666666666667,0,1.4285714285714286,0,1,0,1.945945945945946,0,0,0,0,-0.6560860108508899,-0.5100689679022363,-0.7372407672780129,-0.6236548675901246,4,2,4,2,1,2,2,3,3,1.1338934190276817,1.8571428571428572,0,3,0.34765989643299416,4,5,5,4,2,2,2,4,6,4,4,1.3972762620115438,3.7142857142857144,0,2.2857142857142856,4,3.8333333333333335,3.2559414990859232,-0.1748077221195339,0,-0.18282942195667984,2,2,2,2,3,2,4,2,2,2,2,4,2,4,4,2,4,4,2,2,1.01418510567422,2.2,0,3.6,0,3.2,0,4,0,3.6,0,1,2,1,4,1,1,2,4,2,2,2,3,1,2,1,3,1,2,2,1,0.9679060415469871,1.5,0,"White, Caucasian, Anglo, European American",0,26,0,1,NA,1,4,6,Unemployed,5,0,160,68,2,5,2,0,0,1,0,0,TRUE,TRUE,TRUE,TRUE,TRUE,5,0.9936757575756673,0.66,0.07772356448996058,5,0.5411321428572493,0.6656593749979511,0.9032258064516129,1,0.016641276515967213,0.011813155392907495,5,0.9777749999994412,1.2447677419353878,1,0.96875,0.06372144129003728,0.08330485934503105,1.5164,0.454,0.4288,1.2062,0.6662,0.6474,0.5759,1.527401033,0.5847184404981,0.4234892987666667,1.476,2.1084,0.2402,3.1066,0.4281,-28.8655,0.8423,2.7696,0.427,3.5321,0.5635,0.9285,1.5623484843333333,3.214554763,2.414301911,0.4179079257666667,0.23982747846666666,1.7876,3.0794,0.6708,2.0864,0.8479,0.9945,0.133,0.535,0.322,0.006,1.937,322.8333333333333,3.204513851,3.0516772226666666,1.9958053176,0.44351069756666667,0.45674873503333335,104,0.3081481481481481,1,1,2,3,FALSE,FALSE,FALSE
519,2021-11-13T09:33:17Z,2021-11-13T10:22:01Z,2923,1,2021-11-13T10:22:01Z,1,Chrome,95.0.4638.69,Windows NT 10.0,1920,1080,NA,1.7777777777777777,2126,51,410,101,63,89,3.4347317079562476,-0.35252770646363196,-0.0842711877708839,-0.04364382157256178,-0.12355101974969247,-0.27662315071978394,3,3,1,2,3,1,2,3,1,3,2,1,1,1,3,3,2,1,3,3,0.9119095061289915,0,1,1,4,4,1.7,0,1,2,4,2,3,4,2,4,3,3,4,2,3,2,2,3,4,1,1,3,3,3,3,0,2,0,0,2,3,2,4,3,4,5,5,4,2,3,2,1,3,3,4,5,3,3,2,5,4,1,3,1,3,1,1,1,2,1,2,5,4,2,5,3,2,2,2,2,1.3495633817354862,0.9611501047232549,2.625,0,2,0,3.8,0,2.4444444444444446,0,2.8333333333333335,0,1.6666666666666667,0,2.4285714285714284,0,3.3333333333333335,0,2.5675675675675675,0,0,0,0,0.5858295507080814,1.0069241872258443,-0.4236359564090485,0.2916441154083979,4,2,3,2,1,1,2,3,2,1.0690449676496976,1.8571428571428572,0,2.5,0.1631660590458031,3,4,3,5,2,3,4,7,6,3,2,0.9759000729485332,3.142857142857143,0,2.857142857142857,2.5,3.8333333333333335,3.2559414990859232,-1.0219528370065065,0,-0.2877179897144191,2,3,2,2,3,2,5,3,2,3,3,4,1,4,4,5,3,2,4,2,1.1872336794093274,2.4,0,3.6,0,3.6,0,3.8,0,3.6666666666666665,0,2,1,2,2,3,2,3,1,3,2,2,3,2,3,1,2,3,3,3,3,0.7326950970650465,2.5,0,"White, Caucasian, Anglo, European American",0,29,0,1,NA,1,3,6,"Computer Scientist, looking for work",5,0,265,71,3,5,2,0,1,1,0,1,TRUE,TRUE,TRUE,TRUE,TRUE,1,0.852774418520373,0.86,0.028929447851734937,1,0.48432500003278256,0.5642218751013279,1,1,0.0028439593509300286,0.0028792966017320465,1,0.5791875001192093,0.6660968751460313,1,1,0.0036981888693354203,0.0020211861220067735,1.2564,1.5382,0.5607,1.1341,1.6435,0.6125,0.1058,1.2968133737333334,1.278441446,0.5500660791666667,3.9237,9.1466,0.2698,8.582,0.3356,-99.7251,0.6735,6.4957,0.4327,5.0829,0.5071,0.9991,1.7110715461333332,5.315987197,5.948351809333333,0.40978178653333336,0.3457171700666667,0.8492,4.3134,0.498,6.9786,0.6081,0.6457,0.195,0.338,0.824,0.012,1.377,114.75,2.483949874,5.485126608666667,6.051637272,0.3587930239,0.47157493083333335,194,0.5748148148148148,1,0,2,3,FALSE,FALSE,FALSE
520,2021-11-13T09:48:29Z,2021-11-13T10:22:26Z,2036,1,2021-11-13T10:22:27Z,1,Firefox,94.0,Windows NT 10.0,1920,1080,"On the exercise question, I actually exercise pretty much daily but it's very light - just walking. I chose the light option for that reason. 

Also, in the consent form, I noticed this

Signing the consent form
Clicking “Yes” below indicates that I have read (or someone has read to me) the description of this study, and I am aware that I am being asked to participate in a research study. 

By clicking ""Yes"", you also consent to the (re)use of the data recorded in this study. I have been told who to contact if I have questions about this study. I have had any questions answered to my satisfaction. I voluntarily agree to participate in this study. I am not giving up any legal rights by agreeing to participate.


Just a nitpick - should it not be I also consent, rather than you? I have been sleeping so little I hope that is actually a useful comment. Anyway, have a good day. Appreciate the opportunity for the study. Thank you.",1.7777777777777777,801,117,572,165,89,93,0.030320409686224094,0.2470650222063974,0.6956355519815023,0.7362861966062256,0.23556253080827336,-0.20905768367637165,3,3,2,2,3,2,1,3,1,3,3,2,1,2,3,3,2,1,3,2,0.7863975156570492,0,1,2,2,3,1.85,0,2,3,2,3,3,3,2,3,3,4,3,2,2,2,4,3,4,4,3,3,4,4,3,4,2,1,2,4,3,3,3,3,4,4,4,3,2,4,3,2,3,2,5,3,2,3,3,3,2,3,1,3,1,1,3,3,1,1,3,3,3,3,3,4,2,4,2,1,0.9671791123858265,0.7037315505489968,3.5,0,2.25,0,3.1333333333333333,0,2.5555555555555554,0,2.4166666666666665,0,2,0,2.2857142857142856,0,3.3333333333333335,0,2.4864864864864864,0,2,1,2,1.079653843375354,1.0616106628621211,0.6204826952926107,0.8410466790773659,4,2,4,2,2,2,2,5,2,0.9759000729485332,2,0,3.5,0.6176209189753294,4,4,4,4,4,3,2,3,4,6,4,0.7867957924694432,3.857142857142857,0,2.142857142857143,5.5,3.8333333333333335,3.2559414990859232,0.6723373927674386,0,0.16107213806536974,2,2,3,3,3,2,4,2,2,3,2,3,3,4,4,2,4,2,3,3,0.8338093878327919,2.6,0,3.8,0,3.4,0,3.8,0,3.6666666666666665,0,2,3,3,3,4,2,3,3,2,2,4,2,2,3,2,3,1,2,2,3,0.7591546545162482,2.45,0,"White, Caucasian, Anglo, European American",0,30,0,1,NA,1,2,1,Unemployed,3,0,225,72,2,5,2,0,0,1,0,0,TRUE,TRUE,TRUE,TRUE,TRUE,1,1.2956857142857143,0.7,0.18200332285714288,1,0.60578125,0.7273870967741936,1,0.96875,0.006312886088709678,0.012819963709677421,1,0.771258064516129,0.8193666666666667,1,0.9375,0.008690264516129033,0.010090931451612902,1.6502,0.5146,0.7365,1.6873,0.3207,0.7499,0.0527,1.6716945173333333,0.60503551627,0.7140419404666667,2.0643,5.1239,0.4043,3.2347,0.424,-53.1192,0.9176,6.6518,0.533,3.1712,0.6034,0.9926,2.098161506,3.206959627333333,4.882478518,0.41185091766666665,0.3919502432,0.9534,3.3086,0.6541,4.0614,0.7061,0.9209,0.076,0.58,0.409,0.023,1.885,81.95652173913044,2.3108307486666666,4.209254836666667,2.627277975,0.49693539966666667,0.4173363556333333,317,0.9392592592592592,1,0,0,2,FALSE,FALSE,FALSE
522,2021-11-13T10:09:20Z,2021-11-13T10:30:57Z,1296,1,2021-11-13T10:30:58Z,1,Chrome,95.0.4638.69,Macintosh,1440,900,"no, thank you",1.6,642,63,318,69,58,95,-0.3782089461061787,-0.24351084670544482,-0.5271811881240909,-0.4336088306619555,-0.19261131793391667,-0.1752749501546655,3,2,2,2,2,2,2,2,2,2,2,2,2,3,3,2,2,1,2,2,0.44721359549995793,0,0,3,3,3,2.4,0,2,4,3,3,3,4,3,3,3,3,3,3,2,3,2,3,3,1,1,3,3,3,3,4,2,0,0,4,2,4,3,2,2,1,2,2,3,2,2,1,4,2,5,3,3,2,3,3,3,1,1,1,1,1,2,4,4,4,3,2,3,1,2,1,1,2,3,3,1.1170262968022497,0.5936168397046637,2.5,0,2.25,0,3.066666666666667,0,3.5555555555555554,0,2.4166666666666665,0,1.1666666666666667,0,3,0,1.3333333333333333,0,2.5675675675675675,0,2,0,0,0.5080784918625958,0.6380566497924803,0.06095019390122543,0.3495034218468529,4,2,3,3,3,3,2,2,1,0.6900655593423543,2.5714285714285716,0,1.5,0.22151431004714253,5,5,5,5,2,2,2,4,7,5,3,1.6035674514745464,4,0,2,3.5,3.8333333333333335,3.2559414990859232,-0.4571894270818581,0,-0.48336226928071535,3,2,3,3,3,3,4,4,2,3,2,2,3,3,4,3,3,3,2,3,0.7037315505489968,2.8,0,3,0,3,0,3.2,0,3.066666666666667,0,2,1,3,2,4,3,4,2,3,3,1,1,3,3,2,2,2,3,3,4,0.9445132413883326,2.85,0,"Asian or Asian American (e.g., Chinese, Japanese, and others) & White, Caucasian, Anglo, European American",1,27,0,1,NA,1,2,6,ESL(English as a second language) assistant,1,0,145,71,1,5,2,0,0,0,0,0,TRUE,TRUE,TRUE,TRUE,TRUE,4,0.7871738095255125,0.84,0.03124920068928651,4,0.46805624999478457,0.5254733333190282,1,0.967741935483871,0.0023829889906034065,0.005199822946529708,4,0.5856249999888241,0.6504433333317439,1,0.967741935483871,0.005672809033485805,0.006456455911608616,1.4848,1.2755,0.4185,0.9078,1.3423,0.6326,0.2994,1.4786279256666666,1.1365975193,0.413547146,1.1161,5.7846,0.3716,3.7489,0.3829,-89.2667,0.8947,6.5208,0.3991,4.2569,0.4265,0.9968,1.2560326048333332,3.896000938,5.6610685966666665,0.3719316811,0.3613934166666667,0.6717,3.672,0.5265,5.4672,0.582,0.6617,0.071,0.427,0.416,0.024,1.921,80.04166666666667,2.012653301,4.502848624,3.7204021743333335,0.36401160903333335,0.3937359603666667,408,1.208888888888889,1,0,0,1,FALSE,FALSE,FALSE
523,2021-11-13T10:13:52Z,2021-11-13T10:32:18Z,1106,1,2021-11-13T10:32:19Z,1,Chrome,95.0.4638.69,Windows NT 10.0,1920,1080,NA,1.7777777777777777,611,35,277,52,31,63,-0.4578593236506095,-0.4978835194745482,-0.7245649926293244,-0.6407777417406959,-0.5655369281287274,-0.7157986865019639,3,3,2,2,3,2,2,3,2,3,2,2,2,2,3,3,2,2,3,3,0.5104177855340404,1,1,2,2,1,2.05,0,3,4,2,4,2,2,4,2,2,2,2,3,2,3,3,3,2,1,1,2,2,2,2,0,2,0,0,4,3,3,3,3,2,3,3,2,2,2,3,1,3,2,2,3,3,2,3,3,4,1,1,1,2,1,1,1,1,1,4,2,2,1,1,1,2,2,2,2,0.9863939238321437,0.816496580927726,1.875,0,2,0,2.2666666666666666,0,3.111111111111111,0,2.75,0,1.1666666666666667,0,1.2857142857142858,0,1,0,2.2162162162162162,0,0,0,0,-0.09922031911971019,-0.12532783400099734,-0.4236359564090485,-0.2744818952050229,4,2,4,1,1,2,3,3,5,1.2724180205607036,1.8571428571428572,0,4,0.7166475712073764,4,4,4,4,3,2,1,4,3,3,3,1.2149857925879117,3.7142857142857144,0,2.2857142857142856,5.5,3.8333333333333335,3.2559414990859232,0.6723373927674386,0,0.24074313548680643,3,4,4,4,4,4,4,4,4,3,4,2,3,2,2,1,4,3,4,4,1.01418510567422,3.8,0,2.6,0,3.8,0,2,0,2.8,0,2,2,3,2,2,3,2,2,3,2,3,2,2,3,2,2,2,3,2,3,0.4893604849295929,2.55,0,"Asian or Asian American (e.g., Chinese, Japanese, and others)",0,18,0,1,NA,1,4,4,Amazon Worker,3,0,135,69,2,5,2,0,0,0,0,0,TRUE,TRUE,TRUE,TRUE,TRUE,3,0.7001736842107616,0.76,0.033431134874323226,3,0.4083935483847895,0.46065624999953436,1,1,8.453412903458553e-4,0.0026630128629211427,3,0.5731625000014902,0.6127517241388559,1,0.9354838709677419,0.004823666935482814,0.007522697849450759,1.0541,1.1026,0.4397,0.9578,1.3422,0.4807,0.1306,1.1172170303,1.0328876962873332,0.43092225696666664,10,18.0785,0.1318,12.0875,0.047,-115.297,0.7644,8.0068,0.3644,5.6039,0.4013,0.9353,1.6768999394333333,5.170501194333333,7.000283725,0.30447118786666666,0.29657515813333335,0.8227,3.3468,0.4791,3.6899,0.5069,0.9651,0.058,0.439,0.45,0.027,1.637,60.62962962962963,1.5006944056666667,4.5525020246666665,3.102570164333333,0.41038835846666666,0.39611056456666666,312,0.9244444444444444,1,0,2,3,FALSE,FALSE,FALSE
524,2021-11-13T10:01:13Z,2021-11-13T10:35:34Z,2060,1,2021-11-13T10:35:36Z,1,Chrome,95.0.4638.69,Windows NT 10.0,1536,864,No.,1.7777777777777777,688,79,688,137,63,314,-0.2600180632983138,-0.09815503369452862,1.254087291557285,0.39506681365300617,-0.12355101974969247,3.523934370472158,4,4,1,1,1,1,2,3,1,3,3,1,1,1,4,3,1,1,3,4,1.268027892769755,0,1,1,5,5,1.45,0,5,5,1,4,1,1,5,1,1,1,1,5,1,5,4,2,1,1,1,1,1,1,1,0,3,0,0,4,5,4,5,4,3,5,5,4,1,5,1,1,4,1,5,1,1,1,3,1,5,1,1,1,3,1,1,1,1,1,5,1,1,1,1,1,2,1,1,1,1.7406981444322935,1.9444671200491874,1.125,0,1.25,0,1.1333333333333333,0,1.6666666666666667,0,1.25,0,1.1666666666666667,0,0.8571428571428571,0,1,0,1.2972972972972974,0,0,0,0,-1.1373020237053812,-1.329591780667467,-0.6588395645607719,-0.9942156726141195,4,2,3,2,1,1,1,2,1,1.1547005383792515,1.7142857142857142,0,1.5,-0.2912888008837234,4,5,5,5,4,4,1,7,7,4,3,1.4142135623730951,4.571428571428571,0,1.4285714285714286,2,3.8333333333333335,3.2559414990859232,-1.3043345419688306,0,-1.2256188164099486,2,2,2,1,2,2,5,2,1,5,1,5,2,4,4,1,4,1,3,3,1.5522640914238175,1.8,0,4.6,0,4.4,0,4,0,4.333333333333333,0,1,1,1,4,1,1,1,4,1,1,1,4,1,1,1,4,1,1,2,1,1.2258187382102494,1.05,0,"White, Caucasian, Anglo, European American",0,22,0,1,NA,1,3,7,academic assistant and department menager,4,0,175,69,3,5,2,0,0,1,0,0,TRUE,TRUE,TRUE,TRUE,TRUE,5,0.7052973684197978,0.7755102040816326,0.04536001708100948,5,0.4352580645142063,0.5011965517360588,1,0.90625,0.0033058078501532156,0.007009270604561328,5,0.5443499999996275,0.591528571422611,1,0.875,0.006146867096091894,0.007288208023997868,1.2488,1.0126,0.3926,0.992,1.0644,0.4992,0.3389,1.296864801,0.9849902373333334,0.3845919832333333,1.0649,3.7139,0.2919,3.139,0.3569,-65.967,0.7728,5.533,0.3725,2.9984,0.396,0.9968,1.1852493520333334,3.342746287333333,4.078997044666667,0.34695724326666666,0.2869000514,0.8484,3.1097,0.4451,3.6375,0.4774,0.8816,0.05,0.413,0.408,0.017,1.592,93.6470588235294,1.28394699,3.731179266,2.5736599311333332,0.36963840156666666,0.38376936246666665,378,1.12,1,0,0,1,FALSE,FALSE,FALSE
525,2021-11-13T10:13:58Z,2021-11-13T10:49:13Z,2114,1,2021-11-13T10:49:13Z,1,Firefox,94.0,Windows NT 10.0,1280,720,N/A,1.7777777777777777,801,76,680,124,83,237,0.030320409686224094,-0.1254092486340754,1.215573378483093,0.23664352871043995,0.15269017298720433,2.223299129886471,4,3,1,1,2,1,1,2,1,3,3,1,1,2,3,3,1,1,3,3,1.025978352085154,0,1,1,4,3,1.6,0,3,4,3,4,3,2,4,2,2,2,2,3,2,4,3,3,3,4,3,3,2,2,3,3,3,0,4,4,3,2,3,1,4,4,4,4,3,3,1,3,2,2,4,4,3,2,3,3,2,3,4,1,3,4,3,3,2,1,4,2,2,2,2,1,2,3,2,2,1.0178585540417864,0.8338093878327919,2.875,0,2.25,0,2.3333333333333335,0,2.7777777777777777,0,2.75,0,3,0,2,0,1.6666666666666667,0,2.6216216216216215,0,2,0,4,0.7749537478998025,0.5072930593772413,0.7667487814979485,0.637020920437595,3,3,2,3,3,3,3,3,3,0.3779644730092272,3.142857142857143,0,3,1.1168645628292926,1,4,3,3,2,3,2,4,1,1,1,0.9759000729485332,2.857142857142857,0,3.142857142857143,6.5,3.8333333333333335,3.2559414990859232,1.237100802692087,0,1.0011508249777512,2,2,2,1,2,2,2,3,2,3,4,5,3,3,3,4,4,3,3,5,0.9611501047232549,1.8,0,3.6,0,2.6,0,2.8,0,3,0,2,1,2,3,3,2,2,3,2,2,2,2,3,1,1,2,1,3,2,2,0.6863327411532597,2.05,0,"Hispanic of Latino (e.g., Mexican American, Central American, and others) & White, Caucasian, Anglo, European American",1,28,0,1,NA,1,1,4,online task worker,1,0,155,70,4,5,2,0,0,1,0,0,TRUE,TRUE,TRUE,TRUE,TRUE,6,1.1098536585365855,0.82,0.17086066326530613,6,0.4898709677419355,0.6120625,1,1,0.005897649462365592,0.008815028225806449,6,0.65390625,0.8079999999999999,1,0.96875,0.013315119959677421,0.025285232862903222,2.1792,0.8038,0.2427,1.4315,1.0075,0.667,0.228,1.9484967586666666,0.7707083649666666,0.2600479613,3.1022,6.6174,0.2555,5.4793,0.329,-71.1108,0.8549,4.8079,0.4009,3.8285,0.5132,0.9936,1.9123291863333334,4.209415644333333,5.12009226,0.38695026116666664,0.3053785450666667,1.4249,4.0385,0.4824,2.4769,0.5475,0.9974,0.097,0.44,0.472,0.014,1.96,140,2.395438905333333,3.909991074666667,2.9901131443333333,0.34641983526666664,0.4204680739,104,0.3081481481481481,1,1,1,2,FALSE,FALSE,FALSE
526,2021-11-13T10:21:14Z,2021-11-13T10:51:36Z,1821,1,2021-11-13T10:51:38Z,0.8999999761581421,Chrome,95.0.4638.69,Windows NT 10.0,1920,1080,None.,1.7777777777777777,656,78,431,102,49,92,-0.3422378078603068,-0.10723977200771087,0.01682783404886987,-0.03145741503851823,-0.31691985466552025,-0.2259490504372247,4,4,2,1,4,1,2,4,1,4,3,2,2,1,3,4,2,1,3,4,1.231174022502185,0,1,2,4,4,1.4,0,5,5,2,5,1,1,5,1,1,2,1,5,2,4,4,2,1,1,1,1,1,2,1,1,2,0,0,5,4,5,3,3,5,4,5,4,1,4,1,1,5,2,5,1,1,1,1,1,5,1,1,1,1,1,1,2,2,1,5,1,2,1,1,1,2,2,2,2,1.6908160334166633,1.791514389985135,1.25,0,2,0,1.3333333333333333,0,1.7777777777777777,0,1.1666666666666667,0,0.8333333333333334,0,1.2857142857142858,0,1,0,1.3243243243243243,0,1,0,0,-1.0427399251095204,-1.1783086631108288,-0.22054348261253207,-0.6994260728616805,4,1,3,1,1,1,1,1,1,1.2535663410560174,1.4285714285714286,0,1,-0.6467170085812028,5,5,5,5,3,2,2,4,4,4,3,1.4638501094227998,4.142857142857143,0,1.8571428571428572,5,3.8333333333333335,3.2559414990859232,0.38995568780511447,0,-0.13946070925866577,2,2,1,1,2,1,4,3,1,3,2,5,2,3,4,2,5,2,3,2,1.2649110640673518,1.6,0,4.6,0,3.6,0,3.8,0,4,0,1,1,1,4,2,1,2,3,1,1,1,4,2,1,1,4,1,1,1,2,1.118033988749895,1.25,0,"White, Caucasian, Anglo, European American",0,19,0,1,NA,1,3,4,Full-time student,5,0,140,70,3,5,2,0,0,1,0,0,TRUE,TRUE,TRUE,TRUE,TRUE,1,0.8735868421047926,0.76,0.11288076749515487,1,0.35712580645372793,0.4305333333313465,0.96875,0.967741935483871,0.0017526438607130344,0.0032256453120345302,1,0.5274354838728905,0.587063333333532,0.96875,0.9375,0.00612425410280567,0.010660965161078267,1.3681,0.8615,0.4852,1.2294,0.7934,0.5294,0.0286,1.4068685003333334,0.8849308763,0.47601351306666667,1.0142,4.858,0.2579,3.8449,0.3049,-86.5379,0.7533,6.0648,0.296,5.3838,0.3633,0.9291,1.0790723816,3.9421209913333333,4.908520012333334,0.3006880693,0.2541851987,0.9859,4.2183,0.4194,3.1655,0.4575,0.932,0.06,0.358,0.322,0.02,1.728,86.39999999999999,1.5622455146666667,3.6504996536666665,2.595774286566667,0.3244986366666667,0.3083570576,292,0.8651851851851852,1,0,0,1,FALSE,FALSE,FALSE
528,2021-11-13T10:34:58Z,2021-11-13T10:59:14Z,1455,1,2021-11-13T10:59:16Z,1,Chrome,95.0.4638.69,Windows NT 10.0,1360,768,The study was great and interesting.,1.7708333333333333,772,56,351,54,40,89,-0.044191233823082085,-0.30710401489772066,-0.36831129669304924,-0.6164049286726088,-0.4412283913971238,-0.27662315071978394,3,3,1,1,3,1,1,3,1,3,3,1,1,1,3,3,1,1,3,3,1.025978352085154,0,0,4,5,5,1.5,0,4,4,1,4,1,1,4,1,1,1,1,4,1,4,4,1,1,1,1,1,1,1,1,2,2,1,1,4,4,4,4,4,4,4,4,4,1,4,1,1,4,1,4,1,1,1,1,1,4,1,1,1,1,1,1,1,1,1,4,1,1,1,1,1,1,1,1,1,1.475017178095115,1.5491933384829668,1,0,1,0,1.4666666666666666,0,2,0,1.25,0,1,0,1,0,1,0,1.3783783783783783,0,1,1,1,-1.1646199632997414,-1.2052163449283244,-0.15106543898929206,-0.6781408919588082,4,3,3,2,2,2,4,3,2,0.8997354108424374,2.5714285714285716,0,2.5,0.5905019848215247,4,4,4,4,3,3,2,3,3,1,3,0.7867957924694432,3.7142857142857144,0,2.2857142857142856,6,3.8333333333333335,3.2559414990859232,0.9547190977297628,0,0.3819339879679685,1,1,1,1,1,1,4,1,1,4,1,4,1,1,4,1,4,1,4,4,1.5491933384829668,1,0,4.6,0,4.4,0,3.4,0,4.133333333333334,0,1,1,1,3,1,1,1,3,1,1,1,3,3,1,1,3,1,1,1,1,0.8885233166386386,1.3,0,Black or African American,0,26,0,1,NA,1,3,7,Information technology,1,0,130,69,3,5,2,0,0,1,0,0,TRUE,TRUE,TRUE,TRUE,TRUE,3,0.7329135135162521,0.7551020408163265,0.0347596118110335,NA,NA,NA,NA,NA,NA,NA,3,0.7301281250016763,0.8164645161292245,1,1,0.008608104021571892,0.02854434836493401,1.2008,0.9723,0.4431,0.6994,1.4589,0.6276,0.1939,1.2587529822666668,0.9620005933666667,0.4344099269666667,NA,NA,NA,NA,NA,NA,NA,NA,NA,NA,NA,NA,NA,NA,NA,NA,NA,1.2868,4.7762,0.5945,2.2381,0.5793,0.9725,0.081,0.55,0.407,0.053,1.982,37.39622641509434,2.6150451556666665,5.149344736,3.6363214173333334,0.48086192136666667,0.4592647988,406,1.202962962962963,1,1,4,5,TRUE,FALSE,FALSE
529,2021-11-13T09:43:19Z,2021-11-13T11:03:38Z,4819,1,2021-11-13T11:03:39Z,1,Chrome,95.0.4638.69,Windows NT 10.0,1680,1050,"Thanks for the opportunity
",1.6,776,84,492,103,1380,85,-0.033913765752832954,-0.0527313421286173,0.3104964212395832,-0.019271008504474677,18.06693152197496,-0.34418861776319626,1,1,3,4,2,2,1,1,1,1,1,3,3,1,1,1,1,1,1,1,0.9445132413883326,0,1,1,2,2,2.95,0,4,1,4,2,4,4,3,2,2,1,3,2,1,4,3,3,1,1,3,1,4,3,3,2,2,0,1,4,2,1,1,1,1,1,1,2,4,3,4,1,3,5,3,5,5,5,5,5,3,1,5,1,3,3,1,2,1,1,2,2,4,1,3,1,2,2,1,1,1.5538386062955234,1.1751393027860062,2.375,0,1.5,0,2.933333333333333,0,4.444444444444445,0,4,0,2.5,0,2,0,1.6666666666666667,0,3.3513513513513513,0,1,0,1,0.9178475857779922,0.8638682385702389,-0.20089624114783355,0.33148599871120266,4,1,4,1,1,2,3,2,2,1.3801311186847085,1.7142857142857142,0,2,-0.10679496349653231,3,4,4,4,2,3,3,7,6,6,4,0.7559289460184544,3.2857142857142856,0,2.7142857142857144,2.5,3.8333333333333335,3.2559414990859232,-1.0219528370065065,0,-0.3673889871358558,3,1,3,3,4,3,4,3,2,1,1,3,3,5,3,4,5,2,3,4,1.2227992865708155,2.8,0,4,0,2.6,0,3.4,0,3.3333333333333335,0,1,1,1,3,4,1,1,3,1,1,3,3,1,1,2,3,1,1,1,2,1.019545822516343,1.55,0,Black or African American,0,26,0,1,NA,1,2,6,Pharmacy Technician,2,0,220,72,2,5,2,1,0,1,0,1,TRUE,TRUE,TRUE,TRUE,TRUE,6,1.3626944444444444,0.72,0.1626742942857143,6,0.5521875,0.5818125,1,1,0.003928866935483873,0.006110608870967743,6,0.6866129032258065,0.8198125,1,1,0.013050445161290317,0.009290415322580644,1.6645,0.5812,0.7937,1.5134,0.521,0.895,0.2823,1.68851294,0.6529511278043333,0.7682443925333333,2.8603,7.3,0.3563,5.9359,0.3409,-83.4575,1.1711,5.1647,0.4396,6.6961,0.4919,0.9806,1.8960190784666666,4.607651862666667,5.630532948,0.3799359575333333,0.3877346266666667,0.9798,3.3589,0.5492,2.8156,0.6831,0.9486,0.148,0.401,0.54,0.009,1.55,172.22222222222223,2.732948653,4.694456028333334,4.548696744,0.3985928619,0.5254175168666667,136,0.40296296296296297,1,0,0,1,FALSE,FALSE,FALSE
530,2021-11-13T10:41:39Z,2021-11-13T11:03:44Z,1325,1,2021-11-13T11:03:45Z,1,Chrome,95.0.4638.69,Windows NT 10.0,1397,786,None.,1.77735368956743,655,50,355,74,62,71,-0.34480717487786905,-0.36161244477681426,-0.34905434015595327,-0.37267679799173775,-0.1373630793865373,-0.5806677524151392,3,3,2,2,3,1,3,2,2,3,1,2,2,3,3,3,2,1,2,2,0.7163503994113789,0,1,1,2,2,2.25,0,2,3,3,3,3,5,2,4,4,5,3,1,3,2,2,2,4,1,3,2,2,3,2,0,5,0,0,4,2,1,3,2,3,2,3,2,3,4,2,2,2,3,3,5,4,3,3,3,3,1,1,1,3,4,1,1,3,3,1,4,4,4,5,3,3,3,3,3,1.146217175675628,1.1338934190276817,2.375,0,3,0,3.8,0,3.5555555555555554,0,3.0833333333333335,0,2,0,2.857142857142857,0,4,0,3.108108108108108,0,0,0,0,0.7665482280246152,1.131783574076812,-0.11003114554008399,0.510876214268364,2,4,2,4,3,4,4,3,3,0.9511897312113419,3.857142857142857,0,3,1.5442004886050142,1,1,3,3,1,1,4,3,4,1,1,1.2909944487358056,1.7142857142857142,0,4.285714285714286,5.5,3.8333333333333335,3.2559414990859232,0.6723373927674386,0,1.3561370993869208,3,3,3,3,3,2,5,3,2,4,2,5,3,4,4,1,4,3,5,2,1.2798809468443688,3,0,4,0,4.4,0,3.8,0,4.066666666666666,0,2,3,2,1,4,3,3,1,3,2,3,1,4,3,2,1,1,3,1,3,1.0310954828418375,2.9,0,"White, Caucasian, Anglo, European American",0,22,0,1,NA,1,3,5,Student,3,0,160,70,3,5,2,0,0,1,0,0,TRUE,TRUE,TRUE,TRUE,TRUE,2,0.8123411765098572,0.68,0.038760504349230535,2,0.48360645162674687,0.540640625,1,1,0.004012407959207309,0.003591003779355941,2,0.700531249947846,0.9045937499627471,1,1,0.011947471254966162,0.09595734835036045,1.3019,0.6277,0.4644,1.1143,0.4935,0.5529,0.0385,1.3484216816666668,0.73871746159,0.45685274893333333,3.3903,7.338,0.2526,8.0211,0.3293,-90.0894,0.732,4.332,0.4106,4.3145,0.4652,0.9895,1.7785639856,5.490121641333333,5.165341638666667,0.3854665069,0.3138298432,1.6105,3.9253,0.5077,1.8389,0.4928,0.818,0.105,0.433,0.343,0.016,1.671,104.4375,2.6066231196666667,4.240944079666667,2.6004491826666665,0.3934588249,0.39670232326666666,104,0.3081481481481481,1,0,0,1,FALSE,FALSE,FALSE
532,2021-11-13T10:40:30Z,2021-11-13T11:07:07Z,1596,1,2021-11-13T11:07:08Z,0.8999999761581421,Chrome,95.0.4638.69,Windows NT 10.0,1366,768,great survey,1.7786458333333333,799,68,385,94,38,112,0.02518167565109953,-0.1980871551395335,-0.2046271661277336,-0.12894866731086665,-0.46885251067081346,0.11187828477983676,4,4,1,1,4,1,1,4,1,4,4,1,1,1,4,4,1,1,4,4,1.538967528127731,0,1,1,5,5,1,0,5,5,1,5,1,1,5,1,1,1,1,5,1,5,5,1,1,1,1,1,1,1,1,0,2,0,0,5,5,5,5,5,5,5,5,5,1,5,1,1,5,1,5,1,1,1,1,1,5,1,1,1,1,1,1,1,1,1,5,1,1,1,1,1,1,1,1,1,1.9666895707934864,2.065591117977289,1,0,1,0,1,0,1,0,1,0,0.8333333333333334,0,0.8571428571428571,0,1,0,1,0,0,0,0,-1.3999745198049947,-1.568373259242148,-0.7372407672780129,-1.1528070132600805,4,2,4,1,1,1,2,1,1,1.3451854182690985,1.5714285714285714,0,1,-0.5612498234260587,5,5,5,5,4,5,1,7,7,2,3,1.4960264830861913,4.857142857142857,0,1.1428571428571428,2,3.8333333333333335,3.2559414990859232,-1.3043345419688306,0,-1.3849608112528222,1,1,1,1,1,1,3,1,1,1,1,5,1,5,5,1,5,1,1,3,1.7994708216848747,1,0,5,0,3,0,4.6,0,4.2,0,1,1,1,1,1,1,1,4,1,1,1,4,1,1,1,4,1,1,1,1,1.0990426455975697,1.15,0,"Hispanic of Latino (e.g., Mexican American, Central American, and others)",0,30,0,1,NA,1,2,4,student,1,0,145,69,2,5,2,0,0,1,0,0,TRUE,TRUE,TRUE,TRUE,TRUE,NA,NA,NA,NA,3,0.618103448275862,0.7489592592583763,1,0.8709677419354839,0.03868702963058236,0.045407427462327274,3,0.8875000000018627,1.0595343749998138,1,1,0.0987689638741757,0.10534146490713554,NA,NA,NA,NA,NA,NA,NA,NA,NA,NA,1.7427,3.3313,0.3565,1.2564,0.2282,-3.6403,1.222,2.8623,0.402,2.3287,0.5109,0.9469,1.7648251593333333,1.411261278,3.4147230536666666,0.2381606736,0.3500773026,1.7515,2.0903,0.4845,1.5675,0.6487,0.9839,0.159,0.292,0.24,0.017,1.851,108.88235294117646,2.8773795373333333,2.5470199096666666,2.0825992963333335,0.3082158919333333,0.35481206546666666,365,1.0814814814814815,1,0,0,1,FALSE,FALSE,FALSE
533,2021-11-13T10:13:53Z,2021-11-13T11:08:07Z,3254,1,2021-11-13T11:08:09Z,1,Chrome,95.0.4638.69,Windows NT 10.0,1536,864,none,1.7777777777777777,1472,94,1266,87,88,142,1.7543656784705153,0.038116041003205335,4.03671751116765,-0.21425351304917153,0.22175047117142851,0.618619287605429,4,4,2,1,4,1,1,4,1,4,4,1,2,1,4,4,1,1,4,4,1.465390194130093,0,1,1,5,5,1.1,0,3,3,1,3,2,1,4,1,1,1,1,1,1,1,1,1,1,1,1,1,1,1,1,4,7,0,0,5,4,2,4,4,4,4,4,4,2,4,4,1,1,3,4,1,4,1,1,1,4,1,1,1,1,1,1,4,4,4,2,3,1,2,2,1,2,2,2,2,1.4247912233130966,1.0465362369445672,1,0,2,0,2.3333333333333335,0,2.111111111111111,0,2.25,0,1,0,2.857142857142857,0,1.6666666666666667,0,2.135135135135135,0,2,0,0,-0.6939108502892343,-0.5075524221207439,-0.01745100881601569,-0.2625017154683798,4,1,1,3,2,2,3,5,5,1.1126972805283737,2.5714285714285716,0,5,1.51297117175748,2,2,3,4,1,1,4,6,6,1,2,1.2724180205607036,2.142857142857143,0,3.857142857142857,3,3.8333333333333335,3.2559414990859232,-0.7395711320441822,0,0.41116984471680035,1,1,1,1,1,1,4,1,1,1,1,4,1,4,4,1,4,4,5,1,1.6417180315870614,1,0,4,0,4,0,4.6,0,4.2,0,1,1,1,1,1,3,4,4,2,3,3,3,1,3,2,2,1,3,3,1,1.0894228312566052,2.15,0,Black or African American,0,26,0,1,NA,0,2,8,teaching assistant,2,0,180.77,67,3,5,3,0,0,1,1,0,TRUE,TRUE,TRUE,TRUE,TRUE,1,0.9624674999989569,0.8,0.049179669943517426,1,0.615409677420893,0.6292125000022352,0.96875,1,0.010029258065462112,0.011856746289832533,1,0.6586387096778039,0.7351032258051057,0.96875,1,0.006691510232155584,0.013888733655659595,1.1714,1.1696,0.661,1.2613,1.2091,0.6354,0.1895,1.2465362525666666,1.0789449936666666,0.6458395576,1.466,2.9941,0.3798,4.0591,0.4486,-53.9487,1.1596,5.1708,0.4961,3.4529,0.4679,0.9553,1.7421431183333334,4.178663711333333,3.3881223773333335,0.4225282646333333,0.3599539970333333,1.1233,5.7023,0.55,2.4051,0.5594,0.7148,0.079,0.477,0.379,0.042,1.695,40.357142857142854,1.7150645657666668,4.067881974666666,3.4054666566666665,0.4654303771666667,0.4839801108333333,382,1.1318518518518519,1,0,0,1,FALSE,FALSE,FALSE
534,2021-11-13T10:49:59Z,2021-11-13T11:12:13Z,1333,1,2021-11-13T11:12:14Z,0.8999999761581421,Chrome,95.0.4638.69,Windows NT 10.0,1920,1080,NA,1.7777777777777777,602,46,385,75,51,97,-0.48098362680867,-0.39795139802954327,-0.2046271661277336,-0.3604903914576942,-0.28929573539183057,-0.14149221663295936,4,4,1,1,4,1,1,3,1,3,3,1,1,1,4,4,1,1,4,3,1.3803127029389886,0,1,1,4,4,1.2,0,2,3,4,3,3,4,3,4,3,2,3,3,2,3,2,4,4,4,2,4,5,5,5,1,3,0,0,5,4,4,2,3,3,2,4,2,2,5,5,1,2,2,4,4,4,5,5,5,1,1,5,1,1,1,1,2,1,1,4,1,2,1,1,4,2,1,1,1,1.5749541201192117,0.7037315505489968,4.125,0,1.25,0,3.2,0,2.7777777777777777,0,3.3333333333333335,0,2.1666666666666665,0,1.2857142857142858,0,2,0,2.5675675675675675,0,1,0,0,1.5188422568539075,1.3936979157967502,-0.4557470907642554,0.4689754125162474,5,1,3,1,1,2,1,2,3,1.5275252316519468,1.4285714285714286,0,2.5,-0.09323549641962975,3,5,4,5,1,1,3,1,1,2,2,1.6761634196950514,3.142857142857143,0,2.857142857142857,8,3.8333333333333335,3.2559414990859232,2.0842459175790595,0,1.265381387578364,3,3,3,1,2,2,4,2,2,4,3,4,1,4,3,2,4,1,2,5,1.245945806357946,2.4,0,4,0,3.8,0,3.2,0,3.6666666666666665,0,2,1,1,3,1,1,1,4,1,1,1,3,3,2,1,4,1,2,2,2,1.0399898784932577,1.45,0,"White, Caucasian, Anglo, European American",0,24,0,1,NA,1,2,4,Student,1,0,165,71,3,5,2,0,0,1,0,0,TRUE,TRUE,TRUE,TRUE,TRUE,6,0.8059785714285653,0.8571428571428571,0.03684016407312645,6,0.4467266666666682,0.5477600000000055,0.967741935483871,0.9375,0.0011563132903225205,0.0031754596370969783,6,0.6181624999999876,0.6541290322580721,1,1,0.004791517903227793,0.0041360921290341445,1.2563,1.5007,0.5226,0.7969,1.9899,0.662,0.3445,1.2958899523333334,1.2569260978666668,0.5124381994666667,1.2967,5.2974,0.3314,3.0018,0.3578,-69.3081,0.7309,7.178,0.3997,4.6677,0.4804,0.9482,1.3696722731666666,3.1651792066666666,5.202132225333333,0.3524350061,0.3253429974,0.569,4.3766,0.5725,4.4907,0.6082,0.9527,0.203,0.357,0.777,0.029,1.33,45.86206896551724,2.5918022253333333,5.291811222,5.334135605666667,0.3784265956,0.4202661097666667,308,0.9125925925925925,1,0,0,1,FALSE,FALSE,FALSE
535,2021-11-13T10:48:22Z,2021-11-13T11:15:15Z,1612,1,2021-11-13T11:15:16Z,1,Chrome,95.0.4638.69,Windows NT 10.0,2560,1080,NA,2.3703703703703702,794,381,189,31,14,77,0.012334840563288119,2.645435936886515,-1.1482180364454353,-0.8966922789556105,-0.8003419419550897,-0.47931955185002084,4,3,3,2,3,2,3,3,3,3,3,3,2,2,3,3,3,3,2,3,0.5231483637805969,0,0,2,2,2,2.3,0,4,3,3,3,4,3,4,4,4,3,3,3,3,3,3,2,3,3,4,3,3,4,3,2,3,2,1,4,3,3,4,3,3,3,4,3,4,4,4,3,3,3,4,4,3,3,3,3,4,4,4,3,4,4,2,2,3,3,4,4,3,3,3,3,4,3,4,2,0.5876609101729886,0.4879500364742666,3.125,0,3.25,0,3.066666666666667,0,2.6666666666666665,0,3.0833333333333335,0,3.3333333333333335,0,2.5714285714285716,0,3,0,2.972972972972973,0,1,2,1,1.1489993823456521,1.080871917112774,0.7611785930589017,0.9210252550858379,4,3,3,2,3,3,2,4,4,0.6900655593423543,2.5714285714285716,0,4,1.143983496983098,2,2,2,2,3,3,4,5,5,3,3,0.7867957924694432,2.2857142857142856,0,3.7142857142857144,4,3.8333333333333335,3.2559414990859232,-0.1748077221195339,0,0.6138805522576877,1,2,2,4,2,2,2,3,4,3,2,3,4,3,2,1,3,3,3,2,0.816496580927726,2.2,0,3.4,0,3,0,2.8,0,3.066666666666667,0,2,2,2,2,2,2,2,2,3,2,3,2,2,2,3,3,3,2,2,2,0.4442616583193193,2.35,0,"White, Caucasian, Anglo, European American",0,19,0,1,NA,1,3,4,student,4,0,154,71,2,5,2,0,0,1,0,0,TRUE,TRUE,TRUE,TRUE,TRUE,6,0.8169333333333333,0.9,0.03595283813877463,6,0.5107903225806452,0.5546645161290278,1,0.96875,0.015686420903225414,0.024750686280241657,6,0.7687533333333286,0.837877419354826,0.9375,1,0.05533375254032383,0.07148489647311453,1.3189,1.6789,0.5163,1.3504,2.1765,0.5308,0.3887,1.338871809,1.3605969284,0.5063156162,1.5611,3.347,0.2776,2.8182,0.2887,-39.7305,1.3402,2.7027,0.296,3.7009,0.36,0.8456,1.5893293656666667,2.9687694373333335,3.509724074,0.2906619472,0.2770284859666667,1.4474,1.8056,0.4376,2.4163,0.5365,0.9341,0.077,0.455,0.217,0.015,1.033,68.86666666666666,1.796375862,2.1980704346666666,2.587232366,0.39992513133333335,0.4831432749,390,1.1555555555555557,1,0,1,2,FALSE,FALSE,FALSE
536,2021-11-13T10:35:00Z,2021-11-13T11:19:22Z,2662,1,2021-11-13T11:19:23Z,1,Chrome,95.0.4638.69,Windows NT 10.0,1360,768,I enjoyed it.,1.7708333333333333,644,36,225,55,37,66,-0.3730702120710542,-0.48879878116136594,-0.9749054276115718,-0.6042185221385653,-0.4826645703076583,-0.6651245862194046,3,3,1,1,3,1,1,3,1,3,3,1,1,1,3,3,1,1,3,3,1.025978352085154,0,0,4,5,5,1.5,0,4,4,1,4,1,1,4,1,1,1,1,4,1,4,4,1,1,1,1,1,1,1,1,2,2,0,0,4,4,4,4,4,4,4,4,4,1,4,4,1,4,4,4,1,1,4,1,1,4,1,1,1,1,1,1,1,1,1,4,1,1,1,1,1,1,1,1,1,1.5156837721956706,1.5491933384829668,1,0,1,0,1.4666666666666666,0,2,0,2,0,1,0,1,0,1,0,1.6216216216216217,0,1,0,0,-1.0133206055463637,-1.1006829047740254,-0.5341482934814965,-0.817415599127761,4,3,3,3,3,3,3,3,3,0.3779644730092272,2.857142857142857,0,3,0.9459301925190042,4,4,4,4,3,3,1,3,3,1,3,1.1126972805283737,3.857142857142857,0,2.142857142857143,6,3.8333333333333335,3.2559414990859232,0.9547190977297628,0,0.30226299054653183,1,1,1,1,1,1,4,1,1,1,1,4,1,4,4,1,4,1,4,1,1.52127765851133,1,0,4.6,0,3.8,0,4.6,0,4.333333333333333,0,1,1,1,3,1,1,1,3,1,1,1,3,3,1,1,3,1,1,1,1,0.8885233166386386,1.3,0,Black or African American,0,20,0,1,NA,1,3,7,Information technology,1,0,130,69,3,5,2,0,0,1,0,0,TRUE,TRUE,TRUE,TRUE,TRUE,5,0.6962414634147795,0.8367346938775511,0.021101112959049505,5,0.5854093749970197,0.6400387096760735,1,1,0.014892542167086967,0.010623521784911778,5,0.7050468749990687,0.8353875000029802,1,1,0.005777120635170682,0.009876189516448591,1.025,1.5866,0.4752,0.9663,1.7021,0.5042,0.2092,1.0865087792333334,1.2682910215,0.46509388756666664,2.9722,4.8183,0.277,5.6709,0.378,-60.2023,0.979,3.215,0.4502,5.4419,0.5392,0.9357,2.1676272383333335,4.543237363,4.103864125333334,0.40495304616666666,0.31855254703333336,0.9077,3.9644,0.5954,2.8225,0.7171,0.9038,0.12,0.502,0.605,0.007,1.222,174.57142857142856,2.8811348216666666,5.723152282666667,4.511066834666667,0.4596688107333333,0.5221984961333334,376,1.114074074074074,1,0,1,2,FALSE,FALSE,FALSE
537,2021-11-13T11:03:58Z,2021-11-13T11:24:02Z,1204,1,2021-11-13T11:24:03Z,1,Chrome,95.0.4638.69,Windows NT 10.0,1366,768,no comment,1.7786458333333333,690,65,232,40,26,91,-0.2548793292631892,-0.22534137007908028,-0.9412057536716539,-0.7870146201492185,-0.6345972263129516,-0.2428404171980778,2,2,1,2,1,2,3,2,3,3,2,3,3,2,3,3,2,3,2,3,0.6708203932499369,0,0,4,3,2,2.55,0,1,3,3,4,4,2,2,4,4,3,2,4,3,4,3,4,3,4,2,3,2,3,4,1,2,0,0,3,4,3,3,4,2,4,3,4,2,4,3,4,3,4,4,3,2,3,4,3,4,2,4,3,4,4,3,2,4,3,2,3,4,2,3,2,1,1,1,1,0.775952383914182,0.9611501047232549,3.125,0,1,0,3.066666666666667,0,2.6666666666666665,0,2.9166666666666665,0,3,0,3.142857142857143,0,2.3333333333333335,0,2.918918918918919,0,1,0,0,1.1153773028449019,1.0576422637451524,-0.5341482934814965,0.2617469851318279,3,2,4,4,3,4,3,3,2,0.7559289460184544,3,0,2.5,0.8469035402869574,5,5,5,5,3,3,1,6,6,3,3,1.5735915849388864,4.428571428571429,0,1.5714285714285714,3,3.8333333333333335,3.2559414990859232,-0.7395711320441822,0,-0.8635661140261877,3,4,3,2,3,2,4,3,4,3,2,3,4,2,4,3,3,5,3,2,0.9154754164341269,3,0,3,0,3,0,3,0,3,0,2,2,3,2,3,1,2,4,3,2,3,2,2,1,2,3,2,3,2,3,0.7451598203705946,2.25,0,"White, Caucasian, Anglo, European American",0,23,0,1,NA,1,4,6,welder,3,0,220,70,2,5,2,0,0,1,0,0,TRUE,TRUE,TRUE,TRUE,TRUE,3,0.6947552631277787,0.76,0.018808014132922643,3,0.41355000003178916,0.47814285714285715,0.967741935483871,0.875,0.001469401399802136,0.004983106412033918,3,0.5827870967926517,0.6116433332602182,0.96875,0.967741935483871,0.007350578300222254,0.005824233160141011,1.2252,1.0468,0.4033,0.8029,1.4065,0.561,0.2925,1.2723229676,1.004891044,0.3970309918666667,0.9689,5.3256,0.3271,2.2012,0.309,-71.9954,0.6149,6.0238,0.3643,3.6894,0.4128,0.987,1.0258387873,2.4712821471333335,5.232228141666667,0.3054351553333333,0.3231073125666667,1.2005,3.7751,0.4351,6.8014,0.5219,0.9854,0.062,0.432,0.447,0.015,1.298,86.53333333333335,1.7883415193333334,3.828695242333333,3.172960076333333,0.3608481612666667,0.3393196453333333,346,1.0251851851851852,1,0,0,1,FALSE,FALSE,FALSE
538,2021-11-13T11:02:35Z,2021-11-13T11:36:33Z,2038,1,2021-11-13T11:36:36Z,1,Firefox,94.0,Windows NT 10.0,1536,864,NA,1.7777777777777777,681,59,615,418,81,97,-0.27800363242124976,-0.2798497999581739,0.9026478347552838,3.819447049719245,0.12506605371351465,-0.14149221663295936,4,4,1,1,4,1,1,3,1,3,4,1,1,1,4,3,1,1,3,3,1.332784974957958,0,0,1,3,4,1.25,0,4,4,3,4,2,1,3,2,2,1,2,4,1,4,5,2,2,1,1,1,1,1,2,0,2,0,0,5,5,2,5,5,5,4,5,4,1,5,2,1,3,2,5,2,2,3,3,3,4,1,1,1,2,1,1,1,2,1,4,2,2,1,1,1,1,1,2,2,1.5673086666181797,1.3201731488169053,1.375,0,1.5,0,1.8666666666666667,0,1.5555555555555556,0,2,0,1.1666666666666667,0,1.4285714285714286,0,1,0,1.6216216216216217,0,0,0,0,-0.7800674290099072,-0.7676277496157452,-0.5804383618435307,-0.6740330557296379,3,2,2,2,2,2,2,3,1,0.3779644730092272,2.4285714285714284,0,2,0.32054096227918905,5,5,5,5,1,1,2,7,4,4,3,1.9880595947760098,3.7142857142857144,0,2.2857142857142856,3.5,3.8333333333333335,3.2559414990859232,-0.4571894270818581,0,-0.3240202744378419,2,2,2,1,2,1,4,2,1,3,1,5,3,3,3,3,4,2,3,5,1.3020130933435712,1.8,0,4.6,0,3.2,0,3.2,0,3.6666666666666665,0,1,2,1,4,1,1,1,4,1,1,1,4,1,2,1,2,1,1,1,1,1.0954451150103321,1.2,0,Black or African American,0,22,0,1,NA,1,3,4,Cybersecurity Analyst,4,0,115,69,1,5,2,1,0,1,0,1,TRUE,TRUE,TRUE,TRUE,TRUE,1,1.0398863636363636,0.88,0.19203139142857142,1,0.382125,0.4494,1,0.9375,0.004019983870967742,0.004958064516129033,1,0.5505,0.6360645161290323,1,1,0.005283032258064516,0.0026567956989247306,1.759,1.1761,0.5041,1.3291,1.2847,0.6526,0.1062,1.687599282,1.0676117938666667,0.5021577409333333,1.0787,4.2062,0.2539,3.7356,0.3192,-78.4302,0.8049,5.0446,0.3034,4.9534,0.3632,0.9616,1.1627246961666666,3.843709962666667,4.4417828083333335,0.3131294456666667,0.25022696866666666,0.8492,4.3399,0.4604,4.7003,0.5571,0.969,0.258,0.278,0.956,0.01,1.255,125.49999999999999,2.0327776016666665,5.263331260666667,5.769775923666667,0.36281851313333335,0.4702860125,385,1.1407407407407408,1,0,0,1,FALSE,FALSE,FALSE
539,2021-11-13T11:04:56Z,2021-11-13T11:40:37Z,2141,1,2021-11-13T11:40:38Z,1,Chrome,95.0.4638.69,Windows NT 10.0,1536,864,Great study. Really made me think over my childhood and just how.....interesting it was.,1.7777777777777777,778,63,862,193,40,100,-0.028775031717708392,-0.24351084670544482,2.091764900920959,1.0775055795594453,-0.4412283913971238,-0.09081811635040013,4,3,1,1,4,1,1,3,1,3,3,1,1,1,4,3,1,1,3,3,1.2258187382102494,0,1,1,5,5,1.35,0,2,4,1,4,1,1,1,3,2,1,2,3,2,3,4,1,3,1,4,1,2,1,1,6,3,4,5,5,1,1,2,1,3,2,2,1,2,5,3,1,1,1,2,1,1,1,3,3,1,3,2,1,4,3,1,3,3,3,5,1,1,1,1,1,2,2,2,2,1.2681120250624975,1.162919151265879,1.75,0,2,0,2.2666666666666666,0,4,0,2.1666666666666665,0,2.8333333333333335,0,1.7142857142857142,0,1,0,2.5945945945945947,0,3,4,5,0.05838317854005811,-0.016438833840269056,1.8944225298484991,0.9389918480041151,1,5,2,5,5,5,5,5,3,1.7320508075688772,4.857142857142857,0,4,2.5114584594654064,3,5,3,5,2,3,3,4,6,1,2,1.1338934190276817,3.4285714285714284,0,2.5714285714285716,4,3.8333333333333335,3.2559414990859232,-0.1748077221195339,0,-0.023487427113806164,2,2,2,1,1,2,4,2,3,1,1,3,1,3,3,1,3,1,3,2,1.01418510567422,1.6,0,4,0,3.6,0,3.4,0,3.6666666666666665,0,1,1,1,4,1,1,1,4,1,1,1,4,1,1,1,4,1,1,1,1,1.231174022502185,1,0,Black or African American,0,30,0,1,NA,1,2,6,self employed,2,0,134,66,1,5,2,0,0,1,0,0,TRUE,TRUE,TRUE,TRUE,TRUE,5,0.8794022727273405,0.88,0.06056987561141217,5,0.4630366666699449,0.5250843750010245,0.9375,1,0.005294561250218902,0.0089502478127288735,5,0.5763281250004657,0.6392531250012107,1,1,0.014669730473774567,0.010128626441645854,1.5467,1.4243,0.4784,1.1353,1.4338,0.6166,0.1786,1.5196250393333333,1.2254751345333332,0.4727887342666667,1.3961,3.6228,0.2871,3.1002,0.2999,-51.9343,1.0601,5.439,0.3605,5.3742,0.4275,0.9826,1.4770398488333334,3.2877722003333334,3.8283550466666667,0.29666763983333333,0.2821322039,1.0766,2.4514,0.4042,4.1178,0.5085,0.8452,0.149,0.271,0.492,0.016,1.409,88.0625,2.180149178,3.98243055,4.206687529,0.30225946686666666,0.3851100577666667,388,1.1496296296296296,1,0,0,1,FALSE,FALSE,FALSE
540,2021-11-13T11:37:47Z,2021-11-13T11:56:56Z,1149,1,2021-11-13T11:56:59Z,1,Edge,95.0.1020.44,Windows NT 10.0,1920,1080,NA,1.7777777777777777,598,38,300,76,43,59,-0.49126109487891917,-0.4706293045350014,-0.6138374925410226,-0.3483039849236506,-0.39979221248658925,-0.7833641535453761,3,4,1,1,3,2,2,3,1,4,3,1,1,1,3,3,1,1,3,3,1.105012502906165,0,0,2,4,4,1.5,0,3,4,1,4,1,1,4,1,1,2,1,4,1,3,4,1,2,1,1,1,1,1,1,0,2,0,0,4,3,5,5,4,5,4,4,5,1,4,1,1,4,1,4,1,1,1,2,2,5,1,1,1,3,3,1,1,1,1,4,1,1,1,1,1,2,1,1,1,1.6065743310164897,1.3972762620115438,1.125,0,1.25,0,1.6666666666666667,0,1.6666666666666667,0,1.4166666666666667,0,1.5,0,1,0,1,0,1.4324324324324325,0,0,0,0,-1.0532468249535052,-1.0423184006878752,-0.6588395645607719,-0.8505789826243235,4,1,4,1,1,1,3,1,1,1.4638501094227998,1.5714285714285714,0,1,-0.5612498234260587,4,4,5,5,3,3,4,6,5,2,3,0.816496580927726,3.7142857142857144,0,2.2857142857142856,3.5,3.8333333333333335,3.2559414990859232,-0.4571894270818581,0,-0.3240202744378419,2,3,2,1,2,1,4,2,1,4,1,4,1,4,2,1,4,2,3,1,1.3451854182690985,2,0,4.4,0,4.2,0,4,0,4.2,0,2,1,2,3,1,3,1,2,1,1,1,2,3,2,1,3,1,2,1,1,0.8013147091860318,1.7,0,"White, Caucasian, Anglo, European American",0,29,0,1,NA,1,3,6,Chemistry Technician,4,0,230,67,3,5,2,0,0,1,0,0,TRUE,TRUE,TRUE,TRUE,TRUE,5,0.8440447368621826,0.76,0.03579383764840281,5,0.43527499997615815,0.530375,1,1,0.0025598561352040694,0.005917362573828543,5,0.6560062499940396,0.7028419355115583,1,0.96875,0.012318906404774649,0.0055682243519408455,1.3799,0.9334,0.4533,0.9955,1.1703,0.615,0.1166,1.413433755,0.9313296308666666,0.4458494753,2.1915,8.088,0.2998,5.3767,0.3266,-93.5925,0.8454,5.9888,0.3653,5.0995,0.4468,0.7537,1.5652023472333334,4.337531164666666,6.268212746333333,0.35302081986666667,0.31651476026666664,0.9725,2.3748,0.5215,8.0097,0.6342,0.926,0.082,0.436,0.39,0.015,1.636,109.06666666666666,2.273721213,3.9094934563333332,3.7996902656666665,0.36376410286666666,0.418103712,297,0.88,1,0,0,1,FALSE,FALSE,FALSE
541,2021-11-13T11:35:07Z,2021-11-13T11:57:59Z,1372,1,2021-11-13T11:58:00Z,1,Chrome,95.0.4638.69,Windows NT 10.0,1280,800,NA,1.6,702,70,352,75,61,78,-0.22404692505244184,-0.17991767851316898,-0.36349705755877526,-0.3604903914576942,-0.15117513902338214,-0.4624281850891678,3,3,2,1,2,1,1,2,1,2,3,1,1,1,2,2,1,1,3,2,0.7863975156570492,0,0,2,4,4,1.85,0,1,3,2,4,1,1,4,2,1,3,3,3,1,3,2,1,3,1,1,2,3,2,2,0,3,0,3,3,1,3,3,2,3,1,1,2,1,4,1,1,4,3,5,2,3,4,4,4,1,4,2,1,1,1,1,1,1,1,5,1,1,1,2,1,2,4,1,1,1.3439889531935545,1.0997835284835873,1.875,0,2,0,2.4,0,3.888888888888889,0,2.3333333333333335,0,2.1666666666666665,0,0.8571428571428571,0,1.3333333333333333,0,2.3783783783783785,0,0,0,3,0.0016459193825419229,0.0016609377420030566,0.10571298428849377,0.05368696101524841,4,2,2,1,1,2,2,3,1,1,2,0,2,0.06413940681375631,3,3,3,3,3,3,2,1,1,NA,2,0.3779644730092272,3.142857142857143,0,2.857142857142857,8,3.8333333333333335,3.2559414990859232,2.0842459175790595,0,1.265381387578364,3,3,3,5,4,3,5,2,1,5,1,5,5,3,3,3,3,2,3,3,1.3557637102737474,3.6,0,4,0,3.4,0,3.6,0,3.6666666666666665,0,1,4,2,1,1,2,1,2,1,1,1,2,2,3,1,3,2,2,3,2,0.8750939799154206,2.05,0,"Hispanic of Latino (e.g., Mexican American, Central American, and others)",0,23,0,1,NA,1,3,6,Teacher,7,0,158,67,2,5,2,0,0,1,0,0,TRUE,TRUE,TRUE,TRUE,TRUE,3,0.8901621621613567,0.74,0.14720522950538478,3,0.43219999999646097,0.509875,1,1,0.002145769677564675,0.0054525929032289595,3,0.6063967741929716,0.6382718750024214,0.96875,1,0.012489445766731362,0.009962725957679275,1.4986,0.697,0.4638,1.4621,0.5086,0.4901,0.0459,1.513386645,0.7576290938133333,0.45712748383333335,2.5923,8.5983,0.2815,5.9024,0.2903,-94.2993,0.8787,6.3772,0.3619,4.7444,0.4284,0.9701,1.5041065896666668,4.375367407666666,6.147223334,0.34114994423333334,0.3155702541666667,1.0048,3.2531,0.4639,3.0747,0.5056,0.9964,0.068,0.419,0.342,0.07,1.619,23.128571428571426,1.757481281,3.6089828836666666,3.6859219043333336,0.38409922686666664,0.40232471216666665,395,1.1703703703703703,1,0,0,1,FALSE,FALSE,FALSE
542,2021-11-13T11:43:29Z,2021-11-13T12:08:56Z,1526,1,2021-11-13T12:08:57Z,0.8999999761581421,Edge,95.0.1020.53,Macintosh,1440,900,NA,1.6,886,51,336,53,55,70,0.24871660617901806,-0.35252770646363196,-0.44052488370715903,-0.6285913352066523,-0.2340474968444512,-0.5975591191759924,3,3,2,2,3,1,1,3,1,3,3,1,1,1,4,4,1,1,4,4,1.2182817926554552,0,0,1,3,3,1.4,0,4,4,2,4,2,1,4,2,1,1,1,5,2,4,4,1,1,1,1,1,1,1,1,4,2,0,0,4,4,4,4,4,4,4,4,4,1,5,1,1,4,2,4,2,3,1,2,2,5,1,1,1,3,2,1,2,2,1,5,1,2,1,1,1,2,1,2,2,1.4451950001949871,1.4375905768565218,1,0,1.75,0,1.6666666666666667,0,2,0,1.6666666666666667,0,1.3333333333333333,0,1.2857142857142858,0,1,0,1.6216216216216217,0,2,0,0,-1.0133206055463637,-1.0147331873138241,-0.0958522115332568,-0.5552926994235404,4,2,3,1,1,2,1,3,1,1.1547005383792515,1.7142857142857142,0,2,-0.10679496349653231,5,5,5,5,3,3,2,6,6,3,2,1.2909944487358056,4.285714285714286,0,1.7142857142857142,3,3.8333333333333335,3.2559414990859232,-0.7395711320441822,0,-0.783895116604751,3,3,3,3,3,3,3,3,2,4,2,3,3,3,3,2,3,3,3,3,0.5163977794943222,3,0,3.2,0,3.4,0,3.2,0,3.2666666666666666,0,1,1,1,2,1,1,1,3,1,1,2,3,2,1,1,3,1,2,1,2,0.7591546545162482,1.45,0,"Asian or Asian American (e.g., Chinese, Japanese, and others)",0,28,0,1,NA,1,3,6,Engineering Specialist,5,0,149,65,4,5,2,0,0,0,0,0,TRUE,TRUE,TRUE,TRUE,TRUE,4,1.0602454545457254,0.88,0.2848381536159569,4,0.4614483870960051,0.5481312499996275,1,1,0.004376727246985211,0.005405173830341796,4,0.6409709677441466,0.7346533333331347,1,0.9375,0.027072118129495344,0.0165335573284663,1.8,1.1091,0.4076,1.6694,1.3649,0.4789,0.2554,NA,NA,NA,1.9987,7.3163,0.3249,4.9968,0.3481,-87.6542,0.7777,6.1924,0.3917,5.2045,0.4769,0.8913,NA,NA,NA,NA,NA,0.8623,3.2675,0.5217,3.1183,0.6284,0.9949,0.085,0.42,0.44,0.006,1.288,214.66666666666666,NA,NA,NA,NA,NA,412,1.2207407407407407,1,0,1,2,FALSE,FALSE,FALSE
543,2021-11-13T11:51:58Z,2021-11-13T12:12:50Z,1251,1,2021-11-13T12:12:51Z,1,Chrome,95.0.4638.69,Windows NT 10.0,1366,768,NA,1.7786458333333333,701,40,255,68,37,88,-0.2266162920700041,-0.45245982790863687,-0.8304782535833521,-0.44579523719599906,-0.4826645703076583,-0.293514517480637,4,4,1,1,3,1,1,3,1,4,3,1,1,1,3,3,1,1,3,3,1.2258187382102494,0,0,2,3,4,1.35,0,4,5,2,5,2,1,5,1,1,1,1,5,2,5,5,1,1,1,1,1,1,1,1,1,2,0,0,5,5,5,5,5,5,5,5,5,2,5,1,1,5,1,5,1,1,1,1,1,5,1,1,1,1,1,1,2,2,2,5,1,1,1,2,1,1,1,2,2,1.88880056320607,1.8516401995451028,1,0,1.5,0,1.2666666666666666,0,1,0,1.0833333333333333,0,0.8333333333333334,0,1.2857142857142858,0,1.3333333333333333,0,1.135135135135135,0,1,0,0,-1.3159193210531184,-1.3956995025428247,-0.3773458880470143,-0.8865226952949194,5,1,5,1,1,1,1,1,1,1.9518001458970664,1,0,1,-0.9031185640466358,5,5,5,5,5,4,1,6,7,6,5,1.4960264830861913,4.857142857142857,0,1.1428571428571428,2.5,3.8333333333333335,3.2559414990859232,-1.0219528370065065,0,-1.2437699587716602,2,3,2,1,2,2,4,1,1,2,3,4,1,4,4,1,4,1,5,2,1.4540583599999397,2,0,4,0,4.2,0,4.4,0,4.2,0,1,1,1,4,2,1,1,4,1,1,2,4,1,1,1,4,1,1,1,1,1.2182817926554552,1.1,0,"White, Caucasian, Anglo, European American",0,28,0,1,NA,1,5,6,Senior Finance Manager,6,0,180,76,3,5,2,0,0,1,0,0,TRUE,TRUE,TRUE,TRUE,TRUE,2,1.4079619047611598,0.875,0.337430857123051,2,0.5520000000004657,0.6295299999992052,1,0.967741935483871,0.003359498709608788,0.005821607569914303,2,0.675268750000745,0.6953870967739532,1,1,0.005533164153221068,0.004019208494626728,2.1515,0.9246,0.6033,1.7972,0.9228,0.7676,0.5958,1.9540757083333333,0.8603953262,0.6094157376666667,1.981,5.8782,0.3835,3.713,0.3736,-65.8333,1.0229,5.5643,0.4652,5.4534,0.5379,0.9945,1.9193328443333333,3.590726914333333,5.397298214666667,0.37115624333333336,0.377232607,0.715,3.5106,0.6042,6.4828,0.6399,0.9835,0.224,0.41,0.835,0.048,0.988,20.583333333333332,2.404310749,5.167227022333333,5.816712859333333,0.4476583531,0.49909928866666664,364,1.0785185185185184,1,0,0,1,FALSE,FALSE,FALSE
544,2021-11-13T11:51:07Z,2021-11-13T12:18:32Z,1644,1,2021-11-13T12:18:33Z,1,Chrome,95.0.4638.69,Windows NT 10.0,1920,1080,very proactive,1.7777777777777777,714,133,399,87,63,107,-0.19321452084169444,0.3924208352173136,-0.13722781824789776,-0.21425351304917153,-0.12355101974969247,0.02742145097557139,2,2,1,3,2,2,4,1,2,3,2,3,1,2,2,3,3,2,3,2,0.7863975156570492,0,1,1,3,4,2.55,0,2,3,4,2,3,3,2,4,2,2,3,2,1,2,2,3,4,1,1,3,4,3,3,1,2,0,0,3,3,4,3,3,4,3,2,2,2,2,3,3,2,2,3,3,3,2,2,3,3,1,1,1,3,2,1,1,1,1,3,1,2,1,3,2,1,2,1,1,0.9021162972775815,0.8338093878327919,2.75,0,1.25,0,3.2666666666666666,0,3,0,2.8333333333333335,0,1.6666666666666667,0,1.2857142857142858,0,2,0,2.3783783783783785,0,1,0,0,0.5459033313009405,0.750139727291256,-0.4557470907642554,0.1471963182635003,3,2,2,3,2,4,3,2,2,0.7559289460184544,3,0,2,0.6624097028997663,5,5,5,5,3,3,4,3,1,NA,2,0.9511897312113419,4,0,2,7,3.8333333333333335,3.2559414990859232,1.5194825076544112,0,0.5049736980874192,4,4,3,4,4,3,4,3,2,3,1,4,4,3,3,2,4,4,3,4,0.9154754164341269,3.8,0,3.6,0,3.2,0,3,0,3.2666666666666666,0,2,2,3,2,2,3,3,3,4,3,2,2,2,1,2,2,3,2,2,3,0.6805570473787206,2.5,0,"Asian or Asian American (e.g., Chinese, Japanese, and others)",0,28,0,1,NA,1,2,4,investor,7,0,120,60,2,5,2,0,0,1,0,0,TRUE,TRUE,TRUE,TRUE,TRUE,2,1.0237947368420857,0.76,0.102978205881785,2,0.6684468750006054,0.6790645161285516,1,1,0.015218304506107078,0.008935555032250832,2,0.7168312499995809,0.7941875000001164,1,1,0.021000371250078725,0.014908065000044194,1.419,0.822,0.5847,1.2497,0.924,0.6666,0.2102,1.4607006026666667,0.8540272383266667,0.5719067056,2.785,4.5038,0.3593,5.9736,0.446,-61.8271,1.142,3.2417,0.5018,5.2783,0.5647,0.9716,2.316481786333333,4.943285812333333,3.9758027516666665,0.44934915523333335,0.3730703496666667,1.1068,2.9454,0.5408,4.0815,0.6544,0.9973,0.236,0.328,0.634,0.011,1.316,119.63636363636365,2.486493603,4.089536549666667,4.425206757,0.4128409322666667,0.519125157,512,1.517037037037037,1,0,5,6,FALSE,FALSE,FALSE
545,2021-11-13T11:52:32Z,2021-11-13T12:20:57Z,1705,1,2021-11-13T12:20:58Z,1,Chrome,95.0.4638.69,Windows NT 10.0,1920,1080,NA,1.7777777777777777,682,82,518,87,72,152,-0.2754342654036875,-0.07090081875498182,0.4356666387307069,-0.21425351304917153,7.57516981911087e-4,0.7875329552139597,3,3,2,2,3,1,2,2,1,3,2,2,1,1,3,2,2,1,2,2,0.7254762501100116,0,1,1,3,2,2,0,4,4,2,4,3,1,5,2,2,1,2,4,2,3,3,1,2,1,1,1,2,2,1,0,2,0,0,5,5,2,4,3,4,3,4,3,1,4,2,1,3,2,3,3,3,2,3,3,4,1,1,1,2,1,1,1,1,1,4,1,2,1,1,1,1,1,1,1,1.2956383286545203,1.2071217242444348,1.375,0,1,0,2,0,2.3333333333333335,0,2.3333333333333335,0,1.1666666666666667,0,1.1428571428571428,0,1,0,1.864864864864865,0,0,0,0,-0.6287680712565301,-0.6057944978213119,-0.7372407672780129,-0.6715176325496623,5,1,3,1,1,2,1,2,2,1.5275252316519468,1.4285714285714286,0,2,-0.2777293338068208,5,5,5,5,3,3,1,6,7,NA,3,1.5735915849388864,4.428571428571429,0,1.5714285714285714,2.5,3.8333333333333335,3.2559414990859232,-1.0219528370065065,0,-1.00475696650735,2,2,2,2,3,2,4,2,2,2,3,4,2,4,4,2,3,2,3,3,0.8618916073713346,2.2,0,3.6,0,3.4,0,3.8,0,3.6,0,1,1,2,3,2,2,1,2,1,1,2,2,2,2,1,2,1,2,2,2,0.5712405705774795,1.8,0,"White, Caucasian, Anglo, European American",0,19,0,1,NA,0,3,3,student,7,0,158,70,2,5,2,0,0,1,0,0,TRUE,TRUE,TRUE,TRUE,TRUE,4,0.8587318181829019,0.88,0.02931388336732563,4,0.48665483870813925,0.5813199999978145,1,0.9375,0.003279467892545811,0.0044111038305952735,4,0.5402312500015832,0.6458357142859271,1,0.9032258064516129,0.004094620927437499,0.007000309999802904,1.2401,1.6698,0.5892,0.9389,2.1277,0.6796,0.2478,1.2813123298333333,1.3452337574666666,0.5774721471,0.9556,5.2719,0.396,3.0759,0.4394,-83.3664,0.7145,5.4873,0.416,5.3329,0.5152,0.7054,1.1310505700666666,3.3910492383333333,5.309892334,0.42625323253333336,0.3829851895333333,1.5338,6.5363,0.4286,10.7802,0.5582,0.715,0.078,0.38,0.524,0.014,2.005,143.2142857142857,1.6348079903333332,4.586609165,2.4249009921333333,0.36428591953333334,0.3463122161,314,0.9303703703703704,1,0,1,2,FALSE,FALSE,FALSE
546,2021-11-13T12:12:12Z,2021-11-13T12:34:01Z,1308,1,2021-11-13T12:34:02Z,1,Chrome,95.0.4638.69,Windows NT 10.0,1536,864,none,1.7777777777777777,680,49,287,94,61,62,-0.28057299943881203,-0.3706971830899965,-0.6764226012865845,-0.12894866731086665,-0.15117513902338214,-0.732690053262817,2,2,3,3,2,3,3,2,2,1,2,3,2,2,1,1,2,2,1,1,0.7254762501100116,0,1,2,2,2,3,0,4,4,3,4,2,3,3,2,3,4,2,3,2,2,2,2,2,1,1,1,1,2,2,2,2,0,0,2,3,3,3,2,4,5,5,3,2,4,3,1,3,2,4,2,2,2,4,3,4,2,1,1,1,1,1,2,1,1,2,3,3,1,1,2,1,2,2,2,1.1892915598853018,0.8338093878327919,1.5,0,1.75,0,2.7333333333333334,0,2.6666666666666665,0,2.3333333333333335,0,1.1666666666666667,0,2,0,1.3333333333333333,0,2.135135135135135,0,1,0,0,-0.3829066149072922,-0.12077869354983783,-0.2989446853297732,-0.20986168943980552,4,2,3,1,1,3,2,1,1,1.1126972805283737,2,0,1,-0.3048482679606258,4,4,4,4,2,2,2,7,6,6,3,1.0690449676496976,3.4285714285714284,0,2.5714285714285716,2.5,3.8333333333333335,3.2559414990859232,-1.0219528370065065,0,-0.4470599845572925,2,2,2,3,3,2,4,2,1,2,2,3,3,2,3,4,5,4,3,3,1.0600988273786194,2.4,0,3.6,0,2.8,0,3.4,0,3.2666666666666666,0,2,4,4,3,4,3,4,2,2,1,3,2,3,3,2,2,1,3,3,3,0.9233805168766387,2.8,0,"Asian or Asian American (e.g., Chinese, Japanese, and others) & Filipino",1,19,0,2,NA,1,3,4,Student,6,0,185,67,2,5,2,0,0,1,0,0,TRUE,TRUE,TRUE,TRUE,TRUE,5,0.7958432432435252,0.7551020408163265,0.05624046252540531,5,0.4797874999997439,0.49769375000032595,1,1,0.007745146290288202,0.003276753508044278,5,0.5913548387096774,0.6956812499999069,1,1,0.012920134559127829,0.024543887378926047,1.237,0.9438,0.4874,1.1467,0.6455,0.5234,0.0574,1.2914313327333333,0.9421216606333334,0.47803432236666665,3.1351,5.6677,0.2032,8.4554,0.3123,-84.8148,0.7906,5.3939,0.4078,5.1627,0.4222,0.8674,1.7620643306666666,5.923196019666666,4.189524993666667,0.3567639263,0.2671863698,1.1096,4.124,0.4625,3.5898,0.5339,0.9963,0.266,0.188,0.669,0.013,1.402,107.84615384615384,2.3655357716666665,4.262573497666667,3.7021575716666666,0.31472370623333334,0.3785068087,384,1.1377777777777778,1,0,0,1,FALSE,FALSE,FALSE
547,2021-11-13T12:18:35Z,2021-11-13T12:40:03Z,1288,1,2021-11-13T12:40:04Z,0.8999999761581421,Safari,14.0.2,Macintosh,1440,900,No.,1.6,646,146,243,90,26,74,-0.3679314780359296,0.510522433288683,-0.88824912319464,-0.17769429344704088,-0.6345972263129516,-0.5299936521325801,3,4,1,1,3,1,1,4,1,4,3,1,1,1,4,4,1,1,3,3,1.332784974957958,0,0,3,4,4,1.25,0,5,5,1,5,1,1,5,1,1,1,1,5,2,5,5,1,1,1,1,1,1,1,1,0,2,0,0,5,5,5,5,5,5,5,5,5,1,5,1,1,5,1,5,1,1,1,1,1,5,1,1,1,3,1,1,1,2,1,5,1,1,1,1,1,1,1,1,1,1.935910056729844,2.016597794967223,1,0,1,0,1.0666666666666667,0,1,0,1,0,1.1666666666666667,0,1,0,1,0,1.0810810810810811,0,0,0,0,-1.3495414005538688,-1.5048788733706477,-0.7372407672780129,-1.1210598203243303,5,1,4,1,1,1,1,2,1,1.7320508075688772,1.1428571428571428,0,1.5,-0.6331575415043005,5,5,5,5,3,3,1,6,4,5,3,1.5735915849388864,4.428571428571429,0,1.5714285714285714,4,3.8333333333333335,3.2559414990859232,-0.1748077221195339,0,-0.5811844090638635,1,1,1,1,1,1,4,1,1,4,1,5,1,5,4,1,5,3,5,3,1.7511900715418263,1,0,4.6,0,4.6,0,4.4,0,4.533333333333333,0,1,1,1,1,1,1,1,4,1,1,1,3,1,1,1,4,1,2,2,1,1,1.3,0,"White, Caucasian, Anglo, European American",0,26,0,1,NA,1,3,8,Physical Therapist,5,0,181,72,3,5,2,0,0,1,0,0,TRUE,TRUE,TRUE,TRUE,TRUE,3,0.853222222222219,0.72,0.05047873632653007,3,0.6358064516128938,0.6919677419354802,1,0.96875,0.06888222795698552,0.04634904737903334,3,0.6349999999999977,0.7778750000000013,1,1,0.008516451612903424,0.025245016129032394,1.2901,0.7454,0.4761,1.0067,0.8239,0.6158,0.4495,1.3427960656666666,0.81463526838,0.4664376506333333,1.5966,2.1473,0.264,2.1634,0.3378,-8.2339,1.5547,1.4689,0.2431,2.8662,0.418,0.2332,1.618184494,2.2978385566666666,2.3476394033333334,0.33810762256666665,0.2685041929,1.2319,4.7672,0.5104,2.3644,0.5634,0.9935,0.124,0.355,0.436,0.009,1.394,154.88888888888889,2.6279580263333333,4.740873593,3.4526674183333332,0.36094266006666664,0.3982377442666667,370,1.0962962962962963,1,0,0,1,FALSE,FALSE,FALSE
548,2021-11-13T12:25:19Z,2021-11-13T12:47:50Z,1351,1,2021-11-13T12:47:52Z,1,Chrome,95.0.4638.69,Windows NT 10.0,1536,864,NA,1.7777777777777777,552,61,447,74,78,81,-0.6094519776867842,-0.26168032333180935,0.09385566019725369,-0.37267679799173775,0.08362987480298012,-0.4117540848066085,1,3,2,2,1,2,2,2,1,1,1,1,2,1,1,1,1,1,1,1,0.5982430416161189,0,0,4,4,3,2.6,0,2,5,4,4,3,1,2,4,4,3,4,2,2,2,4,2,4,1,1,3,4,4,3,3,2,0,2,4,4,2,3,2,3,3,4,2,2,4,3,1,3,3,2,5,5,3,4,4,2,4,1,1,2,1,1,4,4,1,4,1,1,1,1,4,2,2,1,1,1.313478292635712,1.162919151265879,2.75,0,1.5,0,3.066666666666667,0,3,0,3.25,0,2,0,1.8571428571428572,0,2,0,2.675675675675676,0,2,0,2,0.7308247685550677,0.7919531033529758,0.1786458795478636,0.4852994914504197,5,1,5,2,1,1,1,8,5,1.889822365046136,1.1428571428571428,0,6.5,1.2117808323676102,5,5,5,5,2,2,1,7,7,6,4,1.8126539343499315,4.142857142857143,0,1.8571428571428572,2,3.8333333333333335,3.2559414990859232,-1.3043345419688306,0,-0.9866058241456384,3,3,3,3,3,3,5,4,3,3,1,3,2,2,2,1,4,1,5,1,1.3972762620115438,3,0,4,0,4.4,0,2.8,0,3.7333333333333334,0,1,1,3,2,2,3,3,2,3,3,3,1,1,4,1,1,1,4,3,1,1.0894228312566052,2.55,0,"Asian or Asian American (e.g., Chinese, Japanese, and others)",0,22,0,1,NA,0,4,4,Student/Freelance Worker,6,0,178,71,2,5,2,0,0,0,0,0,TRUE,TRUE,TRUE,TRUE,TRUE,1,0.5347031250009313,0.64,0.017482915203942465,1,0.3884238095219646,0.45026666666788084,0.8076923076923077,0.84375,0.005704336246295274,0.005045020715512337,1,0.5294774193576267,0.5708318181823601,0.96875,0.6875,0.008620769677208033,0.007715100876867076,1.0957,0.5504,0.257,0.6854,0.7073,0.4378,0.3543,1.1522358753333333,0.7193637246733333,0.25153403756666665,0.84,1.9559,0.2429,1.9887,0.2979,-39.5658,0.6653,2.6166,0.2989,3.2045,0.3572,0.9391,0.8878131477333333,2.2935788724333332,2.4768805833666665,0.29466253060000003,0.2401060936,0.7278,3.7565,0.4484,1.2378,0.4534,0.968,0.052,0.356,0.27,0.003,1.106,368.6666666666667,1.1005681733333332,3.0745234446666667,1.1428048958823334,0.35287568333333336,0.33590611233333334,378,1.12,1,0,0,1,FALSE,FALSE,FALSE
549,2021-11-13T12:30:30Z,2021-11-13T12:49:37Z,1147,1,2021-11-13T12:49:39Z,1,Chrome,95.0.4638.69,Windows NT 10.0,2560,1080,NA,2.3703703703703702,625,40,272,25,31,61,-0.42188818540473755,-0.45245982790863687,-0.7486361883006943,-0.9698107181598719,-0.5655369281287274,-0.74958142002367,4,3,1,2,3,1,1,3,2,3,4,2,1,2,3,3,1,2,3,3,0.9880869341680844,0,1,1,4,4,1.65,0,4,3,2,3,4,2,4,2,2,1,1,5,1,4,4,1,2,3,1,1,1,1,1,1,2,0,1,5,5,5,5,4,4,5,4,4,3,4,2,2,4,4,2,2,3,4,2,3,2,4,1,1,2,1,1,2,1,1,4,3,1,1,1,1,1,1,1,1,1.4555475322429765,1.3201731488169053,1.375,0,1,0,2,0,1.4444444444444444,0,2.75,0,2,0,1.4285714285714286,0,1,0,1.972972972972973,0,1,0,1,-0.5615239122550293,-0.5593351910860681,-0.35769864658231576,-0.45851691883419193,5,1,3,1,1,2,1,1,1,1.5275252316519468,1.4285714285714286,0,1,-0.6467170085812028,5,5,5,5,2,2,1,7,7,4,4,1.8126539343499315,4.142857142857143,0,1.8571428571428572,2,3.8333333333333335,3.2559414990859232,-1.3043345419688306,0,-0.9866058241456384,2,2,2,1,3,2,3,3,4,2,3,3,4,2,4,3,3,2,4,4,0.7988086367179802,2,0,3.4,0,2.8,0,2.6,0,2.933333333333333,0,2,2,3,2,2,1,3,3,1,2,2,3,2,1,2,3,1,1,1,1,0.7880689256524124,1.8,0,"White, Caucasian, Anglo, European American",0,27,0,1,NA,1,4,7,Architect,3,0,175,70,3,5,2,0,0,1,0,0,TRUE,TRUE,TRUE,TRUE,TRUE,NA,NA,NA,NA,1,0.426227586203608,0.4650607142874173,0.90625,0.9032258064516129,0.007057502732157948,0.008650555161548263,1,0.5261580645192054,0.6384379310320164,1,0.90625,0.0064960525166728135,0.014459484827592706,NA,NA,NA,NA,NA,NA,NA,NA,NA,NA,0.9759,2.5599,0.2686,2.597,0.3043,-48.8197,0.8286,4.4207,0.3277,3.4179,0.3418,0.8921,NA,NA,NA,NA,NA,0.9524,3.7083,0.4138,3.8255,0.5059,0.9085,0.059,0.372,0.423,0.007,1.374,196.2857142857143,NA,NA,NA,NA,NA,104,0.3081481481481481,1,0,4,5,FALSE,TRUE,FALSE
550,2021-11-13T12:42:45Z,2021-11-13T13:05:18Z,1352,1,2021-11-13T13:05:18Z,1,Chrome,95.0.4638.69,Windows NT 10.0,1920,1080,NA,1.7777777777777777,657,46,388,93,58,65,-0.3396684408427445,-0.39795139802954327,-0.19018444872491164,-0.14113507384491022,-0.19261131793391667,-0.6820159529802577,4,1,1,1,4,1,1,1,1,4,2,1,1,1,4,1,1,1,1,2,1.2182817926554552,0,1,2,3,1,1.8,0,5,5,1,5,1,1,5,1,1,2,1,5,1,5,1,1,1,1,1,1,1,1,1,4,1,1,1,1,3,2,3,1,5,1,5,3,1,5,2,1,3,1,5,1,1,2,2,2,3,1,1,1,3,1,1,3,3,3,5,1,1,1,1,1,1,1,2,2,1.404625563263382,1.9880595947760098,1,0,1.5,0,1.3333333333333333,0,3.3333333333333335,0,1.5,0,1.5,0,1.7142857142857142,0,1,0,2,0,2,1,1,-0.7779660490411104,-0.9953751428408057,0.20882944024170652,-0.3932728512995496,5,1,3,1,1,3,1,1,1,1.5735915849388864,1.5714285714285714,0,1,-0.5612498234260587,5,5,5,5,4,4,1,6,4,2,3,1.4638501094227998,4.714285714285714,0,1.2857142857142858,4,3.8333333333333335,3.2559414990859232,-0.1748077221195339,0,-0.740526403906737,3,2,3,2,3,3,3,3,3,2,5,1,3,3,3,5,3,5,2,3,1.1254628677422756,2.6,0,1.8,0,2.2,0,3,0,2.3333333333333335,0,1,1,3,1,4,4,4,1,2,1,2,1,1,2,1,2,1,4,1,4,1.2763022245616642,2.55,0,Black or African American,0,23,0,1,NA,1,1,4,Student,1,0,215,75,1,5,2,0,0,1,0,0,TRUE,TRUE,TRUE,TRUE,TRUE,NA,NA,NA,NA,6,0.45246875,0.4718206896553266,1,0.9354838709677419,0.0026143989920432526,0.002882104322530447,6,0.596581250000745,0.6666187499999069,1,1,0.003449082217791571,0.0033481725403485124,NA,NA,NA,NA,NA,NA,NA,NA,NA,NA,0.9986,4.9667,0.3519,3.883,0.3554,-89.2917,0.7185,5.0422,0.3873,5.4852,0.4069,0.9633,1.0997797794666666,3.9977449733333335,5.062457438333333,0.3483018311666667,0.3457883401,0.8002,5.276,0.5253,5.3912,0.5962,0.8022,0.138,0.4,0.717,0.024,1.867,77.79166666666667,2.1545518497666665,5.763391698666666,5.381472201666667,0.41663797103333333,0.47578944523333333,356,1.0548148148148149,1,1,4,5,FALSE,FALSE,FALSE
551,2021-11-13T12:42:32Z,2021-11-13T13:09:33Z,1621,1,2021-11-13T13:09:35Z,1,Chrome,95.0.4638.69,Macintosh,1280,800,"In the last game, there were times when the arrow was not visible. I think it was off the screen, so I had to guess the direction blindly. If this was not intended, you should probably disregard arrows that were either placed very high or very low.",1.6,750,78,382,87,70,124,-0.1007173082094523,-0.10723977200771087,-0.21906988353055556,-0.21425351304917153,-0.026866602291778594,0.31457468591007365,2,2,3,3,1,2,3,2,1,2,2,3,2,2,2,2,3,2,2,2,0.5871429486123998,0,0,4,4,2,2.75,0,4,4,3,4,4,1,4,1,2,1,2,4,3,5,3,2,3,1,1,2,1,2,2,0,2,0,0,5,5,5,5,3,5,4,5,4,2,5,3,1,4,2,5,2,3,4,3,5,5,1,1,1,3,2,1,1,1,1,5,2,2,1,2,1,2,2,1,1,1.624234631492057,1.3093073414159542,1.75,0,1.5,0,2.066666666666667,0,1.4444444444444444,0,2.4166666666666665,0,1.3333333333333333,0,1.1428571428571428,0,1.3333333333333333,0,1.7297297297297298,0,0,0,0,-0.4795700934719498,-0.47406300518242234,-0.5804383618435307,-0.5272506835129765,4,1,3,1,1,2,1,1,1,1.2149857925879117,1.5714285714285714,0,1,-0.5612498234260587,4,4,4,3,1,2,5,4,6,3,3,1.3801311186847085,2.7142857142857144,0,3.2857142857142856,4,3.8333333333333335,3.2559414990859232,-0.1748077221195339,0,0.3748675599933774,2,2,2,2,2,2,5,3,2,2,2,4,3,4,5,4,4,2,3,3,1.082325538564332,2,0,4,0,3,0,3.8,0,3.6,0,3,3,4,2,4,4,4,2,1,4,1,2,2,3,2,2,1,3,2,4,1.0894228312566052,2.85,0,"White, Caucasian, Anglo, European American",0,29,0,1,NA,1,3,6,Student/English Teacher,1,0,165,73,2,5,2,0,0,0,0,0,TRUE,TRUE,TRUE,TRUE,TRUE,1,0.9535911764701938,0.6938775510204082,0.06839352474464175,NA,NA,NA,NA,NA,NA,NA,1,0.7346096774188261,0.794953125,1,1,0.004798773569899081,0.006278752247980209,1.3125,0.676,0.5572,0.9775,0.7699,0.69,0.1875,1.3627654086666667,0.7687177896833334,0.5480108169,NA,NA,NA,NA,NA,NA,NA,NA,NA,NA,NA,NA,NA,NA,NA,NA,NA,0.8138,4.6352,0.6553,3.8194,0.7,0.9943,0.182,0.508,0.831,0.025,1.674,66.96,2.6877360213333334,5.710467383,5.340077311,0.5061343529333333,0.5520483208333333,382,1.1318518518518519,1,1,1,2,FALSE,FALSE,FALSE
552,2021-11-13T12:53:12Z,2021-11-13T13:11:00Z,1067,1,2021-11-13T13:11:01Z,1,Chrome,95.0.4638.69,Macintosh,1680,1050,NA,1.6,566,27,228,51,24,55,-0.5734808394409122,-0.5705614259800063,-0.9604627102087498,-0.6529641482747395,-0.6622213455866413,-0.8509296205887885,4,4,1,1,4,1,1,4,1,4,4,1,1,1,4,4,1,1,4,4,1.538967528127731,0,0,2,2,2,1,0,4,5,3,4,2,2,4,2,2,2,2,4,2,4,4,2,3,1,1,1,2,3,2,1,2,0,0,4,4,4,4,4,4,3,4,4,2,4,2,1,4,1,5,3,2,2,2,3,4,1,1,1,1,1,1,2,2,1,4,1,2,1,1,1,1,1,2,2,1.34566370643293,1.0997835284835873,1.875,0,1.5,0,2,0,2.111111111111111,0,1.9166666666666667,0,1,0,1.4285714285714286,0,1,0,1.7027027027027026,0,1,0,0,-0.41863007437683963,-0.46060916427367454,-0.3773458880470143,-0.41897752616034445,4,2,3,2,2,2,2,1,1,0.7867957924694432,2.142857142857143,0,1,-0.21938108280548152,5,5,5,5,3,3,1,6,7,6,4,1.5735915849388864,4.428571428571429,0,1.5714285714285714,2.5,3.8333333333333335,3.2559414990859232,-1.0219528370065065,0,-1.00475696650735,2,3,3,2,2,3,5,2,2,3,2,4,2,4,4,2,4,2,4,2,1.0690449676496976,2.4,0,3.8,0,4,0,4,0,3.933333333333333,0,1,1,1,4,1,1,1,4,1,1,2,4,1,1,1,4,1,1,1,1,1.2258187382102494,1.05,0,"White, Caucasian, Anglo, European American",0,30,0,1,NA,1,5,7,entrepreneur,6,0,125,69,3,5,2,0,0,1,0,0,TRUE,TRUE,TRUE,TRUE,TRUE,3,0.620389999999851,0.8163265306122449,0.023464337840232028,3,0.4382741935479064,0.4765740740740741,0.96875,0.8709677419354839,0.0019534101613117123,0.003204230473135126,3,0.5744937499995576,0.6431032258066679,1,0.96875,0.005924385120974626,0.00264020028232135,1.1505,1.3992,0.3788,0.9055,1.3786,0.4529,0.1133,1.1964044358666666,1.1909157349666666,0.37150880703333333,0.8001,4.0202,0.3432,2.7452,0.3568,-78.2859,0.6735,5.9576,0.3837,4.5656,0.4041,0.9448,0.8793637655,3.0321688284,4.287471374333333,0.3509473040666667,0.3384426873333333,1.0416,4.3594,0.4683,7.6905,0.5744,0.9508,0.098,0.403,0.612,0.017,1.839,108.17647058823529,1.8584815283333334,4.217449275666667,4.673431703333334,0.3547762164666667,0.46016265986666666,396,1.1733333333333333,1,0,0,1,FALSE,FALSE,FALSE
553,2021-11-13T12:32:44Z,2021-11-13T13:12:16Z,2371,1,2021-11-13T13:12:16Z,1,Chrome,95.0.4638.69,Windows NT 10.0,1920,1080,everything was ok,1.7777777777777777,773,101,838,305,148,155,-0.041621866805519804,0.10170920919548118,1.9762231616983832,2.4423831113723233,1.050474049382119,0.838207055496519,4,4,2,2,3,1,2,3,1,2,3,2,2,3,3,3,3,1,2,2,0.8825799501580878,0,1,1,2,3,2,0,2,4,2,3,2,1,5,2,2,3,1,4,3,4,3,2,2,1,1,1,1,1,2,1,2,0,0,4,3,3,5,3,5,3,5,5,1,5,1,1,3,2,3,1,2,1,3,3,4,1,1,1,1,1,1,1,1,1,4,1,2,1,1,1,2,1,1,1,1.4881917600614225,1.162919151265879,1.375,0,1.25,0,2.2,0,2,0,1.8333333333333333,0,1,0,1.1428571428571428,0,1,0,1.5945945945945945,0,1,0,0,-0.7968784687602826,-0.6359930471992205,-0.4557470907642554,-0.545870068981738,5,2,3,1,1,1,1,1,1,1.5275252316519468,1.4285714285714286,0,1,-0.6467170085812028,4,3,3,4,3,3,2,7,7,2,3,0.6900655593423543,3.4285714285714284,0,2.5714285714285716,2,3.8333333333333335,3.2559414990859232,-1.3043345419688306,0,-0.5882508370384546,1,3,1,2,3,2,2,2,1,1,2,3,1,4,4,2,3,4,3,2,1.0555973258234952,2,0,3.2,0,3,0,4.2,0,3.466666666666667,0,2,2,1,1,1,1,1,3,1,1,3,3,2,1,2,3,1,2,1,1,0.812727700887249,1.65,0,"White, Caucasian, Anglo, European American",0,21,0,1,NA,1,3,3,chemistry,2,0,154,72,2,5,2,0,0,2,0,0,TRUE,TRUE,TRUE,TRUE,TRUE,2,0.8295718750000014,0.6666666666666666,0.05659983913120998,2,0.4134218750000182,0.4512066666666884,1,0.967741935483871,0.0032892998286300577,0.002219417784945034,2,0.6321749999999774,0.7075624999999891,1,1,0.008266066451609428,0.009483995967740827,1.373,0.5252,0.3806,1.2603,0.4953,0.4631,0.3022,1.4071179386666666,0.659538975186,0.37461460733333335,0.9928,4.9363,0.3129,4.9432,0.3572,-98.5253,0.8186,5.8817,0.3401,5.902,0.3805,0.9978,1.0777797619666667,4.777291847666667,4.997220209,0.35007764593333335,0.30747156416666666,0.8991,4.5277,0.5374,3.5205,0.5878,0.9617,0.248,0.28,0.698,0.014,1.289,92.07142857142857,2.443026828333333,4.78022105,4.653152003333333,0.38024632783333334,0.45155957366666666,104,0.3081481481481481,1,1,4,5,FALSE,FALSE,FALSE
554,2021-11-13T12:53:12Z,2021-11-13T13:13:25Z,1213,1,2021-11-13T13:13:26Z,1,Chrome,95.0.4638.69,Windows NT 10.0,1920,1080,"Very interesting survey, I enjoyed participating!",1.7777777777777777,634,40,287,65,49,63,-0.39876388224667697,-0.45245982790863687,-0.6764226012865845,-0.4823544567981297,-0.31691985466552025,-0.7157986865019639,4,4,1,1,4,1,1,4,1,4,3,1,1,1,4,4,1,1,3,4,1.465390194130093,0,1,1,4,4,1.1,0,3,3,4,3,4,3,2,3,3,3,3,2,2,2,2,2,3,1,1,2,2,2,2,2,2,0,0,3,2,2,2,3,4,3,3,3,2,3,4,1,3,4,4,4,4,4,4,4,2,1,1,1,3,1,1,3,3,3,2,4,3,1,1,2,1,1,2,2,1.1109609508143095,0.6761234037828132,1.875,0,1.5,0,3.3333333333333335,0,3.2222222222222223,0,3.25,0,1.6666666666666667,0,2.857142857142857,0,1.3333333333333333,0,2.810810810810811,0,1,0,0,0.27062255538854535,0.5885968461639186,-0.3773458880470143,0.10562547905845215,5,1,5,2,1,1,1,3,2,1.889822365046136,1.1428571428571428,0,2.5,-0.2641698667299184,5,5,5,5,4,4,1,6,6,3,3,1.4638501094227998,4.714285714285714,0,1.2857142857142858,3,3.8333333333333335,3.2559414990859232,-0.7395711320441822,0,-1.022908108869061,2,2,2,2,2,2,4,2,2,4,3,3,1,4,4,1,3,3,4,2,1.082325538564332,2,0,3.2,0,4.4,0,4,0,3.8666666666666667,0,2,2,1,4,3,1,2,3,1,1,2,3,1,1,1,3,1,1,1,2,0.9514531821875089,1.5,0,"Hispanic of Latino (e.g., Mexican American, Central American, and others)",0,28,0,1,NA,1,3,6,IT Department Manager,3,0,200,63,2,5,2,0,0,1,0,0,TRUE,TRUE,TRUE,TRUE,TRUE,1,0.7694214285725639,0.84,0.056477901730050725,1,0.4450093750003725,0.53235172413752,1,0.90625,0.0014056299092707056,0.005308950604895392,1,0.6472066666662692,0.6919281250019558,1,1,0.0020768234023330976,0.007300171119098916,1.3788,1.2466,0.4117,1.3255,1.4034,0.4347,0.0826,1.3987994333333333,1.1257794001333334,0.4050913616,1.2393,6.6423,0.3517,2.4425,0.3165,-75.6299,0.732,7.0636,0.3951,4.2475,0.4544,0.9609,1.2872306349666667,2.6398007153,6.076238819333334,0.31393624536666664,0.3443348103,1.0477,6.4912,0.5673,3.7872,0.5646,0.9916,0.083,0.51,0.579,0.032,1.215,37.96875,2.0136431804,6.398967984333333,4.636637166,0.49919090843333336,0.482143804,284,0.8414814814814815,1,0,0,1,FALSE,FALSE,FALSE
555,2021-11-13T12:49:21Z,2021-11-13T13:21:51Z,1949,1,2021-11-13T13:21:52Z,1,Chrome,95.0.4638.69,Macintosh,1280,800,n/a,1.6,816,100,527,130,73,87,0.06886091494965832,0.09262447088229891,0.4789947909391728,0.3097619679147013,0.014569576618755927,-0.31040588424149007,2,1,1,2,1,2,3,1,2,1,1,3,2,2,3,2,1,2,1,2,0.7163503994113789,0,1,2,3,2,2.75,0,1,2,2,3,2,2,3,4,3,3,3,4,3,1,2,2,3,1,3,4,2,3,2,0,6,3,2,4,2,1,2,3,2,2,1,3,2,2,2,1,1,2,2,3,4,3,2,1,2,1,1,1,1,1,1,1,1,1,3,2,2,3,3,2,2,1,1,1,0.8937554468638492,0.9154754164341269,2.5,0,1.25,0,3.2,0,3.7777777777777777,0,2.75,0,1.3333333333333333,0,1.4285714285714286,0,2.6666666666666665,0,2.5675675675675675,0,0,3,2,0.5080784918625958,0.6953564614326144,0.3139593520166609,0.5046579067246377,3,2,3,2,3,3,2,3,3,0.5345224838248488,2.5714285714285716,0,3,0.7749958222087157,4,3,3,2,1,1,1,1,3,NA,2,1.2149857925879117,2.7142857142857144,0,3.2857142857142856,7,3.8333333333333335,3.2559414990859232,1.5194825076544112,0,1.22201267488035,4,3,3,2,2,1,2,1,3,2,1,4,2,3,3,1,3,2,3,4,1.0465362369445672,2.8,0,4.2,0,3.2,0,3.2,0,3.533333333333333,0,2,1,2,1,2,3,2,2,1,2,2,1,2,1,1,2,1,1,1,3,0.6708203932499369,2.05,0,"Asian or Asian American (e.g., Chinese, Japanese, and others)",0,25,0,1,NA,1,2,6,retail worker,1,0,135,65,3,5,2,0,0,1,0,0,TRUE,TRUE,TRUE,TRUE,TRUE,1,0.6256727272730433,0.6875,0.033821862907753734,NA,NA,NA,NA,NA,NA,NA,1,0.8166481481481481,1.0871312499996275,0.84375,0.5161290322580645,0.22685538684484682,0.3263969162365287,1.2501,0.6647,0.2664,0.9462,1.0295,0.4097,0.2988,1.2954237863333333,0.77140668995,0.2611150066333333,NA,NA,NA,NA,NA,NA,NA,NA,NA,NA,NA,NA,NA,NA,NA,NA,NA,1.3461,1.174,0.4228,0.2612,0.4247,0.9707,0.076,0.303,0.048,0.328,1.71,5.213414634146341,1.640171457,1.0670211744,0.16975968018152,0.22468747963333333,0.31444464963333335,386,1.1437037037037037,1,0,1,2,FALSE,FALSE,FALSE
556,2021-11-13T13:03:48Z,2021-11-13T13:26:34Z,1365,1,2021-11-13T13:26:36Z,1,Firefox,91.0,Windows NT 10.0,1366,768,NA,1.7786458333333333,847,42,215,32,24,90,0.14851129249408906,-0.43429035128227234,-1.0230478189543117,-0.884505872421567,-0.6622213455866413,-0.2597317839589309,3,3,3,2,4,1,2,3,1,3,2,2,2,2,3,3,2,2,4,3,0.8271701918685112,0,0,5,4,4,1.9,0,4,3,3,3,3,1,3,4,3,3,3,3,3,3,4,3,3,3,3,3,3,4,3,5,2,4,5,4,3,5,3,4,3,3,4,4,3,4,3,3,4,4,3,3,3,3,3,3,3,4,3,1,4,3,4,4,4,4,4,3,3,3,3,3,2,3,3,3,0.6811490027622179,0.7037315505489968,3.125,0,2.75,0,2.8,0,2.3333333333333335,0,2.9166666666666665,0,2.8333333333333335,0,3.2857142857142856,0,3,0,2.891891891891892,0,3,4,5,1.0985662630945265,0.9314278137810728,2.1296261380002224,1.5305269758906475,4,1,4,1,1,3,3,1,1,1.3972762620115438,1.8571428571428572,0,1,-0.39031545311577004,3,3,3,3,3,2,3,4,4,2,3,0.3779644730092272,2.857142857142857,0,3.142857142857143,5,3.8333333333333335,3.2559414990859232,0.38995568780511447,0,0.5775782675342649,3,3,2,2,2,3,3,3,3,3,3,3,2,3,3,3,3,3,3,3,0.2581988897471611,2.4,0,3,0,3.2,0,3,0,3.066666666666667,0,2,2,2,2,2,2,2,2,2,2,2,2,2,2,2,2,2,2,2,2,0,2.2,0,"White, Caucasian, Anglo, European American",0,27,0,1,NA,1,2,2,Mturker,1,0,200,65,2,5,2,0,0,1,0,0,TRUE,TRUE,TRUE,TRUE,TRUE,3,0.8822758620689655,0.6304347826086957,0.13927399855072467,3,0.5918064516129032,0.6290967741935484,1,0.96875,0.023001294623655914,0.011381419354838707,3,0.64925,0.7821333333333333,1,0.967741935483871,0.011209999999999998,0.010897346236559139,1.3434,0.3994,0.4874,1.2666,0.2015,0.5079,0.0375,1.3894360966666666,0.580635551773,0.4768267642,1.2406,3.4011,0.4095,3.1779,0.4415,-55.0118,1.0797,3.1421,0.4198,3.8811,0.4866,0.9848,1.5320351352333332,3.5151401163333333,3.7594501586666667,0.41811662196666666,0.3824824244,1.1045,4.6439,0.5202,4.8283,0.6604,0.9173,0.095,0.452,0.548,0.011,1.792,162.90909090909093,1.973024513,4.666253262666666,3.31130923,0.4404219054,0.4961426384,350,1.0370370370370372,1,1,2,3,FALSE,FALSE,FALSE
557,2021-11-13T13:10:55Z,2021-11-13T13:42:41Z,1906,1,2021-11-13T13:42:44Z,1,Chrome,95.0.4638.69,Windows NT 10.0,1366,768,no,1.7786458333333333,866,76,588,105,49,83,0.1973292658277724,-0.1254092486340754,0.7726633781298861,0.0051018045636124325,-0.31691985466552025,-0.3779713512849024,4,4,1,1,1,1,1,3,1,4,4,1,1,1,4,4,1,4,4,4,1.5035046776746235,0,0,3,3,4,1.35,0,1,2,2,2,3,1,5,1,1,1,2,3,3,3,3,1,1,1,2,1,1,1,1,1,1,4,0,2,3,2,5,1,5,5,5,5,1,4,5,1,2,1,1,3,1,1,1,1,1,4,5,1,3,3,2,1,1,1,5,1,1,2,3,1,3,2,4,2,1.6251588048991217,1.1464230084422218,1.125,0,2.75,0,2.466666666666667,0,2.3333333333333335,0,2.1666666666666665,0,3.3333333333333335,0,1,0,2,0,2.2162162162162162,0,1,4,0,-0.565726672192623,-0.36168955701655103,0.8411929559112861,0.23975169944736752,2,4,1,5,2,3,5,8,4,1.5735915849388864,4,0,6,2.736630698083305,1,3,3,2,1,1,5,1,2,1,1,1.4960264830861913,1.7142857142857142,0,4.285714285714286,7.5,3.8333333333333335,3.2559414990859232,1.8018642126167355,0,1.9209005093115694,2,2,3,2,2,1,4,3,1,1,1,3,1,4,3,5,4,1,4,5,1.5796322658258457,2.2,0,4.4,0,3,0,3.2,0,3.533333333333333,0,1,1,1,4,1,1,1,4,1,1,1,3,1,2,1,3,1,1,1,1,1.050062654772261,1.15,0,Black or African American,0,22,0,1,NA,1,2,5,Unemployed,1,0,230,69,1,5,2,0,0,2,0,0,TRUE,TRUE,TRUE,TRUE,TRUE,5,1.3422696969716839,0.66,0.2534461520660866,5,0.6191656249994412,0.7142548387108311,1,1,0.009546255876275455,0.011792842559204183,5,0.8351656249966473,1.064777419356569,1,1,0.04604045458633045,0.12031538580424916,1.8591,0.3597,0.6025,1.9051,0.2245,0.5925,0.2623,1.8104612993333333,0.46253425878933335,0.5933814811,1.9723,4.7765,0.4127,4.1436,0.4763,-61.7638,1.0093,4.065,0.4926,4.082,0.5921,0.914,2.198799697,4.079410289666667,4.728857561,0.44623218433333334,0.3872512072666667,1.9684,3.5927,0.5287,1.4685,0.5311,0.9127,0.127,0.433,0.294,0.009,1.495,166.11111111111114,2.747070234,3.444753098666667,2.1839664668,0.4313832841,0.4224057945333333,332,0.9837037037037036,1,0,0,1,FALSE,FALSE,FALSE
558,2021-11-13T13:16:23Z,2021-11-13T13:44:48Z,1704,1,2021-11-13T13:44:50Z,1,Chrome,95.0.4638.69,Windows NT 10.0,1920,1080,none,1.7777777777777777,712,109,546,107,77,86,-0.198353254876819,0.1743871157009393,0.5704653344903786,0.02947461763169954,0.06981781516613529,-0.3272972510023432,4,4,1,1,4,1,2,2,1,4,4,1,1,2,4,4,1,1,2,3,1.348488432516786,0,0,1,5,5,1.35,0,5,5,2,4,3,1,1,4,1,1,1,5,1,5,3,1,1,1,1,1,1,1,1,4,2,0,0,5,5,5,3,1,5,5,5,5,1,5,3,1,2,2,5,1,1,1,1,1,1,1,1,1,1,1,1,1,1,5,5,1,1,1,1,1,1,1,2,2,1.8137777674758806,1.740279123753264,1,0,1.5,0,1.8666666666666667,0,1.6666666666666667,0,1.5,0,1.5,0,1.4285714285714286,0,1,0,1.5405405405405406,0,2,0,0,-1.0637537247974898,-0.9636279499050556,-0.17425341425049792,-0.5689406820777768,3,3,1,3,1,1,5,8,4,1.5118578920369088,3,0,6,2.1383604019972946,4,4,4,4,1,1,1,3,3,1,1,1.6035674514745464,3.2857142857142856,0,2.7142857142857144,6,3.8333333333333335,3.2559414990859232,0.9547190977297628,0,0.6209469802322789,3,3,3,3,3,1,5,1,1,5,5,5,1,5,5,3,3,1,1,4,1.869555587629877,3,0,3.8,0,3.8,0,4.4,0,4,0,2,1,1,4,4,1,2,1,4,1,1,1,1,2,4,1,1,1,1,4,1.2937094768634556,2.2,0,Black or African American,0,29,0,1,NA,1,1,3,photographer,1,0,188,65,2,5,2,0,0,1,0,0,TRUE,TRUE,TRUE,TRUE,TRUE,6,0.8211657142864807,0.7142857142857143,0.07651404833346265,6,0.42269375000032594,0.48782580645166096,1,0.96875,0.004048174798430775,0.003991598991879243,6,0.7119624999994412,0.7818375000008382,1,1,0.016932219193666682,0.015945316612640682,1.4334,0.6881,0.3519,1.1095,0.9939,0.4909,0.0958,1.4540065336666668,0.7655329917,0.34714776166666667,1.2379,4.9322,0.2972,4.1499,0.3448,-83.2462,0.9339,5.1993,0.3335,6.2669,0.4128,0.9984,1.3137276959,4.180511339333333,4.962228295333333,0.3391911394,0.2920452659,1.1112,3.5218,0.5519,3.391,0.6187,0.9197,0.085,0.513,0.472,0.016,1.485,92.8125,2.400039951666667,4.328200363666666,4.281941847333333,0.4362159932333333,0.5068814862,452,1.3392592592592591,1,0,1,2,FALSE,FALSE,FALSE
559,2021-11-13T13:19:06Z,2021-11-13T13:47:02Z,1676,1,2021-11-13T13:47:03Z,1,Chrome,95.0.4638.69,Windows NT 10.0,1536,864,No the survey worked as intended.,1.7777777777777777,645,102,311,126,62,100,-0.3705008450534919,0.11079394750866343,-0.5608808620640088,0.26101634177852706,-0.1373630793865373,-0.09081811635040013,2,2,3,3,2,2,3,2,3,2,3,3,3,2,2,2,3,3,3,3,0.5104177855340404,1,0,3,3,3,2.75,0,2,4,3,4,2,1,4,2,2,2,2,4,2,4,3,2,2,1,1,1,1,1,1,0,2,0,0,4,4,5,4,3,5,4,5,5,2,4,2,1,4,2,5,2,2,2,2,3,5,1,1,1,3,2,1,1,1,1,4,1,1,1,2,1,2,2,2,2,1.5156837721956706,1.0327955589886444,1.25,0,2,0,2.2,0,1.6666666666666667,0,1.9166666666666667,0,1.3333333333333333,0,1,0,1.3333333333333333,0,1.5945945945945945,0,0,0,0,-0.8746295276057681,-0.6897116206118464,-0.4236359564090485,-0.5566737885104475,5,1,4,1,1,1,3,1,1,1.7043362064926932,1.4285714285714286,0,1,-0.6467170085812028,4,4,4,4,3,3,3,7,3,4,3,0.5345224838248488,3.5714285714285716,0,2.4285714285714284,4,3.8333333333333335,3.2559414990859232,-0.1748077221195339,0,-0.10315842453524313,2,4,3,2,3,2,5,2,2,4,3,4,2,3,4,1,3,2,3,2,1.082325538564332,2.8,0,3.6,0,4.2,0,3.8,0,3.8666666666666667,0,2,1,2,3,2,1,2,3,1,3,2,3,2,2,1,4,1,2,2,2,0.8255779474818965,1.75,0,"White, Caucasian, Anglo, European American",0,21,0,1,NA,1,3,4,Student,5,0,170,70,3,5,2,0,0,1,0,0,TRUE,TRUE,TRUE,TRUE,TRUE,2,0.8799583333200879,0.72,0.14146444222085017,2,0.5211718750037253,0.6205375000089407,1,1,0.005005209184304422,0.011835861776351085,2,0.5718249999955297,0.6960064516221324,1,0.96875,0.00436858838653403,0.01135866774196663,1.669,0.5961,0.3369,1.481,0.4647,0.4645,0.185,1.6379659576666667,0.672287085765,0.3381288399,1.3852,5.9702,0.4052,3.4257,0.4184,-78.5426,0.8435,5.0233,0.4307,3.8018,0.5098,0.8456,1.6769830323666666,3.747671212333333,5.791535507666667,0.3967480503333333,0.38087560243333335,0.9127,6.0249,0.4957,2.8206,0.5706,0.988,0.164,0.326,0.655,0.014,1.687,120.5,1.7228859679666666,5.053740905333333,3.350636187666667,0.40578891743333334,0.46114394206666665,104,0.3081481481481481,1,0,1,2,FALSE,FALSE,FALSE
560,2021-11-13T13:24:53Z,2021-11-13T13:49:55Z,1502,1,2021-11-13T13:49:57Z,0.699999988079071,Safari,15.1,Macintosh,1440,900,N/A,1.6,715,102,418,108,44,74,-0.19064515382413216,0.11079394750866343,-0.04575727469669198,0.04166102416574309,-0.3859801528497444,-0.5299936521325801,3,3,2,2,3,1,1,3,1,3,3,1,2,1,3,3,1,1,2,3,0.9119095061289915,0,0,2,4,4,1.7,0,1,4,2,3,2,2,1,3,1,1,2,1,1,1,1,3,3,1,1,3,5,3,4,2,2,0,0,4,4,1,5,4,5,5,5,2,2,4,5,1,3,2,3,3,5,5,5,5,4,1,1,1,3,1,1,2,2,1,4,2,3,1,1,4,1,1,1,1,1.572091432287407,0.9611501047232549,2.875,0,1,0,2.933333333333333,0,2.111111111111111,0,3.4166666666666665,0,1.3333333333333333,0,1.7142857142857142,0,2,0,2.3783783783783785,0,1,0,0,0.623654390146426,0.6606087716035466,-0.5341482934814965,0.06323023906102504,5,1,1,1,1,1,1,1,2,1.5118578920369088,1.5714285714285714,0,1.5,-0.3767559860388676,5,5,5,5,1,4,1,6,6,5,3,1.889822365046136,4.285714285714286,0,1.7142857142857142,3,3.8333333333333335,3.2559414990859232,-0.7395711320441822,0,-0.783895116604751,1,1,1,2,1,2,4,1,1,2,1,4,3,4,5,1,5,2,3,4,1.4735767952260144,1.2,0,4.4,0,3.4,0,4.2,0,4,0,1,1,2,4,2,2,2,4,1,1,1,4,2,2,1,4,1,2,1,2,1.1239029738980326,1.4,0,"White, Caucasian, Anglo, European American",0,23,0,1,NA,1,4,6,IT Engineer,5,0,304,71,1,5,2,0,0,1,0,0,TRUE,TRUE,TRUE,TRUE,TRUE,5,0.87185,0.8163265306122449,0.048046950680275424,5,0.479709677419352,0.52309375,0.96875,1,0.005103338709677058,0.002525571572580675,5,0.6705937500000037,0.7121935483870968,1,1,0.005940119959677378,0.0032768946236564653,1.4329,1.1276,0.4707,1.3125,1.3818,0.5304,0.33,1.4512176706666666,1.0515023641666668,0.46322046586666665,1.1155,4.1712,0.353,5.1023,0.4138,-89.4811,0.7931,3.6186,0.3808,6.9399,0.4663,0.9843,1.2625334664666668,5.027531749666666,4.397864193666667,0.4030169095666667,0.3425875005333333,1.0177,3.9386,0.5522,6.4401,0.6328,0.9913,0.219,0.376,0.75,0.022,1.386,63,2.5751831353333334,5.058106181,5.875428088333333,0.4208335885,0.5032281555,370,1.0962962962962963,1,0,0,1,FALSE,FALSE,FALSE
561,2021-11-13T13:34:29Z,2021-11-13T13:56:58Z,1348,1,2021-11-13T13:56:59Z,1,Chrome,95.0.4638.69,Windows NT 10.0,1366,768,"Thank you so much guys, have a great day",1.7786458333333333,704,43,354,66,31,101,-0.21890819101731726,-0.4252056129690901,-0.35386857929022725,-0.47016805026408615,-0.5655369281287274,-0.07392674958954705,3,3,1,1,3,1,1,2,1,4,2,1,1,1,2,3,1,1,2,4,1.0711528467275955,0,1,1,4,3,1.6,0,4,3,2,4,3,2,4,1,1,1,1,5,2,5,3,2,1,1,1,1,1,1,1,4,2,0,0,5,4,4,2,1,5,3,4,5,2,4,1,1,5,1,5,1,1,1,2,2,5,1,1,1,4,3,2,5,5,1,4,2,1,1,1,1,2,1,3,3,1.6558205644760369,1.4375905768565218,1.125,0,2.25,0,1.8,0,2.3333333333333335,0,1.3333333333333333,0,1.6666666666666667,0,2.4285714285714284,0,1,0,1.864864864864865,0,2,0,0,-0.7842701889475012,-0.799181362106765,0.06095019390122543,-0.3691155841027698,5,1,2,1,1,1,3,1,1,1.5275252316519468,1.7142857142857142,0,1,-0.4757826382709144,3,5,5,5,1,2,4,8,6,NA,2,1.618347187425374,3.2857142857142856,0,2.7142857142857144,2,3.8333333333333335,3.2559414990859232,-1.3043345419688306,0,-0.5085798396170178,1,1,2,2,2,2,4,1,1,1,1,5,1,4,5,1,5,1,4,1,1.7674302033770737,1.6,0,4.8,0,3.8,0,4.8,0,4.466666666666667,0,1,1,1,4,1,1,1,3,1,1,1,4,1,1,1,4,1,1,1,1,1.145931016569864,1.05,0,"Hispanic of Latino (e.g., Mexican American, Central American, and others)",0,21,0,1,NA,1,4,6,Medical assistant,6,0,138,65,2,5,2,0,0,1,0,0,TRUE,TRUE,TRUE,TRUE,TRUE,5,0.8798441176453934,0.68,0.0709745258118037,5,0.40597142856993845,0.48372083333320914,0.9032258064516129,0.75,0.0058583976126168474,0.008445787812231657,5,0.5562499999980132,0.6595888888896615,0.9375,0.84375,0.02134461350833954,0.025871508780151337,1.5553,0.5211,0.3764,0.8644,0.8384,0.741,0.3444,1.554139791,0.6304938920133333,0.3737063304,0.9356,2.7004,0.263,1.3137,0.2786,-38.059,0.7064,3.9661,0.323,2.3517,0.3551,0.9151,0.9867343268666666,1.6453691513,3.04964409,0.2758960542,0.2598082883,0.8198,3.4346,0.4372,2.8973,0.5245,0.9907,0.062,0.33,0.287,0.01,1.812,181.2,1.3581486913333334,2.7433231853333333,1.4850823981133334,0.3238161999333333,0.28138917973333333,370,1.0962962962962963,1,0,0,1,FALSE,FALSE,FALSE
562,2021-11-13T13:47:23Z,2021-11-13T14:17:42Z,1818,1,2021-11-13T14:17:43Z,0.8999999761581421,Chrome,95.0.4638.69,Windows NT 10.0,1920,1080,.,1.7777777777777777,823,115,484,105,98,119,0.0868464840725943,0.22889554558003286,0.27198250816539127,0.0051018045636124325,0.3598710675398769,0.2301178521058083,4,4,1,1,3,1,1,4,1,4,3,1,1,1,4,2,1,1,4,3,1.3717065820970682,0,1,1,5,5,1.25,0,4,4,2,4,1,2,5,2,1,1,1,4,3,4,1,2,1,1,1,2,1,3,1,1,2,0,1,4,3,3,3,2,5,5,4,4,1,5,1,1,2,1,1,1,1,1,1,1,5,1,1,1,3,2,1,2,1,1,5,1,1,1,1,1,2,1,2,2,1.5052460814650095,1.4540583599999397,1.5,0,1.75,0,1.9333333333333333,0,2.3333333333333335,0,1.5833333333333333,0,1.3333333333333333,0,1,0,1,0,1.6216216216216217,0,1,0,1,-0.7023163701644217,-0.6852592703830522,-0.12249503843059244,-0.4038771544068223,2,2,1,2,1,2,1,4,2,0.5345224838248488,2.4285714285714284,0,3,0.6895286370535711,3,3,4,4,1,1,3,1,1,1,2,1.2535663410560174,2.7142857142857144,0,3.2857142857142856,8,3.8333333333333335,3.2559414990859232,2.0842459175790595,0,1.5043943798426742,1,2,2,1,1,3,4,1,1,2,1,4,1,4,2,3,3,2,3,4,1.1872336794093274,1.4,0,3.8,0,3.4,0,3.6,0,3.6,0,1,1,1,3,1,1,2,3,1,1,2,4,1,1,1,3,1,1,1,1,0.9445132413883326,1.25,0,"White, Caucasian, Anglo, European American",0,21,0,1,NA,1,3,1,IT Techican,1,0,140,66,2,5,2,0,0,1,0,0,TRUE,TRUE,TRUE,TRUE,TRUE,2,0.8421472222222688,0.72,0.11268741092242825,2,0.48650322580634947,0.5712612903226587,0.96875,1,0.005167779425388478,0.0091632744516272,2,0.5863437500001164,0.6916999999998661,1,1,0.010310910282267634,0.01784381032257291,1.4503,0.6852,0.4109,1.127,0.5956,0.543,0.2645,1.4721457396666666,0.7586171378333333,0.4046372001333333,1.6139,3.8358,0.287,3.9939,0.3692,-58.435,0.9364,4.8581,0.3981,3.8261,0.4581,0.6766,1.6590053510333334,3.974543768,3.973217959,0.36313046886666667,0.2846652981,1.1246,3.6493,0.4503,4.0065,0.5369,0.9624,0.431,0.025,0.773,0.012,1.449,120.75,2.271923495,4.134657906,4.218609368666667,0.31196436126666666,0.42738596323333333,278,0.8237037037037037,1,0,3,4,FALSE,FALSE,FALSE
563,2021-11-13T13:51:07Z,2021-11-13T14:31:28Z,2421,1,2021-11-13T14:31:31Z,1,Chrome,94.0.4606.81,Windows NT 10.0,1366,768,Everything went well!,1.7786458333333333,883,147,803,157,122,153,0.2410085051263312,0.5196071716018653,1.8077247919987938,0.6387949443338773,0.6913604988241531,0.8044243219748128,3,3,1,1,3,1,2,4,1,3,3,2,1,2,3,3,2,1,1,2,0.9679060415469871,0,0,1,5,5,1.8,0,2,4,1,4,3,4,3,3,2,2,2,4,1,4,3,1,3,1,1,1,1,1,1,0,2,0,1,4,3,5,3,3,5,3,3,5,4,5,2,1,4,2,5,3,1,1,2,3,5,1,1,1,1,1,1,1,1,1,4,1,3,1,2,1,3,1,1,1,1.5206289199907754,1.082325538564332,1.25,0,1.5,0,2.4,0,2.2222222222222223,0,1.9166666666666667,0,0.8333333333333334,0,1.2857142857142858,0,1.3333333333333333,0,1.7027027027027026,0,0,0,1,-0.8073853686042672,-0.5573025964164013,-0.40398871494434996,-0.48064565568037565,4,2,2,2,1,2,2,3,8,0.8997354108424374,2.142857142857143,0,5.5,1.4410634536792382,4,4,4,4,2,2,3,4,4,2,2,0.9511897312113419,3.2857142857142856,0,2.7142857142857144,5,3.8333333333333335,3.2559414990859232,0.38995568780511447,0,0.3385652752699547,2,3,3,1,2,3,3,2,2,3,3,3,2,4,3,2,4,2,3,4,0.7432233529572065,2.2,0,3.4,0,3.4,0,3.4,0,3.4,0,2,1,1,3,2,2,2,4,2,1,2,4,2,2,1,3,1,1,1,2,0.9445132413883326,1.55,0,"White, Caucasian, Anglo, European American",0,24,0,1,NA,1,1,6,Skilled Laborer,1,0,200,71,4,5,2,0,0,0,0,0,TRUE,TRUE,TRUE,TRUE,TRUE,NA,NA,NA,NA,1,0.4738718750178814,0.4987218749821186,1,1,0.0023315995095441813,0.0027306217627982555,1,0.6317312500327825,0.7131482758522034,1,0.90625,0.010625648013318317,0.013268004652575063,NA,NA,NA,NA,NA,NA,NA,NA,NA,NA,10,12.4333,0.0717,12.083,0.0849,-99.7877,0.5259,5.2912,0.4379,7.0734,0.4685,0.9505,1.9260191000333333,5.718531692666667,5.409321040333333,0.3377726128333333,0.2991985309333333,0.9078,4.1243,0.5379,2.3296,0.5704,0.8981,0.07,0.438,0.365,0.016,1.769,110.56249999999999,1.627902951,3.3771849186666665,2.549233017666667,0.38518824683333336,0.4329568042,336,0.9955555555555555,1,0,0,1,FALSE,FALSE,FALSE
564,2021-11-13T13:40:36Z,2021-11-13T14:35:21Z,3285,1,2021-11-13T14:35:22Z,0.8999999761581421,Chrome,95.0.4638.69,Windows NT 10.0,1920,1080,This was a very interesting survey.,1.7777777777777777,630,37,232,65,29,72,-0.4090413503169261,-0.47971404284818364,-0.9412057536716539,-0.4823544567981297,-0.593161047402417,-0.5637763856542862,4,4,1,1,4,1,1,4,1,4,4,1,1,1,4,4,1,1,4,4,1.538967528127731,0,0,2,5,5,1,0,5,5,2,5,1,1,5,1,1,1,1,5,2,5,3,1,1,1,1,1,1,1,1,1,2,0,0,5,4,4,5,4,5,5,5,5,1,5,1,1,5,1,5,1,1,1,1,2,5,1,1,1,2,2,1,2,2,1,5,1,1,1,1,1,2,1,1,2,1.8034001919297482,1.88477610139267,1,0,1.5,0,1.2666666666666666,0,1.3333333333333333,0,1.0833333333333333,0,1.1666666666666667,0,1.1428571428571428,0,1,0,1.2162162162162162,0,1,0,0,-1.2654862018019926,-1.3608550224913916,-0.3773458880470143,-0.869100455269203,5,1,4,1,1,1,1,1,1,1.7320508075688772,1.1428571428571428,0,1,-0.8176513788914915,4,3,5,5,2,3,2,6,5,3,3,1.2724180205607036,3.7142857142857144,0,2.2857142857142856,3.5,3.8333333333333335,3.2559414990859232,-0.4571894270818581,0,-0.3240202744378419,1,2,2,2,2,2,4,3,1,4,1,5,2,5,5,1,5,1,4,2,1.647508942095828,1.8,0,4.8,0,4.2,0,4.4,0,4.466666666666667,0,1,1,1,4,1,1,1,4,1,1,1,4,1,1,1,4,1,1,1,1,1.231174022502185,1,0,"White, Caucasian, Anglo, European American",0,30,0,1,NA,1,3,6,Communications Director,4,0,158,73,3,5,2,0,0,1,0,0,TRUE,TRUE,TRUE,TRUE,TRUE,1,0.895434883720653,0.86,0.022624625698157708,1,0.4915937500055879,0.5697741935483871,1,0.96875,0.0021118980241960432,0.00241716160265523,1,0.6402906250040978,0.6464468750003726,1,1,0.006727498941655854,0.005067250313043982,1.2188,1.5692,0.6312,0.7093,2.1376,0.7969,0.3375,1.2701991335666667,1.2936953447666666,0.6189531546,1.0185,7.0587,0.4195,3.9915,0.4473,-105.3445,0.6458,6.0456,0.4359,6.1639,0.5211,0.952,1.1756320943333334,4.180630403,6.395643749333333,0.4369836805,0.40583037163333335,0.8945,4.2133,0.5414,4.876,0.5562,0.8836,0.291,0.275,0.795,0.246,1.088,4.4227642276422765,2.3377781063333334,5.179370494333333,5.032365297666667,0.4196350582,0.4224819130333333,354,1.0488888888888888,1,0,0,1,FALSE,FALSE,FALSE
